Assists,Blocked Shots,Defensive Rebounds,3-PT Attempted,3-PT Made,FG Attempted,FG Made,Free Throws Attempted,Free Throws Made,Minutes,Offensive Rebounds,Fouls,Points,Rebounds,Steals,Turnovers,Game_ID,Game_Date,player.id,team.id,Name,Blks+Stls,Pts+Rebs,Pts+Rebs+Asts,Pts+Asts,Rebs+Asts,Fantasy Score
5,1,5,2,1,11,7,0,0,35,2,0,15,7,2,0,1037593,2023-10-24T00:00:00.000Z,177,8,Aaron Gordon,3,22,27,20,12,39.9
0,0,0,0,0,0,0,0,0,1,0,0,0,0,0,0,1037593,2023-10-24T00:00:00.000Z,17896007,8,Braxton Key,0,0,0,0,0,0
2,1,2,1,0,5,2,2,1,19,1,1,5,3,0,1,1037593,2023-10-24T00:00:00.000Z,38017709,8,Christian Braun,1,8,10,7,5,13.6
0,0,0,0,0,0,0,0,0,1,0,0,0,0,0,0,1037593,2023-10-24T00:00:00.000Z,38017727,8,Collin Gillespie,0,0,0,0,0,0
0,0,0,0,0,0,0,0,0,0,0,0,0,0,0,0,1037593,2023-10-24T00:00:00.000Z,250,8,DeAndre Jordan,0,0,0,0,0,0
0,0,0,0,0,0,0,0,0,0,0,0,0,0,0,0,1037593,2023-10-24T00:00:00.000Z,56677871,8,Hunter Tyson,0,0,0,0,0,0
0,0,0,0,0,1,1,0,0,1,0,0,2,0,0,0,1037593,2023-10-24T00:00:00.000Z,56677582,8,Jalen Pickett,0,2,2,2,0,2
6,1,2,5,3,13,8,2,2,34,0,3,21,2,0,1,1037593,2023-10-24T00:00:00.000Z,335,8,Jamal Murray,1,23,29,27,8,34.4
0,0,0,0,0,0,0,0,0,0,0,0,0,0,0,0,1037593,2023-10-24T00:00:00.000Z,17896103,8,Jay Huff,0,0,0,0,0,0
0,0,0,0,0,0,0,0,0,0,0,0,0,0,0,0,1037593,2023-10-24T00:00:00.000Z,56677776,8,Julian Strawther,0,0,0,0,0,0
0,0,0,0,0,0,0,0,0,0,0,0,0,0,0,0,1037593,2023-10-24T00:00:00.000Z,215,8,Justin Holiday,0,0,0,0,0,0
1,1,1,3,2,12,8,2,2,36,1,5,20,2,3,3,1037593,2023-10-24T00:00:00.000Z,81,8,Kentavious Caldwell-Pope,4,22,23,21,3,32.9
2,0,10,9,2,13,5,0,0,30,2,1,12,12,2,0,1037593,2023-10-24T00:00:00.000Z,375,8,Michael Porter Jr.,2,24,26,14,14,35.4
11,1,10,5,3,22,12,4,2,36,3,2,29,13,1,2,1037593,2023-10-24T00:00:00.000Z,246,8,Nikola Jokic,2,42,53,40,24,65.1
1,0,3,5,2,8,3,0,0,24,0,0,8,3,1,2,1037593,2023-10-24T00:00:00.000Z,236,8,Reggie Jackson,1,11,12,9,4,14.1
0,0,0,0,0,0,0,0,0,0,0,0,0,0,0,0,1037593,2023-10-24T00:00:00.000Z,666489,8,Vlatko Cancar,0,0,0,0,0,0
0,0,0,0,0,0,0,0,0,0,0,0,0,0,0,0,1037593,2023-10-24T00:00:00.000Z,56677867,14,Alex Fudge,0,0,0,0,0,0
4,2,7,2,1,17,6,4,4,34,1,3,17,8,0,2,1037593,2023-10-24T00:00:00.000Z,117,14,Anthony Davis,2,25,29,21,12,36.6
4,0,4,2,1,11,4,7,5,31,4,2,14,8,2,2,1037593,2023-10-24T00:00:00.000Z,17553995,14,Austin Reaves,2,22,26,18,12,33.6
0,1,2,2,1,4,2,2,2,18,2,2,7,4,0,0,1037593,2023-10-24T00:00:00.000Z,666860,14,Cameron Reddish,1,11,11,7,4,14.8
0,0,3,1,0,4,3,2,1,16,1,1,7,4,0,1,1037593,2023-10-24T00:00:00.000Z,486,14,Christian Wood,0,11,11,7,4,10.8
0,0,0,0,0,0,0,0,0,0,0,0,0,0,0,0,1037593,2023-10-24T00:00:00.000Z,56677738,14,Colin Castleton,0,0,0,0,0,0
7,0,4,5,2,12,4,2,1,36,0,3,11,4,1,3,1037593,2023-10-24T00:00:00.000Z,405,14,D'Angelo Russell,1,15,22,18,11,26.3
0,0,0,0,0,0,0,0,0,0,0,0,0,0,0,0,1037593,2023-10-24T00:00:00.000Z,56677868,14,D'Moi Hodge,0,0,0,0,0,0
2,0,0,4,0,8,3,0,0,22,1,3,6,1,1,2,1037593,2023-10-24T00:00:00.000Z,1603383,14,Gabe Vincent,1,7,9,8,3,11.2
0,0,0,0,0,0,0,0,0,0,0,0,0,0,0,0,1037593,2023-10-24T00:00:00.000Z,56677835,14,Jalen Hood-Schifino,0,0,0,0,0,0
0,0,0,0,0,0,0,0,0,0,0,0,0,0,0,0,1037593,2023-10-24T00:00:00.000Z,457,14,Jarred Vanderbilt,0,0,0,0,0,0
0,0,1,0,0,0,0,0,0,7,0,1,0,1,0,0,1037593,2023-10-24T00:00:00.000Z,666626,14,Jaxson Hayes,0,1,1,0,1,1.2
5,0,7,4,1,16,10,1,0,29,1,1,21,8,1,0,1037593,2023-10-24T00:00:00.000Z,237,14,LeBron James,1,29,34,26,13,41.1
0,0,0,0,0,0,0,0,0,1,0,0,0,0,0,0,1037593,2023-10-24T00:00:00.000Z,38017697,14,Max Christie,0,0,0,0,0,0
0,0,0,0,0,0,0,0,0,1,0,0,0,0,0,0,1037593,2023-10-24T00:00:00.000Z,56677836,14,Maxwell Lewis,0,0,0,0,0,0
0,0,1,3,0,10,3,0,0,15,2,2,6,3,0,0,1037593,2023-10-24T00:00:00.000Z,666609,14,Rui Hachimura,0,9,9,6,3,9.6
1,1,2,6,4,8,6,2,2,30,1,0,18,3,0,1,1037593,2023-10-24T00:00:00.000Z,383,14,Taurean Prince,1,21,22,19,4,25.1
0,1,0,3,0,12,4,3,2,27,1,3,10,1,0,0,1037594,2023-10-24T00:00:00.000Z,475,10,Andrew Wiggins,1,11,11,10,1,14.2
9,0,5,6,0,15,4,7,6,34,1,0,14,6,2,1,1037594,2023-10-24T00:00:00.000Z,367,10,Chris Paul,2,20,29,23,15,39.7
1,0,0,0,0,0,0,0,0,4,1,0,0,1,0,0,1037594,2023-10-24T00:00:00.000Z,251,10,Cory Joseph,0,1,2,1,2,2.7
1,2,3,3,1,11,3,0,0,20,4,3,7,7,0,0,1037594,2023-10-24T00:00:00.000Z,407,10,Dario Saric,2,14,15,8,8,22.9
2,0,2,2,0,5,0,2,1,22,0,1,1,2,3,0,1037594,2023-10-24T00:00:00.000Z,2189,10,Gary Payton II,3,3,5,3,4,15.4
1,1,3,0,0,8,4,6,4,20,3,5,12,6,2,2,1037594,2023-10-24T00:00:00.000Z,17553979,10,Jonathan Kuminga,3,18,19,13,7,27.7
1,0,6,0,0,6,3,1,1,28,5,2,7,11,0,2,1037594,2023-10-24T00:00:00.000Z,282,10,Kevon Looney,0,18,19,8,12,19.7
3,1,6,11,3,18,6,0,0,36,1,3,15,7,0,3,1037594,2023-10-24T00:00:00.000Z,443,10,Klay Thompson,1,22,25,18,10,27.9
0,1,2,4,2,6,4,2,1,18,1,1,11,3,3,1,1037594,2023-10-24T00:00:00.000Z,17553992,10,Moses Moody,4,14,14,11,3,25.6
1,0,4,14,4,20,8,7,7,31,1,5,27,5,1,2,1037594,2023-10-24T00:00:00.000Z,115,10,Stephen Curry,1,32,33,28,6,35.5
0,0,0,0,0,0,0,0,0,0,0,0,0,0,0,0,1037594,2023-10-24T00:00:00.000Z,56677799,10,Trayce Jackson-Davis,0,0,0,0,0,0
0,0,0,0,0,0,0,0,0,0,0,0,0,0,0,0,1037594,2023-10-24T00:00:00.000Z,666451,24,Bol Bol,0,0,0,0,0,0
0,0,0,0,0,0,0,0,0,0,0,0,0,0,0,0,1037594,2023-10-24T00:00:00.000Z,32,24,Keita Bates-Diop,0,0,0,0,0,0
0,0,0,0,0,0,0,0,0,0,0,0,0,0,0,0,1037594,2023-10-24T00:00:00.000Z,3547298,24,Saben Lee,0,0,0,0,0,0
0,0,0,0,0,0,0,0,0,0,0,0,0,0,0,0,1037594,2023-10-24T00:00:00.000Z,3547095,24,Udoka Azubuike,0,0,0,0,0,0
0,0,2,1,0,2,1,0,0,10,0,1,2,2,0,1,1037595,2023-10-25T00:00:00.000Z,38017689,1,AJ Griffin,0,4,4,2,2,3.4
4,0,4,5,1,9,3,0,0,24,0,1,7,4,3,0,1037595,2023-10-25T00:00:00.000Z,53,1,Bogdan Bogdanovic,3,11,15,11,8,26.8
0,0,0,0,0,0,0,0,0,0,0,0,0,0,0,0,1037595,2023-10-25T00:00:00.000Z,666564,1,Bruno Fernando,0,0,0,0,0,0
0,0,7,0,0,10,6,4,3,29,6,1,15,13,1,2,1037595,2023-10-25T00:00:00.000Z,83,1,Clint Capela,1,28,28,15,13,31.6
1,0,2,4,1,9,4,1,0,31,2,6,9,4,0,0,1037595,2023-10-25T00:00:00.000Z,666656,1,De'Andre Hunter,0,13,14,10,5,15.3
6,0,2,3,0,14,3,6,5,33,0,0,11,2,0,1,1037595,2023-10-25T00:00:00.000Z,334,1,Dejounte Murray,0,13,19,17,8,21.4
0,0,0,0,0,0,0,0,0,0,0,0,0,0,0,0,1037595,2023-10-25T00:00:00.000Z,666754,1,Garrison Mathews,0,0,0,0,0,0
2,1,7,3,1,13,9,4,2,29,0,1,21,7,2,0,1037595,2023-10-25T00:00:00.000Z,17896040,1,Jalen Johnson,3,28,30,23,9,41.4
0,0,0,0,0,0,0,0,0,0,0,0,0,0,0,0,1037595,2023-10-25T00:00:00.000Z,56677838,1,Kobe Bufkin,0,0,0,0,0,0
0,0,0,0,0,0,0,0,0,0,0,0,0,0,0,0,1037595,2023-10-25T00:00:00.000Z,56677875,1,Miles Norris,0,0,0,0,0,0
0,0,0,0,0,0,0,0,0,0,0,0,0,0,0,0,1037595,2023-10-25T00:00:00.000Z,56677806,1,Mouhamed Gueye,0,0,0,0,0,0
2,0,3,0,0,5,3,1,1,19,1,5,7,4,0,1,1037595,2023-10-25T00:00:00.000Z,3547244,1,Onyeka Okongwu,0,11,13,9,6,13.8
0,0,0,0,0,0,0,0,0,0,0,0,0,0,0,0,1037595,2023-10-25T00:00:00.000Z,319,1,Patty Mills,0,0,0,0,0,0
0,0,2,4,1,12,6,2,2,29,3,1,15,5,5,2,1037595,2023-10-25T00:00:00.000Z,3547256,1,Saddiq Bey,5,20,20,15,5,34
0,0,0,0,0,0,0,0,0,0,0,0,0,0,0,0,1037595,2023-10-25T00:00:00.000Z,56677855,1,Seth Lundy,0,0,0,0,0,0
9,0,1,9,1,19,4,15,14,36,0,3,23,1,1,5,1037595,2023-10-25T00:00:00.000Z,490,1,Trae Young,1,24,33,32,10,35.7
0,0,0,0,0,0,0,0,0,0,0,0,0,0,0,0,1037595,2023-10-25T00:00:00.000Z,3547297,1,Trent Forrest,0,0,0,0,0,0
0,0,0,0,0,0,0,0,0,0,0,0,0,0,0,0,1037595,2023-10-25T00:00:00.000Z,301,1,Wesley Matthews,0,0,0,0,0,0
0,0,0,0,0,0,0,0,0,0,0,0,0,0,0,0,1037595,2023-10-25T00:00:00.000Z,56677848,4,Amari Bailey,0,0,0,0,0,0
2,0,3,7,3,9,5,0,0,25,0,3,13,3,0,1,1037595,2023-10-25T00:00:00.000Z,56677823,4,Brandon Miller,0,16,18,15,5,18.6
0,0,0,0,0,0,0,0,0,0,0,0,0,0,0,0,1037595,2023-10-25T00:00:00.000Z,38017708,4,Bryce McGowens,0,0,0,0,0,0
0,0,0,0,0,0,0,0,0,0,0,0,0,0,0,0,1037595,2023-10-25T00:00:00.000Z,666748,4,Cody Martin,0,0,0,0,0,0
0,0,0,0,0,0,0,0,0,0,0,0,0,0,0,0,1037595,2023-10-25T00:00:00.000Z,347,4,Frank Ntilikina,0,0,0,0,0,0
7,1,5,1,0,8,4,3,2,33,3,1,10,8,1,6,1037595,2023-10-25T00:00:00.000Z,204,4,Gordon Hayward,2,18,25,17,15,30.1
0,0,0,0,0,0,0,0,0,0,0,0,0,0,0,0,1037595,2023-10-25T00:00:00.000Z,422,4,Ish Smith,0,0,0,0,0,0
0,0,0,0,0,0,0,0,0,0,0,0,0,0,0,0,1037595,2023-10-25T00:00:00.000Z,17896037,4,James Bouknight,0,0,0,0,0,0
1,0,1,3,1,7,2,0,0,20,1,0,5,2,0,0,1037595,2023-10-25T00:00:00.000Z,18678001,4,JT Thor,0,7,8,6,3,8.9
10,0,5,11,4,15,4,4,3,31,1,3,15,6,1,3,1037595,2023-10-25T00:00:00.000Z,3547239,4,LaMelo Ball,1,21,31,25,16,37.2
0,0,0,0,0,0,0,0,0,0,0,0,0,0,0,0,1037595,2023-10-25T00:00:00.000Z,56677866,4,Leaky Black,0,0,0,0,0,0
1,1,11,0,0,6,5,3,3,30,4,2,13,15,3,2,1037595,2023-10-25T00:00:00.000Z,38017698,4,Mark Williams,4,28,29,14,16,42.5
0,0,0,0,0,0,0,0,0,0,0,0,0,0,0,0,1037595,2023-10-25T00:00:00.000Z,62,4,Miles Bridges,0,0,0,0,0,0
1,1,3,0,0,2,2,4,3,18,1,3,7,4,0,2,1037595,2023-10-25T00:00:00.000Z,3547282,4,Nick Richards,1,11,12,8,5,14.3
0,0,0,0,0,0,0,0,0,1,0,0,0,0,0,0,1037595,2023-10-25T00:00:00.000Z,56677846,4,Nick Smith Jr.,0,0,0,0,0,0
2,0,4,6,1,18,12,0,0,32,1,4,25,5,0,1,1037595,2023-10-25T00:00:00.000Z,666950,4,P.J. Washington,0,30,32,27,7,33
6,0,4,7,2,16,7,12,8,34,1,2,24,5,0,3,1037595,2023-10-25T00:00:00.000Z,403,4,Terry Rozier,0,29,35,30,11,36
4,0,3,2,0,5,2,0,0,16,0,3,4,3,0,1,1037595,2023-10-25T00:00:00.000Z,3547253,4,Theo Maledon,0,7,11,8,7,12.6
1,1,4,3,1,5,2,2,2,23,1,3,7,5,0,1,1037596,2023-10-25T00:00:00.000Z,3547250,12,Aaron Nesmith,1,12,13,8,6,16.5
10,0,3,1,0,9,6,0,0,22,1,4,12,4,0,2,1037596,2023-10-25T00:00:00.000Z,38017507,12,Andrew Nembhard,0,16,26,22,14,29.8
0,0,0,0,0,1,0,0,0,6,0,0,0,0,0,0,1037596,2023-10-25T00:00:00.000Z,56677861,12,Ben Sheppard,0,0,0,0,0,0
1,0,2,8,6,11,8,2,2,27,1,3,24,3,1,1,1037596,2023-10-25T00:00:00.000Z,69,12,Bruce Brown,1,27,28,25,4,31.1
5,1,2,7,4,9,5,0,0,25,0,0,14,2,1,1,1037596,2023-10-25T00:00:00.000Z,210,12,Buddy Hield,2,16,21,19,7,28.9
0,0,0,0,0,0,0,0,0,0,0,0,0,0,0,0,1037596,2023-10-25T00:00:00.000Z,439,12,Daniel Theis,0,0,0,0,0,0
0,0,3,0,0,4,2,0,0,11,1,2,4,4,0,0,1037596,2023-10-25T00:00:00.000Z,17896035,12,Isaiah Jackson,0,8,8,4,4,8.8
0,0,0,0,0,0,0,0,0,0,0,0,0,0,0,0,1037596,2023-10-25T00:00:00.000Z,56677794,12,Isaiah Wong,0,0,0,0,0,0
0,0,5,2,2,6,5,1,1,13,3,4,13,8,1,0,1037596,2023-10-25T00:00:00.000Z,3547264,12,Jalen Smith,1,21,21,13,8,25.6
0,0,3,1,0,5,0,0,0,6,1,1,0,4,1,0,1037596,2023-10-25T00:00:00.000Z,56677832,12,Jarace Walker,1,4,4,0,4,7.8
1,1,0,2,1,7,2,0,0,6,1,0,5,1,0,0,1037596,2023-10-25T00:00:00.000Z,3547207,12,Jordan Nwora,1,6,7,6,2,10.7
0,0,0,0,0,0,0,0,0,0,0,0,0,0,0,0,1037596,2023-10-25T00:00:00.000Z,38017701,12,Kendall Brown,0,0,0,0,0,0
1,3,8,2,0,8,5,2,1,23,0,4,11,8,0,2,1037596,2023-10-25T00:00:00.000Z,452,12,Myles Turner,3,19,20,12,9,29.1
1,0,3,5,2,9,4,1,1,19,1,0,11,4,1,0,1037596,2023-10-25T00:00:00.000Z,3547243,12,Obi Toppin,1,15,16,12,5,20.3
0,0,0,0,0,0,0,0,0,0,0,0,0,0,0,0,1037596,2023-10-25T00:00:00.000Z,56677778,12,Oscar Tshiebwe,0,0,0,0,0,0
2,0,1,0,0,2,2,0,0,6,0,0,4,1,2,0,1037596,2023-10-25T00:00:00.000Z,304,12,T.J. McConnell,2,5,7,6,3,14.2
11,2,3,6,2,16,9,0,0,27,0,1,20,3,1,3,1037596,2023-10-25T00:00:00.000Z,3547245,12,Tyrese Haliburton,3,23,34,31,14,46.1
0,0,0,0,0,0,0,0,0,0,0,0,0,0,0,0,1037596,2023-10-25T00:00:00.000Z,3547302,30,Anthony Gill,0,0,0,0,0,0
3,3,4,1,1,3,1,0,0,23,0,1,3,4,0,3,1037596,2023-10-25T00:00:00.000Z,56677844,30,Bilal Coulibaly,3,7,10,6,7,18.3
1,0,3,5,1,11,4,2,2,25,2,1,11,5,0,1,1037596,2023-10-25T00:00:00.000Z,17896045,30,Corey Kispert,0,16,17,12,6,17.5
0,2,4,0,0,2,2,4,2,21,1,5,6,5,0,0,1037596,2023-10-25T00:00:00.000Z,666577,30,Daniel Gafford,2,11,11,6,5,18
0,0,1,2,2,7,4,6,6,17,2,1,16,3,0,0,1037596,2023-10-25T00:00:00.000Z,167,30,Danilo Gallinari,0,19,19,16,3,19.6
6,0,5,1,1,8,3,1,1,25,1,1,8,6,3,0,1037596,2023-10-25T00:00:00.000Z,487,30,Delon Wright,3,14,20,14,12,33.2
5,0,5,0,0,8,4,2,1,21,2,0,9,7,1,2,1037596,2023-10-25T00:00:00.000Z,3547242,30,Deni Avdija,1,16,21,14,12,25.9
1,0,1,0,0,3,2,0,0,8,1,0,4,2,0,1,1037596,2023-10-25T00:00:00.000Z,17896106,30,Eugene Omoruyi,0,6,7,5,3,6.9
0,0,0,1,1,2,1,0,0,4,0,0,3,0,0,0,1037596,2023-10-25T00:00:00.000Z,18677954,30,Jared Butler,0,3,3,3,0,3
0,0,0,0,0,0,0,0,0,0,0,0,0,0,0,0,1037596,2023-10-25T00:00:00.000Z,38124126,30,John Butler Jr.,0,0,0,0,0,0
0,0,0,0,0,0,0,0,0,0,0,0,0,0,0,0,1037596,2023-10-25T00:00:00.000Z,38017687,30,Johnny Davis,0,0,0,0,0,0
5,1,2,6,0,18,7,5,4,26,0,1,18,2,1,4,1037596,2023-10-25T00:00:00.000Z,666848,30,Jordan Poole,2,20,25,23,7,29.9
0,2,1,4,1,18,9,6,6,25,1,0,25,2,0,0,1037596,2023-10-25T00:00:00.000Z,265,30,Kyle Kuzma,2,27,27,25,2,33.4
0,0,0,0,0,0,0,0,0,0,0,0,0,0,0,0,1037596,2023-10-25T00:00:00.000Z,414,30,Landry Shamet,0,0,0,0,0,0
0,0,3,0,0,0,0,0,0,8,0,0,0,3,0,0,1037596,2023-10-25T00:00:00.000Z,337,30,Mike Muscala,0,3,3,0,3,3.6
0,0,0,0,0,1,0,0,0,3,0,0,0,0,0,0,1037596,2023-10-25T00:00:00.000Z,38017704,30,Patrick Baldwin Jr.,0,0,0,0,0,0
1,0,3,0,0,3,0,2,1,6,0,0,1,3,0,1,1037596,2023-10-25T00:00:00.000Z,38017712,30,Ryan Rollins,0,4,5,2,4,5.1
6,1,2,4,2,12,7,1,0,28,1,1,16,3,1,2,1037596,2023-10-25T00:00:00.000Z,249,30,Tyus Jones,2,19,25,22,9,32.6
0,0,0,1,0,3,0,0,0,5,0,0,0,0,0,0,1037598,2023-10-25T00:00:00.000Z,213,11,Aaron Holiday,0,0,0,0,0,0
6,0,6,1,0,11,6,4,2,28,2,4,14,8,0,1,1037598,2023-10-25T00:00:00.000Z,17896062,11,Alperen Sengun,0,22,28,20,14,31.6
2,0,4,7,1,10,3,2,1,21,1,2,8,5,0,4,1037598,2023-10-25T00:00:00.000Z,56677825,11,Amen Thompson,0,13,15,10,7,13
0,0,0,0,0,0,0,0,0,0,0,0,0,0,0,0,1037598,2023-10-25T00:00:00.000Z,296,11,Boban Marjanovic,0,0,0,0,0,0
0,0,1,2,0,4,0,0,0,10,0,0,0,1,0,1,1037598,2023-10-25T00:00:00.000Z,56677831,11,Cam Whitmore,0,1,1,0,1,0.2
2,0,4,6,4,7,5,0,0,26,0,4,14,4,1,2,1037598,2023-10-25T00:00:00.000Z,66,11,Dillon Brooks,1,18,20,16,6,22.8
5,0,1,6,4,13,5,0,0,34,0,0,14,1,1,3,1037598,2023-10-25T00:00:00.000Z,458,11,Fred VanVleet,1,15,20,19,6,22.7
1,0,4,4,0,9,3,2,1,26,1,6,7,5,1,1,1037598,2023-10-25T00:00:00.000Z,38017684,11,Jabari Smith Jr.,1,12,13,8,6,16.5
0,1,2,1,1,2,2,0,0,15,0,1,5,2,1,0,1037598,2023-10-25T00:00:00.000Z,3547301,11,Jae'Sean Tate,2,7,7,5,2,13.4
0,1,1,1,0,10,2,7,6,30,0,2,10,1,1,4,1037598,2023-10-25T00:00:00.000Z,17895966,11,Jalen Green,2,11,11,10,1,13.2
0,0,0,1,0,3,2,0,0,5,0,0,4,0,0,0,1037598,2023-10-25T00:00:00.000Z,47738533,11,Jeenathan Williams,0,4,4,4,0,4
1,0,0,1,0,4,2,1,0,14,3,2,4,3,0,1,1037598,2023-10-25T00:00:00.000Z,188,11,Jeff Green,0,7,8,5,4,8.1
0,0,0,0,0,0,0,0,0,6,0,1,0,0,0,0,1037598,2023-10-25T00:00:00.000Z,56677809,11,Jermaine Samuels Jr.,0,0,0,0,0,0
2,0,0,2,1,2,1,0,0,9,0,1,3,0,0,1,1037598,2023-10-25T00:00:00.000Z,19465326,11,Jock Landale,0,3,5,5,2,5
0,0,0,0,0,0,0,0,0,0,0,0,0,0,0,0,1037598,2023-10-25T00:00:00.000Z,3547281,11,Nate Hinton,0,0,0,0,0,0
0,1,1,1,1,1,1,0,0,11,0,1,3,1,1,0,1037598,2023-10-25T00:00:00.000Z,75,11,Reggie Bullock,2,4,4,3,1,10.2
0,0,0,0,0,0,0,0,0,0,0,0,0,0,0,0,1037598,2023-10-25T00:00:00.000Z,38017695,11,Tari Eason,0,0,0,0,0,0
0,0,0,0,0,0,0,0,0,0,0,0,0,0,0,0,1037598,2023-10-25T00:00:00.000Z,357,11,Victor Oladipo,0,0,0,0,0,0
0,0,0,0,0,0,0,0,0,0,0,0,0,0,0,0,1037598,2023-10-25T00:00:00.000Z,666885,22,Admiral Schofield,0,0,0,0,0,0
1,2,0,0,0,2,2,1,1,5,0,0,5,0,0,0,1037598,2023-10-25T00:00:00.000Z,56677827,22,Anthony Black,2,5,6,6,1,12.5
0,0,1,2,1,2,1,0,0,5,0,0,3,1,0,0,1037598,2023-10-25T00:00:00.000Z,38017724,22,Caleb Houstan,0,4,4,3,1,4.2
0,0,3,1,0,1,0,0,0,5,0,0,0,3,0,0,1037598,2023-10-25T00:00:00.000Z,666818,22,Chuma Okeke,0,3,3,0,3,3.6
2,0,7,2,1,12,8,3,3,24,1,2,20,8,0,0,1037598,2023-10-25T00:00:00.000Z,3547251,22,Cole Anthony,0,28,30,22,10,32.6
2,0,1,7,3,11,5,4,4,27,2,1,17,3,1,3,1037598,2023-10-25T00:00:00.000Z,17896026,22,Franz Wagner,1,20,22,19,5,23.6
0,1,3,4,1,8,5,0,0,17,3,0,11,6,0,0,1037598,2023-10-25T00:00:00.000Z,196,22,Gary Harris,1,17,17,11,6,21.2
0,0,3,7,2,12,3,0,0,21,1,2,8,4,0,0,1037598,2023-10-25T00:00:00.000Z,17896073,22,Jalen Suggs,0,12,12,8,4,12.8
1,0,0,1,0,1,0,0,0,5,0,0,0,0,1,0,1037598,2023-10-25T00:00:00.000Z,56677839,22,Jett Howard,1,0,1,1,1,4.5
5,0,4,3,0,3,0,0,0,18,0,3,0,4,0,1,1037598,2023-10-25T00:00:00.000Z,226,22,Joe Ingles,0,4,9,5,9,11.3
0,1,3,3,1,6,4,3,2,14,1,2,11,4,0,2,1037598,2023-10-25T00:00:00.000Z,229,22,Jonathan Isaac,1,15,15,11,4,16.8
0,0,0,0,0,0,0,0,0,0,0,0,0,0,0,0,1037598,2023-10-25T00:00:00.000Z,38017607,22,Kevon Harris,0,0,0,0,0,0
2,0,1,0,0,9,5,0,0,24,3,0,10,4,3,1,1037598,2023-10-25T00:00:00.000Z,165,22,Markelle Fultz,3,14,16,12,6,25.8
0,1,3,1,0,1,0,4,4,15,0,4,4,3,0,3,1037598,2023-10-25T00:00:00.000Z,462,22,Moritz Wagner,1,7,7,4,3,7.6
5,0,5,1,0,6,3,7,6,28,0,2,12,5,1,1,1037598,2023-10-25T00:00:00.000Z,38017683,22,Paolo Banchero,1,17,22,17,10,27.5
0,0,0,0,0,0,0,0,0,0,0,0,0,0,0,0,1037598,2023-10-25T00:00:00.000Z,17553983,22,Trevelin Queen,0,0,0,0,0,0
1,0,4,2,0,10,4,0,0,27,4,3,8,8,2,2,1037598,2023-10-25T00:00:00.000Z,85,22,Wendell Carter Jr.,2,16,17,9,9,23.1
0,0,0,0,0,0,0,0,0,0,0,0,0,0,0,0,1037599,2023-10-25T00:00:00.000Z,9051997,3,Armoni Brooks,0,0,0,0,0,0
9,1,9,0,0,6,2,0,0,23,1,2,4,10,0,2,1037599,2023-10-25T00:00:00.000Z,417,3,Ben Simmons,1,14,23,13,19,30.5
2,0,3,5,2,21,13,11,8,25,0,0,36,3,1,1,1037599,2023-10-25T00:00:00.000Z,17896048,3,Cam Thomas,1,39,41,38,5,44.6
3,0,3,4,1,10,5,2,1,26,2,1,12,5,2,2,1037599,2023-10-25T00:00:00.000Z,666679,3,Cameron Johnson,2,17,20,15,8,26.5
0,0,0,0,0,0,0,0,0,0,0,0,0,0,0,0,1037599,2023-10-25T00:00:00.000Z,56677841,3,Dariq Whitehead,0,0,0,0,0,0
0,2,1,0,0,3,2,0,0,12,1,2,4,2,0,3,1037599,2023-10-25T00:00:00.000Z,17896038,3,Day'Ron Sharpe,2,6,6,4,2,9.4
1,0,2,3,2,5,4,0,0,16,2,1,10,4,0,1,1037599,2023-10-25T00:00:00.000Z,421,3,Dennis Smith Jr.,0,14,15,11,5,15.3
2,0,4,6,2,8,4,1,0,28,1,1,10,5,0,3,1037599,2023-10-25T00:00:00.000Z,158,3,Dorian Finney-Smith,0,15,17,12,7,16
0,0,0,0,0,0,0,0,0,0,0,0,0,0,0,0,1037599,2023-10-25T00:00:00.000Z,174,3,Harry Giles III,0,0,0,0,0,0
0,0,0,0,0,0,0,0,0,0,0,0,0,0,0,0,1037599,2023-10-25T00:00:00.000Z,56677722,3,Jalen Wilson,0,0,0,0,0,0
0,0,0,0,0,0,0,0,0,0,0,0,0,0,0,0,1037599,2023-10-25T00:00:00.000Z,464,3,Lonnie Walker IV,0,0,0,0,0,0
4,0,4,2,0,12,6,9,8,35,2,4,20,6,3,3,1037599,2023-10-25T00:00:00.000Z,61,3,Mikal Bridges,3,26,30,24,10,39.2
4,3,3,0,0,10,3,1,1,28,4,1,7,7,0,0,1037599,2023-10-25T00:00:00.000Z,666508,3,Nicolas Claxton,3,14,18,11,11,30.4
0,0,0,0,0,0,0,0,0,0,0,0,0,0,0,0,1037599,2023-10-25T00:00:00.000Z,56677843,3,Noah Clowney,0,0,0,0,0,0
2,0,7,4,1,6,2,0,0,23,0,2,5,7,0,1,1037599,2023-10-25T00:00:00.000Z,351,3,Royce O'Neale,0,12,14,7,9,15.4
3,0,1,3,1,3,1,2,2,24,0,2,5,1,0,1,1037599,2023-10-25T00:00:00.000Z,130,3,Spencer Dinwiddie,0,6,9,8,4,9.7
0,0,0,0,0,0,0,0,0,0,0,0,0,0,0,0,1037599,2023-10-25T00:00:00.000Z,17896058,3,Trendon Watford,0,0,0,0,0,0
5,1,3,8,3,17,4,0,0,31,0,1,11,3,1,0,1037599,2023-10-25T00:00:00.000Z,277,6,Caris LeVert,2,14,19,16,8,28.1
0,0,0,0,0,0,0,0,0,0,0,0,0,0,0,0,1037599,2023-10-25T00:00:00.000Z,56677872,6,Craig Porter,0,0,0,0,0,0
2,0,0,0,0,2,2,0,0,11,0,3,4,0,0,2,1037599,2023-10-25T00:00:00.000Z,248,6,Damian Jones,0,4,6,6,2,5
5,0,1,5,1,12,6,2,2,32,1,2,15,2,2,6,1037599,2023-10-25T00:00:00.000Z,666581,6,Darius Garland,2,17,22,20,7,24.9
0,0,0,0,0,0,0,0,0,0,0,0,0,0,0,0,1037599,2023-10-25T00:00:00.000Z,666940,6,Dean Wade,0,0,0,0,0,0
6,1,3,10,4,21,11,1,1,36,2,1,27,5,4,0,1037599,2023-10-25T00:00:00.000Z,322,6,Donovan Mitchell,5,32,38,33,11,57
0,0,0,0,0,0,0,0,0,0,0,0,0,0,0,0,1037599,2023-10-25T00:00:00.000Z,56677847,6,Emoni Bates,0,0,0,0,0,0
1,2,5,0,0,11,5,0,0,34,1,3,10,6,0,0,1037599,2023-10-25T00:00:00.000Z,17896076,6,Evan Mobley,2,16,17,11,7,24.7
0,0,2,3,0,3,0,0,0,20,2,3,0,4,0,0,1037599,2023-10-25T00:00:00.000Z,344,6,Georges Niang,0,4,4,0,4,4.8
4,1,3,4,2,10,6,5,4,32,3,5,18,6,2,2,1037599,2023-10-25T00:00:00.000Z,3547247,6,Isaac Okoro,3,24,28,22,10,38.2
0,0,0,0,0,0,0,0,0,0,0,0,0,0,0,0,1037599,2023-10-25T00:00:00.000Z,38017662,6,Isaiah Mobley,0,0,0,0,0,0
0,0,0,0,0,0,0,0,0,0,0,0,0,0,0,0,1037599,2023-10-25T00:00:00.000Z,9,6,Jarrett Allen,0,0,0,0,0,0
2,1,12,13,7,17,9,2,2,39,0,4,27,12,1,0,1037599,2023-10-25T00:00:00.000Z,666908,6,Max Strus,2,39,41,29,14,50.4
0,0,0,0,0,0,0,0,0,0,0,0,0,0,0,0,1037599,2023-10-25T00:00:00.000Z,404,6,Ricky Rubio,0,0,0,0,0,0
0,0,0,0,0,0,0,0,0,0,0,0,0,0,0,0,1037599,2023-10-25T00:00:00.000Z,3547299,6,Sam Merrill,0,0,0,0,0,0
0,0,0,0,0,0,0,0,0,0,0,0,0,0,0,0,1037599,2023-10-25T00:00:00.000Z,444,6,Tristan Thompson,0,0,0,0,0,0
0,0,0,0,0,1,1,0,0,5,0,1,2,0,0,0,1037599,2023-10-25T00:00:00.000Z,666676,6,Ty Jerome,0,2,2,2,0,2
0,1,5,5,2,8,2,2,1,25,0,1,7,5,0,0,1037600,2023-10-25T00:00:00.000Z,77,9,Alec Burks,1,12,12,7,5,16
3,5,4,2,1,7,1,2,1,27,3,2,4,7,0,2,1037600,2023-10-25T00:00:00.000Z,56677826,9,Ausar Thompson,5,11,14,7,10,29.9
0,0,0,0,0,0,0,0,0,0,0,0,0,0,0,0,1037600,2023-10-25T00:00:00.000Z,54,9,Bojan Bogdanovic,0,0,0,0,0,0
9,1,3,9,4,27,13,0,0,36,0,5,30,3,1,3,1037600,2023-10-25T00:00:00.000Z,17896075,9,Cade Cunningham,2,33,42,39,12,50.1
0,0,0,0,0,0,0,0,0,0,0,0,0,0,0,0,1037600,2023-10-25T00:00:00.000Z,17896071,9,Isaiah Livers,0,0,0,0,0,0
2,0,8,3,2,11,6,0,0,35,6,3,14,14,0,1,1037600,2023-10-25T00:00:00.000Z,3547267,9,Isaiah Stewart,0,28,30,16,16,32.8
3,0,2,2,0,7,1,3,2,17,0,3,4,2,0,3,1037600,2023-10-25T00:00:00.000Z,38017682,9,Jaden Ivey,0,6,9,7,5,7.9
4,4,8,0,0,11,8,3,1,32,6,4,17,14,0,4,1037600,2023-10-25T00:00:00.000Z,38017694,9,Jalen Duren,4,31,35,21,18,47.8
0,0,0,0,0,0,0,0,0,0,0,0,0,0,0,0,1037600,2023-10-25T00:00:00.000Z,3547240,9,James Wiseman,0,0,0,0,0,0
0,0,0,0,0,0,0,0,0,0,0,0,0,0,0,0,1037600,2023-10-25T00:00:00.000Z,42097199,9,Jared Rhoden,0,0,0,0,0,0
0,0,0,2,0,2,0,0,0,12,0,2,0,0,0,0,1037600,2023-10-25T00:00:00.000Z,197,9,Joe Harris,0,0,0,0,0,0
3,1,1,6,0,12,4,3,2,30,0,2,10,1,2,1,1037600,2023-10-25T00:00:00.000Z,3547241,9,Killian Hayes,3,11,14,13,4,23.7
0,0,0,0,0,0,0,0,0,0,0,0,0,0,0,0,1037600,2023-10-25T00:00:00.000Z,56677729,9,Malcolm Cazalon,0,0,0,0,0,0
1,0,2,3,2,4,3,0,0,10,0,0,8,2,0,1,1037600,2023-10-25T00:00:00.000Z,56677792,9,Marcus Sasser,0,10,11,9,3,10.9
3,1,6,0,0,3,3,2,2,16,2,1,8,8,0,1,1037600,2023-10-25T00:00:00.000Z,24,9,Marvin Bagley III,1,16,19,11,11,24.1
0,0,0,0,0,0,0,0,0,0,0,0,0,0,0,0,1037600,2023-10-25T00:00:00.000Z,330,9,Monte Morris,0,0,0,0,0,0
0,0,0,0,0,0,0,0,0,0,0,0,0,0,0,0,1037600,2023-10-25T00:00:00.000Z,44477024,9,Stanley Umude,0,0,0,0,0,0
3,2,6,0,0,13,7,10,8,32,2,3,22,8,0,2,1037600,2023-10-25T00:00:00.000Z,4,16,Bam Adebayo,2,30,33,25,11,40.1
1,0,2,3,0,7,1,0,0,20,1,1,2,3,1,0,1037600,2023-10-25T00:00:00.000Z,666747,16,Caleb Martin,1,5,6,3,4,10.1
0,0,0,0,0,0,0,0,0,0,0,0,0,0,0,0,1037600,2023-10-25T00:00:00.000Z,38017736,16,Cole Swider,0,0,0,0,0,0
1,0,0,1,0,2,1,0,0,9,0,1,2,0,0,0,1037600,2023-10-25T00:00:00.000Z,19465585,16,Dru Smith,0,2,3,3,1,3.5
0,0,0,0,0,0,0,0,0,0,0,0,0,0,0,0,1037600,2023-10-25T00:00:00.000Z,3092,16,Haywood Highsmith,0,0,0,0,0,0
2,0,2,0,0,3,3,0,0,13,0,2,6,2,2,1,1037600,2023-10-25T00:00:00.000Z,56677785,16,Jaime Jaquez Jr.,2,8,10,8,4,16.4
0,0,0,0,0,0,0,0,0,0,0,0,0,0,0,0,1037600,2023-10-25T00:00:00.000Z,38017734,16,Jamal Cain,0,0,0,0,0,0
4,0,5,0,0,18,6,9,7,34,8,0,19,13,2,0,1037600,2023-10-25T00:00:00.000Z,79,16,Jimmy Butler,2,32,36,23,17,46.6
0,0,0,0,0,0,0,0,0,0,0,0,0,0,0,0,1037600,2023-10-25T00:00:00.000Z,391,16,Josh Richardson,0,0,0,0,0,0
2,0,8,6,3,9,4,2,2,28,2,5,13,10,0,1,1037600,2023-10-25T00:00:00.000Z,285,16,Kevin Love,0,23,25,15,12,27
2,1,2,0,0,1,0,0,0,32,0,4,0,2,2,0,1037600,2023-10-25T00:00:00.000Z,286,16,Kyle Lowry,3,2,4,2,4,14.4
0,0,0,0,0,0,0,0,0,0,0,0,0,0,0,0,1037600,2023-10-25T00:00:00.000Z,38017696,16,Nikola Jovic,0,0,0,0,0,0
0,0,0,0,0,0,0,0,0,0,0,0,0,0,0,0,1037600,2023-10-25T00:00:00.000Z,39398582,16,Orlando Robinson,0,0,0,0,0,0
0,0,0,0,0,0,0,0,0,0,0,0,0,0,0,0,1037600,2023-10-25T00:00:00.000Z,3547257,16,R.J. Hampton,0,0,0,0,0,0
3,0,4,0,0,5,2,5,4,16,2,0,8,6,1,1,1037600,2023-10-25T00:00:00.000Z,74,16,Thomas Bryant,1,14,17,11,9,21.7
3,0,2,7,2,24,7,0,0,34,0,1,16,2,3,2,1037600,2023-10-25T00:00:00.000Z,666633,16,Tyler Herro,3,18,21,19,5,29.9
1,0,9,7,4,27,8,6,6,38,5,1,26,14,0,2,1037601,2023-10-25T00:00:00.000Z,3547238,18,Anthony Edwards,0,40,41,27,15,42.3
0,0,0,0,0,0,0,0,0,0,0,0,0,0,0,0,1037601,2023-10-25T00:00:00.000Z,17895968,18,Daishen Nix,0,0,0,0,0,0
0,0,0,0,0,0,0,0,0,0,0,0,0,0,0,0,1037601,2023-10-25T00:00:00.000Z,3547259,18,Jaden McDaniels,0,0,0,0,0,0
0,0,0,0,0,0,0,0,0,0,0,0,0,0,0,0,1037601,2023-10-25T00:00:00.000Z,56677851,18,Jaylen Clark,0,0,0,0,0,0
0,0,0,0,0,0,0,0,0,0,0,0,0,0,0,0,1037601,2023-10-25T00:00:00.000Z,666767,18,Jordan McLaughlin,0,0,0,0,0,0
0,0,0,0,0,0,0,0,0,0,0,0,0,0,0,0,1037601,2023-10-25T00:00:00.000Z,38017715,18,Josh Minott,0,0,0,0,0,0
5,0,7,1,0,9,3,2,1,30,2,0,7,9,1,1,1037601,2023-10-25T00:00:00.000Z,12,18,Kyle Anderson,1,16,21,12,14,27.3
0,0,0,0,0,0,0,0,0,0,0,0,0,0,0,0,1037601,2023-10-25T00:00:00.000Z,56677782,18,Leonard Miller,0,0,0,0,0,0
0,0,0,0,0,0,0,0,0,0,0,0,0,0,0,0,1037601,2023-10-25T00:00:00.000Z,17896056,18,Luka Garza,0,0,0,0,0,0
3,1,3,4,1,9,4,2,2,31,1,1,11,4,1,1,1037601,2023-10-25T00:00:00.000Z,104,18,Mike Conley,2,15,18,14,7,25.3
1,0,3,2,0,8,3,4,4,24,1,0,10,4,0,1,1037601,2023-10-25T00:00:00.000Z,667378,18,Naz Reid,0,14,15,11,5,15.3
4,0,3,4,1,5,1,2,1,21,0,4,4,3,3,2,1037601,2023-10-25T00:00:00.000Z,320,18,Shake Milton,3,7,11,8,7,20.6
0,0,1,0,0,0,0,0,0,5,0,0,0,1,0,0,1037601,2023-10-25T00:00:00.000Z,68,18,Troy Brown Jr.,0,1,1,0,1,1.2
0,0,0,0,0,0,0,0,0,0,0,0,0,0,0,0,1037601,2023-10-25T00:00:00.000Z,38017700,18,Wendell Moore Jr.,0,0,0,0,0,0
0,0,0,0,0,0,0,0,0,0,0,0,0,0,0,0,1037601,2023-10-25T00:00:00.000Z,58,28,Chris Boucher,0,0,0,0,0,0
0,0,0,0,0,0,0,0,0,0,0,0,0,0,0,0,1037601,2023-10-25T00:00:00.000Z,38017710,28,Christian Koloko,0,0,0,0,0,0
7,0,2,8,4,17,8,2,2,32,1,1,22,3,0,2,1037601,2023-10-25T00:00:00.000Z,409,28,Dennis Schroder,0,25,32,29,10,34.1
0,0,0,0,0,0,0,0,0,0,0,0,0,0,0,0,1037601,2023-10-25T00:00:00.000Z,436,28,Garrett Temple,0,0,0,0,0,0
1,0,0,0,0,1,0,0,0,2,0,1,0,0,0,0,1037601,2023-10-25T00:00:00.000Z,56677828,28,Gradey Dick,0,0,1,1,1,1.5
1,1,8,0,0,3,3,4,1,24,3,1,7,11,1,0,1037601,2023-10-25T00:00:00.000Z,373,28,Jakob Poeltl,2,18,19,8,12,27.7
2,1,2,3,0,3,0,0,0,16,0,2,0,2,1,0,1037601,2023-10-25T00:00:00.000Z,666762,28,Jalen McDaniels,2,2,4,2,4,11.4
0,0,0,0,0,0,0,0,0,0,0,0,0,0,0,0,1037601,2023-10-25T00:00:00.000Z,56677805,28,Javon Freeman-Liberty,0,0,0,0,0,0
2,0,0,1,1,3,1,0,0,10,0,4,3,0,1,2,1037601,2023-10-25T00:00:00.000Z,3547275,28,Malachi Flynn,1,3,5,5,2,7
0,0,0,0,0,0,0,0,0,0,0,0,0,0,0,0,1037601,2023-10-25T00:00:00.000Z,56677869,28,Markquis Nowell,0,0,0,0,0,0
1,3,6,9,4,13,7,2,2,34,0,2,20,6,2,2,1037601,2023-10-25T00:00:00.000Z,18,28,OG Anunoby,5,26,27,21,7,41.7
0,0,0,0,0,0,0,0,0,0,0,0,0,0,0,0,1037601,2023-10-25T00:00:00.000Z,376,28,Otto Porter Jr.,0,0,0,0,0,0
6,0,7,5,3,17,5,2,2,34,0,2,15,7,1,2,1037601,2023-10-25T00:00:00.000Z,416,28,Pascal Siakam,1,22,28,21,13,33.4
0,0,6,1,0,9,4,0,0,24,3,1,8,9,0,2,1037601,2023-10-25T00:00:00.000Z,3547249,28,Precious Achiuwa,0,17,17,8,9,16.8
0,0,0,0,0,0,0,0,0,0,0,0,0,0,0,0,1037601,2023-10-25T00:00:00.000Z,38017717,28,Ron Harper Jr.,0,0,0,0,0,0
5,5,7,4,1,16,6,6,4,37,1,1,17,8,2,4,1037601,2023-10-25T00:00:00.000Z,17896055,28,Scottie Barnes,7,25,30,22,13,51.1
0,0,0,0,0,0,0,0,0,0,0,0,0,0,0,0,1037601,2023-10-25T00:00:00.000Z,489,28,Thaddeus Young,0,0,0,0,0,0
0,0,0,0,0,0,0,0,0,0,0,0,0,0,0,0,1037602,2023-10-25T00:00:00.000Z,56677860,5,Adama Sanogo,0,0,0,0,0,0
3,0,2,4,1,5,2,2,1,19,0,1,6,2,2,1,1037602,2023-10-25T00:00:00.000Z,89,5,Alex Caruso,2,8,11,9,5,17.9
1,0,2,0,0,4,3,0,0,16,3,1,6,5,1,1,1037602,2023-10-25T00:00:00.000Z,137,5,Andre Drummond,1,11,12,7,6,15.5
4,0,3,7,2,14,4,6,5,30,1,3,15,4,0,0,1037602,2023-10-25T00:00:00.000Z,666956,5,Coby White,0,19,23,19,8,25.8
1,0,2,1,0,2,0,0,0,4,0,0,0,2,0,0,1037602,2023-10-25T00:00:00.000Z,38017719,5,Dalen Terry,0,2,3,1,3,3.9
2,1,3,3,1,20,9,3,1,33,2,1,20,5,1,0,1037602,2023-10-25T00:00:00.000Z,125,5,DeMar DeRozan,2,25,27,22,7,35
2,0,1,4,1,4,1,0,0,16,0,0,3,1,0,0,1037602,2023-10-25T00:00:00.000Z,87,5,Jevon Carter,0,4,6,5,3,7.2
0,0,0,0,0,0,0,0,0,0,0,0,0,0,0,0,1037602,2023-10-25T00:00:00.000Z,45969255,5,Justin Lewis,0,0,0,0,0,0
0,0,0,0,0,0,0,0,0,0,0,0,0,0,0,0,1037602,2023-10-25T00:00:00.000Z,27,5,Lonzo Ball,0,0,0,0,0,0
4,2,8,2,0,8,5,1,1,32,1,2,11,9,3,4,1037602,2023-10-25T00:00:00.000Z,460,5,Nikola Vucevic,5,20,24,15,13,38.8
0,0,0,0,0,0,0,0,0,0,0,0,0,0,0,0,1037602,2023-10-25T00:00:00.000Z,56677874,5,Onuralp Bitim,0,0,0,0,0,0
4,0,1,4,0,10,4,0,0,30,2,3,8,3,2,0,1037602,2023-10-25T00:00:00.000Z,3547248,5,Patrick Williams,2,11,15,12,7,23.6
1,0,3,4,3,6,4,0,0,22,4,2,11,7,0,1,1037602,2023-10-25T00:00:00.000Z,110,5,Torrey Craig,0,18,19,12,8,19.9
3,0,4,9,2,16,4,6,6,25,0,3,16,4,0,4,1037602,2023-10-25T00:00:00.000Z,268,5,Zach LaVine,0,20,23,19,7,21.3
0,0,2,1,0,1,0,0,0,2,0,0,0,2,0,0,1037602,2023-10-25T00:00:00.000Z,3547271,21,Aleksej Pokusevski,0,2,2,0,2,2.4
1,1,2,3,3,5,5,0,0,19,0,3,13,2,0,1,1037602,2023-10-25T00:00:00.000Z,56677833,21,Cason Wallace,1,15,16,14,3,18.9
3,0,4,3,2,7,4,3,1,25,0,3,11,4,1,1,1037602,2023-10-25T00:00:00.000Z,38017685,21,Chet Holmgren,1,15,18,14,7,22.3
0,0,0,0,0,0,0,0,0,0,0,0,0,0,0,0,1037602,2023-10-25T00:00:00.000Z,44,21,Davis Bertans,0,0,0,0,0,0
5,0,3,6,2,11,5,4,4,32,0,3,16,3,1,2,1037602,2023-10-25T00:00:00.000Z,38017703,21,Jalen Williams,1,19,24,21,8,28.1
0,0,0,0,0,0,0,0,0,0,0,0,0,0,0,0,1037602,2023-10-25T00:00:00.000Z,38017706,21,Jaylin Williams,0,0,0,0,0,0
6,0,5,3,2,14,7,0,0,32,1,1,16,6,0,3,1037602,2023-10-25T00:00:00.000Z,17896065,21,Josh Giddey,0,22,28,22,12,29.2
0,0,0,0,0,0,0,0,0,0,0,0,0,0,0,0,1037602,2023-10-25T00:00:00.000Z,480,21,Kenrich Williams,0,0,0,0,0,0
0,0,0,0,0,0,0,0,0,0,0,0,0,0,0,0,1037602,2023-10-25T00:00:00.000Z,56677853,21,Keyontae Johnson,0,0,0,0,0,0
0,0,0,1,0,1,0,0,0,3,0,0,0,0,0,0,1037602,2023-10-25T00:00:00.000Z,27924547,21,Lindy Waters III,0,0,0,0,0,0
2,1,7,5,2,8,3,0,0,32,0,1,8,7,2,2,1037602,2023-10-25T00:00:00.000Z,666541,21,Luguentz Dort,3,15,17,10,9,26.4
1,0,0,0,0,0,0,0,0,2,0,0,0,0,0,0,1037602,2023-10-25T00:00:00.000Z,17896036,21,Tre Mann,0,0,1,1,1,1.5
0,0,0,0,0,0,0,0,0,0,0,0,0,0,0,0,1037602,2023-10-25T00:00:00.000Z,4197029,21,Vasilije Micic,0,0,0,0,0,0
0,0,0,0,0,0,0,0,0,0,0,0,0,0,0,0,1037603,2023-10-25T00:00:00.000Z,666505,15,Brandon Clarke,0,0,0,0,0,0
2,0,4,3,1,7,4,0,0,28,1,2,9,5,0,1,1037603,2023-10-25T00:00:00.000Z,38017729,15,David Roddy,0,14,16,11,7,17
3,0,1,4,2,11,3,0,0,16,1,0,8,2,0,0,1037603,2023-10-25T00:00:00.000Z,401,15,Derrick Rose,0,10,13,11,5,14.9
5,1,5,10,5,22,11,5,4,36,0,1,31,5,2,2,1037603,2023-10-25T00:00:00.000Z,3547287,15,Desmond Bane,3,36,41,36,10,51.5
0,0,0,0,0,0,0,0,0,0,0,0,0,0,0,0,1037603,2023-10-25T00:00:00.000Z,56677830,15,GG Jackson,0,0,0,0,0,0
0,0,0,0,0,0,0,0,0,0,0,0,0,0,0,0,1037603,2023-10-25T00:00:00.000Z,666786,15,Ja Morant,0,0,0,0,0,0
0,0,0,0,0,0,0,0,0,0,0,0,0,0,0,0,1037603,2023-10-25T00:00:00.000Z,48248287,15,Jacob Gilyard,0,0,0,0,0,0
1,0,2,2,0,3,1,0,0,14,0,4,2,2,1,0,1037603,2023-10-25T00:00:00.000Z,38017728,15,Jake LaRavia,1,4,5,3,3,8.9
3,5,4,5,0,9,2,4,4,36,1,5,8,5,0,3,1037603,2023-10-25T00:00:00.000Z,231,15,Jaren Jackson Jr.,5,13,16,11,8,30.5
0,0,0,0,0,0,0,0,0,0,0,0,0,0,0,0,1037603,2023-10-25T00:00:00.000Z,666703,15,John Konchar,0,0,0,0,0,0
0,0,0,0,0,0,0,0,0,0,0,0,0,0,0,0,1037603,2023-10-25T00:00:00.000Z,38017732,15,Kenneth Lofton Jr.,0,0,0,0,0,0
2,0,1,5,0,5,0,3,3,15,1,0,3,2,0,1,1037603,2023-10-25T00:00:00.000Z,254,15,Luke Kennard,0,5,7,5,4,7.4
3,0,0,6,2,11,6,6,3,32,0,3,17,0,2,5,1037603,2023-10-25T00:00:00.000Z,420,15,Marcus Smart,2,17,20,20,3,22.5
0,0,0,0,0,0,0,0,0,0,0,0,0,0,0,0,1037603,2023-10-25T00:00:00.000Z,17896067,15,Santi Aldama,0,0,0,0,0,0
0,0,0,0,0,0,0,0,0,0,0,0,0,0,0,0,1037603,2023-10-25T00:00:00.000Z,3,15,Steven Adams,0,0,0,0,0,0
0,0,0,0,0,0,0,0,0,0,0,0,0,0,0,0,1037603,2023-10-25T00:00:00.000Z,38017731,15,Vince Williams Jr.,0,0,0,0,0,0
4,1,8,5,1,16,7,2,2,34,4,2,17,12,3,0,1037603,2023-10-25T00:00:00.000Z,3547285,15,Xavier Tillman,4,29,33,21,16,49.4
0,0,4,3,1,7,4,0,0,29,0,2,9,4,0,1,1037603,2023-10-25T00:00:00.000Z,17896027,15,Ziaire Williams,0,13,13,9,4,12.8
6,0,7,3,0,18,7,6,5,36,0,3,19,7,2,5,1037603,2023-10-25T00:00:00.000Z,227,19,Brandon Ingram,2,26,32,25,13,37.4
0,0,0,0,0,0,0,0,0,0,0,0,0,0,0,0,1037603,2023-10-25T00:00:00.000Z,491,19,Cody Zeller,0,0,0,0,0,0
0,0,0,0,0,0,0,0,0,0,0,0,0,0,0,0,1037603,2023-10-25T00:00:00.000Z,38017663,19,E.J. Liddell,0,0,0,0,0,0
1,1,12,4,2,7,4,2,2,29,0,1,12,12,0,3,1037603,2023-10-25T00:00:00.000Z,455,19,Jonas Valanciunas,1,24,25,13,13,27.9
2,0,0,2,1,2,1,0,0,9,0,2,3,0,0,0,1037603,2023-10-25T00:00:00.000Z,56677837,19,Jordan Hawkins,0,3,5,5,2,6
0,0,0,0,0,0,0,0,0,0,0,0,0,0,0,0,1037603,2023-10-25T00:00:00.000Z,17896097,19,Jose Alvarado,0,0,0,0,0,0
0,0,0,0,0,0,0,0,0,0,0,0,0,0,0,0,1037603,2023-10-25T00:00:00.000Z,666584,19,Kaiser Gates,0,0,0,0,0,0
0,1,0,2,0,3,0,0,0,11,0,1,0,0,0,1,1037603,2023-10-25T00:00:00.000Z,3547260,19,Kira Lewis Jr.,1,0,0,0,0,2
0,0,7,0,0,2,1,0,0,15,1,1,2,8,1,2,1037603,2023-10-25T00:00:00.000Z,340,19,Larry Nance Jr.,1,10,10,2,8,12.6
1,0,1,6,3,6,3,0,0,14,0,2,9,1,0,0,1037603,2023-10-25T00:00:00.000Z,17896017,19,Matt Ryan,0,10,11,10,2,11.7
0,0,0,0,0,0,0,0,0,0,0,0,0,0,0,0,1037603,2023-10-25T00:00:00.000Z,3547293,19,Naji Marshall,0,0,0,0,0,0
3,0,3,0,0,17,9,7,5,32,4,1,23,7,0,3,1037603,2023-10-25T00:00:00.000Z,666969,19,Zion Williamson,0,30,33,26,10,32.9
6,1,3,7,1,18,6,6,5,33,2,4,18,5,1,3,1037604,2023-10-25T00:00:00.000Z,161,26,De'Aaron Fox,2,23,29,24,11,36
5,2,6,2,1,14,8,7,5,32,6,3,22,12,1,3,1037604,2023-10-25T00:00:00.000Z,406,26,Domantas Sabonis,3,34,39,27,17,49.9
1,2,6,9,4,13,5,1,1,30,2,4,15,8,1,0,1037604,2023-10-25T00:00:00.000Z,38017688,26,Keegan Murray,3,23,24,16,9,35.1
2,0,3,5,1,9,3,0,0,24,2,3,7,5,0,1,1037604,2023-10-25T00:00:00.000Z,221,26,Kevin Huerter,0,12,14,9,7,15
0,0,0,0,0,2,0,0,0,2,1,0,0,1,0,0,1037604,2023-10-25T00:00:00.000Z,56677842,29,Brice Sensabaugh,0,1,1,0,1,1.2
0,0,3,2,0,9,2,7,5,20,0,3,9,3,0,3,1037604,2023-10-25T00:00:00.000Z,413,29,Collin Sexton,0,12,12,9,3,9.6
2,0,8,3,1,11,6,2,2,31,3,3,15,11,1,0,1037604,2023-10-25T00:00:00.000Z,101,29,John Collins,1,26,28,17,13,34.2
6,0,2,5,2,16,8,8,6,31,2,4,24,4,0,2,1037604,2023-10-25T00:00:00.000Z,100,29,Jordan Clarkson,0,28,34,30,10,35.8
0,0,0,0,0,0,0,0,0,0,0,0,0,0,0,0,1037604,2023-10-25T00:00:00.000Z,17896023,29,Josh Christopher,0,0,0,0,0,0
4,0,3,0,0,3,2,1,1,17,3,3,5,6,1,1,1037604,2023-10-25T00:00:00.000Z,358,29,Kelly Olynyk,1,11,15,9,10,20.2
2,0,2,3,1,5,3,1,1,19,0,0,8,2,0,1,1037604,2023-10-25T00:00:00.000Z,56677834,29,Keyonte George,0,10,12,10,4,12.4
2,0,1,1,0,6,3,4,2,16,0,0,8,1,2,4,1037604,2023-10-25T00:00:00.000Z,139,29,Kris Dunn,2,9,11,10,3,14.2
1,0,8,6,2,15,6,6,5,32,2,1,19,10,2,1,1037604,2023-10-25T00:00:00.000Z,297,29,Lauri Markkanen,2,29,30,20,11,37.5
0,0,3,2,1,6,2,0,0,20,0,2,5,3,0,0,1037604,2023-10-25T00:00:00.000Z,38017620,29,Ochai Agbaji,0,8,8,5,3,8.6
1,0,0,1,0,2,1,0,0,2,1,0,2,1,0,0,1037604,2023-10-25T00:00:00.000Z,38017739,29,Simone Fontecchio,0,3,4,3,2,4.7
4,1,1,4,2,9,3,0,0,22,0,1,8,1,0,1,1037604,2023-10-25T00:00:00.000Z,666650,29,Talen Horton-Tucker,1,9,13,12,5,17.2
0,0,1,0,0,0,0,2,1,2,0,0,1,1,0,0,1037604,2023-10-25T00:00:00.000Z,56677824,29,Taylor Hendricks,0,2,2,1,1,2.2
0,1,4,0,0,5,4,0,0,22,4,3,8,8,0,1,1037604,2023-10-25T00:00:00.000Z,38017705,29,Walker Kessler,1,16,16,8,8,19.6
0,0,0,0,0,0,0,0,0,0,0,0,0,0,0,0,1037605,2023-10-25T00:00:00.000Z,17554004,7,AJ Lawson,0,0,0,0,0,0
0,0,1,1,0,2,1,1,1,8,0,1,3,1,0,0,1037605,2023-10-25T00:00:00.000Z,151,7,Dante Exum,0,4,4,3,1,4.2
1,1,5,0,0,8,7,3,2,31,5,4,16,10,1,1,1037605,2023-10-25T00:00:00.000Z,56677840,7,Dereck Lively II,2,26,27,17,11,34.5
0,1,5,8,4,11,6,1,1,35,1,4,17,6,0,3,1037605,2023-10-25T00:00:00.000Z,666965,7,Grant Williams,1,23,23,17,6,24.2
0,0,0,0,0,0,0,0,0,0,0,0,0,0,0,0,1037605,2023-10-25T00:00:00.000Z,38017679,7,Jaden Hardy,0,0,0,0,0,0
1,0,0,2,2,5,3,4,3,30,2,4,11,2,1,0,1037605,2023-10-25T00:00:00.000Z,3547258,7,Josh Green,1,13,14,12,3,17.9
6,0,2,8,1,24,10,1,1,36,0,3,22,2,1,2,1037605,2023-10-25T00:00:00.000Z,228,7,Kyrie Irving,1,24,30,28,8,34.4
0,0,0,0,0,0,0,0,0,0,0,0,0,0,0,0,1037605,2023-10-25T00:00:00.000Z,329,7,Markieff Morris,0,0,0,0,0,0
2,1,5,5,2,7,2,0,0,23,2,3,6,7,0,0,1037605,2023-10-25T00:00:00.000Z,257,7,Maxi Kleber,1,13,15,8,9,20.4
0,0,0,0,0,0,0,0,0,0,0,0,0,0,0,0,1037605,2023-10-25T00:00:00.000Z,217,7,Richaun Holmes,0,0,0,0,0,0
0,0,0,0,0,0,0,0,0,4,0,0,0,0,0,0,1037605,2023-10-25T00:00:00.000Z,114,7,Seth Curry,0,0,0,0,0,0
4,0,4,10,3,14,5,4,4,28,2,0,17,6,1,1,1037605,2023-10-25T00:00:00.000Z,191,7,Tim Hardaway Jr.,1,23,27,21,10,32.2
0,0,0,0,0,0,0,0,0,0,0,0,0,0,0,0,1037605,2023-10-25T00:00:00.000Z,38017693,27,Blake Wesley,0,0,0,0,0,0
0,0,0,0,0,0,0,0,0,0,0,0,0,0,0,0,1037605,2023-10-25T00:00:00.000Z,56677865,27,Charles Bediako,0,0,0,0,0,0
0,0,0,0,0,0,0,0,0,0,0,0,0,0,0,0,1037605,2023-10-25T00:00:00.000Z,180,27,Devonte' Graham,0,0,0,0,0,0
0,0,0,0,0,0,0,0,0,0,0,0,0,0,0,0,1037605,2023-10-25T00:00:00.000Z,38017730,27,Dominick Barlow,0,0,0,0,0,0
1,1,1,1,0,1,0,0,0,11,0,1,0,1,0,0,1037605,2023-10-25T00:00:00.000Z,305,27,Doug McDermott,1,1,2,1,2,5.7
0,0,0,0,0,0,0,0,0,0,0,0,0,0,0,0,1037605,2023-10-25T00:00:00.000Z,38017649,27,Julian Champagnie,0,0,0,0,0,0
2,0,2,3,0,7,3,1,1,18,0,1,7,2,1,1,1037605,2023-10-25T00:00:00.000Z,38017692,27,Malaki Branham,1,9,11,9,4,14.4
0,0,0,0,0,0,0,0,0,0,0,0,0,0,0,0,1037605,2023-10-25T00:00:00.000Z,17896059,27,Sandro Mamukelashvili,0,0,0,0,0,0
6,0,4,3,2,7,5,4,4,25,1,0,16,5,0,1,1037605,2023-10-25T00:00:00.000Z,3547274,27,Tre Jones,0,21,27,22,11,30
1,0,0,0,0,1,0,2,2,4,0,0,2,0,0,0,1037606,2023-10-25T00:00:00.000Z,666511,13,Amir Coffey,0,2,3,3,1,3.5
0,0,0,0,0,0,0,0,0,0,0,0,0,0,0,0,1037606,2023-10-25T00:00:00.000Z,17896022,13,Brandon Boston Jr.,0,0,0,0,0,0
0,4,7,0,0,10,8,5,4,26,5,3,20,12,0,2,1037606,2023-10-25T00:00:00.000Z,493,13,Ivica Zubac,4,32,32,20,12,44.4
0,0,0,0,0,0,0,0,0,0,0,0,0,0,0,0,1037606,2023-10-25T00:00:00.000Z,17896051,13,Joshua Primo,0,0,0,0,0,0
6,1,4,5,5,17,9,0,0,29,1,2,23,5,1,4,1037606,2023-10-25T00:00:00.000Z,274,13,Kawhi Leonard,2,28,34,29,11,40
1,0,0,2,0,4,0,0,0,13,1,2,0,1,1,0,1037606,2023-10-25T00:00:00.000Z,3547294,13,Kenyon Martin Jr.,1,1,2,1,2,5.7
0,0,0,1,0,2,0,0,0,5,0,1,0,0,0,0,1037606,2023-10-25T00:00:00.000Z,56677849,13,Kobe Brown,0,0,0,0,0,0
0,0,0,0,0,0,0,0,0,0,0,0,0,0,0,0,1037606,2023-10-25T00:00:00.000Z,328,13,Marcus Morris,0,0,0,0,0,0
2,0,5,0,0,4,2,4,2,17,3,0,6,8,0,0,1037606,2023-10-25T00:00:00.000Z,371,13,Mason Plumlee,0,14,16,8,10,18.6
3,0,0,8,3,11,6,2,2,22,0,4,17,0,0,2,1037606,2023-10-25T00:00:00.000Z,17896031,13,Nah'Shon Hyland,0,17,20,20,3,19.5
1,1,3,0,0,0,0,0,0,9,0,0,0,3,1,0,1037606,2023-10-25T00:00:00.000Z,33,13,Nicolas Batum,2,3,4,1,4,11.1
1,0,3,5,2,6,2,2,2,23,0,0,8,3,0,2,1037606,2023-10-25T00:00:00.000Z,380,13,Norman Powell,0,11,12,9,4,11.1
6,0,3,7,4,17,11,1,1,32,0,2,27,3,3,4,1037606,2023-10-25T00:00:00.000Z,172,13,Paul George,3,30,36,33,9,44.6
2,1,3,4,1,5,2,0,0,23,1,2,5,4,3,0,1037606,2023-10-25T00:00:00.000Z,108,13,Robert Covington,4,9,11,7,6,24.8
13,0,3,2,1,8,5,0,0,29,2,3,11,5,0,3,1037606,2023-10-25T00:00:00.000Z,472,13,Russell Westbrook,0,16,29,24,18,33.5
0,0,0,0,0,0,0,0,0,0,0,0,0,0,0,0,1037606,2023-10-25T00:00:00.000Z,666743,13,Terance Mann,0,0,0,0,0,0
0,0,0,0,0,0,0,0,0,0,0,0,0,0,0,0,1037606,2023-10-25T00:00:00.000Z,56783340,25,Duop Reath,0,0,0,0,0,0
0,0,0,0,0,0,0,0,0,0,0,0,0,0,0,0,1037606,2023-10-25T00:00:00.000Z,17896120,25,Ish Wainright,0,0,0,0,0,0
0,0,0,0,0,3,2,3,2,6,1,0,6,1,0,2,1037606,2023-10-25T00:00:00.000Z,38017711,25,Jabari Walker,0,7,7,6,1,5.2
1,1,1,4,0,12,5,4,3,30,2,1,13,3,0,3,1037606,2023-10-25T00:00:00.000Z,182,25,Jerami Grant,1,16,17,14,4,18.1
0,0,0,0,0,0,0,0,0,0,0,0,0,0,0,0,1037606,2023-10-25T00:00:00.000Z,47957121,25,Justin Minaya,0,0,0,0,0,0
0,0,1,0,0,0,0,0,0,5,0,0,0,1,0,0,1037606,2023-10-25T00:00:00.000Z,56677791,25,Kris Murray,0,1,1,0,1,1.2
1,0,0,6,2,7,3,0,0,20,1,0,8,1,1,2,1037606,2023-10-25T00:00:00.000Z,666923,25,Matisse Thybulle,1,9,10,9,2,11.7
0,0,0,0,0,0,0,0,0,2,0,0,0,0,0,0,1037606,2023-10-25T00:00:00.000Z,56677829,25,Rayan Rupert,0,0,0,0,0,0
0,0,0,0,0,0,0,0,0,0,0,0,0,0,0,0,1037606,2023-10-25T00:00:00.000Z,3547289,25,Skylar Mays,0,0,0,0,0,0
0,0,0,0,0,0,0,0,0,0,0,0,0,0,0,0,1037607,2023-10-26T00:00:00.000Z,38017733,17,A.J. Green,0,0,0,0,0,0
0,0,0,0,0,0,0,0,0,0,0,0,0,0,0,0,1037607,2023-10-26T00:00:00.000Z,56677852,17,Andre Jackson Jr.,0,0,0,0,0,0
2,1,4,0,0,8,5,4,0,19,2,3,10,6,0,0,1037607,2023-10-26T00:00:00.000Z,377,17,Bobby Portis,1,16,18,12,8,23.2
0,0,1,4,3,7,5,0,0,29,1,4,13,2,0,2,1037607,2023-10-26T00:00:00.000Z,283,17,Brook Lopez,0,15,15,13,2,13.4
0,0,0,1,0,3,1,0,0,9,0,3,2,0,1,0,1037607,2023-10-26T00:00:00.000Z,368,17,Cameron Payne,1,2,2,2,0,5
0,0,0,0,0,0,0,0,0,0,0,0,0,0,0,0,1037607,2023-10-26T00:00:00.000Z,56677854,17,Chris Livingston,0,0,0,0,0,0
4,0,8,12,4,20,9,17,17,37,0,2,39,8,0,0,1037607,2023-10-26T00:00:00.000Z,278,17,Damian Lillard,0,47,51,43,12,54.6
3,2,8,3,0,22,10,9,3,35,5,4,23,13,2,7,1037607,2023-10-26T00:00:00.000Z,15,17,Giannis Antetokounmpo,4,36,39,26,16,48.1
2,0,4,1,1,4,3,2,2,27,0,3,9,4,2,1,1037607,2023-10-26T00:00:00.000Z,112,17,Jae Crowder,2,13,15,11,6,21.8
4,0,3,3,1,5,2,2,1,16,0,0,6,3,2,2,1037607,2023-10-26T00:00:00.000Z,315,17,Khris Middleton,2,9,13,10,7,19.6
0,0,0,0,0,0,0,0,0,0,0,0,0,0,0,0,1037607,2023-10-26T00:00:00.000Z,666960,17,Lindell Wigginton,0,0,0,0,0,0
3,0,4,1,1,4,2,0,0,31,0,1,5,4,2,2,1037607,2023-10-26T00:00:00.000Z,38,17,Malik Beasley,2,9,12,8,7,18.3
0,0,1,1,0,3,2,0,0,17,1,3,4,2,0,0,1037607,2023-10-26T00:00:00.000Z,38017676,17,MarJon Beauchamp,0,6,6,4,2,6.4
0,0,0,0,0,0,0,0,0,0,0,0,0,0,0,0,1037607,2023-10-26T00:00:00.000Z,666453,17,Marques Bolden,0,0,0,0,0,0
2,1,2,4,1,6,2,2,2,20,0,0,7,2,0,0,1037607,2023-10-26T00:00:00.000Z,105,17,Pat Connaughton,1,9,11,9,4,15.4
0,0,0,0,0,0,0,0,0,0,0,0,0,0,0,0,1037607,2023-10-26T00:00:00.000Z,284,17,Robin Lopez,0,0,0,0,0,0
0,0,0,0,0,0,0,0,0,0,0,0,0,0,0,0,1037607,2023-10-26T00:00:00.000Z,2148,17,Thanasis Antetokounmpo,0,0,0,0,0,0
0,0,0,0,0,0,0,0,0,0,0,0,0,0,0,0,1037607,2023-10-26T00:00:00.000Z,38017691,17,TyTy Washington Jr.,0,0,0,0,0,0
1,0,2,1,0,1,0,0,0,14,0,0,0,2,1,0,1037607,2023-10-26T00:00:00.000Z,184,23,Danny Green,1,2,3,1,3,6.9
0,0,0,0,0,0,0,0,0,0,0,0,0,0,0,0,1037607,2023-10-26T00:00:00.000Z,2175,23,Danuel House Jr.,0,0,0,0,0,0
0,0,0,0,0,0,0,0,0,0,0,0,0,0,0,0,1037607,2023-10-26T00:00:00.000Z,17895941,23,Filip Petrusev,0,0,0,0,0,0
0,0,0,0,0,0,0,0,0,0,0,0,0,0,0,0,1037607,2023-10-26T00:00:00.000Z,260,23,Furkan Korkmaz,0,0,0,0,0,0
0,2,0,1,0,1,0,0,0,5,0,1,0,0,0,0,1037607,2023-10-26T00:00:00.000Z,17896025,23,Jaden Springer,2,0,0,0,0,6
0,0,3,6,5,11,9,4,4,32,1,4,27,4,1,3,1037607,2023-10-26T00:00:00.000Z,360,23,Kelly Oubre Jr.,1,31,31,27,4,31.8
0,0,0,0,0,0,0,0,0,0,0,0,0,0,0,0,1037607,2023-10-26T00:00:00.000Z,28,23,Mo Bamba,0,0,0,0,0,0
2,0,2,0,0,1,1,0,0,13,0,2,2,2,0,0,1037607,2023-10-26T00:00:00.000Z,45,23,Patrick Beverley,0,4,6,4,4,7.4
2,1,3,1,0,2,1,2,1,12,1,4,3,4,0,2,1037607,2023-10-26T00:00:00.000Z,3547270,23,Paul Reed,1,7,9,5,6,11.8
2,3,9,2,1,17,10,10,9,39,3,2,30,12,3,2,1037608,2023-10-26T00:00:00.000Z,117,14,Anthony Davis,6,42,44,32,14,63.4
1,0,1,2,1,7,4,2,1,28,1,5,10,2,1,1,1037608,2023-10-26T00:00:00.000Z,17553995,14,Austin Reaves,1,12,13,11,3,15.9
0,0,1,3,0,5,2,0,0,12,0,2,4,1,0,1,1037608,2023-10-26T00:00:00.000Z,666860,14,Cameron Reddish,0,5,5,4,1,4.2
0,0,0,0,0,0,0,0,0,0,0,0,0,0,0,0,1037608,2023-10-26T00:00:00.000Z,56677738,14,Colin Castleton,0,0,0,0,0,0
5,1,4,7,1,16,6,1,1,33,0,2,14,4,2,3,1037608,2023-10-26T00:00:00.000Z,405,14,D'Angelo Russell,3,18,23,19,9,32.3
0,0,0,0,0,0,0,0,0,0,0,0,0,0,0,0,1037608,2023-10-26T00:00:00.000Z,56677868,14,D'Moi Hodge,0,0,0,0,0,0
6,0,2,5,0,10,3,2,1,35,1,1,7,3,3,0,1037608,2023-10-26T00:00:00.000Z,1603383,14,Gabe Vincent,3,10,16,13,9,28.6
0,0,2,0,0,0,0,0,0,6,0,3,0,2,1,2,1037608,2023-10-26T00:00:00.000Z,666626,14,Jaxson Hayes,1,2,2,0,2,3.4
0,0,0,0,0,0,0,0,0,0,0,0,0,0,0,0,1037608,2023-10-26T00:00:00.000Z,38017697,14,Max Christie,0,0,0,0,0,0
0,0,0,0,0,0,0,0,0,0,0,0,0,0,0,0,1037608,2023-10-26T00:00:00.000Z,56677836,14,Maxwell Lewis,0,0,0,0,0,0
0,1,0,2,1,3,2,2,2,13,0,2,7,0,1,1,1037608,2023-10-26T00:00:00.000Z,666609,14,Rui Hachimura,2,7,7,7,0,12
0,0,0,0,0,0,0,0,0,0,0,0,0,0,0,0,1037608,2023-10-26T00:00:00.000Z,666451,24,Bol Bol,0,0,0,0,0,0
0,0,0,0,0,0,0,0,0,0,0,0,0,0,0,0,1037608,2023-10-26T00:00:00.000Z,37,24,Bradley Beal,0,0,0,0,0,0
0,0,0,0,0,0,0,0,0,0,0,0,0,0,0,0,1037608,2023-10-26T00:00:00.000Z,314,24,Chimezie Metu,0,0,0,0,0,0
0,0,0,0,0,0,0,0,0,0,0,0,0,0,0,0,1037608,2023-10-26T00:00:00.000Z,272,24,Damion Lee,0,0,0,0,0,0
0,0,0,0,0,0,0,0,0,0,0,0,0,0,0,0,1037608,2023-10-26T00:00:00.000Z,57,24,Devin Booker,0,0,0,0,0,0
2,0,3,0,0,2,1,0,0,17,1,3,2,4,0,2,1037608,2023-10-26T00:00:00.000Z,147,24,Drew Eubanks,0,6,8,4,6,7.8
0,0,1,8,2,16,6,1,1,30,1,2,15,2,0,2,1037608,2023-10-26T00:00:00.000Z,178,24,Eric Gordon,0,17,17,15,2,15.4
2,0,6,5,1,15,6,3,1,30,0,2,14,6,2,1,1037608,2023-10-26T00:00:00.000Z,18678058,24,Jordan Goodwin,2,20,22,16,8,29.2
0,0,0,0,0,0,0,0,0,0,0,0,0,0,0,0,1037608,2023-10-26T00:00:00.000Z,32,24,Keita Bates-Diop,0,0,0,0,0,0
0,1,2,2,0,2,0,2,2,13,0,0,2,2,1,1,1037608,2023-10-26T00:00:00.000Z,666729,24,Nassir Little,2,4,4,2,2,9.4
0,0,0,0,0,0,0,0,0,0,0,0,0,0,0,0,1037608,2023-10-26T00:00:00.000Z,3547298,24,Saben Lee,0,0,0,0,0,0
0,0,0,0,0,0,0,0,0,0,0,0,0,0,0,0,1037608,2023-10-26T00:00:00.000Z,3547095,24,Udoka Azubuike,0,0,0,0,0,0
0,0,1,1,1,2,1,0,0,15,0,2,3,1,0,1,1037608,2023-10-26T00:00:00.000Z,470,24,Yuta Watanabe,0,4,4,3,1,3.2
0,0,0,0,0,0,0,0,0,0,0,0,0,0,0,0,1037609,2023-10-27T00:00:00.000Z,56677848,4,Amari Bailey,0,0,0,0,0,0
2,1,4,4,2,13,6,4,3,33,2,4,17,6,1,3,1037609,2023-10-27T00:00:00.000Z,56677823,4,Brandon Miller,2,23,25,19,8,30.2
4,0,8,4,2,15,6,6,5,34,1,2,19,9,3,3,1037609,2023-10-27T00:00:00.000Z,204,4,Gordon Hayward,3,28,32,23,13,41.8
0,1,3,1,0,3,1,0,0,25,1,1,2,4,1,0,1037609,2023-10-27T00:00:00.000Z,18678001,4,JT Thor,2,6,6,2,4,12.8
9,1,6,7,2,17,4,12,10,33,3,1,20,9,2,4,1037609,2023-10-27T00:00:00.000Z,3547239,4,LaMelo Ball,3,29,38,29,18,49.3
0,0,0,0,0,0,0,0,0,0,0,0,0,0,0,0,1037609,2023-10-27T00:00:00.000Z,56677866,4,Leaky Black,0,0,0,0,0,0
1,1,1,0,0,4,1,0,0,21,2,5,2,3,0,1,1037609,2023-10-27T00:00:00.000Z,38017698,4,Mark Williams,1,5,6,3,4,9.1
0,2,1,0,0,1,0,2,0,16,1,4,0,2,1,2,1037609,2023-10-27T00:00:00.000Z,3547282,4,Nick Richards,3,2,2,0,2,9.4
3,1,3,5,1,13,6,1,0,29,0,6,13,3,2,2,1037609,2023-10-27T00:00:00.000Z,666950,4,P.J. Washington,3,16,19,16,6,28.1
1,0,2,7,0,20,8,4,4,35,1,0,20,3,1,2,1037609,2023-10-27T00:00:00.000Z,403,4,Terry Rozier,1,23,24,21,4,26.1
0,0,2,0,0,2,1,5,4,14,0,0,6,2,2,1,1037609,2023-10-27T00:00:00.000Z,3547253,4,Theo Maledon,2,8,8,6,2,13.4
2,1,4,7,3,10,5,12,11,31,0,1,24,4,1,0,1037609,2023-10-27T00:00:00.000Z,77,9,Alec Burks,2,28,30,26,6,37.8
6,1,9,1,0,9,2,2,2,30,3,5,6,12,0,3,1037609,2023-10-27T00:00:00.000Z,56677826,9,Ausar Thompson,1,18,24,12,18,29.4
0,0,0,0,0,0,0,0,0,0,0,0,0,0,0,0,1037609,2023-10-27T00:00:00.000Z,54,9,Bojan Bogdanovic,0,0,0,0,0,0
6,0,1,5,2,13,4,2,2,24,1,6,12,2,1,5,1037609,2023-10-27T00:00:00.000Z,17896075,9,Cade Cunningham,1,14,20,18,8,21.4
0,0,0,0,0,0,0,0,0,0,0,0,0,0,0,0,1037609,2023-10-27T00:00:00.000Z,17896071,9,Isaiah Livers,0,0,0,0,0,0
1,1,6,4,2,10,6,2,1,36,1,3,15,7,0,4,1037609,2023-10-27T00:00:00.000Z,3547267,9,Isaiah Stewart,1,22,23,16,8,23.9
4,0,2,6,2,14,8,0,0,23,0,4,18,2,1,2,1037609,2023-10-27T00:00:00.000Z,38017682,9,Jaden Ivey,1,20,24,22,6,27.4
3,2,11,0,0,8,7,0,0,35,6,3,14,17,2,5,1037609,2023-10-27T00:00:00.000Z,38017694,9,Jalen Duren,4,31,34,17,20,45.9
0,0,0,0,0,0,0,0,0,0,0,0,0,0,0,0,1037609,2023-10-27T00:00:00.000Z,3547240,9,James Wiseman,0,0,0,0,0,0
0,0,0,0,0,0,0,0,0,0,0,0,0,0,0,0,1037609,2023-10-27T00:00:00.000Z,42097199,9,Jared Rhoden,0,0,0,0,0,0
1,0,0,1,0,3,1,0,0,11,0,2,2,0,1,0,1037609,2023-10-27T00:00:00.000Z,197,9,Joe Harris,1,2,3,3,1,6.5
3,1,3,3,1,10,2,2,1,29,0,4,6,3,1,3,1037609,2023-10-27T00:00:00.000Z,3547241,9,Killian Hayes,2,9,12,9,6,17.1
0,0,0,0,0,0,0,0,0,0,0,0,0,0,0,0,1037609,2023-10-27T00:00:00.000Z,56677729,9,Malcolm Cazalon,0,0,0,0,0,0
1,0,1,1,0,1,0,0,0,8,0,1,0,1,0,1,1037609,2023-10-27T00:00:00.000Z,56677792,9,Marcus Sasser,0,1,2,1,2,1.7
1,0,4,1,0,9,5,5,4,13,0,0,14,4,0,0,1037609,2023-10-27T00:00:00.000Z,24,9,Marvin Bagley III,0,18,19,15,5,20.3
0,0,0,0,0,0,0,0,0,0,0,0,0,0,0,0,1037609,2023-10-27T00:00:00.000Z,330,9,Monte Morris,0,0,0,0,0,0
0,0,0,0,0,0,0,0,0,0,0,0,0,0,0,0,1037609,2023-10-27T00:00:00.000Z,44477024,9,Stanley Umude,0,0,0,0,0,0
3,1,1,1,0,11,5,1,0,30,1,3,10,2,3,1,1037610,2023-10-27T00:00:00.000Z,177,8,Aaron Gordon,4,12,15,13,5,27.9
0,0,0,0,0,0,0,0,0,0,0,0,0,0,0,0,1037610,2023-10-27T00:00:00.000Z,17896007,8,Braxton Key,0,0,0,0,0,0
2,0,3,4,1,6,2,2,0,19,1,1,5,4,1,1,1037610,2023-10-27T00:00:00.000Z,38017709,8,Christian Braun,1,9,11,7,6,14.8
0,0,0,0,0,0,0,0,0,0,0,0,0,0,0,0,1037610,2023-10-27T00:00:00.000Z,38017727,8,Collin Gillespie,0,0,0,0,0,0
0,0,0,0,0,0,0,0,0,0,0,0,0,0,0,0,1037610,2023-10-27T00:00:00.000Z,250,8,DeAndre Jordan,0,0,0,0,0,0
0,0,0,0,0,0,0,0,0,0,0,0,0,0,0,0,1037610,2023-10-27T00:00:00.000Z,56677871,8,Hunter Tyson,0,0,0,0,0,0
0,0,0,0,0,0,0,0,0,0,0,0,0,0,0,0,1037610,2023-10-27T00:00:00.000Z,56677582,8,Jalen Pickett,0,0,0,0,0,0
5,1,1,9,4,17,7,4,4,34,0,2,22,1,0,3,1037610,2023-10-27T00:00:00.000Z,335,8,Jamal Murray,1,23,28,27,6,30.7
0,0,0,0,0,0,0,0,0,0,0,0,0,0,0,0,1037610,2023-10-27T00:00:00.000Z,17896103,8,Jay Huff,0,0,0,0,0,0
0,0,0,0,0,2,0,0,0,5,0,2,0,0,0,0,1037610,2023-10-27T00:00:00.000Z,56677776,8,Julian Strawther,0,0,0,0,0,0
0,0,0,0,0,0,0,0,0,0,0,0,0,0,0,0,1037610,2023-10-27T00:00:00.000Z,215,8,Justin Holiday,0,0,0,0,0,0
2,1,2,6,2,10,3,0,0,35,0,1,8,2,5,0,1037610,2023-10-27T00:00:00.000Z,81,8,Kentavious Caldwell-Pope,6,10,12,10,4,31.4
2,0,12,5,2,7,3,1,1,29,1,4,9,13,0,1,1037610,2023-10-27T00:00:00.000Z,375,8,Michael Porter Jr.,0,22,24,11,15,26.6
7,1,9,4,1,14,8,6,5,35,3,1,22,12,1,9,1037610,2023-10-27T00:00:00.000Z,246,8,Nikola Jokic,2,34,41,29,19,43.9
6,0,2,5,2,13,7,0,0,22,0,0,16,2,0,0,1037610,2023-10-27T00:00:00.000Z,236,8,Reggie Jackson,0,18,24,22,8,27.4
0,0,0,0,0,0,0,0,0,0,0,0,0,0,0,0,1037610,2023-10-27T00:00:00.000Z,666489,8,Vlatko Cancar,0,0,0,0,0,0
0,2,0,0,0,4,3,2,1,13,0,1,7,0,1,1,1037610,2023-10-27T00:00:00.000Z,3547268,8,Zeke Nnaji,3,7,7,7,0,15
0,0,0,0,0,0,0,0,0,0,0,0,0,0,0,0,1037610,2023-10-27T00:00:00.000Z,666505,15,Brandon Clarke,0,0,0,0,0,0
2,0,2,2,0,4,0,0,0,15,0,3,0,2,1,2,1037610,2023-10-27T00:00:00.000Z,38017729,15,David Roddy,1,2,4,2,4,6.4
3,0,2,3,2,14,6,2,2,22,2,2,16,4,1,3,1037610,2023-10-27T00:00:00.000Z,401,15,Derrick Rose,1,20,23,19,7,25.3
3,0,2,10,1,17,4,6,6,32,1,3,15,3,2,2,1037610,2023-10-27T00:00:00.000Z,3547287,15,Desmond Bane,2,18,21,18,6,27.1
0,0,0,0,0,0,0,0,0,0,0,0,0,0,0,0,1037610,2023-10-27T00:00:00.000Z,56677830,15,GG Jackson,0,0,0,0,0,0
0,0,0,0,0,0,0,0,0,0,0,0,0,0,0,0,1037610,2023-10-27T00:00:00.000Z,666786,15,Ja Morant,0,0,0,0,0,0
0,0,0,0,0,0,0,0,0,0,0,0,0,0,0,0,1037610,2023-10-27T00:00:00.000Z,48248287,15,Jacob Gilyard,0,0,0,0,0,0
0,0,2,2,1,3,2,2,1,16,3,1,6,5,0,2,1037610,2023-10-27T00:00:00.000Z,38017728,15,Jake LaRavia,0,11,11,6,5,10
2,3,7,2,2,12,9,2,1,29,2,5,21,9,0,1,1037610,2023-10-27T00:00:00.000Z,231,15,Jaren Jackson Jr.,3,30,32,23,11,42.8
2,2,6,1,0,2,1,0,0,30,0,1,2,6,1,0,1037610,2023-10-27T00:00:00.000Z,666703,15,John Konchar,3,8,10,4,8,21.2
0,0,0,0,0,0,0,0,0,0,0,0,0,0,0,0,1037610,2023-10-27T00:00:00.000Z,38017732,15,Kenneth Lofton Jr.,0,0,0,0,0,0
0,0,0,0,0,0,0,0,0,0,0,0,0,0,0,0,1037610,2023-10-27T00:00:00.000Z,254,15,Luke Kennard,0,0,0,0,0,0
5,0,1,7,3,13,7,3,3,31,1,3,20,2,5,2,1037610,2023-10-27T00:00:00.000Z,420,15,Marcus Smart,5,22,27,25,7,42.9
0,0,0,0,0,0,0,0,0,0,0,0,0,0,0,0,1037610,2023-10-27T00:00:00.000Z,17896067,15,Santi Aldama,0,0,0,0,0,0
0,0,0,0,0,0,0,0,0,0,0,0,0,0,0,0,1037610,2023-10-27T00:00:00.000Z,3,15,Steven Adams,0,0,0,0,0,0
0,0,0,0,0,0,0,0,0,0,0,0,0,0,0,0,1037610,2023-10-27T00:00:00.000Z,38017731,15,Vince Williams Jr.,0,0,0,0,0,0
2,2,6,3,1,9,5,4,2,34,2,5,13,8,3,5,1037610,2023-10-27T00:00:00.000Z,3547285,15,Xavier Tillman,5,21,23,15,10,35.6
3,0,7,3,0,10,3,5,5,31,2,0,11,9,0,4,1037610,2023-10-27T00:00:00.000Z,17896027,15,Ziaire Williams,0,20,23,14,12,22.3
0,0,2,4,2,4,2,0,0,8,0,0,6,2,0,0,1037611,2023-10-27T00:00:00.000Z,38017689,1,AJ Griffin,0,8,8,6,2,8.4
3,0,1,9,4,11,6,0,0,26,0,3,16,1,1,2,1037611,2023-10-27T00:00:00.000Z,53,1,Bogdan Bogdanovic,1,17,20,19,4,22.7
2,1,9,2,0,8,5,3,1,30,0,2,11,9,1,3,1037611,2023-10-27T00:00:00.000Z,17896040,1,Jalen Johnson,2,20,22,13,11,27.8
1,1,2,0,0,2,1,4,4,20,0,4,6,2,2,0,1037611,2023-10-27T00:00:00.000Z,3547244,1,Onyeka Okongwu,3,8,9,7,3,18.9
12,0,2,5,2,16,4,10,8,35,1,2,18,3,3,6,1037611,2023-10-27T00:00:00.000Z,490,1,Trae Young,3,21,33,30,15,42.6
0,0,0,0,0,0,0,0,0,0,0,0,0,0,0,0,1037611,2023-10-27T00:00:00.000Z,666474,20,Charles Brown,0,0,0,0,0,0
0,0,0,0,0,0,0,0,0,0,0,0,0,0,0,0,1037611,2023-10-27T00:00:00.000Z,666675,20,DaQuan Jeffries,0,0,0,0,0,0
1,1,1,5,3,10,6,2,1,20,1,2,16,2,1,2,1037611,2023-10-27T00:00:00.000Z,131,20,Donte DiVincenzo,2,18,19,17,3,23.9
0,0,0,0,0,0,0,0,0,0,0,0,0,0,0,0,1037611,2023-10-27T00:00:00.000Z,17896089,20,Duane Washington Jr.,0,0,0,0,0,0
0,0,0,0,0,0,0,0,0,0,0,0,0,0,0,0,1037611,2023-10-27T00:00:00.000Z,666971,20,Dylan Windler,0,0,0,0,0,0
0,0,0,0,0,0,0,0,0,0,0,0,0,0,0,0,1037611,2023-10-27T00:00:00.000Z,160,20,Evan Fournier,0,0,0,0,0,0
6,0,6,9,1,14,4,2,2,24,0,2,11,6,1,4,1037611,2023-10-27T00:00:00.000Z,3547269,20,Immanuel Quickley,1,17,23,17,12,26.2
1,1,1,0,0,4,3,4,2,10,1,4,8,2,1,1,1037611,2023-10-27T00:00:00.000Z,201,20,Isaiah Hartenstein,2,10,11,9,3,16.9
0,0,0,0,0,0,0,0,0,0,0,0,0,0,0,0,1037611,2023-10-27T00:00:00.000Z,56677795,20,Jacob Toppin,0,0,0,0,0,0
5,0,3,12,8,21,11,2,1,33,0,1,31,3,0,1,1037611,2023-10-27T00:00:00.000Z,73,20,Jalen Brunson,0,34,39,36,8,41.1
0,0,0,0,0,0,0,0,0,0,0,0,0,0,0,0,1037611,2023-10-27T00:00:00.000Z,17896063,20,Jericho Sims,0,0,0,0,0,0
0,0,3,1,0,4,2,0,0,22,0,3,4,3,1,0,1037611,2023-10-27T00:00:00.000Z,202,20,Josh Hart,1,7,7,4,3,10.6
9,0,10,7,3,10,4,8,6,34,2,3,17,12,0,3,1037611,2023-10-27T00:00:00.000Z,387,20,Julius Randle,0,29,38,26,21,41.9
0,0,0,0,0,0,0,0,0,0,0,0,0,0,0,0,1037611,2023-10-27T00:00:00.000Z,17896033,20,Miles McBride,0,0,0,0,0,0
1,4,7,0,0,6,2,4,3,38,6,1,7,13,4,1,1037611,2023-10-27T00:00:00.000Z,399,20,Mitchell Robinson,8,20,21,8,14,47.1
1,0,0,5,2,6,2,0,0,25,1,3,6,1,0,1,1037611,2023-10-27T00:00:00.000Z,17895858,20,Quentin Grimes,0,7,8,7,2,7.7
6,0,2,5,3,15,9,6,5,34,1,2,26,3,1,3,1037611,2023-10-27T00:00:00.000Z,666423,20,RJ Barrett,1,29,35,32,9,38.6
0,0,0,0,0,0,0,0,0,0,0,0,0,0,0,0,1037611,2023-10-27T00:00:00.000Z,19,20,Ryan Arcidiacono,0,0,0,0,0,0
2,2,4,0,0,24,10,9,7,35,3,1,27,7,1,3,1037612,2023-10-27T00:00:00.000Z,4,16,Bam Adebayo,3,34,36,29,9,44.4
0,0,0,0,0,0,0,0,0,0,0,0,0,0,0,0,1037612,2023-10-27T00:00:00.000Z,666747,16,Caleb Martin,0,0,0,0,0,0
0,0,0,0,0,0,0,0,0,0,0,0,0,0,0,0,1037612,2023-10-27T00:00:00.000Z,38017736,16,Cole Swider,0,0,0,0,0,0
2,0,2,1,0,2,0,0,0,14,0,2,0,2,0,1,1037612,2023-10-27T00:00:00.000Z,56677785,16,Jaime Jaquez Jr.,0,2,4,2,4,4.4
0,0,1,1,0,1,0,0,0,4,0,1,0,1,1,1,1037612,2023-10-27T00:00:00.000Z,38017734,16,Jamal Cain,1,1,1,0,1,3.2
5,1,7,4,3,7,5,0,0,32,1,3,13,8,0,1,1037612,2023-10-27T00:00:00.000Z,286,16,Kyle Lowry,1,21,26,18,13,32.1
0,0,0,0,0,0,0,0,0,0,0,0,0,0,0,0,1037612,2023-10-27T00:00:00.000Z,38017696,16,Nikola Jovic,0,0,0,0,0,0
0,0,0,0,0,0,0,0,0,0,0,0,0,0,0,0,1037612,2023-10-27T00:00:00.000Z,3547257,16,R.J. Hampton,0,0,0,0,0,0
1,1,3,1,0,5,1,0,0,13,1,1,2,4,0,1,1037612,2023-10-27T00:00:00.000Z,74,16,Thomas Bryant,1,6,7,3,5,10.3
6,0,5,12,5,19,10,3,3,40,1,2,28,6,1,3,1037612,2023-10-27T00:00:00.000Z,666633,16,Tyler Herro,1,34,40,34,12,44.2
0,0,0,0,0,0,0,0,0,0,0,0,0,0,0,0,1037613,2023-10-27T00:00:00.000Z,56677872,6,Craig Porter,0,0,0,0,0,0
0,0,0,0,0,0,0,0,0,0,0,0,0,0,0,0,1037613,2023-10-27T00:00:00.000Z,666581,6,Darius Garland,0,0,0,0,0,0
0,0,0,0,0,0,0,0,0,0,0,0,0,0,0,0,1037613,2023-10-27T00:00:00.000Z,9,6,Jarrett Allen,0,0,0,0,0,0
0,0,0,0,0,0,0,0,0,0,0,0,0,0,0,0,1037613,2023-10-27T00:00:00.000Z,404,6,Ricky Rubio,0,0,0,0,0,0
0,0,0,0,0,0,0,0,0,0,0,0,0,0,0,0,1037613,2023-10-27T00:00:00.000Z,444,6,Tristan Thompson,0,0,0,0,0,0
1,1,0,0,0,0,0,0,0,12,0,0,0,0,0,1,1037613,2023-10-27T00:00:00.000Z,17896078,21,Aaron Wiggins,1,0,1,1,1,3.5
0,0,0,0,0,0,0,0,0,0,0,0,0,0,0,0,1037613,2023-10-27T00:00:00.000Z,3547271,21,Aleksej Pokusevski,0,0,0,0,0,0
0,0,1,1,1,4,3,2,2,19,1,0,9,2,0,0,1037613,2023-10-27T00:00:00.000Z,56677833,21,Cason Wallace,0,11,11,9,2,11.4
2,7,12,4,3,9,5,4,3,31,1,3,16,13,1,1,1037613,2023-10-27T00:00:00.000Z,38017685,21,Chet Holmgren,8,29,31,18,15,57.6
0,0,0,0,0,0,0,0,0,0,0,0,0,0,0,0,1037613,2023-10-27T00:00:00.000Z,44,21,Davis Bertans,0,0,0,0,0,0
2,0,3,7,1,10,2,1,0,22,0,1,5,3,0,1,1037613,2023-10-27T00:00:00.000Z,3547272,21,Isaiah Joe,0,8,10,7,5,10.6
2,0,5,4,2,14,4,4,4,35,0,2,14,5,1,4,1037613,2023-10-27T00:00:00.000Z,38017703,21,Jalen Williams,1,19,21,16,7,22
0,0,0,0,0,0,0,0,0,0,0,0,0,0,0,0,1037613,2023-10-27T00:00:00.000Z,38017706,21,Jaylin Williams,0,0,0,0,0,0
6,0,6,1,0,8,1,0,0,28,0,1,2,6,0,3,1037613,2023-10-27T00:00:00.000Z,17896065,21,Josh Giddey,0,8,14,8,12,15.2
0,0,0,0,0,0,0,0,0,0,0,0,0,0,0,0,1037613,2023-10-27T00:00:00.000Z,480,21,Kenrich Williams,0,0,0,0,0,0
0,0,0,0,0,0,0,0,0,0,0,0,0,0,0,0,1037613,2023-10-27T00:00:00.000Z,56677853,21,Keyontae Johnson,0,0,0,0,0,0
0,0,0,0,0,0,0,0,0,1,0,0,0,0,0,0,1037613,2023-10-27T00:00:00.000Z,27924547,21,Lindy Waters III,0,0,0,0,0,0
2,1,3,4,3,13,9,6,4,39,3,5,25,6,1,1,1037613,2023-10-27T00:00:00.000Z,666541,21,Luguentz Dort,2,31,33,27,8,40.2
0,0,0,0,0,0,0,0,0,0,0,0,0,0,0,0,1037613,2023-10-27T00:00:00.000Z,24572055,21,Olivier Sarr,0,0,0,0,0,0
2,0,1,2,0,2,0,0,0,11,0,3,0,1,0,0,1037613,2023-10-27T00:00:00.000Z,38017716,21,Ousmane Dieng,0,1,3,2,3,4.2
4,1,10,2,2,26,15,2,2,36,1,2,34,11,5,5,1037613,2023-10-27T00:00:00.000Z,175,21,Shai Gilgeous-Alexander,6,45,49,38,15,66.2
0,0,0,0,0,0,0,0,0,0,0,0,0,0,0,0,1037613,2023-10-27T00:00:00.000Z,17896036,21,Tre Mann,0,0,0,0,0,0
1,0,0,1,1,1,1,0,0,6,0,0,3,0,0,2,1037613,2023-10-27T00:00:00.000Z,4197029,21,Vasilije Micic,0,3,4,4,1,2.5
0,0,0,0,0,0,0,0,0,0,0,0,0,0,0,0,1037614,2023-10-27T00:00:00.000Z,56677860,5,Adama Sanogo,0,0,0,0,0,0
2,1,7,5,2,9,5,2,1,32,6,5,13,13,2,0,1037614,2023-10-27T00:00:00.000Z,89,5,Alex Caruso,3,26,28,15,15,40.6
0,0,0,0,0,6,3,2,2,12,2,2,8,2,0,2,1037614,2023-10-27T00:00:00.000Z,137,5,Andre Drummond,0,10,10,8,2,8.4
0,0,1,1,0,4,2,0,0,11,0,0,4,1,0,0,1037614,2023-10-27T00:00:00.000Z,17895983,5,Ayo Dosunmu,0,5,5,4,1,5.2
8,0,6,9,2,15,5,5,5,40,0,2,17,6,1,3,1037614,2023-10-27T00:00:00.000Z,666956,5,Coby White,1,23,31,25,14,36.2
0,0,0,0,0,0,0,0,0,0,0,0,0,0,0,0,1037614,2023-10-27T00:00:00.000Z,38017719,5,Dalen Terry,0,0,0,0,0,0
2,0,1,2,0,2,0,0,0,13,0,1,0,1,0,1,1037614,2023-10-27T00:00:00.000Z,87,5,Jevon Carter,0,1,3,2,3,3.2
0,0,0,0,0,0,0,0,0,0,0,0,0,0,0,0,1037614,2023-10-27T00:00:00.000Z,56677857,5,Julian Phillips,0,0,0,0,0,0
0,0,0,0,0,0,0,0,0,0,0,0,0,0,0,0,1037614,2023-10-27T00:00:00.000Z,45969255,5,Justin Lewis,0,0,0,0,0,0
0,0,0,0,0,0,0,0,0,0,0,0,0,0,0,0,1037614,2023-10-27T00:00:00.000Z,27,5,Lonzo Ball,0,0,0,0,0,0
0,0,0,0,0,0,0,0,0,0,0,0,0,0,0,0,1037614,2023-10-27T00:00:00.000Z,56677874,5,Onuralp Bitim,0,0,0,0,0,0
0,0,0,0,0,0,0,0,0,0,0,0,0,0,0,0,1037614,2023-10-27T00:00:00.000Z,17896116,5,Terry Taylor,0,0,0,0,0,0
0,1,2,4,1,7,3,0,0,24,3,2,7,5,1,0,1037614,2023-10-27T00:00:00.000Z,110,5,Torrey Craig,2,12,12,7,5,19
0,0,5,0,0,4,3,5,4,17,1,3,10,6,0,1,1037614,2023-10-27T00:00:00.000Z,58,28,Chris Boucher,0,16,16,10,6,16.2
0,0,0,0,0,0,0,0,0,0,0,0,0,0,0,0,1037614,2023-10-27T00:00:00.000Z,436,28,Garrett Temple,0,0,0,0,0,0
0,0,1,2,0,2,0,0,0,6,0,0,0,1,0,0,1037614,2023-10-27T00:00:00.000Z,56677828,28,Gradey Dick,0,1,1,0,1,1.2
0,0,6,0,0,5,4,0,0,19,0,6,8,6,0,3,1037614,2023-10-27T00:00:00.000Z,373,28,Jakob Poeltl,0,14,14,8,6,12.2
1,0,2,4,0,4,0,0,0,18,1,1,0,3,1,0,1037614,2023-10-27T00:00:00.000Z,666762,28,Jalen McDaniels,1,3,4,1,4,8.1
0,0,0,1,0,1,0,0,0,4,0,0,0,0,0,0,1037614,2023-10-27T00:00:00.000Z,3547275,28,Malachi Flynn,0,0,0,0,0,0
0,0,0,0,0,0,0,0,0,0,0,0,0,0,0,0,1037614,2023-10-27T00:00:00.000Z,56677869,28,Markquis Nowell,0,0,0,0,0,0
0,0,3,4,1,8,5,1,0,28,0,2,11,3,2,1,1037614,2023-10-27T00:00:00.000Z,18,28,OG Anunoby,2,14,14,11,3,19.6
0,0,0,0,0,0,0,0,0,0,0,0,0,0,0,0,1037614,2023-10-27T00:00:00.000Z,376,28,Otto Porter Jr.,0,0,0,0,0,0
2,0,7,5,1,15,7,5,3,41,1,4,18,8,0,3,1037614,2023-10-27T00:00:00.000Z,416,28,Pascal Siakam,0,26,28,20,10,27.6
1,0,7,3,1,5,2,3,3,23,2,6,8,9,0,3,1037614,2023-10-27T00:00:00.000Z,3547249,28,Precious Achiuwa,0,17,18,9,10,17.3
10,2,9,2,1,14,9,4,3,38,1,5,22,10,0,7,1037614,2023-10-27T00:00:00.000Z,17896055,28,Scottie Barnes,2,32,42,32,20,48
0,0,0,0,0,0,0,0,0,0,0,0,0,0,0,0,1037614,2023-10-27T00:00:00.000Z,489,28,Thaddeus Young,0,0,0,0,0,0
7,1,8,3,1,18,11,6,2,41,6,6,25,14,2,6,1037615,2023-10-27T00:00:00.000Z,17896062,11,Alperen Sengun,3,39,46,32,21,55.3
3,1,1,1,0,4,2,2,0,13,0,1,4,1,0,1,1037615,2023-10-27T00:00:00.000Z,56677825,11,Amen Thompson,1,5,8,7,4,11.7
1,0,0,0,0,2,2,0,0,7,0,1,4,0,0,0,1037615,2023-10-27T00:00:00.000Z,296,11,Boban Marjanovic,0,4,5,5,1,5.5
0,0,0,0,0,0,0,0,0,0,0,0,0,0,0,0,1037615,2023-10-27T00:00:00.000Z,56677831,11,Cam Whitmore,0,0,0,0,0,0
2,0,2,2,1,13,7,2,2,39,0,4,17,2,1,2,1037615,2023-10-27T00:00:00.000Z,66,11,Dillon Brooks,1,19,21,19,4,23.4
0,0,5,8,2,16,5,4,1,37,4,4,13,9,1,2,1037615,2023-10-27T00:00:00.000Z,38017684,11,Jabari Smith Jr.,1,22,22,13,9,24.8
0,0,0,1,0,2,1,1,1,14,0,1,3,0,3,1,1037615,2023-10-27T00:00:00.000Z,3547301,11,Jae'Sean Tate,3,3,3,3,0,11
4,0,4,6,2,20,10,0,0,38,1,2,22,5,0,2,1037615,2023-10-27T00:00:00.000Z,17895966,11,Jalen Green,0,27,31,26,9,32
1,0,1,0,0,4,4,2,2,21,0,1,10,1,0,0,1037615,2023-10-27T00:00:00.000Z,188,11,Jeff Green,0,11,12,11,2,12.7
0,0,0,0,0,0,0,0,0,0,0,0,0,0,0,0,1037615,2023-10-27T00:00:00.000Z,56677809,11,Jermaine Samuels Jr.,0,0,0,0,0,0
0,0,0,0,0,0,0,0,0,0,0,0,0,0,0,0,1037615,2023-10-27T00:00:00.000Z,38017693,27,Blake Wesley,0,0,0,0,0,0
1,0,2,6,4,7,5,0,0,23,0,1,14,2,0,3,1037615,2023-10-27T00:00:00.000Z,359,27,Cedi Osman,0,16,17,15,3,14.9
0,0,2,0,0,0,0,0,0,8,1,1,0,3,0,0,1037615,2023-10-27T00:00:00.000Z,17895854,27,Charles Bassey,0,3,3,0,3,3.6
0,0,0,0,0,0,0,0,0,0,0,0,0,0,0,0,1037615,2023-10-27T00:00:00.000Z,56677865,27,Charles Bediako,0,0,0,0,0,0
2,0,3,7,3,13,7,11,8,40,0,0,25,3,0,1,1037615,2023-10-27T00:00:00.000Z,3547246,27,Devin Vassell,0,28,30,27,5,30.6
0,0,0,0,0,0,0,0,0,0,0,0,0,0,0,0,1037615,2023-10-27T00:00:00.000Z,180,27,Devonte' Graham,0,0,0,0,0,0
0,0,0,0,0,0,0,0,0,0,0,0,0,0,0,0,1037615,2023-10-27T00:00:00.000Z,38017730,27,Dominick Barlow,0,0,0,0,0,0
0,0,0,4,2,5,3,0,0,16,0,0,8,0,0,0,1037615,2023-10-27T00:00:00.000Z,305,27,Doug McDermott,0,8,8,8,0,8
4,0,4,1,0,9,5,4,4,26,1,3,14,5,2,2,1037615,2023-10-27T00:00:00.000Z,38017699,27,Jeremy Sochan,2,19,23,18,9,30
0,0,0,0,0,0,0,0,0,0,0,0,0,0,0,0,1037615,2023-10-27T00:00:00.000Z,38017649,27,Julian Champagnie,0,0,0,0,0,0
4,1,2,7,3,14,8,2,1,35,2,5,20,4,0,3,1037615,2023-10-27T00:00:00.000Z,666682,27,Keldon Johnson,1,24,28,24,8,30.8
0,0,0,0,0,0,0,0,0,0,0,0,0,0,0,0,1037615,2023-10-27T00:00:00.000Z,17896059,27,Sandro Mamukelashvili,0,0,0,0,0,0
0,0,0,0,0,0,0,0,0,0,0,0,0,0,0,0,1037615,2023-10-27T00:00:00.000Z,56677817,27,Sidy Cissoko,0,0,0,0,0,0
0,0,0,0,0,0,0,0,0,0,0,0,0,0,0,0,1037615,2023-10-27T00:00:00.000Z,56677870,27,Sir'Jabari Rice,0,0,0,0,0,0
8,0,3,3,0,8,3,0,0,33,3,0,6,6,3,0,1037615,2023-10-27T00:00:00.000Z,3547274,27,Tre Jones,3,12,20,14,14,34.2
1,3,7,6,0,19,7,8,7,31,5,2,21,12,2,4,1037615,2023-10-27T00:00:00.000Z,56677822,27,Victor Wembanyama,5,33,34,22,13,47.9
8,0,6,7,0,12,4,3,1,39,0,5,9,6,4,4,1037615,2023-10-27T00:00:00.000Z,102,27,Zach Collins,4,15,23,17,14,36.2
0,0,0,0,0,0,0,0,0,0,0,0,0,0,0,0,1037616,2023-10-27T00:00:00.000Z,9051997,3,Armoni Brooks,0,0,0,0,0,0
8,2,6,0,0,8,5,0,0,33,4,3,10,10,2,2,1037616,2023-10-27T00:00:00.000Z,417,3,Ben Simmons,4,20,28,18,18,44
2,1,7,4,1,19,12,5,5,33,0,2,30,7,1,0,1037616,2023-10-27T00:00:00.000Z,17896048,3,Cam Thomas,2,37,39,32,9,47.4
0,0,0,0,0,0,0,0,0,0,0,0,0,0,0,0,1037616,2023-10-27T00:00:00.000Z,666679,3,Cameron Johnson,0,0,0,0,0,0
0,0,0,0,0,0,0,0,0,0,0,0,0,0,0,0,1037616,2023-10-27T00:00:00.000Z,56677841,3,Dariq Whitehead,0,0,0,0,0,0
0,0,2,0,0,2,1,0,0,3,2,1,2,4,1,2,1037616,2023-10-27T00:00:00.000Z,17896038,3,Day'Ron Sharpe,1,6,6,2,4,7.8
1,0,1,0,0,3,0,0,0,8,0,4,0,1,0,1,1037616,2023-10-27T00:00:00.000Z,421,3,Dennis Smith Jr.,0,1,2,1,2,1.7
3,0,6,7,4,8,4,0,0,32,1,5,12,7,0,2,1037616,2023-10-27T00:00:00.000Z,158,3,Dorian Finney-Smith,0,19,22,15,10,22.9
0,0,0,0,0,0,0,0,0,0,0,0,0,0,0,0,1037616,2023-10-27T00:00:00.000Z,174,3,Harry Giles III,0,0,0,0,0,0
0,0,0,0,0,0,0,0,0,0,0,0,0,0,0,0,1037616,2023-10-27T00:00:00.000Z,56677722,3,Jalen Wilson,0,0,0,0,0,0
2,1,1,6,4,9,5,0,0,21,0,3,14,1,0,2,1037616,2023-10-27T00:00:00.000Z,464,3,Lonnie Walker IV,1,15,17,16,3,19.2
3,0,3,7,3,17,6,3,3,36,1,2,18,4,0,1,1037616,2023-10-27T00:00:00.000Z,61,3,Mikal Bridges,0,22,25,21,7,26.3
0,0,0,0,0,0,0,0,0,0,0,0,0,0,0,0,1037616,2023-10-27T00:00:00.000Z,666508,3,Nicolas Claxton,0,0,0,0,0,0
0,0,0,0,0,0,0,0,0,0,0,0,0,0,0,0,1037616,2023-10-27T00:00:00.000Z,56677843,3,Noah Clowney,0,0,0,0,0,0
3,0,8,7,3,9,4,0,0,34,2,4,11,10,1,3,1037616,2023-10-27T00:00:00.000Z,351,3,Royce O'Neale,1,21,24,14,13,27.5
8,0,3,12,6,17,8,2,1,40,0,4,23,3,0,2,1037616,2023-10-27T00:00:00.000Z,130,3,Spencer Dinwiddie,0,26,34,31,11,36.6
0,0,0,0,0,0,0,0,0,0,0,0,0,0,0,0,1037616,2023-10-27T00:00:00.000Z,17896058,3,Trendon Watford,0,0,0,0,0,0
0,0,0,0,0,0,0,0,0,0,0,0,0,0,0,0,1037616,2023-10-27T00:00:00.000Z,17554004,7,AJ Lawson,0,0,0,0,0,0
0,1,0,1,0,2,1,0,0,4,0,0,2,0,1,0,1037616,2023-10-27T00:00:00.000Z,151,7,Dante Exum,2,2,2,2,0,8
0,1,1,0,0,4,4,2,1,17,1,0,9,2,0,1,1037616,2023-10-27T00:00:00.000Z,56677840,7,Dereck Lively II,1,11,11,9,2,13.4
0,0,0,0,0,0,0,0,0,0,0,0,0,0,0,0,1037616,2023-10-27T00:00:00.000Z,56677873,7,Dexter Dennis,0,0,0,0,0,0
0,0,0,1,1,4,4,2,2,13,2,0,11,2,1,0,1037616,2023-10-27T00:00:00.000Z,379,7,Dwight Powell,1,13,13,11,2,16.4
0,0,6,4,1,6,2,0,0,29,0,5,5,6,0,2,1037616,2023-10-27T00:00:00.000Z,666965,7,Grant Williams,0,11,11,5,6,10.2
0,0,0,0,0,0,0,0,0,0,0,0,0,0,0,0,1037616,2023-10-27T00:00:00.000Z,17896028,7,Greg Brown III,0,0,0,0,0,0
0,0,0,0,0,0,0,0,0,0,0,0,0,0,0,0,1037616,2023-10-27T00:00:00.000Z,38017679,7,Jaden Hardy,0,0,0,0,0,0
2,0,2,3,0,7,2,6,3,28,1,2,7,3,3,3,1037616,2023-10-27T00:00:00.000Z,3547258,7,Josh Green,3,10,12,9,5,19.6
6,0,6,4,1,17,6,4,4,34,1,2,17,7,0,0,1037616,2023-10-27T00:00:00.000Z,228,7,Kyrie Irving,0,24,30,23,13,34.4
7,0,9,14,9,25,16,10,8,36,1,1,49,10,0,0,1037616,2023-10-27T00:00:00.000Z,132,7,Luka Doncic,0,59,66,56,17,71.5
0,0,0,0,0,0,0,0,0,0,0,0,0,0,0,0,1037616,2023-10-27T00:00:00.000Z,329,7,Markieff Morris,0,0,0,0,0,0
2,0,4,0,0,3,0,0,0,26,1,1,0,5,0,0,1037616,2023-10-27T00:00:00.000Z,257,7,Maxi Kleber,0,5,7,2,7,9
0,0,0,0,0,0,0,0,0,0,0,0,0,0,0,0,1037616,2023-10-27T00:00:00.000Z,56677859,7,Olivier-Maxence Prosper,0,0,0,0,0,0
0,0,0,0,0,0,0,0,0,0,0,0,0,0,0,0,1037616,2023-10-27T00:00:00.000Z,217,7,Richaun Holmes,0,0,0,0,0,0
1,0,0,0,0,1,1,0,0,9,0,1,2,0,0,1,1037616,2023-10-27T00:00:00.000Z,114,7,Seth Curry,0,2,3,3,1,2.5
1,0,3,7,3,17,6,4,4,30,1,2,19,4,0,1,1037616,2023-10-27T00:00:00.000Z,191,7,Tim Hardaway Jr.,0,23,24,20,5,24.3
0,0,0,0,0,0,0,0,0,0,0,0,0,0,0,0,1037617,2023-10-27T00:00:00.000Z,666511,13,Amir Coffey,0,0,0,0,0,0
0,0,0,0,0,0,0,0,0,0,0,0,0,0,0,0,1037617,2023-10-27T00:00:00.000Z,17896022,13,Brandon Boston Jr.,0,0,0,0,0,0
0,0,0,0,0,0,0,0,0,0,0,0,0,0,0,0,1037617,2023-10-27T00:00:00.000Z,56677856,13,Jordan Miller,0,0,0,0,0,0
0,0,0,0,0,0,0,0,0,0,0,0,0,0,0,0,1037617,2023-10-27T00:00:00.000Z,17896051,13,Joshua Primo,0,0,0,0,0,0
0,0,0,0,0,0,0,0,0,0,0,0,0,0,0,0,1037617,2023-10-27T00:00:00.000Z,3547294,13,Kenyon Martin Jr.,0,0,0,0,0,0
0,0,0,0,0,0,0,0,0,0,0,0,0,0,0,0,1037617,2023-10-27T00:00:00.000Z,56677849,13,Kobe Brown,0,0,0,0,0,0
0,0,0,0,0,0,0,0,0,0,0,0,0,0,0,0,1037617,2023-10-27T00:00:00.000Z,328,13,Marcus Morris,0,0,0,0,0,0
0,0,3,0,0,1,1,2,1,12,1,2,3,4,0,1,1037617,2023-10-27T00:00:00.000Z,371,13,Mason Plumlee,0,7,7,3,4,6.8
0,0,0,0,0,0,0,0,0,0,0,0,0,0,0,0,1037617,2023-10-27T00:00:00.000Z,38017725,13,Moussa Diabate,0,0,0,0,0,0
1,0,2,5,2,10,5,0,0,22,0,2,12,2,1,3,1037617,2023-10-27T00:00:00.000Z,17896031,13,Nah'Shon Hyland,1,14,15,13,3,15.9
3,3,2,3,2,4,3,0,0,30,0,4,8,2,1,0,1037617,2023-10-27T00:00:00.000Z,33,13,Nicolas Batum,4,10,13,11,5,26.9
1,0,3,4,2,10,7,4,4,25,0,2,20,3,1,1,1037617,2023-10-27T00:00:00.000Z,380,13,Norman Powell,1,23,24,21,4,27.1
1,0,3,9,3,17,9,15,15,38,1,1,36,4,0,2,1037617,2023-10-27T00:00:00.000Z,172,13,Paul George,0,40,41,37,5,40.3
4,1,8,1,0,4,2,0,0,37,1,4,4,9,1,5,1037617,2023-10-27T00:00:00.000Z,472,13,Russell Westbrook,2,13,17,8,13,21.8
0,0,0,0,0,0,0,0,0,0,0,0,0,0,0,0,1037617,2023-10-27T00:00:00.000Z,666743,13,Terance Mann,0,0,0,0,0,0
0,0,0,0,0,0,0,0,0,0,0,0,0,0,0,0,1037617,2023-10-27T00:00:00.000Z,56677842,29,Brice Sensabaugh,0,0,0,0,0,0
0,0,1,2,0,12,5,4,3,20,0,3,13,1,0,0,1037617,2023-10-27T00:00:00.000Z,413,29,Collin Sexton,0,14,14,13,1,14.2
0,1,7,5,1,11,4,4,4,34,5,4,13,12,0,0,1037617,2023-10-27T00:00:00.000Z,101,29,John Collins,1,25,25,13,12,30.4
0,0,0,0,0,0,0,0,0,0,0,0,0,0,0,0,1037617,2023-10-27T00:00:00.000Z,38017630,29,Johnny Juzang,0,0,0,0,0,0
6,0,3,5,3,13,4,3,2,34,1,0,13,4,1,2,1037617,2023-10-27T00:00:00.000Z,100,29,Jordan Clarkson,1,17,23,19,10,27.8
0,0,0,0,0,0,0,0,0,0,0,0,0,0,0,0,1037617,2023-10-27T00:00:00.000Z,17896023,29,Josh Christopher,0,0,0,0,0,0
3,1,1,2,2,6,5,3,3,27,3,3,15,4,1,3,1037617,2023-10-27T00:00:00.000Z,358,29,Kelly Olynyk,2,19,22,18,7,27.3
2,0,2,3,2,5,3,0,0,12,1,2,8,3,0,1,1037617,2023-10-27T00:00:00.000Z,56677834,29,Keyonte George,0,11,13,10,5,13.6
3,0,1,2,0,7,2,0,0,18,0,6,4,1,1,3,1037617,2023-10-27T00:00:00.000Z,139,29,Kris Dunn,1,5,8,7,4,9.7
0,0,0,0,0,0,0,0,0,0,0,0,0,0,0,0,1037617,2023-10-27T00:00:00.000Z,666881,29,Luka Samanic,0,0,0,0,0,0
2,1,1,2,0,3,1,0,0,12,0,3,2,1,1,0,1037617,2023-10-27T00:00:00.000Z,38017620,29,Ochai Agbaji,2,3,5,4,3,12.2
0,0,0,0,0,0,0,0,0,0,0,0,0,0,0,0,1037617,2023-10-27T00:00:00.000Z,11891374,29,Omer Yurtseven,0,0,0,0,0,0
0,0,0,0,0,0,0,0,0,0,0,0,0,0,0,0,1037617,2023-10-27T00:00:00.000Z,38017739,29,Simone Fontecchio,0,0,0,0,0,0
8,1,3,5,2,10,3,2,2,27,0,1,10,3,3,2,1037617,2023-10-27T00:00:00.000Z,666650,29,Talen Horton-Tucker,4,13,21,18,11,35.6
0,0,0,0,0,0,0,0,0,0,0,0,0,0,0,0,1037617,2023-10-27T00:00:00.000Z,56677824,29,Taylor Hendricks,0,0,0,0,0,0
0,0,2,2,1,6,3,0,0,21,2,0,7,4,0,0,1037617,2023-10-27T00:00:00.000Z,38017705,29,Walker Kessler,0,11,11,7,4,11.8
1,0,11,0,0,9,7,0,0,30,4,4,14,15,0,2,1037618,2023-10-27T00:00:00.000Z,22,25,Deandre Ayton,0,29,30,15,16,31.5
0,0,3,2,1,3,2,4,4,9,1,3,9,4,0,0,1037618,2023-10-27T00:00:00.000Z,38017711,25,Jabari Walker,0,13,13,9,4,13.8
3,0,4,5,1,14,4,7,6,36,0,5,15,4,2,3,1037618,2023-10-27T00:00:00.000Z,182,25,Jerami Grant,2,19,22,18,7,27.3
0,0,0,0,0,0,0,0,0,0,0,0,0,0,0,0,1037618,2023-10-27T00:00:00.000Z,56677791,25,Kris Murray,0,0,0,0,0,0
1,0,5,6,2,15,6,6,4,31,2,2,18,7,0,2,1037618,2023-10-27T00:00:00.000Z,65,25,Malcolm Brogdon,0,25,26,19,8,25.9
0,1,2,1,0,1,0,0,0,17,0,2,0,2,1,0,1037618,2023-10-27T00:00:00.000Z,666923,25,Matisse Thybulle,2,2,2,0,2,8.4
0,0,0,0,0,0,0,0,0,0,0,0,0,0,0,0,1037618,2023-10-27T00:00:00.000Z,666476,25,Moses Brown,0,0,0,0,0,0
0,0,0,0,0,0,0,0,0,0,0,0,0,0,0,0,1037618,2023-10-27T00:00:00.000Z,56677829,25,Rayan Rupert,0,0,0,0,0,0
2,0,2,0,0,5,3,0,0,20,1,2,6,3,0,1,1037618,2023-10-27T00:00:00.000Z,476,25,Robert Williams III,0,9,11,8,5,11.6
2,0,1,5,1,12,3,0,0,25,2,5,7,3,1,5,1037618,2023-10-27T00:00:00.000Z,56677747,25,Scoot Henderson,1,10,12,9,5,11.6
2,0,1,11,4,23,9,2,2,41,4,1,24,5,2,3,1037618,2023-10-27T00:00:00.000Z,38017690,25,Shaedon Sharpe,2,29,31,26,7,36
1,0,0,0,0,2,1,0,0,8,0,0,2,0,0,0,1037618,2023-10-27T00:00:00.000Z,3547289,25,Skylar Mays,0,2,3,3,1,3.5
3,0,3,2,0,4,0,2,2,23,1,0,2,4,0,0,1037618,2023-10-27T00:00:00.000Z,56677850,25,Toumani Camara,0,6,9,5,7,11.3
0,0,1,4,2,6,4,0,0,12,0,0,10,1,0,0,1037619,2023-10-27T00:00:00.000Z,4197162,26,Aleksandar Vezenkov,0,11,11,10,1,11.2
3,0,1,4,0,7,1,3,2,26,0,6,4,1,1,1,1037619,2023-10-27T00:00:00.000Z,17896030,26,Chris Duarte,1,5,8,7,4,11.7
0,0,0,0,0,0,0,0,0,1,0,0,0,0,0,0,1037619,2023-10-27T00:00:00.000Z,56677845,26,Colby Jones,0,0,0,0,0,0
0,0,0,1,0,2,0,0,0,11,0,1,0,0,1,2,1037619,2023-10-27T00:00:00.000Z,17553994,26,Davion Mitchell,1,0,0,0,0,1
4,0,4,9,5,28,14,7,6,39,0,3,39,4,2,2,1037619,2023-10-27T00:00:00.000Z,161,26,De'Aaron Fox,2,43,47,43,8,53.8
7,0,14,2,0,15,7,6,5,36,4,1,19,18,3,1,1037619,2023-10-27T00:00:00.000Z,406,26,Domantas Sabonis,3,37,44,26,25,59.1
1,0,3,2,1,5,4,4,1,30,1,1,10,4,1,0,1037619,2023-10-27T00:00:00.000Z,30,26,Harrison Barnes,1,14,15,11,5,19.3
0,0,2,0,0,6,3,3,1,12,2,0,7,4,0,2,1037619,2023-10-27T00:00:00.000Z,306,26,JaVale McGee,0,11,11,7,4,9.8
1,1,4,11,3,16,6,2,1,39,3,2,16,7,2,4,1037619,2023-10-27T00:00:00.000Z,38017688,26,Keegan Murray,3,23,24,17,8,30.9
2,1,2,5,0,5,0,0,0,16,0,0,0,2,0,0,1037619,2023-10-27T00:00:00.000Z,221,26,Kevin Huerter,1,2,4,2,4,8.4
6,1,0,2,1,4,2,4,4,18,0,2,9,0,0,2,1037619,2023-10-27T00:00:00.000Z,324,26,Malik Monk,1,9,15,15,6,19
0,0,0,0,0,0,0,0,0,0,0,0,0,0,0,0,1037620,2023-10-28T00:00:00.000Z,56677860,5,Adama Sanogo,0,0,0,0,0,0
2,1,2,0,0,6,1,0,0,15,3,0,2,5,3,0,1037620,2023-10-28T00:00:00.000Z,137,5,Andre Drummond,4,7,9,4,7,23
0,0,0,1,1,1,1,0,0,1,0,0,3,0,0,0,1037620,2023-10-28T00:00:00.000Z,38017719,5,Dalen Terry,0,3,3,3,0,3
4,2,1,1,0,13,7,7,6,32,1,3,20,2,1,1,1037620,2023-10-28T00:00:00.000Z,125,5,DeMar DeRozan,3,22,26,24,6,36.4
0,0,0,0,0,0,0,0,0,1,0,0,0,0,0,0,1037620,2023-10-28T00:00:00.000Z,56677857,5,Julian Phillips,0,0,0,0,0,0
0,0,0,0,0,0,0,0,0,0,0,0,0,0,0,0,1037620,2023-10-28T00:00:00.000Z,45969255,5,Justin Lewis,0,0,0,0,0,0
0,0,0,0,0,0,0,0,0,0,0,0,0,0,0,0,1037620,2023-10-28T00:00:00.000Z,27,5,Lonzo Ball,0,0,0,0,0,0
1,0,4,2,1,12,5,1,1,32,0,5,12,4,0,1,1037620,2023-10-28T00:00:00.000Z,460,5,Nikola Vucevic,0,16,17,13,5,17.3
0,0,0,0,0,0,0,0,0,0,0,0,0,0,0,0,1037620,2023-10-28T00:00:00.000Z,56677874,5,Onuralp Bitim,0,0,0,0,0,0
1,0,2,1,0,3,0,0,0,21,1,3,0,3,1,1,1037620,2023-10-28T00:00:00.000Z,3547248,5,Patrick Williams,1,3,4,1,4,7.1
0,0,0,0,0,0,0,0,0,1,0,0,0,0,0,0,1037620,2023-10-28T00:00:00.000Z,17896116,5,Terry Taylor,0,0,0,0,0,0
0,0,0,0,0,0,0,0,0,0,0,0,0,0,0,0,1037620,2023-10-28T00:00:00.000Z,54,9,Bojan Bogdanovic,0,0,0,0,0,0
0,0,0,0,0,0,0,0,0,0,0,0,0,0,0,0,1037620,2023-10-28T00:00:00.000Z,17896071,9,Isaiah Livers,0,0,0,0,0,0
3,0,0,2,1,6,3,0,0,22,0,0,7,0,1,2,1037620,2023-10-28T00:00:00.000Z,38017682,9,Jaden Ivey,1,7,10,10,3,12.5
0,0,0,0,0,0,0,0,0,0,0,0,0,0,0,0,1037620,2023-10-28T00:00:00.000Z,3547240,9,James Wiseman,0,0,0,0,0,0
0,0,0,0,0,0,0,0,0,0,0,0,0,0,0,0,1037620,2023-10-28T00:00:00.000Z,42097199,9,Jared Rhoden,0,0,0,0,0,0
1,0,1,2,1,2,1,0,0,10,0,0,3,1,0,1,1037620,2023-10-28T00:00:00.000Z,197,9,Joe Harris,0,4,5,4,2,4.7
1,0,2,1,0,2,1,0,0,6,1,0,2,3,0,0,1037620,2023-10-28T00:00:00.000Z,56677792,9,Marcus Sasser,0,5,6,3,4,7.1
0,0,0,0,0,0,0,0,0,0,0,0,0,0,0,0,1037620,2023-10-28T00:00:00.000Z,330,9,Monte Morris,0,0,0,0,0,0
0,0,0,0,0,0,0,0,0,1,0,0,0,0,0,0,1037620,2023-10-28T00:00:00.000Z,44477024,9,Stanley Umude,0,0,0,0,0,0
0,0,0,0,0,0,0,0,0,0,0,0,0,0,0,0,1037621,2023-10-28T00:00:00.000Z,666505,15,Brandon Clarke,0,0,0,0,0,0
2,1,6,4,3,8,5,1,1,24,0,3,14,6,0,1,1037621,2023-10-28T00:00:00.000Z,38017729,15,David Roddy,1,20,22,16,8,26.2
5,1,0,2,1,8,3,0,0,18,1,0,7,1,1,3,1037621,2023-10-28T00:00:00.000Z,401,15,Derrick Rose,2,8,13,12,6,18.7
5,1,1,10,4,20,10,2,2,34,1,4,26,2,1,5,1037621,2023-10-28T00:00:00.000Z,3547287,15,Desmond Bane,2,28,33,31,7,36.9
0,0,0,0,0,0,0,0,0,0,0,0,0,0,0,0,1037621,2023-10-28T00:00:00.000Z,56677830,15,GG Jackson,0,0,0,0,0,0
0,0,0,0,0,0,0,0,0,0,0,0,0,0,0,0,1037621,2023-10-28T00:00:00.000Z,666786,15,Ja Morant,0,0,0,0,0,0
0,0,0,0,0,0,0,0,0,0,0,0,0,0,0,0,1037621,2023-10-28T00:00:00.000Z,48248287,15,Jacob Gilyard,0,0,0,0,0,0
1,0,1,5,1,9,2,0,0,16,0,0,5,1,0,0,1037621,2023-10-28T00:00:00.000Z,38017728,15,Jake LaRavia,0,6,7,6,2,7.7
2,1,5,4,2,12,4,6,6,31,0,4,16,5,1,1,1037621,2023-10-28T00:00:00.000Z,231,15,Jaren Jackson Jr.,2,21,23,18,7,30
1,2,6,3,1,4,2,0,0,22,3,0,5,9,2,1,1037621,2023-10-28T00:00:00.000Z,666703,15,John Konchar,4,14,15,6,10,28.3
1,0,0,0,0,1,0,0,0,5,0,2,0,0,0,1,1037621,2023-10-28T00:00:00.000Z,38017732,15,Kenneth Lofton Jr.,0,0,1,1,1,0.5
0,0,0,0,0,0,0,0,0,0,0,0,0,0,0,0,1037621,2023-10-28T00:00:00.000Z,254,15,Luke Kennard,0,0,0,0,0,0
6,2,4,5,1,8,4,0,0,32,0,2,9,4,2,2,1037621,2023-10-28T00:00:00.000Z,420,15,Marcus Smart,4,13,19,15,10,32.8
0,0,0,0,0,0,0,0,0,0,0,0,0,0,0,0,1037621,2023-10-28T00:00:00.000Z,17896067,15,Santi Aldama,0,0,0,0,0,0
0,0,0,0,0,0,0,0,0,0,0,0,0,0,0,0,1037621,2023-10-28T00:00:00.000Z,3,15,Steven Adams,0,0,0,0,0,0
0,0,0,0,0,0,0,0,0,0,0,0,0,0,0,0,1037621,2023-10-28T00:00:00.000Z,38017731,15,Vince Williams Jr.,0,0,0,0,0,0
3,0,6,2,2,7,3,0,0,24,1,4,8,7,0,1,1037621,2023-10-28T00:00:00.000Z,3547285,15,Xavier Tillman,0,15,18,11,10,19.9
1,0,10,12,4,14,6,0,0,34,0,2,16,10,0,1,1037621,2023-10-28T00:00:00.000Z,17896027,15,Ziaire Williams,0,26,27,17,11,28.5
0,0,0,0,0,0,0,0,0,0,0,0,0,0,0,0,1037621,2023-10-28T00:00:00.000Z,3547302,30,Anthony Gill,0,0,0,0,0,0
0,1,1,1,0,2,0,0,0,14,0,1,0,1,0,1,1037621,2023-10-28T00:00:00.000Z,56677844,30,Bilal Coulibaly,1,1,1,0,1,3.2
1,0,3,10,5,14,8,1,1,32,0,2,22,3,1,2,1037621,2023-10-28T00:00:00.000Z,17896045,30,Corey Kispert,1,25,26,23,4,28.1
1,0,0,1,0,3,2,1,1,8,0,0,5,0,1,0,1037621,2023-10-28T00:00:00.000Z,167,30,Danilo Gallinari,1,5,6,6,1,9.5
7,1,2,1,0,3,0,2,2,20,0,0,2,2,2,1,1037621,2023-10-28T00:00:00.000Z,487,30,Delon Wright,3,4,11,9,9,22.9
0,0,0,0,0,0,0,0,0,0,0,0,0,0,0,0,1037621,2023-10-28T00:00:00.000Z,17896106,30,Eugene Omoruyi,0,0,0,0,0,0
0,0,0,0,0,0,0,0,0,0,0,0,0,0,0,0,1037621,2023-10-28T00:00:00.000Z,18677954,30,Jared Butler,0,0,0,0,0,0
0,0,0,0,0,0,0,0,0,0,0,0,0,0,0,0,1037621,2023-10-28T00:00:00.000Z,38124126,30,John Butler Jr.,0,0,0,0,0,0
0,0,0,0,0,0,0,0,0,0,0,0,0,0,0,0,1037621,2023-10-28T00:00:00.000Z,38017687,30,Johnny Davis,0,0,0,0,0,0
0,0,0,0,0,0,0,0,0,0,0,0,0,0,0,0,1037621,2023-10-28T00:00:00.000Z,414,30,Landry Shamet,0,0,0,0,0,0
2,0,3,0,0,1,1,0,0,11,0,2,2,3,0,0,1037621,2023-10-28T00:00:00.000Z,337,30,Mike Muscala,0,5,7,4,5,8.6
0,0,0,0,0,0,0,0,0,0,0,0,0,0,0,0,1037621,2023-10-28T00:00:00.000Z,38017704,30,Patrick Baldwin Jr.,0,0,0,0,0,0
0,0,0,0,0,0,0,0,0,0,0,0,0,0,0,0,1037621,2023-10-28T00:00:00.000Z,38017712,30,Ryan Rollins,0,0,0,0,0,0
7,0,0,8,4,12,5,0,0,28,2,2,14,2,2,0,1037621,2023-10-28T00:00:00.000Z,249,30,Tyus Jones,2,16,23,21,9,32.9
7,0,3,7,2,11,4,4,2,30,0,2,12,3,4,1,1037622,2023-10-28T00:00:00.000Z,303,19,CJ McCollum,4,15,22,19,10,37.1
0,0,0,0,0,0,0,0,0,0,0,0,0,0,0,0,1037622,2023-10-28T00:00:00.000Z,38017726,19,Dereon Seabron,0,0,0,0,0,0
3,0,4,3,0,7,1,4,0,22,0,2,2,4,1,1,1037622,2023-10-28T00:00:00.000Z,38017677,19,Dyson Daniels,1,6,9,5,7,13.3
1,3,2,2,2,6,4,0,0,27,0,5,10,2,0,1,1037622,2023-10-28T00:00:00.000Z,17896024,19,Herbert Jones,3,12,13,11,3,21.9
0,0,4,1,0,7,3,2,2,21,0,4,8,4,1,4,1037622,2023-10-28T00:00:00.000Z,455,19,Jonas Valanciunas,1,12,12,8,4,11.8
0,0,0,0,0,0,0,0,0,0,0,0,0,0,0,0,1037622,2023-10-28T00:00:00.000Z,18677986,19,Trey Murphy III,0,0,0,0,0,0
2,0,4,0,0,17,12,2,0,28,1,0,24,5,0,0,1037622,2023-10-28T00:00:00.000Z,666969,19,Zion Williamson,0,29,31,26,7,33
0,0,0,0,0,0,0,0,0,0,0,0,0,0,0,0,1037622,2023-10-28T00:00:00.000Z,666474,20,Charles Brown,0,0,0,0,0,0
0,0,0,0,0,0,0,0,0,0,0,0,0,0,0,0,1037622,2023-10-28T00:00:00.000Z,17896089,20,Duane Washington Jr.,0,0,0,0,0,0
1,0,0,1,1,1,1,0,0,3,0,1,3,0,0,0,1037622,2023-10-28T00:00:00.000Z,666971,20,Dylan Windler,0,3,4,4,1,4.5
0,0,0,0,0,0,0,0,0,0,0,0,0,0,0,0,1037622,2023-10-28T00:00:00.000Z,160,20,Evan Fournier,0,0,0,0,0,0
0,0,0,0,0,0,0,0,0,0,0,0,0,0,0,0,1037622,2023-10-28T00:00:00.000Z,56677795,20,Jacob Toppin,0,0,0,0,0,0
4,0,12,5,0,15,4,2,2,34,0,4,10,12,0,8,1037622,2023-10-28T00:00:00.000Z,387,20,Julius Randle,0,22,26,14,16,22.4
0,2,5,0,0,8,4,0,0,29,10,1,8,15,0,0,1037622,2023-10-28T00:00:00.000Z,399,20,Mitchell Robinson,2,23,23,8,15,32
1,0,2,6,1,9,2,0,0,26,0,1,5,2,2,0,1037622,2023-10-28T00:00:00.000Z,17895858,20,Quentin Grimes,2,7,8,6,3,14.9
2,1,3,6,1,16,7,4,3,30,0,0,18,3,1,3,1037622,2023-10-28T00:00:00.000Z,666423,20,RJ Barrett,2,21,23,20,5,27.6
0,0,0,0,0,0,0,0,0,0,0,0,0,0,0,0,1037622,2023-10-28T00:00:00.000Z,19,20,Ryan Arcidiacono,0,0,0,0,0,0
8,0,3,10,4,28,12,9,3,44,2,2,31,5,1,2,1037623,2023-10-28T00:00:00.000Z,277,6,Caris LeVert,1,36,44,39,13,50
1,0,0,0,0,0,0,0,0,4,0,0,0,0,0,0,1037623,2023-10-28T00:00:00.000Z,56677872,6,Craig Porter,0,0,1,1,1,1.5
0,0,1,0,0,0,0,0,0,6,2,0,0,3,0,0,1037623,2023-10-28T00:00:00.000Z,248,6,Damian Jones,0,3,3,0,3,3.6
0,0,0,0,0,0,0,0,0,0,0,0,0,0,0,0,1037623,2023-10-28T00:00:00.000Z,666581,6,Darius Garland,0,0,0,0,0,0
3,1,3,5,2,5,2,0,0,37,0,2,6,3,0,0,1037623,2023-10-28T00:00:00.000Z,666940,6,Dean Wade,1,9,12,9,6,17.1
0,0,0,0,0,0,0,0,0,0,0,0,0,0,0,0,1037623,2023-10-28T00:00:00.000Z,322,6,Donovan Mitchell,0,0,0,0,0,0
0,0,0,1,0,1,0,0,0,6,0,0,0,0,0,0,1037623,2023-10-28T00:00:00.000Z,56677847,6,Emoni Bates,0,0,0,0,0,0
3,3,9,1,1,22,12,10,8,33,5,4,33,14,0,2,1037623,2023-10-28T00:00:00.000Z,17896076,6,Evan Mobley,3,47,50,36,17,61.3
2,1,2,4,1,10,3,0,0,19,1,3,7,3,0,1,1037623,2023-10-28T00:00:00.000Z,344,6,Georges Niang,1,10,12,9,5,15.6
3,1,3,0,0,8,5,2,1,35,2,3,11,5,0,0,1037623,2023-10-28T00:00:00.000Z,3547247,6,Isaac Okoro,1,16,19,14,8,24.5
0,0,0,0,0,0,0,0,0,0,0,0,0,0,0,0,1037623,2023-10-28T00:00:00.000Z,9,6,Jarrett Allen,0,0,0,0,0,0
6,0,10,9,4,20,7,3,3,42,1,2,21,11,0,1,1037623,2023-10-28T00:00:00.000Z,666908,6,Max Strus,0,32,38,27,17,42.2
0,0,0,0,0,0,0,0,0,0,0,0,0,0,0,0,1037623,2023-10-28T00:00:00.000Z,404,6,Ricky Rubio,0,0,0,0,0,0
2,0,1,0,0,3,2,0,0,8,4,0,4,5,0,0,1037623,2023-10-28T00:00:00.000Z,444,6,Tristan Thompson,0,9,11,6,7,13
0,0,0,0,0,0,0,0,0,0,0,0,0,0,0,0,1037623,2023-10-28T00:00:00.000Z,666676,6,Ty Jerome,0,0,0,0,0,0
0,0,5,9,5,16,10,2,1,30,4,1,26,9,0,0,1037623,2023-10-28T00:00:00.000Z,3547250,12,Aaron Nesmith,0,35,35,26,9,36.8
4,0,2,2,0,5,2,0,0,25,0,4,4,2,2,1,1037623,2023-10-28T00:00:00.000Z,38017507,12,Andrew Nembhard,2,6,10,8,6,17.4
1,0,0,3,1,10,5,3,2,17,0,0,13,0,0,0,1037623,2023-10-28T00:00:00.000Z,38017686,12,Bennedict Mathurin,0,13,14,14,1,14.5
2,0,4,1,0,8,3,0,0,32,0,3,6,4,1,0,1037623,2023-10-28T00:00:00.000Z,69,12,Bruce Brown,1,10,12,8,6,16.8
4,1,1,7,2,12,4,0,0,19,0,1,10,1,0,1,1037623,2023-10-28T00:00:00.000Z,210,12,Buddy Hield,1,11,15,14,5,19.2
0,0,0,0,0,0,0,0,0,0,0,0,0,0,0,0,1037623,2023-10-28T00:00:00.000Z,17896035,12,Isaiah Jackson,0,0,0,0,0,0
3,0,4,3,2,7,5,2,1,19,2,2,13,6,0,1,1037623,2023-10-28T00:00:00.000Z,3547264,12,Jalen Smith,0,19,22,16,9,23.7
0,0,0,0,0,0,0,0,0,0,0,0,0,0,0,0,1037623,2023-10-28T00:00:00.000Z,3547207,12,Jordan Nwora,0,0,0,0,0,0
1,2,11,5,1,14,7,5,5,29,1,5,20,12,0,2,1037623,2023-10-28T00:00:00.000Z,452,12,Myles Turner,2,32,33,21,13,39.9
0,1,2,1,0,5,2,0,0,18,2,1,4,4,0,1,1037623,2023-10-28T00:00:00.000Z,3547243,12,Obi Toppin,1,8,8,4,4,10.8
8,0,1,0,0,5,3,2,2,19,1,1,8,2,0,0,1037623,2023-10-28T00:00:00.000Z,304,12,T.J. McConnell,0,10,18,16,10,22.4
13,0,7,7,4,16,7,3,3,32,1,2,21,8,0,1,1037623,2023-10-28T00:00:00.000Z,3547245,12,Tyrese Haliburton,0,29,42,34,21,49.1
0,0,0,0,0,1,0,0,0,5,0,1,0,0,0,0,1037624,2023-10-28T00:00:00.000Z,184,23,Danny Green,0,0,0,0,0,0
0,1,2,1,0,3,1,0,0,11,0,1,2,2,0,0,1037624,2023-10-28T00:00:00.000Z,2175,23,Danuel House Jr.,1,4,4,2,2,7.4
0,0,0,0,0,0,0,0,0,0,0,0,0,0,0,0,1037624,2023-10-28T00:00:00.000Z,17895941,23,Filip Petrusev,0,0,0,0,0,0
0,0,0,0,0,0,0,0,0,0,0,0,0,0,0,0,1037624,2023-10-28T00:00:00.000Z,260,23,Furkan Korkmaz,0,0,0,0,0,0
0,0,0,0,0,0,0,0,0,0,0,0,0,0,0,0,1037624,2023-10-28T00:00:00.000Z,17896025,23,Jaden Springer,0,0,0,0,0,0
0,0,0,0,0,0,0,0,0,0,0,0,0,0,0,0,1037624,2023-10-28T00:00:00.000Z,192,23,James Harden,0,0,0,0,0,0
0,0,0,0,0,0,0,0,0,0,0,0,0,0,0,0,1037624,2023-10-28T00:00:00.000Z,17554001,23,Javonte Smart,0,0,0,0,0,0
2,0,3,6,0,17,7,5,4,29,2,3,18,5,3,0,1037624,2023-10-28T00:00:00.000Z,360,23,Kelly Oubre Jr.,3,23,25,20,7,36
0,0,0,0,0,0,0,0,0,0,0,0,0,0,0,0,1037624,2023-10-28T00:00:00.000Z,28,23,Mo Bamba,0,0,0,0,0,0
2,0,2,0,0,2,1,0,0,17,3,2,2,5,0,1,1037624,2023-10-28T00:00:00.000Z,45,23,Patrick Beverley,0,7,9,4,7,10
0,0,3,0,0,4,2,0,0,13,2,4,4,5,1,1,1037624,2023-10-28T00:00:00.000Z,3547270,23,Paul Reed,1,9,9,4,5,12
2,2,1,4,1,10,4,7,6,36,1,1,15,2,2,2,1037624,2023-10-28T00:00:00.000Z,200,23,Tobias Harris,4,17,19,17,4,30.4
7,1,5,9,7,20,12,3,3,41,1,1,34,6,0,1,1037624,2023-10-28T00:00:00.000Z,3547254,23,Tyrese Maxey,1,40,47,41,13,53.7
0,0,3,2,0,6,1,3,3,12,1,2,5,4,1,1,1037624,2023-10-28T00:00:00.000Z,58,28,Chris Boucher,1,9,9,5,4,11.8
0,0,0,0,0,0,0,0,0,0,0,0,0,0,0,0,1037624,2023-10-28T00:00:00.000Z,38017710,28,Christian Koloko,0,0,0,0,0,0
10,0,1,6,4,14,5,2,1,35,3,1,15,4,2,1,1037624,2023-10-28T00:00:00.000Z,409,28,Dennis Schroder,2,19,29,25,14,39.8
0,0,0,0,0,0,0,0,0,0,0,0,0,0,0,0,1037624,2023-10-28T00:00:00.000Z,436,28,Garrett Temple,0,0,0,0,0,0
0,0,1,5,3,16,6,4,2,33,1,0,17,2,1,1,1037624,2023-10-28T00:00:00.000Z,3089,28,Gary Trent Jr.,1,19,19,17,2,21.4
1,0,0,6,4,8,5,2,2,28,2,5,16,2,0,1,1037624,2023-10-28T00:00:00.000Z,56677828,28,Gradey Dick,0,18,19,17,3,18.9
3,1,6,0,0,5,2,3,2,25,1,2,6,7,0,2,1037624,2023-10-28T00:00:00.000Z,373,28,Jakob Poeltl,1,13,16,9,10,19.9
0,0,0,0,0,0,0,0,0,3,0,0,0,0,0,0,1037624,2023-10-28T00:00:00.000Z,666762,28,Jalen McDaniels,0,0,0,0,0,0
0,0,0,0,0,0,0,0,0,0,0,0,0,0,0,0,1037624,2023-10-28T00:00:00.000Z,56677805,28,Javon Freeman-Liberty,0,0,0,0,0,0
2,0,0,2,2,4,2,1,1,13,0,1,7,0,1,3,1037624,2023-10-28T00:00:00.000Z,3547275,28,Malachi Flynn,1,7,9,9,2,10
0,0,0,0,0,0,0,0,0,0,0,0,0,0,0,0,1037624,2023-10-28T00:00:00.000Z,56677869,28,Markquis Nowell,0,0,0,0,0,0
0,0,0,0,0,0,0,0,0,0,0,0,0,0,0,0,1037624,2023-10-28T00:00:00.000Z,18,28,OG Anunoby,0,0,0,0,0,0
0,0,0,0,0,0,0,0,0,0,0,0,0,0,0,0,1037624,2023-10-28T00:00:00.000Z,376,28,Otto Porter Jr.,0,0,0,0,0,0
4,1,6,5,2,8,3,4,3,36,1,4,11,7,0,2,1037624,2023-10-28T00:00:00.000Z,416,28,Pascal Siakam,1,18,22,15,11,26.4
3,1,4,1,0,10,3,0,0,18,3,1,6,7,0,1,1037624,2023-10-28T00:00:00.000Z,3547249,28,Precious Achiuwa,1,13,16,9,10,20.9
0,0,0,0,0,0,0,0,0,0,0,0,0,0,0,0,1037624,2023-10-28T00:00:00.000Z,38017717,28,Ron Harper Jr.,0,0,0,0,0,0
5,2,7,5,2,16,11,0,0,37,1,3,24,8,0,1,1037624,2023-10-28T00:00:00.000Z,17896055,28,Scottie Barnes,2,32,37,29,13,46.1
0,0,0,0,0,0,0,0,0,0,0,0,0,0,0,0,1037624,2023-10-28T00:00:00.000Z,489,28,Thaddeus Young,0,0,0,0,0,0
4,0,1,1,1,4,2,0,0,22,0,1,5,1,1,1,1037625,2023-10-28T00:00:00.000Z,19465585,16,Dru Smith,1,6,10,9,5,14.2
1,0,2,10,2,12,3,0,0,29,1,1,8,3,1,1,1037625,2023-10-28T00:00:00.000Z,397,16,Duncan Robinson,1,11,12,9,4,15.1
0,1,1,0,0,2,0,0,0,4,0,0,0,1,0,0,1037625,2023-10-28T00:00:00.000Z,39398582,16,Orlando Robinson,1,1,1,0,1,4.2
0,2,1,0,0,0,0,0,0,4,0,0,0,1,0,2,1037626,2023-10-28T00:00:00.000Z,666451,24,Bol Bol,2,1,1,0,1,5.2
0,0,0,0,0,0,0,0,0,0,0,0,0,0,0,0,1037626,2023-10-28T00:00:00.000Z,37,24,Bradley Beal,0,0,0,0,0,0
1,0,1,0,0,2,1,0,0,3,0,0,2,1,0,0,1037626,2023-10-28T00:00:00.000Z,314,24,Chimezie Metu,0,3,4,3,2,4.7
0,0,0,0,0,0,0,0,0,0,0,0,0,0,0,0,1037626,2023-10-28T00:00:00.000Z,272,24,Damion Lee,0,0,0,0,0,0
0,0,0,0,0,0,0,0,0,0,0,0,0,0,0,0,1037626,2023-10-28T00:00:00.000Z,57,24,Devin Booker,0,0,0,0,0,0
2,2,3,0,0,7,6,0,0,19,2,3,12,5,0,0,1037626,2023-10-28T00:00:00.000Z,147,24,Drew Eubanks,2,17,19,14,7,27
5,0,3,5,2,9,2,6,6,25,2,2,12,5,1,2,1037626,2023-10-28T00:00:00.000Z,18678058,24,Jordan Goodwin,1,17,22,17,10,26.5
0,0,1,5,0,8,3,0,0,21,0,2,6,1,1,0,1037626,2023-10-28T00:00:00.000Z,666729,24,Nassir Little,1,7,7,6,1,10.2
2,1,0,1,0,2,1,0,0,4,0,0,2,0,0,0,1037626,2023-10-28T00:00:00.000Z,3547298,24,Saben Lee,1,2,4,4,2,8
0,1,3,4,1,7,2,2,2,20,1,2,7,4,2,0,1037626,2023-10-28T00:00:00.000Z,470,24,Yuta Watanabe,3,11,11,7,4,20.8
0,0,1,1,0,2,1,0,0,3,0,0,2,1,0,0,1037627,2023-10-29T00:00:00.000Z,17896007,8,Braxton Key,0,3,3,2,1,3.2
7,1,6,2,0,9,4,5,5,21,1,2,13,7,1,0,1037627,2023-10-29T00:00:00.000Z,38017709,8,Christian Braun,2,20,27,20,14,37.9
0,0,0,1,0,1,0,0,0,5,0,1,0,0,1,0,1037627,2023-10-29T00:00:00.000Z,38017727,8,Collin Gillespie,1,0,0,0,0,3
0,0,0,0,0,0,0,0,0,0,0,0,0,0,0,0,1037627,2023-10-29T00:00:00.000Z,250,8,DeAndre Jordan,0,0,0,0,0,0
0,0,1,0,0,0,0,0,0,3,0,1,0,1,0,0,1037627,2023-10-29T00:00:00.000Z,56677871,8,Hunter Tyson,0,1,1,0,1,1.2
0,0,0,0,0,0,0,0,0,0,0,0,0,0,0,0,1037627,2023-10-29T00:00:00.000Z,56677582,8,Jalen Pickett,0,0,0,0,0,0
8,0,1,1,1,14,9,0,0,30,1,1,19,2,0,4,1037627,2023-10-29T00:00:00.000Z,335,8,Jamal Murray,0,21,29,27,10,29.4
0,0,0,0,0,0,0,0,0,0,0,0,0,0,0,0,1037627,2023-10-29T00:00:00.000Z,17896103,8,Jay Huff,0,0,0,0,0,0
1,0,1,3,2,5,3,0,0,8,0,0,8,1,0,0,1037627,2023-10-29T00:00:00.000Z,56677776,8,Julian Strawther,0,9,10,9,2,10.7
0,0,0,0,0,0,0,0,0,3,0,0,0,0,0,0,1037627,2023-10-29T00:00:00.000Z,215,8,Justin Holiday,0,0,0,0,0,0
1,0,3,4,1,5,2,2,2,30,0,2,7,3,2,1,1037627,2023-10-29T00:00:00.000Z,81,8,Kentavious Caldwell-Pope,2,10,11,8,4,17.1
5,0,12,2,1,16,12,3,3,30,2,3,28,14,0,4,1037627,2023-10-29T00:00:00.000Z,246,8,Nikola Jokic,0,42,47,33,19,48.3
1,1,3,3,1,11,8,0,0,22,1,1,17,4,1,0,1037627,2023-10-29T00:00:00.000Z,38017721,8,Peyton Watson,2,21,22,18,5,29.3
6,0,0,2,1,3,2,0,0,22,0,4,5,0,2,2,1037627,2023-10-29T00:00:00.000Z,236,8,Reggie Jackson,2,5,11,11,6,18
0,0,0,0,0,0,0,0,0,0,0,0,0,0,0,0,1037627,2023-10-29T00:00:00.000Z,666489,8,Vlatko Cancar,0,0,0,0,0,0
1,0,2,0,0,1,0,0,0,15,1,2,0,3,0,0,1037627,2023-10-29T00:00:00.000Z,3547268,8,Zeke Nnaji,0,3,4,1,4,5.1
0,0,0,0,0,0,0,0,0,0,0,0,0,0,0,0,1037627,2023-10-29T00:00:00.000Z,480,21,Kenrich Williams,0,0,0,0,0,0
0,0,0,0,0,0,0,0,0,0,0,0,0,0,0,0,1037628,2023-10-29T00:00:00.000Z,56677858,10,Brandin Podziemski,0,0,0,0,0,0
7,0,5,3,0,8,3,2,2,27,0,1,8,5,1,1,1037628,2023-10-29T00:00:00.000Z,367,10,Chris Paul,1,13,20,15,12,26.5
5,1,5,3,1,6,1,2,1,21,3,0,4,8,0,1,1037628,2023-10-29T00:00:00.000Z,407,10,Dario Saric,1,12,17,9,13,23.1
1,1,4,4,3,8,6,0,0,19,0,1,15,4,3,0,1037628,2023-10-29T00:00:00.000Z,2189,10,Gary Payton II,4,19,20,16,5,33.3
0,0,0,0,0,0,0,0,0,0,0,0,0,0,0,0,1037628,2023-10-29T00:00:00.000Z,398,10,Jerome Robinson,0,0,0,0,0,0
1,0,2,3,1,8,3,3,2,19,0,4,9,2,1,3,1037628,2023-10-29T00:00:00.000Z,17553979,10,Jonathan Kuminga,1,11,12,10,3,12.9
0,0,0,0,0,0,0,0,0,0,0,0,0,0,0,0,1037628,2023-10-29T00:00:00.000Z,45658838,10,Lester Quinones,0,0,0,0,0,0
1,1,3,5,1,6,1,2,2,18,0,1,5,3,0,0,1037628,2023-10-29T00:00:00.000Z,17553992,10,Moses Moody,1,8,9,6,4,13.1
0,0,0,0,0,0,0,0,0,0,0,0,0,0,0,0,1037628,2023-10-29T00:00:00.000Z,17896070,10,Usman Garuba,0,0,0,0,0,0
7,0,1,2,1,15,7,4,4,33,4,3,19,5,0,0,1037628,2023-10-29T00:00:00.000Z,17896062,11,Alperen Sengun,0,24,31,26,12,35.5
2,0,4,5,2,10,4,2,2,34,0,5,12,4,0,0,1037628,2023-10-29T00:00:00.000Z,66,11,Dillon Brooks,0,16,18,14,6,19.8
5,0,6,6,2,12,6,0,0,34,2,3,14,8,2,1,1037628,2023-10-29T00:00:00.000Z,38017684,11,Jabari Smith Jr.,2,22,27,19,13,36.1
1,0,0,2,2,3,2,0,0,9,1,0,6,1,1,1,1037629,2023-10-29T00:00:00.000Z,38017689,1,AJ Griffin,1,7,8,7,2,10.7
0,0,0,1,0,1,0,0,0,5,0,1,0,0,0,2,1037629,2023-10-29T00:00:00.000Z,666564,1,Bruno Fernando,0,0,0,0,0,-2
1,0,10,0,0,10,5,2,2,23,2,1,12,12,1,0,1037629,2023-10-29T00:00:00.000Z,83,1,Clint Capela,1,24,25,13,13,30.9
1,0,2,4,2,10,6,1,1,24,1,3,15,3,4,2,1037629,2023-10-29T00:00:00.000Z,666656,1,De'Andre Hunter,4,18,19,16,4,30.1
0,0,0,0,0,0,0,0,0,0,0,0,0,0,0,0,1037629,2023-10-29T00:00:00.000Z,666754,1,Garrison Mathews,0,0,0,0,0,0
1,1,6,3,2,10,6,0,0,26,1,4,14,7,2,2,1037629,2023-10-29T00:00:00.000Z,17896040,1,Jalen Johnson,3,21,22,15,8,30.9
0,0,0,1,0,1,0,0,0,3,0,1,0,0,1,0,1037629,2023-10-29T00:00:00.000Z,56677806,1,Mouhamed Gueye,1,0,0,0,0,3
0,0,0,0,0,0,0,0,0,0,0,0,0,0,0,0,1037629,2023-10-29T00:00:00.000Z,319,1,Patty Mills,0,0,0,0,0,0
0,0,0,0,0,0,0,0,0,0,0,0,0,0,0,0,1037629,2023-10-29T00:00:00.000Z,56677855,1,Seth Lundy,0,0,0,0,0,0
1,0,0,0,0,0,0,0,0,5,0,1,0,0,0,0,1037629,2023-10-29T00:00:00.000Z,3547297,1,Trent Forrest,0,0,1,1,1,1.5
0,0,0,0,0,0,0,0,0,0,0,0,0,0,0,0,1037629,2023-10-29T00:00:00.000Z,301,1,Wesley Matthews,0,0,0,0,0,0
0,0,1,2,2,2,2,1,1,6,0,0,7,1,0,0,1037629,2023-10-29T00:00:00.000Z,38017733,17,A.J. Green,0,8,8,7,1,8.2
1,0,3,1,0,1,0,0,0,7,1,2,0,4,1,1,1037629,2023-10-29T00:00:00.000Z,56677852,17,Andre Jackson Jr.,1,4,5,1,5,8.3
0,0,0,0,0,0,0,0,0,0,0,0,0,0,0,0,1037629,2023-10-29T00:00:00.000Z,56677854,17,Chris Livingston,0,0,0,0,0,0
0,0,0,0,0,0,0,0,0,0,0,0,0,0,0,0,1037629,2023-10-29T00:00:00.000Z,315,17,Khris Middleton,0,0,0,0,0,0
0,0,0,0,0,0,0,0,0,0,0,0,0,0,0,0,1037629,2023-10-29T00:00:00.000Z,666960,17,Lindell Wigginton,0,0,0,0,0,0
0,0,0,0,0,0,0,0,0,0,0,0,0,0,0,0,1037629,2023-10-29T00:00:00.000Z,666453,17,Marques Bolden,0,0,0,0,0,0
1,0,0,0,0,0,0,2,2,6,0,0,2,0,0,1,1037629,2023-10-29T00:00:00.000Z,284,17,Robin Lopez,0,2,3,3,1,2.5
2,0,0,0,0,1,1,0,0,8,0,2,2,0,1,3,1037629,2023-10-29T00:00:00.000Z,2148,17,Thanasis Antetokounmpo,1,2,4,4,2,5
0,0,0,1,1,2,1,0,0,3,0,0,3,0,0,1,1037629,2023-10-29T00:00:00.000Z,38017691,17,TyTy Washington Jr.,0,3,3,3,0,2
0,0,0,0,0,0,0,0,0,0,0,0,0,0,0,0,1037630,2023-10-29T00:00:00.000Z,192,23,James Harden,0,0,0,0,0,0
0,0,0,0,0,0,0,0,0,0,0,0,0,0,0,0,1037630,2023-10-29T00:00:00.000Z,17554001,23,Javonte Smart,0,0,0,0,0,0
0,0,0,0,0,0,0,0,0,0,0,0,0,0,0,0,1037630,2023-10-29T00:00:00.000Z,56677788,23,Terquavion Smith,0,0,0,0,0,0
0,0,0,0,0,0,0,0,0,0,0,0,0,0,0,0,1037630,2023-10-29T00:00:00.000Z,419,25,Anfernee Simons,0,0,0,0,0,0
2,1,7,0,0,7,3,1,1,20,2,3,7,9,2,0,1037630,2023-10-29T00:00:00.000Z,22,25,Deandre Ayton,3,16,18,9,11,29.8
0,0,0,0,0,0,0,0,0,0,0,0,0,0,0,0,1037630,2023-10-29T00:00:00.000Z,56783340,25,Duop Reath,0,0,0,0,0,0
0,0,0,0,0,0,0,0,0,0,0,0,0,0,0,0,1037630,2023-10-29T00:00:00.000Z,17896120,25,Ish Wainright,0,0,0,0,0,0
1,1,4,3,1,9,4,3,3,24,3,4,12,7,4,2,1037630,2023-10-29T00:00:00.000Z,38017711,25,Jabari Walker,5,19,20,13,8,34.9
1,2,3,4,1,16,5,7,6,28,2,2,17,5,0,2,1037630,2023-10-29T00:00:00.000Z,182,25,Jerami Grant,2,22,23,18,6,28.5
0,0,0,0,0,0,0,0,0,0,0,0,0,0,0,0,1037630,2023-10-29T00:00:00.000Z,47957121,25,Justin Minaya,0,0,0,0,0,0
0,0,0,1,0,1,0,0,0,6,0,1,0,0,1,0,1037630,2023-10-29T00:00:00.000Z,56677791,25,Kris Murray,1,0,0,0,0,3
5,0,4,6,2,16,7,2,2,26,1,2,18,5,1,2,1037630,2023-10-29T00:00:00.000Z,65,25,Malcolm Brogdon,1,23,28,23,10,32.5
0,0,0,2,0,3,1,0,0,11,0,1,2,0,0,0,1037630,2023-10-29T00:00:00.000Z,666923,25,Matisse Thybulle,0,2,2,2,0,2
0,0,0,0,0,0,0,0,0,0,0,0,0,0,0,0,1037630,2023-10-29T00:00:00.000Z,666476,25,Moses Brown,0,0,0,0,0,0
0,0,0,1,0,1,0,0,0,5,0,0,0,0,0,0,1037630,2023-10-29T00:00:00.000Z,56677829,25,Rayan Rupert,0,0,0,0,0,0
2,2,5,0,0,3,2,2,2,26,2,2,6,7,2,1,1037630,2023-10-29T00:00:00.000Z,476,25,Robert Williams III,4,13,15,8,9,28.4
3,1,1,4,0,7,2,0,0,26,0,5,4,1,0,4,1037630,2023-10-29T00:00:00.000Z,56677747,25,Scoot Henderson,1,5,8,7,4,8.7
2,0,4,4,2,13,7,5,4,35,1,3,20,5,0,3,1037630,2023-10-29T00:00:00.000Z,38017690,25,Shaedon Sharpe,0,25,27,22,7,26
1,0,0,1,0,2,0,0,0,5,0,0,0,0,0,1,1037630,2023-10-29T00:00:00.000Z,3547289,25,Skylar Mays,0,0,1,1,1,0.5
2,2,0,5,1,16,5,2,1,28,3,3,12,3,0,0,1037630,2023-10-29T00:00:00.000Z,56677850,25,Toumani Camara,2,15,17,14,5,24.6
1,0,1,0,0,0,0,0,0,5,0,0,0,1,0,1,1037631,2023-10-29T00:00:00.000Z,666511,13,Amir Coffey,0,1,2,1,2,1.7
0,0,0,0,0,0,0,0,0,0,0,0,0,0,0,0,1037631,2023-10-29T00:00:00.000Z,17896022,13,Brandon Boston Jr.,0,0,0,0,0,0
0,1,6,0,0,7,6,6,4,22,2,4,16,8,0,1,1037631,2023-10-29T00:00:00.000Z,493,13,Ivica Zubac,1,24,24,16,8,27.6
0,0,0,0,0,0,0,0,0,0,0,0,0,0,0,0,1037631,2023-10-29T00:00:00.000Z,56677856,13,Jordan Miller,0,0,0,0,0,0
4,0,3,7,3,13,6,7,6,28,0,2,21,3,2,3,1037631,2023-10-29T00:00:00.000Z,274,13,Kawhi Leonard,2,24,28,25,7,33.6
0,1,2,3,1,6,4,2,1,18,0,1,10,2,1,2,1037631,2023-10-29T00:00:00.000Z,3547294,13,Kenyon Martin Jr.,2,12,12,10,2,16.4
1,0,4,2,1,2,1,0,0,5,0,1,3,4,1,0,1037631,2023-10-29T00:00:00.000Z,56677849,13,Kobe Brown,1,7,8,4,5,12.3
1,0,4,0,0,3,2,0,0,21,2,0,4,6,0,0,1037631,2023-10-29T00:00:00.000Z,371,13,Mason Plumlee,0,10,11,5,7,12.7
2,0,0,0,0,0,0,0,0,5,1,0,0,1,0,1,1037631,2023-10-29T00:00:00.000Z,38017725,13,Moussa Diabate,0,1,3,2,3,3.2
1,0,3,8,4,14,7,0,0,21,0,1,18,3,1,4,1037631,2023-10-29T00:00:00.000Z,17896031,13,Nah'Shon Hyland,1,21,22,19,4,22.1
1,0,2,4,0,4,0,0,0,15,0,1,0,2,1,1,1037631,2023-10-29T00:00:00.000Z,33,13,Nicolas Batum,1,2,3,1,3,5.9
1,1,2,5,2,11,5,2,1,19,1,1,13,3,2,0,1037631,2023-10-29T00:00:00.000Z,380,13,Norman Powell,3,16,17,14,4,27.1
5,0,3,7,2,17,8,1,1,28,1,1,19,4,5,1,1037631,2023-10-29T00:00:00.000Z,172,13,Paul George,5,23,28,24,9,45.3
3,1,2,1,0,1,0,0,0,26,1,1,0,3,1,0,1037631,2023-10-29T00:00:00.000Z,108,13,Robert Covington,2,3,6,3,6,14.1
3,1,7,5,3,13,8,3,0,27,1,3,19,8,1,2,1037631,2023-10-29T00:00:00.000Z,472,13,Russell Westbrook,2,27,30,22,11,37.1
1,1,0,1,0,1,0,2,1,7,0,0,1,0,0,1,1037631,2023-10-29T00:00:00.000Z,38017693,27,Blake Wesley,1,1,2,2,1,4.5
1,1,1,4,2,7,4,2,2,17,0,1,12,1,1,0,1037631,2023-10-29T00:00:00.000Z,359,27,Cedi Osman,2,13,14,13,2,20.7
0,0,0,0,0,0,0,0,0,0,0,0,0,0,0,0,1037631,2023-10-29T00:00:00.000Z,56677865,27,Charles Bediako,0,0,0,0,0,0
0,0,0,0,0,0,0,0,0,0,0,0,0,0,0,0,1037631,2023-10-29T00:00:00.000Z,180,27,Devonte' Graham,0,0,0,0,0,0
2,0,3,4,2,6,3,0,0,15,0,3,8,3,0,0,1037631,2023-10-29T00:00:00.000Z,305,27,Doug McDermott,0,11,13,10,5,14.6
0,1,2,2,1,4,1,0,0,7,0,0,3,2,0,1,1037631,2023-10-29T00:00:00.000Z,38017649,27,Julian Champagnie,1,5,5,3,2,7.4
2,0,1,4,2,12,3,1,1,21,0,1,9,1,1,3,1037631,2023-10-29T00:00:00.000Z,38017692,27,Malaki Branham,1,10,12,11,3,13.2
0,0,1,0,0,0,0,0,0,7,1,1,0,2,1,0,1037631,2023-10-29T00:00:00.000Z,17896059,27,Sandro Mamukelashvili,1,2,2,0,2,5.4
4,0,2,2,1,4,1,2,2,20,0,3,5,2,1,4,1037631,2023-10-29T00:00:00.000Z,3547274,27,Tre Jones,1,7,11,9,6,12.4
0,0,0,0,0,0,0,0,0,0,0,0,0,0,0,0,1037632,2023-10-29T00:00:00.000Z,56677867,14,Alex Fudge,0,0,0,0,0,0
0,0,1,1,0,2,0,0,0,5,0,0,0,1,0,0,1037632,2023-10-29T00:00:00.000Z,666860,14,Cameron Reddish,0,1,1,0,1,1.2
1,0,5,2,2,3,3,3,3,14,0,0,11,5,0,0,1037632,2023-10-29T00:00:00.000Z,486,14,Christian Wood,0,16,17,12,6,18.5
0,0,0,0,0,0,0,0,0,0,0,0,0,0,0,0,1037632,2023-10-29T00:00:00.000Z,56677738,14,Colin Castleton,0,0,0,0,0,0
9,0,3,5,1,13,5,7,6,41,0,4,17,3,0,0,1037632,2023-10-29T00:00:00.000Z,405,14,D'Angelo Russell,0,20,29,26,12,34.1
0,0,0,0,0,0,0,0,0,0,0,0,0,0,0,0,1037632,2023-10-29T00:00:00.000Z,56677868,14,D'Moi Hodge,0,0,0,0,0,0
2,0,0,2,0,3,1,0,0,32,0,4,2,0,1,0,1037632,2023-10-29T00:00:00.000Z,1603383,14,Gabe Vincent,1,2,4,4,2,8
0,0,0,0,0,0,0,0,0,0,0,0,0,0,0,0,1037632,2023-10-29T00:00:00.000Z,56677835,14,Jalen Hood-Schifino,0,0,0,0,0,0
0,0,0,0,0,0,0,0,0,0,0,0,0,0,0,0,1037632,2023-10-29T00:00:00.000Z,457,14,Jarred Vanderbilt,0,0,0,0,0,0
0,0,2,0,0,1,1,2,2,7,0,1,4,2,0,0,1037632,2023-10-29T00:00:00.000Z,666626,14,Jaxson Hayes,0,6,6,4,2,6.4
0,0,0,0,0,0,0,0,0,0,0,0,0,0,0,0,1037632,2023-10-29T00:00:00.000Z,38017697,14,Max Christie,0,0,0,0,0,0
0,0,0,0,0,0,0,0,0,0,0,0,0,0,0,0,1037632,2023-10-29T00:00:00.000Z,56677836,14,Maxwell Lewis,0,0,0,0,0,0
1,0,4,4,2,6,3,4,3,17,2,1,11,6,0,0,1037632,2023-10-29T00:00:00.000Z,666609,14,Rui Hachimura,0,17,18,12,7,19.7
0,0,0,0,0,0,0,0,0,0,0,0,0,0,0,0,1037632,2023-10-29T00:00:00.000Z,273,26,Alex Len,0,0,0,0,0,0
0,0,2,2,0,4,2,0,0,14,0,3,4,2,1,0,1037632,2023-10-29T00:00:00.000Z,17896030,26,Chris Duarte,1,6,6,4,2,9.4
0,0,0,0,0,0,0,0,0,0,0,0,0,0,0,0,1037632,2023-10-29T00:00:00.000Z,56677845,26,Colby Jones,0,0,0,0,0,0
2,0,2,2,1,4,2,0,0,15,0,4,5,2,0,0,1037632,2023-10-29T00:00:00.000Z,17553994,26,Davion Mitchell,0,7,9,7,4,10.4
8,1,3,8,3,24,14,8,6,34,1,5,37,4,1,3,1037632,2023-10-29T00:00:00.000Z,161,26,De'Aaron Fox,2,41,49,45,12,56.8
5,0,14,1,1,8,5,3,1,34,1,6,12,15,1,3,1037632,2023-10-29T00:00:00.000Z,406,26,Domantas Sabonis,1,27,32,17,20,37.5
2,1,2,4,0,9,3,2,2,39,0,1,8,2,0,0,1037632,2023-10-29T00:00:00.000Z,30,26,Harrison Barnes,1,10,12,10,4,16.4
0,1,0,0,0,2,2,0,0,15,0,1,4,0,1,1,1037632,2023-10-29T00:00:00.000Z,306,26,JaVale McGee,2,4,4,4,0,9
5,1,5,9,3,14,6,3,2,33,3,4,17,8,2,1,1037632,2023-10-29T00:00:00.000Z,38017688,26,Keegan Murray,3,25,30,22,13,42.1
0,0,0,0,0,0,0,0,0,0,0,0,0,0,0,0,1037632,2023-10-29T00:00:00.000Z,38017714,26,Keon Ellis,0,0,0,0,0,0
4,2,7,7,3,12,4,2,1,37,0,3,12,7,0,0,1037632,2023-10-29T00:00:00.000Z,221,26,Kevin Huerter,2,19,23,16,11,32.4
0,0,0,0,0,0,0,0,0,0,0,0,0,0,0,0,1037633,2023-10-30T00:00:00.000Z,9051997,3,Armoni Brooks,0,0,0,0,0,0
8,1,7,0,0,6,5,2,1,35,3,1,11,10,0,2,1037633,2023-10-30T00:00:00.000Z,417,3,Ben Simmons,1,21,29,19,18,36
0,0,0,0,0,0,0,0,0,0,0,0,0,0,0,0,1037633,2023-10-30T00:00:00.000Z,666679,3,Cameron Johnson,0,0,0,0,0,0
0,0,0,0,0,0,0,0,0,0,0,0,0,0,0,0,1037633,2023-10-30T00:00:00.000Z,56677841,3,Dariq Whitehead,0,0,0,0,0,0
1,1,4,0,0,8,5,3,1,10,4,5,11,8,0,1,1037633,2023-10-30T00:00:00.000Z,17896038,3,Day'Ron Sharpe,1,19,20,12,9,24.1
2,0,3,1,0,4,1,2,1,14,1,2,3,4,1,1,1037633,2023-10-30T00:00:00.000Z,421,3,Dennis Smith Jr.,1,7,9,5,6,12.8
0,0,0,0,0,0,0,0,0,0,0,0,0,0,0,0,1037633,2023-10-30T00:00:00.000Z,174,3,Harry Giles III,0,0,0,0,0,0
0,0,0,0,0,0,0,0,0,0,0,0,0,0,0,0,1037633,2023-10-30T00:00:00.000Z,56677722,3,Jalen Wilson,0,0,0,0,0,0
4,1,5,7,3,13,6,6,4,29,0,1,19,5,1,0,1037633,2023-10-30T00:00:00.000Z,464,3,Lonnie Walker IV,2,24,28,23,9,37
0,0,0,0,0,0,0,0,0,0,0,0,0,0,0,0,1037633,2023-10-30T00:00:00.000Z,666508,3,Nicolas Claxton,0,0,0,0,0,0
0,0,0,0,0,0,0,0,0,0,0,0,0,0,0,0,1037633,2023-10-30T00:00:00.000Z,56677843,3,Noah Clowney,0,0,0,0,0,0
0,2,2,6,2,8,3,0,0,32,0,1,8,2,0,0,1037633,2023-10-30T00:00:00.000Z,351,3,Royce O'Neale,2,10,10,8,2,16.4
3,0,1,3,1,6,2,0,0,13,0,2,5,1,0,1,1037633,2023-10-30T00:00:00.000Z,130,3,Spencer Dinwiddie,0,6,9,8,4,9.7
0,0,0,0,0,0,0,0,0,0,0,0,0,0,0,0,1037633,2023-10-30T00:00:00.000Z,17896058,3,Trendon Watford,0,0,0,0,0,0
0,0,0,0,0,0,0,0,0,0,0,0,0,0,0,0,1037633,2023-10-30T00:00:00.000Z,56677848,4,Amari Bailey,0,0,0,0,0,0
2,1,5,5,2,16,7,6,6,36,4,3,22,9,0,0,1037633,2023-10-30T00:00:00.000Z,56677823,4,Brandon Miller,1,31,33,24,11,38.8
0,0,0,0,0,0,0,0,0,0,0,0,0,0,0,0,1037633,2023-10-30T00:00:00.000Z,38017708,4,Bryce McGowens,0,0,0,0,0,0
5,1,0,2,2,11,6,1,1,31,0,4,15,0,2,0,1037633,2023-10-30T00:00:00.000Z,204,4,Gordon Hayward,3,15,20,20,5,31.5
0,0,0,0,0,0,0,0,0,0,0,0,0,0,0,0,1037633,2023-10-30T00:00:00.000Z,17896037,4,James Bouknight,0,0,0,0,0,0
3,0,2,4,1,6,3,0,0,19,0,1,7,2,0,1,1037633,2023-10-30T00:00:00.000Z,18678001,4,JT Thor,0,9,12,10,5,12.9
8,0,3,6,0,12,3,2,2,22,0,6,8,3,2,3,1037633,2023-10-30T00:00:00.000Z,3547239,4,LaMelo Ball,2,11,19,16,11,26.6
0,0,0,0,0,0,0,0,0,0,0,0,0,0,0,0,1037633,2023-10-30T00:00:00.000Z,56677866,4,Leaky Black,0,0,0,0,0,0
1,0,6,0,0,8,8,2,2,23,1,1,18,7,0,1,1037633,2023-10-30T00:00:00.000Z,38017698,4,Mark Williams,0,25,26,19,8,26.9
0,0,0,0,0,0,0,0,0,0,0,0,0,0,0,0,1037633,2023-10-30T00:00:00.000Z,62,4,Miles Bridges,0,0,0,0,0,0
1,2,2,0,0,1,1,2,2,13,0,2,4,2,1,1,1037633,2023-10-30T00:00:00.000Z,3547282,4,Nick Richards,3,6,7,5,3,15.9
0,0,0,0,0,0,0,0,0,0,0,0,0,0,0,0,1037633,2023-10-30T00:00:00.000Z,56677846,4,Nick Smith Jr.,0,0,0,0,0,0
2,0,9,3,1,14,7,1,0,35,3,4,15,12,0,1,1037633,2023-10-30T00:00:00.000Z,666950,4,P.J. Washington,0,27,29,17,14,31.4
9,1,3,6,2,19,10,1,1,41,0,2,23,3,2,2,1037633,2023-10-30T00:00:00.000Z,403,4,Terry Rozier,3,26,35,32,12,47.1
2,0,1,5,0,9,2,5,5,20,0,0,9,1,1,0,1037633,2023-10-30T00:00:00.000Z,3547253,4,Theo Maledon,1,10,12,11,3,16.2
3,1,3,2,1,5,3,2,1,26,1,1,8,4,0,3,1037634,2023-10-30T00:00:00.000Z,89,5,Alex Caruso,1,12,15,11,7,17.3
2,0,1,0,0,4,2,2,1,14,2,0,5,3,1,1,1037634,2023-10-30T00:00:00.000Z,137,5,Andre Drummond,1,8,10,7,5,13.6
0,1,1,1,0,1,0,0,0,10,0,2,0,1,1,0,1037634,2023-10-30T00:00:00.000Z,17895983,5,Ayo Dosunmu,2,1,1,0,1,7.2
3,0,2,2,1,6,3,0,0,25,0,4,7,2,1,1,1037634,2023-10-30T00:00:00.000Z,666956,5,Coby White,1,9,12,10,5,15.9
0,0,0,0,0,0,0,0,0,0,0,0,0,0,0,0,1037634,2023-10-30T00:00:00.000Z,38017719,5,Dalen Terry,0,0,0,0,0,0
4,1,1,1,0,19,6,8,8,35,1,2,20,2,0,0,1037634,2023-10-30T00:00:00.000Z,125,5,DeMar DeRozan,1,22,26,24,6,31.4
2,1,2,1,1,7,5,0,0,18,0,1,11,2,1,3,1037634,2023-10-30T00:00:00.000Z,87,5,Jevon Carter,2,13,15,13,4,19.4
0,0,0,0,0,0,0,0,0,0,0,0,0,0,0,0,1037634,2023-10-30T00:00:00.000Z,56677857,5,Julian Phillips,0,0,0,0,0,0
0,0,0,0,0,0,0,0,0,0,0,0,0,0,0,0,1037634,2023-10-30T00:00:00.000Z,27,5,Lonzo Ball,0,0,0,0,0,0
3,0,12,1,0,19,10,6,4,34,5,3,24,17,1,1,1037634,2023-10-30T00:00:00.000Z,460,5,Nikola Vucevic,1,41,44,27,20,50.9
0,0,0,0,0,0,0,0,0,0,0,0,0,0,0,0,1037634,2023-10-30T00:00:00.000Z,56677874,5,Onuralp Bitim,0,0,0,0,0,0
0,1,4,2,1,6,3,2,2,22,0,0,9,4,1,1,1037634,2023-10-30T00:00:00.000Z,3547248,5,Patrick Williams,2,13,13,9,4,18.8
1,1,3,1,1,3,2,0,0,20,1,3,5,4,2,2,1037634,2023-10-30T00:00:00.000Z,110,5,Torrey Craig,3,9,10,6,5,18.3
1,0,5,6,1,17,6,11,10,36,0,1,23,5,0,1,1037634,2023-10-30T00:00:00.000Z,268,5,Zach LaVine,0,28,29,24,6,29.5
3,2,4,4,1,4,1,2,2,27,0,6,5,4,0,0,1037634,2023-10-30T00:00:00.000Z,3547250,12,Aaron Nesmith,2,9,12,8,7,20.3
0,0,0,0,0,0,0,0,0,0,0,0,0,0,0,0,1037634,2023-10-30T00:00:00.000Z,56677861,12,Ben Sheppard,0,0,0,0,0,0
4,0,2,8,3,12,4,0,0,19,3,0,11,5,0,2,1037634,2023-10-30T00:00:00.000Z,210,12,Buddy Hield,0,16,20,15,9,21
0,0,0,0,0,0,0,0,0,0,0,0,0,0,0,0,1037634,2023-10-30T00:00:00.000Z,439,12,Daniel Theis,0,0,0,0,0,0
0,0,0,0,0,0,0,0,0,0,0,0,0,0,0,0,1037634,2023-10-30T00:00:00.000Z,17896035,12,Isaiah Jackson,0,0,0,0,0,0
0,0,0,0,0,0,0,0,0,0,0,0,0,0,0,0,1037634,2023-10-30T00:00:00.000Z,56677794,12,Isaiah Wong,0,0,0,0,0,0
0,1,2,2,0,7,4,0,0,16,0,3,8,2,1,1,1037634,2023-10-30T00:00:00.000Z,3547264,12,Jalen Smith,2,10,10,8,2,15.4
0,0,0,0,0,0,0,0,0,0,0,0,0,0,0,0,1037634,2023-10-30T00:00:00.000Z,56677832,12,Jarace Walker,0,0,0,0,0,0
0,0,0,0,0,0,0,0,0,0,0,0,0,0,0,0,1037634,2023-10-30T00:00:00.000Z,3547207,12,Jordan Nwora,0,0,0,0,0,0
0,0,0,0,0,0,0,0,0,0,0,0,0,0,0,0,1037634,2023-10-30T00:00:00.000Z,38017701,12,Kendall Brown,0,0,0,0,0,0
0,0,0,0,0,0,0,0,0,0,0,0,0,0,0,0,1037634,2023-10-30T00:00:00.000Z,56677778,12,Oscar Tshiebwe,0,0,0,0,0,0
0,0,0,0,0,0,0,0,0,0,0,0,0,0,0,0,1037634,2023-10-30T00:00:00.000Z,304,12,T.J. McConnell,0,0,0,0,0,0
1,0,1,3,0,9,4,0,0,15,4,1,8,5,2,0,1037635,2023-10-30T00:00:00.000Z,219,2,Al Horford,2,13,14,9,6,21.5
1,0,0,1,0,3,1,0,0,10,2,1,2,2,0,1,1037635,2023-10-30T00:00:00.000Z,17896094,2,Dalano Banton,0,4,5,3,3,4.9
8,1,0,2,1,3,2,0,0,24,1,1,5,1,2,2,1037635,2023-10-30T00:00:00.000Z,473,2,Derrick White,3,6,14,13,9,25.2
2,1,6,13,8,24,13,4,2,31,0,3,36,6,3,0,1037635,2023-10-30T00:00:00.000Z,70,2,Jaylen Brown,4,42,44,38,8,58.2
3,0,6,9,4,21,14,1,1,28,0,2,33,6,0,2,1037635,2023-10-30T00:00:00.000Z,434,2,Jayson Tatum,0,39,42,36,9,42.7
0,0,0,0,0,0,0,0,0,0,0,0,0,0,0,0,1037635,2023-10-30T00:00:00.000Z,38017707,2,JD Davison,0,0,0,0,0,0
0,0,0,0,0,0,0,0,0,0,0,0,0,0,0,0,1037635,2023-10-30T00:00:00.000Z,56677864,2,Jordan Walsh,0,0,0,0,0,0
3,2,4,3,1,7,4,2,2,27,1,1,11,5,1,1,1037635,2023-10-30T00:00:00.000Z,214,2,Jrue Holiday,3,16,19,14,8,29.5
3,1,6,2,1,9,7,0,0,24,0,2,15,6,0,2,1037635,2023-10-30T00:00:00.000Z,378,2,Kristaps Porzingis,1,21,24,18,9,27.7
0,0,0,1,1,2,2,0,0,5,2,1,5,2,0,3,1037635,2023-10-30T00:00:00.000Z,3547279,2,Lamar Stevens,0,7,7,5,2,4.4
1,0,1,0,0,0,0,0,0,11,0,1,0,1,0,2,1037635,2023-10-30T00:00:00.000Z,261,2,Luke Kornet,0,1,2,1,2,0.7
0,0,0,0,0,0,0,0,0,0,0,0,0,0,0,0,1037635,2023-10-30T00:00:00.000Z,3547295,2,Nathan Knight,0,0,0,0,0,0
0,0,0,0,0,0,0,0,0,0,0,0,0,0,0,0,1037635,2023-10-30T00:00:00.000Z,17553967,2,Neemias Queta,0,0,0,0,0,0
1,0,1,2,0,4,0,0,0,10,1,2,0,2,1,0,1037635,2023-10-30T00:00:00.000Z,666468,2,Oshae Brissett,1,2,3,1,3,6.9
6,0,6,6,0,8,0,0,0,25,1,3,0,7,1,4,1037635,2023-10-30T00:00:00.000Z,3547276,2,Payton Pritchard,1,7,13,6,13,16.4
1,1,5,9,2,10,3,0,0,25,3,3,8,8,0,1,1037635,2023-10-30T00:00:00.000Z,17896060,2,Sam Hauser,1,16,17,9,9,21.1
1,0,0,2,1,2,1,0,0,5,0,0,3,0,1,0,1037635,2023-10-30T00:00:00.000Z,338,2,Svi Mykhailiuk,1,3,4,4,1,7.5
1,0,2,0,0,3,1,4,3,10,0,2,5,2,0,0,1037635,2023-10-30T00:00:00.000Z,3547302,30,Anthony Gill,0,7,8,6,3,8.9
0,0,2,6,3,6,3,2,0,24,0,1,9,2,0,2,1037635,2023-10-30T00:00:00.000Z,17896045,30,Corey Kispert,0,11,11,9,2,9.4
0,0,0,0,0,0,0,0,0,0,0,0,0,0,0,0,1037635,2023-10-30T00:00:00.000Z,666577,30,Daniel Gafford,0,0,0,0,0,0
2,0,2,2,0,5,1,2,1,16,0,0,3,2,1,1,1037635,2023-10-30T00:00:00.000Z,167,30,Danilo Gallinari,1,5,7,5,4,10.4
2,0,2,0,0,2,0,2,1,11,0,0,1,2,0,0,1037635,2023-10-30T00:00:00.000Z,487,30,Delon Wright,0,3,5,3,4,6.4
1,1,3,1,1,5,5,4,3,12,3,0,14,6,1,0,1037635,2023-10-30T00:00:00.000Z,17896106,30,Eugene Omoruyi,2,20,21,15,7,28.7
1,0,0,2,0,2,0,0,0,6,0,0,0,0,0,1,1037635,2023-10-30T00:00:00.000Z,18677954,30,Jared Butler,0,0,1,1,1,0.5
0,0,0,0,0,0,0,0,0,0,0,0,0,0,0,0,1037635,2023-10-30T00:00:00.000Z,38124126,30,John Butler Jr.,0,0,0,0,0,0
0,0,1,0,0,4,2,2,1,16,1,2,5,2,0,2,1037635,2023-10-30T00:00:00.000Z,38017687,30,Johnny Davis,0,7,7,5,2,5.4
4,0,5,6,3,15,9,0,0,26,0,0,21,5,0,2,1037635,2023-10-30T00:00:00.000Z,265,30,Kyle Kuzma,0,26,30,25,9,31
0,0,0,0,0,0,0,0,0,0,0,0,0,0,0,0,1037635,2023-10-30T00:00:00.000Z,414,30,Landry Shamet,0,0,0,0,0,0
0,0,0,0,0,0,0,0,0,0,0,0,0,0,0,0,1037635,2023-10-30T00:00:00.000Z,337,30,Mike Muscala,0,0,0,0,0,0
1,0,0,1,0,1,0,0,0,5,0,0,0,0,0,0,1037635,2023-10-30T00:00:00.000Z,38017704,30,Patrick Baldwin Jr.,0,0,1,1,1,1.5
3,0,0,0,0,2,0,8,7,12,1,1,7,1,4,1,1037635,2023-10-30T00:00:00.000Z,38017712,30,Ryan Rollins,4,8,11,10,4,23.7
7,0,3,4,1,9,5,0,0,27,0,0,11,3,1,2,1037635,2023-10-30T00:00:00.000Z,249,30,Tyus Jones,1,14,21,18,10,26.1
1,0,0,1,1,1,1,0,0,6,0,0,3,0,0,0,1037636,2023-10-30T00:00:00.000Z,38017689,1,AJ Griffin,0,3,4,4,1,4.5
4,0,1,7,2,10,3,0,0,21,0,1,8,1,1,1,1037636,2023-10-30T00:00:00.000Z,53,1,Bogdan Bogdanovic,1,9,13,12,5,17.2
0,0,0,0,0,0,0,0,0,1,0,0,0,0,0,0,1037636,2023-10-30T00:00:00.000Z,666564,1,Bruno Fernando,0,0,0,0,0,0
1,5,4,0,0,3,0,2,2,23,1,3,2,5,0,1,1037636,2023-10-30T00:00:00.000Z,83,1,Clint Capela,5,7,8,3,6,23.5
2,0,4,5,3,10,6,2,1,30,0,0,16,4,1,0,1037636,2023-10-30T00:00:00.000Z,666656,1,De'Andre Hunter,1,20,22,18,6,26.8
5,0,7,5,3,24,17,4,4,40,0,1,41,7,2,3,1037636,2023-10-30T00:00:00.000Z,334,1,Dejounte Murray,2,48,53,46,12,59.9
0,0,0,0,0,0,0,0,0,0,0,0,0,0,0,0,1037636,2023-10-30T00:00:00.000Z,666754,1,Garrison Mathews,0,0,0,0,0,0
3,1,4,2,1,7,5,1,1,33,1,3,12,5,1,2,1037636,2023-10-30T00:00:00.000Z,17896040,1,Jalen Johnson,2,17,20,15,8,26.5
0,0,0,0,0,1,0,0,0,1,0,0,0,0,0,0,1037636,2023-10-30T00:00:00.000Z,56677838,1,Kobe Bufkin,0,0,0,0,0,0
0,0,0,0,0,0,0,0,0,1,0,0,0,0,0,0,1037636,2023-10-30T00:00:00.000Z,56677806,1,Mouhamed Gueye,0,0,0,0,0,0
3,0,5,0,0,3,3,4,4,24,2,1,10,7,0,0,1037636,2023-10-30T00:00:00.000Z,3547244,1,Onyeka Okongwu,0,17,20,13,10,22.9
1,1,6,3,3,5,4,0,0,25,0,2,11,6,0,1,1037636,2023-10-30T00:00:00.000Z,3547256,1,Saddiq Bey,1,17,18,12,7,21.7
8,0,1,7,1,22,9,5,5,35,0,1,24,1,1,1,1037636,2023-10-30T00:00:00.000Z,490,1,Trae Young,1,25,33,32,9,39.2
0,0,0,0,0,0,0,0,0,0,0,0,0,0,0,0,1037636,2023-10-30T00:00:00.000Z,3547297,1,Trent Forrest,0,0,0,0,0,0
0,0,0,0,0,0,0,0,0,0,0,0,0,0,0,0,1037636,2023-10-30T00:00:00.000Z,56677782,18,Leonard Miller,0,0,0,0,0,0
2,0,0,3,1,3,1,2,0,13,0,1,3,0,0,1,1037636,2023-10-30T00:00:00.000Z,666400,18,Nickeil Alexander-Walker,0,3,5,5,2,5
0,0,0,0,0,0,0,0,0,0,0,0,0,0,0,0,1037636,2023-10-30T00:00:00.000Z,38017700,18,Wendell Moore Jr.,0,0,0,0,0,0
0,0,0,0,0,0,0,0,0,0,0,0,0,0,0,0,1037637,2023-10-30T00:00:00.000Z,419,25,Anfernee Simons,0,0,0,0,0,0
2,2,16,0,0,9,5,0,0,32,7,1,10,23,1,1,1037637,2023-10-30T00:00:00.000Z,22,25,Deandre Ayton,3,33,35,12,25,48.6
0,0,0,0,0,0,0,0,0,0,0,0,0,0,0,0,1037637,2023-10-30T00:00:00.000Z,56783340,25,Duop Reath,0,0,0,0,0,0
0,0,0,0,0,0,0,0,0,0,0,0,0,0,0,0,1037637,2023-10-30T00:00:00.000Z,17896120,25,Ish Wainright,0,0,0,0,0,0
0,1,3,0,0,3,2,0,0,16,0,2,4,3,0,1,1037637,2023-10-30T00:00:00.000Z,38017711,25,Jabari Walker,1,7,7,4,3,9.6
0,1,5,8,2,18,8,4,4,37,1,2,22,6,1,2,1037637,2023-10-30T00:00:00.000Z,182,25,Jerami Grant,2,28,28,22,6,33.2
0,0,0,0,0,0,0,0,0,0,0,0,0,0,0,0,1037637,2023-10-30T00:00:00.000Z,47957121,25,Justin Minaya,0,0,0,0,0,0
0,0,0,0,0,0,0,0,0,0,0,0,0,0,0,0,1037637,2023-10-30T00:00:00.000Z,56677791,25,Kris Murray,0,0,0,0,0,0
5,0,2,7,3,21,9,1,0,29,1,2,21,3,0,1,1037637,2023-10-30T00:00:00.000Z,65,25,Malcolm Brogdon,0,24,29,26,8,31.1
2,0,0,4,3,4,3,0,0,19,0,1,9,0,0,0,1037637,2023-10-30T00:00:00.000Z,666923,25,Matisse Thybulle,0,9,11,11,2,12
0,0,0,0,0,0,0,0,0,0,0,0,0,0,0,0,1037637,2023-10-30T00:00:00.000Z,666476,25,Moses Brown,0,0,0,0,0,0
0,0,0,0,0,0,0,0,0,0,0,0,0,0,0,0,1037637,2023-10-30T00:00:00.000Z,56677829,25,Rayan Rupert,0,0,0,0,0,0
0,0,0,0,0,0,0,0,0,0,0,0,0,0,0,0,1037637,2023-10-30T00:00:00.000Z,476,25,Robert Williams III,0,0,0,0,0,0
7,0,4,6,0,12,4,4,3,35,0,6,11,4,2,4,1037637,2023-10-30T00:00:00.000Z,56677747,25,Scoot Henderson,2,15,22,18,11,28.3
3,2,3,5,2,10,4,4,4,38,2,3,14,5,1,4,1037637,2023-10-30T00:00:00.000Z,38017690,25,Shaedon Sharpe,3,19,22,17,8,29.5
1,0,0,3,1,4,2,0,0,11,0,0,5,0,1,0,1037637,2023-10-30T00:00:00.000Z,3547289,25,Skylar Mays,1,5,6,6,1,9.5
0,1,5,2,0,4,1,2,1,23,2,2,3,7,0,1,1037637,2023-10-30T00:00:00.000Z,56677850,25,Toumani Camara,1,10,10,3,7,13.4
1,1,4,0,0,4,1,2,2,17,3,2,4,7,0,1,1037637,2023-10-30T00:00:00.000Z,58,28,Chris Boucher,1,11,12,5,8,15.9
0,0,0,0,0,0,0,0,0,0,0,0,0,0,0,0,1037637,2023-10-30T00:00:00.000Z,38017710,28,Christian Koloko,0,0,0,0,0,0
8,0,1,3,1,10,4,1,1,32,0,1,10,1,1,1,1037637,2023-10-30T00:00:00.000Z,409,28,Dennis Schroder,1,11,19,18,9,25.2
0,0,0,0,0,0,0,0,0,0,0,0,0,0,0,0,1037637,2023-10-30T00:00:00.000Z,436,28,Garrett Temple,0,0,0,0,0,0
2,0,1,1,0,7,1,3,1,19,0,2,3,1,1,0,1037637,2023-10-30T00:00:00.000Z,3089,28,Gary Trent Jr.,1,4,6,5,3,10.2
0,0,5,3,0,7,2,0,0,21,1,3,4,6,2,0,1037637,2023-10-30T00:00:00.000Z,56677828,28,Gradey Dick,2,10,10,4,6,17.2
1,1,5,0,0,8,6,3,2,29,5,3,14,10,0,2,1037637,2023-10-30T00:00:00.000Z,373,28,Jakob Poeltl,1,24,25,15,11,28.5
1,0,0,1,0,1,0,0,0,5,0,1,0,0,0,0,1037637,2023-10-30T00:00:00.000Z,666762,28,Jalen McDaniels,0,0,1,1,1,1.5
0,0,0,0,0,0,0,0,0,0,0,0,0,0,0,0,1037637,2023-10-30T00:00:00.000Z,56677805,28,Javon Freeman-Liberty,0,0,0,0,0,0
0,0,1,2,0,5,3,0,0,15,0,1,6,1,1,1,1037637,2023-10-30T00:00:00.000Z,3547275,28,Malachi Flynn,1,7,7,6,1,9.2
0,0,0,0,0,0,0,0,0,0,0,0,0,0,0,0,1037637,2023-10-30T00:00:00.000Z,56677869,28,Markquis Nowell,0,0,0,0,0,0
1,1,3,9,2,12,4,0,0,30,0,0,10,3,2,2,1037637,2023-10-30T00:00:00.000Z,18,28,OG Anunoby,3,13,14,11,4,22.1
0,0,0,0,0,0,0,0,0,0,0,0,0,0,0,0,1037637,2023-10-30T00:00:00.000Z,376,28,Otto Porter Jr.,0,0,0,0,0,0
3,0,5,6,0,21,9,3,2,35,1,1,20,6,1,0,1037637,2023-10-30T00:00:00.000Z,416,28,Pascal Siakam,1,26,29,23,9,34.7
0,0,0,0,0,0,0,0,0,0,0,0,0,0,0,0,1037637,2023-10-30T00:00:00.000Z,3547249,28,Precious Achiuwa,0,0,0,0,0,0
0,0,0,0,0,0,0,0,0,0,0,0,0,0,0,0,1037637,2023-10-30T00:00:00.000Z,38017717,28,Ron Harper Jr.,0,0,0,0,0,0
2,1,8,4,1,19,8,3,3,37,4,3,20,12,2,4,1037637,2023-10-30T00:00:00.000Z,17896055,28,Scottie Barnes,3,32,34,22,14,42.4
0,0,0,0,0,0,0,0,0,0,0,0,0,0,0,0,1037637,2023-10-30T00:00:00.000Z,489,28,Thaddeus Young,0,0,0,0,0,0
2,0,4,0,0,3,1,0,0,6,0,0,2,4,0,0,1037638,2023-10-30T00:00:00.000Z,151,7,Dante Exum,0,6,8,4,6,9.8
0,1,5,0,0,2,1,0,0,14,1,5,2,6,0,0,1037638,2023-10-30T00:00:00.000Z,56677840,7,Dereck Lively II,1,8,8,2,6,12.2
0,0,4,6,4,10,7,6,4,27,0,0,22,4,0,1,1037638,2023-10-30T00:00:00.000Z,247,7,Derrick Jones Jr.,0,26,26,22,4,25.8
0,4,3,0,0,0,0,0,0,12,2,1,0,5,0,1,1037638,2023-10-30T00:00:00.000Z,379,7,Dwight Powell,4,5,5,0,5,17
2,0,2,8,4,8,4,4,3,31,1,1,15,3,0,1,1037638,2023-10-30T00:00:00.000Z,666965,7,Grant Williams,0,18,20,17,5,20.6
1,0,0,4,2,6,2,0,0,10,0,1,6,0,0,1,1037638,2023-10-30T00:00:00.000Z,38017679,7,Jaden Hardy,0,6,7,7,1,6.5
3,0,1,4,2,10,5,0,0,34,1,0,12,2,1,1,1037638,2023-10-30T00:00:00.000Z,3547258,7,Josh Green,1,14,17,15,5,20.9
12,1,12,12,6,22,11,10,7,40,0,4,35,12,1,6,1037638,2023-10-30T00:00:00.000Z,132,7,Luka Doncic,2,47,59,47,24,67.4
2,0,4,3,1,4,2,2,2,22,1,2,7,5,1,2,1037638,2023-10-30T00:00:00.000Z,257,7,Maxi Kleber,1,12,14,9,7,17
2,1,2,3,1,5,1,0,0,15,0,2,3,2,1,1,1037638,2023-10-30T00:00:00.000Z,114,7,Seth Curry,2,5,7,5,4,13.4
0,0,5,7,3,14,8,2,2,29,0,1,21,5,0,1,1037638,2023-10-30T00:00:00.000Z,191,7,Tim Hardaway Jr.,0,26,26,21,5,26
0,0,0,0,0,0,0,0,0,0,0,0,0,0,0,0,1037638,2023-10-30T00:00:00.000Z,666505,15,Brandon Clarke,0,0,0,0,0,0
0,0,0,0,0,1,0,0,0,1,0,0,0,0,0,0,1037638,2023-10-30T00:00:00.000Z,48248287,15,Jacob Gilyard,0,0,0,0,0,0
0,0,0,0,0,0,0,0,0,0,0,0,0,0,0,0,1037638,2023-10-30T00:00:00.000Z,254,15,Luke Kennard,0,0,0,0,0,0
0,0,0,0,0,0,0,0,0,0,0,0,0,0,0,0,1037638,2023-10-30T00:00:00.000Z,17896067,15,Santi Aldama,0,0,0,0,0,0
0,0,0,0,0,0,0,0,0,0,0,0,0,0,0,0,1037638,2023-10-30T00:00:00.000Z,3,15,Steven Adams,0,0,0,0,0,0
3,1,1,5,2,9,3,0,0,23,1,2,8,2,1,0,1037639,2023-10-30T00:00:00.000Z,56677785,16,Jaime Jaquez Jr.,2,10,13,11,5,20.9
0,0,0,0,0,0,0,0,0,0,0,0,0,0,0,0,1037639,2023-10-30T00:00:00.000Z,38017734,16,Jamal Cain,0,0,0,0,0,0
4,1,2,2,1,11,4,4,4,29,2,0,13,4,0,1,1037639,2023-10-30T00:00:00.000Z,79,16,Jimmy Butler,1,17,21,17,8,25.8
3,0,5,5,1,6,1,0,0,18,0,1,3,5,0,2,1037639,2023-10-30T00:00:00.000Z,285,16,Kevin Love,0,8,11,6,8,11.5
4,0,4,5,2,6,3,0,0,28,0,4,8,4,2,2,1037639,2023-10-30T00:00:00.000Z,286,16,Kyle Lowry,2,12,16,12,8,22.8
7,0,5,1,1,7,4,2,2,26,2,4,11,7,1,3,1037639,2023-10-30T00:00:00.000Z,39398582,16,Orlando Robinson,1,18,25,18,14,29.9
0,0,0,0,0,0,0,0,0,0,0,0,0,0,0,0,1037639,2023-10-30T00:00:00.000Z,3547257,16,R.J. Hampton,0,0,0,0,0,0
0,0,2,1,0,7,4,2,2,22,0,0,10,2,2,1,1037639,2023-10-30T00:00:00.000Z,74,16,Thomas Bryant,2,12,12,10,2,17.4
3,0,7,5,2,21,12,10,9,42,1,1,35,8,1,3,1037639,2023-10-30T00:00:00.000Z,666633,16,Tyler Herro,1,43,46,38,11,49.1
2,0,0,3,0,4,0,0,0,15,0,3,0,0,0,0,1037639,2023-10-30T00:00:00.000Z,38017733,17,A.J. Green,0,0,2,2,2,3
0,0,0,0,0,0,0,0,0,0,0,0,0,0,0,0,1037639,2023-10-30T00:00:00.000Z,56677852,17,Andre Jackson Jr.,0,0,0,0,0,0
2,1,6,2,0,10,7,2,2,19,2,3,16,8,2,0,1037639,2023-10-30T00:00:00.000Z,377,17,Bobby Portis,3,24,26,18,10,37.6
3,1,4,4,1,9,5,0,0,29,3,3,11,7,1,2,1037639,2023-10-30T00:00:00.000Z,283,17,Brook Lopez,2,18,21,14,10,27.9
0,0,0,4,3,5,4,0,0,13,1,0,11,1,0,1,1037639,2023-10-30T00:00:00.000Z,368,17,Cameron Payne,0,12,12,11,1,11.2
0,0,0,0,0,0,0,0,0,0,0,0,0,0,0,0,1037639,2023-10-30T00:00:00.000Z,56677854,17,Chris Livingston,0,0,0,0,0,0
4,0,4,7,2,14,7,11,9,35,1,2,25,5,1,4,1037639,2023-10-30T00:00:00.000Z,278,17,Damian Lillard,1,30,34,29,9,36
2,1,6,3,1,21,12,11,8,32,1,3,33,7,0,2,1037639,2023-10-30T00:00:00.000Z,15,17,Giannis Antetokounmpo,1,40,42,35,9,45.4
2,1,4,3,2,7,3,0,0,25,1,2,8,5,1,1,1037639,2023-10-30T00:00:00.000Z,112,17,Jae Crowder,2,13,15,10,7,22
5,0,2,2,0,4,1,4,3,17,0,2,5,2,1,1,1037639,2023-10-30T00:00:00.000Z,315,17,Khris Middleton,1,7,12,10,7,16.9
0,0,0,0,0,0,0,0,0,0,0,0,0,0,0,0,1037639,2023-10-30T00:00:00.000Z,666960,17,Lindell Wigginton,0,0,0,0,0,0
2,0,3,6,1,8,2,2,0,32,0,3,5,3,2,2,1037639,2023-10-30T00:00:00.000Z,38,17,Malik Beasley,2,8,10,7,5,15.6
0,0,0,0,0,0,0,0,0,0,0,0,0,0,0,0,1037639,2023-10-30T00:00:00.000Z,38017676,17,MarJon Beauchamp,0,0,0,0,0,0
0,0,0,0,0,0,0,0,0,0,0,0,0,0,0,0,1037639,2023-10-30T00:00:00.000Z,666453,17,Marques Bolden,0,0,0,0,0,0
2,1,5,3,2,5,3,0,0,23,0,2,8,5,0,1,1037639,2023-10-30T00:00:00.000Z,105,17,Pat Connaughton,1,13,15,10,7,19
0,0,0,0,0,0,0,0,0,0,0,0,0,0,0,0,1037639,2023-10-30T00:00:00.000Z,284,17,Robin Lopez,0,0,0,0,0,0
0,0,0,0,0,0,0,0,0,0,0,0,0,0,0,0,1037639,2023-10-30T00:00:00.000Z,2148,17,Thanasis Antetokounmpo,0,0,0,0,0,0
0,0,0,0,0,0,0,0,0,0,0,0,0,0,0,0,1037639,2023-10-30T00:00:00.000Z,38017691,17,TyTy Washington Jr.,0,0,0,0,0,0
0,0,2,2,1,8,4,2,0,20,1,2,9,3,0,3,1037640,2023-10-30T00:00:00.000Z,475,10,Andrew Wiggins,0,12,12,9,3,9.6
2,0,7,1,0,5,2,2,1,23,1,4,5,8,0,2,1037640,2023-10-30T00:00:00.000Z,56677858,10,Brandin Podziemski,0,13,15,7,10,15.6
1,0,1,1,0,1,0,0,0,5,0,2,0,1,0,0,1037640,2023-10-30T00:00:00.000Z,251,10,Cory Joseph,0,1,2,1,2,2.7
2,1,6,4,1,7,2,2,1,21,4,2,6,10,0,0,1037640,2023-10-30T00:00:00.000Z,407,10,Dario Saric,1,16,18,8,12,24
7,1,5,2,0,8,3,0,0,21,1,2,6,6,0,1,1037640,2023-10-30T00:00:00.000Z,185,10,Draymond Green,1,12,19,13,13,25.7
1,1,2,6,2,10,4,0,0,20,2,4,10,4,1,0,1037640,2023-10-30T00:00:00.000Z,2189,10,Gary Payton II,2,14,15,11,5,22.3
0,0,1,0,0,2,0,0,0,5,0,0,0,1,0,0,1037640,2023-10-30T00:00:00.000Z,398,10,Jerome Robinson,0,1,1,0,1,1.2
0,0,0,0,0,0,0,0,0,0,0,0,0,0,0,0,1037640,2023-10-30T00:00:00.000Z,17553979,10,Jonathan Kuminga,0,0,0,0,0,0
1,0,5,0,0,5,3,2,2,24,2,2,8,7,1,1,1037640,2023-10-30T00:00:00.000Z,282,10,Kevon Looney,1,15,16,9,8,19.9
0,0,0,0,0,0,0,0,0,0,0,0,0,0,0,0,1037640,2023-10-30T00:00:00.000Z,443,10,Klay Thompson,0,0,0,0,0,0
0,0,0,2,1,3,2,0,0,5,0,0,5,0,0,0,1037640,2023-10-30T00:00:00.000Z,45658838,10,Lester Quinones,0,5,5,5,0,5
0,4,2,0,0,10,5,4,3,20,8,2,13,10,0,2,1037640,2023-10-30T00:00:00.000Z,56677799,10,Trayce Jackson-Davis,4,23,23,13,10,35
0,0,0,0,0,0,0,0,0,0,0,0,0,0,0,0,1037640,2023-10-30T00:00:00.000Z,17896070,10,Usman Garuba,0,0,0,0,0,0
0,0,1,0,0,2,0,2,0,5,1,0,0,2,0,0,1037640,2023-10-30T00:00:00.000Z,491,19,Cody Zeller,0,2,2,0,2,2.4
0,0,0,0,0,0,0,0,0,0,0,0,0,0,0,0,1037640,2023-10-30T00:00:00.000Z,38017726,19,Dereon Seabron,0,0,0,0,0,0
0,0,0,0,0,0,0,0,0,0,0,0,0,0,0,0,1037640,2023-10-30T00:00:00.000Z,38017663,19,E.J. Liddell,0,0,0,0,0,0
0,0,0,0,0,0,0,0,0,0,0,0,0,0,0,0,1037640,2023-10-30T00:00:00.000Z,17896097,19,Jose Alvarado,0,0,0,0,0,0
2,0,3,1,1,2,2,0,0,17,2,2,5,5,0,3,1037640,2023-10-30T00:00:00.000Z,340,19,Larry Nance Jr.,0,10,12,7,7,11
2,0,2,7,3,9,4,1,1,27,1,2,12,3,0,2,1037640,2023-10-30T00:00:00.000Z,17896017,19,Matt Ryan,0,15,17,14,5,16.6
0,0,0,0,0,0,0,0,0,0,0,0,0,0,0,0,1037640,2023-10-30T00:00:00.000Z,3547293,19,Naji Marshall,0,0,0,0,0,0
0,0,0,0,0,0,0,0,0,0,0,0,0,0,0,0,1037640,2023-10-30T00:00:00.000Z,18677986,19,Trey Murphy III,0,0,0,0,0,0
7,0,1,4,3,9,4,0,0,21,1,3,11,2,0,0,1037641,2023-10-30T00:00:00.000Z,77,9,Alec Burks,0,13,20,18,9,23.9
3,3,3,2,0,14,6,4,3,31,7,4,15,10,1,3,1037641,2023-10-30T00:00:00.000Z,56677826,9,Ausar Thompson,4,25,28,18,13,40.5
0,0,0,0,0,0,0,0,0,0,0,0,0,0,0,0,1037641,2023-10-30T00:00:00.000Z,54,9,Bojan Bogdanovic,0,0,0,0,0,0
5,0,2,7,3,15,5,5,4,36,0,1,17,2,0,7,1037641,2023-10-30T00:00:00.000Z,17896075,9,Cade Cunningham,0,19,24,22,7,19.9
0,0,0,0,0,0,0,0,0,0,0,0,0,0,0,0,1037641,2023-10-30T00:00:00.000Z,17896071,9,Isaiah Livers,0,0,0,0,0,0
1,0,7,3,2,9,4,2,2,31,0,2,12,7,0,2,1037641,2023-10-30T00:00:00.000Z,3547267,9,Isaiah Stewart,0,19,20,13,8,19.9
3,1,1,6,4,13,7,2,2,19,1,5,20,2,1,1,1037641,2023-10-30T00:00:00.000Z,38017682,9,Jaden Ivey,2,22,25,23,5,31.9
0,0,0,0,0,0,0,0,0,0,0,0,0,0,0,0,1037641,2023-10-30T00:00:00.000Z,3547240,9,James Wiseman,0,0,0,0,0,0
0,0,1,0,0,0,0,0,0,2,0,0,0,1,0,0,1037641,2023-10-30T00:00:00.000Z,42097199,9,Jared Rhoden,0,1,1,0,1,1.2
1,0,0,0,0,1,0,0,0,10,0,2,0,0,0,1,1037641,2023-10-30T00:00:00.000Z,197,9,Joe Harris,0,0,1,1,1,0.5
0,0,0,0,0,0,0,0,0,0,0,0,0,0,0,0,1037641,2023-10-30T00:00:00.000Z,56677729,9,Malcolm Cazalon,0,0,0,0,0,0
2,0,2,2,2,4,2,0,0,14,0,1,6,2,1,0,1037641,2023-10-30T00:00:00.000Z,56677792,9,Marcus Sasser,1,8,10,8,4,14.4
1,0,3,0,0,4,3,8,7,24,1,1,13,4,0,0,1037641,2023-10-30T00:00:00.000Z,24,9,Marvin Bagley III,0,17,18,14,5,19.3
0,0,0,0,0,0,0,0,0,0,0,0,0,0,0,0,1037641,2023-10-30T00:00:00.000Z,330,9,Monte Morris,0,0,0,0,0,0
0,0,0,0,0,0,0,0,0,2,0,0,0,0,1,0,1037641,2023-10-30T00:00:00.000Z,44477024,9,Stanley Umude,1,0,0,0,0,3
0,0,0,0,0,0,0,0,0,0,0,0,0,0,0,0,1037641,2023-10-30T00:00:00.000Z,17896078,21,Aaron Wiggins,0,0,0,0,0,0
0,0,0,2,0,2,0,0,0,2,0,2,0,0,0,1,1037641,2023-10-30T00:00:00.000Z,3547271,21,Aleksej Pokusevski,0,0,0,0,0,-1
2,0,4,1,0,2,1,2,2,22,0,2,4,4,0,1,1037641,2023-10-30T00:00:00.000Z,56677833,21,Cason Wallace,0,8,10,6,6,10.8
3,4,4,5,4,5,4,2,2,24,0,5,14,4,2,3,1037641,2023-10-30T00:00:00.000Z,38017685,21,Chet Holmgren,6,18,21,17,7,38.3
0,0,1,2,1,2,1,3,3,13,0,1,6,1,0,0,1037641,2023-10-30T00:00:00.000Z,44,21,Davis Bertans,0,7,7,6,1,7.2
0,0,0,5,3,6,3,0,0,20,0,1,9,0,0,1,1037641,2023-10-30T00:00:00.000Z,3547272,21,Isaiah Joe,0,9,9,9,0,8
6,1,7,3,1,14,8,2,2,31,0,2,19,7,1,2,1037641,2023-10-30T00:00:00.000Z,38017703,21,Jalen Williams,2,26,32,25,13,40.4
0,0,0,0,0,0,0,0,0,0,0,0,0,0,0,0,1037641,2023-10-30T00:00:00.000Z,38017706,21,Jaylin Williams,0,0,0,0,0,0
3,1,4,2,0,18,9,5,3,28,3,1,21,7,1,1,1037641,2023-10-30T00:00:00.000Z,17896065,21,Josh Giddey,2,28,31,24,10,38.9
0,0,0,0,0,0,0,0,0,0,0,0,0,0,0,0,1037641,2023-10-30T00:00:00.000Z,480,21,Kenrich Williams,0,0,0,0,0,0
0,0,0,0,0,0,0,0,0,0,0,0,0,0,0,0,1037641,2023-10-30T00:00:00.000Z,56677853,21,Keyontae Johnson,0,0,0,0,0,0
0,0,0,0,0,0,0,0,0,0,0,0,0,0,0,0,1037641,2023-10-30T00:00:00.000Z,27924547,21,Lindy Waters III,0,0,0,0,0,0
0,1,2,4,1,7,3,0,0,26,0,1,7,2,2,0,1037641,2023-10-30T00:00:00.000Z,666541,21,Luguentz Dort,3,9,9,7,2,18.4
1,3,8,0,0,0,0,4,2,21,1,2,2,9,0,0,1037641,2023-10-30T00:00:00.000Z,24572055,21,Olivier Sarr,3,11,12,3,10,23.3
2,0,0,2,2,4,4,1,0,18,1,0,10,1,0,1,1037641,2023-10-30T00:00:00.000Z,38017716,21,Ousmane Dieng,0,11,13,12,3,13.2
4,0,8,3,1,23,11,9,9,33,1,2,32,9,3,5,1037641,2023-10-30T00:00:00.000Z,175,21,Shai Gilgeous-Alexander,3,41,45,36,13,52.8
0,0,0,0,0,0,0,0,0,2,0,0,0,0,0,0,1037641,2023-10-30T00:00:00.000Z,17896036,21,Tre Mann,0,0,0,0,0,0
0,0,0,0,0,0,0,0,0,0,0,0,0,0,0,0,1037641,2023-10-30T00:00:00.000Z,4197029,21,Vasilije Micic,0,0,0,0,0,0
0,0,0,0,0,0,0,0,0,0,0,0,0,0,0,0,1037642,2023-10-30T00:00:00.000Z,17896007,8,Braxton Key,0,0,0,0,0,0
0,0,0,0,0,0,0,0,0,0,0,0,0,0,0,0,1037642,2023-10-30T00:00:00.000Z,38017727,8,Collin Gillespie,0,0,0,0,0,0
0,0,0,0,0,0,0,0,0,0,0,0,0,0,0,0,1037642,2023-10-30T00:00:00.000Z,250,8,DeAndre Jordan,0,0,0,0,0,0
0,0,0,0,0,0,0,0,0,0,0,0,0,0,0,0,1037642,2023-10-30T00:00:00.000Z,56677871,8,Hunter Tyson,0,0,0,0,0,0
0,0,0,0,0,0,0,0,0,0,0,0,0,0,0,0,1037642,2023-10-30T00:00:00.000Z,56677582,8,Jalen Pickett,0,0,0,0,0,0
0,0,0,0,0,0,0,0,0,0,0,0,0,0,0,0,1037642,2023-10-30T00:00:00.000Z,17896103,8,Jay Huff,0,0,0,0,0,0
0,0,2,2,0,4,2,0,0,6,0,0,4,2,0,0,1037642,2023-10-30T00:00:00.000Z,56677776,8,Julian Strawther,0,6,6,4,2,6.4
0,0,0,0,0,0,0,0,0,0,0,0,0,0,0,0,1037642,2023-10-30T00:00:00.000Z,215,8,Justin Holiday,0,0,0,0,0,0
0,0,0,0,0,0,0,0,0,0,0,0,0,0,0,0,1037642,2023-10-30T00:00:00.000Z,666489,8,Vlatko Cancar,0,0,0,0,0,0
0,0,2,0,0,2,2,3,2,13,1,0,6,3,2,0,1037642,2023-10-30T00:00:00.000Z,3547268,8,Zeke Nnaji,2,9,9,6,3,15.6
0,0,0,0,0,0,0,0,0,0,0,0,0,0,0,0,1037642,2023-10-30T00:00:00.000Z,56677842,29,Brice Sensabaugh,0,0,0,0,0,0
0,0,0,5,2,10,5,0,0,17,0,2,12,0,0,1,1037642,2023-10-30T00:00:00.000Z,413,29,Collin Sexton,0,12,12,12,0,11
1,0,6,3,1,16,7,3,0,34,3,3,15,9,1,0,1037642,2023-10-30T00:00:00.000Z,101,29,John Collins,1,24,25,16,10,30.3
0,0,0,0,0,0,0,0,0,0,0,0,0,0,0,0,1037642,2023-10-30T00:00:00.000Z,38017630,29,Johnny Juzang,0,0,0,0,0,0
6,0,1,4,0,10,2,3,0,34,2,1,4,3,1,5,1037642,2023-10-30T00:00:00.000Z,100,29,Jordan Clarkson,1,7,13,10,9,14.6
0,0,0,0,0,0,0,0,0,0,0,0,0,0,0,0,1037642,2023-10-30T00:00:00.000Z,17896023,29,Josh Christopher,0,0,0,0,0,0
5,0,2,2,0,2,0,4,3,18,2,4,3,4,3,1,1037642,2023-10-30T00:00:00.000Z,358,29,Kelly Olynyk,3,7,12,8,9,23.3
2,0,0,4,1,6,1,0,0,20,1,0,3,1,1,0,1037642,2023-10-30T00:00:00.000Z,56677834,29,Keyonte George,1,4,6,5,3,10.2
1,0,2,1,0,2,0,0,0,6,0,1,0,2,0,0,1037642,2023-10-30T00:00:00.000Z,139,29,Kris Dunn,0,2,3,1,3,3.9
5,1,9,13,5,24,10,2,2,38,5,2,27,14,0,2,1037642,2023-10-30T00:00:00.000Z,297,29,Lauri Markkanen,1,41,46,32,19,52.3
0,0,0,0,0,0,0,0,0,0,0,0,0,0,0,0,1037642,2023-10-30T00:00:00.000Z,666881,29,Luka Samanic,0,0,0,0,0,0
0,0,0,0,0,0,0,0,0,0,0,0,0,0,0,0,1037642,2023-10-30T00:00:00.000Z,19465584,29,Micah Potter,0,0,0,0,0,0
2,0,1,2,0,5,0,0,0,15,1,0,0,2,0,0,1037642,2023-10-30T00:00:00.000Z,38017620,29,Ochai Agbaji,0,2,4,2,4,5.4
0,0,0,0,0,0,0,0,0,0,0,0,0,0,0,0,1037642,2023-10-30T00:00:00.000Z,11891374,29,Omer Yurtseven,0,0,0,0,0,0
0,0,0,0,0,0,0,0,0,0,0,0,0,0,0,0,1037642,2023-10-30T00:00:00.000Z,38017739,29,Simone Fontecchio,0,0,0,0,0,0
8,0,3,3,2,12,7,0,0,29,0,4,16,3,0,1,1037642,2023-10-30T00:00:00.000Z,666650,29,Talen Horton-Tucker,0,19,27,24,11,30.6
0,0,0,0,0,0,0,0,0,0,0,0,0,0,0,0,1037642,2023-10-30T00:00:00.000Z,56677824,29,Taylor Hendricks,0,0,0,0,0,0
0,1,10,0,0,11,10,3,2,29,3,4,22,13,0,2,1037642,2023-10-30T00:00:00.000Z,38017705,29,Walker Kessler,1,35,35,22,13,38.6
0,0,0,0,0,0,0,0,0,0,0,0,0,0,0,0,1037643,2023-10-30T00:00:00.000Z,56677867,14,Alex Fudge,0,0,0,0,0,0
5,3,17,1,0,18,12,3,2,38,2,3,26,19,1,1,1037643,2023-10-30T00:00:00.000Z,117,14,Anthony Davis,4,45,50,31,24,67.3
3,1,3,4,1,12,5,0,0,31,0,0,11,3,0,3,1037643,2023-10-30T00:00:00.000Z,17553995,14,Austin Reaves,1,14,17,14,6,19.1
2,0,2,1,0,1,0,0,0,14,0,0,0,2,1,1,1037643,2023-10-30T00:00:00.000Z,666860,14,Cameron Reddish,1,2,4,2,4,7.4
3,3,8,4,1,6,3,4,2,27,1,3,9,9,0,3,1037643,2023-10-30T00:00:00.000Z,486,14,Christian Wood,3,18,21,12,12,30.3
0,0,0,0,0,0,0,0,0,0,0,0,0,0,0,0,1037643,2023-10-30T00:00:00.000Z,56677738,14,Colin Castleton,0,0,0,0,0,0
8,1,2,6,3,14,10,5,5,36,0,4,28,2,1,3,1037643,2023-10-30T00:00:00.000Z,405,14,D'Angelo Russell,2,30,38,36,10,45.4
0,0,0,0,0,0,0,0,0,0,0,0,0,0,0,0,1037643,2023-10-30T00:00:00.000Z,56677868,14,D'Moi Hodge,0,0,0,0,0,0
2,0,0,3,1,7,4,0,0,25,0,2,9,0,1,0,1037643,2023-10-30T00:00:00.000Z,1603383,14,Gabe Vincent,1,9,11,11,2,15
0,0,0,0,0,0,0,0,0,0,0,0,0,0,0,0,1037643,2023-10-30T00:00:00.000Z,56677835,14,Jalen Hood-Schifino,0,0,0,0,0,0
0,0,0,0,0,0,0,0,0,0,0,0,0,0,0,0,1037643,2023-10-30T00:00:00.000Z,457,14,Jarred Vanderbilt,0,0,0,0,0,0
0,0,2,0,0,0,0,0,0,10,0,2,0,2,0,0,1037643,2023-10-30T00:00:00.000Z,666626,14,Jaxson Hayes,0,2,2,0,2,2.4
4,1,3,6,2,17,7,4,3,33,0,0,19,3,3,5,1037643,2023-10-30T00:00:00.000Z,237,14,LeBron James,4,22,26,23,7,35.6
0,0,0,0,0,0,0,0,0,0,0,0,0,0,0,0,1037643,2023-10-30T00:00:00.000Z,38017697,14,Max Christie,0,0,0,0,0,0
0,0,0,0,0,0,0,0,0,0,0,0,0,0,0,0,1037643,2023-10-30T00:00:00.000Z,56677836,14,Maxwell Lewis,0,0,0,0,0,0
0,0,0,0,0,0,0,0,0,0,0,0,0,0,0,0,1037643,2023-10-30T00:00:00.000Z,666609,14,Rui Hachimura,0,0,0,0,0,0
1,1,0,2,0,4,1,2,2,26,0,3,4,0,0,0,1037643,2023-10-30T00:00:00.000Z,383,14,Taurean Prince,1,4,5,5,1,8.5
0,0,0,0,0,0,0,0,0,0,0,0,0,0,0,0,1037643,2023-10-30T00:00:00.000Z,56677827,22,Anthony Black,0,0,0,0,0,0
2,0,3,3,1,12,4,4,3,21,0,2,12,3,3,1,1037643,2023-10-30T00:00:00.000Z,3547251,22,Cole Anthony,3,15,17,14,5,26.6
4,0,6,7,2,17,5,4,4,37,2,4,16,8,2,2,1037643,2023-10-30T00:00:00.000Z,17896026,22,Franz Wagner,2,24,28,20,12,35.6
3,0,2,5,5,6,6,0,0,21,1,0,17,3,0,3,1037643,2023-10-30T00:00:00.000Z,196,22,Gary Harris,0,20,23,20,6,22.1
0,0,0,0,0,0,0,0,0,1,0,0,0,0,0,0,1037643,2023-10-30T00:00:00.000Z,666442,22,Goga Bitadze,0,0,0,0,0,0
2,0,5,7,3,12,4,4,4,26,3,2,15,8,1,0,1037643,2023-10-30T00:00:00.000Z,17896073,22,Jalen Suggs,1,23,25,17,10,30.6
3,0,0,0,0,2,1,0,0,12,1,2,2,1,2,1,1037643,2023-10-30T00:00:00.000Z,226,22,Joe Ingles,2,3,6,5,4,12.7
0,0,3,3,1,3,1,0,0,11,0,1,3,3,1,0,1037643,2023-10-30T00:00:00.000Z,229,22,Jonathan Isaac,1,6,6,3,3,9.6
8,2,3,1,0,16,7,0,0,33,1,2,14,4,1,1,1037643,2023-10-30T00:00:00.000Z,165,22,Markelle Fultz,3,18,26,22,12,38.8
0,0,0,1,0,5,2,2,1,12,1,2,5,1,0,1,1037643,2023-10-30T00:00:00.000Z,462,22,Moritz Wagner,0,6,6,5,1,5.2
5,0,4,5,1,14,4,2,0,31,1,3,9,5,0,2,1037643,2023-10-30T00:00:00.000Z,38017683,22,Paolo Banchero,0,14,19,14,10,20.5
1,1,6,3,1,8,4,2,1,35,2,4,10,8,0,0,1037643,2023-10-30T00:00:00.000Z,85,22,Wendell Carter Jr.,1,18,19,11,9,24.1
0,0,0,0,0,0,0,0,0,0,0,0,0,0,0,0,1037644,2023-10-31T00:00:00.000Z,277,6,Caris LeVert,0,0,0,0,0,0
0,0,0,0,0,0,0,0,0,0,0,0,0,0,0,0,1037644,2023-10-31T00:00:00.000Z,666581,6,Darius Garland,0,0,0,0,0,0
0,0,0,0,0,0,0,0,0,0,0,0,0,0,0,0,1037644,2023-10-31T00:00:00.000Z,9,6,Jarrett Allen,0,0,0,0,0,0
0,0,0,0,0,0,0,0,0,0,0,0,0,0,0,0,1037644,2023-10-31T00:00:00.000Z,404,6,Ricky Rubio,0,0,0,0,0,0
1,2,1,0,0,1,1,2,2,19,1,2,4,2,0,2,1037644,2023-10-31T00:00:00.000Z,444,6,Tristan Thompson,2,6,7,5,3,11.9
0,0,0,0,0,0,0,0,0,0,0,0,0,0,0,0,1037644,2023-10-31T00:00:00.000Z,666676,6,Ty Jerome,0,0,0,0,0,0
2,0,7,5,2,14,5,10,7,31,3,1,19,10,1,1,1037644,2023-10-31T00:00:00.000Z,387,20,Julius Randle,1,29,31,21,12,36
0,0,2,5,3,13,5,4,3,25,1,2,16,3,0,1,1037644,2023-10-31T00:00:00.000Z,666423,20,RJ Barrett,0,19,19,16,3,18.6
0,0,0,0,0,0,0,0,0,0,0,0,0,0,0,0,1037645,2023-10-31T00:00:00.000Z,666451,24,Bol Bol,0,0,0,0,0,0
4,2,8,0,0,3,1,2,1,17,1,1,3,9,1,2,1037645,2023-10-31T00:00:00.000Z,147,24,Drew Eubanks,3,12,16,7,13,26.8
6,0,2,9,4,14,8,0,0,36,0,1,20,2,0,4,1037645,2023-10-31T00:00:00.000Z,178,24,Eric Gordon,0,22,28,26,8,27.4
3,1,6,7,5,9,5,4,4,37,1,2,19,7,0,2,1037645,2023-10-31T00:00:00.000Z,8,24,Grayson Allen,1,26,29,22,10,32.9
0,0,2,2,0,7,3,0,0,15,2,3,6,4,1,1,1037645,2023-10-31T00:00:00.000Z,18678058,24,Jordan Goodwin,1,10,10,6,4,12.8
2,2,1,4,1,10,3,5,4,30,1,1,11,2,0,2,1037645,2023-10-31T00:00:00.000Z,356,24,Josh Okogie,2,13,15,13,4,20.4
4,2,12,5,2,10,4,2,2,30,0,4,12,12,1,0,1037645,2023-10-31T00:00:00.000Z,349,24,Jusuf Nurkic,3,24,28,16,16,41.4
0,0,0,0,0,0,0,0,0,0,0,0,0,0,0,0,1037645,2023-10-31T00:00:00.000Z,32,24,Keita Bates-Diop,0,0,0,0,0,0
7,0,2,3,1,19,12,2,1,37,0,0,26,2,2,5,1037645,2023-10-31T00:00:00.000Z,140,24,Kevin Durant,2,28,35,33,9,39.9
1,0,2,2,2,3,2,0,0,18,0,5,6,2,2,1,1037645,2023-10-31T00:00:00.000Z,666729,24,Nassir Little,2,8,9,7,3,14.9
0,0,0,0,0,0,0,0,0,0,0,0,0,0,0,0,1037645,2023-10-31T00:00:00.000Z,3547095,24,Udoka Azubuike,0,0,0,0,0,0
0,0,0,0,0,0,0,0,0,0,0,0,0,0,0,0,1037646,2023-10-31T00:00:00.000Z,17896022,13,Brandon Boston Jr.,0,0,0,0,0,0
0,0,0,0,0,0,0,0,0,0,0,0,0,0,0,0,1037646,2023-10-31T00:00:00.000Z,17896051,13,Joshua Primo,0,0,0,0,0,0
0,0,0,0,0,0,0,0,0,0,0,0,0,0,0,0,1037646,2023-10-31T00:00:00.000Z,3547294,13,Kenyon Martin Jr.,0,0,0,0,0,0
0,0,0,0,0,0,0,0,0,0,0,0,0,0,0,0,1037646,2023-10-31T00:00:00.000Z,328,13,Marcus Morris,0,0,0,0,0,0
0,0,0,0,0,0,0,0,0,0,0,0,0,0,0,0,1037646,2023-10-31T00:00:00.000Z,108,13,Robert Covington,0,0,0,0,0,0
0,0,0,0,0,0,0,0,0,0,0,0,0,0,0,0,1037646,2023-10-31T00:00:00.000Z,666743,13,Terance Mann,0,0,0,0,0,0
0,0,0,0,0,0,0,0,0,0,0,0,0,0,0,0,1037646,2023-10-31T00:00:00.000Z,666885,22,Admiral Schofield,0,0,0,0,0,0
1,0,0,0,0,0,0,0,0,4,0,1,0,0,0,0,1037646,2023-10-31T00:00:00.000Z,56677827,22,Anthony Black,0,0,1,1,1,1.5
0,0,0,4,1,5,2,1,1,4,0,0,6,0,0,0,1037646,2023-10-31T00:00:00.000Z,38017724,22,Caleb Houstan,0,6,6,6,0,6
0,0,0,0,0,1,1,0,0,4,1,0,2,1,0,1,1037646,2023-10-31T00:00:00.000Z,666818,22,Chuma Okeke,0,3,3,2,1,2.2
3,1,7,7,2,13,6,0,0,32,1,4,14,8,0,3,1037646,2023-10-31T00:00:00.000Z,17896026,22,Franz Wagner,1,22,25,17,11,28.1
3,0,0,0,0,0,0,2,1,4,1,0,1,1,0,0,1037646,2023-10-31T00:00:00.000Z,666442,22,Goga Bitadze,0,2,5,4,4,6.7
0,0,1,0,0,1,1,0,0,4,0,0,2,1,0,0,1037646,2023-10-31T00:00:00.000Z,56677839,22,Jett Howard,0,3,3,2,1,3.2
0,0,0,0,0,0,0,0,0,0,0,0,0,0,0,0,1037646,2023-10-31T00:00:00.000Z,229,22,Jonathan Isaac,0,0,0,0,0,0
0,0,0,0,0,0,0,0,0,0,0,0,0,0,0,0,1037646,2023-10-31T00:00:00.000Z,38017607,22,Kevon Harris,0,0,0,0,0,0
1,1,1,2,0,7,4,6,5,14,0,2,13,1,1,1,1037646,2023-10-31T00:00:00.000Z,462,22,Moritz Wagner,2,14,15,14,2,20.7
4,0,4,3,1,13,5,8,4,32,0,3,15,4,4,3,1037646,2023-10-31T00:00:00.000Z,38017683,22,Paolo Banchero,4,19,23,19,8,34.8
0,0,0,0,0,0,0,0,0,0,0,0,0,0,0,0,1037646,2023-10-31T00:00:00.000Z,17553983,22,Trevelin Queen,0,0,0,0,0,0
3,0,7,2,0,8,2,6,3,30,1,2,7,8,1,2,1037646,2023-10-31T00:00:00.000Z,85,22,Wendell Carter Jr.,1,15,18,10,11,22.1
0,0,0,0,0,0,0,0,0,0,0,0,0,0,0,0,1037647,2023-11-01T00:00:00.000Z,77,9,Alec Burks,0,0,0,0,0,0
2,0,4,3,0,14,8,0,0,30,3,4,16,7,2,2,1037647,2023-11-01T00:00:00.000Z,56677826,9,Ausar Thompson,2,23,25,18,9,31.4
0,0,0,0,0,0,0,0,0,0,0,0,0,0,0,0,1037647,2023-11-01T00:00:00.000Z,54,9,Bojan Bogdanovic,0,0,0,0,0,0
4,0,5,9,5,27,11,3,3,37,0,3,30,5,1,6,1037647,2023-11-01T00:00:00.000Z,17896075,9,Cade Cunningham,1,35,39,34,9,39
0,0,0,0,0,0,0,0,0,0,0,0,0,0,0,0,1037647,2023-11-01T00:00:00.000Z,17896071,9,Isaiah Livers,0,0,0,0,0,0
4,0,4,4,2,8,5,0,0,33,2,5,12,6,1,2,1037647,2023-11-01T00:00:00.000Z,3547267,9,Isaiah Stewart,1,18,22,16,10,26.2
2,1,2,3,1,7,3,3,3,22,0,3,10,2,1,1,1037647,2023-11-01T00:00:00.000Z,38017682,9,Jaden Ivey,2,12,14,12,4,20.4
0,0,0,0,0,0,0,0,0,0,0,0,0,0,0,0,1037647,2023-11-01T00:00:00.000Z,38017694,9,Jalen Duren,0,0,0,0,0,0
1,0,2,0,0,4,2,0,0,6,0,4,4,2,0,1,1037647,2023-11-01T00:00:00.000Z,3547240,9,James Wiseman,0,6,7,5,3,6.9
0,0,0,0,0,0,0,0,0,0,0,0,0,0,0,0,1037647,2023-11-01T00:00:00.000Z,42097199,9,Jared Rhoden,0,0,0,0,0,0
1,0,1,6,3,7,4,0,0,17,1,1,11,2,0,0,1037647,2023-11-01T00:00:00.000Z,197,9,Joe Harris,0,13,14,12,3,14.9
1,0,3,1,0,6,0,0,0,26,0,2,0,3,3,1,1037647,2023-11-01T00:00:00.000Z,3547241,9,Killian Hayes,3,3,4,1,4,13.1
0,0,0,0,0,0,0,0,0,0,0,0,0,0,0,0,1037647,2023-11-01T00:00:00.000Z,56677729,9,Malcolm Cazalon,0,0,0,0,0,0
6,1,3,1,0,6,4,0,0,24,0,3,8,3,4,0,1037647,2023-11-01T00:00:00.000Z,56677792,9,Marcus Sasser,5,11,17,14,9,35.6
3,2,6,2,0,10,3,5,4,33,0,3,10,6,0,5,1037647,2023-11-01T00:00:00.000Z,24,9,Marvin Bagley III,2,16,19,13,9,22.7
0,0,0,0,0,0,0,0,0,0,0,0,0,0,0,0,1037647,2023-11-01T00:00:00.000Z,330,9,Monte Morris,0,0,0,0,0,0
0,0,2,0,0,1,0,0,0,12,0,3,0,2,0,0,1037647,2023-11-01T00:00:00.000Z,44477024,9,Stanley Umude,0,2,2,0,2,2.4
0,0,0,0,0,0,0,0,0,0,0,0,0,0,0,0,1037647,2023-11-01T00:00:00.000Z,419,25,Anfernee Simons,0,0,0,0,0,0
0,0,0,0,0,0,0,0,0,0,0,0,0,0,0,0,1037647,2023-11-01T00:00:00.000Z,56783340,25,Duop Reath,0,0,0,0,0,0
0,0,0,0,0,0,0,0,0,0,0,0,0,0,0,0,1037647,2023-11-01T00:00:00.000Z,17896120,25,Ish Wainright,0,0,0,0,0,0
1,0,1,3,0,3,0,0,0,17,0,1,0,1,1,0,1037647,2023-11-01T00:00:00.000Z,666923,25,Matisse Thybulle,1,1,2,1,2,5.7
1,0,1,0,0,1,1,0,0,5,0,1,2,1,0,0,1037648,2023-11-01T00:00:00.000Z,38017733,17,A.J. Green,0,3,4,3,2,4.7
3,0,1,0,0,1,1,0,0,6,0,2,2,1,1,0,1037648,2023-11-01T00:00:00.000Z,56677852,17,Andre Jackson Jr.,1,3,6,5,4,10.7
1,0,5,1,0,6,2,9,6,19,1,1,10,6,2,1,1037648,2023-11-01T00:00:00.000Z,377,17,Bobby Portis,2,16,17,11,7,23.7
0,1,1,4,0,8,1,4,4,17,2,0,6,3,2,0,1037648,2023-11-01T00:00:00.000Z,283,17,Brook Lopez,3,9,9,6,3,18.6
1,0,2,2,0,5,2,0,0,19,0,2,4,2,0,1,1037648,2023-11-01T00:00:00.000Z,368,17,Cameron Payne,0,6,7,5,3,6.9
1,0,0,1,1,2,2,0,0,5,0,0,5,0,0,0,1037648,2023-11-01T00:00:00.000Z,56677854,17,Chris Livingston,0,5,6,6,1,6.5
6,0,2,4,1,9,4,7,6,31,0,1,15,2,0,2,1037648,2023-11-01T00:00:00.000Z,278,17,Damian Lillard,0,17,23,21,8,24.4
3,1,0,3,2,5,3,3,1,25,1,2,9,1,0,0,1037648,2023-11-01T00:00:00.000Z,112,17,Jae Crowder,1,10,13,12,4,17.7
0,0,0,0,0,0,0,0,0,0,0,0,0,0,0,0,1037648,2023-11-01T00:00:00.000Z,666960,17,Lindell Wigginton,0,0,0,0,0,0
0,0,2,9,6,10,7,0,0,25,0,2,20,2,2,0,1037648,2023-11-01T00:00:00.000Z,38,17,Malik Beasley,2,22,22,20,2,28.4
0,0,2,5,2,5,2,2,2,16,0,0,8,2,0,0,1037648,2023-11-01T00:00:00.000Z,38017676,17,MarJon Beauchamp,0,10,10,8,2,10.4
0,0,0,0,0,0,0,0,0,0,0,0,0,0,0,0,1037648,2023-11-01T00:00:00.000Z,666453,17,Marques Bolden,0,0,0,0,0,0
0,0,0,0,0,0,0,0,0,0,0,0,0,0,0,0,1037648,2023-11-01T00:00:00.000Z,284,17,Robin Lopez,0,0,0,0,0,0
0,0,0,0,0,1,0,0,0,4,0,0,0,0,0,0,1037648,2023-11-01T00:00:00.000Z,2148,17,Thanasis Antetokounmpo,0,0,0,0,0,0
0,0,0,0,0,0,0,0,0,0,0,0,0,0,0,0,1037648,2023-11-01T00:00:00.000Z,38017691,17,TyTy Washington Jr.,0,0,0,0,0,0
1,0,4,1,0,4,2,2,2,13,1,3,6,5,1,0,1037648,2023-11-01T00:00:00.000Z,58,28,Chris Boucher,1,11,12,7,6,16.5
11,0,3,4,2,13,9,4,4,29,1,2,24,4,1,2,1037648,2023-11-01T00:00:00.000Z,409,28,Dennis Schroder,1,28,39,35,15,46.3
1,0,2,5,0,11,4,0,0,23,1,2,8,3,0,1,1037648,2023-11-01T00:00:00.000Z,3089,28,Gary Trent Jr.,0,11,12,9,4,12.1
0,0,1,8,1,10,2,0,0,21,0,1,5,1,0,0,1037648,2023-11-01T00:00:00.000Z,56677828,28,Gradey Dick,0,6,6,5,1,6.2
2,4,7,0,0,10,7,0,0,29,4,4,14,11,0,2,1037648,2023-11-01T00:00:00.000Z,373,28,Jakob Poeltl,4,25,27,16,13,40.2
0,0,0,0,0,0,0,0,0,0,0,0,0,0,0,0,1037648,2023-11-01T00:00:00.000Z,666762,28,Jalen McDaniels,0,0,0,0,0,0
4,0,2,1,0,3,1,0,0,19,1,1,2,3,3,3,1037648,2023-11-01T00:00:00.000Z,3547275,28,Malachi Flynn,3,5,9,6,7,17.6
3,0,2,1,1,7,7,2,1,25,0,5,16,2,1,2,1037648,2023-11-01T00:00:00.000Z,18,28,OG Anunoby,1,18,21,19,5,23.9
7,0,6,8,5,13,9,3,3,33,0,3,26,6,0,3,1037648,2023-11-01T00:00:00.000Z,416,28,Pascal Siakam,0,32,39,33,13,40.7
5,2,7,6,4,16,8,1,1,29,5,1,21,12,1,3,1037648,2023-11-01T00:00:00.000Z,17896055,28,Scottie Barnes,3,33,38,26,17,48.9
0,0,0,2,0,2,0,0,0,12,0,0,0,0,0,0,1037649,2023-11-01T00:00:00.000Z,38017689,1,AJ Griffin,0,0,0,0,0,0
1,1,3,5,1,10,4,3,3,23,0,2,12,3,1,1,1037649,2023-11-01T00:00:00.000Z,53,1,Bogdan Bogdanovic,2,15,16,13,4,22.1
0,0,0,0,0,0,0,0,0,0,0,0,0,0,0,0,1037649,2023-11-01T00:00:00.000Z,666564,1,Bruno Fernando,0,0,0,0,0,0
0,0,0,0,0,0,0,0,0,0,0,0,0,0,0,0,1037649,2023-11-01T00:00:00.000Z,666754,1,Garrison Mathews,0,0,0,0,0,0
2,0,7,2,0,7,3,2,2,24,4,2,8,11,0,5,1037649,2023-11-01T00:00:00.000Z,17896040,1,Jalen Johnson,0,19,21,10,13,19.2
0,0,0,0,0,0,0,0,0,0,0,0,0,0,0,0,1037649,2023-11-01T00:00:00.000Z,56677838,1,Kobe Bufkin,0,0,0,0,0,0
0,0,0,0,0,0,0,0,0,0,0,0,0,0,0,0,1037649,2023-11-01T00:00:00.000Z,56677875,1,Miles Norris,0,0,0,0,0,0
0,0,0,0,0,0,0,0,0,0,0,0,0,0,0,0,1037649,2023-11-01T00:00:00.000Z,56677806,1,Mouhamed Gueye,0,0,0,0,0,0
2,1,6,1,0,8,6,4,4,27,5,3,16,11,0,1,1037649,2023-11-01T00:00:00.000Z,3547244,1,Onyeka Okongwu,1,27,29,18,13,34.2
0,0,0,0,0,0,0,0,0,0,0,0,0,0,0,0,1037649,2023-11-01T00:00:00.000Z,319,1,Patty Mills,0,0,0,0,0,0
0,0,0,0,0,0,0,0,0,0,0,0,0,0,0,0,1037649,2023-11-01T00:00:00.000Z,56677855,1,Seth Lundy,0,0,0,0,0,0
0,0,0,0,0,0,0,0,0,0,0,0,0,0,0,0,1037649,2023-11-01T00:00:00.000Z,3547297,1,Trent Forrest,0,0,0,0,0,0
0,0,0,0,0,0,0,0,0,0,0,0,0,0,0,0,1037649,2023-11-01T00:00:00.000Z,301,1,Wesley Matthews,0,0,0,0,0,0
3,1,2,4,2,16,10,1,0,24,3,5,22,5,2,1,1037649,2023-11-01T00:00:00.000Z,3547242,30,Deni Avdija,3,27,30,25,8,40.5
1,0,0,6,2,13,5,1,1,20,0,1,13,0,1,1,1037649,2023-11-01T00:00:00.000Z,666848,30,Jordan Poole,1,13,14,14,1,16.5
6,0,9,6,1,21,11,3,2,25,0,1,25,9,0,1,1037649,2023-11-01T00:00:00.000Z,265,30,Kyle Kuzma,0,34,40,31,15,43.8
1,1,3,4,1,7,2,2,2,22,1,3,7,4,1,2,1037649,2023-11-01T00:00:00.000Z,337,30,Mike Muscala,2,11,12,8,5,17.3
3,0,1,3,0,6,3,0,0,22,0,1,6,1,1,1,1037649,2023-11-01T00:00:00.000Z,249,30,Tyus Jones,1,7,10,9,4,13.7
0,1,2,1,1,3,1,2,2,11,2,0,5,4,1,1,1037650,2023-11-01T00:00:00.000Z,219,2,Al Horford,2,9,9,5,4,14.8
1,0,3,0,0,4,4,3,3,8,0,2,11,3,1,0,1037650,2023-11-01T00:00:00.000Z,17896094,2,Dalano Banton,1,14,15,12,4,19.1
4,0,2,7,4,10,7,0,0,27,1,3,18,3,0,2,1037650,2023-11-01T00:00:00.000Z,473,2,Derrick White,0,21,25,22,7,25.6
1,0,6,1,0,15,7,2,2,25,1,3,16,7,0,2,1037650,2023-11-01T00:00:00.000Z,70,2,Jaylen Brown,0,23,24,17,8,23.9
4,0,10,5,3,15,9,10,9,27,2,1,30,12,0,2,1037650,2023-11-01T00:00:00.000Z,434,2,Jayson Tatum,0,42,46,34,16,48.4
0,0,0,0,0,0,0,0,0,0,0,0,0,0,0,0,1037650,2023-11-01T00:00:00.000Z,38017707,2,JD Davison,0,0,0,0,0,0
4,1,7,4,3,9,6,0,0,25,0,0,15,7,0,1,1037650,2023-11-01T00:00:00.000Z,214,2,Jrue Holiday,1,22,26,19,11,31.4
2,0,5,3,1,7,3,6,6,27,1,3,13,6,0,2,1037650,2023-11-01T00:00:00.000Z,378,2,Kristaps Porzingis,0,19,21,15,8,21.2
2,0,0,0,0,4,2,0,0,7,2,2,4,2,0,0,1037650,2023-11-01T00:00:00.000Z,3547279,2,Lamar Stevens,0,6,8,6,4,9.4
0,0,1,0,0,1,1,0,0,6,1,0,2,2,0,0,1037650,2023-11-01T00:00:00.000Z,261,2,Luke Kornet,0,4,4,2,2,4.4
0,0,0,0,0,0,0,0,0,0,0,0,0,0,0,0,1037650,2023-11-01T00:00:00.000Z,3547295,2,Nathan Knight,0,0,0,0,0,0
0,0,1,1,0,4,1,2,2,20,0,0,4,1,2,0,1037650,2023-11-01T00:00:00.000Z,666468,2,Oshae Brissett,2,5,5,4,1,11.2
9,0,3,3,2,10,6,1,1,26,1,2,15,4,0,0,1037650,2023-11-01T00:00:00.000Z,3547276,2,Payton Pritchard,0,19,28,24,13,33.3
0,0,3,6,5,7,5,2,2,20,0,3,17,3,1,1,1037650,2023-11-01T00:00:00.000Z,17896060,2,Sam Hauser,1,20,20,17,3,22.6
0,0,3,4,1,6,2,0,0,11,0,0,5,3,0,0,1037650,2023-11-01T00:00:00.000Z,338,2,Svi Mykhailiuk,0,8,8,5,3,8.6
1,0,0,6,1,9,4,1,0,18,1,4,9,1,0,0,1037650,2023-11-01T00:00:00.000Z,3547250,12,Aaron Nesmith,0,10,11,10,2,11.7
5,0,3,4,1,8,3,0,0,24,1,3,7,4,1,1,1037650,2023-11-01T00:00:00.000Z,210,12,Buddy Hield,1,11,16,12,9,21.3
1,4,3,0,0,5,3,2,1,19,0,1,7,3,0,1,1037650,2023-11-01T00:00:00.000Z,17896035,12,Isaiah Jackson,4,10,11,8,4,23.1
5,0,5,1,0,13,8,2,2,28,2,2,18,7,1,1,1037650,2023-11-01T00:00:00.000Z,304,12,T.J. McConnell,1,25,30,23,12,35.9
1,1,2,7,2,19,4,4,3,34,0,2,13,2,3,4,1037651,2023-11-01T00:00:00.000Z,17896048,3,Cam Thomas,4,15,16,14,3,24.9
0,0,0,0,0,0,0,0,0,0,0,0,0,0,0,0,1037651,2023-11-01T00:00:00.000Z,666679,3,Cameron Johnson,0,0,0,0,0,0
0,0,0,0,0,0,0,0,0,0,0,0,0,0,0,0,1037651,2023-11-01T00:00:00.000Z,56677841,3,Dariq Whitehead,0,0,0,0,0,0
1,0,6,0,0,3,2,2,1,13,1,0,5,7,1,0,1037651,2023-11-01T00:00:00.000Z,17896038,3,Day'Ron Sharpe,1,12,13,6,8,17.9
0,0,0,0,0,0,0,0,0,0,0,0,0,0,0,0,1037651,2023-11-01T00:00:00.000Z,421,3,Dennis Smith Jr.,0,0,0,0,0,0
0,1,1,0,0,1,0,0,0,5,0,0,0,1,0,0,1037651,2023-11-01T00:00:00.000Z,56677722,3,Jalen Wilson,1,1,1,0,1,4.2
0,0,0,0,0,0,0,0,0,0,0,0,0,0,0,0,1037651,2023-11-01T00:00:00.000Z,17896041,3,Keon Johnson,0,0,0,0,0,0
4,0,2,4,1,9,4,11,8,25,1,1,17,3,3,3,1037651,2023-11-01T00:00:00.000Z,464,3,Lonnie Walker IV,3,20,24,21,7,32.6
0,0,0,0,0,0,0,0,0,0,0,0,0,0,0,0,1037651,2023-11-01T00:00:00.000Z,56677843,3,Noah Clowney,0,0,0,0,0,0
0,0,0,0,0,0,0,0,0,0,0,0,0,0,0,0,1037651,2023-11-01T00:00:00.000Z,130,3,Spencer Dinwiddie,0,0,0,0,0,0
4,0,3,2,1,6,4,2,2,14,1,2,11,4,1,1,1037651,2023-11-01T00:00:00.000Z,17896058,3,Trendon Watford,1,15,19,15,8,23.8
3,2,10,0,0,12,8,5,5,33,4,0,21,14,2,4,1037651,2023-11-01T00:00:00.000Z,4,16,Bam Adebayo,4,35,38,24,17,50.3
0,0,0,0,0,0,0,0,0,0,0,0,0,0,0,0,1037651,2023-11-01T00:00:00.000Z,666747,16,Caleb Martin,0,0,0,0,0,0
0,0,0,0,0,0,0,0,0,0,0,0,0,0,0,0,1037651,2023-11-01T00:00:00.000Z,19465585,16,Dru Smith,0,0,0,0,0,0
2,0,3,6,1,8,2,0,0,21,0,4,5,3,0,1,1037651,2023-11-01T00:00:00.000Z,397,16,Duncan Robinson,0,8,10,7,5,10.6
2,1,4,4,3,5,3,0,0,22,0,0,9,4,1,1,1037651,2023-11-01T00:00:00.000Z,3092,16,Haywood Highsmith,2,13,15,11,6,21.8
0,0,0,0,0,0,0,0,0,0,0,0,0,0,0,0,1037651,2023-11-01T00:00:00.000Z,38017734,16,Jamal Cain,0,0,0,0,0,0
3,0,3,2,0,16,7,8,6,34,4,1,20,7,1,1,1037651,2023-11-01T00:00:00.000Z,79,16,Jimmy Butler,1,27,30,23,10,34.9
3,0,3,5,1,9,1,2,1,30,0,2,4,3,1,0,1037651,2023-11-01T00:00:00.000Z,391,16,Josh Richardson,1,7,10,7,6,15.1
0,0,0,0,0,0,0,0,0,0,0,0,0,0,0,0,1037651,2023-11-01T00:00:00.000Z,285,16,Kevin Love,0,0,0,0,0,0
3,1,3,5,2,5,2,0,0,30,0,3,6,3,2,2,1037651,2023-11-01T00:00:00.000Z,286,16,Kyle Lowry,3,9,12,9,6,21.1
0,0,0,0,0,0,0,0,0,0,0,0,0,0,0,0,1037651,2023-11-01T00:00:00.000Z,38017696,16,Nikola Jovic,0,0,0,0,0,0
0,0,0,0,0,0,0,0,0,0,0,0,0,0,0,0,1037651,2023-11-01T00:00:00.000Z,39398582,16,Orlando Robinson,0,0,0,0,0,0
0,0,0,0,0,0,0,0,0,0,0,0,0,0,0,0,1037651,2023-11-01T00:00:00.000Z,3547257,16,R.J. Hampton,0,0,0,0,0,0
0,0,4,0,0,4,3,2,2,15,1,4,8,5,1,2,1037651,2023-11-01T00:00:00.000Z,74,16,Thomas Bryant,1,13,13,8,5,15
5,0,3,10,6,23,12,1,0,36,0,2,30,3,0,3,1037651,2023-11-01T00:00:00.000Z,666633,16,Tyler Herro,0,33,38,35,8,38.1
5,0,6,4,3,14,6,4,4,30,0,3,19,6,1,3,1037652,2023-11-01T00:00:00.000Z,277,6,Caris LeVert,1,25,30,24,11,33.7
0,0,1,0,0,1,1,2,2,11,0,3,4,1,1,0,1037652,2023-11-01T00:00:00.000Z,56677872,6,Craig Porter,1,5,5,4,1,8.2
0,0,0,0,0,0,0,0,0,0,0,0,0,0,0,0,1037652,2023-11-01T00:00:00.000Z,248,6,Damian Jones,0,0,0,0,0,0
0,0,2,3,2,3,2,0,0,20,1,0,6,3,0,0,1037652,2023-11-01T00:00:00.000Z,666940,6,Dean Wade,0,9,9,6,3,9.6
4,1,5,15,6,22,9,6,6,37,1,5,30,6,1,5,1037652,2023-11-01T00:00:00.000Z,322,6,Donovan Mitchell,2,36,40,34,10,44.2
0,0,0,0,0,0,0,0,0,0,0,0,0,0,0,0,1037652,2023-11-01T00:00:00.000Z,56677847,6,Emoni Bates,0,0,0,0,0,0
5,2,6,0,0,12,6,3,2,35,2,2,14,8,2,2,1037652,2023-11-01T00:00:00.000Z,17896076,6,Evan Mobley,4,22,27,19,13,41.1
2,0,10,3,1,6,1,2,2,28,0,4,5,10,1,0,1037652,2023-11-01T00:00:00.000Z,344,6,Georges Niang,1,15,17,7,12,23
2,0,3,2,0,3,1,0,0,31,0,6,2,3,1,1,1037652,2023-11-01T00:00:00.000Z,3547247,6,Isaac Okoro,1,5,7,4,5,10.6
0,0,0,0,0,0,0,0,0,0,0,0,0,0,0,0,1037652,2023-11-01T00:00:00.000Z,38017662,6,Isaiah Mobley,0,0,0,0,0,0
4,2,4,5,0,9,3,3,3,35,0,3,9,4,0,5,1037652,2023-11-01T00:00:00.000Z,666908,6,Max Strus,2,13,17,13,8,20.8
0,0,0,0,0,0,0,0,0,0,0,0,0,0,0,0,1037652,2023-11-01T00:00:00.000Z,3547299,6,Sam Merrill,0,0,0,0,0,0
0,0,3,0,0,4,3,0,0,13,2,1,6,5,0,2,1037652,2023-11-01T00:00:00.000Z,444,6,Tristan Thompson,0,11,11,6,5,10
0,0,0,0,0,0,0,0,0,0,0,0,0,0,0,0,1037652,2023-11-01T00:00:00.000Z,666474,20,Charles Brown,0,0,0,0,0,0
0,0,0,0,0,0,0,0,0,0,0,0,0,0,0,0,1037652,2023-11-01T00:00:00.000Z,666675,20,DaQuan Jeffries,0,0,0,0,0,0
0,0,0,0,0,0,0,0,0,0,0,0,0,0,0,0,1037652,2023-11-01T00:00:00.000Z,17896089,20,Duane Washington Jr.,0,0,0,0,0,0
0,0,0,0,0,0,0,0,0,0,0,0,0,0,0,0,1037652,2023-11-01T00:00:00.000Z,666971,20,Dylan Windler,0,0,0,0,0,0
0,0,0,0,0,0,0,0,0,0,0,0,0,0,0,0,1037652,2023-11-01T00:00:00.000Z,160,20,Evan Fournier,0,0,0,0,0,0
0,0,0,0,0,0,0,0,0,0,0,0,0,0,0,0,1037652,2023-11-01T00:00:00.000Z,56677795,20,Jacob Toppin,0,0,0,0,0,0
0,0,0,0,0,0,0,0,0,0,0,0,0,0,0,0,1037652,2023-11-01T00:00:00.000Z,17896063,20,Jericho Sims,0,0,0,0,0,0
4,0,6,6,0,15,3,0,0,35,0,2,6,6,1,3,1037652,2023-11-01T00:00:00.000Z,387,20,Julius Randle,1,12,16,10,10,19.2
0,0,0,0,0,0,0,0,0,0,0,0,0,0,0,0,1037652,2023-11-01T00:00:00.000Z,666423,20,RJ Barrett,0,0,0,0,0,0
0,0,0,0,0,0,0,0,0,0,0,0,0,0,0,0,1037653,2023-11-01T00:00:00.000Z,227,19,Brandon Ingram,0,0,0,0,0,0
0,0,0,0,0,2,0,0,0,2,2,0,0,2,0,0,1037653,2023-11-01T00:00:00.000Z,491,19,Cody Zeller,0,2,2,0,2,2.4
0,0,0,0,0,0,0,0,0,0,0,0,0,0,0,0,1037653,2023-11-01T00:00:00.000Z,38017726,19,Dereon Seabron,0,0,0,0,0,0
0,0,0,0,0,0,0,0,0,0,0,0,0,0,0,0,1037653,2023-11-01T00:00:00.000Z,38017663,19,E.J. Liddell,0,0,0,0,0,0
0,0,0,0,0,0,0,0,0,0,0,0,0,0,0,0,1037653,2023-11-01T00:00:00.000Z,17896097,19,Jose Alvarado,0,0,0,0,0,0
0,0,0,0,0,0,0,0,0,0,0,0,0,0,0,0,1037653,2023-11-01T00:00:00.000Z,666584,19,Kaiser Gates,0,0,0,0,0,0
0,0,0,0,0,0,0,0,0,0,0,0,0,0,0,0,1037653,2023-11-01T00:00:00.000Z,3547293,19,Naji Marshall,0,0,0,0,0,0
0,0,0,0,0,0,0,0,0,0,0,0,0,0,0,0,1037653,2023-11-01T00:00:00.000Z,18677986,19,Trey Murphy III,0,0,0,0,0,0
2,0,4,1,0,5,4,2,2,14,0,5,10,4,0,2,1037653,2023-11-01T00:00:00.000Z,17896078,21,Aaron Wiggins,0,14,16,12,6,15.8
1,0,2,0,0,2,1,2,2,18,0,4,4,2,0,0,1037653,2023-11-01T00:00:00.000Z,56677833,21,Cason Wallace,0,6,7,5,3,7.9
3,2,8,5,1,14,8,2,2,37,3,4,19,11,1,5,1037653,2023-11-01T00:00:00.000Z,38017685,21,Chet Holmgren,3,30,33,22,14,40.7
0,0,0,0,0,0,0,0,0,0,0,0,0,0,0,0,1037653,2023-11-01T00:00:00.000Z,44,21,Davis Bertans,0,0,0,0,0,0
1,0,1,7,2,7,2,3,3,14,0,0,9,1,0,0,1037653,2023-11-01T00:00:00.000Z,3547272,21,Isaiah Joe,0,10,11,10,2,11.7
3,0,7,3,0,13,5,9,8,38,1,3,18,8,0,1,1037653,2023-11-01T00:00:00.000Z,38017703,21,Jalen Williams,0,26,29,21,11,31.1
4,1,9,4,1,16,6,2,2,31,0,1,15,9,1,2,1037653,2023-11-01T00:00:00.000Z,17896065,21,Josh Giddey,2,24,28,19,13,35.8
0,0,0,0,0,0,0,0,0,1,0,0,0,0,0,0,1037653,2023-11-01T00:00:00.000Z,27924547,21,Lindy Waters III,0,0,0,0,0,0
0,0,1,6,3,7,3,0,0,30,1,4,9,2,1,1,1037653,2023-11-01T00:00:00.000Z,666541,21,Luguentz Dort,1,11,11,9,2,13.4
0,2,4,0,0,0,0,0,0,7,1,1,0,5,0,1,1037653,2023-11-01T00:00:00.000Z,24572055,21,Olivier Sarr,2,5,5,0,5,11
1,0,2,3,0,4,1,0,0,12,0,0,2,2,0,0,1037653,2023-11-01T00:00:00.000Z,38017716,21,Ousmane Dieng,0,4,5,3,3,5.9
8,0,5,5,0,20,8,5,4,38,0,2,20,5,3,2,1037653,2023-11-01T00:00:00.000Z,175,21,Shai Gilgeous-Alexander,3,25,33,28,13,45
0,0,0,0,0,0,0,0,0,0,0,0,0,0,0,0,1037653,2023-11-01T00:00:00.000Z,17896036,21,Tre Mann,0,0,0,0,0,0
0,0,0,0,0,0,0,0,0,0,0,0,0,0,0,0,1037654,2023-11-01T00:00:00.000Z,666748,4,Cody Martin,0,0,0,0,0,0
0,0,0,0,0,0,0,0,0,0,0,0,0,0,0,0,1037654,2023-11-01T00:00:00.000Z,347,4,Frank Ntilikina,0,0,0,0,0,0
5,1,5,1,0,11,6,7,5,31,2,1,17,7,1,1,1037654,2023-11-01T00:00:00.000Z,204,4,Gordon Hayward,2,24,29,22,12,37.9
0,0,0,0,0,0,0,0,0,0,0,0,0,0,0,0,1037654,2023-11-01T00:00:00.000Z,422,4,Ish Smith,0,0,0,0,0,0
0,0,0,0,0,0,0,0,0,0,0,0,0,0,0,0,1037654,2023-11-01T00:00:00.000Z,17896037,4,James Bouknight,0,0,0,0,0,0
0,1,5,3,1,4,2,0,0,13,0,2,5,5,3,1,1037654,2023-11-01T00:00:00.000Z,18678001,4,JT Thor,4,10,10,5,5,22
5,0,0,6,2,15,7,4,3,33,1,4,19,1,1,3,1037654,2023-11-01T00:00:00.000Z,3547239,4,LaMelo Ball,1,20,25,24,6,27.7
1,2,3,0,0,4,3,6,3,25,3,0,9,6,2,1,1037654,2023-11-01T00:00:00.000Z,38017698,4,Mark Williams,4,15,16,10,7,28.7
0,0,0,0,0,0,0,0,0,0,0,0,0,0,0,0,1037654,2023-11-01T00:00:00.000Z,56677846,4,Nick Smith Jr.,0,0,0,0,0,0
0,0,2,6,5,13,8,2,2,35,1,2,23,3,0,1,1037654,2023-11-01T00:00:00.000Z,666950,4,P.J. Washington,0,26,26,23,3,25.6
6,0,1,6,1,21,10,0,0,39,2,0,21,3,1,4,1037654,2023-11-01T00:00:00.000Z,403,4,Terry Rozier,1,24,30,27,9,32.6
1,0,1,2,2,2,2,0,0,11,0,1,6,1,0,1,1037654,2023-11-01T00:00:00.000Z,213,11,Aaron Holiday,0,7,8,7,2,7.7
1,0,1,1,0,3,1,2,2,13,0,3,4,1,1,1,1037654,2023-11-01T00:00:00.000Z,56677825,11,Amen Thompson,1,5,6,5,2,8.7
0,0,0,0,0,0,0,0,0,0,0,0,0,0,0,0,1037654,2023-11-01T00:00:00.000Z,56677831,11,Cam Whitmore,0,0,0,0,0,0
5,0,5,2,1,5,1,2,1,19,1,4,4,6,0,0,1037654,2023-11-01T00:00:00.000Z,3547301,11,Jae'Sean Tate,0,10,15,9,11,18.7
0,0,0,0,0,0,0,0,0,0,0,0,0,0,0,0,1037654,2023-11-01T00:00:00.000Z,47738533,11,Jeenathan Williams,0,0,0,0,0,0
0,0,2,2,2,3,2,4,3,12,0,1,9,2,0,1,1037654,2023-11-01T00:00:00.000Z,188,11,Jeff Green,0,11,11,9,2,10.4
1,1,2,3,0,7,1,2,2,19,3,1,4,5,1,1,1037654,2023-11-01T00:00:00.000Z,19465326,11,Jock Landale,2,9,10,5,6,16.5
0,0,0,0,0,0,0,0,0,0,0,0,0,0,0,0,1037654,2023-11-01T00:00:00.000Z,3547281,11,Nate Hinton,0,0,0,0,0,0
0,0,0,0,0,0,0,0,0,0,0,0,0,0,0,0,1037654,2023-11-01T00:00:00.000Z,75,11,Reggie Bullock,0,0,0,0,0,0
0,0,0,0,0,0,0,0,0,0,0,0,0,0,0,0,1037654,2023-11-01T00:00:00.000Z,38017695,11,Tari Eason,0,0,0,0,0,0
0,0,0,0,0,0,0,0,0,0,0,0,0,0,0,0,1037654,2023-11-01T00:00:00.000Z,357,11,Victor Oladipo,0,0,0,0,0,0
3,0,0,0,0,2,0,0,0,5,0,2,0,0,0,0,1037655,2023-11-01T00:00:00.000Z,17896007,8,Braxton Key,0,0,3,3,3,4.5
2,1,6,1,0,8,4,0,0,20,3,3,8,9,0,1,1037655,2023-11-01T00:00:00.000Z,38017709,8,Christian Braun,1,17,19,10,11,23.8
0,0,0,0,0,0,0,0,0,0,0,0,0,0,0,0,1037655,2023-11-01T00:00:00.000Z,38017727,8,Collin Gillespie,0,0,0,0,0,0
0,0,0,0,0,0,0,0,0,0,0,0,0,0,0,0,1037655,2023-11-01T00:00:00.000Z,250,8,DeAndre Jordan,0,0,0,0,0,0
0,0,1,1,0,2,1,0,0,4,0,2,2,1,0,0,1037655,2023-11-01T00:00:00.000Z,56677871,8,Hunter Tyson,0,3,3,2,1,3.2
0,0,2,1,0,2,1,0,0,5,0,1,2,2,0,0,1037655,2023-11-01T00:00:00.000Z,56677582,8,Jalen Pickett,0,4,4,2,2,4.4
6,1,4,4,1,16,5,5,3,32,2,3,14,6,1,3,1037655,2023-11-01T00:00:00.000Z,335,8,Jamal Murray,2,20,26,20,12,33.2
0,0,0,0,0,0,0,0,0,0,0,0,0,0,0,0,1037655,2023-11-01T00:00:00.000Z,17896103,8,Jay Huff,0,0,0,0,0,0
0,2,0,6,1,7,2,1,0,16,0,0,5,0,1,0,1037655,2023-11-01T00:00:00.000Z,56677776,8,Julian Strawther,3,5,5,5,0,14
0,1,0,1,1,4,2,1,1,26,0,2,6,0,1,1,1037655,2023-11-01T00:00:00.000Z,81,8,Kentavious Caldwell-Pope,2,6,6,6,0,11
1,0,2,1,0,3,2,0,0,16,0,2,4,2,0,2,1037655,2023-11-01T00:00:00.000Z,38017721,8,Peyton Watson,0,6,7,5,3,5.9
5,1,0,1,0,4,1,0,0,19,0,0,2,0,2,1,1037655,2023-11-01T00:00:00.000Z,236,8,Reggie Jackson,3,2,7,7,5,17.5
0,0,0,0,0,0,0,0,0,0,0,0,0,0,0,0,1037655,2023-11-01T00:00:00.000Z,666489,8,Vlatko Cancar,0,0,0,0,0,0
0,2,3,3,1,9,4,0,0,18,2,3,9,5,0,0,1037655,2023-11-01T00:00:00.000Z,3547268,8,Zeke Nnaji,2,14,14,9,5,21
1,0,2,4,1,16,8,8,7,32,0,1,24,2,2,4,1037655,2023-11-01T00:00:00.000Z,3547238,18,Anthony Edwards,2,26,27,25,3,29.9
0,0,0,0,0,0,0,0,0,0,0,0,0,0,0,0,1037655,2023-11-01T00:00:00.000Z,17895968,18,Daishen Nix,0,0,0,0,0,0
2,2,6,1,0,5,3,0,0,21,3,5,6,9,0,4,1037655,2023-11-01T00:00:00.000Z,3547259,18,Jaden McDaniels,2,15,17,8,11,21.8
0,0,0,1,0,1,0,0,0,4,0,0,0,0,0,0,1037655,2023-11-01T00:00:00.000Z,666767,18,Jordan McLaughlin,0,0,0,0,0,0
4,0,6,4,1,19,7,6,6,31,2,2,21,8,2,1,1037655,2023-11-01T00:00:00.000Z,447,18,Karl-Anthony Towns,2,29,33,25,12,41.6
2,0,3,1,1,6,4,0,0,25,0,0,9,3,0,0,1037655,2023-11-01T00:00:00.000Z,12,18,Kyle Anderson,0,12,14,11,5,15.6
6,0,3,4,3,9,7,0,0,27,0,1,17,3,1,0,1037655,2023-11-01T00:00:00.000Z,104,18,Mike Conley,1,20,26,23,9,32.6
1,0,4,3,1,9,6,3,3,19,1,0,16,5,1,1,1037655,2023-11-01T00:00:00.000Z,667378,18,Naz Reid,1,21,22,17,6,25.5
1,1,0,2,1,6,2,0,0,21,0,2,5,0,0,0,1037655,2023-11-01T00:00:00.000Z,666400,18,Nickeil Alexander-Walker,1,5,6,6,1,9.5
1,2,10,0,0,7,0,4,4,33,2,3,4,12,1,1,1037655,2023-11-01T00:00:00.000Z,176,18,Rudy Gobert,3,16,17,5,13,27.9
1,0,1,0,0,3,0,2,2,18,0,1,2,1,2,1,1037655,2023-11-01T00:00:00.000Z,320,18,Shake Milton,2,3,4,3,2,9.7
1,0,4,1,0,1,0,4,4,5,0,0,4,4,0,1,1037655,2023-11-01T00:00:00.000Z,68,18,Troy Brown Jr.,0,8,9,5,5,9.3
1,1,2,3,0,6,3,0,0,22,2,4,6,4,1,2,1037656,2023-11-01T00:00:00.000Z,89,5,Alex Caruso,2,10,11,7,5,16.3
0,0,2,0,0,5,4,0,0,12,1,2,8,3,2,0,1037656,2023-11-01T00:00:00.000Z,137,5,Andre Drummond,2,11,11,8,3,17.6
4,0,1,6,1,12,4,2,1,33,0,3,10,1,0,3,1037656,2023-11-01T00:00:00.000Z,666956,5,Coby White,0,11,15,14,5,14.2
2,1,1,2,2,7,5,0,0,15,0,0,12,1,1,1,1037656,2023-11-01T00:00:00.000Z,87,5,Jevon Carter,2,13,15,14,3,21.2
1,0,3,1,0,2,1,0,0,17,2,3,2,5,0,0,1037656,2023-11-01T00:00:00.000Z,110,5,Torrey Craig,0,7,8,3,6,9.5
1,0,2,9,5,17,7,3,3,36,0,2,22,2,2,0,1037656,2023-11-01T00:00:00.000Z,268,5,Zach LaVine,2,24,25,23,3,31.9
1,0,4,9,3,13,7,0,0,31,1,2,17,5,0,0,1037656,2023-11-01T00:00:00.000Z,247,7,Derrick Jones Jr.,0,22,23,18,6,24.5
1,0,3,9,7,10,7,6,4,30,2,1,25,5,1,0,1037656,2023-11-01T00:00:00.000Z,666965,7,Grant Williams,1,30,31,26,6,35.5
0,0,0,0,0,0,0,0,0,0,0,0,0,0,0,0,1037656,2023-11-01T00:00:00.000Z,329,7,Markieff Morris,0,0,0,0,0,0
0,0,0,0,0,0,0,0,0,0,0,0,0,0,0,0,1037657,2023-11-01T00:00:00.000Z,666505,15,Brandon Clarke,0,0,0,0,0,0
0,0,0,0,0,0,0,0,0,0,0,0,0,0,0,0,1037657,2023-11-01T00:00:00.000Z,666786,15,Ja Morant,0,0,0,0,0,0
0,0,0,2,0,4,2,0,0,8,0,0,4,0,0,0,1037657,2023-11-01T00:00:00.000Z,38017728,15,Jake LaRavia,0,4,4,4,0,4
2,0,3,1,1,7,4,9,3,19,2,5,12,5,2,1,1037657,2023-11-01T00:00:00.000Z,38017732,15,Kenneth Lofton Jr.,2,17,19,14,7,26
0,0,0,0,0,0,0,0,0,0,0,0,0,0,0,0,1037657,2023-11-01T00:00:00.000Z,17896067,15,Santi Aldama,0,0,0,0,0,0
0,0,0,0,0,0,0,0,0,0,0,0,0,0,0,0,1037657,2023-11-01T00:00:00.000Z,3,15,Steven Adams,0,0,0,0,0,0
3,3,2,4,1,5,2,8,7,16,0,3,12,2,1,1,1037657,2023-11-01T00:00:00.000Z,38017731,15,Vince Williams Jr.,4,14,17,15,5,29.9
0,0,1,0,0,3,0,0,0,14,3,3,0,4,1,2,1037657,2023-11-01T00:00:00.000Z,3547285,15,Xavier Tillman,1,4,4,0,4,5.8
0,2,3,5,2,5,2,2,2,19,1,2,8,4,0,1,1037657,2023-11-01T00:00:00.000Z,17896027,15,Ziaire Williams,2,12,12,8,4,17.8
6,0,2,6,4,10,8,3,3,22,1,1,23,3,0,2,1037657,2023-11-01T00:00:00.000Z,413,29,Collin Sexton,0,26,32,29,9,33.6
2,0,2,5,2,12,5,6,4,28,2,2,16,4,2,1,1037657,2023-11-01T00:00:00.000Z,101,29,John Collins,2,20,22,18,6,28.8
0,0,0,0,0,0,0,0,0,0,0,0,0,0,0,0,1037657,2023-11-01T00:00:00.000Z,38017630,29,Johnny Juzang,0,0,0,0,0,0
0,0,0,0,0,0,0,0,0,0,0,0,0,0,0,0,1037657,2023-11-01T00:00:00.000Z,17896023,29,Josh Christopher,0,0,0,0,0,0
1,0,10,6,4,11,6,3,3,28,1,5,19,11,1,0,1037657,2023-11-01T00:00:00.000Z,297,29,Lauri Markkanen,1,30,31,20,12,36.7
0,0,0,0,0,0,0,0,0,0,0,0,0,0,0,0,1037657,2023-11-01T00:00:00.000Z,19465584,29,Micah Potter,0,0,0,0,0,0
1,0,2,0,0,2,1,2,1,7,1,3,3,3,0,1,1037657,2023-11-01T00:00:00.000Z,11891374,29,Omer Yurtseven,0,6,7,4,4,7.1
0,0,2,1,0,10,6,2,2,25,0,2,14,2,0,1,1037658,2023-11-01T00:00:00.000Z,475,10,Andrew Wiggins,0,16,16,14,2,15.4
0,0,0,0,0,0,0,0,0,0,0,0,0,0,0,0,1037658,2023-11-01T00:00:00.000Z,56677858,10,Brandin Podziemski,0,0,0,0,0,0
8,0,3,3,0,5,1,0,0,28,1,2,2,4,1,0,1037658,2023-11-01T00:00:00.000Z,367,10,Chris Paul,1,6,14,10,12,21.8
0,0,0,0,0,0,0,0,0,0,0,0,0,0,0,0,1037658,2023-11-01T00:00:00.000Z,251,10,Cory Joseph,0,0,0,0,0,0
2,0,6,5,3,9,6,0,0,20,0,1,15,6,0,3,1037658,2023-11-01T00:00:00.000Z,407,10,Dario Saric,0,21,23,17,8,22.2
9,2,0,4,2,7,4,4,3,28,2,1,13,2,2,2,1037658,2023-11-01T00:00:00.000Z,185,10,Draymond Green,4,15,24,22,11,38.9
1,0,2,0,0,4,2,0,0,22,0,0,4,2,1,1,1037658,2023-11-01T00:00:00.000Z,2189,10,Gary Payton II,1,6,7,5,3,9.9
0,0,0,0,0,0,0,0,0,0,0,0,0,0,0,0,1037658,2023-11-01T00:00:00.000Z,398,10,Jerome Robinson,0,0,0,0,0,0
1,0,1,2,1,9,4,3,3,17,0,2,12,1,1,1,1037658,2023-11-01T00:00:00.000Z,17553979,10,Jonathan Kuminga,1,13,14,13,2,16.7
6,0,7,0,0,4,3,0,0,23,2,2,6,9,0,0,1037658,2023-11-01T00:00:00.000Z,282,10,Kevon Looney,0,15,21,12,15,25.8
2,3,1,4,1,15,6,1,1,29,1,3,14,2,0,2,1037658,2023-11-01T00:00:00.000Z,443,10,Klay Thompson,3,16,18,16,4,26.4
0,0,0,0,0,0,0,0,0,0,0,0,0,0,0,0,1037658,2023-11-01T00:00:00.000Z,45658838,10,Lester Quinones,0,0,0,0,0,0
0,1,3,2,0,3,0,2,1,15,0,1,1,3,0,0,1037658,2023-11-01T00:00:00.000Z,17553992,10,Moses Moody,1,4,4,1,3,7.6
3,0,4,10,4,15,7,3,3,32,1,3,21,5,0,7,1037658,2023-11-01T00:00:00.000Z,115,10,Stephen Curry,0,26,29,24,8,24.5
0,0,0,0,0,0,0,0,0,1,0,0,0,0,0,0,1037658,2023-11-01T00:00:00.000Z,56677799,10,Trayce Jackson-Davis,0,0,0,0,0,0
0,0,0,0,0,0,0,0,0,0,0,0,0,0,0,0,1037658,2023-11-01T00:00:00.000Z,17896070,10,Usman Garuba,0,0,0,0,0,0
7,0,8,1,0,16,8,12,7,37,3,2,23,11,0,2,1037658,2023-11-01T00:00:00.000Z,406,26,Domantas Sabonis,0,34,41,30,18,44.7
1,0,0,7,4,8,4,2,2,31,1,0,14,1,1,1,1037658,2023-11-01T00:00:00.000Z,30,26,Harrison Barnes,1,15,16,15,2,18.7
2,0,4,7,0,15,4,2,2,39,2,2,10,6,2,0,1037658,2023-11-01T00:00:00.000Z,38017688,26,Keegan Murray,2,16,18,12,8,26.2
0,0,0,0,0,0,0,0,0,0,0,0,0,0,0,0,1037658,2023-11-01T00:00:00.000Z,290,26,Trey Lyles,0,0,0,0,0,0
0,0,7,0,0,8,3,2,1,29,2,5,7,9,0,1,1037659,2023-11-01T00:00:00.000Z,493,13,Ivica Zubac,0,16,16,7,9,16.8
5,0,5,11,5,28,15,6,3,41,1,2,38,6,2,2,1037659,2023-11-01T00:00:00.000Z,274,13,Kawhi Leonard,2,44,49,43,11,56.7
5,0,1,3,0,7,2,0,0,34,0,3,4,1,1,0,1037659,2023-11-01T00:00:00.000Z,17896031,13,Nah'Shon Hyland,1,5,10,9,6,15.7
1,0,6,9,6,16,11,8,7,37,0,6,35,6,2,3,1037659,2023-11-01T00:00:00.000Z,172,13,Paul George,2,41,42,36,7,46.7
8,0,7,6,3,21,9,5,3,44,4,5,24,11,4,6,1037659,2023-11-01T00:00:00.000Z,472,13,Russell Westbrook,4,35,43,32,19,55.2
3,4,6,0,0,18,10,9,7,48,4,3,27,10,2,0,1037659,2023-11-01T00:00:00.000Z,117,14,Anthony Davis,6,37,40,30,13,61.5
7,0,5,3,0,13,5,5,5,38,2,4,15,7,3,5,1037659,2023-11-01T00:00:00.000Z,17553995,14,Austin Reaves,3,22,29,22,14,37.9
4,1,4,5,1,7,2,4,3,37,0,5,8,4,3,0,1037659,2023-11-01T00:00:00.000Z,666860,14,Cameron Reddish,4,12,16,12,8,30.8
0,1,9,4,2,6,4,0,0,29,2,3,10,11,1,2,1037659,2023-11-01T00:00:00.000Z,486,14,Christian Wood,2,21,21,10,11,27.2
6,0,2,7,3,19,10,4,4,36,0,2,27,2,0,3,1037659,2023-11-01T00:00:00.000Z,405,14,D'Angelo Russell,0,29,35,33,8,35.4
0,0,0,0,0,0,0,0,0,0,0,0,0,0,0,0,1037659,2023-11-01T00:00:00.000Z,1603383,14,Gabe Vincent,0,0,0,0,0,0
0,0,0,0,0,0,0,0,0,0,0,0,0,0,0,0,1037659,2023-11-01T00:00:00.000Z,457,14,Jarred Vanderbilt,0,0,0,0,0,0
7,2,12,8,4,19,13,10,5,42,0,3,35,12,1,4,1037659,2023-11-01T00:00:00.000Z,237,14,LeBron James,3,47,54,42,19,64.9
0,0,3,5,1,7,1,2,2,22,0,3,5,3,0,0,1037659,2023-11-01T00:00:00.000Z,38017697,14,Max Christie,0,8,8,5,3,8.6
0,1,2,0,0,4,3,0,0,12,3,2,6,5,0,1,1037660,2023-11-02T00:00:00.000Z,3547270,23,Paul Reed,1,11,11,6,5,14
0,1,2,2,0,4,2,2,2,13,2,3,6,4,0,1,1037660,2023-11-02T00:00:00.000Z,58,28,Chris Boucher,1,10,10,6,4,12.8
0,0,0,0,0,0,0,0,0,0,0,0,0,0,0,0,1037660,2023-11-02T00:00:00.000Z,38017710,28,Christian Koloko,0,0,0,0,0,0
10,0,3,2,1,9,4,6,4,31,0,0,13,3,1,3,1037660,2023-11-02T00:00:00.000Z,409,28,Dennis Schroder,1,16,26,23,13,31.6
0,0,5,5,2,8,2,4,2,23,0,1,8,5,1,3,1037660,2023-11-02T00:00:00.000Z,3089,28,Gary Trent Jr.,1,13,13,8,5,14
1,0,0,0,0,2,0,0,0,14,0,1,0,0,0,1,1037660,2023-11-02T00:00:00.000Z,56677828,28,Gradey Dick,0,0,1,1,1,0.5
2,1,7,0,0,8,4,1,1,28,2,2,9,9,0,4,1037660,2023-11-02T00:00:00.000Z,373,28,Jakob Poeltl,1,18,20,11,11,21.8
0,0,1,2,1,3,2,0,0,9,0,0,5,1,0,0,1037660,2023-11-02T00:00:00.000Z,666762,28,Jalen McDaniels,0,6,6,5,1,6.2
1,0,2,3,2,5,2,0,0,17,1,2,6,3,2,1,1037660,2023-11-02T00:00:00.000Z,3547275,28,Malachi Flynn,2,9,10,7,4,16.1
0,0,0,0,0,0,0,0,0,0,0,0,0,0,0,0,1037660,2023-11-02T00:00:00.000Z,56677869,28,Markquis Nowell,0,0,0,0,0,0
0,0,0,0,0,0,0,0,0,0,0,0,0,0,0,0,1037660,2023-11-02T00:00:00.000Z,376,28,Otto Porter Jr.,0,0,0,0,0,0
0,0,0,0,0,0,0,0,0,0,0,0,0,0,0,0,1037660,2023-11-02T00:00:00.000Z,38017717,28,Ron Harper Jr.,0,0,0,0,0,0
8,0,6,7,2,16,9,4,4,35,2,4,24,8,0,1,1037660,2023-11-02T00:00:00.000Z,17896055,28,Scottie Barnes,0,32,40,32,16,44.6
0,0,0,0,0,0,0,0,0,0,0,0,0,0,0,0,1037661,2023-11-02T00:00:00.000Z,77,9,Alec Burks,0,0,0,0,0,0
0,0,0,0,0,0,0,0,0,0,0,0,0,0,0,0,1037661,2023-11-02T00:00:00.000Z,54,9,Bojan Bogdanovic,0,0,0,0,0,0
11,0,2,7,2,22,8,5,4,34,0,4,22,2,1,6,1037661,2023-11-02T00:00:00.000Z,17896075,9,Cade Cunningham,1,24,35,33,13,37.9
0,0,0,0,0,0,0,0,0,0,0,0,0,0,0,0,1037661,2023-11-02T00:00:00.000Z,17896071,9,Isaiah Livers,0,0,0,0,0,0
0,2,6,3,1,7,3,6,4,35,2,3,11,8,0,2,1037661,2023-11-02T00:00:00.000Z,3547267,9,Isaiah Stewart,2,19,19,11,8,24.6
0,1,4,3,1,6,4,4,3,21,3,4,12,7,0,2,1037661,2023-11-02T00:00:00.000Z,38017682,9,Jaden Ivey,1,19,19,12,7,21.4
1,0,5,0,0,8,5,2,2,25,0,5,12,5,0,1,1037661,2023-11-02T00:00:00.000Z,38017694,9,Jalen Duren,0,17,18,13,6,18.5
0,0,0,0,0,0,0,0,0,0,0,0,0,0,0,0,1037661,2023-11-02T00:00:00.000Z,42097199,9,Jared Rhoden,0,0,0,0,0,0
1,0,2,6,2,8,3,0,0,24,1,4,8,3,1,1,1037661,2023-11-02T00:00:00.000Z,197,9,Joe Harris,1,11,12,9,4,15.1
9,0,2,4,2,8,4,0,0,39,3,4,10,5,1,0,1037661,2023-11-02T00:00:00.000Z,3547241,9,Killian Hayes,1,15,24,19,14,32.5
0,0,0,0,0,0,0,0,0,0,0,0,0,0,0,0,1037661,2023-11-02T00:00:00.000Z,56677729,9,Malcolm Cazalon,0,0,0,0,0,0
3,0,1,8,5,10,6,2,2,23,1,2,19,2,1,0,1037661,2023-11-02T00:00:00.000Z,56677792,9,Marcus Sasser,1,21,24,22,5,28.9
0,1,5,0,0,7,3,0,0,13,4,0,6,9,0,1,1037661,2023-11-02T00:00:00.000Z,24,9,Marvin Bagley III,1,15,15,6,9,18.8
0,0,0,0,0,0,0,0,0,0,0,0,0,0,0,0,1037661,2023-11-02T00:00:00.000Z,330,9,Monte Morris,0,0,0,0,0,0
0,0,0,1,0,1,0,0,0,1,0,0,0,0,0,0,1037661,2023-11-02T00:00:00.000Z,44477024,9,Stanley Umude,0,0,0,0,0,0
5,0,3,10,3,23,10,11,10,35,1,3,33,4,0,4,1037661,2023-11-02T00:00:00.000Z,303,19,CJ McCollum,0,37,42,38,9,41.3
6,0,6,2,2,4,3,2,2,25,1,2,10,7,1,1,1037661,2023-11-02T00:00:00.000Z,38017677,19,Dyson Daniels,1,17,23,16,13,29.4
3,4,5,1,0,7,6,9,9,34,0,4,21,5,3,0,1037661,2023-11-02T00:00:00.000Z,17896024,19,Herbert Jones,7,26,29,24,8,52.5
5,3,9,3,2,16,9,4,3,33,4,5,23,13,0,2,1037661,2023-11-02T00:00:00.000Z,455,19,Jonas Valanciunas,3,36,41,28,18,53.1
0,0,1,5,1,7,1,3,3,29,0,0,6,1,0,1,1037661,2023-11-02T00:00:00.000Z,56677837,19,Jordan Hawkins,0,7,7,6,1,6.2
4,0,3,1,0,5,1,4,4,20,0,1,6,3,1,1,1037661,2023-11-02T00:00:00.000Z,3547260,19,Kira Lewis Jr.,1,9,13,10,7,17.6
1,0,0,2,0,6,2,0,0,16,1,2,4,1,0,0,1037661,2023-11-02T00:00:00.000Z,340,19,Larry Nance Jr.,0,5,6,5,2,6.7
2,0,2,8,6,10,7,0,0,35,0,0,20,2,0,3,1037661,2023-11-02T00:00:00.000Z,17896017,19,Matt Ryan,0,22,24,22,4,22.4
0,0,0,0,0,0,0,0,0,0,0,0,0,0,0,0,1037662,2023-11-02T00:00:00.000Z,666885,22,Admiral Schofield,0,0,0,0,0,0
1,0,2,0,0,4,4,3,1,16,1,2,9,3,2,1,1037662,2023-11-02T00:00:00.000Z,56677827,22,Anthony Black,2,12,13,10,4,19.1
0,0,0,0,0,0,0,0,0,0,0,0,0,0,0,0,1037662,2023-11-02T00:00:00.000Z,38017724,22,Caleb Houstan,0,0,0,0,0,0
0,0,0,0,0,0,0,0,0,0,0,0,0,0,0,0,1037662,2023-11-02T00:00:00.000Z,666818,22,Chuma Okeke,0,0,0,0,0,0
7,0,7,4,2,10,5,6,6,31,0,3,18,7,2,3,1037662,2023-11-02T00:00:00.000Z,3547251,22,Cole Anthony,2,25,32,25,14,39.9
5,0,3,5,2,21,9,2,1,38,1,4,21,4,4,2,1037662,2023-11-02T00:00:00.000Z,17896026,22,Franz Wagner,4,25,30,26,9,43.3
1,1,0,2,0,2,0,0,0,14,0,1,0,0,0,0,1037662,2023-11-02T00:00:00.000Z,196,22,Gary Harris,1,0,1,1,1,4.5
0,0,0,0,0,0,0,0,0,0,0,0,0,0,0,0,1037662,2023-11-02T00:00:00.000Z,666442,22,Goga Bitadze,0,0,0,0,0,0
3,0,2,0,0,7,1,4,4,21,2,4,6,4,4,3,1037662,2023-11-02T00:00:00.000Z,17896073,22,Jalen Suggs,4,10,13,9,7,24.3
0,0,0,0,0,0,0,0,0,0,0,0,0,0,0,0,1037662,2023-11-02T00:00:00.000Z,56677839,22,Jett Howard,0,0,0,0,0,0
1,0,1,4,1,5,1,2,1,24,1,0,4,2,0,0,1037662,2023-11-02T00:00:00.000Z,226,22,Joe Ingles,0,6,7,5,3,7.9
1,3,2,3,0,4,1,1,1,12,1,1,3,3,1,0,1037662,2023-11-02T00:00:00.000Z,229,22,Jonathan Isaac,4,6,7,4,4,20.1
0,0,0,0,0,0,0,0,0,0,0,0,0,0,0,0,1037662,2023-11-02T00:00:00.000Z,38017607,22,Kevon Harris,0,0,0,0,0,0
0,0,0,0,0,0,0,0,0,0,0,0,0,0,0,0,1037662,2023-11-02T00:00:00.000Z,165,22,Markelle Fultz,0,0,0,0,0,0
1,2,1,2,1,6,4,1,1,19,0,2,10,1,0,0,1037662,2023-11-02T00:00:00.000Z,462,22,Moritz Wagner,2,11,12,11,2,18.7
5,2,7,2,1,13,9,15,11,36,2,4,30,9,3,6,1037662,2023-11-02T00:00:00.000Z,38017683,22,Paolo Banchero,5,39,44,35,14,57.3
0,0,0,0,0,0,0,0,0,0,0,0,0,0,0,0,1037662,2023-11-02T00:00:00.000Z,17553983,22,Trevelin Queen,0,0,0,0,0,0
2,1,8,6,3,12,5,2,1,29,2,4,14,10,0,2,1037662,2023-11-02T00:00:00.000Z,85,22,Wendell Carter Jr.,1,24,26,16,12,30
0,1,7,4,3,10,7,4,3,33,3,5,20,10,0,2,1037662,2023-11-02T00:00:00.000Z,101,29,John Collins,1,30,30,20,10,33
6,0,3,8,2,20,5,9,9,37,3,1,21,6,1,6,1037662,2023-11-02T00:00:00.000Z,100,29,Jordan Clarkson,1,27,33,27,12,34.2
3,0,1,1,0,4,2,0,0,19,1,5,4,2,3,2,1037662,2023-11-02T00:00:00.000Z,358,29,Kelly Olynyk,3,6,9,7,5,17.9
1,0,6,10,4,17,9,2,0,33,1,4,22,7,2,3,1037662,2023-11-02T00:00:00.000Z,297,29,Lauri Markkanen,2,29,30,23,8,34.9
8,1,3,4,1,14,7,0,0,31,0,4,15,3,3,2,1037662,2023-11-02T00:00:00.000Z,666650,29,Talen Horton-Tucker,4,18,26,23,11,40.6
1,5,7,0,0,6,2,0,0,25,3,2,4,10,0,1,1037662,2023-11-02T00:00:00.000Z,38017705,29,Walker Kessler,5,14,15,5,11,31.5
0,0,0,0,0,0,0,0,0,0,0,0,0,0,0,0,1037663,2023-11-02T00:00:00.000Z,37,24,Bradley Beal,0,0,0,0,0,0
0,0,0,0,0,0,0,0,0,0,0,0,0,0,0,0,1037663,2023-11-02T00:00:00.000Z,314,24,Chimezie Metu,0,0,0,0,0,0
0,0,0,0,0,0,0,0,0,0,0,0,0,0,0,0,1037663,2023-11-02T00:00:00.000Z,272,24,Damion Lee,0,0,0,0,0,0
0,0,1,1,0,2,0,0,0,12,0,0,0,1,2,0,1037663,2023-11-02T00:00:00.000Z,356,24,Josh Okogie,2,1,1,0,1,7.2
1,2,6,5,3,15,10,9,5,37,0,3,28,6,0,3,1037663,2023-11-02T00:00:00.000Z,140,24,Kevin Durant,2,34,35,29,7,39.7
0,0,0,0,0,0,0,0,0,0,0,0,0,0,0,0,1037663,2023-11-02T00:00:00.000Z,666729,24,Nassir Little,0,0,0,0,0,0
1,0,4,4,0,5,1,2,1,26,0,1,3,4,0,0,1037663,2023-11-02T00:00:00.000Z,470,24,Yuta Watanabe,0,7,8,4,5,9.3
0,0,0,0,0,0,0,0,0,0,0,0,0,0,0,0,1037663,2023-11-02T00:00:00.000Z,38017693,27,Blake Wesley,0,0,0,0,0,0
1,0,2,6,3,8,5,0,0,23,0,1,13,2,1,0,1037663,2023-11-02T00:00:00.000Z,359,27,Cedi Osman,1,15,16,14,3,19.9
1,0,1,0,0,1,1,1,1,6,0,0,3,1,1,1,1037663,2023-11-02T00:00:00.000Z,17895854,27,Charles Bassey,1,4,5,4,2,7.7
0,0,0,0,0,0,0,0,0,0,0,0,0,0,0,0,1037663,2023-11-02T00:00:00.000Z,56677865,27,Charles Bediako,0,0,0,0,0,0
1,0,2,3,3,10,7,0,0,17,0,2,17,2,0,0,1037663,2023-11-02T00:00:00.000Z,3547246,27,Devin Vassell,0,19,20,18,3,20.9
0,0,0,0,0,0,0,0,0,0,0,0,0,0,0,0,1037663,2023-11-02T00:00:00.000Z,180,27,Devonte' Graham,0,0,0,0,0,0
0,0,0,0,0,0,0,0,0,0,0,0,0,0,0,0,1037663,2023-11-02T00:00:00.000Z,38017730,27,Dominick Barlow,0,0,0,0,0,0
0,0,0,3,2,4,2,0,0,16,0,0,6,0,1,0,1037663,2023-11-02T00:00:00.000Z,305,27,Doug McDermott,1,6,6,6,0,9
9,1,4,0,0,13,7,0,0,26,1,4,14,5,0,1,1037663,2023-11-02T00:00:00.000Z,38017699,27,Jeremy Sochan,1,19,28,23,14,35.5
0,0,0,0,0,0,0,0,0,0,0,0,0,0,0,0,1037663,2023-11-02T00:00:00.000Z,38017649,27,Julian Champagnie,0,0,0,0,0,0
6,1,6,6,1,11,3,0,0,35,1,5,7,7,2,0,1037663,2023-11-02T00:00:00.000Z,666682,27,Keldon Johnson,3,14,20,13,13,33.4
3,1,1,6,1,7,1,0,0,20,0,1,3,1,0,0,1037663,2023-11-02T00:00:00.000Z,38017692,27,Malaki Branham,1,4,7,6,4,11.7
0,0,0,0,0,0,0,0,0,0,0,0,0,0,0,0,1037663,2023-11-02T00:00:00.000Z,17896059,27,Sandro Mamukelashvili,0,0,0,0,0,0
0,0,0,0,0,0,0,0,0,0,0,0,0,0,0,0,1037663,2023-11-02T00:00:00.000Z,56677817,27,Sidy Cissoko,0,0,0,0,0,0
0,0,0,0,0,0,0,0,0,0,0,0,0,0,0,0,1037663,2023-11-02T00:00:00.000Z,56677870,27,Sir'Jabari Rice,0,0,0,0,0,0
10,0,4,4,2,8,3,4,4,28,1,3,12,5,1,1,1037663,2023-11-02T00:00:00.000Z,3547274,27,Tre Jones,1,17,27,22,15,35
2,2,8,6,3,26,15,6,5,34,2,3,38,10,1,2,1037663,2023-11-02T00:00:00.000Z,56677822,27,Victor Wembanyama,3,48,50,40,12,60
4,0,4,3,3,10,7,2,2,35,4,2,19,8,0,3,1037663,2023-11-02T00:00:00.000Z,102,27,Zach Collins,0,27,31,23,12,31.6
4,1,5,4,0,12,5,4,3,30,0,2,13,5,0,1,3277349,2023-11-03T00:00:00.000Z,277,6,Caris LeVert,1,18,22,17,9,27
0,0,0,0,0,0,0,0,0,0,0,0,0,0,0,0,3277349,2023-11-03T00:00:00.000Z,56677872,6,Craig Porter,0,0,0,0,0,0
0,0,0,0,0,0,0,0,0,0,0,0,0,0,0,0,3277349,2023-11-03T00:00:00.000Z,248,6,Damian Jones,0,0,0,0,0,0
6,1,0,2,0,11,5,4,4,32,0,1,14,0,2,4,3277349,2023-11-03T00:00:00.000Z,666581,6,Darius Garland,3,14,20,20,6,28
0,0,0,0,0,0,0,0,0,3,0,1,0,0,0,0,3277349,2023-11-03T00:00:00.000Z,666940,6,Dean Wade,0,0,0,0,0,0
9,0,4,7,4,21,13,10,8,37,1,1,38,5,1,3,3277349,2023-11-03T00:00:00.000Z,322,6,Donovan Mitchell,1,43,52,47,14,57.5
0,0,0,0,0,0,0,0,0,0,0,0,0,0,0,0,3277349,2023-11-03T00:00:00.000Z,56677847,6,Emoni Bates,0,0,0,0,0,0
5,4,8,2,0,13,7,0,0,36,2,2,14,10,3,2,3277349,2023-11-03T00:00:00.000Z,17896076,6,Evan Mobley,7,24,29,19,15,52.5
1,0,5,6,2,9,4,2,2,27,0,2,12,5,0,0,3277349,2023-11-03T00:00:00.000Z,344,6,Georges Niang,0,17,18,13,6,19.5
2,0,1,1,1,3,2,0,0,23,0,4,5,1,2,1,3277349,2023-11-03T00:00:00.000Z,3547247,6,Isaac Okoro,2,6,8,7,3,14.2
0,0,0,0,0,0,0,0,0,0,0,0,0,0,0,0,3277349,2023-11-03T00:00:00.000Z,38017662,6,Isaiah Mobley,0,0,0,0,0,0
0,2,5,0,0,6,4,3,2,21,2,4,10,7,1,1,3277349,2023-11-03T00:00:00.000Z,9,6,Jarrett Allen,3,17,17,10,7,26.4
0,1,1,6,1,9,4,2,1,28,0,2,10,1,1,1,3277349,2023-11-03T00:00:00.000Z,666908,6,Max Strus,2,11,11,10,1,16.2
0,0,0,0,0,0,0,0,0,0,0,0,0,0,0,0,3277349,2023-11-03T00:00:00.000Z,404,6,Ricky Rubio,0,0,0,0,0,0
0,0,0,0,0,0,0,0,0,0,0,0,0,0,0,0,3277349,2023-11-03T00:00:00.000Z,3547299,6,Sam Merrill,0,0,0,0,0,0
0,0,1,0,0,0,0,0,0,3,0,1,0,1,0,0,3277349,2023-11-03T00:00:00.000Z,444,6,Tristan Thompson,0,1,1,0,1,1.2
0,0,0,0,0,0,0,0,0,0,0,0,0,0,0,0,3277349,2023-11-03T00:00:00.000Z,666676,6,Ty Jerome,0,0,0,0,0,0
0,0,0,0,0,0,0,0,0,0,0,0,0,0,0,0,3277349,2023-11-03T00:00:00.000Z,56677794,12,Isaiah Wong,0,0,0,0,0,0
0,0,0,0,0,0,0,0,0,0,0,0,0,0,0,0,3277349,2023-11-03T00:00:00.000Z,56677778,12,Oscar Tshiebwe,0,0,0,0,0,0
0,0,0,0,0,0,0,0,0,0,0,0,0,0,0,0,3277350,2023-11-03T00:00:00.000Z,38017733,17,A.J. Green,0,0,0,0,0,0
0,0,0,0,0,0,0,0,0,0,0,0,0,0,0,0,3277350,2023-11-03T00:00:00.000Z,56677852,17,Andre Jackson Jr.,0,0,0,0,0,0
0,0,2,2,0,10,2,0,0,17,0,1,4,2,2,0,3277350,2023-11-03T00:00:00.000Z,377,17,Bobby Portis,2,6,6,4,2,12.4
1,0,0,0,0,1,0,0,0,12,0,2,0,0,0,1,3277350,2023-11-03T00:00:00.000Z,368,17,Cameron Payne,0,0,1,1,1,0.5
0,0,0,0,0,0,0,0,0,0,0,0,0,0,0,0,3277350,2023-11-03T00:00:00.000Z,56677854,17,Chris Livingston,0,0,0,0,0,0
4,1,4,7,4,15,7,12,12,36,0,0,30,4,1,4,3277350,2023-11-03T00:00:00.000Z,278,17,Damian Lillard,2,34,38,34,8,42.8
2,0,6,6,4,8,5,0,0,24,0,1,14,6,1,0,3277350,2023-11-03T00:00:00.000Z,112,17,Jae Crowder,1,20,22,16,8,27.2
0,0,0,0,0,0,0,0,0,0,0,0,0,0,0,0,3277350,2023-11-03T00:00:00.000Z,666960,17,Lindell Wigginton,0,0,0,0,0,0
2,0,1,5,3,7,5,1,0,13,1,2,13,2,0,0,3277350,2023-11-03T00:00:00.000Z,38017676,17,MarJon Beauchamp,0,15,17,15,4,18.4
0,0,0,0,0,0,0,0,0,0,0,0,0,0,0,0,3277350,2023-11-03T00:00:00.000Z,666453,17,Marques Bolden,0,0,0,0,0,0
2,0,0,2,0,4,1,0,0,24,2,2,2,2,1,1,3277350,2023-11-03T00:00:00.000Z,105,17,Pat Connaughton,1,4,6,4,4,9.4
0,0,0,0,0,0,0,0,0,0,0,0,0,0,0,0,3277350,2023-11-03T00:00:00.000Z,284,17,Robin Lopez,0,0,0,0,0,0
0,0,0,0,0,0,0,0,0,0,0,0,0,0,0,0,3277350,2023-11-03T00:00:00.000Z,2148,17,Thanasis Antetokounmpo,0,0,0,0,0,0
0,0,0,0,0,0,0,0,0,0,0,0,0,0,0,0,3277350,2023-11-03T00:00:00.000Z,38017691,17,TyTy Washington Jr.,0,0,0,0,0,0
0,0,0,0,0,0,0,0,0,0,0,0,0,0,0,0,3277350,2023-11-03T00:00:00.000Z,666474,20,Charles Brown,0,0,0,0,0,0
0,0,0,0,0,0,0,0,0,0,0,0,0,0,0,0,3277350,2023-11-03T00:00:00.000Z,666675,20,DaQuan Jeffries,0,0,0,0,0,0
0,0,3,4,1,8,1,0,0,18,1,0,3,4,0,1,3277350,2023-11-03T00:00:00.000Z,131,20,Donte DiVincenzo,0,7,7,3,4,6.8
0,0,0,0,0,0,0,0,0,0,0,0,0,0,0,0,3277350,2023-11-03T00:00:00.000Z,666971,20,Dylan Windler,0,0,0,0,0,0
0,0,0,0,0,0,0,0,0,0,0,0,0,0,0,0,3277350,2023-11-03T00:00:00.000Z,160,20,Evan Fournier,0,0,0,0,0,0
1,0,3,3,1,10,5,3,3,22,0,1,14,3,0,1,3277350,2023-11-03T00:00:00.000Z,3547269,20,Immanuel Quickley,0,17,18,15,4,18.1
0,0,2,0,0,3,2,0,0,18,1,3,4,3,0,2,3277350,2023-11-03T00:00:00.000Z,201,20,Isaiah Hartenstein,0,7,7,4,3,5.6
4,0,3,8,2,30,17,11,9,42,2,3,45,5,1,4,3277350,2023-11-03T00:00:00.000Z,73,20,Jalen Brunson,1,50,54,49,9,56
0,0,0,0,0,0,0,0,0,0,0,0,0,0,0,0,3277350,2023-11-03T00:00:00.000Z,17896063,20,Jericho Sims,0,0,0,0,0,0
5,1,8,4,0,9,2,2,2,36,2,4,6,10,3,0,3277350,2023-11-03T00:00:00.000Z,202,20,Josh Hart,4,16,21,11,15,37.5
5,0,8,9,1,20,5,9,5,39,4,4,16,12,2,1,3277350,2023-11-03T00:00:00.000Z,387,20,Julius Randle,2,28,33,21,17,42.9
0,0,0,1,0,1,0,0,0,2,0,0,0,0,0,0,3277350,2023-11-03T00:00:00.000Z,17896033,20,Miles McBride,0,0,0,0,0,0
1,0,9,0,0,4,0,0,0,29,6,4,0,15,0,0,3277350,2023-11-03T00:00:00.000Z,399,20,Mitchell Robinson,0,15,16,1,16,19.5
2,0,4,10,5,11,6,0,0,34,0,3,17,4,0,1,3277350,2023-11-03T00:00:00.000Z,17895858,20,Quentin Grimes,0,21,23,19,6,23.8
0,0,0,0,0,0,0,0,0,0,0,0,0,0,0,0,3277350,2023-11-03T00:00:00.000Z,666423,20,RJ Barrett,0,0,0,0,0,0
0,0,0,0,0,0,0,0,0,0,0,0,0,0,0,0,3277350,2023-11-03T00:00:00.000Z,19,20,Ryan Arcidiacono,0,0,0,0,0,0
3,0,4,0,0,15,8,2,2,30,0,3,18,4,0,4,3277351,2023-11-03T00:00:00.000Z,4,16,Bam Adebayo,0,22,25,21,7,23.3
0,0,0,0,0,0,0,0,0,0,0,0,0,0,0,0,3277351,2023-11-03T00:00:00.000Z,19465585,16,Dru Smith,0,0,0,0,0,0
6,0,1,8,4,11,7,0,0,29,0,0,18,1,1,2,3277351,2023-11-03T00:00:00.000Z,397,16,Duncan Robinson,1,19,25,24,7,29.2
3,0,2,1,0,5,4,1,1,22,3,1,9,5,1,0,3277351,2023-11-03T00:00:00.000Z,56677785,16,Jaime Jaquez Jr.,1,14,17,12,8,22.5
0,0,0,0,0,0,0,0,0,0,0,0,0,0,0,0,3277351,2023-11-03T00:00:00.000Z,38017734,16,Jamal Cain,0,0,0,0,0,0
5,0,3,2,1,6,4,1,1,25,0,2,10,3,0,2,3277351,2023-11-03T00:00:00.000Z,391,16,Josh Richardson,0,13,18,15,8,19.1
0,0,0,0,0,0,0,0,0,0,0,0,0,0,0,0,3277351,2023-11-03T00:00:00.000Z,285,16,Kevin Love,0,0,0,0,0,0
7,0,1,4,1,4,1,0,0,26,2,1,3,3,2,2,3277351,2023-11-03T00:00:00.000Z,286,16,Kyle Lowry,2,6,13,10,10,21.1
0,0,0,0,0,0,0,0,0,0,0,0,0,0,0,0,3277351,2023-11-03T00:00:00.000Z,38017696,16,Nikola Jovic,0,0,0,0,0,0
0,0,0,0,0,0,0,0,0,0,0,0,0,0,0,0,3277351,2023-11-03T00:00:00.000Z,39398582,16,Orlando Robinson,0,0,0,0,0,0
0,1,2,0,0,7,5,2,1,18,2,4,11,4,0,2,3277351,2023-11-03T00:00:00.000Z,74,16,Thomas Bryant,1,15,15,11,4,16.8
9,0,10,7,4,17,9,2,2,37,0,3,24,10,2,3,3277351,2023-11-03T00:00:00.000Z,666633,16,Tyler Herro,2,34,43,33,19,52.5
3,0,3,9,4,19,8,2,2,31,1,3,22,4,0,5,3277351,2023-11-03T00:00:00.000Z,265,30,Kyle Kuzma,0,26,29,25,7,26.3
0,0,0,0,0,0,0,0,0,0,0,0,0,0,0,0,3277352,2023-11-03T00:00:00.000Z,9051997,3,Armoni Brooks,0,0,0,0,0,0
6,0,6,0,0,8,4,0,0,33,3,3,8,9,1,4,3277352,2023-11-03T00:00:00.000Z,417,3,Ben Simmons,1,17,23,14,15,26.8
4,1,4,9,3,18,6,2,2,31,1,1,17,5,0,0,3277352,2023-11-03T00:00:00.000Z,17896048,3,Cam Thomas,1,22,26,21,9,32
0,0,9,0,0,3,3,1,0,15,1,1,6,10,0,0,3277352,2023-11-03T00:00:00.000Z,17896038,3,Day'Ron Sharpe,0,16,16,6,10,18
1,0,0,2,1,9,3,0,0,16,1,0,7,1,1,1,3277352,2023-11-03T00:00:00.000Z,421,3,Dennis Smith Jr.,1,8,9,8,2,11.7
0,1,1,9,5,14,8,0,0,33,2,1,21,3,0,0,3277352,2023-11-03T00:00:00.000Z,158,3,Dorian Finney-Smith,1,24,24,21,3,27.6
1,1,1,4,1,10,5,0,0,16,0,2,11,1,0,0,3277352,2023-11-03T00:00:00.000Z,464,3,Lonnie Walker IV,1,12,13,12,2,16.7
3,0,2,8,3,17,8,2,1,33,0,0,20,2,0,0,3277352,2023-11-03T00:00:00.000Z,61,3,Mikal Bridges,0,22,25,23,5,26.9
8,1,5,9,3,10,3,0,0,32,0,4,9,5,0,0,3277352,2023-11-03T00:00:00.000Z,351,3,Royce O'Neale,1,14,22,17,13,30
9,0,3,4,2,7,4,0,0,31,0,0,10,3,2,3,3277352,2023-11-03T00:00:00.000Z,130,3,Spencer Dinwiddie,2,13,22,19,12,30.1
0,0,0,0,0,0,0,0,0,0,0,0,0,0,0,0,3277352,2023-11-03T00:00:00.000Z,56677860,5,Adama Sanogo,0,0,0,0,0,0
2,1,2,8,2,17,7,2,2,35,1,0,18,3,0,2,3277352,2023-11-03T00:00:00.000Z,666956,5,Coby White,1,21,23,20,5,25.6
4,0,0,4,2,20,9,4,4,34,1,0,24,1,0,0,3277352,2023-11-03T00:00:00.000Z,125,5,DeMar DeRozan,0,25,29,28,5,31.2
0,0,1,2,1,3,2,0,0,14,0,2,5,1,1,2,3277352,2023-11-03T00:00:00.000Z,87,5,Jevon Carter,1,6,6,5,1,7.2
3,0,7,1,1,13,6,0,0,36,6,1,13,13,0,0,3277352,2023-11-03T00:00:00.000Z,460,5,Nikola Vucevic,0,26,29,16,16,33.1
4,0,6,2,1,4,1,0,0,23,0,4,3,6,1,1,3277352,2023-11-03T00:00:00.000Z,110,5,Torrey Craig,1,9,13,7,10,18.2
5,1,6,6,1,21,10,4,3,39,1,2,24,7,1,2,3277352,2023-11-03T00:00:00.000Z,268,5,Zach LaVine,2,31,36,29,12,43.9
0,0,0,0,0,0,0,0,0,0,0,0,0,0,0,0,3277353,2023-11-03T00:00:00.000Z,56677858,10,Brandin Podziemski,0,0,0,0,0,0
13,0,2,2,0,6,0,2,1,28,0,1,1,2,2,0,3277353,2023-11-03T00:00:00.000Z,367,10,Chris Paul,2,3,16,14,15,28.9
3,0,5,7,4,9,6,4,4,20,1,2,20,6,1,1,3277353,2023-11-03T00:00:00.000Z,407,10,Dario Saric,1,26,29,23,9,33.7
3,1,3,4,2,11,5,3,3,29,2,5,15,5,0,3,3277353,2023-11-03T00:00:00.000Z,185,10,Draymond Green,1,20,23,18,8,25.5
1,0,3,3,1,6,4,0,0,22,0,2,9,3,2,1,3277353,2023-11-03T00:00:00.000Z,2189,10,Gary Payton II,2,12,13,10,4,19.1
0,0,0,0,0,0,0,0,0,0,0,0,0,0,0,0,3277353,2023-11-03T00:00:00.000Z,398,10,Jerome Robinson,0,0,0,0,0,0
0,0,0,0,0,0,0,0,0,0,0,0,0,0,0,0,3277353,2023-11-03T00:00:00.000Z,45658838,10,Lester Quinones,0,0,0,0,0,0
0,0,0,0,0,0,0,0,0,0,0,0,0,0,0,0,3277353,2023-11-03T00:00:00.000Z,56677799,10,Trayce Jackson-Davis,0,0,0,0,0,0
0,0,2,3,1,6,3,0,0,17,0,1,7,2,1,0,3277353,2023-11-03T00:00:00.000Z,17896078,21,Aaron Wiggins,1,9,9,7,2,12.4
0,0,0,0,0,0,0,0,0,0,0,0,0,0,0,0,3277353,2023-11-03T00:00:00.000Z,3547271,21,Aleksej Pokusevski,0,0,0,0,0,0
1,0,1,2,1,10,6,0,0,36,1,1,13,2,0,1,3277353,2023-11-03T00:00:00.000Z,56677833,21,Cason Wallace,0,15,16,14,3,15.9
5,1,5,2,2,9,7,8,8,32,3,4,24,8,1,2,3277353,2023-11-03T00:00:00.000Z,38017685,21,Chet Holmgren,2,32,37,29,13,45.1
0,0,0,0,0,0,0,0,0,0,0,0,0,0,0,0,3277353,2023-11-03T00:00:00.000Z,44,21,Davis Bertans,0,0,0,0,0,0
1,0,0,5,3,6,4,6,5,26,0,0,16,0,0,1,3277353,2023-11-03T00:00:00.000Z,3547272,21,Isaiah Joe,0,16,17,17,1,16.5
8,0,2,0,0,12,8,5,2,35,1,6,18,3,1,6,3277353,2023-11-03T00:00:00.000Z,38017703,21,Jalen Williams,1,21,29,26,11,30.6
3,0,5,3,0,5,2,2,2,15,0,1,6,5,0,1,3277353,2023-11-03T00:00:00.000Z,38017706,21,Jaylin Williams,0,11,14,9,8,15.5
4,0,5,3,0,15,8,2,2,31,0,2,18,5,0,6,3277353,2023-11-03T00:00:00.000Z,17896065,21,Josh Giddey,0,23,27,22,9,24
0,0,0,0,0,0,0,0,0,0,0,0,0,0,0,0,3277353,2023-11-03T00:00:00.000Z,480,21,Kenrich Williams,0,0,0,0,0,0
0,0,0,0,0,0,0,0,0,0,0,0,0,0,0,0,3277353,2023-11-03T00:00:00.000Z,56677853,21,Keyontae Johnson,0,0,0,0,0,0
0,0,0,0,0,0,0,0,0,0,0,0,0,0,0,0,3277353,2023-11-03T00:00:00.000Z,27924547,21,Lindy Waters III,0,0,0,0,0,0
0,0,3,6,6,12,9,7,5,30,2,4,29,5,0,1,3277353,2023-11-03T00:00:00.000Z,666541,21,Luguentz Dort,0,34,34,29,5,34
0,0,0,0,0,0,0,0,0,0,0,0,0,0,0,0,3277353,2023-11-03T00:00:00.000Z,24572055,21,Olivier Sarr,0,0,0,0,0,0
1,0,1,3,1,3,1,0,0,6,0,0,3,1,0,1,3277353,2023-11-03T00:00:00.000Z,38017716,21,Ousmane Dieng,0,4,5,4,2,4.7
0,0,0,0,0,0,0,0,0,0,0,0,0,0,0,0,3277353,2023-11-03T00:00:00.000Z,175,21,Shai Gilgeous-Alexander,0,0,0,0,0,0
0,0,0,0,0,0,0,0,0,0,0,0,0,0,0,0,3277353,2023-11-03T00:00:00.000Z,17896036,21,Tre Mann,0,0,0,0,0,0
3,0,1,2,1,5,2,0,0,12,0,1,5,1,0,0,3277353,2023-11-03T00:00:00.000Z,4197029,21,Vasilije Micic,0,6,9,8,4,10.7
0,0,0,0,0,0,0,0,0,0,0,0,0,0,0,0,3277354,2023-11-03T00:00:00.000Z,17554004,7,AJ Lawson,0,0,0,0,0,0
0,0,0,0,0,0,0,0,0,1,0,0,0,0,0,0,3277354,2023-11-03T00:00:00.000Z,151,7,Dante Exum,0,0,0,0,0,0
0,1,3,1,0,3,2,0,0,25,1,2,4,4,1,0,3277354,2023-11-03T00:00:00.000Z,56677840,7,Dereck Lively II,2,8,8,4,4,14.8
0,0,0,0,0,0,0,0,0,0,0,0,0,0,0,0,3277354,2023-11-03T00:00:00.000Z,56677873,7,Dexter Dennis,0,0,0,0,0,0
1,0,0,0,0,5,2,2,2,17,1,2,6,1,0,0,3277354,2023-11-03T00:00:00.000Z,379,7,Dwight Powell,0,7,8,7,2,8.7
0,0,0,0,0,0,0,0,0,0,0,0,0,0,0,0,3277354,2023-11-03T00:00:00.000Z,17896028,7,Greg Brown III,0,0,0,0,0,0
3,0,2,4,2,6,2,0,0,14,1,2,6,3,0,0,3277354,2023-11-03T00:00:00.000Z,38017679,7,Jaden Hardy,0,9,12,9,6,14.1
2,0,4,5,3,8,5,0,0,27,1,2,13,5,2,0,3277354,2023-11-03T00:00:00.000Z,3547258,7,Josh Green,2,18,20,15,7,28
7,2,1,5,1,15,9,4,3,35,0,1,22,1,4,3,3277354,2023-11-03T00:00:00.000Z,228,7,Kyrie Irving,6,23,30,29,8,48.7
8,1,7,11,6,24,11,7,6,38,3,2,34,10,0,9,3277354,2023-11-03T00:00:00.000Z,132,7,Luka Doncic,1,44,52,42,18,52
0,0,0,0,0,0,0,0,0,0,0,0,0,0,0,0,3277354,2023-11-03T00:00:00.000Z,257,7,Maxi Kleber,0,0,0,0,0,0
0,0,0,0,0,1,0,0,0,1,0,0,0,0,0,0,3277354,2023-11-03T00:00:00.000Z,56677859,7,Olivier-Maxence Prosper,0,0,0,0,0,0
0,0,0,0,0,0,0,0,0,0,0,0,0,0,0,0,3277354,2023-11-03T00:00:00.000Z,217,7,Richaun Holmes,0,0,0,0,0,0
1,0,1,1,0,1,0,0,0,5,0,1,0,1,1,0,3277354,2023-11-03T00:00:00.000Z,114,7,Seth Curry,1,1,2,1,2,5.7
2,0,3,5,1,8,3,2,2,27,0,3,9,3,1,2,3277354,2023-11-03T00:00:00.000Z,191,7,Tim Hardaway Jr.,1,12,14,11,5,16.6
0,0,0,0,0,0,0,0,0,1,0,0,0,0,0,0,3277355,2023-11-03T00:00:00.000Z,48,15,Bismack Biyombo,0,0,0,0,0,0
0,0,2,4,0,14,8,0,0,32,1,4,16,3,0,0,3277355,2023-11-03T00:00:00.000Z,38017729,15,David Roddy,0,19,19,16,3,19.6
7,3,7,9,3,26,13,5,4,45,1,5,33,8,4,3,3277355,2023-11-03T00:00:00.000Z,3547287,15,Desmond Bane,7,41,48,40,15,71.1
3,0,0,0,0,0,0,0,0,12,0,0,0,0,0,1,3277355,2023-11-03T00:00:00.000Z,48248287,15,Jacob Gilyard,0,0,3,3,3,3.5
3,3,8,8,5,17,11,6,3,38,2,1,30,10,1,4,3277355,2023-11-03T00:00:00.000Z,231,15,Jaren Jackson Jr.,4,40,43,33,13,54.5
0,1,1,0,0,2,1,0,0,10,0,0,2,1,0,0,3277355,2023-11-03T00:00:00.000Z,666703,15,John Konchar,1,3,3,2,1,6.2
3,0,7,4,1,7,2,0,0,27,1,1,5,8,0,0,3277355,2023-11-03T00:00:00.000Z,254,15,Luke Kennard,0,13,16,8,11,19.1
4,0,2,5,0,12,4,0,0,39,1,2,8,3,1,5,3277355,2023-11-03T00:00:00.000Z,420,15,Marcus Smart,1,11,15,12,7,15.6
3,1,6,1,1,8,5,2,2,27,0,6,13,6,1,2,3277355,2023-11-03T00:00:00.000Z,17896027,15,Ziaire Williams,2,19,22,16,9,28.7
0,0,0,0,0,0,0,0,0,0,0,0,0,0,0,0,3277355,2023-11-03T00:00:00.000Z,419,25,Anfernee Simons,0,0,0,0,0,0
0,0,0,0,0,0,0,0,0,0,0,0,0,0,0,0,3277355,2023-11-03T00:00:00.000Z,56783340,25,Duop Reath,0,0,0,0,0,0
0,0,0,0,0,0,0,0,0,0,0,0,0,0,0,0,3277355,2023-11-03T00:00:00.000Z,17896120,25,Ish Wainright,0,0,0,0,0,0
0,1,3,0,0,2,0,0,0,9,1,2,0,4,0,0,3277355,2023-11-03T00:00:00.000Z,38017711,25,Jabari Walker,1,4,4,0,4,7.8
0,0,0,0,0,0,0,0,0,0,0,0,0,0,0,0,3277355,2023-11-03T00:00:00.000Z,47957121,25,Justin Minaya,0,0,0,0,0,0
0,0,0,0,0,0,0,0,0,0,0,0,0,0,0,0,3277355,2023-11-03T00:00:00.000Z,56677791,25,Kris Murray,0,0,0,0,0,0
0,0,0,0,0,0,0,0,0,0,0,0,0,0,0,0,3277355,2023-11-03T00:00:00.000Z,56677829,25,Rayan Rupert,0,0,0,0,0,0
0,1,6,0,0,4,3,3,2,20,4,1,8,10,2,1,3277355,2023-11-03T00:00:00.000Z,476,25,Robert Williams III,3,18,18,8,10,28
0,0,0,0,0,0,0,0,0,0,0,0,0,0,0,0,3277355,2023-11-03T00:00:00.000Z,56677747,25,Scoot Henderson,0,0,0,0,0,0
1,0,1,5,1,8,3,2,2,15,0,0,9,1,1,1,3277355,2023-11-03T00:00:00.000Z,3547289,25,Skylar Mays,1,10,11,10,2,13.7
0,0,0,0,0,0,0,0,0,0,0,0,0,0,0,0,1037672,2023-11-04T00:00:00.000Z,56677848,4,Amari Bailey,0,0,0,0,0,0
1,1,2,2,0,7,4,2,2,34,1,4,10,3,0,0,1037672,2023-11-04T00:00:00.000Z,56677823,4,Brandon Miller,1,13,14,11,4,18.1
0,0,0,0,0,0,0,0,0,0,0,0,0,0,0,0,1037672,2023-11-04T00:00:00.000Z,38017708,4,Bryce McGowens,0,0,0,0,0,0
0,0,0,0,0,0,0,0,0,0,0,0,0,0,0,0,1037672,2023-11-04T00:00:00.000Z,666748,4,Cody Martin,0,0,0,0,0,0
0,0,0,0,0,0,0,0,0,0,0,0,0,0,0,0,1037672,2023-11-04T00:00:00.000Z,347,4,Frank Ntilikina,0,0,0,0,0,0
3,2,5,2,1,17,10,2,2,34,1,3,23,6,0,1,1037672,2023-11-04T00:00:00.000Z,204,4,Gordon Hayward,2,29,32,26,9,39.7
0,0,0,0,0,0,0,0,0,0,0,0,0,0,0,0,1037672,2023-11-04T00:00:00.000Z,422,4,Ish Smith,0,0,0,0,0,0
0,0,0,0,0,0,0,0,0,0,0,0,0,0,0,0,1037672,2023-11-04T00:00:00.000Z,17896037,4,James Bouknight,0,0,0,0,0,0
0,0,3,1,1,3,3,0,0,15,1,1,7,4,0,0,1037672,2023-11-04T00:00:00.000Z,18678001,4,JT Thor,0,11,11,7,4,11.8
11,0,1,7,2,15,4,1,1,31,1,5,11,2,2,6,1037672,2023-11-04T00:00:00.000Z,3547239,4,LaMelo Ball,2,13,24,22,13,29.9
0,0,0,0,0,0,0,0,0,0,0,0,0,0,0,0,1037672,2023-11-04T00:00:00.000Z,56677866,4,Leaky Black,0,0,0,0,0,0
1,2,3,0,0,12,9,9,9,30,4,2,27,7,2,3,1037672,2023-11-04T00:00:00.000Z,38017698,4,Mark Williams,4,34,35,28,8,45.9
0,0,0,0,0,0,0,0,0,0,0,0,0,0,0,0,1037672,2023-11-04T00:00:00.000Z,62,4,Miles Bridges,0,0,0,0,0,0
0,2,7,0,0,4,4,2,2,18,3,1,10,10,0,1,1037672,2023-11-04T00:00:00.000Z,3547282,4,Nick Richards,2,20,20,10,10,27
0,0,0,0,0,0,0,0,0,0,0,0,0,0,0,0,1037672,2023-11-04T00:00:00.000Z,56677846,4,Nick Smith Jr.,0,0,0,0,0,0
4,2,2,1,1,13,6,2,2,33,1,0,15,3,1,1,1037672,2023-11-04T00:00:00.000Z,666950,4,P.J. Washington,3,18,22,19,7,32.6
3,1,6,5,3,14,7,5,5,31,0,0,22,6,0,0,1037672,2023-11-04T00:00:00.000Z,403,4,Terry Rozier,1,28,31,25,9,36.7
0,0,0,2,0,3,0,0,0,14,0,4,0,0,0,1,1037672,2023-11-04T00:00:00.000Z,3547253,4,Theo Maledon,0,0,0,0,0,-1
0,0,0,0,0,0,0,0,0,0,0,0,0,0,0,0,1037672,2023-11-04T00:00:00.000Z,56677794,12,Isaiah Wong,0,0,0,0,0,0
0,0,0,0,0,0,0,0,0,0,0,0,0,0,0,0,1037672,2023-11-04T00:00:00.000Z,56677832,12,Jarace Walker,0,0,0,0,0,0
0,0,0,0,0,1,0,0,0,4,0,0,0,0,0,0,1037673,2023-11-04T00:00:00.000Z,56677867,14,Alex Fudge,0,0,0,0,0,0
0,0,0,2,0,2,0,0,0,4,0,1,0,0,0,0,1037673,2023-11-04T00:00:00.000Z,56677868,14,D'Moi Hodge,0,0,0,0,0,0
0,0,0,0,0,0,0,0,0,0,0,0,0,0,0,0,1037673,2023-11-04T00:00:00.000Z,1603383,14,Gabe Vincent,0,0,0,0,0,0
0,0,0,0,0,0,0,0,0,0,0,0,0,0,0,0,1037673,2023-11-04T00:00:00.000Z,56677835,14,Jalen Hood-Schifino,0,0,0,0,0,0
0,0,0,0,0,0,0,0,0,0,0,0,0,0,0,0,1037673,2023-11-04T00:00:00.000Z,457,14,Jarred Vanderbilt,0,0,0,0,0,0
5,0,8,5,2,15,8,7,6,35,1,1,24,9,3,3,1037673,2023-11-04T00:00:00.000Z,237,14,LeBron James,3,33,38,29,14,48.3
0,0,0,0,0,0,0,0,0,4,0,0,0,0,0,1,1037673,2023-11-04T00:00:00.000Z,56677836,14,Maxwell Lewis,0,0,0,0,0,-1
0,0,0,0,0,0,0,0,0,0,0,0,0,0,0,0,1037673,2023-11-04T00:00:00.000Z,666609,14,Rui Hachimura,0,0,0,0,0,0
0,0,0,0,0,0,0,0,0,0,0,0,0,0,0,0,1037673,2023-11-04T00:00:00.000Z,383,14,Taurean Prince,0,0,0,0,0,0
0,0,0,3,1,4,2,0,0,3,0,0,5,0,0,0,1037673,2023-11-04T00:00:00.000Z,666885,22,Admiral Schofield,0,5,5,5,0,5
2,0,3,3,2,6,4,1,1,30,1,2,11,4,1,0,1037673,2023-11-04T00:00:00.000Z,56677827,22,Anthony Black,1,15,17,13,6,21.8
1,0,1,0,0,0,0,0,0,3,0,0,0,1,0,0,1037673,2023-11-04T00:00:00.000Z,38017724,22,Caleb Houstan,0,1,2,1,2,2.7
1,0,0,1,0,1,0,0,0,3,1,0,0,1,0,0,1037673,2023-11-04T00:00:00.000Z,666818,22,Chuma Okeke,0,1,2,1,2,2.7
1,0,2,5,3,9,4,3,3,23,3,1,14,5,0,3,1037673,2023-11-04T00:00:00.000Z,3547251,22,Cole Anthony,0,19,20,15,6,18.5
0,0,0,1,0,2,0,0,0,3,1,0,0,1,0,0,1037673,2023-11-04T00:00:00.000Z,56677839,22,Jett Howard,0,1,1,0,1,1.2
3,0,3,5,2,6,2,1,1,25,0,2,7,3,1,2,1037673,2023-11-04T00:00:00.000Z,226,22,Joe Ingles,1,10,13,10,6,16.1
0,1,0,2,0,3,0,0,0,11,0,2,0,0,0,1,1037673,2023-11-04T00:00:00.000Z,229,22,Jonathan Isaac,1,0,0,0,0,2
0,0,0,0,0,0,0,0,0,0,0,0,0,0,0,0,1037673,2023-11-04T00:00:00.000Z,165,22,Markelle Fultz,0,0,0,0,0,0
2,0,3,3,1,10,6,0,0,19,5,5,13,8,1,2,1037673,2023-11-04T00:00:00.000Z,462,22,Moritz Wagner,1,21,23,15,10,26.6
0,0,0,0,0,0,0,0,0,0,0,0,0,0,0,0,1037673,2023-11-04T00:00:00.000Z,85,22,Wendell Carter Jr.,0,0,0,0,0,0
0,0,0,0,0,0,0,0,0,0,0,0,0,0,0,0,1037674,2023-11-04T00:00:00.000Z,56677838,1,Kobe Bufkin,0,0,0,0,0,0
2,0,1,7,2,13,5,0,0,26,4,2,12,5,1,0,1037674,2023-11-04T00:00:00.000Z,3547256,1,Saddiq Bey,1,17,19,14,7,24
0,0,0,0,0,0,0,0,0,0,0,0,0,0,0,0,1037674,2023-11-04T00:00:00.000Z,56677855,1,Seth Lundy,0,0,0,0,0,0
0,0,0,0,0,0,0,0,0,0,0,0,0,0,0,0,1037674,2023-11-04T00:00:00.000Z,301,1,Wesley Matthews,0,0,0,0,0,0
6,2,1,6,1,12,5,3,2,33,0,3,13,1,2,0,1037674,2023-11-04T00:00:00.000Z,303,19,CJ McCollum,4,14,20,19,7,35.2
0,0,0,0,0,0,0,0,0,0,0,0,0,0,0,0,1037674,2023-11-04T00:00:00.000Z,491,19,Cody Zeller,0,0,0,0,0,0
5,1,2,2,1,4,3,0,0,22,1,0,7,3,1,0,1037674,2023-11-04T00:00:00.000Z,38017677,19,Dyson Daniels,2,10,15,12,8,24.1
0,0,0,0,0,0,0,0,0,1,0,0,0,0,0,0,1037674,2023-11-04T00:00:00.000Z,38017663,19,E.J. Liddell,0,0,0,0,0,0
1,1,1,5,1,13,6,0,0,33,1,1,13,2,3,3,1037674,2023-11-04T00:00:00.000Z,17896024,19,Herbert Jones,4,15,16,14,3,25.9
0,0,5,8,4,11,5,1,1,24,0,3,15,5,1,1,1037674,2023-11-04T00:00:00.000Z,56677837,19,Jordan Hawkins,1,20,20,15,5,23
0,0,0,0,0,0,0,0,0,0,0,0,0,0,0,0,1037674,2023-11-04T00:00:00.000Z,17896097,19,Jose Alvarado,0,0,0,0,0,0
4,0,0,2,0,3,0,0,0,10,0,1,0,0,1,0,1037674,2023-11-04T00:00:00.000Z,3547260,19,Kira Lewis Jr.,1,0,4,4,4,9
1,0,2,2,0,5,2,2,2,15,1,1,6,3,0,0,1037674,2023-11-04T00:00:00.000Z,340,19,Larry Nance Jr.,0,9,10,7,4,11.1
1,0,1,3,0,4,1,2,2,17,1,2,4,2,0,1,1037674,2023-11-04T00:00:00.000Z,17896017,19,Matt Ryan,0,6,7,5,3,6.9
0,0,0,0,0,0,0,0,0,0,0,0,0,0,0,0,1037674,2023-11-04T00:00:00.000Z,3547293,19,Naji Marshall,0,0,0,0,0,0
3,0,3,0,0,16,9,10,7,32,2,2,25,5,0,0,1037674,2023-11-04T00:00:00.000Z,666969,19,Zion Williamson,0,30,33,28,8,35.5
10,1,5,9,4,15,6,2,2,40,4,1,18,9,0,3,1037675,2023-11-04T00:00:00.000Z,214,2,Jrue Holiday,1,27,37,28,19,43.8
0,0,0,0,0,0,0,0,0,0,0,0,0,0,0,0,1037675,2023-11-04T00:00:00.000Z,3547295,2,Nathan Knight,0,0,0,0,0,0
0,0,0,0,0,0,0,0,0,0,0,0,0,0,0,0,1037675,2023-11-04T00:00:00.000Z,17553967,2,Neemias Queta,0,0,0,0,0,0
0,0,2,2,0,4,0,0,0,19,1,1,0,3,0,1,1037676,2023-11-04T00:00:00.000Z,213,11,Aaron Holiday,0,3,3,0,3,2.6
6,0,9,3,1,13,7,0,0,34,0,2,15,9,2,2,1037676,2023-11-04T00:00:00.000Z,17896062,11,Alperen Sengun,2,24,30,21,15,38.8
0,0,0,0,0,0,0,0,0,0,0,0,0,0,0,0,1037676,2023-11-04T00:00:00.000Z,56677825,11,Amen Thompson,0,0,0,0,0,0
0,0,0,0,0,0,0,0,0,0,0,0,0,0,0,0,1037676,2023-11-04T00:00:00.000Z,296,11,Boban Marjanovic,0,0,0,0,0,0
0,0,1,0,0,0,0,0,0,1,0,0,0,1,0,1,1037676,2023-11-04T00:00:00.000Z,56677831,11,Cam Whitmore,0,1,1,0,1,0.2
1,0,6,4,2,14,9,6,6,38,3,0,26,9,1,1,1037676,2023-11-04T00:00:00.000Z,66,11,Dillon Brooks,1,35,36,27,10,40.3
12,2,6,14,4,22,7,3,3,36,0,4,21,6,0,2,1037676,2023-11-04T00:00:00.000Z,458,11,Fred VanVleet,2,27,39,33,18,50.2
0,1,8,6,3,15,9,0,0,35,3,4,21,11,0,0,1037676,2023-11-04T00:00:00.000Z,38017684,11,Jabari Smith Jr.,1,32,32,21,11,37.2
1,0,4,3,3,6,4,0,0,21,0,4,11,4,0,0,1037676,2023-11-04T00:00:00.000Z,3547301,11,Jae'Sean Tate,0,15,16,12,5,17.3
5,0,2,2,0,10,4,7,2,36,0,1,10,2,0,3,1037676,2023-11-04T00:00:00.000Z,17895966,11,Jalen Green,0,12,17,15,7,16.9
0,0,0,0,0,0,0,0,0,0,0,0,0,0,0,0,1037676,2023-11-04T00:00:00.000Z,47738533,11,Jeenathan Williams,0,0,0,0,0,0
0,0,3,0,0,1,0,2,1,6,2,0,1,5,0,1,1037676,2023-11-04T00:00:00.000Z,188,11,Jeff Green,0,6,6,1,5,6
0,0,0,1,0,1,0,2,2,1,0,1,2,0,0,0,1037676,2023-11-04T00:00:00.000Z,56677809,11,Jermaine Samuels Jr.,0,2,2,2,0,2
3,0,2,1,0,1,0,0,0,12,1,1,0,3,1,0,1037676,2023-11-04T00:00:00.000Z,19465326,11,Jock Landale,1,3,6,3,6,11.1
0,0,0,0,0,0,0,0,0,1,0,0,0,0,0,0,1037676,2023-11-04T00:00:00.000Z,3547281,11,Nate Hinton,0,0,0,0,0,0
0,0,0,0,0,0,0,0,0,0,0,0,0,0,0,0,1037676,2023-11-04T00:00:00.000Z,75,11,Reggie Bullock,0,0,0,0,0,0
0,0,0,0,0,0,0,0,0,0,0,0,0,0,0,0,1037676,2023-11-04T00:00:00.000Z,38017695,11,Tari Eason,0,0,0,0,0,0
0,0,0,0,0,0,0,0,0,0,0,0,0,0,0,0,1037676,2023-11-04T00:00:00.000Z,357,11,Victor Oladipo,0,0,0,0,0,0
0,0,0,0,0,0,0,0,0,0,0,0,0,0,0,0,1037676,2023-11-04T00:00:00.000Z,161,26,De'Aaron Fox,0,0,0,0,0,0
0,0,4,1,0,9,5,2,2,15,2,0,12,6,0,0,1037676,2023-11-04T00:00:00.000Z,306,26,JaVale McGee,0,18,18,12,6,19.2
0,0,0,1,0,1,0,0,0,1,0,1,0,0,1,0,1037676,2023-11-04T00:00:00.000Z,38017714,26,Keon Ellis,1,0,0,0,0,3
0,0,0,0,0,0,0,0,0,0,0,0,0,0,0,0,1037676,2023-11-04T00:00:00.000Z,290,26,Trey Lyles,0,0,0,0,0,0
2,0,0,2,0,3,1,1,1,14,0,3,3,0,1,2,1037678,2023-11-04T00:00:00.000Z,89,5,Alex Caruso,1,3,5,5,2,7
0,0,7,0,0,3,2,2,1,15,4,1,5,11,1,0,1037678,2023-11-04T00:00:00.000Z,137,5,Andre Drummond,1,16,16,5,11,21.2
5,1,2,4,1,10,4,2,2,31,0,2,11,2,2,2,1037678,2023-11-04T00:00:00.000Z,666956,5,Coby White,3,13,18,16,7,27.9
1,0,0,5,4,9,6,1,0,18,0,2,16,0,0,1,1037678,2023-11-04T00:00:00.000Z,87,5,Jevon Carter,0,16,17,17,1,16.5
0,0,0,0,0,0,0,0,0,3,0,0,0,0,0,0,1037678,2023-11-04T00:00:00.000Z,56677857,5,Julian Phillips,0,0,0,0,0,0
3,0,5,2,1,17,8,2,2,30,2,3,19,7,0,2,1037678,2023-11-04T00:00:00.000Z,460,5,Nikola Vucevic,0,26,29,22,10,29.9
0,0,0,0,0,0,0,0,0,3,0,0,0,0,0,0,1037678,2023-11-04T00:00:00.000Z,56677874,5,Onuralp Bitim,0,0,0,0,0,0
3,2,2,5,0,7,2,4,3,28,1,0,7,3,1,1,1037678,2023-11-04T00:00:00.000Z,3547248,5,Patrick Williams,3,10,13,10,6,23.1
4,0,4,5,1,12,4,4,3,31,0,2,12,4,1,3,1037678,2023-11-04T00:00:00.000Z,268,5,Zach LaVine,1,16,20,16,8,22.8
5,1,9,3,1,9,4,8,6,35,3,2,15,12,2,3,1037678,2023-11-04T00:00:00.000Z,177,8,Aaron Gordon,3,27,32,20,17,42.9
0,0,0,0,0,0,0,0,0,0,0,0,0,0,0,0,1037678,2023-11-04T00:00:00.000Z,17896007,8,Braxton Key,0,0,0,0,0,0
0,0,0,0,0,0,0,0,0,0,0,0,0,0,0,0,1037678,2023-11-04T00:00:00.000Z,17896103,8,Jay Huff,0,0,0,0,0,0
2,2,5,10,5,16,9,5,4,31,1,4,27,6,1,2,1037678,2023-11-04T00:00:00.000Z,375,8,Michael Porter Jr.,3,33,35,29,8,44.2
0,0,0,0,0,0,0,0,0,0,0,0,0,0,0,0,1037678,2023-11-04T00:00:00.000Z,666489,8,Vlatko Cancar,0,0,0,0,0,0
4,4,4,3,2,14,6,0,0,38,5,3,14,9,4,1,1037679,2023-11-05T00:00:00.000Z,56677826,9,Ausar Thompson,8,23,27,18,13,53.8
6,1,2,6,0,24,12,3,2,39,1,2,26,3,0,6,1037679,2023-11-05T00:00:00.000Z,17896075,9,Cade Cunningham,1,29,35,32,9,35.6
1,0,2,2,1,6,3,2,1,34,0,0,8,2,0,3,1037679,2023-11-05T00:00:00.000Z,3547267,9,Isaiah Stewart,0,10,11,9,3,8.9
0,0,0,0,0,0,0,0,0,0,0,0,0,0,0,0,1037679,2023-11-05T00:00:00.000Z,38017682,9,Jaden Ivey,0,0,0,0,0,0
3,0,8,0,0,10,6,0,0,31,3,4,12,11,2,5,1037679,2023-11-05T00:00:00.000Z,38017694,9,Jalen Duren,2,23,26,15,14,30.7
0,0,0,0,0,0,0,0,0,3,0,0,0,0,0,0,1037679,2023-11-05T00:00:00.000Z,42097199,9,Jared Rhoden,0,0,0,0,0,0
1,0,1,2,0,2,0,0,0,13,0,1,0,1,0,0,1037679,2023-11-05T00:00:00.000Z,197,9,Joe Harris,0,1,2,1,2,2.7
5,1,2,3,1,8,4,4,4,34,0,4,13,2,0,0,1037679,2023-11-05T00:00:00.000Z,3547241,9,Killian Hayes,1,15,20,18,7,25.9
0,0,0,0,0,0,0,0,0,3,0,0,0,0,0,0,1037679,2023-11-05T00:00:00.000Z,56677729,9,Malcolm Cazalon,0,0,0,0,0,0
4,0,3,6,4,16,9,0,0,30,0,3,22,3,1,0,1037679,2023-11-05T00:00:00.000Z,56677792,9,Marcus Sasser,1,25,29,26,7,34.6
1,0,1,0,0,5,3,5,5,11,1,5,11,2,0,1,1037679,2023-11-05T00:00:00.000Z,24,9,Marvin Bagley III,0,13,14,12,3,13.9
0,0,0,1,0,2,0,0,0,4,0,1,0,0,0,0,1037679,2023-11-05T00:00:00.000Z,44477024,9,Stanley Umude,0,0,0,0,0,0
0,0,0,0,0,0,0,0,0,0,0,0,0,0,0,0,1037680,2023-11-05T00:00:00.000Z,38017693,27,Blake Wesley,0,0,0,0,0,0
0,0,0,0,0,0,0,0,0,0,0,0,0,0,0,0,1037680,2023-11-05T00:00:00.000Z,56677865,27,Charles Bediako,0,0,0,0,0,0
0,0,0,0,0,0,0,0,0,0,0,0,0,0,0,0,1037680,2023-11-05T00:00:00.000Z,3547246,27,Devin Vassell,0,0,0,0,0,0
0,0,0,0,0,0,0,0,0,0,0,0,0,0,0,0,1037680,2023-11-05T00:00:00.000Z,56677870,27,Sir'Jabari Rice,0,0,0,0,0,0
0,0,0,0,0,0,0,0,0,0,0,0,0,0,0,0,1037680,2023-11-05T00:00:00.000Z,58,28,Chris Boucher,0,0,0,0,0,0
0,0,0,0,0,0,0,0,0,0,0,0,0,0,0,0,1037680,2023-11-05T00:00:00.000Z,38017710,28,Christian Koloko,0,0,0,0,0,0
6,1,1,8,1,19,10,4,3,38,2,1,24,3,2,2,1037680,2023-11-05T00:00:00.000Z,409,28,Dennis Schroder,3,27,33,30,9,43.6
0,0,0,0,0,0,0,0,0,0,0,0,0,0,0,0,1037680,2023-11-05T00:00:00.000Z,436,28,Garrett Temple,0,0,0,0,0,0
0,0,0,4,2,8,4,0,0,29,0,1,10,0,1,2,1037680,2023-11-05T00:00:00.000Z,3089,28,Gary Trent Jr.,1,10,10,10,0,11
4,0,2,2,0,2,0,0,0,14,1,1,0,3,0,1,1037680,2023-11-05T00:00:00.000Z,56677828,28,Gradey Dick,0,3,7,4,7,8.6
0,1,7,0,0,10,8,2,0,29,3,2,16,10,3,1,1037680,2023-11-05T00:00:00.000Z,373,28,Jakob Poeltl,4,26,26,16,10,39
0,0,1,1,0,3,0,0,0,5,0,0,0,1,0,1,1037680,2023-11-05T00:00:00.000Z,666762,28,Jalen McDaniels,0,1,1,0,1,0.2
0,0,0,0,0,0,0,0,0,0,0,0,0,0,0,0,1037680,2023-11-05T00:00:00.000Z,56677805,28,Javon Freeman-Liberty,0,0,0,0,0,0
4,1,2,2,1,3,1,2,2,15,1,1,5,3,0,0,1037680,2023-11-05T00:00:00.000Z,3547275,28,Malachi Flynn,1,8,12,9,7,17.6
0,0,0,0,0,0,0,0,0,0,0,0,0,0,0,0,1037680,2023-11-05T00:00:00.000Z,56677869,28,Markquis Nowell,0,0,0,0,0,0
4,0,5,13,7,16,8,4,1,38,2,3,24,7,1,1,1037680,2023-11-05T00:00:00.000Z,18,28,OG Anunoby,1,31,35,28,11,40.4
0,1,4,4,2,4,2,0,0,19,0,2,6,4,0,0,1037680,2023-11-05T00:00:00.000Z,376,28,Otto Porter Jr.,1,10,10,6,4,13.8
5,0,6,4,1,12,2,3,3,36,0,3,8,6,1,3,1037680,2023-11-05T00:00:00.000Z,416,28,Pascal Siakam,1,14,19,13,11,22.7
0,0,0,0,0,0,0,0,0,0,0,0,0,0,0,0,1037680,2023-11-05T00:00:00.000Z,3547249,28,Precious Achiuwa,0,0,0,0,0,0
0,0,0,0,0,0,0,0,0,0,0,0,0,0,0,0,1037680,2023-11-05T00:00:00.000Z,38017717,28,Ron Harper Jr.,0,0,0,0,0,0
6,3,7,10,5,20,9,11,7,42,4,1,30,11,3,3,1037680,2023-11-05T00:00:00.000Z,17896055,28,Scottie Barnes,6,41,47,36,17,67.2
0,0,0,0,0,0,0,0,0,0,0,0,0,0,0,0,1037680,2023-11-05T00:00:00.000Z,489,28,Thaddeus Young,0,0,0,0,0,0
2,0,5,3,0,6,3,2,2,32,0,0,8,5,2,1,1037681,2023-11-05T00:00:00.000Z,277,6,Caris LeVert,2,13,15,10,7,22
0,0,0,0,0,0,0,0,0,0,0,0,0,0,0,0,1037681,2023-11-05T00:00:00.000Z,56677872,6,Craig Porter,0,0,0,0,0,0
0,0,0,0,0,0,0,0,0,1,0,0,0,0,0,0,1037681,2023-11-05T00:00:00.000Z,248,6,Damian Jones,0,0,0,0,0,0
7,0,3,5,0,17,6,13,12,30,0,3,24,3,0,6,1037681,2023-11-05T00:00:00.000Z,666581,6,Darius Garland,0,27,34,31,10,32.1
0,0,3,3,1,3,1,0,0,13,1,1,3,4,3,0,1037681,2023-11-05T00:00:00.000Z,666940,6,Dean Wade,3,7,7,3,4,16.8
7,0,1,11,5,19,11,4,4,34,1,3,31,2,2,4,1037681,2023-11-05T00:00:00.000Z,322,6,Donovan Mitchell,2,33,40,38,9,45.9
0,0,0,0,0,0,0,0,0,0,0,0,0,0,0,0,1037681,2023-11-05T00:00:00.000Z,56677847,6,Emoni Bates,0,0,0,0,0,0
2,1,11,1,0,10,6,4,1,29,5,4,13,16,0,5,1037681,2023-11-05T00:00:00.000Z,17896076,6,Evan Mobley,1,29,31,15,18,33.2
1,0,6,4,2,6,2,0,0,25,0,4,6,6,0,0,1037681,2023-11-05T00:00:00.000Z,344,6,Georges Niang,0,12,13,7,7,14.7
0,0,0,0,0,0,0,0,0,0,0,0,0,0,0,0,1037681,2023-11-05T00:00:00.000Z,3547247,6,Isaac Okoro,0,0,0,0,0,0
0,0,0,0,0,0,0,0,0,0,0,0,0,0,0,0,1037681,2023-11-05T00:00:00.000Z,38017662,6,Isaiah Mobley,0,0,0,0,0,0
3,0,4,0,0,7,5,2,2,28,5,1,12,9,0,2,1037681,2023-11-05T00:00:00.000Z,9,6,Jarrett Allen,0,21,24,15,12,25.3
4,0,4,10,3,13,6,0,0,36,0,3,15,4,1,0,1037681,2023-11-05T00:00:00.000Z,666908,6,Max Strus,1,19,23,19,8,28.8
0,0,0,0,0,0,0,0,0,0,0,0,0,0,0,0,1037681,2023-11-05T00:00:00.000Z,404,6,Ricky Rubio,0,0,0,0,0,0
0,0,0,0,0,0,0,0,0,1,0,0,0,0,0,0,1037681,2023-11-05T00:00:00.000Z,3547299,6,Sam Merrill,0,0,0,0,0,0
0,1,4,0,0,2,1,3,1,11,1,2,3,5,0,0,1037681,2023-11-05T00:00:00.000Z,444,6,Tristan Thompson,1,8,8,3,5,12
0,0,0,0,0,0,0,0,0,0,0,0,0,0,0,0,1037681,2023-11-05T00:00:00.000Z,666676,6,Ty Jerome,0,0,0,0,0,0
1,0,2,2,1,9,3,4,1,26,3,1,8,5,0,0,1037681,2023-11-05T00:00:00.000Z,475,10,Andrew Wiggins,0,13,14,9,6,15.5
2,0,1,1,0,2,0,0,0,8,1,0,0,2,1,2,1037681,2023-11-05T00:00:00.000Z,56677858,10,Brandin Podziemski,1,2,4,2,4,6.4
2,0,1,5,1,10,2,0,0,25,0,3,5,1,1,0,1037681,2023-11-05T00:00:00.000Z,367,10,Chris Paul,1,6,8,7,3,12.2
0,0,0,0,0,0,0,0,0,3,0,0,0,0,1,0,1037681,2023-11-05T00:00:00.000Z,251,10,Cory Joseph,1,0,0,0,0,3
0,0,4,1,0,3,0,0,0,13,1,2,0,5,0,1,1037681,2023-11-05T00:00:00.000Z,407,10,Dario Saric,0,5,5,0,5,5
8,1,3,3,2,11,5,6,6,29,0,0,18,3,3,1,1037681,2023-11-05T00:00:00.000Z,185,10,Draymond Green,4,21,29,26,11,44.6
1,0,0,3,1,7,2,0,0,12,2,2,5,2,0,0,1037681,2023-11-05T00:00:00.000Z,2189,10,Gary Payton II,0,7,8,6,3,8.9
0,0,0,0,0,0,0,0,0,0,0,0,0,0,0,0,1037681,2023-11-05T00:00:00.000Z,398,10,Jerome Robinson,0,0,0,0,0,0
0,2,2,4,1,14,5,4,4,20,1,2,15,3,0,1,1037681,2023-11-05T00:00:00.000Z,17553979,10,Jonathan Kuminga,2,18,18,15,3,23.6
5,0,6,0,0,2,1,0,0,15,5,1,2,11,0,0,1037681,2023-11-05T00:00:00.000Z,282,10,Kevon Looney,0,13,18,7,16,22.7
2,0,1,9,3,14,5,2,2,32,2,2,15,3,1,2,1037681,2023-11-05T00:00:00.000Z,443,10,Klay Thompson,1,18,20,17,5,22.6
0,0,0,0,0,0,0,0,0,0,0,0,0,0,0,0,1037681,2023-11-05T00:00:00.000Z,45658838,10,Lester Quinones,0,0,0,0,0,0
0,0,2,2,0,3,1,2,1,14,1,1,3,3,1,0,1037681,2023-11-05T00:00:00.000Z,17553992,10,Moses Moody,1,6,6,3,3,9.6
4,0,2,11,7,16,8,6,5,31,0,0,28,2,1,6,1037681,2023-11-05T00:00:00.000Z,115,10,Stephen Curry,1,30,34,32,6,33.4
1,1,3,0,0,3,2,6,1,12,1,4,5,4,1,0,1037681,2023-11-05T00:00:00.000Z,56677799,10,Trayce Jackson-Davis,2,9,10,6,5,17.3
0,0,0,0,0,0,0,0,0,0,0,0,0,0,0,0,1037681,2023-11-05T00:00:00.000Z,17896070,10,Usman Garuba,0,0,0,0,0,0
0,0,0,0,0,0,0,0,0,0,0,0,0,0,0,0,1037682,2023-11-05T00:00:00.000Z,56677848,4,Amari Bailey,0,0,0,0,0,0
1,0,1,5,0,12,3,2,1,36,0,3,7,1,1,0,1037682,2023-11-05T00:00:00.000Z,56677823,4,Brandon Miller,1,8,9,8,2,12.7
0,0,2,1,0,1,0,2,1,10,0,0,1,2,2,0,1037682,2023-11-05T00:00:00.000Z,38017708,4,Bryce McGowens,2,3,3,1,2,9.4
0,0,0,0,0,0,0,0,0,0,0,0,0,0,0,0,1037682,2023-11-05T00:00:00.000Z,666748,4,Cody Martin,0,0,0,0,0,0
0,0,0,0,0,0,0,0,0,0,0,0,0,0,0,0,1037682,2023-11-05T00:00:00.000Z,347,4,Frank Ntilikina,0,0,0,0,0,0
8,0,2,4,1,23,9,4,1,34,2,2,20,4,1,1,1037682,2023-11-05T00:00:00.000Z,204,4,Gordon Hayward,1,24,32,28,12,38.8
0,0,0,0,0,0,0,0,0,3,0,3,0,0,0,1,1037682,2023-11-05T00:00:00.000Z,422,4,Ish Smith,0,0,0,0,0,-1
0,0,0,0,0,0,0,0,0,0,0,0,0,0,0,0,1037682,2023-11-05T00:00:00.000Z,17896037,4,James Bouknight,0,0,0,0,0,0
1,0,2,0,0,1,0,0,0,15,1,0,0,3,0,0,1037682,2023-11-05T00:00:00.000Z,18678001,4,JT Thor,0,3,4,1,4,5.1
13,1,8,10,5,23,11,3,3,39,2,6,30,10,1,3,1037682,2023-11-05T00:00:00.000Z,3547239,4,LaMelo Ball,2,40,53,43,23,64.5
0,0,0,0,0,0,0,0,0,0,0,0,0,0,0,0,1037682,2023-11-05T00:00:00.000Z,56677866,4,Leaky Black,0,0,0,0,0,0
1,0,8,0,0,8,8,6,3,27,2,3,19,10,0,2,1037682,2023-11-05T00:00:00.000Z,38017698,4,Mark Williams,0,29,30,20,11,30.5
0,0,0,0,0,0,0,0,0,0,0,0,0,0,0,0,1037682,2023-11-05T00:00:00.000Z,62,4,Miles Bridges,0,0,0,0,0,0
1,1,6,0,0,7,6,0,0,21,3,4,12,9,0,0,1037682,2023-11-05T00:00:00.000Z,3547282,4,Nick Richards,1,21,22,13,10,27.3
0,0,0,0,0,0,0,0,0,0,0,0,0,0,0,0,1037682,2023-11-05T00:00:00.000Z,56677846,4,Nick Smith Jr.,0,0,0,0,0,0
1,0,4,4,1,15,8,4,3,34,0,3,20,4,0,0,1037682,2023-11-05T00:00:00.000Z,666950,4,P.J. Washington,0,24,25,21,5,26.3
0,0,0,0,0,0,0,0,0,0,0,0,0,0,0,0,1037682,2023-11-05T00:00:00.000Z,403,4,Terry Rozier,0,0,0,0,0,0
4,0,0,6,1,9,4,0,0,21,0,1,9,0,0,1,1037682,2023-11-05T00:00:00.000Z,3547253,4,Theo Maledon,0,9,13,13,4,14
0,0,0,0,0,0,0,0,0,0,0,0,0,0,0,0,1037682,2023-11-05T00:00:00.000Z,17554004,7,AJ Lawson,0,0,0,0,0,0
0,0,1,1,1,2,1,0,0,3,0,1,3,1,0,0,1037682,2023-11-05T00:00:00.000Z,151,7,Dante Exum,0,4,4,3,1,4.2
1,1,11,0,0,9,7,2,1,32,3,4,15,14,0,2,1037682,2023-11-05T00:00:00.000Z,56677840,7,Dereck Lively II,1,29,30,16,15,34.3
1,1,0,1,0,2,0,0,0,17,0,1,0,0,1,1,1037682,2023-11-05T00:00:00.000Z,247,7,Derrick Jones Jr.,2,0,1,1,1,6.5
0,0,0,0,0,0,0,0,0,0,0,0,0,0,0,0,1037682,2023-11-05T00:00:00.000Z,56677873,7,Dexter Dennis,0,0,0,0,0,0
3,1,4,5,4,9,7,1,0,31,0,3,18,4,0,0,1037682,2023-11-05T00:00:00.000Z,666965,7,Grant Williams,1,22,25,21,7,30.3
0,0,0,0,0,0,0,0,0,0,0,0,0,0,0,0,1037682,2023-11-05T00:00:00.000Z,17896028,7,Greg Brown III,0,0,0,0,0,0
10,1,3,6,2,14,6,4,4,34,0,3,18,3,1,2,1037682,2023-11-05T00:00:00.000Z,228,7,Kyrie Irving,2,21,31,28,13,40.6
9,1,11,9,1,19,8,7,6,36,1,3,23,12,0,4,1037682,2023-11-05T00:00:00.000Z,132,7,Luka Doncic,1,35,44,32,21,49.9
0,0,0,0,0,0,0,0,0,0,0,0,0,0,0,0,1037682,2023-11-05T00:00:00.000Z,329,7,Markieff Morris,0,0,0,0,0,0
0,0,0,0,0,0,0,0,0,0,0,0,0,0,0,0,1037682,2023-11-05T00:00:00.000Z,257,7,Maxi Kleber,0,0,0,0,0,0
0,0,0,0,0,0,0,0,0,0,0,0,0,0,0,0,1037682,2023-11-05T00:00:00.000Z,56677859,7,Olivier-Maxence Prosper,0,0,0,0,0,0
0,0,0,0,0,0,0,0,0,0,0,0,0,0,0,0,1037682,2023-11-05T00:00:00.000Z,217,7,Richaun Holmes,0,0,0,0,0,0
0,0,0,0,0,0,0,0,0,0,0,0,0,0,0,0,1037682,2023-11-05T00:00:00.000Z,114,7,Seth Curry,0,0,0,0,0,0
5,0,8,9,3,27,13,1,1,34,0,5,30,8,1,3,1037683,2023-11-05T00:00:00.000Z,3547287,15,Desmond Bane,1,38,43,35,13,47.1
2,1,4,4,1,18,11,6,4,37,3,1,27,7,1,2,1037683,2023-11-05T00:00:00.000Z,231,15,Jaren Jackson Jr.,2,34,36,29,9,42.4
3,1,2,2,1,3,2,1,0,10,0,0,5,2,0,0,1037683,2023-11-05T00:00:00.000Z,38017732,15,Kenneth Lofton Jr.,1,7,10,8,5,14.9
2,0,5,6,4,9,5,1,1,32,0,0,15,5,1,1,1037683,2023-11-05T00:00:00.000Z,254,15,Luke Kennard,1,20,22,17,7,26
5,0,2,5,2,9,4,0,0,29,0,3,10,2,2,3,1037683,2023-11-05T00:00:00.000Z,420,15,Marcus Smart,2,12,17,15,7,22.9
3,0,4,3,1,8,3,0,0,20,1,0,7,5,0,2,1037683,2023-11-05T00:00:00.000Z,17896067,15,Santi Aldama,0,12,15,10,8,15.5
1,1,6,2,1,4,2,2,1,28,1,2,6,7,0,2,1037683,2023-11-05T00:00:00.000Z,17896027,15,Ziaire Williams,1,13,14,7,8,16.9
0,0,0,0,0,0,0,0,0,0,0,0,0,0,0,0,1037683,2023-11-05T00:00:00.000Z,419,25,Anfernee Simons,0,0,0,0,0,0
0,1,9,0,0,9,3,0,0,35,2,4,6,11,2,3,1037683,2023-11-05T00:00:00.000Z,22,25,Deandre Ayton,3,17,17,6,11,25.2
0,0,0,0,0,0,0,0,0,0,0,0,0,0,0,0,1037683,2023-11-05T00:00:00.000Z,56783340,25,Duop Reath,0,0,0,0,0,0
0,0,0,0,0,0,0,0,0,0,0,0,0,0,0,0,1037683,2023-11-05T00:00:00.000Z,17896120,25,Ish Wainright,0,0,0,0,0,0
1,1,2,5,0,9,2,1,1,16,3,2,5,5,3,0,1037683,2023-11-05T00:00:00.000Z,38017711,25,Jabari Walker,4,10,11,6,6,24.5
3,0,1,13,4,22,10,4,3,38,2,3,27,3,0,2,1037683,2023-11-05T00:00:00.000Z,182,25,Jerami Grant,0,30,33,30,6,33.1
0,0,0,0,0,0,0,0,0,0,0,0,0,0,0,0,1037683,2023-11-05T00:00:00.000Z,47957121,25,Justin Minaya,0,0,0,0,0,0
0,0,0,0,0,0,0,0,0,0,0,0,0,0,0,0,1037683,2023-11-05T00:00:00.000Z,56677791,25,Kris Murray,0,0,0,0,0,0
11,0,4,8,2,20,6,4,4,39,3,2,18,7,1,1,1037683,2023-11-05T00:00:00.000Z,65,25,Malcolm Brogdon,1,25,36,29,18,44.9
1,2,3,3,2,3,2,0,0,19,0,1,6,3,1,1,1037683,2023-11-05T00:00:00.000Z,666923,25,Matisse Thybulle,3,9,10,7,4,19.1
0,0,0,0,0,0,0,0,0,0,0,0,0,0,0,0,1037683,2023-11-05T00:00:00.000Z,666476,25,Moses Brown,0,0,0,0,0,0
0,0,0,0,0,0,0,0,0,0,0,0,0,0,0,0,1037683,2023-11-05T00:00:00.000Z,56677829,25,Rayan Rupert,0,0,0,0,0,0
0,0,1,0,0,3,2,1,1,11,2,4,5,3,0,1,1037683,2023-11-05T00:00:00.000Z,476,25,Robert Williams III,0,8,8,5,3,7.6
0,0,0,0,0,0,0,0,0,0,0,0,0,0,0,0,1037683,2023-11-05T00:00:00.000Z,56677747,25,Scoot Henderson,0,0,0,0,0,0
3,1,7,8,3,15,7,3,1,41,1,1,18,8,1,3,1037683,2023-11-05T00:00:00.000Z,38017690,25,Shaedon Sharpe,2,26,29,21,11,35.1
2,0,1,5,1,9,2,2,2,16,0,3,7,1,2,0,1037683,2023-11-05T00:00:00.000Z,3547289,25,Skylar Mays,2,8,10,9,3,17.2
2,0,3,3,2,5,3,0,0,25,3,1,8,6,1,3,1037683,2023-11-05T00:00:00.000Z,56677850,25,Toumani Camara,1,14,16,10,8,18.2
0,0,0,0,0,0,0,0,0,0,0,0,0,0,0,0,1037684,2023-11-06T00:00:00.000Z,77,9,Alec Burks,0,0,0,0,0,0
2,0,3,4,1,10,6,3,3,38,4,2,16,7,4,1,1037684,2023-11-06T00:00:00.000Z,56677826,9,Ausar Thompson,4,23,25,18,9,38.4
0,0,0,0,0,0,0,0,0,0,0,0,0,0,0,0,1037684,2023-11-06T00:00:00.000Z,54,9,Bojan Bogdanovic,0,0,0,0,0,0
5,0,4,6,1,18,7,7,6,40,0,2,21,4,2,5,1037684,2023-11-06T00:00:00.000Z,17896075,9,Cade Cunningham,2,25,30,26,9,34.3
0,0,0,0,0,0,0,0,0,0,0,0,0,0,0,0,1037684,2023-11-06T00:00:00.000Z,17896071,9,Isaiah Livers,0,0,0,0,0,0
4,1,9,5,3,9,5,4,4,39,2,3,17,11,0,3,1037684,2023-11-06T00:00:00.000Z,3547267,9,Isaiah Stewart,1,28,32,21,15,36.2
0,0,0,0,0,0,0,0,0,0,0,0,0,0,0,0,1037684,2023-11-06T00:00:00.000Z,38017682,9,Jaden Ivey,0,0,0,0,0,0
0,0,0,0,0,0,0,0,0,0,0,0,0,0,0,0,1037684,2023-11-06T00:00:00.000Z,38017694,9,Jalen Duren,0,0,0,0,0,0
0,0,3,0,0,3,0,0,0,11,0,0,0,3,0,0,1037684,2023-11-06T00:00:00.000Z,3547240,9,James Wiseman,0,3,3,0,3,3.6
0,0,1,1,0,2,0,2,2,5,1,1,2,2,0,1,1037684,2023-11-06T00:00:00.000Z,42097199,9,Jared Rhoden,0,4,4,2,2,3.4
0,0,0,0,0,0,0,0,0,0,0,0,0,0,0,0,1037684,2023-11-06T00:00:00.000Z,197,9,Joe Harris,0,0,0,0,0,0
7,1,4,4,3,12,8,2,2,34,0,3,21,4,1,0,1037684,2023-11-06T00:00:00.000Z,3547241,9,Killian Hayes,2,25,32,28,11,42.3
0,0,0,0,0,0,0,0,0,0,0,0,0,0,0,0,1037684,2023-11-06T00:00:00.000Z,56677729,9,Malcolm Cazalon,0,0,0,0,0,0
4,0,3,5,1,10,3,0,0,33,0,5,7,3,1,2,1037684,2023-11-06T00:00:00.000Z,56677792,9,Marcus Sasser,1,10,14,11,7,17.6
1,0,2,0,0,8,4,2,2,24,0,1,10,2,0,1,1037684,2023-11-06T00:00:00.000Z,24,9,Marvin Bagley III,0,12,13,11,3,12.9
0,0,0,0,0,0,0,0,0,0,0,0,0,0,0,0,1037684,2023-11-06T00:00:00.000Z,330,9,Monte Morris,0,0,0,0,0,0
0,0,3,5,4,8,5,1,1,16,0,3,15,3,0,1,1037684,2023-11-06T00:00:00.000Z,44477024,9,Stanley Umude,0,18,18,15,3,17.6
1,1,3,2,0,9,2,2,0,21,3,0,4,6,1,2,1037684,2023-11-06T00:00:00.000Z,475,10,Andrew Wiggins,2,10,11,5,7,16.7
0,0,0,0,0,0,0,0,0,1,0,0,0,0,0,0,1037684,2023-11-06T00:00:00.000Z,56677858,10,Brandin Podziemski,0,0,0,0,0,0
6,0,5,3,2,9,6,3,3,21,0,0,17,5,0,0,1037684,2023-11-06T00:00:00.000Z,367,10,Chris Paul,0,22,28,23,11,32
8,0,6,1,0,4,2,2,2,27,3,2,6,9,0,2,1037684,2023-11-06T00:00:00.000Z,185,10,Draymond Green,0,15,23,14,17,26.8
0,0,0,0,0,0,0,0,0,0,0,0,0,0,0,0,1037684,2023-11-06T00:00:00.000Z,398,10,Jerome Robinson,0,0,0,0,0,0
0,0,0,0,0,0,0,0,0,0,0,0,0,0,0,0,1037684,2023-11-06T00:00:00.000Z,45658838,10,Lester Quinones,0,0,0,0,0,0
2,0,1,2,0,6,2,0,0,19,1,0,4,2,3,0,1037684,2023-11-06T00:00:00.000Z,17553992,10,Moses Moody,3,6,8,6,4,18.4
0,0,0,0,0,0,0,0,0,0,0,0,0,0,0,0,1037684,2023-11-06T00:00:00.000Z,17896070,10,Usman Garuba,0,0,0,0,0,0
2,0,1,4,3,8,5,2,2,16,1,0,15,2,2,0,1037685,2023-11-06T00:00:00.000Z,3547250,12,Aaron Nesmith,2,17,19,17,4,26.4
8,0,2,5,3,7,3,0,0,16,0,3,9,2,0,2,1037685,2023-11-06T00:00:00.000Z,38017507,12,Andrew Nembhard,0,11,19,17,10,21.4
0,0,2,4,1,7,3,0,0,12,0,1,7,2,0,0,1037685,2023-11-06T00:00:00.000Z,56677861,12,Ben Sheppard,0,9,9,7,2,9.4
2,0,2,2,0,8,4,2,2,22,1,2,10,3,1,1,1037685,2023-11-06T00:00:00.000Z,38017686,12,Bennedict Mathurin,1,13,15,12,5,18.6
4,0,5,3,1,7,3,0,0,24,0,1,7,5,0,0,1037685,2023-11-06T00:00:00.000Z,69,12,Bruce Brown,0,12,16,11,9,19
2,0,2,6,5,8,7,0,0,21,0,1,19,2,1,4,1037685,2023-11-06T00:00:00.000Z,210,12,Buddy Hield,1,21,23,21,4,23.4
0,0,0,0,0,0,0,0,0,0,0,0,0,0,0,0,1037685,2023-11-06T00:00:00.000Z,439,12,Daniel Theis,0,0,0,0,0,0
1,2,1,0,0,3,3,1,1,15,2,5,7,3,0,0,1037685,2023-11-06T00:00:00.000Z,17896035,12,Isaiah Jackson,2,10,11,8,4,18.1
0,0,0,0,0,0,0,0,0,0,0,0,0,0,0,0,1037685,2023-11-06T00:00:00.000Z,56677794,12,Isaiah Wong,0,0,0,0,0,0
2,0,6,1,1,4,4,0,0,12,1,3,9,7,0,1,1037685,2023-11-06T00:00:00.000Z,3547264,12,Jalen Smith,0,16,18,11,9,19.4
2,0,1,0,0,1,0,2,2,9,0,0,2,1,0,0,1037685,2023-11-06T00:00:00.000Z,56677832,12,Jarace Walker,0,3,5,4,3,6.2
0,0,4,2,1,3,2,2,1,9,0,0,6,4,0,2,1037685,2023-11-06T00:00:00.000Z,3547207,12,Jordan Nwora,0,10,10,6,4,8.8
0,0,0,0,0,0,0,0,0,0,0,0,0,0,0,0,1037685,2023-11-06T00:00:00.000Z,38017701,12,Kendall Brown,0,0,0,0,0,0
2,1,7,1,1,7,5,4,4,21,4,3,15,11,0,0,1037685,2023-11-06T00:00:00.000Z,452,12,Myles Turner,1,26,28,17,13,34.2
1,0,2,3,1,11,6,6,6,27,0,3,19,2,2,1,1037685,2023-11-06T00:00:00.000Z,3547243,12,Obi Toppin,2,21,22,20,3,27.9
0,0,0,0,0,0,0,0,0,0,0,0,0,0,0,0,1037685,2023-11-06T00:00:00.000Z,56677778,12,Oscar Tshiebwe,0,0,0,0,0,0
4,0,3,0,0,2,1,2,2,9,0,1,4,3,0,1,1037685,2023-11-06T00:00:00.000Z,304,12,T.J. McConnell,0,7,11,8,7,12.6
8,1,2,7,3,19,9,2,2,27,0,1,23,2,1,2,1037685,2023-11-06T00:00:00.000Z,3547245,12,Tyrese Haliburton,2,25,33,31,10,41.4
0,0,0,0,0,0,0,0,0,0,0,0,0,0,0,0,1037685,2023-11-06T00:00:00.000Z,56677865,27,Charles Bediako,0,0,0,0,0,0
3,0,2,0,0,12,6,5,4,23,1,1,16,3,0,1,1037685,2023-11-06T00:00:00.000Z,666682,27,Keldon Johnson,0,19,22,19,6,23.1
0,0,0,0,0,0,0,0,0,0,0,0,0,0,0,0,1037685,2023-11-06T00:00:00.000Z,56677870,27,Sir'Jabari Rice,0,0,0,0,0,0
0,2,9,5,2,12,3,6,5,21,1,1,13,10,1,2,1037685,2023-11-06T00:00:00.000Z,56677822,27,Victor Wembanyama,3,23,23,13,10,32
0,0,0,0,0,0,0,0,0,0,0,0,0,0,0,0,1037686,2023-11-06T00:00:00.000Z,17554004,7,AJ Lawson,0,0,0,0,0,0
0,0,0,0,0,0,0,0,0,0,0,0,0,0,0,0,1037686,2023-11-06T00:00:00.000Z,151,7,Dante Exum,0,0,0,0,0,0
2,2,1,0,0,2,2,5,3,29,0,3,7,1,1,0,1037686,2023-11-06T00:00:00.000Z,379,7,Dwight Powell,3,8,10,9,3,20.2
1,0,1,3,0,5,1,4,3,11,0,0,5,1,1,1,1037686,2023-11-06T00:00:00.000Z,38017679,7,Jaden Hardy,1,6,7,6,2,9.7
1,0,2,2,1,3,2,2,1,20,0,3,6,2,1,1,1037686,2023-11-06T00:00:00.000Z,3547258,7,Josh Green,1,8,9,7,3,11.9
6,0,3,10,5,17,9,6,6,35,0,2,29,3,2,6,1037686,2023-11-06T00:00:00.000Z,132,7,Luka Doncic,2,32,38,35,9,41.6
0,0,0,0,0,0,0,0,0,0,0,0,0,0,0,0,1037686,2023-11-06T00:00:00.000Z,329,7,Markieff Morris,0,0,0,0,0,0
0,0,0,0,0,0,0,0,0,0,0,0,0,0,0,0,1037686,2023-11-06T00:00:00.000Z,257,7,Maxi Kleber,0,0,0,0,0,0
0,0,0,0,0,0,0,0,0,0,0,0,0,0,0,0,1037686,2023-11-06T00:00:00.000Z,56677859,7,Olivier-Maxence Prosper,0,0,0,0,0,0
0,0,0,0,0,0,0,0,0,0,0,0,0,0,0,0,1037686,2023-11-06T00:00:00.000Z,217,7,Richaun Holmes,0,0,0,0,0,0
0,0,0,0,0,0,0,0,0,0,0,0,0,0,0,0,1037686,2023-11-06T00:00:00.000Z,114,7,Seth Curry,0,0,0,0,0,0
0,0,6,11,4,16,8,1,1,31,0,0,21,6,0,0,1037686,2023-11-06T00:00:00.000Z,191,7,Tim Hardaway Jr.,0,27,27,21,6,28.2
0,0,0,0,0,0,0,0,0,0,0,0,0,0,0,0,1037686,2023-11-06T00:00:00.000Z,666885,22,Admiral Schofield,0,0,0,0,0,0
2,0,3,4,2,7,3,0,0,33,2,2,8,5,0,1,1037686,2023-11-06T00:00:00.000Z,56677827,22,Anthony Black,0,13,15,10,7,16
0,0,1,2,1,2,1,0,0,14,0,1,3,1,0,0,1037686,2023-11-06T00:00:00.000Z,38017724,22,Caleb Houstan,0,4,4,3,1,4.2
0,0,0,0,0,0,0,0,0,0,0,0,0,0,0,0,1037686,2023-11-06T00:00:00.000Z,666818,22,Chuma Okeke,0,0,0,0,0,0
5,2,2,5,2,13,7,5,3,30,0,3,19,2,1,3,1037686,2023-11-06T00:00:00.000Z,3547251,22,Cole Anthony,3,21,26,24,7,34.9
4,0,5,4,1,13,5,2,1,33,0,3,12,5,1,1,1037686,2023-11-06T00:00:00.000Z,17896026,22,Franz Wagner,1,17,21,16,9,26
0,0,0,0,0,0,0,0,0,0,0,0,0,0,0,0,1037686,2023-11-06T00:00:00.000Z,196,22,Gary Harris,0,0,0,0,0,0
0,1,4,1,0,5,3,1,1,22,2,3,7,6,2,1,1037686,2023-11-06T00:00:00.000Z,666442,22,Goga Bitadze,3,13,13,7,6,22.2
7,1,3,6,1,12,4,2,1,24,1,3,10,4,1,4,1037686,2023-11-06T00:00:00.000Z,17896073,22,Jalen Suggs,2,14,21,17,11,27.3
0,0,0,0,0,0,0,0,0,0,0,0,0,0,0,0,1037686,2023-11-06T00:00:00.000Z,56677839,22,Jett Howard,0,0,0,0,0,0
3,0,5,0,0,2,1,0,0,21,0,1,2,5,0,2,1037686,2023-11-06T00:00:00.000Z,226,22,Joe Ingles,0,7,10,5,8,10.5
0,0,0,0,0,0,0,0,0,0,0,0,0,0,0,0,1037686,2023-11-06T00:00:00.000Z,165,22,Markelle Fultz,0,0,0,0,0,0
0,0,5,4,1,13,8,2,2,26,0,3,19,5,1,2,1037686,2023-11-06T00:00:00.000Z,462,22,Moritz Wagner,1,24,24,19,5,26
6,0,4,1,0,18,8,6,6,37,1,5,22,5,0,6,1037686,2023-11-06T00:00:00.000Z,38017683,22,Paolo Banchero,0,27,33,28,11,31
0,0,0,0,0,0,0,0,0,0,0,0,0,0,0,0,1037686,2023-11-06T00:00:00.000Z,85,22,Wendell Carter Jr.,0,0,0,0,0,0
0,0,0,1,0,2,1,1,1,7,0,0,3,0,0,2,1037687,2023-11-06T00:00:00.000Z,2175,23,Danuel House Jr.,0,3,3,3,0,1
2,0,2,2,0,2,0,2,1,14,1,1,1,3,0,1,1037687,2023-11-06T00:00:00.000Z,260,23,Furkan Korkmaz,0,4,6,3,5,6.6
0,0,0,1,0,4,0,4,2,12,1,1,2,1,1,1,1037687,2023-11-06T00:00:00.000Z,17896025,23,Jaden Springer,1,3,3,2,1,5.2
0,0,0,0,0,0,0,0,0,0,0,0,0,0,0,0,1037687,2023-11-06T00:00:00.000Z,17554001,23,Javonte Smart,0,0,0,0,0,0
1,0,1,0,0,1,0,0,0,4,0,0,0,1,0,0,1037687,2023-11-06T00:00:00.000Z,3547294,23,Kenyon Martin Jr.,0,1,2,1,2,2.7
0,1,1,0,0,2,1,1,1,6,0,0,3,1,0,0,1037687,2023-11-06T00:00:00.000Z,328,23,Marcus Morris,1,4,4,3,1,7.2
5,1,2,2,1,3,2,1,1,12,2,0,6,4,1,1,1037687,2023-11-06T00:00:00.000Z,45,23,Patrick Beverley,2,10,15,11,9,23.3
2,0,4,0,0,3,3,0,0,13,2,1,6,6,1,1,1037687,2023-11-06T00:00:00.000Z,3547270,23,Paul Reed,1,12,14,8,8,18.2
0,0,0,0,0,0,0,0,0,0,0,0,0,0,0,0,1037687,2023-11-06T00:00:00.000Z,56913527,23,Ricky Council IV,0,0,0,0,0,0
0,1,0,1,1,2,2,2,2,4,0,2,7,0,3,0,1037687,2023-11-06T00:00:00.000Z,108,23,Robert Covington,4,7,7,7,0,19
0,0,0,0,0,0,0,0,0,0,0,0,0,0,0,0,1037687,2023-11-06T00:00:00.000Z,56677788,23,Terquavion Smith,0,0,0,0,0,0
0,2,0,1,0,3,2,2,1,8,1,0,5,1,1,0,1037687,2023-11-06T00:00:00.000Z,3547302,30,Anthony Gill,3,6,6,5,1,15.2
0,1,3,3,1,7,3,3,3,19,0,3,10,3,0,0,1037687,2023-11-06T00:00:00.000Z,56677844,30,Bilal Coulibaly,1,13,13,10,3,16.6
3,5,4,0,0,7,6,0,0,30,3,5,12,7,0,4,1037687,2023-11-06T00:00:00.000Z,666577,30,Daniel Gafford,5,19,22,15,10,35.9
0,0,1,2,0,2,0,1,1,4,0,0,1,1,0,0,1037687,2023-11-06T00:00:00.000Z,167,30,Danilo Gallinari,0,2,2,1,1,2.2
6,0,4,4,2,8,5,4,4,28,1,1,16,5,1,1,1037687,2023-11-06T00:00:00.000Z,3547242,30,Deni Avdija,1,21,27,22,11,33
1,0,1,0,0,8,2,0,0,14,2,0,4,3,0,0,1037687,2023-11-06T00:00:00.000Z,38017687,30,Johnny Davis,0,7,8,5,4,9.1
6,1,1,9,4,15,8,3,3,31,0,4,23,1,0,2,1037687,2023-11-06T00:00:00.000Z,666848,30,Jordan Poole,1,24,30,29,7,34.2
4,1,4,5,4,20,12,1,0,30,2,2,28,6,0,2,1037687,2023-11-06T00:00:00.000Z,265,30,Kyle Kuzma,1,34,38,32,10,42.2
6,0,1,4,2,13,5,0,0,33,0,2,12,1,2,0,1037687,2023-11-06T00:00:00.000Z,249,30,Tyus Jones,2,13,19,18,7,28.2
0,0,0,0,0,0,0,0,0,0,0,0,0,0,0,0,1037688,2023-11-06T00:00:00.000Z,9051997,3,Armoni Brooks,0,0,0,0,0,0
4,0,12,0,0,3,1,0,0,33,3,3,2,15,0,1,1037688,2023-11-06T00:00:00.000Z,417,3,Ben Simmons,0,17,21,6,19,25
3,0,3,16,6,33,17,6,5,40,1,3,45,4,1,1,1037688,2023-11-06T00:00:00.000Z,17896048,3,Cam Thomas,1,49,52,48,7,56.3
0,0,0,0,0,0,0,0,0,0,0,0,0,0,0,0,1037688,2023-11-06T00:00:00.000Z,666679,3,Cameron Johnson,0,0,0,0,0,0
0,0,0,0,0,0,0,0,0,0,0,0,0,0,0,0,1037688,2023-11-06T00:00:00.000Z,56677841,3,Dariq Whitehead,0,0,0,0,0,0
2,1,2,7,1,12,3,0,0,37,4,2,7,6,1,1,1037688,2023-11-06T00:00:00.000Z,158,3,Dorian Finney-Smith,2,13,15,9,8,22.2
0,0,0,0,0,0,0,0,0,0,0,0,0,0,0,0,1037688,2023-11-06T00:00:00.000Z,174,3,Harry Giles III,0,0,0,0,0,0
0,0,0,0,0,0,0,0,0,0,0,0,0,0,0,0,1037688,2023-11-06T00:00:00.000Z,17896041,3,Keon Johnson,0,0,0,0,0,0
4,1,4,5,1,21,12,7,6,39,1,2,31,5,0,1,1037688,2023-11-06T00:00:00.000Z,61,3,Mikal Bridges,1,36,40,35,9,45
0,0,0,0,0,0,0,0,0,0,0,0,0,0,0,0,1037688,2023-11-06T00:00:00.000Z,666508,3,Nicolas Claxton,0,0,0,0,0,0
0,0,0,0,0,0,0,0,0,0,0,0,0,0,0,0,1037688,2023-11-06T00:00:00.000Z,56677843,3,Noah Clowney,0,0,0,0,0,0
3,0,2,3,1,4,1,0,0,24,1,0,3,3,0,0,1037688,2023-11-06T00:00:00.000Z,130,3,Spencer Dinwiddie,0,6,9,6,6,11.1
0,0,0,0,0,0,0,0,0,0,0,0,0,0,0,0,1037688,2023-11-06T00:00:00.000Z,38017733,17,A.J. Green,0,0,0,0,0,0
0,0,0,0,0,0,0,0,0,0,0,0,0,0,0,0,1037688,2023-11-06T00:00:00.000Z,56677852,17,Andre Jackson Jr.,0,0,0,0,0,0
2,0,6,2,1,8,3,4,4,26,0,2,11,6,2,1,1037688,2023-11-06T00:00:00.000Z,377,17,Bobby Portis,2,17,19,13,8,26.2
2,0,3,3,0,6,2,0,0,27,4,3,4,7,0,0,1037688,2023-11-06T00:00:00.000Z,283,17,Brook Lopez,0,11,13,6,9,15.4
3,0,1,4,3,6,4,0,0,17,0,1,11,1,0,0,1037688,2023-11-06T00:00:00.000Z,368,17,Cameron Payne,0,12,15,14,4,16.7
0,0,0,0,0,0,0,0,0,0,0,0,0,0,0,0,1037688,2023-11-06T00:00:00.000Z,56677854,17,Chris Livingston,0,0,0,0,0,0
7,0,4,8,2,15,5,10,9,34,2,1,21,6,1,1,1037688,2023-11-06T00:00:00.000Z,278,17,Damian Lillard,1,27,34,28,13,40.7
0,0,3,9,4,10,5,2,1,30,2,1,15,5,1,2,1037688,2023-11-06T00:00:00.000Z,112,17,Jae Crowder,1,20,20,15,5,22
0,0,0,0,0,0,0,0,0,0,0,0,0,0,0,0,1037688,2023-11-06T00:00:00.000Z,666960,17,Lindell Wigginton,0,0,0,0,0,0
0,0,6,5,1,5,1,0,0,14,0,2,3,6,0,1,1037688,2023-11-06T00:00:00.000Z,38,17,Malik Beasley,0,9,9,3,6,9.2
2,0,0,1,1,2,1,0,0,16,1,0,3,1,1,1,1037688,2023-11-06T00:00:00.000Z,38017676,17,MarJon Beauchamp,1,4,6,5,3,9.2
0,0,0,0,0,0,0,0,0,0,0,0,0,0,0,0,1037688,2023-11-06T00:00:00.000Z,666453,17,Marques Bolden,0,0,0,0,0,0
3,0,0,5,2,7,4,0,0,20,1,1,10,1,0,1,1037688,2023-11-06T00:00:00.000Z,105,17,Pat Connaughton,0,11,14,13,4,14.7
0,0,0,0,0,0,0,0,0,0,0,0,0,0,0,0,1037688,2023-11-06T00:00:00.000Z,284,17,Robin Lopez,0,0,0,0,0,0
0,0,0,0,0,0,0,0,0,0,0,0,0,0,0,0,1037688,2023-11-06T00:00:00.000Z,38017691,17,TyTy Washington Jr.,0,0,0,0,0,0
0,0,0,0,0,0,0,0,0,0,0,0,0,0,0,0,1037689,2023-11-06T00:00:00.000Z,56677867,14,Alex Fudge,0,0,0,0,0,0
4,1,6,0,0,7,4,1,1,25,0,2,9,6,0,1,1037689,2023-11-06T00:00:00.000Z,117,14,Anthony Davis,1,15,19,13,10,24.2
9,0,7,8,3,14,9,3,2,40,3,1,23,10,1,4,1037689,2023-11-06T00:00:00.000Z,17553995,14,Austin Reaves,1,33,42,32,19,47.5
0,0,0,0,0,0,0,0,0,0,0,0,0,0,0,0,1037689,2023-11-06T00:00:00.000Z,56677738,14,Colin Castleton,0,0,0,0,0,0
6,1,4,3,1,10,6,0,0,29,0,2,13,4,0,3,1037689,2023-11-06T00:00:00.000Z,405,14,D'Angelo Russell,1,17,23,19,10,26.8
0,0,0,0,0,0,0,0,0,0,0,0,0,0,0,0,1037689,2023-11-06T00:00:00.000Z,56677868,14,D'Moi Hodge,0,0,0,0,0,0
0,0,0,0,0,0,0,0,0,0,0,0,0,0,0,0,1037689,2023-11-06T00:00:00.000Z,1603383,14,Gabe Vincent,0,0,0,0,0,0
0,0,0,0,0,0,0,0,0,0,0,0,0,0,0,0,1037689,2023-11-06T00:00:00.000Z,56677835,14,Jalen Hood-Schifino,0,0,0,0,0,0
0,0,0,0,0,0,0,0,0,0,0,0,0,0,0,0,1037689,2023-11-06T00:00:00.000Z,457,14,Jarred Vanderbilt,0,0,0,0,0,0
0,0,0,0,0,0,0,0,0,0,0,0,0,0,0,0,1037689,2023-11-06T00:00:00.000Z,666626,14,Jaxson Hayes,0,0,0,0,0,0
0,0,0,0,0,0,0,0,0,0,0,0,0,0,0,0,1037689,2023-11-06T00:00:00.000Z,56677836,14,Maxwell Lewis,0,0,0,0,0,0
0,0,0,0,0,0,0,0,0,0,0,0,0,0,0,0,1037689,2023-11-06T00:00:00.000Z,666609,14,Rui Hachimura,0,0,0,0,0,0
10,2,15,1,1,20,9,5,3,38,5,2,22,20,2,4,1037689,2023-11-06T00:00:00.000Z,4,16,Bam Adebayo,4,42,52,32,30,69
0,0,0,0,0,0,0,0,0,0,0,0,0,0,0,0,1037689,2023-11-06T00:00:00.000Z,19465585,16,Dru Smith,0,0,0,0,0,0
3,0,2,6,2,11,5,0,0,26,0,1,12,2,1,1,1037689,2023-11-06T00:00:00.000Z,397,16,Duncan Robinson,1,14,17,15,5,20.9
0,1,1,5,1,6,2,0,0,22,0,2,5,1,1,0,1037689,2023-11-06T00:00:00.000Z,3092,16,Haywood Highsmith,2,6,6,5,1,12.2
1,0,1,4,1,7,4,0,0,18,1,1,9,2,1,1,1037689,2023-11-06T00:00:00.000Z,56677785,16,Jaime Jaquez Jr.,1,11,12,10,3,14.9
0,0,0,0,0,0,0,0,0,0,0,0,0,0,0,0,1037689,2023-11-06T00:00:00.000Z,38017734,16,Jamal Cain,0,0,0,0,0,0
6,0,2,4,3,15,9,7,7,37,2,0,28,4,2,3,1037689,2023-11-06T00:00:00.000Z,79,16,Jimmy Butler,2,32,38,34,10,44.8
0,0,2,2,1,2,1,0,0,21,0,4,3,2,0,1,1037689,2023-11-06T00:00:00.000Z,391,16,Josh Richardson,0,5,5,3,2,4.4
0,0,0,0,0,0,0,0,0,0,0,0,0,0,0,0,1037689,2023-11-06T00:00:00.000Z,285,16,Kevin Love,0,0,0,0,0,0
5,0,2,5,1,6,2,0,0,33,2,2,5,4,1,0,1037689,2023-11-06T00:00:00.000Z,286,16,Kyle Lowry,1,9,14,10,9,20.3
5,0,4,10,2,20,8,4,4,35,1,1,22,5,3,6,1037689,2023-11-06T00:00:00.000Z,666633,16,Tyler Herro,3,27,32,27,10,38.5
0,0,0,0,0,0,0,0,0,5,0,0,0,0,0,0,1037690,2023-11-06T00:00:00.000Z,666511,13,Amir Coffey,0,0,0,0,0,0
0,3,3,0,0,3,3,4,2,30,4,3,8,7,1,5,1037690,2023-11-06T00:00:00.000Z,493,13,Ivica Zubac,4,15,15,8,7,23.4
6,0,3,4,2,9,6,3,3,31,0,2,17,3,1,2,1037690,2023-11-06T00:00:00.000Z,192,13,James Harden,1,20,26,23,9,30.6
0,0,0,1,0,1,0,0,0,5,0,0,0,0,0,0,1037690,2023-11-06T00:00:00.000Z,56677849,13,Kobe Brown,0,0,0,0,0,0
1,0,2,0,0,1,1,0,0,11,0,0,2,2,1,1,1037690,2023-11-06T00:00:00.000Z,371,13,Mason Plumlee,1,4,5,3,3,7.9
0,0,0,0,0,1,1,2,2,6,0,0,4,0,0,0,1037690,2023-11-06T00:00:00.000Z,38017725,13,Moussa Diabate,0,4,4,4,0,4
4,0,1,4,1,9,2,0,0,22,0,2,5,1,1,3,1037690,2023-11-06T00:00:00.000Z,17896031,13,Nah'Shon Hyland,1,6,10,9,5,12.2
0,1,1,6,4,7,5,0,0,22,0,1,14,1,0,3,1037690,2023-11-06T00:00:00.000Z,380,13,Norman Powell,1,15,15,14,1,15.2
4,0,4,3,1,13,8,0,0,31,0,2,17,4,0,4,1037690,2023-11-06T00:00:00.000Z,472,13,Russell Westbrook,0,21,25,21,8,23.8
0,0,0,0,0,0,0,0,0,0,0,0,0,0,0,0,1037690,2023-11-06T00:00:00.000Z,666474,20,Charles Brown,0,0,0,0,0,0
0,0,0,0,0,0,0,0,0,0,0,0,0,0,0,0,1037690,2023-11-06T00:00:00.000Z,666675,20,DaQuan Jeffries,0,0,0,0,0,0
1,1,4,5,3,6,4,2,1,16,2,1,12,6,1,1,1037690,2023-11-06T00:00:00.000Z,131,20,Donte DiVincenzo,2,18,19,13,7,25.7
0,0,0,0,0,0,0,0,0,0,0,0,0,0,0,0,1037690,2023-11-06T00:00:00.000Z,17896089,20,Duane Washington Jr.,0,0,0,0,0,0
0,0,0,0,0,0,0,0,0,0,0,0,0,0,0,0,1037690,2023-11-06T00:00:00.000Z,666971,20,Dylan Windler,0,0,0,0,0,0
0,0,0,0,0,0,0,0,0,0,0,0,0,0,0,0,1037690,2023-11-06T00:00:00.000Z,160,20,Evan Fournier,0,0,0,0,0,0
5,0,1,3,1,5,3,0,0,20,0,0,7,1,0,0,1037690,2023-11-06T00:00:00.000Z,3547269,20,Immanuel Quickley,0,8,13,12,6,15.7
2,0,1,0,0,5,3,0,0,13,2,2,6,3,2,0,1037690,2023-11-06T00:00:00.000Z,201,20,Isaiah Hartenstein,2,9,11,8,5,18.6
0,0,0,0,0,0,0,0,0,0,0,0,0,0,0,0,1037690,2023-11-06T00:00:00.000Z,56677795,20,Jacob Toppin,0,0,0,0,0,0
6,0,1,3,1,12,2,2,2,35,2,1,7,3,3,4,1037690,2023-11-06T00:00:00.000Z,73,20,Jalen Brunson,3,10,16,13,9,24.6
0,0,0,0,0,0,0,0,0,0,0,0,0,0,0,0,1037690,2023-11-06T00:00:00.000Z,17896063,20,Jericho Sims,0,0,0,0,0,0
7,0,3,4,1,9,4,1,1,32,0,2,10,3,2,2,1037690,2023-11-06T00:00:00.000Z,202,20,Josh Hart,2,13,20,17,10,28.1
3,0,8,8,3,21,9,6,6,37,2,3,27,10,0,6,1037690,2023-11-06T00:00:00.000Z,387,20,Julius Randle,0,37,40,30,13,37.5
0,0,0,0,0,0,0,0,0,0,0,0,0,0,0,0,1037690,2023-11-06T00:00:00.000Z,17896033,20,Miles McBride,0,0,0,0,0,0
0,0,6,0,0,10,6,1,1,35,9,2,13,15,4,0,1037690,2023-11-06T00:00:00.000Z,399,20,Mitchell Robinson,4,28,28,13,15,43
0,0,1,4,1,4,1,0,0,21,0,1,3,1,1,1,1037690,2023-11-06T00:00:00.000Z,17895858,20,Quentin Grimes,1,4,4,3,1,6.2
4,0,5,4,2,16,9,6,6,31,1,1,26,6,0,5,1037690,2023-11-06T00:00:00.000Z,666423,20,RJ Barrett,0,32,36,30,10,34.2
0,0,0,0,0,0,0,0,0,0,0,0,0,0,0,0,1037690,2023-11-06T00:00:00.000Z,19,20,Ryan Arcidiacono,0,0,0,0,0,0
3,0,0,2,2,3,3,2,2,20,1,1,10,1,1,0,1037691,2023-11-06T00:00:00.000Z,89,5,Alex Caruso,1,11,14,13,4,18.7
1,1,2,0,0,10,5,3,2,14,5,2,12,7,1,2,1037691,2023-11-06T00:00:00.000Z,137,5,Andre Drummond,2,19,20,13,8,25.9
0,0,1,3,2,5,2,2,2,16,0,0,8,1,0,1,1037691,2023-11-06T00:00:00.000Z,17895983,5,Ayo Dosunmu,0,9,9,8,1,8.2
7,0,3,6,4,9,7,0,0,29,0,1,18,3,1,1,1037691,2023-11-06T00:00:00.000Z,666956,5,Coby White,1,21,28,25,10,34.1
1,0,1,1,0,3,1,0,0,3,0,0,2,1,0,1,1037691,2023-11-06T00:00:00.000Z,38017719,5,Dalen Terry,0,3,4,3,2,3.7
1,0,0,8,4,8,4,0,0,17,0,1,12,0,2,0,1037691,2023-11-06T00:00:00.000Z,87,5,Jevon Carter,2,12,13,13,1,19.5
0,0,1,1,0,1,0,0,0,2,0,0,0,1,0,0,1037691,2023-11-06T00:00:00.000Z,56677857,5,Julian Phillips,0,1,1,0,1,1.2
0,0,0,0,0,0,0,0,0,0,0,0,0,0,0,0,1037691,2023-11-06T00:00:00.000Z,27,5,Lonzo Ball,0,0,0,0,0,0
0,0,0,0,0,0,0,0,0,0,0,0,0,0,0,0,1037691,2023-11-06T00:00:00.000Z,56677874,5,Onuralp Bitim,0,0,0,0,0,0
0,0,3,4,2,10,4,0,0,25,0,1,10,3,0,0,1037691,2023-11-06T00:00:00.000Z,3547248,5,Patrick Williams,0,13,13,10,3,13.6
0,0,1,0,0,0,0,0,0,2,0,0,0,1,0,0,1037691,2023-11-06T00:00:00.000Z,17896116,5,Terry Taylor,0,1,1,0,1,1.2
0,0,0,0,0,0,0,0,0,0,0,0,0,0,0,0,1037691,2023-11-06T00:00:00.000Z,56677842,29,Brice Sensabaugh,0,0,0,0,0,0
0,0,5,2,1,9,6,1,1,29,1,5,14,6,1,2,1037691,2023-11-06T00:00:00.000Z,101,29,John Collins,1,20,20,14,6,22.2
0,0,0,0,0,0,0,0,0,0,0,0,0,0,0,0,1037691,2023-11-06T00:00:00.000Z,38017630,29,Johnny Juzang,0,0,0,0,0,0
6,0,0,8,1,14,3,0,0,29,1,1,7,1,0,5,1037691,2023-11-06T00:00:00.000Z,100,29,Jordan Clarkson,0,8,14,13,7,12.2
3,0,3,1,1,1,1,0,0,10,2,1,3,5,0,2,1037691,2023-11-06T00:00:00.000Z,139,29,Kris Dunn,0,8,11,6,8,11.5
3,1,4,12,5,15,8,8,8,34,1,2,29,5,0,1,1037691,2023-11-06T00:00:00.000Z,297,29,Lauri Markkanen,1,34,37,32,8,41.5
0,0,0,0,0,0,0,0,0,0,0,0,0,0,0,0,1037691,2023-11-06T00:00:00.000Z,19465584,29,Micah Potter,0,0,0,0,0,0
1,1,1,2,1,3,1,0,0,11,0,2,3,1,0,2,1037691,2023-11-06T00:00:00.000Z,38017620,29,Ochai Agbaji,1,4,5,4,2,6.7
4,0,6,3,1,5,2,0,0,23,0,0,5,6,0,5,1037691,2023-11-06T00:00:00.000Z,666650,29,Talen Horton-Tucker,0,11,15,9,10,13.2
0,4,4,2,1,12,5,6,4,31,11,3,15,15,0,1,1037691,2023-11-06T00:00:00.000Z,38017705,29,Walker Kessler,4,30,30,15,15,44
12,0,6,2,0,13,7,4,3,26,2,3,17,8,1,1,1037692,2023-11-06T00:00:00.000Z,17896062,11,Alperen Sengun,1,25,37,29,20,46.6
0,0,0,0,0,0,0,0,0,0,0,0,0,0,0,0,1037692,2023-11-06T00:00:00.000Z,56677825,11,Amen Thompson,0,0,0,0,0,0
1,0,6,3,1,6,3,2,2,28,0,1,9,6,0,1,1037692,2023-11-06T00:00:00.000Z,66,11,Dillon Brooks,0,15,16,10,7,16.7
5,0,4,5,3,8,3,2,2,27,0,1,11,4,0,1,1037692,2023-11-06T00:00:00.000Z,458,11,Fred VanVleet,0,15,20,16,9,22.3
0,1,4,5,3,8,5,0,0,22,0,4,13,4,0,0,1037692,2023-11-06T00:00:00.000Z,38017684,11,Jabari Smith Jr.,1,17,17,13,4,20.8
2,1,2,5,3,9,5,12,10,26,0,0,23,2,1,3,1037692,2023-11-06T00:00:00.000Z,17895966,11,Jalen Green,2,25,27,25,4,31.4
0,0,0,0,0,0,0,0,0,0,0,0,0,0,0,0,1037692,2023-11-06T00:00:00.000Z,47738533,11,Jeenathan Williams,0,0,0,0,0,0
0,0,1,0,0,2,2,4,2,5,0,1,6,1,1,0,1037692,2023-11-06T00:00:00.000Z,188,11,Jeff Green,1,7,7,6,1,10.2
2,0,1,1,0,1,0,0,0,12,0,1,0,1,0,0,1037692,2023-11-06T00:00:00.000Z,75,11,Reggie Bullock,0,1,3,2,3,4.2
1,1,2,1,0,1,0,0,0,8,1,0,0,3,0,0,1037692,2023-11-06T00:00:00.000Z,273,26,Alex Len,1,3,4,1,4,8.1
2,0,1,1,1,3,1,4,2,15,0,1,5,1,0,1,1037692,2023-11-06T00:00:00.000Z,17896030,26,Chris Duarte,0,6,8,7,3,8.2
1,0,2,0,0,6,4,2,2,13,3,1,10,5,0,0,1037692,2023-11-06T00:00:00.000Z,56677845,26,Colby Jones,0,15,16,11,6,17.5
2,1,0,5,1,11,2,0,0,27,1,2,5,1,0,0,1037692,2023-11-06T00:00:00.000Z,17553994,26,Davion Mitchell,1,6,8,7,3,12.2
5,0,5,0,0,4,3,3,2,30,3,4,8,8,0,4,1037692,2023-11-06T00:00:00.000Z,406,26,Domantas Sabonis,0,16,21,13,13,21.1
1,0,0,4,0,6,1,2,1,22,0,0,3,0,0,0,1037692,2023-11-06T00:00:00.000Z,30,26,Harrison Barnes,0,3,4,4,1,4.5
0,0,0,0,0,5,4,2,2,10,3,4,10,3,0,2,1037692,2023-11-06T00:00:00.000Z,306,26,JaVale McGee,0,13,13,10,3,11.6
1,0,1,1,1,3,2,0,0,9,0,0,5,1,0,0,1037692,2023-11-06T00:00:00.000Z,17895990,26,Jordan Ford,0,6,7,6,2,7.7
1,0,5,6,2,11,5,0,0,28,0,3,12,5,1,2,1037692,2023-11-06T00:00:00.000Z,38017688,26,Keegan Murray,1,17,18,13,6,20.5
1,0,1,6,4,7,5,4,1,14,1,1,15,2,1,0,1037692,2023-11-06T00:00:00.000Z,38017714,26,Keon Ellis,1,17,18,16,3,21.9
2,0,1,2,1,4,1,2,1,12,0,1,4,1,1,0,1037692,2023-11-06T00:00:00.000Z,17896044,26,Kessler Edwards,1,5,7,6,3,11.2
2,0,3,8,3,10,5,1,0,25,0,0,13,3,1,3,1037692,2023-11-06T00:00:00.000Z,221,26,Kevin Huerter,1,16,18,15,5,19.6
2,0,1,3,1,6,2,0,0,15,0,3,5,1,1,1,1037692,2023-11-06T00:00:00.000Z,324,26,Malik Monk,1,6,8,7,3,11.2
4,0,3,4,1,5,1,0,0,36,2,4,3,5,1,2,1037693,2023-11-06T00:00:00.000Z,219,2,Al Horford,1,8,12,7,9,16
0,0,0,0,0,0,0,0,0,0,0,0,0,0,0,0,1037693,2023-11-06T00:00:00.000Z,473,2,Derrick White,0,0,0,0,0,0
4,0,7,8,3,21,10,4,3,39,0,5,26,7,1,3,1037693,2023-11-06T00:00:00.000Z,70,2,Jaylen Brown,1,33,37,30,11,40.4
2,0,5,8,2,22,12,8,6,43,0,2,32,5,5,6,1037693,2023-11-06T00:00:00.000Z,434,2,Jayson Tatum,5,37,39,34,7,50
0,0,0,0,0,0,0,0,0,0,0,0,0,0,0,0,1037693,2023-11-06T00:00:00.000Z,38017707,2,JD Davison,0,0,0,0,0,0
0,0,0,0,0,0,0,0,0,0,0,0,0,0,0,0,1037693,2023-11-06T00:00:00.000Z,56677864,2,Jordan Walsh,0,0,0,0,0,0
6,0,8,4,0,16,4,6,4,42,3,3,12,11,1,3,1037693,2023-11-06T00:00:00.000Z,214,2,Jrue Holiday,1,23,29,18,17,34.2
1,1,4,6,2,14,5,10,8,36,1,5,20,5,1,1,1037693,2023-11-06T00:00:00.000Z,378,2,Kristaps Porzingis,2,25,26,21,6,32.5
0,0,1,0,0,1,0,0,0,4,0,0,0,1,1,0,1037693,2023-11-06T00:00:00.000Z,3547279,2,Lamar Stevens,1,1,1,0,1,4.2
0,0,0,0,0,0,0,0,0,0,0,0,0,0,0,0,1037693,2023-11-06T00:00:00.000Z,3547295,2,Nathan Knight,0,0,0,0,0,0
0,0,0,0,0,0,0,0,0,0,0,0,0,0,0,0,1037693,2023-11-06T00:00:00.000Z,17553967,2,Neemias Queta,0,0,0,0,0,0
3,0,3,1,0,3,0,0,0,20,3,2,0,6,0,0,1037693,2023-11-06T00:00:00.000Z,3547276,2,Payton Pritchard,0,6,9,3,9,11.7
0,1,3,8,3,8,3,2,2,25,1,3,11,4,1,1,1037693,2023-11-06T00:00:00.000Z,17896060,2,Sam Hauser,2,15,15,11,4,20.8
7,0,9,8,2,25,15,7,6,38,0,5,38,9,1,3,1037693,2023-11-06T00:00:00.000Z,3547238,18,Anthony Edwards,1,47,54,45,16,59.3
1,0,1,9,4,18,8,0,0,45,1,3,20,2,1,3,1037693,2023-11-06T00:00:00.000Z,3547259,18,Jaden McDaniels,1,22,23,21,3,23.9
0,0,0,0,0,0,0,0,0,0,0,0,0,0,0,0,1037693,2023-11-06T00:00:00.000Z,56677851,18,Jaylen Clark,0,0,0,0,0,0
3,0,10,7,1,10,3,0,0,28,0,6,7,10,0,7,1037693,2023-11-06T00:00:00.000Z,447,18,Karl-Anthony Towns,0,17,20,10,13,16.5
0,0,0,0,0,0,0,0,0,0,0,0,0,0,0,0,1037693,2023-11-06T00:00:00.000Z,56677782,18,Leonard Miller,0,0,0,0,0,0
0,0,0,0,0,0,0,0,0,0,0,0,0,0,0,0,1037693,2023-11-06T00:00:00.000Z,17896056,18,Luka Garza,0,0,0,0,0,0
3,0,2,3,2,5,3,0,0,36,0,1,8,2,2,0,1037693,2023-11-06T00:00:00.000Z,104,18,Mike Conley,2,10,13,11,5,20.9
3,0,1,4,2,6,3,1,0,20,0,3,8,1,1,1,1037693,2023-11-06T00:00:00.000Z,666400,18,Nickeil Alexander-Walker,1,9,12,11,4,15.7
1,1,10,0,0,6,6,11,2,41,2,4,14,12,0,2,1037693,2023-11-06T00:00:00.000Z,176,18,Rudy Gobert,1,26,27,15,13,30.9
0,0,0,0,0,0,0,0,0,0,0,0,0,0,0,0,1037693,2023-11-06T00:00:00.000Z,38017700,18,Wendell Moore Jr.,0,0,0,0,0,0
0,0,0,0,0,0,0,0,0,0,0,0,0,0,0,0,1037694,2023-11-06T00:00:00.000Z,38017689,1,AJ Griffin,0,0,0,0,0,0
3,0,2,8,3,14,7,0,0,27,0,1,17,2,2,0,1037694,2023-11-06T00:00:00.000Z,53,1,Bogdan Bogdanovic,2,19,22,20,5,29.9
0,0,0,0,0,0,0,0,0,0,0,0,0,0,0,0,1037694,2023-11-06T00:00:00.000Z,666564,1,Bruno Fernando,0,0,0,0,0,0
0,2,6,0,0,5,2,4,2,22,6,2,6,12,1,1,1037694,2023-11-06T00:00:00.000Z,83,1,Clint Capela,3,18,18,6,12,28.4
0,0,2,7,1,13,2,4,3,33,0,2,8,2,0,0,1037694,2023-11-06T00:00:00.000Z,666656,1,De'Andre Hunter,0,10,10,8,2,10.4
6,0,2,9,6,16,7,10,9,33,2,4,29,4,1,3,1037694,2023-11-06T00:00:00.000Z,334,1,Dejounte Murray,1,33,39,35,10,42.8
0,0,1,2,0,2,0,0,0,4,0,0,0,1,0,0,1037694,2023-11-06T00:00:00.000Z,666754,1,Garrison Mathews,0,1,1,0,1,1.2
5,1,6,4,0,15,6,2,1,34,6,2,13,12,3,0,1037694,2023-11-06T00:00:00.000Z,17896040,1,Jalen Johnson,4,25,30,18,17,46.9
0,0,0,0,0,0,0,0,0,0,0,0,0,0,0,0,1037694,2023-11-06T00:00:00.000Z,56677838,1,Kobe Bufkin,0,0,0,0,0,0
0,0,0,0,0,0,0,0,0,0,0,0,0,0,0,0,1037694,2023-11-06T00:00:00.000Z,56677875,1,Miles Norris,0,0,0,0,0,0
0,0,0,0,0,0,0,0,0,0,0,0,0,0,0,0,1037694,2023-11-06T00:00:00.000Z,56677806,1,Mouhamed Gueye,0,0,0,0,0,0
0,0,8,1,0,8,3,1,1,25,6,3,7,14,0,2,1037694,2023-11-06T00:00:00.000Z,3547244,1,Onyeka Okongwu,0,21,21,7,14,21.8
0,0,0,0,0,0,0,0,0,0,0,0,0,0,0,0,1037694,2023-11-06T00:00:00.000Z,319,1,Patty Mills,0,0,0,0,0,0
2,0,4,6,3,11,6,0,0,26,4,1,15,8,0,2,1037694,2023-11-06T00:00:00.000Z,3547256,1,Saddiq Bey,0,23,25,17,10,25.6
0,0,0,0,0,0,0,0,0,0,0,0,0,0,0,0,1037694,2023-11-06T00:00:00.000Z,56677855,1,Seth Lundy,0,0,0,0,0,0
11,0,3,5,1,18,5,11,11,36,1,1,22,4,1,7,1037694,2023-11-06T00:00:00.000Z,490,1,Trae Young,1,26,37,33,15,39.3
0,0,0,0,0,0,0,0,0,0,0,0,0,0,0,0,1037694,2023-11-06T00:00:00.000Z,3547297,1,Trent Forrest,0,0,0,0,0,0
0,0,0,0,0,0,0,0,0,0,0,0,0,0,0,0,1037694,2023-11-06T00:00:00.000Z,301,1,Wesley Matthews,0,0,0,0,0,0
0,0,0,1,1,2,2,0,0,7,1,0,5,1,0,0,1037694,2023-11-06T00:00:00.000Z,17896078,21,Aaron Wiggins,0,6,6,5,1,6.2
0,0,0,0,0,0,0,0,0,0,0,0,0,0,0,0,1037694,2023-11-06T00:00:00.000Z,3547271,21,Aleksej Pokusevski,0,0,0,0,0,0
4,0,2,3,0,6,3,0,0,24,0,1,6,2,4,1,1037694,2023-11-06T00:00:00.000Z,56677833,21,Cason Wallace,4,8,12,10,6,25.4
3,3,9,3,1,14,4,7,7,34,3,3,16,12,1,1,1037694,2023-11-06T00:00:00.000Z,38017685,21,Chet Holmgren,4,28,31,19,15,45.9
3,0,3,8,4,8,4,0,0,20,0,1,12,3,0,0,1037694,2023-11-06T00:00:00.000Z,3547272,21,Isaiah Joe,0,15,18,15,6,20.1
2,1,3,5,2,13,8,3,3,36,0,5,21,3,0,2,1037694,2023-11-06T00:00:00.000Z,38017703,21,Jalen Williams,1,24,26,23,5,28.6
2,1,2,2,0,5,2,2,2,13,0,3,6,2,1,0,1037694,2023-11-06T00:00:00.000Z,38017706,21,Jaylin Williams,2,8,10,8,4,17.4
4,0,4,0,0,13,4,0,0,27,3,3,8,7,0,4,1037694,2023-11-06T00:00:00.000Z,17896065,21,Josh Giddey,0,15,19,12,11,18.4
0,0,0,0,0,0,0,0,0,0,0,0,0,0,0,0,1037694,2023-11-06T00:00:00.000Z,480,21,Kenrich Williams,0,0,0,0,0,0
0,0,0,0,0,0,0,0,0,0,0,0,0,0,0,0,1037694,2023-11-06T00:00:00.000Z,56677853,21,Keyontae Johnson,0,0,0,0,0,0
0,0,0,0,0,0,0,0,0,0,0,0,0,0,0,0,1037694,2023-11-06T00:00:00.000Z,27924547,21,Lindy Waters III,0,0,0,0,0,0
3,2,7,5,2,10,6,5,5,32,2,1,19,9,0,2,1037694,2023-11-06T00:00:00.000Z,666541,21,Luguentz Dort,2,28,31,22,12,38.3
0,0,0,0,0,0,0,0,0,0,0,0,0,0,0,0,1037694,2023-11-06T00:00:00.000Z,24572055,21,Olivier Sarr,0,0,0,0,0,0
0,0,1,2,1,4,1,0,0,10,1,0,3,2,0,1,1037694,2023-11-06T00:00:00.000Z,38017716,21,Ousmane Dieng,0,5,5,3,2,4.4
6,0,7,7,3,20,11,6,5,37,1,5,30,8,1,2,1037694,2023-11-06T00:00:00.000Z,175,21,Shai Gilgeous-Alexander,1,38,44,36,14,49.6
0,0,0,0,0,0,0,0,0,0,0,0,0,0,0,0,1037694,2023-11-06T00:00:00.000Z,4197029,21,Vasilije Micic,0,0,0,0,0,0
0,0,0,0,0,0,0,0,0,1,0,0,0,0,0,0,1037695,2023-11-06T00:00:00.000Z,17896007,8,Braxton Key,0,0,0,0,0,0
1,0,0,1,0,5,1,6,4,18,0,1,6,0,0,0,1037695,2023-11-06T00:00:00.000Z,38017709,8,Christian Braun,0,6,7,7,1,7.5
1,0,1,3,1,4,2,1,1,17,0,3,6,1,2,0,1037695,2023-11-06T00:00:00.000Z,38017727,8,Collin Gillespie,2,7,8,7,2,14.7
0,0,0,0,0,0,0,0,0,0,0,0,0,0,0,0,1037695,2023-11-06T00:00:00.000Z,250,8,DeAndre Jordan,0,0,0,0,0,0
0,0,0,1,1,1,1,0,0,1,0,0,3,0,0,0,1037695,2023-11-06T00:00:00.000Z,56677582,8,Jalen Pickett,0,3,3,3,0,3
1,0,2,9,5,13,8,1,0,19,0,1,21,2,0,1,1037695,2023-11-06T00:00:00.000Z,56677776,8,Julian Strawther,0,23,24,22,3,23.9
0,0,0,0,0,0,0,0,0,0,0,0,0,0,0,0,1037695,2023-11-06T00:00:00.000Z,215,8,Justin Holiday,0,0,0,0,0,0
7,0,1,7,3,10,5,2,2,33,0,4,15,1,1,2,1037695,2023-11-06T00:00:00.000Z,81,8,Kentavious Caldwell-Pope,1,16,23,22,8,27.7
1,1,1,0,0,0,0,0,0,6,1,2,0,2,0,1,1037695,2023-11-06T00:00:00.000Z,3547268,8,Zeke Nnaji,1,2,3,1,3,5.9
0,0,0,0,0,0,0,0,0,0,0,0,0,0,0,0,1037695,2023-11-06T00:00:00.000Z,303,19,CJ McCollum,0,0,0,0,0,0
0,0,1,0,0,0,0,0,0,4,0,0,0,1,0,0,1037695,2023-11-06T00:00:00.000Z,491,19,Cody Zeller,0,1,1,0,1,1.2
0,0,0,0,0,0,0,0,0,0,0,0,0,0,0,0,1037695,2023-11-06T00:00:00.000Z,38017726,19,Dereon Seabron,0,0,0,0,0,0
1,1,2,1,1,5,4,0,0,21,0,0,9,2,1,3,1037695,2023-11-06T00:00:00.000Z,38017677,19,Dyson Daniels,2,11,12,10,3,15.9
0,0,0,0,0,0,0,0,0,0,0,0,0,0,0,0,1037695,2023-11-06T00:00:00.000Z,38017663,19,E.J. Liddell,0,0,0,0,0,0
2,0,2,2,0,3,1,2,2,31,0,2,4,2,2,1,1037695,2023-11-06T00:00:00.000Z,17896024,19,Herbert Jones,2,6,8,6,4,14.4
3,0,6,14,7,19,10,5,4,38,1,2,31,7,1,1,1037695,2023-11-06T00:00:00.000Z,56677837,19,Jordan Hawkins,1,38,41,34,10,45.9
0,0,0,0,0,0,0,0,0,0,0,0,0,0,0,0,1037695,2023-11-06T00:00:00.000Z,17896097,19,Jose Alvarado,0,0,0,0,0,0
0,0,0,1,0,2,1,0,0,9,0,1,2,0,0,0,1037695,2023-11-06T00:00:00.000Z,3547260,19,Kira Lewis Jr.,0,2,2,2,0,2
1,0,2,1,1,3,2,0,0,15,1,1,5,3,0,1,1037695,2023-11-06T00:00:00.000Z,340,19,Larry Nance Jr.,0,8,9,6,4,9.1
1,0,0,6,4,8,5,3,3,25,0,3,17,0,0,0,1037695,2023-11-06T00:00:00.000Z,17896017,19,Matt Ryan,0,17,18,18,1,18.5
0,0,0,0,0,0,0,0,0,0,0,0,0,0,0,0,1037695,2023-11-06T00:00:00.000Z,3547293,19,Naji Marshall,0,0,0,0,0,0
0,0,0,0,0,0,0,0,0,0,0,0,0,0,0,0,1037696,2023-11-08T00:00:00.000Z,56677848,4,Amari Bailey,0,0,0,0,0,0
2,0,3,2,1,11,5,3,2,30,2,2,13,5,1,2,1037696,2023-11-08T00:00:00.000Z,56677823,4,Brandon Miller,1,18,20,15,7,23
1,0,3,0,0,0,0,2,2,15,0,2,2,3,0,2,1037696,2023-11-08T00:00:00.000Z,38017708,4,Bryce McGowens,0,5,6,3,4,5.1
0,0,0,0,0,0,0,0,0,0,0,0,0,0,0,0,1037696,2023-11-08T00:00:00.000Z,666748,4,Cody Martin,0,0,0,0,0,0
0,0,0,0,0,0,0,0,0,0,0,0,0,0,0,0,1037696,2023-11-08T00:00:00.000Z,347,4,Frank Ntilikina,0,0,0,0,0,0
4,0,6,4,2,14,6,6,4,32,1,2,18,7,3,3,1037696,2023-11-08T00:00:00.000Z,204,4,Gordon Hayward,3,25,29,22,11,38.4
0,0,1,0,0,0,0,0,0,10,0,0,0,1,1,2,1037696,2023-11-08T00:00:00.000Z,422,4,Ish Smith,1,1,1,0,1,2.2
0,0,0,0,0,0,0,0,0,0,0,0,0,0,0,0,1037696,2023-11-08T00:00:00.000Z,17896037,4,James Bouknight,0,0,0,0,0,0
1,1,3,2,0,3,0,0,0,21,2,3,0,5,0,0,1037696,2023-11-08T00:00:00.000Z,18678001,4,JT Thor,1,5,6,1,6,10.5
7,0,1,9,3,22,13,7,5,36,3,3,34,4,1,6,1037696,2023-11-08T00:00:00.000Z,3547239,4,LaMelo Ball,1,38,45,41,11,46.3
0,1,0,0,0,1,0,0,0,4,0,0,0,0,0,0,1037696,2023-11-08T00:00:00.000Z,56677866,4,Leaky Black,1,0,0,0,0,3
0,1,5,0,0,5,5,6,4,18,2,4,14,7,0,1,1037696,2023-11-08T00:00:00.000Z,38017698,4,Mark Williams,1,21,21,14,7,24.4
0,0,0,0,0,0,0,0,0,0,0,0,0,0,0,0,1037696,2023-11-08T00:00:00.000Z,62,4,Miles Bridges,0,0,0,0,0,0
1,0,6,0,0,3,2,4,3,16,0,2,7,6,0,0,1037696,2023-11-08T00:00:00.000Z,3547282,4,Nick Richards,0,13,14,8,7,15.7
0,0,1,1,1,2,2,0,0,4,0,0,5,1,1,1,1037696,2023-11-08T00:00:00.000Z,56677846,4,Nick Smith Jr.,1,6,6,5,1,8.2
1,2,6,5,0,11,4,7,6,36,1,2,14,7,0,2,1037696,2023-11-08T00:00:00.000Z,666950,4,P.J. Washington,2,21,22,15,8,27.9
0,0,0,0,0,0,0,0,0,0,0,0,0,0,0,0,1037696,2023-11-08T00:00:00.000Z,403,4,Terry Rozier,0,0,0,0,0,0
0,0,1,2,1,7,4,0,0,18,0,2,9,1,1,1,1037696,2023-11-08T00:00:00.000Z,3547253,4,Theo Maledon,1,10,10,9,1,12.2
0,0,0,0,0,3,0,0,0,4,1,0,0,1,0,0,1037696,2023-11-08T00:00:00.000Z,3547302,30,Anthony Gill,0,1,1,0,1,1.2
1,0,2,3,2,3,2,0,0,30,0,5,6,2,0,0,1037696,2023-11-08T00:00:00.000Z,56677844,30,Bilal Coulibaly,0,8,9,7,3,9.9
2,1,4,7,4,11,7,2,0,20,0,3,18,4,0,1,1037696,2023-11-08T00:00:00.000Z,167,30,Danilo Gallinari,1,22,24,20,6,27.8
3,0,1,3,2,5,4,8,8,26,2,1,18,3,4,1,1037696,2023-11-08T00:00:00.000Z,487,30,Delon Wright,4,21,24,21,6,37.1
0,0,0,0,0,0,0,0,0,0,0,0,0,0,0,0,1037696,2023-11-08T00:00:00.000Z,18677954,30,Jared Butler,0,0,0,0,0,0
0,1,0,0,0,0,0,0,0,3,0,0,0,0,0,0,1037696,2023-11-08T00:00:00.000Z,38017687,30,Johnny Davis,1,0,0,0,0,3
4,0,6,11,4,24,13,3,3,31,3,1,33,9,0,2,1037696,2023-11-08T00:00:00.000Z,265,30,Kyle Kuzma,0,42,46,37,13,47.8
2,1,1,6,3,9,6,1,0,17,0,3,15,1,1,0,1037696,2023-11-08T00:00:00.000Z,414,30,Landry Shamet,2,16,18,17,3,25.2
0,0,0,0,0,0,0,0,0,0,0,0,0,0,0,0,1037696,2023-11-08T00:00:00.000Z,38017704,30,Patrick Baldwin Jr.,0,0,0,0,0,0
0,0,1,6,4,13,9,2,2,30,1,4,24,2,2,1,1037697,2023-11-08T00:00:00.000Z,3547250,12,Aaron Nesmith,2,26,26,24,2,31.4
4,0,4,7,4,18,9,0,0,39,5,1,22,9,2,3,1037697,2023-11-08T00:00:00.000Z,38017686,12,Bennedict Mathurin,2,31,35,26,13,41.8
0,1,4,4,1,11,4,0,0,32,0,2,9,4,2,2,1037697,2023-11-08T00:00:00.000Z,69,12,Bruce Brown,3,13,13,9,4,20.8
1,1,3,12,2,16,4,0,0,22,0,2,10,3,1,1,1037697,2023-11-08T00:00:00.000Z,210,12,Buddy Hield,2,13,14,11,4,20.1
0,0,0,0,0,0,0,0,0,0,0,0,0,0,0,0,1037697,2023-11-08T00:00:00.000Z,439,12,Daniel Theis,0,0,0,0,0,0
1,1,8,0,0,8,5,7,6,25,3,0,16,11,2,1,1037697,2023-11-08T00:00:00.000Z,3547264,12,Jalen Smith,3,27,28,17,12,38.7
0,0,0,0,0,0,0,0,0,0,0,0,0,0,0,0,1037697,2023-11-08T00:00:00.000Z,56677832,12,Jarace Walker,0,0,0,0,0,0
0,0,0,0,0,0,0,0,0,0,0,0,0,0,0,0,1037697,2023-11-08T00:00:00.000Z,38017701,12,Kendall Brown,0,0,0,0,0,0
0,3,3,2,0,12,8,8,6,23,3,2,22,6,0,0,1037697,2023-11-08T00:00:00.000Z,452,12,Myles Turner,3,28,28,22,6,38.2
0,1,1,3,0,7,3,0,0,19,0,2,6,1,3,1,1037697,2023-11-08T00:00:00.000Z,3547243,12,Obi Toppin,4,7,7,6,1,18.2
13,0,5,6,1,12,6,3,3,31,1,0,16,6,1,2,1037697,2023-11-08T00:00:00.000Z,3547245,12,Tyrese Haliburton,1,22,35,29,19,43.7
0,0,0,0,0,0,0,0,0,0,0,0,0,0,0,0,1037697,2023-11-08T00:00:00.000Z,56677842,29,Brice Sensabaugh,0,0,0,0,0,0
2,0,2,2,1,9,3,3,3,16,0,0,10,2,0,0,1037697,2023-11-08T00:00:00.000Z,413,29,Collin Sexton,0,12,14,12,4,15.4
0,0,4,2,0,4,2,0,0,21,1,5,4,5,1,2,1037697,2023-11-08T00:00:00.000Z,358,29,Kelly Olynyk,1,9,9,4,5,11
5,1,2,1,0,8,3,0,0,20,2,1,6,4,0,4,1037697,2023-11-08T00:00:00.000Z,666650,29,Talen Horton-Tucker,1,10,15,11,9,17.3
3,2,5,6,1,6,1,0,0,26,0,1,3,5,0,1,1037698,2023-11-08T00:00:00.000Z,219,2,Al Horford,2,8,11,6,8,18.5
0,0,0,0,0,0,0,0,0,0,0,0,0,0,0,0,1037698,2023-11-08T00:00:00.000Z,17896094,2,Dalano Banton,0,0,0,0,0,0
2,1,2,7,2,13,4,2,1,35,0,2,11,2,1,4,1037698,2023-11-08T00:00:00.000Z,70,2,Jaylen Brown,2,13,15,13,4,18.4
0,0,0,0,0,0,0,0,0,0,0,0,0,0,0,0,1037698,2023-11-08T00:00:00.000Z,38017707,2,JD Davison,0,0,0,0,0,0
0,0,0,0,0,0,0,0,0,0,0,0,0,0,0,0,1037698,2023-11-08T00:00:00.000Z,56677864,2,Jordan Walsh,0,0,0,0,0,0
0,0,0,0,0,0,0,0,0,0,0,0,0,0,0,0,1037698,2023-11-08T00:00:00.000Z,3547279,2,Lamar Stevens,0,0,0,0,0,0
0,0,0,0,0,0,0,0,0,3,0,0,0,0,0,0,1037698,2023-11-08T00:00:00.000Z,261,2,Luke Kornet,0,0,0,0,0,0
0,0,0,0,0,0,0,0,0,0,0,0,0,0,0,0,1037698,2023-11-08T00:00:00.000Z,3547295,2,Nathan Knight,0,0,0,0,0,0
0,0,0,0,0,0,0,0,0,0,0,0,0,0,0,0,1037698,2023-11-08T00:00:00.000Z,17553967,2,Neemias Queta,0,0,0,0,0,0
0,0,0,0,0,0,0,0,0,0,0,0,0,0,0,0,1037698,2023-11-08T00:00:00.000Z,666468,2,Oshae Brissett,0,0,0,0,0,0
4,0,0,2,0,4,0,0,0,16,2,0,0,2,0,1,1037698,2023-11-08T00:00:00.000Z,3547276,2,Payton Pritchard,0,2,6,4,6,7.4
0,1,4,6,3,8,5,0,0,19,0,0,13,4,1,0,1037698,2023-11-08T00:00:00.000Z,17896060,2,Sam Hauser,2,17,17,13,4,23.8
0,0,0,0,0,0,0,0,0,0,0,0,0,0,0,0,1037698,2023-11-08T00:00:00.000Z,338,2,Svi Mykhailiuk,0,0,0,0,0,0
2,0,4,7,1,9,1,0,0,29,0,2,3,4,1,1,1037698,2023-11-08T00:00:00.000Z,313,23,De'Anthony Melton,1,7,9,5,6,12.8
4,4,9,4,1,20,10,6,6,37,1,3,27,10,1,6,1037698,2023-11-08T00:00:00.000Z,145,23,Joel Embiid,5,37,41,31,14,54
1,0,7,3,1,11,6,2,1,27,1,0,14,8,1,0,1037698,2023-11-08T00:00:00.000Z,360,23,Kelly Oubre Jr.,1,22,23,15,9,28.1
0,0,0,0,0,0,0,0,0,0,0,0,0,0,0,0,1037698,2023-11-08T00:00:00.000Z,328,23,Marcus Morris,0,0,0,0,0,0
0,0,0,0,0,0,0,0,0,0,0,0,0,0,0,0,1037698,2023-11-08T00:00:00.000Z,28,23,Mo Bamba,0,0,0,0,0,0
1,1,2,2,1,3,2,0,0,26,2,2,5,4,0,0,1037698,2023-11-08T00:00:00.000Z,33,23,Nicolas Batum,1,9,10,6,5,14.3
4,0,5,1,0,2,1,0,0,15,0,2,2,5,0,0,1037698,2023-11-08T00:00:00.000Z,45,23,Patrick Beverley,0,7,11,6,9,14
0,0,1,2,1,4,2,0,0,15,2,2,5,3,2,0,1037698,2023-11-08T00:00:00.000Z,108,23,Robert Covington,2,8,8,5,3,14.6
3,0,7,4,1,12,5,6,6,38,2,1,17,9,0,2,1037698,2023-11-08T00:00:00.000Z,200,23,Tobias Harris,0,26,29,20,12,30.3
5,2,8,11,3,27,11,1,0,39,1,4,25,9,1,1,1037698,2023-11-08T00:00:00.000Z,3547254,23,Tyrese Maxey,3,34,39,30,14,51.3
0,0,0,0,0,0,0,0,0,0,0,0,0,0,0,0,1037699,2023-11-08T00:00:00.000Z,9051997,3,Armoni Brooks,0,0,0,0,0,0
0,0,0,0,0,0,0,0,0,0,0,0,0,0,0,0,1037699,2023-11-08T00:00:00.000Z,417,3,Ben Simmons,0,0,0,0,0,0
0,0,0,0,0,0,0,0,0,0,0,0,0,0,0,0,1037699,2023-11-08T00:00:00.000Z,666679,3,Cameron Johnson,0,0,0,0,0,0
0,0,0,0,0,0,0,0,0,0,0,0,0,0,0,0,1037699,2023-11-08T00:00:00.000Z,174,3,Harry Giles III,0,0,0,0,0,0
0,0,0,0,0,0,0,0,0,0,0,0,0,0,0,0,1037699,2023-11-08T00:00:00.000Z,56677722,3,Jalen Wilson,0,0,0,0,0,0
0,0,0,0,0,0,0,0,0,0,0,0,0,0,0,0,1037699,2023-11-08T00:00:00.000Z,17896041,3,Keon Johnson,0,0,0,0,0,0
0,1,1,7,3,16,8,2,2,28,0,0,21,1,1,0,1037699,2023-11-08T00:00:00.000Z,464,3,Lonnie Walker IV,2,22,22,21,1,28.2
2,0,3,2,1,6,3,2,2,19,2,2,9,5,3,4,1037699,2023-11-08T00:00:00.000Z,17896058,3,Trendon Watford,3,14,16,11,7,23
0,0,0,0,0,0,0,0,0,0,0,0,0,0,0,0,1037699,2023-11-08T00:00:00.000Z,17896022,13,Brandon Boston Jr.,0,0,0,0,0,0
0,0,0,0,0,0,0,0,0,0,0,0,0,0,0,0,1037699,2023-11-08T00:00:00.000Z,56677856,13,Jordan Miller,0,0,0,0,0,0
0,0,0,0,0,0,0,0,0,0,0,0,0,0,0,0,1037699,2023-11-08T00:00:00.000Z,17896051,13,Joshua Primo,0,0,0,0,0,0
0,0,0,0,0,0,0,0,0,0,0,0,0,0,0,0,1037699,2023-11-08T00:00:00.000Z,371,13,Mason Plumlee,0,0,0,0,0,0
0,0,1,2,0,6,2,0,0,6,1,0,4,2,0,1,1037699,2023-11-08T00:00:00.000Z,17896031,13,Nah'Shon Hyland,0,6,6,4,2,5.4
1,2,1,5,2,8,4,0,0,23,0,2,10,1,3,1,1037699,2023-11-08T00:00:00.000Z,380,13,Norman Powell,5,11,12,11,2,26.7
3,1,3,1,0,3,1,1,1,21,3,3,3,6,1,0,1037699,2023-11-08T00:00:00.000Z,450,13,PJ Tucker,2,9,12,6,9,20.7
1,0,4,2,0,2,0,0,0,19,0,1,0,4,0,2,1037699,2023-11-08T00:00:00.000Z,666743,13,Terance Mann,0,4,5,1,5,4.3
0,0,0,0,0,0,0,0,0,0,0,0,0,0,0,0,1037700,2023-11-08T00:00:00.000Z,666474,20,Charles Brown,0,0,0,0,0,0
0,0,1,1,0,1,0,0,0,2,0,0,0,1,0,1,1037700,2023-11-08T00:00:00.000Z,666675,20,DaQuan Jeffries,0,1,1,0,1,0.2
2,0,3,3,1,6,1,0,0,20,1,1,3,4,1,0,1037700,2023-11-08T00:00:00.000Z,131,20,Donte DiVincenzo,1,7,9,5,6,13.8
0,0,0,0,0,0,0,0,0,0,0,0,0,0,0,0,1037700,2023-11-08T00:00:00.000Z,17896089,20,Duane Washington Jr.,0,0,0,0,0,0
0,0,0,0,0,0,0,0,0,1,0,0,0,0,0,0,1037700,2023-11-08T00:00:00.000Z,666971,20,Dylan Windler,0,0,0,0,0,0
0,0,0,0,0,0,0,0,0,0,0,0,0,0,0,0,1037700,2023-11-08T00:00:00.000Z,160,20,Evan Fournier,0,0,0,0,0,0
5,0,0,9,3,17,8,0,0,28,0,1,19,0,1,0,1037700,2023-11-08T00:00:00.000Z,3547269,20,Immanuel Quickley,1,19,24,24,5,29.5
0,0,0,0,0,9,6,1,1,15,3,4,13,3,2,0,1037700,2023-11-08T00:00:00.000Z,201,20,Isaiah Hartenstein,2,16,16,13,3,22.6
0,0,0,0,0,0,0,0,0,0,0,0,0,0,0,0,1037700,2023-11-08T00:00:00.000Z,56677795,20,Jacob Toppin,0,0,0,0,0,0
6,0,2,8,5,19,8,4,4,33,0,2,25,2,0,0,1037700,2023-11-08T00:00:00.000Z,73,20,Jalen Brunson,0,27,33,31,8,36.4
0,0,1,0,0,0,0,0,0,1,0,0,0,1,0,0,1037700,2023-11-08T00:00:00.000Z,17896063,20,Jericho Sims,0,1,1,0,1,1.2
0,0,5,2,1,3,1,0,0,24,0,0,3,5,1,0,1037700,2023-11-08T00:00:00.000Z,202,20,Josh Hart,1,8,8,3,5,12
5,0,12,6,2,19,8,8,5,31,4,1,23,16,1,2,1037700,2023-11-08T00:00:00.000Z,387,20,Julius Randle,1,39,44,28,21,50.7
0,0,0,0,0,0,0,0,0,2,0,0,0,0,0,0,1037700,2023-11-08T00:00:00.000Z,17896033,20,Miles McBride,0,0,0,0,0,0
1,0,7,0,0,4,3,6,2,31,5,3,8,12,0,0,1037700,2023-11-08T00:00:00.000Z,399,20,Mitchell Robinson,0,20,21,9,13,23.9
3,0,1,4,2,5,3,0,0,19,0,0,8,1,0,0,1037700,2023-11-08T00:00:00.000Z,17895858,20,Quentin Grimes,0,9,12,11,4,13.7
6,0,2,9,5,17,8,3,3,32,0,2,24,2,1,0,1037700,2023-11-08T00:00:00.000Z,666423,20,RJ Barrett,1,26,32,30,8,38.4
0,0,0,0,0,0,0,0,0,1,0,0,0,0,0,0,1037700,2023-11-08T00:00:00.000Z,19,20,Ryan Arcidiacono,0,0,0,0,0,0
1,0,1,0,0,3,2,0,0,3,1,0,4,2,0,0,1037700,2023-11-08T00:00:00.000Z,38017693,27,Blake Wesley,0,6,7,5,3,7.9
1,2,3,0,0,3,3,0,0,15,1,1,6,4,1,0,1037700,2023-11-08T00:00:00.000Z,17895854,27,Charles Bassey,3,10,11,7,5,21.3
0,0,0,0,0,0,0,0,0,0,0,0,0,0,0,0,1037700,2023-11-08T00:00:00.000Z,180,27,Devonte' Graham,0,0,0,0,0,0
0,0,1,0,0,1,1,2,0,3,0,0,2,1,0,0,1037700,2023-11-08T00:00:00.000Z,38017730,27,Dominick Barlow,0,3,3,2,1,3.2
1,0,2,8,3,9,4,0,0,22,1,3,11,3,0,3,1037700,2023-11-08T00:00:00.000Z,305,27,Doug McDermott,0,14,15,12,4,13.1
5,0,6,4,2,12,7,0,0,29,0,5,16,6,0,0,1037700,2023-11-08T00:00:00.000Z,38017699,27,Jeremy Sochan,0,22,27,21,11,30.7
0,0,0,2,0,2,0,0,0,3,0,0,0,0,0,0,1037700,2023-11-08T00:00:00.000Z,38017649,27,Julian Champagnie,0,0,0,0,0,0
8,0,7,4,1,9,4,2,0,33,0,4,9,7,0,3,1037700,2023-11-08T00:00:00.000Z,666682,27,Keldon Johnson,0,16,24,17,15,26.4
1,0,0,2,2,9,6,0,0,24,0,2,14,0,0,1,1037700,2023-11-08T00:00:00.000Z,38017692,27,Malaki Branham,0,14,15,15,1,14.5
0,0,0,1,0,1,0,0,0,3,1,1,0,1,0,0,1037700,2023-11-08T00:00:00.000Z,17896059,27,Sandro Mamukelashvili,0,1,1,0,1,1.2
0,0,0,0,0,0,0,0,0,0,0,0,0,0,0,0,1037700,2023-11-08T00:00:00.000Z,56677817,27,Sidy Cissoko,0,0,0,0,0,0
2,1,5,4,0,14,4,6,6,30,4,2,14,9,0,3,1037700,2023-11-08T00:00:00.000Z,56677822,27,Victor Wembanyama,1,23,25,16,11,27.8
3,3,5,2,1,6,4,2,2,25,2,4,11,7,0,2,1037700,2023-11-08T00:00:00.000Z,102,27,Zach Collins,3,18,21,14,10,30.9
1,0,2,0,0,1,1,0,0,12,1,2,2,3,1,2,1037701,2023-11-08T00:00:00.000Z,137,5,Andre Drummond,1,5,6,3,4,8.1
0,0,0,0,0,0,0,0,0,0,0,0,0,0,0,0,1037701,2023-11-08T00:00:00.000Z,38017719,5,Dalen Terry,0,0,0,0,0,0
0,0,0,0,0,0,0,0,0,0,0,0,0,0,0,0,1037701,2023-11-08T00:00:00.000Z,27,5,Lonzo Ball,0,0,0,0,0,0
1,0,3,2,1,7,1,0,0,21,1,0,3,4,1,1,1037701,2023-11-08T00:00:00.000Z,3547248,5,Patrick Williams,1,7,8,4,5,11.3
0,0,0,0,0,0,0,0,0,0,0,0,0,0,0,0,1037701,2023-11-08T00:00:00.000Z,17896116,5,Terry Taylor,0,0,0,0,0,0
0,0,0,0,0,0,0,0,0,1,0,0,0,0,0,0,1037701,2023-11-08T00:00:00.000Z,666451,24,Bol Bol,0,0,0,0,0,0
4,2,4,6,3,12,3,4,4,24,0,0,13,4,0,2,1037701,2023-11-08T00:00:00.000Z,37,24,Bradley Beal,2,17,21,17,8,27.8
0,0,0,0,0,0,0,0,0,0,0,0,0,0,0,0,1037701,2023-11-08T00:00:00.000Z,314,24,Chimezie Metu,0,0,0,0,0,0
4,1,9,13,8,16,9,0,0,37,0,3,26,9,1,1,1037701,2023-11-08T00:00:00.000Z,8,24,Grayson Allen,2,35,39,30,13,47.8
0,0,1,3,2,5,2,0,0,17,1,1,6,2,0,0,1037701,2023-11-08T00:00:00.000Z,18678058,24,Jordan Goodwin,0,8,8,6,2,8.4
0,0,0,0,0,0,0,0,0,0,0,0,0,0,0,0,1037701,2023-11-08T00:00:00.000Z,666729,24,Nassir Little,0,0,0,0,0,0
0,0,0,0,0,0,0,0,0,0,0,0,0,0,0,0,1037701,2023-11-08T00:00:00.000Z,3547298,24,Saben Lee,0,0,0,0,0,0
0,0,0,0,0,0,0,0,0,0,0,0,0,0,0,0,1037701,2023-11-08T00:00:00.000Z,3547095,24,Udoka Azubuike,0,0,0,0,0,0
3,0,2,2,1,6,3,0,0,23,0,3,7,2,0,0,1037702,2023-11-08T00:00:00.000Z,213,11,Aaron Holiday,0,9,12,10,5,13.9
0,0,0,0,0,0,0,0,0,0,0,0,0,0,0,0,1037702,2023-11-08T00:00:00.000Z,56677825,11,Amen Thompson,0,0,0,0,0,0
0,0,5,0,0,4,3,1,0,6,2,1,6,7,0,0,1037702,2023-11-08T00:00:00.000Z,296,11,Boban Marjanovic,0,13,13,6,7,14.4
1,1,0,6,2,10,6,0,0,27,1,3,14,1,0,0,1037702,2023-11-08T00:00:00.000Z,3547301,11,Jae'Sean Tate,1,15,16,15,2,19.7
3,0,6,6,5,15,11,4,1,22,1,3,28,7,1,1,1037702,2023-11-08T00:00:00.000Z,17895966,11,Jalen Green,1,35,38,31,10,42.9
1,0,0,1,0,4,2,2,1,8,0,0,5,0,1,0,1037702,2023-11-08T00:00:00.000Z,47738533,11,Jeenathan Williams,1,5,6,6,1,9.5
0,0,3,0,0,5,4,2,1,11,3,3,9,6,0,1,1037702,2023-11-08T00:00:00.000Z,188,11,Jeff Green,0,15,15,9,6,15.2
0,0,0,0,0,0,0,0,0,0,0,0,0,0,0,0,1037702,2023-11-08T00:00:00.000Z,56677809,11,Jermaine Samuels Jr.,0,0,0,0,0,0
0,1,2,1,0,3,1,0,0,12,1,0,2,3,0,1,1037702,2023-11-08T00:00:00.000Z,19465326,11,Jock Landale,1,5,5,2,3,7.6
0,0,0,0,0,0,0,0,0,0,0,0,0,0,0,0,1037702,2023-11-08T00:00:00.000Z,3547281,11,Nate Hinton,0,0,0,0,0,0
0,0,0,0,0,0,0,0,0,0,0,0,0,0,0,0,1037702,2023-11-08T00:00:00.000Z,357,11,Victor Oladipo,0,0,0,0,0,0
0,0,0,0,0,0,0,0,0,0,0,0,0,0,0,0,1037702,2023-11-08T00:00:00.000Z,56677867,14,Alex Fudge,0,0,0,0,0,0
0,0,0,0,0,0,0,0,0,0,0,0,0,0,0,0,1037702,2023-11-08T00:00:00.000Z,117,14,Anthony Davis,0,0,0,0,0,0
4,0,1,4,0,9,2,3,3,26,0,1,7,1,2,2,1037702,2023-11-08T00:00:00.000Z,17553995,14,Austin Reaves,2,8,12,11,5,18.2
0,0,1,3,0,7,2,4,3,25,0,0,7,1,3,0,1037702,2023-11-08T00:00:00.000Z,666860,14,Cameron Reddish,3,8,8,7,1,17.2
1,0,4,0,0,1,0,2,0,22,0,4,0,4,0,0,1037702,2023-11-08T00:00:00.000Z,486,14,Christian Wood,0,4,5,1,5,6.3
2,0,0,0,0,3,1,0,0,14,2,5,2,2,0,0,1037702,2023-11-08T00:00:00.000Z,56677738,14,Colin Castleton,0,4,6,4,4,7.4
4,3,2,7,4,18,9,0,0,28,0,1,22,2,0,1,1037702,2023-11-08T00:00:00.000Z,405,14,D'Angelo Russell,3,24,28,26,6,38.4
1,1,0,2,0,3,1,2,1,10,0,1,3,0,0,1,1037702,2023-11-08T00:00:00.000Z,56677868,14,D'Moi Hodge,1,3,4,4,1,6.5
0,0,0,0,0,0,0,0,0,0,0,0,0,0,0,0,1037702,2023-11-08T00:00:00.000Z,666626,14,Jaxson Hayes,0,0,0,0,0,0
2,0,5,2,0,13,7,5,4,27,1,1,18,6,0,3,1037702,2023-11-08T00:00:00.000Z,237,14,LeBron James,0,24,26,20,8,25.2
3,1,7,2,0,8,1,3,2,28,1,2,4,8,0,1,1037702,2023-11-08T00:00:00.000Z,38017697,14,Max Christie,1,12,15,7,11,20.1
0,0,1,0,0,2,0,0,0,8,0,0,0,1,0,0,1037702,2023-11-08T00:00:00.000Z,56677836,14,Maxwell Lewis,0,1,1,0,1,1.2
2,1,7,3,2,14,10,5,2,25,1,0,24,8,2,0,1037702,2023-11-08T00:00:00.000Z,666609,14,Rui Hachimura,3,32,34,26,10,45.6
0,0,4,0,0,4,4,2,1,30,6,4,9,10,1,1,1037703,2023-11-08T00:00:00.000Z,48,15,Bismack Biyombo,1,19,19,9,10,23
0,0,0,0,0,0,0,0,0,0,0,0,0,0,0,0,1037703,2023-11-08T00:00:00.000Z,666505,15,Brandon Clarke,0,0,0,0,0,0
0,0,1,0,0,2,1,2,2,13,2,2,4,3,1,2,1037703,2023-11-08T00:00:00.000Z,38017729,15,David Roddy,1,7,7,4,3,8.6
0,0,0,0,0,0,0,0,0,0,0,0,0,0,0,0,1037703,2023-11-08T00:00:00.000Z,401,15,Derrick Rose,0,0,0,0,0,0
3,2,5,8,2,16,4,6,5,36,0,3,15,5,1,1,1037703,2023-11-08T00:00:00.000Z,3547287,15,Desmond Bane,3,20,23,18,8,33.5
0,0,0,0,0,0,0,0,0,0,0,0,0,0,0,0,1037703,2023-11-08T00:00:00.000Z,56677830,15,GG Jackson,0,0,0,0,0,0
0,0,0,0,0,0,0,0,0,0,0,0,0,0,0,0,1037703,2023-11-08T00:00:00.000Z,666786,15,Ja Morant,0,0,0,0,0,0
4,0,0,3,2,3,2,0,0,15,0,1,6,0,0,0,1037703,2023-11-08T00:00:00.000Z,48248287,15,Jacob Gilyard,0,6,10,10,4,12
0,0,0,0,0,0,0,0,0,0,0,0,0,0,0,0,1037703,2023-11-08T00:00:00.000Z,38017728,15,Jake LaRavia,0,0,0,0,0,0
2,1,2,8,2,18,9,10,8,33,2,5,28,4,0,1,1037703,2023-11-08T00:00:00.000Z,231,15,Jaren Jackson Jr.,1,32,34,30,6,37.8
0,0,0,0,0,0,0,0,0,0,0,0,0,0,0,0,1037703,2023-11-08T00:00:00.000Z,666703,15,John Konchar,0,0,0,0,0,0
1,0,0,0,0,3,1,0,0,7,0,1,2,0,0,0,1037703,2023-11-08T00:00:00.000Z,38017732,15,Kenneth Lofton Jr.,0,2,3,3,1,3.5
3,0,2,6,3,7,4,2,2,27,0,1,13,2,1,3,1037703,2023-11-08T00:00:00.000Z,254,15,Luke Kennard,1,15,18,16,5,19.9
7,0,4,3,0,14,4,4,3,32,0,4,11,4,2,3,1037703,2023-11-08T00:00:00.000Z,420,15,Marcus Smart,2,15,22,18,11,29.3
0,1,6,4,2,14,5,2,0,26,2,4,12,8,2,1,1037703,2023-11-08T00:00:00.000Z,17896067,15,Santi Aldama,3,20,20,12,8,29.6
0,0,0,0,0,0,0,0,0,0,0,0,0,0,0,0,1037703,2023-11-08T00:00:00.000Z,3,15,Steven Adams,0,0,0,0,0,0
0,0,0,0,0,0,0,0,0,0,0,0,0,0,0,0,1037703,2023-11-08T00:00:00.000Z,38017731,15,Vince Williams Jr.,0,0,0,0,0,0
0,0,0,0,0,0,0,0,0,0,0,0,0,0,0,0,1037703,2023-11-08T00:00:00.000Z,3547285,15,Xavier Tillman,0,0,0,0,0,0
0,0,1,5,0,9,1,0,0,21,1,2,2,2,2,1,1037703,2023-11-08T00:00:00.000Z,17896027,15,Ziaire Williams,2,4,4,2,2,9.4
1,3,11,0,0,15,8,16,14,36,0,5,30,11,1,4,1037703,2023-11-08T00:00:00.000Z,4,16,Bam Adebayo,4,41,42,31,12,52.7
0,0,0,0,0,0,0,0,0,0,0,0,0,0,0,0,1037703,2023-11-08T00:00:00.000Z,38017736,16,Cole Swider,0,0,0,0,0,0
1,3,0,4,2,7,5,2,2,27,2,2,14,2,2,0,1037703,2023-11-08T00:00:00.000Z,3092,16,Haywood Highsmith,5,16,17,15,3,32.9
2,0,2,4,2,13,5,3,3,35,1,1,15,3,1,1,1037703,2023-11-08T00:00:00.000Z,79,16,Jimmy Butler,1,18,20,17,5,23.6
0,0,0,0,0,0,0,0,0,0,0,0,0,0,0,0,1037703,2023-11-08T00:00:00.000Z,285,16,Kevin Love,0,0,0,0,0,0
0,0,0,0,0,0,0,0,0,0,0,0,0,0,0,0,1037703,2023-11-08T00:00:00.000Z,39398582,16,Orlando Robinson,0,0,0,0,0,0
3,1,12,1,0,8,3,0,0,37,3,4,6,15,0,2,1037704,2023-11-08T00:00:00.000Z,56677826,9,Ausar Thompson,1,21,24,9,18,29.5
8,0,6,8,2,27,11,10,9,39,2,2,33,8,0,5,1037704,2023-11-08T00:00:00.000Z,17896075,9,Cade Cunningham,0,41,49,41,16,49.6
0,0,0,0,0,0,0,0,0,0,0,0,0,0,0,0,1037704,2023-11-08T00:00:00.000Z,17896071,9,Isaiah Livers,0,0,0,0,0,0
1,2,3,7,2,9,3,0,0,37,1,4,8,4,0,1,1037704,2023-11-08T00:00:00.000Z,3547267,9,Isaiah Stewart,2,12,13,9,5,19.3
0,0,0,0,0,0,0,0,0,0,0,0,0,0,0,0,1037704,2023-11-08T00:00:00.000Z,38017682,9,Jaden Ivey,0,0,0,0,0,0
5,0,9,1,0,10,5,1,1,28,3,5,11,12,0,2,1037704,2023-11-08T00:00:00.000Z,38017694,9,Jalen Duren,0,23,28,16,17,30.9
0,0,0,0,0,0,0,0,0,0,0,0,0,0,0,0,1037704,2023-11-08T00:00:00.000Z,197,9,Joe Harris,0,0,0,0,0,0
0,0,0,0,0,0,0,0,0,0,0,0,0,0,0,0,1037704,2023-11-08T00:00:00.000Z,259,9,Kevin Knox,0,0,0,0,0,0
4,0,5,3,0,15,6,2,2,29,0,1,14,5,1,1,1037704,2023-11-08T00:00:00.000Z,3547241,9,Killian Hayes,1,19,23,18,9,28
0,0,0,0,0,0,0,0,0,0,0,0,0,0,0,0,1037704,2023-11-08T00:00:00.000Z,56677729,9,Malcolm Cazalon,0,0,0,0,0,0
2,0,6,7,3,17,11,1,1,28,0,1,26,6,1,3,1037704,2023-11-08T00:00:00.000Z,56677792,9,Marcus Sasser,1,32,34,28,8,36.2
2,1,0,0,0,6,5,2,2,20,2,4,12,2,0,1,1037704,2023-11-08T00:00:00.000Z,24,9,Marvin Bagley III,1,14,16,14,4,19.4
0,0,0,0,0,0,0,0,0,0,0,0,0,0,0,0,1037704,2023-11-08T00:00:00.000Z,330,9,Monte Morris,0,0,0,0,0,0
0,0,0,0,0,0,0,0,0,0,0,0,0,0,0,0,1037704,2023-11-08T00:00:00.000Z,38017733,17,A.J. Green,0,0,0,0,0,0
0,0,0,0,0,0,0,0,0,4,0,3,0,0,1,0,1037704,2023-11-08T00:00:00.000Z,56677852,17,Andre Jackson Jr.,1,0,0,0,0,3
2,0,3,4,1,14,7,3,3,23,2,1,18,5,0,2,1037704,2023-11-08T00:00:00.000Z,377,17,Bobby Portis,0,23,25,20,7,25
3,0,1,3,1,4,1,4,4,24,0,2,7,1,2,1,1037704,2023-11-08T00:00:00.000Z,368,17,Cameron Payne,2,8,11,10,4,17.7
0,0,0,0,0,0,0,0,0,0,0,0,0,0,0,0,1037704,2023-11-08T00:00:00.000Z,56677854,17,Chris Livingston,0,0,0,0,0,0
0,0,0,0,0,0,0,0,0,0,0,0,0,0,0,0,1037704,2023-11-08T00:00:00.000Z,315,17,Khris Middleton,0,0,0,0,0,0
0,0,0,0,0,0,0,0,0,0,0,0,0,0,0,0,1037704,2023-11-08T00:00:00.000Z,666960,17,Lindell Wigginton,0,0,0,0,0,0
1,0,1,3,0,8,4,2,2,26,1,4,10,2,0,1,1037704,2023-11-08T00:00:00.000Z,38017676,17,MarJon Beauchamp,0,12,13,11,3,12.9
0,0,0,0,0,0,0,0,0,0,0,0,0,0,0,0,1037704,2023-11-08T00:00:00.000Z,666453,17,Marques Bolden,0,0,0,0,0,0
1,0,0,1,0,3,1,0,0,19,0,0,2,0,0,1,1037704,2023-11-08T00:00:00.000Z,105,17,Pat Connaughton,0,2,3,3,1,2.5
0,0,0,0,0,0,0,0,0,0,0,0,0,0,0,0,1037704,2023-11-08T00:00:00.000Z,284,17,Robin Lopez,0,0,0,0,0,0
0,0,0,0,0,0,0,0,0,0,0,0,0,0,0,0,1037704,2023-11-08T00:00:00.000Z,2148,17,Thanasis Antetokounmpo,0,0,0,0,0,0
0,0,0,0,0,0,0,0,0,0,0,0,0,0,0,0,1037704,2023-11-08T00:00:00.000Z,38017691,17,TyTy Washington Jr.,0,0,0,0,0,0
8,2,3,8,2,22,10,5,4,33,0,1,26,3,3,3,1037705,2023-11-08T00:00:00.000Z,3547238,18,Anthony Edwards,5,29,37,34,11,53.6
0,0,0,0,0,0,0,0,0,3,0,0,0,0,0,0,1037705,2023-11-08T00:00:00.000Z,17895968,18,Daishen Nix,0,0,0,0,0,0
3,0,0,5,2,7,4,0,0,26,0,2,10,0,0,0,1037705,2023-11-08T00:00:00.000Z,3547259,18,Jaden McDaniels,0,10,13,13,3,14.5
0,0,0,0,0,0,0,0,0,0,0,0,0,0,0,0,1037705,2023-11-08T00:00:00.000Z,56677851,18,Jaylen Clark,0,0,0,0,0,0
0,0,0,0,0,0,0,0,0,0,0,0,0,0,0,0,1037705,2023-11-08T00:00:00.000Z,666767,18,Jordan McLaughlin,0,0,0,0,0,0
0,0,0,1,0,1,0,0,0,3,0,2,0,0,0,0,1037705,2023-11-08T00:00:00.000Z,38017715,18,Josh Minott,0,0,0,0,0,0
5,2,2,2,1,3,2,2,1,25,0,2,6,2,1,2,1037705,2023-11-08T00:00:00.000Z,12,18,Kyle Anderson,3,8,13,11,7,22.9
0,0,0,0,0,0,0,0,0,0,0,0,0,0,0,0,1037705,2023-11-08T00:00:00.000Z,56677782,18,Leonard Miller,0,0,0,0,0,0
0,0,1,0,0,4,2,2,1,5,1,3,5,2,0,0,1037705,2023-11-08T00:00:00.000Z,17896056,18,Luka Garza,0,7,7,5,2,7.4
0,0,3,4,1,8,4,0,0,22,1,2,9,4,1,0,1037705,2023-11-08T00:00:00.000Z,667378,18,Naz Reid,1,13,13,9,4,16.8
1,0,4,5,1,9,4,1,1,19,0,1,10,4,2,2,1037705,2023-11-08T00:00:00.000Z,320,18,Shake Milton,2,14,15,11,5,20.3
0,0,0,1,0,5,2,0,0,5,1,0,4,1,0,0,1037705,2023-11-08T00:00:00.000Z,68,18,Troy Brown Jr.,0,5,5,4,1,5.2
0,0,0,0,0,0,0,0,0,0,0,0,0,0,0,0,1037705,2023-11-08T00:00:00.000Z,38017700,18,Wendell Moore Jr.,0,0,0,0,0,0
6,0,3,6,1,25,11,1,1,32,0,1,24,3,0,2,1037705,2023-11-08T00:00:00.000Z,227,19,Brandon Ingram,0,27,33,30,9,34.6
0,0,0,0,0,0,0,0,0,0,0,0,0,0,0,0,1037705,2023-11-08T00:00:00.000Z,303,19,CJ McCollum,0,0,0,0,0,0
1,0,2,2,1,7,3,2,2,17,1,1,9,3,0,0,1037705,2023-11-08T00:00:00.000Z,38017726,19,Dereon Seabron,0,12,13,10,4,14.1
5,0,2,3,1,10,3,0,0,31,1,2,7,3,4,3,1037705,2023-11-08T00:00:00.000Z,38017677,19,Dyson Daniels,4,10,15,12,8,27.1
1,0,6,2,1,7,3,4,4,28,3,2,11,9,0,2,1037705,2023-11-08T00:00:00.000Z,17896021,19,Jeremiah Robinson-Earl,0,20,21,12,10,21.3
0,0,5,2,0,9,4,0,0,22,1,1,8,6,0,0,1037705,2023-11-08T00:00:00.000Z,455,19,Jonas Valanciunas,0,14,14,8,6,15.2
1,0,1,5,2,11,4,4,4,30,0,5,14,1,0,2,1037705,2023-11-08T00:00:00.000Z,56677837,19,Jordan Hawkins,0,15,16,15,2,14.7
0,0,0,0,0,0,0,0,0,0,0,0,0,0,0,0,1037705,2023-11-08T00:00:00.000Z,18677986,19,Trey Murphy III,0,0,0,0,0,0
0,0,0,0,0,0,0,0,0,0,0,0,0,0,0,0,1037706,2023-11-08T00:00:00.000Z,56677872,6,Craig Porter,0,0,0,0,0,0
0,0,0,0,0,0,0,0,0,0,0,0,0,0,0,0,1037706,2023-11-08T00:00:00.000Z,3547247,6,Isaac Okoro,0,0,0,0,0,0
2,0,2,0,0,0,0,2,1,13,0,2,1,2,1,2,1037706,2023-11-08T00:00:00.000Z,444,6,Tristan Thompson,1,3,5,3,4,7.4
0,0,0,0,0,0,0,0,0,0,0,0,0,0,0,0,1037706,2023-11-08T00:00:00.000Z,3547271,21,Aleksej Pokusevski,0,0,0,0,0,0
0,0,3,6,2,7,2,0,0,18,0,4,6,3,0,1,1037706,2023-11-08T00:00:00.000Z,3547272,21,Isaiah Joe,0,9,9,6,3,8.6
1,0,3,1,0,2,1,2,2,9,2,1,4,5,1,0,1037706,2023-11-08T00:00:00.000Z,38017716,21,Ousmane Dieng,1,9,10,5,6,14.5
0,0,0,0,0,0,0,0,0,0,0,0,0,0,0,0,1037706,2023-11-08T00:00:00.000Z,17896036,21,Tre Mann,0,0,0,0,0,0
0,0,0,0,0,0,0,0,0,0,0,0,0,0,0,0,1037706,2023-11-08T00:00:00.000Z,4197029,21,Vasilije Micic,0,0,0,0,0,0
0,0,0,0,0,0,0,0,0,0,0,0,0,0,0,0,1037707,2023-11-08T00:00:00.000Z,17554004,7,AJ Lawson,0,0,0,0,0,0
0,0,0,0,0,0,0,0,0,0,0,0,0,0,0,0,1037707,2023-11-08T00:00:00.000Z,56677840,7,Dereck Lively II,0,0,0,0,0,0
1,3,4,5,3,8,6,0,0,29,1,3,15,5,0,3,1037707,2023-11-08T00:00:00.000Z,247,7,Derrick Jones Jr.,3,20,21,16,6,28.5
0,0,0,0,0,0,0,0,0,0,0,0,0,0,0,0,1037707,2023-11-08T00:00:00.000Z,56677873,7,Dexter Dennis,0,0,0,0,0,0
0,0,0,0,0,0,0,0,0,0,0,0,0,0,0,0,1037707,2023-11-08T00:00:00.000Z,17896028,7,Greg Brown III,0,0,0,0,0,0
2,0,1,3,1,4,2,2,1,12,0,0,6,1,0,0,1037707,2023-11-08T00:00:00.000Z,38017679,7,Jaden Hardy,0,7,9,8,3,10.2
2,1,1,2,1,3,1,0,0,18,0,2,3,1,0,1,1037707,2023-11-08T00:00:00.000Z,3547258,7,Josh Green,1,4,6,5,3,9.2
0,0,0,0,0,0,0,0,0,0,0,0,0,0,0,0,1037707,2023-11-08T00:00:00.000Z,329,7,Markieff Morris,0,0,0,0,0,0
0,0,0,0,0,0,0,0,0,0,0,0,0,0,0,0,1037707,2023-11-08T00:00:00.000Z,56677859,7,Olivier-Maxence Prosper,0,0,0,0,0,0
1,0,1,0,0,2,1,0,0,7,2,2,2,3,0,1,1037707,2023-11-08T00:00:00.000Z,217,7,Richaun Holmes,0,5,6,3,4,6.1
1,0,1,9,5,11,6,0,0,26,1,0,17,2,0,3,1037707,2023-11-08T00:00:00.000Z,191,7,Tim Hardaway Jr.,0,19,20,18,3,17.9
0,0,0,0,0,0,0,0,0,0,0,0,0,0,0,0,1037707,2023-11-08T00:00:00.000Z,38017710,28,Christian Koloko,0,0,0,0,0,0
5,1,2,4,1,13,7,4,3,30,0,4,18,2,2,2,1037707,2023-11-08T00:00:00.000Z,409,28,Dennis Schroder,3,20,25,23,7,34.9
1,0,2,8,4,11,6,0,0,26,0,0,16,2,1,0,1037707,2023-11-08T00:00:00.000Z,3089,28,Gary Trent Jr.,1,18,19,17,3,22.9
0,0,0,0,0,1,0,0,0,6,0,1,0,0,0,2,1037707,2023-11-08T00:00:00.000Z,56677828,28,Gradey Dick,0,0,0,0,0,-2
3,0,3,0,0,5,2,1,0,21,3,4,4,6,2,1,1037707,2023-11-08T00:00:00.000Z,373,28,Jakob Poeltl,2,10,13,7,9,20.7
0,0,0,0,0,0,0,0,0,0,0,0,0,0,0,0,1037707,2023-11-08T00:00:00.000Z,56677805,28,Javon Freeman-Liberty,0,0,0,0,0,0
3,0,4,4,2,5,2,2,2,15,0,2,8,4,0,0,1037707,2023-11-08T00:00:00.000Z,3547275,28,Malachi Flynn,0,12,15,11,7,17.3
0,0,0,0,0,0,0,0,0,0,0,0,0,0,0,0,1037707,2023-11-08T00:00:00.000Z,56677869,28,Markquis Nowell,0,0,0,0,0,0
2,0,4,8,3,17,9,6,5,36,1,4,26,5,0,2,1037707,2023-11-08T00:00:00.000Z,18,28,OG Anunoby,0,31,33,28,7,33
0,0,3,2,0,3,0,0,0,15,0,1,0,3,1,0,1037707,2023-11-08T00:00:00.000Z,376,28,Otto Porter Jr.,1,3,3,0,3,6.6
5,0,8,5,0,25,15,4,1,37,4,2,31,12,0,3,1037707,2023-11-08T00:00:00.000Z,416,28,Pascal Siakam,0,43,48,36,17,49.9
0,0,0,0,0,0,0,0,0,0,0,0,0,0,0,0,1037707,2023-11-08T00:00:00.000Z,3547249,28,Precious Achiuwa,0,0,0,0,0,0
0,0,0,0,0,0,0,0,0,0,0,0,0,0,0,0,1037707,2023-11-08T00:00:00.000Z,38017717,28,Ron Harper Jr.,0,0,0,0,0,0
7,2,8,4,0,15,4,8,6,39,6,2,14,14,4,0,1037707,2023-11-08T00:00:00.000Z,17896055,28,Scottie Barnes,6,28,35,21,21,59.3
0,0,0,0,0,0,0,0,0,0,0,0,0,0,0,0,1037707,2023-11-08T00:00:00.000Z,489,28,Thaddeus Young,0,0,0,0,0,0
3,1,7,2,1,14,5,4,3,34,4,2,14,11,3,2,1037708,2023-11-08T00:00:00.000Z,177,8,Aaron Gordon,4,25,28,17,14,41.7
0,0,0,0,0,0,0,0,0,0,0,0,0,0,0,0,1037708,2023-11-08T00:00:00.000Z,17896007,8,Braxton Key,0,0,0,0,0,0
2,0,2,2,1,3,1,2,1,16,0,1,4,2,0,0,1037708,2023-11-08T00:00:00.000Z,38017709,8,Christian Braun,0,6,8,6,4,9.4
1,0,0,2,1,2,1,0,0,16,0,2,3,0,0,1,1037708,2023-11-08T00:00:00.000Z,38017727,8,Collin Gillespie,0,3,4,4,1,3.5
0,0,0,0,0,0,0,0,0,0,0,0,0,0,0,0,1037708,2023-11-08T00:00:00.000Z,56677871,8,Hunter Tyson,0,0,0,0,0,0
0,0,0,0,0,0,0,0,0,0,0,0,0,0,0,0,1037708,2023-11-08T00:00:00.000Z,56677582,8,Jalen Pickett,0,0,0,0,0,0
0,0,0,0,0,0,0,0,0,0,0,0,0,0,0,0,1037708,2023-11-08T00:00:00.000Z,335,8,Jamal Murray,0,0,0,0,0,0
0,0,0,0,0,0,0,0,0,0,0,0,0,0,0,0,1037708,2023-11-08T00:00:00.000Z,17896103,8,Jay Huff,0,0,0,0,0,0
0,0,1,1,0,1,0,0,0,8,0,2,0,1,0,0,1037708,2023-11-08T00:00:00.000Z,56677776,8,Julian Strawther,0,1,1,0,1,1.2
3,0,2,3,0,8,3,4,4,35,1,3,10,3,1,0,1037708,2023-11-08T00:00:00.000Z,81,8,Kentavious Caldwell-Pope,1,13,16,13,6,21.1
2,2,6,8,3,17,7,0,0,37,2,1,17,8,0,0,1037708,2023-11-08T00:00:00.000Z,375,8,Michael Porter Jr.,2,25,27,19,10,35.6
5,1,10,8,1,25,14,10,6,37,3,3,35,13,3,3,1037708,2023-11-08T00:00:00.000Z,246,8,Nikola Jokic,4,48,53,40,18,67.1
0,0,0,0,0,2,1,0,0,11,0,0,2,0,0,0,1037708,2023-11-08T00:00:00.000Z,38017721,8,Peyton Watson,0,2,2,2,0,2
6,0,2,7,3,17,8,2,1,32,0,5,20,2,0,0,1037708,2023-11-08T00:00:00.000Z,236,8,Reggie Jackson,0,22,28,26,8,31.4
0,0,0,0,0,0,0,0,0,0,0,0,0,0,0,0,1037708,2023-11-08T00:00:00.000Z,666489,8,Vlatko Cancar,0,0,0,0,0,0
2,0,2,0,0,1,0,0,0,6,0,0,0,2,0,0,1037708,2023-11-08T00:00:00.000Z,3547268,8,Zeke Nnaji,0,2,4,2,4,5.4
0,0,2,3,0,13,4,4,3,29,3,3,11,5,0,1,1037708,2023-11-08T00:00:00.000Z,475,10,Andrew Wiggins,0,16,16,11,5,16
4,0,4,4,1,10,4,0,0,27,1,2,9,5,1,1,1037708,2023-11-08T00:00:00.000Z,367,10,Chris Paul,1,14,18,13,9,23
1,0,3,3,2,7,4,0,0,14,0,0,10,3,1,0,1037708,2023-11-08T00:00:00.000Z,17553992,10,Moses Moody,1,13,14,11,4,18.1
4,0,4,13,6,17,6,5,5,34,1,2,23,5,1,3,1037708,2023-11-08T00:00:00.000Z,115,10,Stephen Curry,1,28,32,27,9,35
0,0,0,0,0,0,0,0,0,0,0,0,0,0,0,0,1037709,2023-11-08T00:00:00.000Z,419,25,Anfernee Simons,0,0,0,0,0,0
0,0,0,0,0,0,0,0,0,0,0,0,0,0,0,0,1037709,2023-11-08T00:00:00.000Z,56783340,25,Duop Reath,0,0,0,0,0,0
0,0,0,0,0,0,0,0,0,0,0,0,0,0,0,0,1037709,2023-11-08T00:00:00.000Z,17896120,25,Ish Wainright,0,0,0,0,0,0
1,0,2,1,0,2,1,0,0,15,0,4,2,2,0,1,1037709,2023-11-08T00:00:00.000Z,38017711,25,Jabari Walker,0,4,5,3,3,4.9
0,0,1,0,0,0,0,0,0,8,1,1,0,2,0,1,1037709,2023-11-08T00:00:00.000Z,47957121,25,Justin Minaya,0,2,2,0,2,1.4
0,1,0,0,0,1,0,0,0,9,0,1,0,0,0,0,1037709,2023-11-08T00:00:00.000Z,56677791,25,Kris Murray,1,0,0,0,0,3
1,0,1,2,1,3,2,0,0,5,0,1,5,1,0,0,1037709,2023-11-08T00:00:00.000Z,65,25,Malcolm Brogdon,0,6,7,6,2,7.7
1,1,1,0,0,3,2,2,0,5,2,1,4,3,0,0,1037709,2023-11-08T00:00:00.000Z,666476,25,Moses Brown,1,7,8,5,4,12.1
0,0,0,0,0,0,0,0,0,0,0,0,0,0,0,0,1037709,2023-11-08T00:00:00.000Z,56677829,25,Rayan Rupert,0,0,0,0,0,0
0,0,0,0,0,0,0,0,0,0,0,0,0,0,0,0,1037709,2023-11-08T00:00:00.000Z,476,25,Robert Williams III,0,0,0,0,0,0
0,0,0,0,0,0,0,0,0,0,0,0,0,0,0,0,1037709,2023-11-08T00:00:00.000Z,56677747,25,Scoot Henderson,0,0,0,0,0,0
11,0,2,2,0,15,8,2,2,37,0,4,18,2,2,3,1037709,2023-11-08T00:00:00.000Z,3547289,25,Skylar Mays,2,20,31,29,13,39.9
1,0,3,0,0,2,1,0,0,25,1,3,2,4,3,1,1037709,2023-11-08T00:00:00.000Z,56677850,25,Toumani Camara,3,6,7,3,5,16.3
0,0,1,3,2,4,2,0,0,17,0,5,6,1,0,1,1037710,2023-11-09T00:00:00.000Z,3547250,12,Aaron Nesmith,0,7,7,6,1,6.2
2,0,2,2,2,5,4,0,0,20,0,3,10,2,1,1,1037710,2023-11-09T00:00:00.000Z,38017507,12,Andrew Nembhard,1,12,14,12,4,17.4
0,0,0,0,0,0,0,0,0,0,0,0,0,0,0,0,1037710,2023-11-09T00:00:00.000Z,56677861,12,Ben Sheppard,0,0,0,0,0,0
2,1,7,7,3,18,9,6,5,36,4,1,26,11,1,1,1037710,2023-11-09T00:00:00.000Z,38017686,12,Bennedict Mathurin,2,37,39,28,13,47.2
7,1,7,4,1,9,3,4,4,38,2,0,11,9,2,2,1037710,2023-11-09T00:00:00.000Z,69,12,Bruce Brown,3,20,27,18,16,39.3
2,0,2,11,2,14,4,1,1,22,0,3,11,2,1,2,1037710,2023-11-09T00:00:00.000Z,210,12,Buddy Hield,1,13,15,13,4,17.4
0,0,0,1,0,4,1,0,0,8,0,1,2,0,0,0,1037710,2023-11-09T00:00:00.000Z,439,12,Daniel Theis,0,2,2,2,0,2
0,2,2,0,0,2,1,2,1,11,1,3,3,3,1,0,1037710,2023-11-09T00:00:00.000Z,17896035,12,Isaiah Jackson,3,6,6,3,3,15.6
0,0,0,0,0,0,0,0,0,0,0,0,0,0,0,0,1037710,2023-11-09T00:00:00.000Z,56677794,12,Isaiah Wong,0,0,0,0,0,0
0,0,0,0,0,0,0,0,0,0,0,0,0,0,0,0,1037710,2023-11-09T00:00:00.000Z,3547264,12,Jalen Smith,0,0,0,0,0,0
0,0,0,0,0,0,0,0,0,0,0,0,0,0,0,0,1037710,2023-11-09T00:00:00.000Z,56677832,12,Jarace Walker,0,0,0,0,0,0
0,0,0,0,0,0,0,0,0,0,0,0,0,0,0,0,1037710,2023-11-09T00:00:00.000Z,3547207,12,Jordan Nwora,0,0,0,0,0,0
0,0,0,0,0,0,0,0,0,0,0,0,0,0,0,0,1037710,2023-11-09T00:00:00.000Z,38017701,12,Kendall Brown,0,0,0,0,0,0
4,1,5,9,4,16,8,1,1,37,1,4,21,6,0,1,1037710,2023-11-09T00:00:00.000Z,452,12,Myles Turner,1,27,31,25,10,36.2
0,0,0,2,1,3,2,2,2,13,0,4,7,0,0,1,1037710,2023-11-09T00:00:00.000Z,3547243,12,Obi Toppin,0,7,7,7,0,6
0,0,0,0,0,0,0,0,0,0,0,0,0,0,0,0,1037710,2023-11-09T00:00:00.000Z,56677778,12,Oscar Tshiebwe,0,0,0,0,0,0
0,0,0,0,0,0,0,0,0,0,0,0,0,0,0,0,1037710,2023-11-09T00:00:00.000Z,304,12,T.J. McConnell,0,0,0,0,0,0
10,1,5,9,5,17,10,4,4,38,1,1,29,6,0,2,1037710,2023-11-09T00:00:00.000Z,3547245,12,Tyrese Haliburton,1,35,45,39,16,52.2
0,3,1,4,0,7,1,0,0,29,0,2,2,1,2,0,1037710,2023-11-09T00:00:00.000Z,283,17,Brook Lopez,5,3,3,2,1,18.2
5,1,4,2,1,9,3,0,0,30,0,4,7,4,0,1,1037710,2023-11-09T00:00:00.000Z,368,17,Cameron Payne,1,11,16,12,9,21.3
3,0,10,1,0,25,19,18,16,36,2,4,54,12,0,8,1037710,2023-11-09T00:00:00.000Z,15,17,Giannis Antetokounmpo,0,66,69,57,15,64.9
1,0,4,1,1,2,2,0,0,29,0,2,5,4,1,0,1037710,2023-11-09T00:00:00.000Z,112,17,Jae Crowder,1,9,10,6,5,14.3
4,0,1,6,2,13,7,4,3,20,1,1,19,2,0,2,1037710,2023-11-09T00:00:00.000Z,315,17,Khris Middleton,0,21,25,23,6,25.4
2,0,3,6,3,10,4,2,2,29,1,2,13,4,1,0,1037710,2023-11-09T00:00:00.000Z,38,17,Malik Beasley,1,17,19,15,6,23.8
0,0,0,0,0,0,0,0,0,0,0,0,0,0,0,0,1037710,2023-11-09T00:00:00.000Z,38017691,17,TyTy Washington Jr.,0,0,0,0,0,0
3,0,4,6,3,11,6,0,0,29,0,3,15,4,3,1,1037711,2023-11-09T00:00:00.000Z,53,1,Bogdan Bogdanovic,3,19,22,18,7,32.3
0,0,0,0,0,0,0,0,0,0,0,0,0,0,0,0,1037711,2023-11-09T00:00:00.000Z,56677838,1,Kobe Bufkin,0,0,0,0,0,0
0,0,0,0,0,0,0,0,0,0,0,0,0,0,0,0,1037711,2023-11-09T00:00:00.000Z,56677875,1,Miles Norris,0,0,0,0,0,0
0,0,0,0,0,0,0,0,0,0,0,0,0,0,0,0,1037711,2023-11-09T00:00:00.000Z,56677806,1,Mouhamed Gueye,0,0,0,0,0,0
2,4,1,1,0,4,3,2,1,21,1,4,7,2,3,1,1037711,2023-11-09T00:00:00.000Z,3547244,1,Onyeka Okongwu,7,9,11,9,4,32.4
0,0,0,0,0,0,0,0,0,0,0,0,0,0,0,0,1037711,2023-11-09T00:00:00.000Z,319,1,Patty Mills,0,0,0,0,0,0
0,0,2,0,0,4,1,0,0,29,1,3,2,3,1,1,1037711,2023-11-09T00:00:00.000Z,3547256,1,Saddiq Bey,1,5,5,2,3,7.6
8,0,3,15,5,27,12,13,12,34,2,1,41,5,2,3,1037711,2023-11-09T00:00:00.000Z,490,1,Trae Young,2,46,54,49,13,62
0,0,0,0,0,0,0,0,0,0,0,0,0,0,0,0,1037711,2023-11-09T00:00:00.000Z,3547297,1,Trent Forrest,0,0,0,0,0,0
0,0,0,0,0,0,0,0,0,0,0,0,0,0,0,0,1037711,2023-11-09T00:00:00.000Z,301,1,Wesley Matthews,0,0,0,0,0,0
1,1,1,2,1,4,3,2,2,17,2,3,9,3,1,1,1037711,2023-11-09T00:00:00.000Z,56677827,22,Anthony Black,2,12,13,10,4,19.1
0,0,0,0,0,0,0,0,0,0,0,0,0,0,0,0,1037711,2023-11-09T00:00:00.000Z,38017724,22,Caleb Houstan,0,0,0,0,0,0
2,0,1,4,0,7,1,6,5,24,1,3,7,2,0,3,1037711,2023-11-09T00:00:00.000Z,3547251,22,Cole Anthony,0,9,11,9,4,9.4
3,0,4,1,0,12,5,2,2,29,2,2,12,6,0,4,1037711,2023-11-09T00:00:00.000Z,17896026,22,Franz Wagner,0,18,21,15,9,19.7
0,2,3,0,0,7,5,4,2,21,2,2,12,5,0,1,1037711,2023-11-09T00:00:00.000Z,666442,22,Goga Bitadze,2,17,17,12,5,23
1,0,3,5,4,10,7,6,3,31,0,5,21,3,7,2,1037711,2023-11-09T00:00:00.000Z,17896073,22,Jalen Suggs,7,24,25,22,4,45.1
0,0,0,0,0,0,0,0,0,0,0,0,0,0,0,0,1037711,2023-11-09T00:00:00.000Z,56677839,22,Jett Howard,0,0,0,0,0,0
5,1,1,3,1,6,1,0,0,18,2,1,3,3,3,0,1037711,2023-11-09T00:00:00.000Z,226,22,Joe Ingles,4,6,11,8,8,26.1
0,2,6,4,1,8,3,7,5,16,1,1,12,7,0,0,1037711,2023-11-09T00:00:00.000Z,229,22,Jonathan Isaac,2,19,19,12,7,26.4
3,0,0,0,0,12,5,3,3,28,1,1,13,1,0,0,1037711,2023-11-09T00:00:00.000Z,165,22,Markelle Fultz,0,14,17,16,4,18.7
0,0,6,4,2,9,5,1,1,20,1,2,13,7,0,2,1037711,2023-11-09T00:00:00.000Z,462,22,Moritz Wagner,0,20,20,13,7,19.4
4,0,4,3,1,14,7,4,2,34,4,4,17,8,1,5,1037711,2023-11-09T00:00:00.000Z,38017683,22,Paolo Banchero,1,25,29,21,12,30.6
0,0,0,0,0,0,0,0,0,0,0,0,0,0,0,0,1037711,2023-11-09T00:00:00.000Z,85,22,Wendell Carter Jr.,0,0,0,0,0,0
0,0,0,0,0,0,0,0,0,0,0,0,0,0,0,0,3277397,2023-11-10T00:00:00.000Z,17896071,9,Isaiah Livers,0,0,0,0,0,0
0,0,1,0,0,3,3,0,0,6,2,1,6,3,0,0,3277397,2023-11-10T00:00:00.000Z,3547240,9,James Wiseman,0,9,9,6,3,9.6
0,0,0,2,1,3,2,0,0,7,0,1,5,0,0,1,3277397,2023-11-10T00:00:00.000Z,42097199,9,Jared Rhoden,0,5,5,5,0,4
0,0,0,0,0,0,0,0,0,0,0,0,0,0,0,0,3277397,2023-11-10T00:00:00.000Z,197,9,Joe Harris,0,0,0,0,0,0
4,0,3,7,1,13,3,2,2,35,0,4,9,3,0,0,3277397,2023-11-10T00:00:00.000Z,56677792,9,Marcus Sasser,0,12,16,13,7,18.6
0,0,0,0,0,0,0,0,0,0,0,0,0,0,0,0,3277397,2023-11-10T00:00:00.000Z,330,9,Monte Morris,0,0,0,0,0,0
0,0,0,0,0,0,0,0,0,0,0,0,0,0,0,0,3277397,2023-11-10T00:00:00.000Z,2175,23,Danuel House Jr.,0,0,0,0,0,0
0,0,0,0,0,0,0,0,0,0,0,0,0,0,0,0,3277397,2023-11-10T00:00:00.000Z,17554001,23,Javonte Smart,0,0,0,0,0,0
1,0,6,3,0,9,3,3,2,26,2,3,8,8,2,0,3277397,2023-11-10T00:00:00.000Z,360,23,Kelly Oubre Jr.,2,16,17,9,9,25.1
0,0,1,0,0,0,0,0,0,6,0,2,0,1,0,0,3277397,2023-11-10T00:00:00.000Z,328,23,Marcus Morris,0,1,1,0,1,1.2
0,0,0,0,0,0,0,0,0,0,0,0,0,0,0,0,3277397,2023-11-10T00:00:00.000Z,28,23,Mo Bamba,0,0,0,0,0,0
3,0,2,2,1,2,1,0,0,27,1,4,3,3,1,0,3277397,2023-11-10T00:00:00.000Z,33,23,Nicolas Batum,1,6,9,6,6,14.1
1,0,0,0,0,1,0,0,0,5,0,0,0,0,0,0,3277397,2023-11-10T00:00:00.000Z,45,23,Patrick Beverley,0,0,1,1,1,1.5
0,0,4,0,0,2,1,0,0,12,0,3,2,4,0,0,3277397,2023-11-10T00:00:00.000Z,3547270,23,Paul Reed,0,6,6,2,4,6.8
0,0,0,3,1,3,1,0,0,14,0,0,3,0,4,0,3277397,2023-11-10T00:00:00.000Z,108,23,Robert Covington,4,3,3,3,0,15
0,0,0,0,0,0,0,0,0,0,0,0,0,0,0,0,3277397,2023-11-10T00:00:00.000Z,56677788,23,Terquavion Smith,0,0,0,0,0,0
2,1,4,3,2,15,8,6,6,38,1,1,24,5,0,3,3277397,2023-11-10T00:00:00.000Z,200,23,Tobias Harris,1,29,31,26,7,33
10,1,6,7,2,19,9,9,9,39,0,3,29,6,4,0,3277397,2023-11-10T00:00:00.000Z,3547254,23,Tyrese Maxey,5,35,45,39,16,66.2
0,0,0,0,0,0,0,0,0,0,0,0,0,0,0,0,3277398,2023-11-10T00:00:00.000Z,56677848,4,Amari Bailey,0,0,0,0,0,0
2,2,1,6,0,16,5,2,2,31,2,5,12,3,2,1,3277398,2023-11-10T00:00:00.000Z,56677823,4,Brandon Miller,4,15,17,14,5,29.6
1,0,2,1,0,2,1,0,0,13,1,3,2,3,0,1,3277398,2023-11-10T00:00:00.000Z,38017708,4,Bryce McGowens,0,5,6,3,4,6.1
9,1,5,4,1,20,10,8,6,36,0,0,27,5,4,0,3277398,2023-11-10T00:00:00.000Z,204,4,Gordon Hayward,5,32,41,36,14,61.5
0,0,0,0,0,0,0,0,0,0,0,0,0,0,0,0,3277398,2023-11-10T00:00:00.000Z,422,4,Ish Smith,0,0,0,0,0,0
6,0,3,8,4,19,9,4,3,38,3,5,25,6,2,2,3277398,2023-11-10T00:00:00.000Z,3547239,4,LaMelo Ball,2,31,37,31,12,45.2
0,0,0,0,0,0,0,0,0,0,0,0,0,0,0,0,3277398,2023-11-10T00:00:00.000Z,56677866,4,Leaky Black,0,0,0,0,0,0
3,0,9,0,0,18,10,2,1,30,12,0,21,21,0,0,3277398,2023-11-10T00:00:00.000Z,38017698,4,Mark Williams,0,42,45,24,24,50.7
0,1,4,0,0,5,5,8,5,18,2,4,15,6,0,1,3277398,2023-11-10T00:00:00.000Z,3547282,4,Nick Richards,1,21,21,15,6,24.2
4,0,7,6,0,15,5,2,1,38,3,0,11,10,1,2,3277398,2023-11-10T00:00:00.000Z,666950,4,P.J. Washington,1,21,25,15,14,30
0,0,0,0,0,0,0,0,0,0,0,0,0,0,0,0,3277398,2023-11-10T00:00:00.000Z,403,4,Terry Rozier,0,0,0,0,0,0
4,0,4,1,0,5,2,0,0,16,1,1,4,5,1,2,3277398,2023-11-10T00:00:00.000Z,3547253,4,Theo Maledon,1,9,13,8,9,17
0,0,0,0,0,0,0,0,0,0,0,0,0,0,0,0,3277398,2023-11-10T00:00:00.000Z,3547302,30,Anthony Gill,0,0,0,0,0,0
1,0,2,4,2,4,2,4,4,20,0,1,10,2,0,2,3277398,2023-11-10T00:00:00.000Z,56677844,30,Bilal Coulibaly,0,12,13,11,3,11.9
0,0,4,3,3,6,5,2,2,16,0,2,15,4,0,0,3277398,2023-11-10T00:00:00.000Z,17896045,30,Corey Kispert,0,19,19,15,4,19.8
1,4,5,0,0,7,4,3,2,30,4,4,10,9,2,2,3277398,2023-11-10T00:00:00.000Z,666577,30,Daniel Gafford,6,19,20,11,10,38.3
4,0,0,4,1,6,3,2,2,18,1,1,9,1,0,1,3277398,2023-11-10T00:00:00.000Z,167,30,Danilo Gallinari,0,10,14,13,5,15.2
6,0,2,2,0,3,1,3,2,14,0,3,4,2,1,0,3277398,2023-11-10T00:00:00.000Z,487,30,Delon Wright,1,6,12,10,8,18.4
5,1,5,4,1,9,5,0,0,31,1,2,11,6,1,3,3277398,2023-11-10T00:00:00.000Z,3547242,30,Deni Avdija,2,17,22,16,11,28.7
0,0,0,0,0,0,0,0,0,0,0,0,0,0,0,0,3277398,2023-11-10T00:00:00.000Z,17896106,30,Eugene Omoruyi,0,0,0,0,0,0
0,0,0,0,0,0,0,0,0,0,0,0,0,0,0,0,3277398,2023-11-10T00:00:00.000Z,18677954,30,Jared Butler,0,0,0,0,0,0
0,0,0,0,0,0,0,0,0,0,0,0,0,0,0,0,3277398,2023-11-10T00:00:00.000Z,38124126,30,John Butler Jr.,0,0,0,0,0,0
0,0,0,0,0,0,0,0,0,0,0,0,0,0,0,0,3277398,2023-11-10T00:00:00.000Z,38017687,30,Johnny Davis,0,0,0,0,0,0
6,0,2,5,1,14,6,1,1,31,0,4,14,2,0,3,3277398,2023-11-10T00:00:00.000Z,666848,30,Jordan Poole,0,16,22,20,8,22.4
1,0,5,5,2,17,7,1,1,29,1,1,17,6,0,3,3277398,2023-11-10T00:00:00.000Z,265,30,Kyle Kuzma,0,23,24,18,7,22.7
0,0,0,7,2,10,4,1,1,17,0,3,11,0,0,1,3277398,2023-11-10T00:00:00.000Z,414,30,Landry Shamet,0,11,11,11,0,10
0,0,0,0,0,0,0,0,0,0,0,0,0,0,0,0,3277398,2023-11-10T00:00:00.000Z,337,30,Mike Muscala,0,0,0,0,0,0
0,0,0,0,0,0,0,0,0,0,0,0,0,0,0,0,3277398,2023-11-10T00:00:00.000Z,38017704,30,Patrick Baldwin Jr.,0,0,0,0,0,0
0,0,0,0,0,0,0,0,0,0,0,0,0,0,0,0,3277398,2023-11-10T00:00:00.000Z,38017712,30,Ryan Rollins,0,0,0,0,0,0
4,1,4,4,2,12,6,3,2,34,0,2,16,4,0,0,3277398,2023-11-10T00:00:00.000Z,249,30,Tyus Jones,1,20,24,20,8,29.8
0,0,0,0,0,0,0,0,0,0,0,0,0,0,0,0,3277399,2023-11-10T00:00:00.000Z,219,2,Al Horford,0,0,0,0,0,0
0,0,0,0,0,1,0,0,0,3,1,0,0,1,0,0,3277399,2023-11-10T00:00:00.000Z,17896094,2,Dalano Banton,0,1,1,0,1,1.2
0,0,0,0,0,0,0,0,0,0,0,0,0,0,0,0,3277399,2023-11-10T00:00:00.000Z,38017707,2,JD Davison,0,0,0,0,0,0
0,0,0,0,0,0,0,0,0,0,0,0,0,0,0,0,3277399,2023-11-10T00:00:00.000Z,56677864,2,Jordan Walsh,0,0,0,0,0,0
0,0,0,0,0,0,0,0,0,0,0,0,0,0,0,0,3277399,2023-11-10T00:00:00.000Z,3547279,2,Lamar Stevens,0,0,0,0,0,0
1,1,3,0,0,5,3,1,1,18,6,1,7,9,0,0,3277399,2023-11-10T00:00:00.000Z,261,2,Luke Kornet,1,16,17,8,10,22.3
0,0,0,0,0,0,0,0,0,0,0,0,0,0,0,0,3277399,2023-11-10T00:00:00.000Z,3547295,2,Nathan Knight,0,0,0,0,0,0
0,0,0,0,0,0,0,0,0,0,0,0,0,0,0,0,3277399,2023-11-10T00:00:00.000Z,17553967,2,Neemias Queta,0,0,0,0,0,0
3,0,1,7,2,10,5,2,1,30,4,1,13,5,1,0,3277399,2023-11-10T00:00:00.000Z,3547276,2,Payton Pritchard,1,18,21,16,8,26.5
1,0,1,10,5,10,5,0,0,25,1,1,15,2,0,0,3277399,2023-11-10T00:00:00.000Z,17896060,2,Sam Hauser,0,17,18,16,3,18.9
0,0,3,6,3,13,4,0,0,25,2,3,11,5,0,1,3277399,2023-11-10T00:00:00.000Z,666679,3,Cameron Johnson,0,16,16,11,5,16
2,1,1,5,3,6,3,0,0,28,2,4,9,3,0,0,3277399,2023-11-10T00:00:00.000Z,158,3,Dorian Finney-Smith,1,12,14,11,5,18.6
1,0,5,6,1,11,4,3,3,28,0,2,12,5,0,2,3277399,2023-11-10T00:00:00.000Z,61,3,Mikal Bridges,0,17,18,13,6,17.5
0,0,0,0,0,0,0,0,0,0,0,0,0,0,0,0,3277399,2023-11-10T00:00:00.000Z,56677843,3,Noah Clowney,0,0,0,0,0,0
4,0,3,3,1,3,1,0,0,27,0,3,3,3,0,1,3277399,2023-11-10T00:00:00.000Z,351,3,Royce O'Neale,0,6,10,7,7,11.6
2,0,0,3,1,5,1,2,2,14,0,0,5,0,1,0,3277400,2023-11-10T00:00:00.000Z,213,11,Aaron Holiday,1,5,7,7,2,11
3,1,4,2,0,15,11,5,2,34,4,3,24,8,2,4,3277400,2023-11-10T00:00:00.000Z,17896062,11,Alperen Sengun,3,32,35,27,11,43.1
0,0,0,0,0,0,0,0,0,0,0,0,0,0,0,0,3277400,2023-11-10T00:00:00.000Z,56677831,11,Cam Whitmore,0,0,0,0,0,0
2,1,2,1,1,7,3,5,3,21,0,5,10,2,2,0,3277400,2023-11-10T00:00:00.000Z,66,11,Dillon Brooks,3,12,14,12,4,24.4
8,1,2,9,4,15,7,2,2,40,1,2,20,3,1,1,3277400,2023-11-10T00:00:00.000Z,458,11,Fred VanVleet,2,23,31,28,11,40.6
2,0,6,4,1,8,2,1,1,23,1,3,6,7,0,2,3277400,2023-11-10T00:00:00.000Z,38017684,11,Jabari Smith Jr.,0,13,15,8,9,15.4
2,0,3,4,1,7,3,0,0,24,0,4,7,3,3,0,3277400,2023-11-10T00:00:00.000Z,3547301,11,Jae'Sean Tate,3,10,12,9,5,22.6
1,0,4,8,2,18,7,10,9,35,0,1,25,4,0,1,3277400,2023-11-10T00:00:00.000Z,17895966,11,Jalen Green,0,29,30,26,5,30.3
5,1,6,11,3,24,11,9,6,38,0,2,31,6,0,4,3277400,2023-11-10T00:00:00.000Z,227,19,Brandon Ingram,1,37,42,36,11,44.7
2,0,8,3,0,6,2,6,6,41,2,2,10,10,1,2,3277400,2023-11-10T00:00:00.000Z,38017677,19,Dyson Daniels,1,20,22,12,12,26
2,4,6,1,1,12,7,1,0,29,3,6,15,9,0,2,3277400,2023-11-10T00:00:00.000Z,455,19,Jonas Valanciunas,4,24,26,17,11,38.8
1,0,7,8,3,11,4,4,3,41,0,6,14,7,2,3,3277400,2023-11-10T00:00:00.000Z,56677837,19,Jordan Hawkins,2,21,22,15,8,26.9
1,1,6,0,0,16,8,11,8,34,2,5,24,8,0,5,3277400,2023-11-10T00:00:00.000Z,666969,19,Zion Williamson,1,32,33,25,9,33.1
8,2,4,13,7,28,14,3,2,38,0,3,37,4,1,3,3277401,2023-11-10T00:00:00.000Z,3547287,15,Desmond Bane,3,41,49,45,12,59.8
2,0,2,2,0,13,7,0,0,23,2,2,14,4,0,2,3277401,2023-11-10T00:00:00.000Z,231,15,Jaren Jackson Jr.,0,18,20,16,6,19.8
0,0,0,0,0,0,0,0,0,0,0,0,0,0,0,0,3277401,2023-11-10T00:00:00.000Z,56677842,29,Brice Sensabaugh,0,0,0,0,0,0
6,0,1,2,0,8,3,4,4,18,1,0,10,2,1,3,3277401,2023-11-10T00:00:00.000Z,413,29,Collin Sexton,1,12,18,16,8,21.4
0,4,3,3,3,6,5,7,5,38,0,2,18,3,0,3,3277401,2023-11-10T00:00:00.000Z,101,29,John Collins,4,21,21,18,3,30.6
0,0,0,0,0,0,0,0,0,0,0,0,0,0,0,0,3277401,2023-11-10T00:00:00.000Z,38017630,29,Johnny Juzang,0,0,0,0,0,0
4,1,2,5,2,16,9,6,6,36,2,1,26,4,2,3,3277401,2023-11-10T00:00:00.000Z,100,29,Jordan Clarkson,3,30,34,30,8,42.8
0,0,0,0,0,0,0,0,0,0,0,0,0,0,0,0,3277401,2023-11-10T00:00:00.000Z,17896023,29,Josh Christopher,0,0,0,0,0,0
11,1,3,6,1,12,2,2,2,30,0,1,7,3,0,2,3277401,2023-11-10T00:00:00.000Z,56677834,29,Keyonte George,1,10,21,18,14,28.1
0,0,0,0,0,0,0,0,0,0,0,0,0,0,0,0,3277401,2023-11-10T00:00:00.000Z,139,29,Kris Dunn,0,0,0,0,0,0
1,2,7,9,4,13,8,6,6,37,0,3,26,7,2,3,3277401,2023-11-10T00:00:00.000Z,297,29,Lauri Markkanen,4,33,34,27,8,44.9
0,0,0,0,0,0,0,0,0,0,0,0,0,0,0,0,3277401,2023-11-10T00:00:00.000Z,666881,29,Luka Samanic,0,0,0,0,0,0
0,0,0,0,0,0,0,0,0,0,0,0,0,0,0,0,3277401,2023-11-10T00:00:00.000Z,19465584,29,Micah Potter,0,0,0,0,0,0
1,2,5,5,3,8,6,0,0,30,1,3,15,6,1,1,3277401,2023-11-10T00:00:00.000Z,38017620,29,Ochai Agbaji,3,21,22,16,7,31.7
0,0,0,0,0,0,0,0,0,0,0,0,0,0,0,0,3277401,2023-11-10T00:00:00.000Z,11891374,29,Omer Yurtseven,0,0,0,0,0,0
2,1,2,5,3,7,4,2,2,18,1,2,13,3,1,1,3277401,2023-11-10T00:00:00.000Z,666650,29,Talen Horton-Tucker,2,16,18,15,5,24.6
0,0,0,0,0,0,0,0,0,0,0,0,0,0,0,0,3277401,2023-11-10T00:00:00.000Z,56677824,29,Taylor Hendricks,0,0,0,0,0,0
0,0,0,0,0,0,0,0,0,0,0,0,0,0,0,0,3277401,2023-11-10T00:00:00.000Z,38017705,29,Walker Kessler,0,0,0,0,0,0
5,1,5,8,2,21,9,11,8,37,2,1,28,7,2,4,3277402,2023-11-10T00:00:00.000Z,3547238,18,Anthony Edwards,3,35,40,33,12,48.9
0,0,0,0,0,0,0,0,0,0,0,0,0,0,0,0,3277402,2023-11-10T00:00:00.000Z,17895968,18,Daishen Nix,0,0,0,0,0,0
0,0,3,2,0,11,5,0,0,26,2,6,10,5,2,0,3277402,2023-11-10T00:00:00.000Z,3547259,18,Jaden McDaniels,2,15,15,10,5,22
0,0,0,0,0,0,0,0,0,0,0,0,0,0,0,0,3277402,2023-11-10T00:00:00.000Z,56677851,18,Jaylen Clark,0,0,0,0,0,0
0,0,0,0,0,0,0,0,0,0,0,0,0,0,0,0,3277402,2023-11-10T00:00:00.000Z,666767,18,Jordan McLaughlin,0,0,0,0,0,0
0,0,0,0,0,0,0,0,0,0,0,0,0,0,0,0,3277402,2023-11-10T00:00:00.000Z,38017715,18,Josh Minott,0,0,0,0,0,0
2,0,11,7,3,21,11,4,4,34,1,1,29,12,0,3,3277402,2023-11-10T00:00:00.000Z,447,18,Karl-Anthony Towns,0,41,43,31,14,43.4
0,0,0,0,0,0,0,0,0,0,0,0,0,0,0,0,3277402,2023-11-10T00:00:00.000Z,56677782,18,Leonard Miller,0,0,0,0,0,0
0,0,0,0,0,0,0,0,0,0,0,0,0,0,0,0,3277402,2023-11-10T00:00:00.000Z,17896056,18,Luka Garza,0,0,0,0,0,0
6,0,1,3,1,7,3,4,4,31,2,3,11,3,0,4,3277402,2023-11-10T00:00:00.000Z,104,18,Mike Conley,0,14,20,17,9,19.6
0,2,2,3,1,7,3,0,0,18,1,1,7,3,0,0,3277402,2023-11-10T00:00:00.000Z,667378,18,Naz Reid,2,10,10,7,3,16.6
4,1,3,1,1,4,3,2,2,19,0,0,9,3,0,0,3277402,2023-11-10T00:00:00.000Z,666400,18,Nickeil Alexander-Walker,1,12,16,13,7,21.6
1,0,6,0,0,10,5,1,1,34,4,3,11,10,1,1,3277402,2023-11-10T00:00:00.000Z,176,18,Rudy Gobert,1,21,22,12,11,26.5
0,0,0,0,0,0,0,0,0,0,0,0,0,0,0,0,3277402,2023-11-10T00:00:00.000Z,38017700,18,Wendell Moore Jr.,0,0,0,0,0,0
0,0,0,0,0,0,0,0,0,0,0,0,0,0,0,0,3277402,2023-11-10T00:00:00.000Z,38017693,27,Blake Wesley,0,0,0,0,0,0
2,0,0,1,0,2,1,0,0,16,0,1,2,0,1,0,3277402,2023-11-10T00:00:00.000Z,359,27,Cedi Osman,1,2,4,4,2,8
0,0,0,0,0,0,0,0,0,0,0,0,0,0,0,0,3277402,2023-11-10T00:00:00.000Z,56677865,27,Charles Bediako,0,0,0,0,0,0
0,0,0,0,0,0,0,0,0,0,0,0,0,0,0,0,3277402,2023-11-10T00:00:00.000Z,180,27,Devonte' Graham,0,0,0,0,0,0
1,0,0,3,1,4,1,0,0,14,0,2,3,0,0,0,3277402,2023-11-10T00:00:00.000Z,305,27,Doug McDermott,0,3,4,4,1,4.5
0,0,0,0,0,0,0,0,0,0,0,0,0,0,0,0,3277402,2023-11-10T00:00:00.000Z,38017649,27,Julian Champagnie,0,0,0,0,0,0
1,0,2,4,0,11,3,0,0,16,0,0,6,2,2,0,3277402,2023-11-10T00:00:00.000Z,38017692,27,Malaki Branham,2,8,9,7,3,15.9
0,0,0,0,0,0,0,0,0,0,0,0,0,0,0,0,3277402,2023-11-10T00:00:00.000Z,17896059,27,Sandro Mamukelashvili,0,0,0,0,0,0
0,0,0,0,0,0,0,0,0,0,0,0,0,0,0,0,3277402,2023-11-10T00:00:00.000Z,56677817,27,Sidy Cissoko,0,0,0,0,0,0
0,0,0,0,0,0,0,0,0,0,0,0,0,0,0,0,3277402,2023-11-10T00:00:00.000Z,56677870,27,Sir'Jabari Rice,0,0,0,0,0,0
4,1,4,1,0,8,4,0,0,26,0,1,8,4,1,2,3277402,2023-11-10T00:00:00.000Z,3547274,27,Tre Jones,2,12,16,12,8,22.8
0,0,0,0,0,0,0,0,0,0,0,0,0,0,0,0,3277403,2023-11-10T00:00:00.000Z,17554004,7,AJ Lawson,0,0,0,0,0,0
6,0,1,3,2,7,3,0,0,18,1,3,8,2,0,0,3277403,2023-11-10T00:00:00.000Z,151,7,Dante Exum,0,10,16,14,8,19.4
0,0,0,0,0,0,0,0,0,0,0,0,0,0,0,0,3277403,2023-11-10T00:00:00.000Z,56677873,7,Dexter Dennis,0,0,0,0,0,0
4,0,1,0,0,3,2,5,5,22,4,3,9,5,1,1,3277403,2023-11-10T00:00:00.000Z,379,7,Dwight Powell,1,14,18,13,9,23
0,0,2,2,1,8,5,1,0,12,0,1,11,2,0,2,3277403,2023-11-10T00:00:00.000Z,38017679,7,Jaden Hardy,0,13,13,11,2,11.4
3,0,0,4,1,4,1,0,0,18,0,2,3,0,0,0,3277403,2023-11-10T00:00:00.000Z,3547258,7,Josh Green,0,3,6,6,3,7.5
0,0,0,0,0,0,0,0,0,0,0,0,0,0,0,0,3277403,2023-11-10T00:00:00.000Z,329,7,Markieff Morris,0,0,0,0,0,0
0,0,0,0,0,0,0,0,0,0,0,0,0,0,0,0,3277403,2023-11-10T00:00:00.000Z,257,7,Maxi Kleber,0,0,0,0,0,0
0,0,0,0,0,1,0,2,1,5,1,1,1,1,0,0,3277403,2023-11-10T00:00:00.000Z,56677859,7,Olivier-Maxence Prosper,0,2,2,1,1,2.2
0,0,0,0,0,0,0,0,0,0,0,0,0,0,0,0,3277403,2023-11-10T00:00:00.000Z,217,7,Richaun Holmes,0,0,0,0,0,0
3,0,3,8,2,13,6,3,3,27,0,0,17,3,0,0,3277403,2023-11-10T00:00:00.000Z,191,7,Tim Hardaway Jr.,0,20,23,20,6,25.1
1,2,3,0,0,9,5,4,2,22,5,3,12,8,0,1,3277403,2023-11-10T00:00:00.000Z,493,13,Ivica Zubac,2,20,21,13,9,28.1
3,0,5,3,2,6,3,6,6,29,0,0,14,5,2,2,3277403,2023-11-10T00:00:00.000Z,192,13,James Harden,2,19,22,17,8,28.5
0,0,0,0,0,0,0,0,0,0,0,0,0,0,0,0,3277403,2023-11-10T00:00:00.000Z,17896051,13,Joshua Primo,0,0,0,0,0,0
4,0,2,4,2,15,8,8,8,29,1,2,26,3,0,2,3277403,2023-11-10T00:00:00.000Z,274,13,Kawhi Leonard,0,29,33,30,7,33.6
2,0,3,7,1,12,3,1,1,23,0,3,8,3,1,2,3277403,2023-11-10T00:00:00.000Z,172,13,Paul George,1,11,13,10,5,15.6
0,0,0,0,0,0,0,0,0,0,0,0,0,0,0,0,3277404,2023-11-10T00:00:00.000Z,56677867,14,Alex Fudge,0,0,0,0,0,0
4,1,7,0,0,14,5,8,8,36,4,3,18,11,0,1,3277404,2023-11-10T00:00:00.000Z,117,14,Anthony Davis,1,29,33,22,15,39.2
7,0,1,4,2,11,6,1,1,35,0,1,15,1,1,2,3277404,2023-11-10T00:00:00.000Z,17553995,14,Austin Reaves,1,16,23,22,8,27.7
0,1,6,1,1,5,2,0,0,18,3,0,5,9,0,1,3277404,2023-11-10T00:00:00.000Z,486,14,Christian Wood,1,14,14,5,9,17.8
0,0,0,0,0,0,0,0,0,0,0,0,0,0,0,0,3277404,2023-11-10T00:00:00.000Z,56677738,14,Colin Castleton,0,0,0,0,0,0
9,1,3,3,0,12,6,9,7,29,0,4,19,3,0,1,3277404,2023-11-10T00:00:00.000Z,405,14,D'Angelo Russell,1,22,31,28,12,38.1
0,0,0,0,0,0,0,0,0,0,0,0,0,0,0,0,3277404,2023-11-10T00:00:00.000Z,56677868,14,D'Moi Hodge,0,0,0,0,0,0
0,0,0,0,0,0,0,0,0,0,0,0,0,0,0,0,3277404,2023-11-10T00:00:00.000Z,1603383,14,Gabe Vincent,0,0,0,0,0,0
0,0,0,0,0,0,0,0,0,0,0,0,0,0,0,0,3277404,2023-11-10T00:00:00.000Z,56677835,14,Jalen Hood-Schifino,0,0,0,0,0,0
0,0,0,0,0,0,0,0,0,0,0,0,0,0,0,0,3277404,2023-11-10T00:00:00.000Z,457,14,Jarred Vanderbilt,0,0,0,0,0,0
0,0,1,0,0,1,1,0,0,5,0,1,2,1,0,1,3277404,2023-11-10T00:00:00.000Z,666626,14,Jaxson Hayes,0,3,3,2,1,2.2
0,0,0,0,0,0,0,0,0,0,0,0,0,0,0,0,3277404,2023-11-10T00:00:00.000Z,38017697,14,Max Christie,0,0,0,0,0,0
0,0,0,0,0,0,0,0,0,0,0,0,0,0,0,0,3277404,2023-11-10T00:00:00.000Z,56677836,14,Maxwell Lewis,0,0,0,0,0,0
1,1,3,3,1,6,3,1,0,20,0,3,7,3,4,1,3277404,2023-11-10T00:00:00.000Z,666609,14,Rui Hachimura,5,10,11,8,4,26.1
0,2,1,4,0,8,3,2,1,33,0,4,7,1,0,0,3277404,2023-11-10T00:00:00.000Z,383,14,Taurean Prince,2,8,8,7,1,14.2
0,0,0,0,0,0,0,0,0,0,0,0,0,0,0,0,3277404,2023-11-10T00:00:00.000Z,666451,24,Bol Bol,0,0,0,0,0,0
2,0,2,4,2,17,9,6,4,31,2,4,24,4,2,2,3277404,2023-11-10T00:00:00.000Z,37,24,Bradley Beal,2,28,30,26,6,35.8
1,1,3,0,0,3,1,0,0,14,2,2,2,5,0,2,3277404,2023-11-10T00:00:00.000Z,147,24,Drew Eubanks,1,7,8,3,6,10.5
4,0,7,4,1,8,4,0,0,32,2,6,9,9,1,2,3277404,2023-11-10T00:00:00.000Z,8,24,Grayson Allen,1,18,22,13,13,26.8
7,0,6,3,2,8,4,7,4,33,3,3,14,9,1,2,3277404,2023-11-10T00:00:00.000Z,349,24,Jusuf Nurkic,1,23,30,21,16,36.3
0,0,3,6,1,11,4,2,2,30,2,0,11,5,2,0,3277404,2023-11-10T00:00:00.000Z,32,24,Keita Bates-Diop,2,16,16,11,5,23
5,0,8,6,4,27,13,10,8,38,1,4,38,9,0,4,3277404,2023-11-10T00:00:00.000Z,140,24,Kevin Durant,0,47,52,43,14,52.3
0,0,0,0,0,0,0,0,0,0,0,0,0,0,0,0,3277404,2023-11-10T00:00:00.000Z,3547095,24,Udoka Azubuike,0,0,0,0,0,0
0,0,0,3,1,4,1,0,0,14,1,5,3,1,0,0,3277404,2023-11-10T00:00:00.000Z,470,24,Yuta Watanabe,0,4,4,3,1,4.2
0,0,0,0,0,0,0,0,0,0,0,0,0,0,0,0,3277405,2023-11-10T00:00:00.000Z,17896078,21,Aaron Wiggins,0,0,0,0,0,0
2,1,2,5,2,7,3,0,0,24,1,1,8,3,0,0,3277405,2023-11-10T00:00:00.000Z,56677833,21,Cason Wallace,1,11,13,10,5,17.6
1,1,6,3,0,12,5,3,2,30,1,2,12,7,1,4,3277405,2023-11-10T00:00:00.000Z,38017685,21,Chet Holmgren,2,19,20,13,8,23.9
0,0,0,0,0,0,0,0,0,0,0,0,0,0,0,0,3277405,2023-11-10T00:00:00.000Z,44,21,Davis Bertans,0,0,0,0,0,0
0,0,1,8,3,9,3,0,0,20,0,0,9,1,1,1,3277405,2023-11-10T00:00:00.000Z,3547272,21,Isaiah Joe,1,10,10,9,1,12.2
1,0,5,3,0,14,6,2,2,31,0,1,14,5,1,3,3277405,2023-11-10T00:00:00.000Z,38017703,21,Jalen Williams,1,19,20,15,6,21.5
2,0,4,2,0,2,0,2,1,18,0,3,1,4,1,0,3277405,2023-11-10T00:00:00.000Z,38017706,21,Jaylin Williams,1,5,7,3,6,11.8
5,0,3,1,0,10,6,1,1,27,1,1,13,4,0,4,3277405,2023-11-10T00:00:00.000Z,17896065,21,Josh Giddey,0,17,22,18,9,21.3
0,0,0,0,0,0,0,0,0,0,0,0,0,0,0,0,3277405,2023-11-10T00:00:00.000Z,480,21,Kenrich Williams,0,0,0,0,0,0
0,0,0,0,0,0,0,0,0,0,0,0,0,0,0,0,3277405,2023-11-10T00:00:00.000Z,56677853,21,Keyontae Johnson,0,0,0,0,0,0
2,0,0,2,0,2,0,0,0,19,0,1,0,0,0,0,3277405,2023-11-10T00:00:00.000Z,27924547,21,Lindy Waters III,0,0,2,2,2,3
2,1,4,3,2,5,2,2,2,25,2,4,8,6,3,2,3277405,2023-11-10T00:00:00.000Z,666541,21,Luguentz Dort,4,14,16,10,8,28.2
0,0,0,0,0,0,0,0,0,0,0,0,0,0,0,0,3277405,2023-11-10T00:00:00.000Z,24572055,21,Olivier Sarr,0,0,0,0,0,0
1,0,1,1,0,1,0,0,0,8,0,1,0,1,0,0,3277405,2023-11-10T00:00:00.000Z,38017716,21,Ousmane Dieng,0,1,2,1,2,2.7
6,2,7,2,0,25,14,6,5,38,0,1,33,7,2,2,3277405,2023-11-10T00:00:00.000Z,175,21,Shai Gilgeous-Alexander,4,40,46,39,13,60.4
0,0,0,0,0,0,0,0,0,0,0,0,0,0,0,0,3277405,2023-11-10T00:00:00.000Z,17896036,21,Tre Mann,0,0,0,0,0,0
0,0,1,3,2,3,2,0,0,8,0,1,6,1,1,0,3277405,2023-11-10T00:00:00.000Z,4197162,26,Aleksandar Vezenkov,1,7,7,6,1,10.2
0,0,1,2,0,2,0,0,0,5,0,2,0,1,1,1,3277405,2023-11-10T00:00:00.000Z,17896030,26,Chris Duarte,1,1,1,0,1,3.2
0,0,0,0,0,0,0,0,0,0,0,0,0,0,0,0,3277405,2023-11-10T00:00:00.000Z,56677845,26,Colby Jones,0,0,0,0,0,0
1,0,1,6,1,6,1,0,0,16,0,1,3,1,0,0,3277405,2023-11-10T00:00:00.000Z,17553994,26,Davion Mitchell,0,4,5,4,2,5.7
0,0,0,0,0,0,0,0,0,0,0,0,0,0,0,0,3277405,2023-11-10T00:00:00.000Z,161,26,De'Aaron Fox,0,0,0,0,0,0
13,2,7,0,0,15,7,6,3,38,6,5,17,13,1,5,3277405,2023-11-10T00:00:00.000Z,406,26,Domantas Sabonis,3,30,43,30,26,56.1
0,0,0,0,0,0,0,0,0,0,0,0,0,0,0,0,3277405,2023-11-10T00:00:00.000Z,17895941,26,Filip Petrusev,0,0,0,0,0,0
1,0,2,4,0,8,1,2,2,26,2,1,4,4,0,1,3277405,2023-11-10T00:00:00.000Z,30,26,Harrison Barnes,0,8,9,5,5,9.3
0,0,0,0,0,0,0,0,0,0,0,0,0,0,0,0,3277405,2023-11-10T00:00:00.000Z,56677862,26,Jalen Slawson,0,0,0,0,0,0
0,0,0,0,0,0,0,0,0,0,0,0,0,0,0,0,3277405,2023-11-10T00:00:00.000Z,17895990,26,Jordan Ford,0,0,0,0,0,0
1,1,7,10,3,17,8,5,5,40,4,1,24,11,3,3,3277405,2023-11-10T00:00:00.000Z,38017688,26,Keegan Murray,4,35,36,25,12,47.7
2,3,3,7,1,8,2,4,3,31,1,3,8,4,0,1,3277405,2023-11-10T00:00:00.000Z,38017714,26,Keon Ellis,3,12,14,10,6,23.8
0,0,0,0,0,0,0,0,0,3,0,0,0,0,0,0,3277405,2023-11-10T00:00:00.000Z,17896044,26,Kessler Edwards,0,0,0,0,0,0
2,1,9,10,4,19,11,2,2,34,0,4,28,9,3,2,3277405,2023-11-10T00:00:00.000Z,221,26,Kevin Huerter,4,37,39,30,11,51.8
8,0,2,5,2,12,5,0,0,29,0,3,12,2,1,2,3277405,2023-11-10T00:00:00.000Z,324,26,Malik Monk,1,14,22,20,10,27.4
0,0,0,0,0,0,0,0,0,0,0,0,0,0,0,0,3277405,2023-11-10T00:00:00.000Z,290,26,Trey Lyles,0,0,0,0,0,0
0,0,0,0,0,0,0,0,0,4,0,0,0,0,0,0,1037721,2023-11-11T00:00:00.000Z,56677854,17,Chris Livingston,0,0,0,0,0,0
0,0,0,0,0,0,0,0,0,0,0,0,0,0,0,0,1037721,2023-11-11T00:00:00.000Z,278,17,Damian Lillard,0,0,0,0,0,0
0,0,0,0,0,0,0,0,0,0,0,0,0,0,0,0,1037721,2023-11-11T00:00:00.000Z,666960,17,Lindell Wigginton,0,0,0,0,0,0
0,0,0,0,0,0,0,0,0,0,0,0,0,0,0,0,1037721,2023-11-11T00:00:00.000Z,666453,17,Marques Bolden,0,0,0,0,0,0
0,0,0,0,0,0,0,0,0,0,0,0,0,0,0,0,1037721,2023-11-11T00:00:00.000Z,284,17,Robin Lopez,0,0,0,0,0,0
0,0,0,0,0,0,0,0,0,0,0,0,0,0,0,0,1037721,2023-11-11T00:00:00.000Z,38017691,17,TyTy Washington Jr.,0,0,0,0,0,0
4,0,6,3,1,5,3,0,0,24,1,2,7,7,0,0,1037722,2023-11-11T00:00:00.000Z,219,2,Al Horford,0,14,18,11,11,21.4
0,0,0,1,0,1,0,0,0,6,0,0,0,0,0,0,1037722,2023-11-11T00:00:00.000Z,17896094,2,Dalano Banton,0,0,0,0,0,0
0,0,0,0,0,0,0,0,0,0,0,0,0,0,0,0,1037722,2023-11-11T00:00:00.000Z,38017707,2,JD Davison,0,0,0,0,0,0
0,0,0,0,0,0,0,0,0,0,0,0,0,0,0,0,1037722,2023-11-11T00:00:00.000Z,56677864,2,Jordan Walsh,0,0,0,0,0,0
7,2,3,2,0,9,4,0,0,30,0,2,8,3,1,4,1037722,2023-11-11T00:00:00.000Z,214,2,Jrue Holiday,3,11,18,15,10,27.1
0,0,0,0,0,0,0,0,0,0,0,0,0,0,0,0,1037722,2023-11-11T00:00:00.000Z,3547279,2,Lamar Stevens,0,0,0,0,0,0
1,0,5,0,0,1,1,0,0,9,0,1,2,5,0,0,1037722,2023-11-11T00:00:00.000Z,261,2,Luke Kornet,0,7,8,3,6,9.5
0,0,0,0,0,0,0,0,0,0,0,0,0,0,0,0,1037722,2023-11-11T00:00:00.000Z,3547295,2,Nathan Knight,0,0,0,0,0,0
0,0,0,0,0,0,0,0,0,0,0,0,0,0,0,0,1037722,2023-11-11T00:00:00.000Z,17553967,2,Neemias Queta,0,0,0,0,0,0
0,0,0,0,0,0,0,0,0,5,0,0,0,0,0,0,1037722,2023-11-11T00:00:00.000Z,666468,2,Oshae Brissett,0,0,0,0,0,0
4,0,3,3,1,5,2,2,2,24,3,1,7,6,0,1,1037722,2023-11-11T00:00:00.000Z,3547276,2,Payton Pritchard,0,13,17,11,10,19.2
0,0,4,6,4,6,4,0,0,18,0,2,12,4,0,0,1037722,2023-11-11T00:00:00.000Z,17896060,2,Sam Hauser,0,16,16,12,4,16.8
0,0,0,2,0,2,0,0,0,5,0,0,0,0,0,1,1037722,2023-11-11T00:00:00.000Z,338,2,Svi Mykhailiuk,0,0,0,0,0,-1
1,0,5,3,2,4,2,0,0,22,0,2,6,5,0,0,1037722,2023-11-11T00:00:00.000Z,58,28,Chris Boucher,0,11,12,7,6,13.5
0,0,0,0,0,0,0,0,0,0,0,0,0,0,0,0,1037722,2023-11-11T00:00:00.000Z,38017710,28,Christian Koloko,0,0,0,0,0,0
4,0,1,3,1,7,3,7,7,25,0,3,14,1,1,1,1037722,2023-11-11T00:00:00.000Z,409,28,Dennis Schroder,1,15,19,18,5,23.2
0,0,1,0,0,2,1,0,0,4,0,0,2,1,1,0,1037722,2023-11-11T00:00:00.000Z,436,28,Garrett Temple,1,3,3,2,1,6.2
0,0,0,0,0,0,0,0,0,0,0,0,0,0,0,0,1037722,2023-11-11T00:00:00.000Z,3089,28,Gary Trent Jr.,0,0,0,0,0,0
1,0,1,2,0,4,1,2,2,15,0,1,4,1,0,1,1037722,2023-11-11T00:00:00.000Z,56677828,28,Gradey Dick,0,5,6,5,2,5.7
2,0,1,0,0,10,6,0,0,21,2,3,12,3,0,1,1037722,2023-11-11T00:00:00.000Z,373,28,Jakob Poeltl,0,15,17,14,5,17.6
0,0,1,0,0,2,0,0,0,9,0,2,0,1,0,0,1037722,2023-11-11T00:00:00.000Z,666762,28,Jalen McDaniels,0,1,1,0,1,1.2
0,0,0,0,0,0,0,0,0,0,0,0,0,0,0,0,1037722,2023-11-11T00:00:00.000Z,56677805,28,Javon Freeman-Liberty,0,0,0,0,0,0
1,0,1,4,2,7,5,1,0,23,0,0,12,1,0,1,1037722,2023-11-11T00:00:00.000Z,3547275,28,Malachi Flynn,0,13,14,13,2,13.7
0,0,0,0,0,0,0,0,0,0,0,0,0,0,0,0,1037722,2023-11-11T00:00:00.000Z,56677869,28,Markquis Nowell,0,0,0,0,0,0
2,0,2,8,2,13,3,0,0,28,1,0,8,3,1,0,1037722,2023-11-11T00:00:00.000Z,18,28,OG Anunoby,1,11,13,10,5,17.6
0,0,3,2,1,2,1,0,0,14,0,1,3,3,1,0,1037722,2023-11-11T00:00:00.000Z,376,28,Otto Porter Jr.,1,6,6,3,3,9.6
3,0,5,4,0,17,6,6,5,28,2,0,17,7,3,3,1037722,2023-11-11T00:00:00.000Z,416,28,Pascal Siakam,3,24,27,20,10,35.9
5,0,5,2,0,5,1,0,0,18,0,1,2,5,0,0,1037722,2023-11-11T00:00:00.000Z,3547249,28,Precious Achiuwa,0,7,12,7,10,15.5
0,0,0,0,0,0,0,0,0,0,0,0,0,0,0,0,1037722,2023-11-11T00:00:00.000Z,38017717,28,Ron Harper Jr.,0,0,0,0,0,0
4,1,4,9,2,15,4,0,0,29,1,1,10,5,1,1,1037722,2023-11-11T00:00:00.000Z,17896055,28,Scottie Barnes,2,15,19,14,9,27
2,0,0,0,0,3,2,0,0,4,1,0,4,1,0,0,1037722,2023-11-11T00:00:00.000Z,489,28,Thaddeus Young,0,5,7,6,3,8.2
0,0,0,0,0,0,0,0,0,0,0,0,0,0,0,0,1037723,2023-11-11T00:00:00.000Z,38017689,1,AJ Griffin,0,0,0,0,0,0
1,0,3,12,5,13,5,0,0,29,0,4,15,3,0,2,1037723,2023-11-11T00:00:00.000Z,53,1,Bogdan Bogdanovic,0,18,19,16,4,18.1
0,0,0,0,0,0,0,0,0,0,0,0,0,0,0,0,1037723,2023-11-11T00:00:00.000Z,666564,1,Bruno Fernando,0,0,0,0,0,0
0,2,5,0,0,6,4,0,0,24,7,3,8,12,1,0,1037723,2023-11-11T00:00:00.000Z,83,1,Clint Capela,3,20,20,8,12,31.4
2,1,5,4,0,11,4,2,2,36,0,4,10,5,1,3,1037723,2023-11-11T00:00:00.000Z,666656,1,De'Andre Hunter,2,15,17,12,7,22
5,1,5,9,5,16,9,1,0,36,0,1,23,5,3,3,1037723,2023-11-11T00:00:00.000Z,334,1,Dejounte Murray,4,28,33,28,10,45.5
0,0,0,0,0,0,0,0,0,0,0,0,0,0,0,0,1037723,2023-11-11T00:00:00.000Z,666754,1,Garrison Mathews,0,0,0,0,0,0
2,0,4,3,1,8,4,0,0,22,0,2,9,4,0,3,1037723,2023-11-11T00:00:00.000Z,17896040,1,Jalen Johnson,0,13,15,11,6,13.8
0,0,0,0,0,0,0,0,0,0,0,0,0,0,0,0,1037723,2023-11-11T00:00:00.000Z,56677838,1,Kobe Bufkin,0,0,0,0,0,0
0,0,0,0,0,0,0,0,0,0,0,0,0,0,0,0,1037723,2023-11-11T00:00:00.000Z,56677875,1,Miles Norris,0,0,0,0,0,0
0,0,0,0,0,0,0,0,0,0,0,0,0,0,0,0,1037723,2023-11-11T00:00:00.000Z,56677806,1,Mouhamed Gueye,0,0,0,0,0,0
2,2,3,0,0,3,0,2,2,24,4,2,2,7,0,0,1037723,2023-11-11T00:00:00.000Z,3547244,1,Onyeka Okongwu,2,9,11,4,9,19.4
0,0,0,0,0,0,0,0,0,0,0,0,0,0,0,0,1037723,2023-11-11T00:00:00.000Z,319,1,Patty Mills,0,0,0,0,0,0
0,0,5,7,2,9,3,0,0,24,3,0,8,8,0,4,1037723,2023-11-11T00:00:00.000Z,3547256,1,Saddiq Bey,0,16,16,8,8,13.6
0,0,0,0,0,0,0,0,0,0,0,0,0,0,0,0,1037723,2023-11-11T00:00:00.000Z,56677855,1,Seth Lundy,0,0,0,0,0,0
11,0,2,9,3,19,7,11,10,38,0,0,27,2,1,5,1037723,2023-11-11T00:00:00.000Z,490,1,Trae Young,1,29,40,38,13,43.9
0,0,0,0,0,0,0,0,0,0,0,0,0,0,0,0,1037723,2023-11-11T00:00:00.000Z,3547297,1,Trent Forrest,0,0,0,0,0,0
0,0,1,2,2,2,2,2,1,7,1,3,7,2,0,1,1037723,2023-11-11T00:00:00.000Z,301,1,Wesley Matthews,0,9,9,7,2,8.4
4,2,12,0,0,12,9,8,8,39,4,2,26,16,2,3,1037723,2023-11-11T00:00:00.000Z,4,16,Bam Adebayo,4,42,46,30,20,60.2
0,0,0,0,0,0,0,0,0,0,0,0,0,0,0,0,1037723,2023-11-11T00:00:00.000Z,666747,16,Caleb Martin,0,0,0,0,0,0
0,0,0,0,0,0,0,0,0,0,0,0,0,0,0,0,1037723,2023-11-11T00:00:00.000Z,38017736,16,Cole Swider,0,0,0,0,0,0
2,1,1,3,1,8,4,0,0,28,1,3,9,2,3,2,1037723,2023-11-11T00:00:00.000Z,19465585,16,Dru Smith,4,11,13,11,4,24.4
2,0,3,10,1,15,5,0,0,30,0,3,11,3,1,1,1037723,2023-11-11T00:00:00.000Z,397,16,Duncan Robinson,1,14,16,13,5,19.6
5,1,5,5,0,13,3,7,5,34,1,2,11,6,2,1,1037723,2023-11-11T00:00:00.000Z,3092,16,Haywood Highsmith,3,17,22,16,11,33.7
4,0,2,7,2,17,8,2,2,38,1,3,20,3,1,3,1037723,2023-11-11T00:00:00.000Z,56677785,16,Jaime Jaquez Jr.,1,23,27,24,7,29.6
0,0,0,0,0,0,0,0,0,1,0,0,0,0,0,0,1037723,2023-11-11T00:00:00.000Z,38017734,16,Jamal Cain,0,0,0,0,0,0
0,0,0,0,0,0,0,0,0,0,0,0,0,0,0,0,1037723,2023-11-11T00:00:00.000Z,79,16,Jimmy Butler,0,0,0,0,0,0
0,0,2,4,3,7,6,1,1,23,0,0,16,2,0,1,1037723,2023-11-11T00:00:00.000Z,391,16,Josh Richardson,0,18,18,16,2,17.4
2,0,4,3,1,4,2,2,2,14,0,0,7,4,0,1,1037723,2023-11-11T00:00:00.000Z,285,16,Kevin Love,0,11,13,9,6,13.8
4,0,3,6,4,8,4,5,5,33,0,1,17,3,1,3,1037723,2023-11-11T00:00:00.000Z,286,16,Kyle Lowry,1,20,24,21,7,26.6
0,0,0,0,0,0,0,0,0,0,0,0,0,0,0,0,1037723,2023-11-11T00:00:00.000Z,38017696,16,Nikola Jovic,0,0,0,0,0,0
0,0,0,0,0,0,0,0,0,0,0,0,0,0,0,0,1037723,2023-11-11T00:00:00.000Z,39398582,16,Orlando Robinson,0,0,0,0,0,0
0,0,0,0,0,0,0,0,0,0,0,0,0,0,0,0,1037723,2023-11-11T00:00:00.000Z,3547257,16,R.J. Hampton,0,0,0,0,0,0
0,0,0,0,0,0,0,0,0,0,0,0,0,0,0,0,1037723,2023-11-11T00:00:00.000Z,74,16,Thomas Bryant,0,0,0,0,0,0
0,0,0,0,0,0,0,0,0,0,0,0,0,0,0,0,1037723,2023-11-11T00:00:00.000Z,666633,16,Tyler Herro,0,0,0,0,0,0
3,1,3,7,2,18,8,5,4,36,2,1,22,5,4,0,1037724,2023-11-11T00:00:00.000Z,277,6,Caris LeVert,5,27,30,25,8,47.5
0,0,0,0,0,0,0,6,1,1,0,0,1,0,0,0,1037724,2023-11-11T00:00:00.000Z,56677872,6,Craig Porter,0,1,1,1,0,1
0,0,0,0,0,0,0,0,0,1,0,0,0,0,0,0,1037724,2023-11-11T00:00:00.000Z,248,6,Damian Jones,0,0,0,0,0,0
0,0,7,4,2,4,2,2,2,17,0,6,8,7,0,0,1037724,2023-11-11T00:00:00.000Z,666940,6,Dean Wade,0,15,15,8,7,16.4
0,0,0,0,0,0,0,0,0,1,0,0,0,0,0,0,1037724,2023-11-11T00:00:00.000Z,56677847,6,Emoni Bates,0,0,0,0,0,0
1,0,1,4,0,4,0,0,0,19,1,1,0,2,0,1,1037724,2023-11-11T00:00:00.000Z,344,6,Georges Niang,0,2,3,1,3,2.9
0,0,0,0,0,0,0,0,0,0,0,0,0,0,0,0,1037724,2023-11-11T00:00:00.000Z,3547247,6,Isaac Okoro,0,0,0,0,0,0
0,0,0,0,0,0,0,0,0,0,0,0,0,0,0,0,1037724,2023-11-11T00:00:00.000Z,38017662,6,Isaiah Mobley,0,0,0,0,0,0
0,0,0,0,0,0,0,0,0,0,0,0,0,0,0,0,1037724,2023-11-11T00:00:00.000Z,404,6,Ricky Rubio,0,0,0,0,0,0
0,0,0,0,0,0,0,0,0,0,0,0,0,0,0,0,1037724,2023-11-11T00:00:00.000Z,3547299,6,Sam Merrill,0,0,0,0,0,0
0,0,0,0,0,0,0,0,0,1,0,0,0,0,0,0,1037724,2023-11-11T00:00:00.000Z,444,6,Tristan Thompson,0,0,0,0,0,0
3,0,2,4,1,12,6,2,0,29,3,2,13,5,0,3,1037724,2023-11-11T00:00:00.000Z,475,10,Andrew Wiggins,0,18,21,16,8,20.5
1,1,5,3,0,5,2,1,1,16,0,3,5,5,0,0,1037724,2023-11-11T00:00:00.000Z,407,10,Dario Saric,1,10,11,6,6,15.5
4,0,3,3,2,4,3,0,0,18,2,3,8,5,0,1,1037724,2023-11-11T00:00:00.000Z,185,10,Draymond Green,0,13,17,12,9,19
0,0,3,1,0,4,1,2,1,11,2,0,3,5,0,1,1037724,2023-11-11T00:00:00.000Z,2189,10,Gary Payton II,0,8,8,3,5,8
2,0,10,0,0,2,1,0,0,24,3,5,2,13,0,1,1037724,2023-11-11T00:00:00.000Z,282,10,Kevon Looney,0,15,17,4,15,19.6
1,1,4,5,2,16,5,2,2,28,1,3,14,5,0,3,1037724,2023-11-11T00:00:00.000Z,443,10,Klay Thompson,1,19,20,15,6,21.5
2,1,2,14,4,24,9,8,8,33,1,1,30,3,1,4,1037724,2023-11-11T00:00:00.000Z,115,10,Stephen Curry,2,33,35,32,5,38.6
0,0,0,0,0,3,1,0,0,3,2,0,2,2,0,0,1037725,2023-11-12T00:00:00.000Z,56677848,4,Amari Bailey,0,4,4,2,2,4.4
0,0,2,2,1,6,5,1,0,10,1,0,11,3,0,0,1037725,2023-11-12T00:00:00.000Z,56677823,4,Brandon Miller,0,14,14,11,3,14.6
0,0,0,2,0,4,1,0,0,19,0,0,2,0,0,0,1037725,2023-11-12T00:00:00.000Z,38017708,4,Bryce McGowens,0,2,2,2,0,2
0,0,0,0,0,0,0,0,0,0,0,0,0,0,0,0,1037725,2023-11-12T00:00:00.000Z,666748,4,Cody Martin,0,0,0,0,0,0
0,0,0,0,0,0,0,0,0,0,0,0,0,0,0,0,1037725,2023-11-12T00:00:00.000Z,347,4,Frank Ntilikina,0,0,0,0,0,0
2,0,1,1,0,9,3,0,0,29,0,3,6,1,0,2,1037725,2023-11-12T00:00:00.000Z,204,4,Gordon Hayward,0,7,9,8,3,8.2
2,0,4,0,0,4,2,0,0,17,1,1,4,5,2,0,1037725,2023-11-12T00:00:00.000Z,422,4,Ish Smith,2,9,11,6,7,19
0,0,0,0,0,0,0,0,0,0,0,0,0,0,0,0,1037725,2023-11-12T00:00:00.000Z,17896037,4,James Bouknight,0,0,0,0,0,0
0,1,2,5,2,6,2,2,0,23,2,4,6,4,0,1,1037725,2023-11-12T00:00:00.000Z,18678001,4,JT Thor,1,10,10,6,4,12.8
6,1,4,8,4,20,13,2,2,33,3,2,32,7,1,2,1037725,2023-11-12T00:00:00.000Z,3547239,4,LaMelo Ball,2,39,45,38,13,53.4
0,1,2,1,1,2,2,0,0,6,0,1,5,2,0,0,1037725,2023-11-12T00:00:00.000Z,56677866,4,Leaky Black,1,7,7,5,2,10.4
2,0,2,0,0,5,4,2,2,23,2,3,10,4,2,1,1037725,2023-11-12T00:00:00.000Z,38017698,4,Mark Williams,2,14,16,12,6,22.8
0,0,0,0,0,0,0,0,0,0,0,0,0,0,0,0,1037725,2023-11-12T00:00:00.000Z,62,4,Miles Bridges,0,0,0,0,0,0
0,0,3,0,0,9,7,2,2,22,1,4,16,4,0,2,1037725,2023-11-12T00:00:00.000Z,3547282,4,Nick Richards,0,20,20,16,4,18.8
2,0,0,4,1,6,1,0,0,8,0,0,3,0,0,0,1037725,2023-11-12T00:00:00.000Z,56677846,4,Nick Smith Jr.,0,3,5,5,2,6
3,1,1,5,1,8,1,2,1,22,1,4,4,2,0,2,1037725,2023-11-12T00:00:00.000Z,666950,4,P.J. Washington,1,6,9,7,5,11.9
0,0,0,0,0,0,0,0,0,0,0,0,0,0,0,0,1037725,2023-11-12T00:00:00.000Z,403,4,Terry Rozier,0,0,0,0,0,0
4,0,0,7,2,12,2,0,0,25,2,3,6,2,0,2,1037725,2023-11-12T00:00:00.000Z,3547253,4,Theo Maledon,0,8,12,10,6,12.4
0,0,0,0,0,0,0,0,0,0,0,0,0,0,0,0,1037725,2023-11-12T00:00:00.000Z,17896089,20,Duane Washington Jr.,0,0,0,0,0,0
0,0,0,0,0,0,0,0,0,0,0,0,0,0,0,0,1037725,2023-11-12T00:00:00.000Z,56677795,20,Jacob Toppin,0,0,0,0,0,0
1,0,1,4,2,12,7,4,4,27,0,2,20,1,1,1,1037725,2023-11-12T00:00:00.000Z,73,20,Jalen Brunson,1,21,22,21,2,24.7
2,0,3,2,0,6,3,0,0,27,1,1,6,4,0,0,1037725,2023-11-12T00:00:00.000Z,202,20,Josh Hart,0,10,12,8,6,13.8
5,0,4,4,1,16,8,8,6,27,1,1,23,5,3,3,1037725,2023-11-12T00:00:00.000Z,387,20,Julius Randle,3,28,33,28,10,42.5
0,0,4,0,0,7,5,2,0,24,5,2,10,9,1,0,1037725,2023-11-12T00:00:00.000Z,399,20,Mitchell Robinson,1,19,19,10,9,23.8
1,0,1,5,2,5,2,0,0,23,0,1,6,1,1,0,1037725,2023-11-12T00:00:00.000Z,17895858,20,Quentin Grimes,1,7,8,7,2,11.7
2,1,4,6,4,16,9,3,2,31,0,1,24,4,1,1,1037725,2023-11-12T00:00:00.000Z,666423,20,RJ Barrett,2,28,30,26,6,36.8
0,0,0,0,0,0,0,0,0,0,0,0,0,0,0,0,1037726,2023-11-12T00:00:00.000Z,9051997,3,Armoni Brooks,0,0,0,0,0,0
0,0,0,0,0,0,0,0,0,0,0,0,0,0,0,0,1037726,2023-11-12T00:00:00.000Z,417,3,Ben Simmons,0,0,0,0,0,0
0,0,0,0,0,0,0,0,0,0,0,0,0,0,0,0,1037726,2023-11-12T00:00:00.000Z,17896048,3,Cam Thomas,0,0,0,0,0,0
1,0,5,11,2,16,5,2,2,35,1,0,14,6,0,3,1037726,2023-11-12T00:00:00.000Z,666679,3,Cameron Johnson,0,20,21,15,7,19.7
1,1,5,1,0,6,3,2,2,19,7,1,8,12,1,1,1037726,2023-11-12T00:00:00.000Z,17896038,3,Day'Ron Sharpe,2,20,21,9,13,28.9
6,0,3,2,2,4,2,2,2,19,1,1,8,4,0,4,1037726,2023-11-12T00:00:00.000Z,421,3,Dennis Smith Jr.,0,12,18,14,10,17.8
0,0,1,6,2,7,2,0,0,20,2,5,6,3,0,2,1037726,2023-11-12T00:00:00.000Z,158,3,Dorian Finney-Smith,0,9,9,6,3,7.6
0,0,0,0,0,0,0,0,0,0,0,0,0,0,0,0,1037726,2023-11-12T00:00:00.000Z,174,3,Harry Giles III,0,0,0,0,0,0
0,0,0,0,0,0,0,0,0,0,0,0,0,0,0,0,1037726,2023-11-12T00:00:00.000Z,17896041,3,Keon Johnson,0,0,0,0,0,0
2,0,2,3,1,8,2,0,0,14,0,1,5,2,0,1,1037726,2023-11-12T00:00:00.000Z,464,3,Lonnie Walker IV,0,7,9,7,4,9.4
2,0,9,14,2,29,11,5,3,34,4,0,27,13,1,4,1037726,2023-11-12T00:00:00.000Z,61,3,Mikal Bridges,1,40,42,29,15,44.6
2,4,9,0,0,7,5,0,0,28,4,2,10,13,0,0,1037726,2023-11-12T00:00:00.000Z,666508,3,Nicolas Claxton,4,23,25,12,15,40.6
0,0,0,0,0,0,0,0,0,0,0,0,0,0,0,0,1037726,2023-11-12T00:00:00.000Z,56677843,3,Noah Clowney,0,0,0,0,0,0
4,0,5,7,3,8,3,2,1,31,1,4,10,6,2,2,1037726,2023-11-12T00:00:00.000Z,351,3,Royce O'Neale,2,16,20,14,10,27.2
3,1,4,5,0,10,3,7,6,31,0,2,12,4,2,0,1037726,2023-11-12T00:00:00.000Z,130,3,Spencer Dinwiddie,3,16,19,15,7,30.3
1,0,3,0,0,3,1,0,0,9,0,2,2,3,0,1,1037726,2023-11-12T00:00:00.000Z,17896058,3,Trendon Watford,0,5,6,3,4,6.1
0,0,0,0,0,0,0,0,0,0,0,0,0,0,0,0,1037726,2023-11-12T00:00:00.000Z,3547302,30,Anthony Gill,0,0,0,0,0,0
3,0,6,7,4,12,8,1,0,34,1,0,20,7,4,2,1037726,2023-11-12T00:00:00.000Z,56677844,30,Bilal Coulibaly,4,27,30,23,10,42.9
4,0,2,5,0,8,2,4,4,26,1,1,8,3,1,1,1037726,2023-11-12T00:00:00.000Z,17896045,30,Corey Kispert,1,11,15,12,7,19.6
3,0,3,3,1,7,3,5,5,20,0,1,12,3,1,0,1037726,2023-11-12T00:00:00.000Z,167,30,Danilo Gallinari,1,15,18,15,6,23.1
0,0,0,0,0,0,0,0,0,0,0,0,0,0,0,0,1037726,2023-11-12T00:00:00.000Z,487,30,Delon Wright,0,0,0,0,0,0
0,0,0,0,0,0,0,0,0,0,0,0,0,0,0,0,1037726,2023-11-12T00:00:00.000Z,17896106,30,Eugene Omoruyi,0,0,0,0,0,0
0,0,0,0,0,0,0,0,0,0,0,0,0,0,0,0,1037726,2023-11-12T00:00:00.000Z,18677954,30,Jared Butler,0,0,0,0,0,0
0,0,0,0,0,0,0,0,0,0,0,0,0,0,0,0,1037726,2023-11-12T00:00:00.000Z,38124126,30,John Butler Jr.,0,0,0,0,0,0
0,0,0,0,0,0,0,0,0,0,0,0,0,0,0,0,1037726,2023-11-12T00:00:00.000Z,38017687,30,Johnny Davis,0,0,0,0,0,0
1,0,4,4,2,7,3,0,0,20,1,1,8,5,0,1,1037726,2023-11-12T00:00:00.000Z,414,30,Landry Shamet,0,13,14,9,6,14.5
0,0,0,0,0,0,0,0,0,0,0,0,0,0,0,0,1037726,2023-11-12T00:00:00.000Z,337,30,Mike Muscala,0,0,0,0,0,0
0,0,0,0,0,0,0,0,0,0,0,0,0,0,0,0,1037726,2023-11-12T00:00:00.000Z,38017704,30,Patrick Baldwin Jr.,0,0,0,0,0,0
0,0,0,0,0,0,0,0,0,0,0,0,0,0,0,0,1037726,2023-11-12T00:00:00.000Z,38017712,30,Ryan Rollins,0,0,0,0,0,0
1,0,1,1,0,5,0,0,0,23,0,1,0,1,2,1,1037726,2023-11-12T00:00:00.000Z,249,30,Tyus Jones,2,1,2,1,2,7.7
0,0,0,0,0,0,0,0,0,0,0,0,0,0,0,0,1037727,2023-11-12T00:00:00.000Z,666511,13,Amir Coffey,0,0,0,0,0,0
0,0,0,0,0,0,0,0,0,0,0,0,0,0,0,0,1037727,2023-11-12T00:00:00.000Z,17896022,13,Brandon Boston Jr.,0,0,0,0,0,0
1,0,6,0,0,4,2,2,2,23,0,3,6,6,1,1,1037727,2023-11-12T00:00:00.000Z,493,13,Ivica Zubac,1,12,13,7,7,16.7
3,1,2,7,1,12,4,2,2,29,2,0,11,4,1,1,1037727,2023-11-12T00:00:00.000Z,192,13,James Harden,2,15,18,14,7,25.3
0,0,0,0,0,0,0,0,0,0,0,0,0,0,0,0,1037727,2023-11-12T00:00:00.000Z,56677856,13,Jordan Miller,0,0,0,0,0,0
0,0,0,0,0,0,0,0,0,0,0,0,0,0,0,0,1037727,2023-11-12T00:00:00.000Z,17896051,13,Joshua Primo,0,0,0,0,0,0
3,2,4,4,1,16,6,2,1,37,1,3,14,5,1,0,1037727,2023-11-12T00:00:00.000Z,274,13,Kawhi Leonard,3,19,22,17,8,33.5
0,0,0,0,0,0,0,0,0,0,0,0,0,0,0,0,1037727,2023-11-12T00:00:00.000Z,56677849,13,Kobe Brown,0,0,0,0,0,0
0,0,0,0,0,0,0,0,0,0,0,0,0,0,0,0,1037727,2023-11-12T00:00:00.000Z,371,13,Mason Plumlee,0,0,0,0,0,0
0,0,2,0,0,2,1,0,0,12,1,1,2,3,0,0,1037727,2023-11-12T00:00:00.000Z,38017725,13,Moussa Diabate,0,5,5,2,3,5.6
0,0,0,0,0,0,0,0,0,0,0,0,0,0,0,0,1037727,2023-11-12T00:00:00.000Z,17896031,13,Nah'Shon Hyland,0,0,0,0,0,0
3,0,2,7,4,13,7,6,2,31,0,5,20,2,0,0,1037727,2023-11-12T00:00:00.000Z,380,13,Norman Powell,0,22,25,23,5,26.9
7,0,6,7,3,16,8,9,7,37,1,5,26,7,2,7,1037727,2023-11-12T00:00:00.000Z,172,13,Paul George,2,33,40,33,14,43.9
1,0,1,2,1,2,1,0,0,13,1,1,3,2,1,0,1037727,2023-11-12T00:00:00.000Z,450,13,PJ Tucker,1,5,6,4,3,9.9
5,0,8,4,1,13,5,2,1,31,1,3,12,9,3,4,1037727,2023-11-12T00:00:00.000Z,472,13,Russell Westbrook,3,21,26,17,14,35.3
3,0,2,3,1,7,3,0,0,27,1,2,7,3,0,1,1037727,2023-11-12T00:00:00.000Z,666743,13,Terance Mann,0,10,13,10,6,14.1
3,2,8,0,0,6,5,7,3,36,4,3,13,12,1,1,1037727,2023-11-12T00:00:00.000Z,48,15,Bismack Biyombo,3,25,28,16,15,39.9
0,0,0,0,0,0,0,0,0,0,0,0,0,0,0,0,1037727,2023-11-12T00:00:00.000Z,666505,15,Brandon Clarke,0,0,0,0,0,0
0,1,2,1,0,7,4,0,0,21,4,1,8,6,1,0,1037727,2023-11-12T00:00:00.000Z,38017729,15,David Roddy,2,14,14,8,6,21.2
0,0,0,0,0,0,0,0,0,0,0,0,0,0,0,0,1037727,2023-11-12T00:00:00.000Z,401,15,Derrick Rose,0,0,0,0,0,0
6,1,3,11,3,24,10,6,4,35,1,4,27,4,0,4,1037727,2023-11-12T00:00:00.000Z,3547287,15,Desmond Bane,1,31,37,33,10,39.8
0,0,0,0,0,0,0,0,0,0,0,0,0,0,0,0,1037727,2023-11-12T00:00:00.000Z,56677830,15,GG Jackson,0,0,0,0,0,0
0,0,0,0,0,0,0,0,0,0,0,0,0,0,0,0,1037727,2023-11-12T00:00:00.000Z,666786,15,Ja Morant,0,0,0,0,0,0
3,0,4,6,2,6,2,0,0,24,1,3,6,5,3,0,1037727,2023-11-12T00:00:00.000Z,48248287,15,Jacob Gilyard,3,11,14,9,8,25.5
0,0,0,0,0,0,0,0,0,0,0,0,0,0,0,0,1037727,2023-11-12T00:00:00.000Z,38017728,15,Jake LaRavia,0,0,0,0,0,0
1,1,4,3,0,15,3,6,6,29,0,4,12,4,1,3,1037727,2023-11-12T00:00:00.000Z,231,15,Jaren Jackson Jr.,2,16,17,13,5,21.3
0,0,2,1,0,1,0,0,0,5,0,2,0,2,0,1,1037727,2023-11-12T00:00:00.000Z,666703,15,John Konchar,0,2,2,0,2,1.4
0,0,0,0,0,0,0,0,0,0,0,0,0,0,0,0,1037727,2023-11-12T00:00:00.000Z,38017732,15,Kenneth Lofton Jr.,0,0,0,0,0,0
2,0,1,5,4,5,4,1,1,24,0,1,13,1,1,0,1037727,2023-11-12T00:00:00.000Z,254,15,Luke Kennard,1,14,16,15,3,20.2
7,0,3,7,3,12,5,4,4,36,0,3,17,3,0,5,1037727,2023-11-12T00:00:00.000Z,420,15,Marcus Smart,0,20,27,24,10,26.1
2,1,3,4,1,8,4,0,0,21,0,1,9,3,0,2,1037727,2023-11-12T00:00:00.000Z,17896067,15,Santi Aldama,1,12,14,11,5,16.6
0,0,0,0,0,0,0,0,0,0,0,0,0,0,0,0,1037727,2023-11-12T00:00:00.000Z,3,15,Steven Adams,0,0,0,0,0,0
0,0,0,0,0,0,0,0,0,0,0,0,0,0,0,0,1037727,2023-11-12T00:00:00.000Z,38017731,15,Vince Williams Jr.,0,0,0,0,0,0
0,0,0,0,0,0,0,0,0,0,0,0,0,0,0,0,1037727,2023-11-12T00:00:00.000Z,3547285,15,Xavier Tillman,0,0,0,0,0,0
1,0,0,3,0,4,0,0,0,9,1,1,0,1,0,0,1037727,2023-11-12T00:00:00.000Z,17896027,15,Ziaire Williams,0,1,2,1,2,2.7
3,0,3,5,2,6,3,0,0,26,1,3,8,4,1,0,1037728,2023-11-12T00:00:00.000Z,3547250,12,Aaron Nesmith,1,12,15,11,7,20.3
1,0,0,2,0,4,2,0,0,14,0,0,4,0,0,3,1037728,2023-11-12T00:00:00.000Z,38017507,12,Andrew Nembhard,0,4,5,5,1,2.5
0,0,0,0,0,0,0,0,0,0,0,0,0,0,0,0,1037728,2023-11-12T00:00:00.000Z,56677861,12,Ben Sheppard,0,0,0,0,0,0
3,2,2,1,0,5,3,4,3,31,2,1,9,4,0,0,1037728,2023-11-12T00:00:00.000Z,69,12,Bruce Brown,2,13,16,12,7,24.3
3,1,3,8,4,13,6,0,0,21,1,0,16,4,1,0,1037728,2023-11-12T00:00:00.000Z,210,12,Buddy Hield,2,20,23,19,7,31.3
0,0,0,0,0,0,0,0,0,0,0,0,0,0,0,0,1037728,2023-11-12T00:00:00.000Z,439,12,Daniel Theis,0,0,0,0,0,0
1,0,5,2,1,7,4,2,2,19,1,2,11,6,0,2,1037728,2023-11-12T00:00:00.000Z,3547264,12,Jalen Smith,0,17,18,12,7,17.7
0,0,0,0,0,0,0,0,0,0,0,0,0,0,0,0,1037728,2023-11-12T00:00:00.000Z,56677832,12,Jarace Walker,0,0,0,0,0,0
0,0,0,0,0,0,0,0,0,0,0,0,0,0,0,0,1037728,2023-11-12T00:00:00.000Z,38017701,12,Kendall Brown,0,0,0,0,0,0
0,3,3,9,4,17,7,4,4,29,2,4,22,5,1,3,1037728,2023-11-12T00:00:00.000Z,452,12,Myles Turner,4,27,27,22,5,37
1,0,1,3,2,7,6,0,0,21,0,2,14,1,0,0,1037728,2023-11-12T00:00:00.000Z,3547243,12,Obi Toppin,0,15,16,15,2,16.7
1,1,2,0,0,6,3,2,2,17,0,1,8,2,3,1,1037728,2023-11-12T00:00:00.000Z,304,12,T.J. McConnell,4,10,11,9,3,22.9
17,1,1,6,3,14,9,4,4,36,0,0,25,1,2,0,1037728,2023-11-12T00:00:00.000Z,3547245,12,Tyrese Haliburton,3,26,43,42,18,60.7
0,0,1,1,1,1,1,2,1,16,0,0,4,1,0,1,1037728,2023-11-12T00:00:00.000Z,2175,23,Danuel House Jr.,0,5,5,4,1,4.2
6,0,3,3,1,7,4,1,1,30,1,1,10,4,0,2,1037728,2023-11-12T00:00:00.000Z,313,23,De'Anthony Melton,0,14,20,16,10,21.8
0,0,0,0,0,1,0,0,0,5,0,0,0,0,1,1,1037728,2023-11-12T00:00:00.000Z,260,23,Furkan Korkmaz,1,0,0,0,0,2
0,0,0,0,0,0,0,0,0,0,0,0,0,0,0,0,1037728,2023-11-12T00:00:00.000Z,17896025,23,Jaden Springer,0,0,0,0,0,0
7,1,5,4,1,26,12,14,12,33,8,2,37,13,1,3,1037728,2023-11-12T00:00:00.000Z,145,23,Joel Embiid,2,50,57,44,20,66.1
0,0,0,0,0,0,0,0,0,0,0,0,0,0,0,0,1037728,2023-11-12T00:00:00.000Z,360,23,Kelly Oubre Jr.,0,0,0,0,0,0
0,0,0,0,0,0,0,0,0,0,0,0,0,0,0,0,1037728,2023-11-12T00:00:00.000Z,3547294,23,Kenyon Martin Jr.,0,0,0,0,0,0
0,0,0,0,0,0,0,0,0,0,0,0,0,0,0,0,1037728,2023-11-12T00:00:00.000Z,328,23,Marcus Morris,0,0,0,0,0,0
0,0,0,0,0,0,0,0,0,0,0,0,0,0,0,0,1037728,2023-11-12T00:00:00.000Z,28,23,Mo Bamba,0,0,0,0,0,0
0,3,5,5,3,5,3,0,0,33,2,2,9,7,1,1,1037728,2023-11-12T00:00:00.000Z,33,23,Nicolas Batum,4,16,16,9,7,28.4
1,0,1,4,1,4,1,0,0,17,1,3,3,2,1,0,1037728,2023-11-12T00:00:00.000Z,45,23,Patrick Beverley,1,5,6,4,3,9.9
3,0,4,0,0,4,2,0,0,15,2,2,4,6,1,0,1037728,2023-11-12T00:00:00.000Z,3547270,23,Paul Reed,1,10,13,7,9,18.7
0,0,0,0,0,0,0,0,0,0,0,0,0,0,0,0,1037728,2023-11-12T00:00:00.000Z,56913527,23,Ricky Council IV,0,0,0,0,0,0
2,0,3,2,0,5,1,0,0,16,2,1,2,5,0,0,1037728,2023-11-12T00:00:00.000Z,108,23,Robert Covington,0,7,9,4,7,11
4,0,5,3,0,20,9,0,0,36,4,2,18,9,0,1,1037728,2023-11-12T00:00:00.000Z,200,23,Tobias Harris,0,27,31,22,13,33.8
5,3,4,11,7,32,20,3,3,39,3,2,50,7,0,2,1037728,2023-11-12T00:00:00.000Z,3547254,23,Tyrese Maxey,3,57,62,55,12,72.9
0,0,0,0,0,0,0,0,0,0,0,0,0,0,0,0,1037729,2023-11-12T00:00:00.000Z,27,5,Lonzo Ball,0,0,0,0,0,0
0,0,0,0,0,0,0,0,0,0,0,0,0,0,0,0,1037729,2023-11-12T00:00:00.000Z,56677874,5,Onuralp Bitim,0,0,0,0,0,0
0,0,0,0,0,0,0,0,0,0,0,0,0,0,0,0,1037729,2023-11-12T00:00:00.000Z,17896116,5,Terry Taylor,0,0,0,0,0,0
4,0,2,6,2,7,3,9,8,21,1,2,16,3,0,0,1037729,2023-11-12T00:00:00.000Z,77,9,Alec Burks,0,19,23,20,7,25.6
0,0,0,0,0,0,0,0,0,0,0,0,0,0,0,0,1037729,2023-11-12T00:00:00.000Z,54,9,Bojan Bogdanovic,0,0,0,0,0,0
5,2,3,5,0,15,4,2,2,38,0,4,10,3,0,1,1037729,2023-11-12T00:00:00.000Z,17896075,9,Cade Cunningham,2,13,18,15,8,26.1
0,0,0,0,0,0,0,0,0,0,0,0,0,0,0,0,1037729,2023-11-12T00:00:00.000Z,17896071,9,Isaiah Livers,0,0,0,0,0,0
2,0,0,2,0,4,2,2,2,12,0,1,6,0,1,1,1037729,2023-11-12T00:00:00.000Z,38017682,9,Jaden Ivey,1,6,8,8,2,11
0,0,0,0,0,0,0,0,0,0,0,0,0,0,0,0,1037729,2023-11-12T00:00:00.000Z,38017694,9,Jalen Duren,0,0,0,0,0,0
0,2,1,1,0,6,3,0,0,14,1,3,6,2,1,2,1037729,2023-11-12T00:00:00.000Z,3547240,9,James Wiseman,3,8,8,6,2,15.4
0,0,0,0,0,0,0,0,0,0,0,0,0,0,0,0,1037729,2023-11-12T00:00:00.000Z,42097199,9,Jared Rhoden,0,0,0,0,0,0
0,0,0,0,0,0,0,0,0,0,0,0,0,0,0,0,1037729,2023-11-12T00:00:00.000Z,197,9,Joe Harris,0,0,0,0,0,0
1,0,3,5,4,8,7,0,0,24,0,2,18,3,1,1,1037729,2023-11-12T00:00:00.000Z,259,9,Kevin Knox,1,21,22,19,4,25.1
3,0,3,3,1,8,3,0,0,25,0,1,7,3,0,0,1037729,2023-11-12T00:00:00.000Z,3547241,9,Killian Hayes,0,10,13,10,6,15.1
0,0,0,0,0,0,0,0,0,0,0,0,0,0,0,0,1037729,2023-11-12T00:00:00.000Z,56677729,9,Malcolm Cazalon,0,0,0,0,0,0
6,0,3,3,1,6,2,0,0,20,0,1,5,3,1,2,1037729,2023-11-12T00:00:00.000Z,56677792,9,Marcus Sasser,1,8,14,11,9,18.6
0,0,0,0,0,0,0,0,0,0,0,0,0,0,0,0,1037729,2023-11-12T00:00:00.000Z,330,9,Monte Morris,0,0,0,0,0,0
0,0,0,0,0,0,0,0,0,0,0,0,0,0,0,0,1037729,2023-11-12T00:00:00.000Z,44477024,9,Stanley Umude,0,0,0,0,0,0
0,0,0,0,0,0,0,0,0,0,0,0,0,0,0,0,1037730,2023-11-12T00:00:00.000Z,17896007,8,Braxton Key,0,0,0,0,0,0
0,0,0,0,0,0,0,0,0,0,0,0,0,0,0,0,1037730,2023-11-12T00:00:00.000Z,250,8,DeAndre Jordan,0,0,0,0,0,0
0,0,0,0,0,0,0,0,0,0,0,0,0,0,0,0,1037730,2023-11-12T00:00:00.000Z,56677871,8,Hunter Tyson,0,0,0,0,0,0
0,0,0,0,0,0,0,0,0,0,0,0,0,0,0,0,1037730,2023-11-12T00:00:00.000Z,56677582,8,Jalen Pickett,0,0,0,0,0,0
0,0,0,0,0,0,0,0,0,0,0,0,0,0,0,0,1037730,2023-11-12T00:00:00.000Z,335,8,Jamal Murray,0,0,0,0,0,0
0,0,0,0,0,0,0,0,0,0,0,0,0,0,0,0,1037730,2023-11-12T00:00:00.000Z,17896103,8,Jay Huff,0,0,0,0,0,0
1,0,0,2,0,2,0,0,0,8,0,2,0,0,0,0,1037730,2023-11-12T00:00:00.000Z,56677776,8,Julian Strawther,0,0,1,1,1,1.5
0,0,0,0,0,0,0,0,0,0,0,0,0,0,0,0,1037730,2023-11-12T00:00:00.000Z,215,8,Justin Holiday,0,0,0,0,0,0
1,1,0,0,0,2,0,0,0,7,0,2,0,0,0,0,1037730,2023-11-12T00:00:00.000Z,38017721,8,Peyton Watson,1,0,1,1,1,4.5
0,0,0,0,0,0,0,0,0,0,0,0,0,0,0,0,1037730,2023-11-12T00:00:00.000Z,666489,8,Vlatko Cancar,0,0,0,0,0,0
0,0,2,1,0,4,1,0,0,11,2,0,2,4,0,0,1037730,2023-11-12T00:00:00.000Z,3547268,8,Zeke Nnaji,0,6,6,2,4,6.8
0,2,1,0,0,5,4,4,2,26,1,5,10,2,1,1,1037731,2023-11-12T00:00:00.000Z,56677840,7,Dereck Lively II,3,12,12,10,2,20.4
2,0,1,6,2,6,2,2,1,22,0,0,7,1,0,1,1037731,2023-11-12T00:00:00.000Z,247,7,Derrick Jones Jr.,0,8,10,9,3,10.2
1,2,1,2,0,4,0,0,0,21,1,1,0,2,1,0,1037731,2023-11-12T00:00:00.000Z,666965,7,Grant Williams,3,2,3,1,3,12.9
0,0,1,0,0,1,1,0,0,4,0,1,2,1,0,0,1037731,2023-11-12T00:00:00.000Z,217,7,Richaun Holmes,0,3,3,2,1,3.2
0,0,0,1,0,2,0,0,0,6,1,0,0,1,0,0,1037731,2023-11-12T00:00:00.000Z,114,7,Seth Curry,0,1,1,0,1,1.2
0,0,0,0,0,0,0,0,0,0,0,0,0,0,0,0,1037731,2023-11-12T00:00:00.000Z,303,19,CJ McCollum,0,0,0,0,0,0
2,0,4,0,0,2,1,2,1,13,1,1,3,5,0,1,1037731,2023-11-12T00:00:00.000Z,491,19,Cody Zeller,0,8,10,5,7,11
2,1,3,0,0,1,1,2,1,8,0,2,3,3,0,0,1037731,2023-11-12T00:00:00.000Z,38017726,19,Dereon Seabron,1,6,8,5,5,12.6
0,0,0,0,0,0,0,0,0,0,0,0,0,0,0,0,1037731,2023-11-12T00:00:00.000Z,38017663,19,E.J. Liddell,0,0,0,0,0,0
0,0,0,0,0,0,0,0,0,0,0,0,0,0,0,0,1037731,2023-11-12T00:00:00.000Z,17896024,19,Herbert Jones,0,0,0,0,0,0
1,0,5,5,3,8,4,0,0,26,1,2,11,6,1,1,1037731,2023-11-12T00:00:00.000Z,17896021,19,Jeremiah Robinson-Earl,1,17,18,12,7,21.7
0,0,0,0,0,0,0,0,0,0,0,0,0,0,0,0,1037731,2023-11-12T00:00:00.000Z,17896097,19,Jose Alvarado,0,0,0,0,0,0
4,0,0,0,0,5,2,1,1,8,1,0,5,1,0,1,1037731,2023-11-12T00:00:00.000Z,3547260,19,Kira Lewis Jr.,0,6,10,9,5,11.2
0,0,2,1,0,2,0,0,0,7,1,1,0,3,0,1,1037731,2023-11-12T00:00:00.000Z,340,19,Larry Nance Jr.,0,3,3,0,3,2.6
0,0,0,0,0,0,0,0,0,0,0,0,0,0,0,0,1037731,2023-11-12T00:00:00.000Z,18677986,19,Trey Murphy III,0,0,0,0,0,0
6,0,7,0,0,20,10,5,4,34,4,0,24,11,3,0,1037732,2023-11-12T00:00:00.000Z,4,16,Bam Adebayo,3,35,41,30,17,55.2
0,0,0,0,0,0,0,0,0,0,0,0,0,0,0,0,1037732,2023-11-12T00:00:00.000Z,666747,16,Caleb Martin,0,0,0,0,0,0
4,1,4,7,4,16,8,6,6,39,1,1,26,5,0,0,1037732,2023-11-12T00:00:00.000Z,397,16,Duncan Robinson,1,31,35,30,9,41
1,0,3,3,0,4,0,0,0,26,1,3,0,4,0,0,1037732,2023-11-12T00:00:00.000Z,3092,16,Haywood Highsmith,0,4,5,1,5,6.3
3,1,5,2,1,10,4,2,2,32,1,1,11,6,4,1,1037732,2023-11-12T00:00:00.000Z,56677785,16,Jaime Jaquez Jr.,5,17,20,14,9,36.7
4,1,4,3,1,14,5,9,8,37,2,1,19,6,0,2,1037732,2023-11-12T00:00:00.000Z,79,16,Jimmy Butler,1,25,29,23,10,33.2
4,0,3,4,2,7,4,2,2,26,0,2,12,3,1,0,1037732,2023-11-12T00:00:00.000Z,391,16,Josh Richardson,1,15,19,16,7,24.6
0,0,2,7,2,8,3,4,4,14,0,2,12,2,0,0,1037732,2023-11-12T00:00:00.000Z,285,16,Kevin Love,0,14,14,12,2,14.4
0,0,0,0,0,0,0,0,0,0,0,0,0,0,0,0,1037732,2023-11-12T00:00:00.000Z,286,16,Kyle Lowry,0,0,0,0,0,0
0,1,0,1,1,3,1,0,0,20,1,2,3,1,0,0,1037732,2023-11-12T00:00:00.000Z,359,27,Cedi Osman,1,4,4,3,1,7.2
1,0,2,0,0,2,1,2,1,6,3,2,3,5,1,1,1037732,2023-11-12T00:00:00.000Z,17895854,27,Charles Bassey,1,8,9,4,6,12.5
4,0,5,9,4,12,5,0,0,33,2,0,14,7,0,1,1037732,2023-11-12T00:00:00.000Z,3547246,27,Devin Vassell,0,21,25,18,11,27.4
3,2,4,3,2,9,6,2,2,34,1,4,16,5,0,3,1037732,2023-11-12T00:00:00.000Z,38017699,27,Jeremy Sochan,2,21,24,19,8,29.5
7,0,1,5,4,7,4,1,1,21,0,2,13,1,0,1,1037732,2023-11-12T00:00:00.000Z,38017692,27,Malaki Branham,0,14,21,20,8,23.7
0,0,0,0,0,0,0,0,0,0,0,0,0,0,0,0,1037732,2023-11-12T00:00:00.000Z,56677870,27,Sir'Jabari Rice,0,0,0,0,0,0
2,1,3,4,1,14,6,6,5,33,2,4,18,5,0,3,1037732,2023-11-12T00:00:00.000Z,102,27,Zach Collins,1,23,25,20,7,27
0,0,0,0,0,0,0,0,0,0,0,0,0,0,0,0,1037733,2023-11-12T00:00:00.000Z,666451,24,Bol Bol,0,0,0,0,0,0
0,0,0,0,0,0,0,0,0,0,0,0,0,0,0,0,1037733,2023-11-12T00:00:00.000Z,3547298,24,Saben Lee,0,0,0,0,0,0
0,0,0,0,0,0,0,0,0,0,0,0,0,0,0,0,1037733,2023-11-12T00:00:00.000Z,3547095,24,Udoka Azubuike,0,0,0,0,0,0
2,0,0,2,2,2,2,0,0,17,0,1,6,0,0,0,1037733,2023-11-12T00:00:00.000Z,470,24,Yuta Watanabe,0,6,8,8,2,9
2,0,2,2,0,7,3,2,0,26,2,4,6,4,1,1,1037734,2023-11-12T00:00:00.000Z,475,10,Andrew Wiggins,1,10,12,8,6,15.8
7,0,7,3,1,7,3,2,2,24,2,5,9,9,1,2,1037734,2023-11-12T00:00:00.000Z,185,10,Draymond Green,1,18,25,16,16,31.3
0,0,1,0,0,3,1,0,0,19,5,3,2,6,1,0,1037734,2023-11-12T00:00:00.000Z,282,10,Kevon Looney,1,8,8,2,6,12.2
3,0,5,10,3,16,5,3,3,33,0,1,16,5,1,1,1037734,2023-11-12T00:00:00.000Z,443,10,Klay Thompson,1,21,24,19,8,28.5
3,0,4,13,5,25,11,12,11,36,1,2,38,5,1,5,1037734,2023-11-12T00:00:00.000Z,115,10,Stephen Curry,1,43,46,41,8,46.5
1,0,0,0,0,1,1,0,0,1,0,0,2,0,0,0,1037734,2023-11-12T00:00:00.000Z,56677799,10,Trayce Jackson-Davis,0,2,3,3,1,3.5
0,0,0,0,0,0,0,0,0,0,0,0,0,0,0,0,1037736,2023-11-13T00:00:00.000Z,666474,20,Charles Brown,0,0,0,0,0,0
0,0,0,0,0,0,0,0,0,0,0,0,0,0,0,0,1037736,2023-11-13T00:00:00.000Z,666675,20,DaQuan Jeffries,0,0,0,0,0,0
1,0,0,4,1,6,2,0,0,16,1,1,5,1,0,0,1037736,2023-11-13T00:00:00.000Z,131,20,Donte DiVincenzo,0,6,7,6,2,7.7
0,0,0,0,0,0,0,0,0,0,0,0,0,0,0,0,1037736,2023-11-13T00:00:00.000Z,17896089,20,Duane Washington Jr.,0,0,0,0,0,0
0,0,0,0,0,0,0,0,0,0,0,0,0,0,0,0,1037736,2023-11-13T00:00:00.000Z,666971,20,Dylan Windler,0,0,0,0,0,0
0,0,0,0,0,0,0,0,0,0,0,0,0,0,0,0,1037736,2023-11-13T00:00:00.000Z,160,20,Evan Fournier,0,0,0,0,0,0
1,0,6,2,1,10,1,4,4,26,0,3,7,6,1,0,1037736,2023-11-13T00:00:00.000Z,3547269,20,Immanuel Quickley,1,13,14,8,7,18.7
1,0,0,1,1,2,1,0,0,15,3,0,3,3,1,0,1037736,2023-11-13T00:00:00.000Z,201,20,Isaiah Hartenstein,1,6,7,4,4,11.1
0,0,0,0,0,0,0,0,0,0,0,0,0,0,0,0,1037736,2023-11-13T00:00:00.000Z,56677795,20,Jacob Toppin,0,0,0,0,0,0
4,0,3,7,3,21,10,5,3,39,0,0,26,3,1,2,1037736,2023-11-13T00:00:00.000Z,73,20,Jalen Brunson,1,29,33,30,7,36.6
0,0,0,0,0,0,0,0,0,1,0,0,0,0,0,0,1037736,2023-11-13T00:00:00.000Z,17896063,20,Jericho Sims,0,0,0,0,0,0
5,0,6,8,2,19,7,11,9,38,3,4,25,9,0,3,1037736,2023-11-13T00:00:00.000Z,387,20,Julius Randle,0,34,39,30,14,40.3
0,0,0,1,0,1,0,0,0,1,0,0,0,0,0,0,1037736,2023-11-13T00:00:00.000Z,17896033,20,Miles McBride,0,0,0,0,0,0
1,2,3,0,0,2,2,2,0,33,3,2,4,6,1,1,1037736,2023-11-13T00:00:00.000Z,399,20,Mitchell Robinson,3,10,11,5,7,20.7
1,0,0,6,4,6,4,0,0,28,0,2,12,0,0,0,1037736,2023-11-13T00:00:00.000Z,17895858,20,Quentin Grimes,0,12,13,13,1,13.5
0,0,0,0,0,0,0,0,0,0,0,0,0,0,0,0,1037736,2023-11-13T00:00:00.000Z,666423,20,RJ Barrett,0,0,0,0,0,0
0,0,0,0,0,0,0,0,0,0,0,0,0,0,0,0,1037736,2023-11-13T00:00:00.000Z,19,20,Ryan Arcidiacono,0,0,0,0,0,0
0,0,0,0,0,0,0,0,0,0,0,0,0,0,0,0,1037738,2023-11-13T00:00:00.000Z,56677860,5,Adama Sanogo,0,0,0,0,0,0
0,0,0,0,0,0,0,0,0,0,0,0,0,0,0,0,1037738,2023-11-13T00:00:00.000Z,38017719,5,Dalen Terry,0,0,0,0,0,0
7,1,2,3,0,14,3,5,5,37,2,3,11,4,0,1,1037738,2023-11-13T00:00:00.000Z,125,5,DeMar DeRozan,1,15,22,18,11,28.3
0,0,0,0,0,0,0,0,0,0,0,0,0,0,0,0,1037738,2023-11-13T00:00:00.000Z,45969255,5,Justin Lewis,0,0,0,0,0,0
0,0,0,0,0,0,0,0,0,0,0,0,0,0,0,0,1037738,2023-11-13T00:00:00.000Z,27,5,Lonzo Ball,0,0,0,0,0,0
0,0,0,0,0,0,0,0,0,0,0,0,0,0,0,0,1037738,2023-11-13T00:00:00.000Z,56677874,5,Onuralp Bitim,0,0,0,0,0,0
2,0,5,4,1,8,3,1,1,23,7,2,8,12,0,0,1037738,2023-11-13T00:00:00.000Z,110,5,Torrey Craig,0,20,22,10,14,25.4
2,1,8,6,3,10,7,2,2,25,2,3,19,10,0,0,1037738,2023-11-13T00:00:00.000Z,377,17,Bobby Portis,1,29,31,21,12,37
0,0,0,0,0,0,0,0,0,0,0,0,0,0,0,0,1037738,2023-11-13T00:00:00.000Z,56677854,17,Chris Livingston,0,0,0,0,0,0
0,0,0,0,0,0,0,0,0,0,0,0,0,0,0,0,1037738,2023-11-13T00:00:00.000Z,112,17,Jae Crowder,0,0,0,0,0,0
0,0,0,0,0,0,0,0,0,0,0,0,0,0,0,0,1037738,2023-11-13T00:00:00.000Z,666960,17,Lindell Wigginton,0,0,0,0,0,0
0,0,0,0,0,0,0,0,0,0,0,0,0,0,0,0,1037738,2023-11-13T00:00:00.000Z,666453,17,Marques Bolden,0,0,0,0,0,0
0,0,0,0,0,0,0,0,0,0,0,0,0,0,0,0,1037738,2023-11-13T00:00:00.000Z,38017691,17,TyTy Washington Jr.,0,0,0,0,0,0
3,0,3,9,5,12,7,0,0,34,2,3,19,5,1,1,1037739,2023-11-13T00:00:00.000Z,666908,6,Max Strus,1,24,27,22,8,31.5
0,0,2,5,3,6,4,0,0,17,0,1,11,2,0,0,1037739,2023-11-13T00:00:00.000Z,4197162,26,Aleksandar Vezenkov,0,13,13,11,2,13.4
0,0,0,0,0,0,0,0,0,1,0,0,0,0,0,0,1037739,2023-11-13T00:00:00.000Z,56677845,26,Colby Jones,0,0,0,0,0,0
0,0,0,0,0,0,0,0,0,0,0,0,0,0,0,0,1037739,2023-11-13T00:00:00.000Z,17553994,26,Davion Mitchell,0,0,0,0,0,0
0,0,0,0,0,0,0,0,0,0,0,0,0,0,0,0,1037739,2023-11-13T00:00:00.000Z,17895941,26,Filip Petrusev,0,0,0,0,0,0
0,0,0,0,0,0,0,0,0,0,0,0,0,0,0,0,1037739,2023-11-13T00:00:00.000Z,56677862,26,Jalen Slawson,0,0,0,0,0,0
1,0,3,0,0,2,1,0,0,7,1,1,2,4,0,0,1037739,2023-11-13T00:00:00.000Z,306,26,JaVale McGee,0,6,7,3,5,8.3
0,0,0,1,0,1,0,0,0,1,0,0,0,0,0,0,1037739,2023-11-13T00:00:00.000Z,17895990,26,Jordan Ford,0,0,0,0,0,0
0,0,0,0,0,0,0,0,0,1,0,0,0,0,0,0,1037739,2023-11-13T00:00:00.000Z,17896044,26,Kessler Edwards,0,0,0,0,0,0
4,1,4,5,3,8,4,2,2,26,1,2,13,5,1,2,1037739,2023-11-13T00:00:00.000Z,324,26,Malik Monk,2,18,22,17,9,29
0,0,0,0,0,0,0,0,0,0,0,0,0,0,0,0,1037739,2023-11-13T00:00:00.000Z,290,26,Trey Lyles,0,0,0,0,0,0
0,0,0,0,0,0,0,0,0,0,0,0,0,0,0,0,3277425,2023-11-14T00:00:00.000Z,56677848,4,Amari Bailey,0,0,0,0,0,0
0,0,0,0,0,0,0,0,0,0,0,0,0,0,0,0,3277425,2023-11-14T00:00:00.000Z,56677823,4,Brandon Miller,0,0,0,0,0,0
1,0,4,5,3,7,4,2,1,29,0,4,12,4,1,1,3277425,2023-11-14T00:00:00.000Z,38017708,4,Bryce McGowens,1,16,17,13,5,20.3
0,0,0,0,0,0,0,0,0,0,0,0,0,0,0,0,3277425,2023-11-14T00:00:00.000Z,666748,4,Cody Martin,0,0,0,0,0,0
0,0,0,0,0,0,0,0,0,0,0,0,0,0,0,0,3277425,2023-11-14T00:00:00.000Z,347,4,Frank Ntilikina,0,0,0,0,0,0
0,0,0,0,0,0,0,0,0,0,0,0,0,0,0,0,3277425,2023-11-14T00:00:00.000Z,204,4,Gordon Hayward,0,0,0,0,0,0
3,0,1,0,0,3,1,0,0,19,1,1,2,2,0,3,3277425,2023-11-14T00:00:00.000Z,422,4,Ish Smith,0,4,7,5,5,5.9
0,0,0,0,0,0,0,0,0,0,0,0,0,0,0,0,3277425,2023-11-14T00:00:00.000Z,17896037,4,James Bouknight,0,0,0,0,0,0
1,0,1,2,1,6,2,0,0,28,3,1,5,4,0,0,3277425,2023-11-14T00:00:00.000Z,18678001,4,JT Thor,0,9,10,6,5,11.3
11,0,4,10,4,26,9,6,6,39,2,5,28,6,3,8,3277425,2023-11-14T00:00:00.000Z,3547239,4,LaMelo Ball,3,34,45,39,17,52.7
0,0,0,1,0,2,0,0,0,3,0,0,0,0,0,0,3277425,2023-11-14T00:00:00.000Z,56677866,4,Leaky Black,0,0,0,0,0,0
0,0,3,0,0,5,5,4,1,23,4,2,11,7,1,0,3277425,2023-11-14T00:00:00.000Z,38017698,4,Mark Williams,1,18,18,11,7,22.4
0,0,0,0,0,0,0,0,0,0,0,0,0,0,0,0,3277425,2023-11-14T00:00:00.000Z,62,4,Miles Bridges,0,0,0,0,0,0
1,0,10,0,0,2,2,6,6,25,1,5,10,11,1,3,3277425,2023-11-14T00:00:00.000Z,3547282,4,Nick Richards,1,21,22,11,12,24.7
0,0,2,1,1,2,1,0,0,15,0,1,3,2,0,0,3277425,2023-11-14T00:00:00.000Z,56677846,4,Nick Smith Jr.,0,5,5,3,2,5.4
1,0,4,11,6,23,12,2,2,36,2,1,32,6,0,1,3277425,2023-11-14T00:00:00.000Z,666950,4,P.J. Washington,0,38,39,33,7,39.7
0,0,0,0,0,0,0,0,0,0,0,0,0,0,0,0,3277425,2023-11-14T00:00:00.000Z,403,4,Terry Rozier,0,0,0,0,0,0
3,0,3,2,0,5,0,2,2,23,0,1,2,3,0,2,3277425,2023-11-14T00:00:00.000Z,3547253,4,Theo Maledon,0,5,8,5,6,8.1
0,0,0,0,0,0,0,0,0,0,0,0,0,0,0,0,3277425,2023-11-14T00:00:00.000Z,38017736,16,Cole Swider,0,0,0,0,0,0
0,0,0,0,0,0,0,0,0,3,0,2,0,0,0,0,3277425,2023-11-14T00:00:00.000Z,19465585,16,Dru Smith,0,0,0,0,0,0
2,2,3,5,2,8,5,0,0,33,1,1,12,4,5,0,3277425,2023-11-14T00:00:00.000Z,3092,16,Haywood Highsmith,7,16,18,14,6,40.8
0,0,0,0,0,0,0,0,0,0,0,0,0,0,0,0,3277425,2023-11-14T00:00:00.000Z,38017734,16,Jamal Cain,0,0,0,0,0,0
5,0,1,1,1,14,10,14,11,34,3,1,32,4,2,3,3277425,2023-11-14T00:00:00.000Z,79,16,Jimmy Butler,2,36,41,37,9,47.3
6,1,4,6,0,10,2,2,2,33,1,2,6,5,1,1,3277425,2023-11-14T00:00:00.000Z,391,16,Josh Richardson,2,11,17,12,11,26
1,0,3,5,0,5,0,4,3,14,0,1,3,3,0,0,3277425,2023-11-14T00:00:00.000Z,285,16,Kevin Love,0,6,7,4,4,8.1
0,0,0,0,0,0,0,0,0,0,0,0,0,0,0,0,3277425,2023-11-14T00:00:00.000Z,39398582,16,Orlando Robinson,0,0,0,0,0,0
0,0,0,0,0,0,0,0,0,0,0,0,0,0,0,0,3277425,2023-11-14T00:00:00.000Z,3547257,16,R.J. Hampton,0,0,0,0,0,0
0,0,0,0,0,0,0,0,0,0,0,0,0,0,0,0,3277425,2023-11-14T00:00:00.000Z,666633,16,Tyler Herro,0,0,0,0,0,0
0,0,0,3,1,3,1,2,2,8,0,2,5,0,0,0,3277426,2023-11-14T00:00:00.000Z,38017689,1,AJ Griffin,0,5,5,5,0,5
3,1,3,11,3,17,7,0,0,34,0,0,17,3,0,3,3277426,2023-11-14T00:00:00.000Z,53,1,Bogdan Bogdanovic,1,20,23,20,6,25.1
0,0,0,0,0,0,0,0,0,0,0,0,0,0,0,0,3277426,2023-11-14T00:00:00.000Z,666564,1,Bruno Fernando,0,0,0,0,0,0
1,3,5,0,0,4,3,2,2,27,2,5,8,7,2,3,3277426,2023-11-14T00:00:00.000Z,83,1,Clint Capela,5,15,16,9,8,29.9
5,0,3,5,2,14,6,3,2,35,2,3,16,5,1,1,3277426,2023-11-14T00:00:00.000Z,666656,1,De'Andre Hunter,1,21,26,21,10,31.5
0,0,1,1,1,1,1,0,0,2,0,0,3,1,0,0,3277426,2023-11-14T00:00:00.000Z,666754,1,Garrison Mathews,0,4,4,3,1,4.2
1,1,4,2,2,9,6,2,2,36,1,2,16,5,1,2,3277426,2023-11-14T00:00:00.000Z,17896040,1,Jalen Johnson,2,21,22,17,6,27.5
0,0,0,0,0,0,0,0,0,0,0,0,0,0,0,0,3277426,2023-11-14T00:00:00.000Z,56677838,1,Kobe Bufkin,0,0,0,0,0,0
0,0,0,0,0,0,0,0,0,0,0,0,0,0,0,0,3277426,2023-11-14T00:00:00.000Z,56677875,1,Miles Norris,0,0,0,0,0,0
0,0,0,0,0,0,0,0,0,0,0,0,0,0,0,0,3277426,2023-11-14T00:00:00.000Z,56677806,1,Mouhamed Gueye,0,0,0,0,0,0
2,1,6,0,0,4,4,0,0,21,3,5,8,9,0,2,3277426,2023-11-14T00:00:00.000Z,3547244,1,Onyeka Okongwu,1,17,19,10,11,22.8
0,0,0,0,0,0,0,0,0,0,0,0,0,0,0,0,3277426,2023-11-14T00:00:00.000Z,319,1,Patty Mills,0,0,0,0,0,0
2,1,4,7,2,13,6,6,5,27,1,0,19,5,2,1,3277426,2023-11-14T00:00:00.000Z,3547256,1,Saddiq Bey,3,24,26,21,7,36
0,0,0,0,0,0,0,0,0,0,0,0,0,0,0,0,3277426,2023-11-14T00:00:00.000Z,56677855,1,Seth Lundy,0,0,0,0,0,0
0,0,0,0,0,0,0,0,0,0,0,0,0,0,0,0,3277426,2023-11-14T00:00:00.000Z,490,1,Trae Young,0,0,0,0,0,0
4,0,0,0,0,1,0,2,2,13,1,0,2,1,0,0,3277426,2023-11-14T00:00:00.000Z,3547297,1,Trent Forrest,0,3,7,6,5,9.2
0,0,0,0,0,0,0,0,0,0,0,0,0,0,0,0,3277426,2023-11-14T00:00:00.000Z,301,1,Wesley Matthews,0,0,0,0,0,0
5,0,1,9,4,12,4,4,4,23,1,3,16,2,1,1,3277426,2023-11-14T00:00:00.000Z,77,9,Alec Burks,1,18,23,21,7,27.9
0,0,0,0,0,0,0,0,0,0,0,0,0,0,0,0,3277426,2023-11-14T00:00:00.000Z,54,9,Bojan Bogdanovic,0,0,0,0,0,0
12,0,3,3,1,14,4,0,0,38,1,3,9,4,3,6,3277426,2023-11-14T00:00:00.000Z,17896075,9,Cade Cunningham,3,13,25,21,16,34.8
0,0,0,0,0,0,0,0,0,0,0,0,0,0,0,0,3277426,2023-11-14T00:00:00.000Z,17896071,9,Isaiah Livers,0,0,0,0,0,0
0,1,1,5,1,9,4,1,1,19,0,1,10,1,0,0,3277426,2023-11-14T00:00:00.000Z,3547267,9,Isaiah Stewart,1,11,11,10,1,14.2
5,0,2,2,1,7,4,4,2,21,3,1,11,5,1,1,3277426,2023-11-14T00:00:00.000Z,38017682,9,Jaden Ivey,1,16,21,16,10,26.5
0,0,0,0,0,0,0,0,0,0,0,0,0,0,0,0,3277426,2023-11-14T00:00:00.000Z,38017694,9,Jalen Duren,0,0,0,0,0,0
1,0,3,0,0,6,5,2,1,14,1,2,11,4,0,0,3277426,2023-11-14T00:00:00.000Z,3547240,9,James Wiseman,0,15,16,12,5,17.3
0,0,0,0,0,0,0,0,0,0,0,0,0,0,0,0,3277426,2023-11-14T00:00:00.000Z,42097199,9,Jared Rhoden,0,0,0,0,0,0
0,0,0,0,0,0,0,0,0,0,0,0,0,0,0,0,3277426,2023-11-14T00:00:00.000Z,197,9,Joe Harris,0,0,0,0,0,0
1,0,3,4,2,8,5,0,0,29,1,3,12,4,0,2,3277426,2023-11-14T00:00:00.000Z,259,9,Kevin Knox,0,16,17,13,5,16.3
5,2,3,3,1,8,3,2,1,23,0,2,8,3,1,1,3277426,2023-11-14T00:00:00.000Z,3547241,9,Killian Hayes,3,11,16,13,8,27.1
0,0,0,0,0,0,0,0,0,0,0,0,0,0,0,0,3277426,2023-11-14T00:00:00.000Z,56677729,9,Malcolm Cazalon,0,0,0,0,0,0
1,0,1,2,0,2,0,0,0,8,0,0,0,1,0,0,3277426,2023-11-14T00:00:00.000Z,56677792,9,Marcus Sasser,0,1,2,1,2,2.7
1,1,4,0,0,12,9,4,4,30,6,2,22,10,0,4,3277426,2023-11-14T00:00:00.000Z,24,9,Marvin Bagley III,1,32,33,23,11,34.5
0,0,0,0,0,0,0,0,0,0,0,0,0,0,0,0,3277426,2023-11-14T00:00:00.000Z,330,9,Monte Morris,0,0,0,0,0,0
0,0,0,0,0,0,0,0,0,0,0,0,0,0,0,0,3277426,2023-11-14T00:00:00.000Z,44477024,9,Stanley Umude,0,0,0,0,0,0
2,1,4,5,1,8,2,2,1,22,0,4,6,4,1,1,3277427,2023-11-14T00:00:00.000Z,3547250,12,Aaron Nesmith,2,10,12,8,6,18.8
4,0,1,1,0,3,1,0,0,10,1,1,2,2,1,0,3277427,2023-11-14T00:00:00.000Z,38017507,12,Andrew Nembhard,1,4,8,6,6,13.4
0,0,0,0,0,0,0,0,0,0,0,0,0,0,0,0,3277427,2023-11-14T00:00:00.000Z,56677861,12,Ben Sheppard,0,0,0,0,0,0
3,0,5,2,0,11,5,4,4,36,0,4,14,5,1,0,3277427,2023-11-14T00:00:00.000Z,69,12,Bruce Brown,1,19,22,17,8,27.5
1,0,2,3,0,5,1,0,0,29,0,2,2,2,1,5,3277427,2023-11-14T00:00:00.000Z,210,12,Buddy Hield,1,4,5,3,3,3.9
0,0,0,0,0,0,0,0,0,0,0,0,0,0,0,0,3277427,2023-11-14T00:00:00.000Z,439,12,Daniel Theis,0,0,0,0,0,0
2,1,4,0,0,4,1,8,5,17,5,4,7,9,0,1,3277427,2023-11-14T00:00:00.000Z,17896035,12,Isaiah Jackson,1,16,18,9,11,22.8
0,0,0,0,0,0,0,0,0,0,0,0,0,0,0,0,3277427,2023-11-14T00:00:00.000Z,56677794,12,Isaiah Wong,0,0,0,0,0,0
1,0,0,1,1,2,2,1,0,3,0,2,5,0,0,0,3277427,2023-11-14T00:00:00.000Z,3547264,12,Jalen Smith,0,5,6,6,1,6.5
0,0,0,0,0,0,0,0,0,0,0,0,0,0,0,0,3277427,2023-11-14T00:00:00.000Z,56677832,12,Jarace Walker,0,0,0,0,0,0
0,0,0,0,0,0,0,0,0,0,0,0,0,0,0,0,3277427,2023-11-14T00:00:00.000Z,3547207,12,Jordan Nwora,0,0,0,0,0,0
0,0,0,0,0,0,0,0,0,0,0,0,0,0,0,0,3277427,2023-11-14T00:00:00.000Z,38017701,12,Kendall Brown,0,0,0,0,0,0
0,0,0,0,0,0,0,0,0,0,0,0,0,0,0,0,3277427,2023-11-14T00:00:00.000Z,56677778,12,Oscar Tshiebwe,0,0,0,0,0,0
3,0,2,2,0,8,5,1,1,13,1,3,11,3,0,1,3277427,2023-11-14T00:00:00.000Z,304,12,T.J. McConnell,0,14,17,14,6,18.1
15,1,6,12,7,18,11,5,4,38,1,1,33,7,2,0,3277427,2023-11-14T00:00:00.000Z,3547245,12,Tyrese Haliburton,3,40,55,48,22,72.9
6,0,9,4,0,22,11,17,17,38,3,4,39,12,3,5,3277427,2023-11-14T00:00:00.000Z,145,23,Joel Embiid,3,51,57,45,18,66.4
1,0,3,2,0,4,1,0,0,18,0,1,2,3,0,0,3277427,2023-11-14T00:00:00.000Z,328,23,Marcus Morris,0,5,6,3,4,7.1
1,1,0,0,0,1,1,0,0,10,1,1,2,1,0,1,3277427,2023-11-14T00:00:00.000Z,3547270,23,Paul Reed,1,3,4,3,2,6.7
1,1,1,2,0,3,1,0,0,16,0,2,2,1,0,0,3277427,2023-11-14T00:00:00.000Z,108,23,Robert Covington,1,3,4,3,2,7.7
3,0,7,1,0,17,11,1,0,37,0,3,22,7,1,1,3277427,2023-11-14T00:00:00.000Z,200,23,Tobias Harris,1,29,32,25,10,36.9
0,0,0,0,0,0,0,0,0,0,0,0,0,0,0,0,3277428,2023-11-14T00:00:00.000Z,9051997,3,Armoni Brooks,0,0,0,0,0,0
0,0,0,0,0,0,0,0,0,0,0,0,0,0,0,0,3277428,2023-11-14T00:00:00.000Z,417,3,Ben Simmons,0,0,0,0,0,0
0,0,0,0,0,0,0,0,0,0,0,0,0,0,0,0,3277428,2023-11-14T00:00:00.000Z,17896048,3,Cam Thomas,0,0,0,0,0,0
2,0,4,7,3,11,7,4,3,29,1,1,20,5,3,1,3277428,2023-11-14T00:00:00.000Z,666679,3,Cameron Johnson,3,25,27,22,7,37
0,0,0,0,0,0,0,0,0,0,0,0,0,0,0,0,3277428,2023-11-14T00:00:00.000Z,56677841,3,Dariq Whitehead,0,0,0,0,0,0
0,1,5,0,0,7,4,5,3,24,5,6,11,10,0,2,3277428,2023-11-14T00:00:00.000Z,17896038,3,Day'Ron Sharpe,1,21,21,11,10,24
5,0,2,1,0,7,3,0,0,19,1,3,6,3,2,1,3277428,2023-11-14T00:00:00.000Z,421,3,Dennis Smith Jr.,2,9,14,11,8,22.1
0,0,2,4,1,5,2,0,0,24,2,1,5,4,1,0,3277428,2023-11-14T00:00:00.000Z,158,3,Dorian Finney-Smith,1,9,9,5,4,12.8
0,0,0,0,0,0,0,0,0,0,0,0,0,0,0,0,3277428,2023-11-14T00:00:00.000Z,174,3,Harry Giles III,0,0,0,0,0,0
0,0,0,0,0,0,0,0,0,0,0,0,0,0,0,0,3277428,2023-11-14T00:00:00.000Z,56677722,3,Jalen Wilson,0,0,0,0,0,0
0,0,0,0,0,0,0,0,0,0,0,0,0,0,0,0,3277428,2023-11-14T00:00:00.000Z,17896041,3,Keon Johnson,0,0,0,0,0,0
1,0,2,6,3,9,4,0,0,20,0,0,11,2,2,2,3277428,2023-11-14T00:00:00.000Z,464,3,Lonnie Walker IV,2,13,14,12,3,18.9
4,0,4,5,3,17,9,1,0,32,1,2,21,5,4,6,3277428,2023-11-14T00:00:00.000Z,61,3,Mikal Bridges,4,26,30,25,9,39
0,2,4,0,0,5,3,2,2,21,2,4,8,6,1,1,3277428,2023-11-14T00:00:00.000Z,666508,3,Nicolas Claxton,3,14,14,8,6,23.2
0,0,0,0,0,0,0,0,0,0,0,0,0,0,0,0,3277428,2023-11-14T00:00:00.000Z,56677843,3,Noah Clowney,0,0,0,0,0,0
1,0,4,6,4,6,4,2,1,34,0,4,13,4,0,1,3277428,2023-11-14T00:00:00.000Z,351,3,Royce O'Neale,0,17,18,14,5,18.3
9,0,4,10,5,18,10,6,4,37,1,3,29,5,0,1,3277428,2023-11-14T00:00:00.000Z,130,3,Spencer Dinwiddie,0,34,43,38,14,47.5
0,0,0,0,0,0,0,0,0,0,0,0,0,0,0,0,3277428,2023-11-14T00:00:00.000Z,17896058,3,Trendon Watford,0,0,0,0,0,0
0,0,0,0,0,0,0,0,0,0,0,0,0,0,0,0,3277428,2023-11-14T00:00:00.000Z,666885,22,Admiral Schofield,0,0,0,0,0,0
1,0,0,3,0,4,1,0,0,19,0,2,2,0,0,1,3277428,2023-11-14T00:00:00.000Z,56677827,22,Anthony Black,0,2,3,3,1,2.5
0,0,0,1,1,1,1,0,0,5,0,1,3,0,0,0,3277428,2023-11-14T00:00:00.000Z,38017724,22,Caleb Houstan,0,3,3,3,0,3
0,0,0,0,0,0,0,0,0,2,0,0,0,0,0,0,3277428,2023-11-14T00:00:00.000Z,666818,22,Chuma Okeke,0,0,0,0,0,0
2,0,3,8,2,10,2,4,4,28,3,0,10,6,0,4,3277428,2023-11-14T00:00:00.000Z,3547251,22,Cole Anthony,0,16,18,12,8,16.2
5,0,5,8,3,16,8,3,2,36,3,2,21,8,0,0,3277428,2023-11-14T00:00:00.000Z,17896026,22,Franz Wagner,0,29,34,26,13,38.1
0,0,0,0,0,0,0,0,0,0,0,0,0,0,0,0,3277428,2023-11-14T00:00:00.000Z,196,22,Gary Harris,0,0,0,0,0,0
1,0,2,1,0,7,6,2,2,25,1,4,14,3,2,0,3277428,2023-11-14T00:00:00.000Z,666442,22,Goga Bitadze,2,17,18,15,4,25.1
2,1,2,7,2,13,4,0,0,32,0,2,10,2,2,3,3277428,2023-11-14T00:00:00.000Z,17896073,22,Jalen Suggs,3,12,14,12,4,21.4
0,0,0,4,0,4,0,0,0,4,0,0,0,0,0,0,3277428,2023-11-14T00:00:00.000Z,56677839,22,Jett Howard,0,0,0,0,0,0
4,1,2,3,3,4,4,0,0,21,1,1,11,3,1,1,3277428,2023-11-14T00:00:00.000Z,226,22,Joe Ingles,2,14,18,15,7,25.6
1,1,3,4,1,4,1,0,0,12,0,1,3,3,2,2,3277428,2023-11-14T00:00:00.000Z,229,22,Jonathan Isaac,3,6,7,4,4,15.1
0,0,0,0,0,0,0,0,0,0,0,0,0,0,0,0,3277428,2023-11-14T00:00:00.000Z,38017607,22,Kevon Harris,0,0,0,0,0,0
0,0,0,0,0,0,0,0,0,0,0,0,0,0,0,0,3277428,2023-11-14T00:00:00.000Z,165,22,Markelle Fultz,0,0,0,0,0,0
4,0,5,0,0,4,3,6,5,21,1,3,11,6,0,1,3277428,2023-11-14T00:00:00.000Z,462,22,Moritz Wagner,0,17,21,15,10,23.2
0,0,0,0,0,0,0,0,0,0,0,0,0,0,0,0,3277428,2023-11-14T00:00:00.000Z,17553983,22,Trevelin Queen,0,0,0,0,0,0
0,0,0,0,0,0,0,0,0,0,0,0,0,0,0,0,3277428,2023-11-14T00:00:00.000Z,85,22,Wendell Carter Jr.,0,0,0,0,0,0
1,0,0,1,1,1,1,0,0,5,0,0,3,0,1,0,3277429,2023-11-14T00:00:00.000Z,17896078,21,Aaron Wiggins,1,3,4,4,1,7.5
1,0,1,1,0,1,0,0,0,5,0,0,0,1,0,0,3277429,2023-11-14T00:00:00.000Z,3547271,21,Aleksej Pokusevski,0,1,2,1,2,2.7
3,2,4,1,1,5,4,0,0,21,1,1,9,5,2,1,3277429,2023-11-14T00:00:00.000Z,56677833,21,Cason Wallace,4,14,17,12,8,30.5
3,1,7,5,1,10,3,2,2,30,0,2,9,7,2,2,3277429,2023-11-14T00:00:00.000Z,38017685,21,Chet Holmgren,3,16,19,12,10,28.9
0,0,0,0,0,0,0,0,0,0,0,0,0,0,0,0,3277429,2023-11-14T00:00:00.000Z,44,21,Davis Bertans,0,0,0,0,0,0
1,0,2,3,2,5,3,0,0,14,0,1,8,2,2,0,3277429,2023-11-14T00:00:00.000Z,3547272,21,Isaiah Joe,2,10,11,9,3,17.9
3,0,2,3,1,9,5,0,0,23,0,3,11,2,0,3,3277429,2023-11-14T00:00:00.000Z,38017703,21,Jalen Williams,0,13,16,14,5,14.9
2,0,4,4,1,7,1,0,0,18,0,2,3,4,2,0,3277429,2023-11-14T00:00:00.000Z,38017706,21,Jaylin Williams,2,7,9,5,6,16.8
7,2,6,2,0,11,7,5,4,25,1,0,18,7,0,3,3277429,2023-11-14T00:00:00.000Z,17896065,21,Josh Giddey,2,25,32,25,14,39.9
2,0,0,3,1,7,4,0,0,15,0,3,9,0,0,1,3277429,2023-11-14T00:00:00.000Z,480,21,Kenrich Williams,0,9,11,11,2,11
0,0,0,0,0,0,0,0,0,0,0,0,0,0,0,0,3277429,2023-11-14T00:00:00.000Z,56677853,21,Keyontae Johnson,0,0,0,0,0,0
0,0,0,3,2,3,2,0,0,5,0,0,6,0,0,0,3277429,2023-11-14T00:00:00.000Z,27924547,21,Lindy Waters III,0,6,6,6,0,6
0,1,2,3,1,6,2,2,1,24,1,2,6,3,1,0,3277429,2023-11-14T00:00:00.000Z,666541,21,Luguentz Dort,2,9,9,6,3,15.6
0,0,0,0,0,0,0,0,0,0,0,0,0,0,0,0,3277429,2023-11-14T00:00:00.000Z,24572055,21,Olivier Sarr,0,0,0,0,0,0
0,0,0,0,0,0,0,0,0,0,0,0,0,0,0,0,3277429,2023-11-14T00:00:00.000Z,38017716,21,Ousmane Dieng,0,0,0,0,0,0
5,0,5,4,1,16,10,7,7,28,1,2,28,6,7,2,3277429,2023-11-14T00:00:00.000Z,175,21,Shai Gilgeous-Alexander,7,34,39,33,11,61.7
2,0,2,3,1,4,2,0,0,8,0,0,5,2,1,1,3277429,2023-11-14T00:00:00.000Z,17896036,21,Tre Mann,1,7,9,7,4,12.4
4,0,1,3,2,4,2,4,2,19,0,1,8,1,1,2,3277429,2023-11-14T00:00:00.000Z,4197029,21,Vasilije Micic,1,9,13,12,5,16.2
0,0,0,0,0,0,0,0,0,0,0,0,0,0,0,0,3277429,2023-11-14T00:00:00.000Z,38017693,27,Blake Wesley,0,0,0,0,0,0
0,0,0,5,2,5,2,0,0,14,0,0,6,0,0,0,3277429,2023-11-14T00:00:00.000Z,359,27,Cedi Osman,0,6,6,6,0,6
1,0,5,0,0,5,3,0,0,17,2,1,6,7,0,0,3277429,2023-11-14T00:00:00.000Z,17895854,27,Charles Bassey,0,13,14,7,8,15.9
0,0,0,0,0,0,0,0,0,0,0,0,0,0,0,0,3277429,2023-11-14T00:00:00.000Z,56677865,27,Charles Bediako,0,0,0,0,0,0
7,0,1,2,0,3,1,3,2,17,0,2,4,1,0,2,3277429,2023-11-14T00:00:00.000Z,180,27,Devonte' Graham,0,5,12,11,8,13.7
0,0,1,0,0,0,0,0,0,5,0,0,0,1,0,0,3277429,2023-11-14T00:00:00.000Z,38017730,27,Dominick Barlow,0,1,1,0,1,1.2
1,0,1,2,1,4,2,0,0,18,0,0,5,1,0,4,3277429,2023-11-14T00:00:00.000Z,305,27,Doug McDermott,0,6,7,6,2,3.7
3,3,2,7,3,14,4,2,2,31,1,0,13,3,4,2,3277429,2023-11-14T00:00:00.000Z,38017649,27,Julian Champagnie,7,16,19,16,6,40.1
0,0,0,0,0,0,0,0,0,0,0,0,0,0,0,0,3277429,2023-11-14T00:00:00.000Z,666682,27,Keldon Johnson,0,0,0,0,0,0
0,0,1,4,0,13,5,2,1,26,1,2,11,2,1,3,3277429,2023-11-14T00:00:00.000Z,38017692,27,Malaki Branham,1,13,13,11,2,13.4
0,0,0,0,0,0,0,0,0,0,0,0,0,0,0,0,3277429,2023-11-14T00:00:00.000Z,17896059,27,Sandro Mamukelashvili,0,0,0,0,0,0
0,0,0,0,0,0,0,0,0,0,0,0,0,0,0,0,3277429,2023-11-14T00:00:00.000Z,56677817,27,Sidy Cissoko,0,0,0,0,0,0
0,0,0,0,0,0,0,0,0,0,0,0,0,0,0,0,3277429,2023-11-14T00:00:00.000Z,56677870,27,Sir'Jabari Rice,0,0,0,0,0,0
0,0,0,0,0,0,0,0,0,0,0,0,0,0,0,0,3277429,2023-11-14T00:00:00.000Z,3547274,27,Tre Jones,0,0,0,0,0,0
2,2,11,3,0,15,4,0,0,28,3,2,8,14,0,5,3277429,2023-11-14T00:00:00.000Z,56677822,27,Victor Wembanyama,2,22,24,10,16,28.8
0,0,0,0,0,0,0,0,0,0,0,0,0,0,0,0,3277430,2023-11-14T00:00:00.000Z,17896028,7,Greg Brown III,0,0,0,0,0,0
0,0,0,0,0,0,0,0,0,0,0,0,0,0,0,0,3277430,2023-11-14T00:00:00.000Z,329,7,Markieff Morris,0,0,0,0,0,0
2,0,3,4,0,4,0,3,3,13,0,1,3,3,3,1,3277430,2023-11-14T00:00:00.000Z,114,7,Seth Curry,3,6,8,5,5,17.6
7,0,8,5,1,20,11,2,2,36,1,0,25,9,2,2,3277430,2023-11-14T00:00:00.000Z,227,19,Brandon Ingram,2,34,41,32,16,50.3
4,2,3,2,0,5,3,0,0,22,0,1,6,3,1,0,3277430,2023-11-14T00:00:00.000Z,455,19,Jonas Valanciunas,3,9,13,10,7,24.6
5,0,4,0,0,15,8,7,3,27,3,3,19,7,2,2,3277430,2023-11-14T00:00:00.000Z,666969,19,Zion Williamson,2,26,31,24,12,38.9
0,0,0,0,0,0,0,0,0,0,0,0,0,0,0,0,3277431,2023-11-14T00:00:00.000Z,419,25,Anfernee Simons,0,0,0,0,0,0
0,0,0,1,0,1,0,0,0,3,0,1,0,0,1,0,3277431,2023-11-14T00:00:00.000Z,17896120,25,Ish Wainright,1,0,0,0,0,3
1,1,2,6,3,17,10,4,3,27,0,3,26,2,0,2,3277431,2023-11-14T00:00:00.000Z,182,25,Jerami Grant,1,28,29,27,3,30.9
0,0,0,0,0,0,0,0,0,3,1,0,0,1,0,0,3277431,2023-11-14T00:00:00.000Z,47957121,25,Justin Minaya,0,1,1,0,1,1.2
0,0,0,0,0,0,0,0,0,0,0,0,0,0,0,0,3277431,2023-11-14T00:00:00.000Z,65,25,Malcolm Brogdon,0,0,0,0,0,0
0,0,0,0,0,0,0,0,0,0,0,0,0,0,0,0,3277431,2023-11-14T00:00:00.000Z,666476,25,Moses Brown,0,0,0,0,0,0
0,0,0,0,0,2,0,2,1,2,0,0,1,0,0,0,3277431,2023-11-14T00:00:00.000Z,56677829,25,Rayan Rupert,0,1,1,1,0,1
0,0,0,0,0,0,0,0,0,0,0,0,0,0,0,0,3277431,2023-11-14T00:00:00.000Z,476,25,Robert Williams III,0,0,0,0,0,0
0,0,0,0,0,0,0,0,0,0,0,0,0,0,0,0,3277431,2023-11-14T00:00:00.000Z,56677747,25,Scoot Henderson,0,0,0,0,0,0
7,0,6,10,2,16,4,10,7,41,2,3,17,8,2,3,3277431,2023-11-14T00:00:00.000Z,38017690,25,Shaedon Sharpe,2,25,32,24,15,40.1
1,2,3,4,2,6,3,2,1,26,2,2,9,5,0,2,3277431,2023-11-14T00:00:00.000Z,56677850,25,Toumani Camara,2,14,15,10,6,20.5
0,0,0,0,0,0,0,0,0,0,0,0,0,0,0,0,3277431,2023-11-14T00:00:00.000Z,56677842,29,Brice Sensabaugh,0,0,0,0,0,0
0,0,0,0,0,0,0,0,0,0,0,0,0,0,0,0,3277431,2023-11-14T00:00:00.000Z,38017630,29,Johnny Juzang,0,0,0,0,0,0
0,0,0,0,0,0,0,0,0,0,0,0,0,0,0,0,3277431,2023-11-14T00:00:00.000Z,17896023,29,Josh Christopher,0,0,0,0,0,0
0,0,0,0,0,0,0,0,0,1,0,0,0,0,0,1,3277431,2023-11-14T00:00:00.000Z,139,29,Kris Dunn,0,0,0,0,0,-1
0,0,0,0,0,0,0,0,0,1,0,0,0,0,0,0,3277431,2023-11-14T00:00:00.000Z,666881,29,Luka Samanic,0,0,0,0,0,0
0,0,0,0,0,0,0,0,0,0,0,0,0,0,0,0,3277431,2023-11-14T00:00:00.000Z,19465584,29,Micah Potter,0,0,0,0,0,0
0,0,0,0,0,0,0,0,0,1,0,0,0,0,0,0,3277431,2023-11-14T00:00:00.000Z,11891374,29,Omer Yurtseven,0,0,0,0,0,0
0,0,1,2,0,2,0,0,0,16,0,2,0,1,0,0,3277431,2023-11-14T00:00:00.000Z,38017739,29,Simone Fontecchio,0,1,1,0,1,1.2
0,0,0,0,0,0,0,0,0,0,0,0,0,0,0,0,3277431,2023-11-14T00:00:00.000Z,56677824,29,Taylor Hendricks,0,0,0,0,0,0
0,0,0,0,0,0,0,0,0,0,0,0,0,0,0,0,3277431,2023-11-14T00:00:00.000Z,38017705,29,Walker Kessler,0,0,0,0,0,0
0,0,0,0,0,0,0,0,0,0,0,0,0,0,0,0,3277432,2023-11-14T00:00:00.000Z,56677871,8,Hunter Tyson,0,0,0,0,0,0
0,0,0,0,0,0,0,0,0,0,0,0,0,0,0,0,3277432,2023-11-14T00:00:00.000Z,335,8,Jamal Murray,0,0,0,0,0,0
0,0,0,0,0,0,0,0,0,0,0,0,0,0,0,0,3277432,2023-11-14T00:00:00.000Z,17896103,8,Jay Huff,0,0,0,0,0,0
0,0,0,0,0,0,0,0,0,0,0,0,0,0,0,0,3277432,2023-11-14T00:00:00.000Z,666511,13,Amir Coffey,0,0,0,0,0,0
0,0,0,0,0,0,0,0,0,0,0,0,0,0,0,0,3277432,2023-11-14T00:00:00.000Z,17896022,13,Brandon Boston Jr.,0,0,0,0,0,0
3,1,6,0,0,8,2,6,5,26,7,4,9,13,0,0,3277432,2023-11-14T00:00:00.000Z,493,13,Ivica Zubac,1,22,25,12,16,32.1
4,0,2,8,3,15,7,4,4,36,0,3,21,2,0,1,3277432,2023-11-14T00:00:00.000Z,192,13,James Harden,0,23,27,25,6,28.4
0,0,0,0,0,0,0,0,0,0,0,0,0,0,0,0,3277432,2023-11-14T00:00:00.000Z,56677856,13,Jordan Miller,0,0,0,0,0,0
0,0,0,0,0,0,0,0,0,0,0,0,0,0,0,0,3277432,2023-11-14T00:00:00.000Z,17896051,13,Joshua Primo,0,0,0,0,0,0
2,0,2,3,2,14,5,4,3,38,0,1,15,2,5,3,3277432,2023-11-14T00:00:00.000Z,274,13,Kawhi Leonard,5,17,19,17,4,32.4
0,0,0,0,0,0,0,0,0,0,0,0,0,0,0,0,3277432,2023-11-14T00:00:00.000Z,56677849,13,Kobe Brown,0,0,0,0,0,0
0,0,0,0,0,0,0,0,0,0,0,0,0,0,0,0,3277432,2023-11-14T00:00:00.000Z,371,13,Mason Plumlee,0,0,0,0,0,0
0,0,0,0,0,0,0,0,0,0,0,0,0,0,0,0,3277432,2023-11-14T00:00:00.000Z,38017725,13,Moussa Diabate,0,0,0,0,0,0
3,0,7,11,4,26,13,5,5,40,0,4,35,7,3,1,3277432,2023-11-14T00:00:00.000Z,172,13,Paul George,3,42,45,38,10,55.9
0,1,5,7,1,15,4,0,0,27,2,5,9,7,3,4,3277433,2023-11-14T00:00:00.000Z,475,10,Andrew Wiggins,4,16,16,9,7,25.4
5,0,6,8,3,18,9,2,2,39,1,4,23,7,1,3,3277433,2023-11-14T00:00:00.000Z,56677858,10,Brandin Podziemski,1,30,35,28,12,38.9
4,1,5,3,2,14,6,1,1,36,0,0,15,5,3,4,3277433,2023-11-14T00:00:00.000Z,367,10,Chris Paul,4,20,24,19,9,35
4,0,0,3,2,6,2,1,0,13,0,1,6,0,0,2,3277433,2023-11-14T00:00:00.000Z,251,10,Cory Joseph,0,6,10,10,4,10
4,0,3,11,3,15,6,6,6,32,1,4,21,4,2,2,3277433,2023-11-14T00:00:00.000Z,407,10,Dario Saric,2,25,29,25,8,35.8
0,0,2,0,0,0,0,0,0,2,0,1,0,2,0,1,3277433,2023-11-14T00:00:00.000Z,185,10,Draymond Green,0,2,2,0,2,1.4
2,0,2,3,1,5,3,0,0,16,1,1,7,3,0,0,3277433,2023-11-14T00:00:00.000Z,2189,10,Gary Payton II,0,10,12,9,5,13.6
0,0,0,0,0,0,0,0,0,0,0,0,0,0,0,0,3277433,2023-11-14T00:00:00.000Z,57875092,10,Gui Santos,0,0,0,0,0,0
0,0,0,0,0,0,0,0,0,0,0,0,0,0,0,0,3277433,2023-11-14T00:00:00.000Z,398,10,Jerome Robinson,0,0,0,0,0,0
1,0,1,1,0,3,2,2,1,16,1,2,5,2,0,1,3277433,2023-11-14T00:00:00.000Z,17553979,10,Jonathan Kuminga,0,7,8,6,3,7.9
3,0,6,0,0,4,1,0,0,31,6,2,2,12,1,0,3277433,2023-11-14T00:00:00.000Z,282,10,Kevon Looney,1,14,17,5,15,23.9
0,0,0,1,0,1,0,0,0,2,0,0,0,0,0,0,3277433,2023-11-14T00:00:00.000Z,443,10,Klay Thompson,0,0,0,0,0,0
0,0,0,0,0,0,0,0,0,0,0,0,0,0,0,0,3277433,2023-11-14T00:00:00.000Z,45658838,10,Lester Quinones,0,0,0,0,0,0
2,0,1,2,1,6,4,2,2,14,1,0,11,2,1,0,3277433,2023-11-14T00:00:00.000Z,17553992,10,Moses Moody,1,13,15,13,4,19.4
0,0,0,0,0,0,0,0,0,0,0,0,0,0,0,0,3277433,2023-11-14T00:00:00.000Z,115,10,Stephen Curry,0,0,0,0,0,0
3,0,2,0,0,1,0,2,2,12,0,2,2,2,0,2,3277433,2023-11-14T00:00:00.000Z,56677799,10,Trayce Jackson-Davis,0,4,7,5,5,6.9
0,0,0,0,0,0,0,0,0,0,0,0,0,0,0,0,3277433,2023-11-14T00:00:00.000Z,17896070,10,Usman Garuba,0,0,0,0,0,0
4,0,4,6,3,16,7,5,3,36,0,1,20,4,3,5,3277433,2023-11-14T00:00:00.000Z,3547238,18,Anthony Edwards,3,24,28,24,8,34.8
0,0,0,1,0,1,0,0,0,2,0,0,0,0,0,0,3277433,2023-11-14T00:00:00.000Z,3547259,18,Jaden McDaniels,0,0,0,0,0,0
0,0,0,0,0,0,0,0,0,0,0,0,0,0,0,0,3277433,2023-11-14T00:00:00.000Z,666767,18,Jordan McLaughlin,0,0,0,0,0,0
2,0,10,12,5,26,12,4,4,42,1,1,33,11,2,5,3277433,2023-11-14T00:00:00.000Z,447,18,Karl-Anthony Towns,2,44,46,35,13,50.2
0,0,0,0,0,0,0,0,0,0,0,0,0,0,0,0,3277433,2023-11-14T00:00:00.000Z,56677782,18,Leonard Miller,0,0,0,0,0,0
0,0,0,0,0,0,0,0,0,0,0,0,0,0,0,0,3277433,2023-11-14T00:00:00.000Z,17896056,18,Luka Garza,0,0,0,0,0,0
2,3,7,0,0,8,2,6,5,35,6,4,9,13,0,2,3277433,2023-11-14T00:00:00.000Z,176,18,Rudy Gobert,3,22,24,11,15,34.6
0,0,0,0,0,0,0,0,0,0,0,0,0,0,0,0,3277433,2023-11-14T00:00:00.000Z,38017700,18,Wendell Moore Jr.,0,0,0,0,0,0
0,0,0,0,0,0,0,0,0,0,0,0,0,0,0,0,3277434,2023-11-14T00:00:00.000Z,56677867,14,Alex Fudge,0,0,0,0,0,0
5,6,7,0,0,11,7,6,5,27,4,1,19,11,0,2,3277434,2023-11-14T00:00:00.000Z,117,14,Anthony Davis,6,30,35,24,16,55.7
7,0,10,4,4,9,5,3,2,29,2,0,16,12,0,3,3277434,2023-11-14T00:00:00.000Z,17553995,14,Austin Reaves,0,28,35,23,19,37.9
2,0,1,5,3,7,3,2,1,25,0,2,10,1,0,0,3277434,2023-11-14T00:00:00.000Z,666860,14,Cameron Reddish,0,11,13,12,3,14.2
2,1,7,3,0,8,1,0,0,22,3,2,2,10,0,3,3277434,2023-11-14T00:00:00.000Z,486,14,Christian Wood,1,12,14,4,12,17
0,0,0,0,0,0,0,0,0,0,0,0,0,0,0,0,3277434,2023-11-14T00:00:00.000Z,56677738,14,Colin Castleton,0,0,0,0,0,0
5,0,3,8,6,12,8,3,2,27,0,0,24,3,0,0,3277434,2023-11-14T00:00:00.000Z,405,14,D'Angelo Russell,0,27,32,29,8,35.1
0,0,0,0,0,0,0,0,0,0,0,0,0,0,0,0,3277434,2023-11-14T00:00:00.000Z,56677868,14,D'Moi Hodge,0,0,0,0,0,0
0,0,0,0,0,0,0,0,0,0,0,0,0,0,0,0,3277434,2023-11-14T00:00:00.000Z,1603383,14,Gabe Vincent,0,0,0,0,0,0
0,0,0,0,0,0,0,0,0,0,0,0,0,0,0,0,3277434,2023-11-14T00:00:00.000Z,457,14,Jarred Vanderbilt,0,0,0,0,0,0
1,3,0,0,0,4,4,4,3,21,1,2,11,1,1,0,3277434,2023-11-14T00:00:00.000Z,666626,14,Jaxson Hayes,4,12,13,12,2,25.7
6,0,9,6,3,11,6,2,1,23,0,1,16,9,1,4,3277434,2023-11-14T00:00:00.000Z,237,14,LeBron James,1,25,31,22,15,34.8
1,0,1,1,1,2,2,0,0,8,0,0,5,1,1,1,3277434,2023-11-14T00:00:00.000Z,38017697,14,Max Christie,1,6,7,6,2,9.7
0,0,3,3,3,10,8,4,4,24,0,2,23,3,0,5,3277434,2023-11-14T00:00:00.000Z,666609,14,Rui Hachimura,0,26,26,23,3,21.6
1,0,3,5,2,6,3,0,0,29,0,3,8,3,1,0,3277434,2023-11-14T00:00:00.000Z,383,14,Taurean Prince,1,11,12,9,4,16.1
0,0,0,0,0,0,0,0,0,0,0,0,0,0,0,0,3277434,2023-11-14T00:00:00.000Z,666505,15,Brandon Clarke,0,0,0,0,0,0
5,0,1,6,2,10,5,3,3,27,0,1,15,1,0,2,3277434,2023-11-14T00:00:00.000Z,3547287,15,Desmond Bane,0,16,21,20,6,21.7
0,0,0,0,0,0,0,0,0,0,0,0,0,0,0,0,3277434,2023-11-14T00:00:00.000Z,56677830,15,GG Jackson,0,0,0,0,0,0
0,0,0,0,0,0,0,0,0,0,0,0,0,0,0,0,3277434,2023-11-14T00:00:00.000Z,666786,15,Ja Morant,0,0,0,0,0,0
0,0,0,0,0,0,0,0,0,0,0,0,0,0,0,0,3277434,2023-11-14T00:00:00.000Z,38017728,15,Jake LaRavia,0,0,0,0,0,0
0,0,0,1,0,2,0,0,0,5,0,0,0,0,0,0,3277434,2023-11-14T00:00:00.000Z,38017732,15,Kenneth Lofton Jr.,0,0,0,0,0,0
0,0,0,0,0,0,0,0,0,0,0,0,0,0,0,0,3277434,2023-11-14T00:00:00.000Z,3,15,Steven Adams,0,0,0,0,0,0
0,0,1,1,0,1,0,0,0,5,0,0,0,1,0,0,3277434,2023-11-14T00:00:00.000Z,38017731,15,Vince Williams Jr.,0,1,1,0,1,1.2
3,0,7,1,0,6,2,2,1,19,0,3,5,7,0,0,1037750,2023-11-15T00:00:00.000Z,151,7,Dante Exum,0,12,15,8,10,17.9
2,2,5,0,0,8,7,3,3,24,4,2,17,9,1,1,1037750,2023-11-15T00:00:00.000Z,56677840,7,Dereck Lively II,3,26,28,19,11,38.8
0,0,0,0,0,0,0,0,0,0,0,0,0,0,0,0,1037750,2023-11-15T00:00:00.000Z,56677873,7,Dexter Dennis,0,0,0,0,0,0
2,0,1,0,0,1,1,0,0,7,0,1,2,1,0,0,1037750,2023-11-15T00:00:00.000Z,379,7,Dwight Powell,0,3,5,4,3,6.2
7,0,1,7,2,13,4,0,0,35,2,1,10,3,1,1,1037750,2023-11-15T00:00:00.000Z,666965,7,Grant Williams,1,13,20,17,10,26.1
0,0,0,0,0,0,0,0,0,0,0,0,0,0,0,0,1037750,2023-11-15T00:00:00.000Z,17896028,7,Greg Brown III,0,0,0,0,0,0
0,0,0,0,0,2,1,1,0,4,0,0,2,0,1,1,1037750,2023-11-15T00:00:00.000Z,38017679,7,Jaden Hardy,1,2,2,2,0,4
1,0,3,4,0,4,0,0,0,37,1,1,0,4,1,0,1037750,2023-11-15T00:00:00.000Z,3547258,7,Josh Green,1,4,5,1,5,9.3
10,0,6,11,4,18,7,12,8,32,1,2,26,7,0,3,1037750,2023-11-15T00:00:00.000Z,132,7,Luka Doncic,0,33,43,36,17,46.4
0,0,0,0,0,0,0,0,0,0,0,0,0,0,0,0,1037750,2023-11-15T00:00:00.000Z,329,7,Markieff Morris,0,0,0,0,0,0
1,0,2,1,0,2,1,2,0,7,0,0,2,2,0,0,1037750,2023-11-15T00:00:00.000Z,56677859,7,Olivier-Maxence Prosper,0,4,5,3,3,5.9
0,0,0,0,0,1,0,0,0,2,0,0,0,0,0,1,1037750,2023-11-15T00:00:00.000Z,217,7,Richaun Holmes,0,0,0,0,0,-1
2,0,2,2,2,6,6,1,1,20,0,1,15,2,1,0,1037750,2023-11-15T00:00:00.000Z,114,7,Seth Curry,1,17,19,17,4,23.4
3,0,4,11,7,20,11,5,2,27,0,1,31,4,0,1,1037750,2023-11-15T00:00:00.000Z,191,7,Tim Hardaway Jr.,0,35,38,34,7,39.3
4,0,2,4,3,6,5,2,2,24,1,4,15,3,3,0,1037750,2023-11-15T00:00:00.000Z,3547242,30,Deni Avdija,3,18,22,19,7,33.6
3,0,4,6,2,18,6,10,8,30,2,1,22,6,0,2,1037750,2023-11-15T00:00:00.000Z,265,30,Kyle Kuzma,0,28,31,25,9,31.7
0,0,0,0,0,0,0,0,0,0,0,0,0,0,0,0,1037751,2023-11-15T00:00:00.000Z,38017689,1,AJ Griffin,0,0,0,0,0,0
3,1,2,11,4,15,8,8,8,29,1,4,28,3,2,1,1037751,2023-11-15T00:00:00.000Z,53,1,Bogdan Bogdanovic,3,31,34,31,6,44.1
0,0,0,0,0,0,0,0,0,0,0,0,0,0,0,0,1037751,2023-11-15T00:00:00.000Z,666564,1,Bruno Fernando,0,0,0,0,0,0
1,2,3,0,0,5,4,2,0,26,0,2,8,3,2,0,1037751,2023-11-15T00:00:00.000Z,83,1,Clint Capela,4,11,12,9,4,25.1
1,0,1,3,1,7,2,0,0,26,1,3,5,2,0,1,1037751,2023-11-15T00:00:00.000Z,666656,1,De'Andre Hunter,0,7,8,6,3,7.9
2,0,5,3,0,12,6,3,1,33,0,1,13,5,1,1,1037751,2023-11-15T00:00:00.000Z,334,1,Dejounte Murray,1,18,20,15,7,24
0,0,0,0,0,0,0,0,0,0,0,0,0,0,0,0,1037751,2023-11-15T00:00:00.000Z,666754,1,Garrison Mathews,0,0,0,0,0,0
0,2,5,4,4,9,7,0,0,31,0,1,18,5,0,3,1037751,2023-11-15T00:00:00.000Z,17896040,1,Jalen Johnson,2,23,23,18,5,27
0,0,0,0,0,0,0,0,0,0,0,0,0,0,0,0,1037751,2023-11-15T00:00:00.000Z,56677838,1,Kobe Bufkin,0,0,0,0,0,0
0,0,0,0,0,0,0,0,0,0,0,0,0,0,0,0,1037751,2023-11-15T00:00:00.000Z,56677875,1,Miles Norris,0,0,0,0,0,0
0,0,0,0,0,0,0,0,0,0,0,0,0,0,0,0,1037751,2023-11-15T00:00:00.000Z,56677806,1,Mouhamed Gueye,0,0,0,0,0,0
1,1,4,0,0,4,2,4,4,22,2,4,8,6,1,4,1037751,2023-11-15T00:00:00.000Z,3547244,1,Onyeka Okongwu,2,14,15,9,7,18.7
0,0,0,0,0,0,0,0,0,0,0,0,0,0,0,0,1037751,2023-11-15T00:00:00.000Z,319,1,Patty Mills,0,0,0,0,0,0
2,0,1,5,2,10,7,0,0,28,1,3,16,2,2,2,1037751,2023-11-15T00:00:00.000Z,3547256,1,Saddiq Bey,2,18,20,18,4,25.4
0,0,0,0,0,0,0,0,0,0,0,0,0,0,0,0,1037751,2023-11-15T00:00:00.000Z,56677855,1,Seth Lundy,0,0,0,0,0,0
17,0,1,4,0,12,4,9,7,35,0,0,15,1,2,3,1037751,2023-11-15T00:00:00.000Z,490,1,Trae Young,2,16,33,32,18,44.7
0,0,0,0,0,0,0,0,0,0,0,0,0,0,0,0,1037751,2023-11-15T00:00:00.000Z,3547297,1,Trent Forrest,0,0,0,0,0,0
1,0,2,1,1,1,1,0,0,10,1,2,3,3,1,0,1037751,2023-11-15T00:00:00.000Z,301,1,Wesley Matthews,1,6,7,4,4,11.1
0,0,0,0,0,0,0,0,0,0,0,0,0,0,0,0,1037751,2023-11-15T00:00:00.000Z,666675,20,DaQuan Jeffries,0,0,0,0,0,0
3,0,3,2,0,8,3,0,0,22,1,1,6,4,2,4,1037751,2023-11-15T00:00:00.000Z,131,20,Donte DiVincenzo,2,10,13,9,7,17.3
0,0,0,0,0,0,0,0,0,0,0,0,0,0,0,0,1037751,2023-11-15T00:00:00.000Z,160,20,Evan Fournier,0,0,0,0,0,0
4,0,0,5,3,11,6,6,5,28,0,3,20,0,1,2,1037751,2023-11-15T00:00:00.000Z,3547269,20,Immanuel Quickley,1,20,24,24,4,27
0,0,1,0,0,9,5,1,1,17,3,2,11,4,1,0,1037751,2023-11-15T00:00:00.000Z,201,20,Isaiah Hartenstein,1,15,15,11,4,18.8
8,0,0,10,6,19,8,2,2,41,0,2,24,0,0,3,1037751,2023-11-15T00:00:00.000Z,73,20,Jalen Brunson,0,24,32,32,8,33
0,0,0,0,0,0,0,0,0,0,0,0,0,0,0,0,1037751,2023-11-15T00:00:00.000Z,17896063,20,Jericho Sims,0,0,0,0,0,0
5,1,6,5,1,10,4,0,0,33,2,4,9,8,0,2,1037751,2023-11-15T00:00:00.000Z,202,20,Josh Hart,1,17,22,14,13,27.1
8,0,8,5,3,24,12,2,2,39,2,4,29,10,1,1,1037751,2023-11-15T00:00:00.000Z,387,20,Julius Randle,1,39,47,37,18,55
0,0,0,0,0,0,0,0,0,1,0,1,0,0,0,0,1037751,2023-11-15T00:00:00.000Z,17896033,20,Miles McBride,0,0,0,0,0,0
0,1,9,0,0,3,3,0,0,31,6,0,6,15,3,1,1037751,2023-11-15T00:00:00.000Z,399,20,Mitchell Robinson,4,21,21,6,15,35
1,0,1,7,3,10,4,0,0,28,0,3,11,1,1,3,1037751,2023-11-15T00:00:00.000Z,17895858,20,Quentin Grimes,1,12,13,12,2,13.7
0,0,0,0,0,0,0,0,0,0,0,0,0,0,0,0,1037751,2023-11-15T00:00:00.000Z,19,20,Ryan Arcidiacono,0,0,0,0,0,0
3,5,7,8,4,9,5,0,0,29,1,2,14,8,0,0,1037752,2023-11-15T00:00:00.000Z,219,2,Al Horford,5,22,25,17,11,43.1
5,0,3,8,4,12,7,10,9,36,0,3,27,3,1,2,1037752,2023-11-15T00:00:00.000Z,473,2,Derrick White,1,30,35,32,8,39.1
0,0,0,0,0,0,0,0,0,0,0,0,0,0,0,0,1037752,2023-11-15T00:00:00.000Z,70,2,Jaylen Brown,0,0,0,0,0,0
6,0,6,10,4,23,10,6,5,39,2,1,29,8,2,3,1037752,2023-11-15T00:00:00.000Z,434,2,Jayson Tatum,2,37,43,35,14,50.6
0,0,0,0,0,0,0,0,0,0,0,0,0,0,0,0,1037752,2023-11-15T00:00:00.000Z,38017707,2,JD Davison,0,0,0,0,0,0
0,0,0,0,0,0,0,0,0,0,0,0,0,0,0,0,1037752,2023-11-15T00:00:00.000Z,56677864,2,Jordan Walsh,0,0,0,0,0,0
3,2,8,9,2,18,8,1,0,36,2,0,18,10,1,1,1037752,2023-11-15T00:00:00.000Z,214,2,Jrue Holiday,3,28,31,21,13,42.5
0,0,0,0,0,0,0,0,0,0,0,0,0,0,0,0,1037752,2023-11-15T00:00:00.000Z,378,2,Kristaps Porzingis,0,0,0,0,0,0
0,0,0,0,0,0,0,0,0,0,0,0,0,0,0,0,1037752,2023-11-15T00:00:00.000Z,3547279,2,Lamar Stevens,0,0,0,0,0,0
0,0,0,0,0,0,0,0,0,0,0,0,0,0,0,0,1037752,2023-11-15T00:00:00.000Z,3547295,2,Nathan Knight,0,0,0,0,0,0
3,0,1,3,1,5,2,0,0,23,1,0,5,2,0,0,1037752,2023-11-15T00:00:00.000Z,3547276,2,Payton Pritchard,0,7,10,8,5,11.9
2,1,1,8,2,9,3,0,0,35,1,2,8,2,0,0,1037752,2023-11-15T00:00:00.000Z,17896060,2,Sam Hauser,1,10,12,10,4,16.4
0,0,0,3,1,4,2,0,0,15,1,3,5,1,1,1,1037752,2023-11-15T00:00:00.000Z,338,2,Svi Mykhailiuk,1,6,6,5,1,8.2
0,0,0,1,0,1,0,0,0,3,0,0,0,0,0,0,1037752,2023-11-15T00:00:00.000Z,2175,23,Danuel House Jr.,0,0,0,0,0,0
1,0,6,6,5,10,5,2,1,34,1,3,16,7,0,0,1037752,2023-11-15T00:00:00.000Z,313,23,De'Anthony Melton,0,23,24,17,8,25.9
0,0,0,1,0,1,0,0,0,3,0,0,0,0,0,0,1037752,2023-11-15T00:00:00.000Z,260,23,Furkan Korkmaz,0,0,0,0,0,0
0,0,2,1,1,5,4,0,0,20,0,2,9,2,2,2,1037752,2023-11-15T00:00:00.000Z,17896025,23,Jaden Springer,2,11,11,9,2,15.4
0,0,0,0,0,0,0,0,0,0,0,0,0,0,0,0,1037752,2023-11-15T00:00:00.000Z,17554001,23,Javonte Smart,0,0,0,0,0,0
7,0,6,2,0,16,8,4,4,34,3,3,20,9,1,2,1037752,2023-11-15T00:00:00.000Z,145,23,Joel Embiid,1,29,36,27,16,42.3
0,0,0,0,0,0,0,0,0,0,0,0,0,0,0,0,1037752,2023-11-15T00:00:00.000Z,360,23,Kelly Oubre Jr.,0,0,0,0,0,0
0,0,0,0,0,0,0,0,0,0,0,0,0,0,0,0,1037752,2023-11-15T00:00:00.000Z,3547294,23,Kenyon Martin Jr.,0,0,0,0,0,0
0,0,0,2,0,3,0,0,0,8,0,0,0,0,0,1,1037752,2023-11-15T00:00:00.000Z,328,23,Marcus Morris,0,0,0,0,0,-1
0,0,0,0,0,0,0,0,0,0,0,0,0,0,0,0,1037752,2023-11-15T00:00:00.000Z,28,23,Mo Bamba,0,0,0,0,0,0
0,0,0,0,0,0,0,0,0,0,0,0,0,0,0,0,1037752,2023-11-15T00:00:00.000Z,33,23,Nicolas Batum,0,0,0,0,0,0
1,0,1,2,0,4,0,2,0,10,0,1,0,1,0,0,1037752,2023-11-15T00:00:00.000Z,45,23,Patrick Beverley,0,1,2,1,2,2.7
2,1,3,1,1,5,4,2,1,14,3,1,10,6,0,1,1037752,2023-11-15T00:00:00.000Z,3547270,23,Paul Reed,1,16,18,12,8,22.2
0,0,0,0,0,0,0,0,0,0,0,0,0,0,0,0,1037752,2023-11-15T00:00:00.000Z,56913527,23,Ricky Council IV,0,0,0,0,0,0
0,0,3,5,0,13,6,4,4,37,3,1,16,6,2,0,1037752,2023-11-15T00:00:00.000Z,108,23,Robert Covington,2,22,22,16,6,29.2
0,0,0,0,0,0,0,0,0,0,0,0,0,0,0,0,1037752,2023-11-15T00:00:00.000Z,56677788,23,Terquavion Smith,0,0,0,0,0,0
3,0,7,2,1,12,6,3,3,38,0,0,16,7,0,1,1037752,2023-11-15T00:00:00.000Z,200,23,Tobias Harris,0,23,26,19,10,27.9
4,0,3,7,3,15,6,5,5,39,0,3,20,3,0,2,1037752,2023-11-15T00:00:00.000Z,3547254,23,Tyrese Maxey,0,23,27,24,7,27.6
0,0,0,1,0,1,0,0,0,7,0,0,0,0,0,0,1037753,2023-11-15T00:00:00.000Z,38017733,17,A.J. Green,0,0,0,0,0,0
1,0,0,0,0,1,0,0,0,17,2,2,0,2,0,2,1037753,2023-11-15T00:00:00.000Z,56677852,17,Andre Jackson Jr.,0,2,3,1,3,1.9
0,2,6,3,2,11,7,2,2,31,1,5,18,7,0,0,1037753,2023-11-15T00:00:00.000Z,377,17,Bobby Portis,2,25,25,18,7,32.4
4,7,6,3,1,10,4,1,1,33,2,2,10,8,1,0,1037753,2023-11-15T00:00:00.000Z,283,17,Brook Lopez,8,18,22,14,12,49.6
2,0,1,4,3,8,4,2,2,16,0,2,13,1,0,0,1037753,2023-11-15T00:00:00.000Z,368,17,Cameron Payne,0,14,16,15,3,17.2
0,0,0,0,0,0,0,0,0,0,0,0,0,0,0,0,1037753,2023-11-15T00:00:00.000Z,56677854,17,Chris Livingston,0,0,0,0,0,0
13,0,4,10,4,18,9,16,15,31,0,1,37,4,2,4,1037753,2023-11-15T00:00:00.000Z,278,17,Damian Lillard,2,41,54,50,17,63.3
0,0,0,0,0,0,0,0,0,0,0,0,0,0,0,0,1037753,2023-11-15T00:00:00.000Z,15,17,Giannis Antetokounmpo,0,0,0,0,0,0
0,0,0,0,0,0,0,0,0,0,0,0,0,0,0,0,1037753,2023-11-15T00:00:00.000Z,112,17,Jae Crowder,0,0,0,0,0,0
4,0,4,2,1,9,5,0,0,20,1,3,11,5,2,4,1037753,2023-11-15T00:00:00.000Z,315,17,Khris Middleton,2,16,20,15,9,25
0,0,0,1,0,1,0,0,0,2,0,1,0,0,0,1,1037753,2023-11-15T00:00:00.000Z,666960,17,Lindell Wigginton,0,0,0,0,0,-1
0,0,4,11,8,14,11,0,0,31,0,2,30,4,1,0,1037753,2023-11-15T00:00:00.000Z,38,17,Malik Beasley,1,34,34,30,4,37.8
1,0,0,0,0,3,2,0,0,10,0,2,4,0,1,0,1037753,2023-11-15T00:00:00.000Z,38017676,17,MarJon Beauchamp,1,4,5,5,1,8.5
0,0,0,0,0,0,0,0,0,0,0,0,0,0,0,0,1037753,2023-11-15T00:00:00.000Z,666453,17,Marques Bolden,0,0,0,0,0,0
0,0,6,3,1,3,1,0,0,23,1,2,3,7,0,1,1037753,2023-11-15T00:00:00.000Z,105,17,Pat Connaughton,0,10,10,3,7,10.4
0,0,0,0,0,0,0,0,0,2,0,0,0,0,0,0,1037753,2023-11-15T00:00:00.000Z,284,17,Robin Lopez,0,0,0,0,0,0
0,0,0,0,0,5,1,0,0,15,2,3,2,2,0,0,1037753,2023-11-15T00:00:00.000Z,2148,17,Thanasis Antetokounmpo,0,4,4,2,2,4.4
0,0,1,1,0,1,0,0,0,2,0,0,0,1,1,1,1037753,2023-11-15T00:00:00.000Z,38017691,17,TyTy Washington Jr.,1,1,1,0,1,3.2
0,1,4,3,1,8,2,4,4,20,5,1,9,9,0,1,1037753,2023-11-15T00:00:00.000Z,58,28,Chris Boucher,1,18,18,9,9,21.8
0,0,0,0,0,0,0,0,0,0,0,0,0,0,0,0,1037753,2023-11-15T00:00:00.000Z,38017710,28,Christian Koloko,0,0,0,0,0,0
5,0,3,4,1,9,2,4,4,23,0,3,9,3,2,2,1037753,2023-11-15T00:00:00.000Z,409,28,Dennis Schroder,2,12,17,14,8,24.1
0,0,1,1,1,1,1,0,0,4,0,0,3,1,0,0,1037753,2023-11-15T00:00:00.000Z,436,28,Garrett Temple,0,4,4,3,1,4.2
0,0,0,0,0,0,0,0,0,0,0,0,0,0,0,0,1037753,2023-11-15T00:00:00.000Z,3089,28,Gary Trent Jr.,0,0,0,0,0,0
2,0,0,6,1,10,2,6,6,26,0,4,11,0,1,1,1037753,2023-11-15T00:00:00.000Z,56677828,28,Gradey Dick,1,11,13,13,2,16
1,2,4,0,0,10,6,2,1,27,7,4,13,11,4,0,1037753,2023-11-15T00:00:00.000Z,373,28,Jakob Poeltl,6,24,25,14,12,45.7
1,1,4,4,1,10,3,0,0,18,0,0,7,4,1,1,1037753,2023-11-15T00:00:00.000Z,666762,28,Jalen McDaniels,2,11,12,8,5,18.3
0,0,0,0,0,0,0,0,0,0,0,0,0,0,0,0,1037753,2023-11-15T00:00:00.000Z,56677805,28,Javon Freeman-Liberty,0,0,0,0,0,0
5,1,1,8,0,11,3,1,1,27,2,1,7,3,0,0,1037753,2023-11-15T00:00:00.000Z,3547275,28,Malachi Flynn,1,10,15,12,8,21.1
2,0,0,0,0,1,0,2,2,3,2,0,2,2,1,0,1037753,2023-11-15T00:00:00.000Z,56677869,28,Markquis Nowell,1,4,6,4,4,10.4
0,0,0,0,0,0,0,0,0,0,0,0,0,0,0,0,1037753,2023-11-15T00:00:00.000Z,18,28,OG Anunoby,0,0,0,0,0,0
0,0,1,0,0,0,0,0,0,11,0,0,0,1,0,0,1037753,2023-11-15T00:00:00.000Z,376,28,Otto Porter Jr.,0,1,1,0,1,1.2
5,1,5,2,0,9,4,5,3,29,2,1,11,7,0,4,1037753,2023-11-15T00:00:00.000Z,416,28,Pascal Siakam,1,18,23,16,12,25.9
0,2,1,2,1,7,4,2,2,17,3,3,11,4,0,1,1037753,2023-11-15T00:00:00.000Z,3547249,28,Precious Achiuwa,2,15,15,11,4,20.8
0,0,0,0,0,0,0,0,0,0,0,0,0,0,0,0,1037753,2023-11-15T00:00:00.000Z,38017717,28,Ron Harper Jr.,0,0,0,0,0,0
7,0,4,3,3,19,11,5,4,31,5,2,29,9,1,3,1037753,2023-11-15T00:00:00.000Z,17896055,28,Scottie Barnes,1,38,45,36,16,50.3
0,0,1,0,0,1,0,0,0,4,0,0,0,1,0,1,1037753,2023-11-15T00:00:00.000Z,489,28,Thaddeus Young,0,1,1,0,1,0.2
0,0,0,0,0,0,0,0,0,0,0,0,0,0,0,0,1037754,2023-11-15T00:00:00.000Z,56677860,5,Adama Sanogo,0,0,0,0,0,0
0,0,0,0,0,0,0,0,0,0,0,0,0,0,0,0,1037754,2023-11-15T00:00:00.000Z,38017719,5,Dalen Terry,0,0,0,0,0,0
0,0,0,0,0,0,0,0,0,0,0,0,0,0,0,0,1037754,2023-11-15T00:00:00.000Z,125,5,DeMar DeRozan,0,0,0,0,0,0
0,0,0,1,0,2,0,0,0,4,0,1,0,0,0,0,1037754,2023-11-15T00:00:00.000Z,56677857,5,Julian Phillips,0,0,0,0,0,0
0,0,0,0,0,0,0,0,0,0,0,0,0,0,0,0,1037754,2023-11-15T00:00:00.000Z,45969255,5,Justin Lewis,0,0,0,0,0,0
0,0,0,0,0,0,0,0,0,0,0,0,0,0,0,0,1037754,2023-11-15T00:00:00.000Z,27,5,Lonzo Ball,0,0,0,0,0,0
2,0,2,2,0,8,3,2,1,27,2,3,7,4,0,2,1037754,2023-11-15T00:00:00.000Z,56677827,22,Anthony Black,0,11,13,9,6,12.8
3,0,2,4,0,16,5,3,3,30,0,0,13,2,0,1,1037754,2023-11-15T00:00:00.000Z,17896026,22,Franz Wagner,0,15,18,16,5,18.9
2,0,5,0,0,10,6,4,3,26,6,5,15,11,2,0,1037754,2023-11-15T00:00:00.000Z,666442,22,Goga Bitadze,2,26,28,17,13,37.2
5,0,2,7,2,8,2,4,4,26,0,4,10,2,3,4,1037754,2023-11-15T00:00:00.000Z,17896073,22,Jalen Suggs,3,12,17,15,7,24.9
1,0,2,3,1,3,1,0,0,18,0,1,3,2,0,0,1037754,2023-11-15T00:00:00.000Z,226,22,Joe Ingles,0,5,6,4,3,6.9
3,0,8,4,2,12,4,10,7,33,1,0,17,9,1,1,1037754,2023-11-15T00:00:00.000Z,38017683,22,Paolo Banchero,1,26,29,20,12,34.3
0,0,0,0,0,0,0,0,0,0,0,0,0,0,0,0,1037754,2023-11-15T00:00:00.000Z,17553983,22,Trevelin Queen,0,0,0,0,0,0
0,0,0,2,0,3,1,1,0,5,1,0,2,1,0,0,1037755,2023-11-15T00:00:00.000Z,38017715,18,Josh Minott,0,3,3,2,1,3.2
3,1,1,0,0,5,2,2,2,21,1,0,6,2,2,1,1037755,2023-11-15T00:00:00.000Z,12,18,Kyle Anderson,3,8,11,9,5,20.9
0,0,0,1,0,4,1,4,3,4,2,0,5,2,0,0,1037755,2023-11-15T00:00:00.000Z,17896056,18,Luka Garza,0,7,7,5,2,7.4
0,0,2,2,1,7,4,4,4,19,2,0,13,4,1,0,1037755,2023-11-15T00:00:00.000Z,667378,18,Naz Reid,1,17,17,13,4,20.8
0,1,0,5,2,6,3,0,0,23,0,1,8,0,0,0,1037755,2023-11-15T00:00:00.000Z,666400,18,Nickeil Alexander-Walker,1,8,8,8,0,11
0,0,3,2,0,8,4,0,0,23,1,3,8,4,0,0,1037755,2023-11-15T00:00:00.000Z,320,18,Shake Milton,0,12,12,8,4,12.8
1,0,3,2,0,3,0,4,4,14,1,1,4,4,1,0,1037755,2023-11-15T00:00:00.000Z,68,18,Troy Brown Jr.,1,8,9,5,5,13.3
0,0,0,0,0,0,0,0,0,0,0,0,0,0,0,0,1037755,2023-11-15T00:00:00.000Z,666451,24,Bol Bol,0,0,0,0,0,0
0,0,0,0,0,0,0,0,0,0,0,0,0,0,0,0,1037755,2023-11-15T00:00:00.000Z,37,24,Bradley Beal,0,0,0,0,0,0
0,0,2,1,0,4,2,0,0,4,0,2,4,2,0,1,1037755,2023-11-15T00:00:00.000Z,314,24,Chimezie Metu,0,6,6,4,2,5.4
3,0,2,1,1,9,6,0,0,20,2,2,13,4,0,1,1037755,2023-11-15T00:00:00.000Z,147,24,Drew Eubanks,0,17,20,16,7,21.3
3,1,3,1,1,1,1,0,0,16,0,2,3,3,1,0,1037755,2023-11-15T00:00:00.000Z,18678058,24,Jordan Goodwin,2,6,9,6,6,17.1
1,0,1,0,0,1,1,0,0,13,1,1,2,2,0,0,1037755,2023-11-15T00:00:00.000Z,32,24,Keita Bates-Diop,0,4,5,3,3,5.9
0,0,0,0,0,1,1,0,0,3,0,1,2,0,0,0,1037755,2023-11-15T00:00:00.000Z,666729,24,Nassir Little,0,2,2,2,0,2
0,0,0,0,0,0,0,0,0,0,0,0,0,0,0,0,1037755,2023-11-15T00:00:00.000Z,3547298,24,Saben Lee,0,0,0,0,0,0
0,0,0,0,0,0,0,0,0,0,0,0,0,0,0,0,1037755,2023-11-15T00:00:00.000Z,3547095,24,Udoka Azubuike,0,0,0,0,0,0
3,0,2,4,1,6,1,0,0,23,0,1,3,2,0,0,1037755,2023-11-15T00:00:00.000Z,470,24,Yuta Watanabe,0,5,8,6,5,9.9
0,0,0,0,0,0,0,0,0,0,0,0,0,0,0,0,1037756,2023-11-15T00:00:00.000Z,56677867,14,Alex Fudge,0,0,0,0,0,0
1,4,9,1,0,9,3,3,3,35,0,4,9,9,0,5,1037756,2023-11-15T00:00:00.000Z,117,14,Anthony Davis,4,18,19,10,10,28.3
0,0,2,5,2,14,7,0,0,32,0,1,16,2,5,1,1037756,2023-11-15T00:00:00.000Z,666860,14,Cameron Reddish,5,18,18,16,2,32.4
0,0,0,0,0,0,0,0,0,0,0,0,0,0,0,0,1037756,2023-11-15T00:00:00.000Z,56677738,14,Colin Castleton,0,0,0,0,0,0
5,1,2,6,4,20,12,0,0,35,3,3,28,5,0,2,1037756,2023-11-15T00:00:00.000Z,405,14,D'Angelo Russell,1,33,38,33,10,42.5
0,0,0,0,0,0,0,0,0,0,0,0,0,0,0,0,1037756,2023-11-15T00:00:00.000Z,1603383,14,Gabe Vincent,0,0,0,0,0,0
0,0,0,0,0,0,0,0,0,0,0,0,0,0,0,0,1037756,2023-11-15T00:00:00.000Z,56677835,14,Jalen Hood-Schifino,0,0,0,0,0,0
0,0,0,0,0,0,0,0,0,0,0,0,0,0,0,0,1037756,2023-11-15T00:00:00.000Z,457,14,Jarred Vanderbilt,0,0,0,0,0,0
0,0,1,0,0,0,0,4,3,13,0,4,3,1,1,2,1037756,2023-11-15T00:00:00.000Z,666626,14,Jaxson Hayes,1,4,4,3,1,5.2
11,1,8,7,3,15,9,8,7,35,2,1,28,10,4,6,1037756,2023-11-15T00:00:00.000Z,237,14,LeBron James,5,38,49,39,21,65.5
0,0,2,4,1,7,3,0,0,26,0,2,7,2,1,0,1037756,2023-11-15T00:00:00.000Z,383,14,Taurean Prince,1,9,9,7,2,12.4
1,0,0,0,0,2,2,0,0,4,0,1,4,0,0,0,1037756,2023-11-15T00:00:00.000Z,17896030,26,Chris Duarte,0,4,5,5,1,5.5
0,0,0,0,0,0,0,0,0,0,0,0,0,0,0,0,1037756,2023-11-15T00:00:00.000Z,17553994,26,Davion Mitchell,0,0,0,0,0,0
5,0,2,9,3,22,10,7,5,38,3,3,28,5,4,3,1037756,2023-11-15T00:00:00.000Z,161,26,De'Aaron Fox,4,33,38,33,10,50.5
7,1,11,1,1,19,13,2,2,39,5,3,29,16,3,4,1037756,2023-11-15T00:00:00.000Z,406,26,Domantas Sabonis,4,45,52,36,23,66.7
0,0,0,0,0,0,0,0,0,1,0,0,0,0,0,0,1037756,2023-11-15T00:00:00.000Z,17895941,26,Filip Petrusev,0,0,0,0,0,0
2,0,1,6,3,10,5,0,0,38,0,3,13,1,4,2,1037756,2023-11-15T00:00:00.000Z,30,26,Harrison Barnes,4,14,16,15,3,27.2
0,0,0,0,0,0,0,0,0,1,0,0,0,0,0,0,1037756,2023-11-15T00:00:00.000Z,56677862,26,Jalen Slawson,0,0,0,0,0,0
1,0,4,0,0,3,3,2,1,9,2,3,7,6,2,2,1037756,2023-11-15T00:00:00.000Z,306,26,JaVale McGee,2,13,14,8,7,19.7
2,0,6,7,2,9,3,2,1,31,0,2,9,6,2,1,1037756,2023-11-15T00:00:00.000Z,38017688,26,Keegan Murray,2,15,17,11,8,24.2
1,0,1,2,0,3,0,0,0,9,1,2,0,2,0,0,1037756,2023-11-15T00:00:00.000Z,38017714,26,Keon Ellis,0,2,3,1,3,3.9
0,0,0,0,0,0,0,0,0,1,0,0,0,0,0,0,1037756,2023-11-15T00:00:00.000Z,17896044,26,Kessler Edwards,0,0,0,0,0,0
7,0,4,11,6,16,10,2,2,37,0,2,28,4,2,0,1037756,2023-11-15T00:00:00.000Z,221,26,Kevin Huerter,2,32,39,35,11,49.3
5,0,5,5,1,8,1,0,0,20,0,1,3,5,1,3,1037756,2023-11-15T00:00:00.000Z,324,26,Malik Monk,1,8,13,8,10,16.5
0,0,0,0,0,0,0,0,0,1,0,0,0,0,0,0,1037757,2023-11-15T00:00:00.000Z,248,6,Damian Jones,0,0,0,0,0,0
0,0,0,0,0,0,0,0,0,0,0,0,0,0,0,0,1037757,2023-11-15T00:00:00.000Z,666581,6,Darius Garland,0,0,0,0,0,0
2,1,2,3,0,3,0,0,0,33,1,1,0,3,0,0,1037757,2023-11-15T00:00:00.000Z,666940,6,Dean Wade,1,3,5,2,5,9.6
0,0,1,0,0,0,0,0,0,1,0,0,0,1,0,0,1037757,2023-11-15T00:00:00.000Z,56677847,6,Emoni Bates,0,1,1,0,1,1.2
0,0,0,0,0,0,0,0,0,0,0,0,0,0,0,0,1037757,2023-11-15T00:00:00.000Z,3547247,6,Isaac Okoro,0,0,0,0,0,0
0,0,0,0,0,0,0,0,0,0,0,0,0,0,0,0,1037757,2023-11-15T00:00:00.000Z,38017662,6,Isaiah Mobley,0,0,0,0,0,0
0,0,0,0,0,0,0,0,0,0,0,0,0,0,0,0,1037757,2023-11-15T00:00:00.000Z,404,6,Ricky Rubio,0,0,0,0,0,0
0,0,0,0,0,0,0,0,0,2,0,0,0,0,0,0,1037757,2023-11-15T00:00:00.000Z,3547299,6,Sam Merrill,0,0,0,0,0,0
0,0,1,0,0,0,0,0,0,2,0,0,0,1,0,0,1037757,2023-11-15T00:00:00.000Z,444,6,Tristan Thompson,0,1,1,0,1,1.2
0,0,0,0,0,0,0,0,0,0,0,0,0,0,0,0,1037757,2023-11-15T00:00:00.000Z,666676,6,Ty Jerome,0,0,0,0,0,0
0,0,0,0,0,0,0,0,0,0,0,0,0,0,0,0,1037757,2023-11-15T00:00:00.000Z,419,25,Anfernee Simons,0,0,0,0,0,0
0,0,4,0,0,10,3,0,0,26,2,3,6,6,0,2,1037757,2023-11-15T00:00:00.000Z,22,25,Deandre Ayton,0,12,12,6,6,11.2
3,0,0,5,2,10,6,2,2,20,2,2,16,2,0,1,1037757,2023-11-15T00:00:00.000Z,56783340,25,Duop Reath,0,18,21,19,5,21.9
0,0,0,0,0,0,0,0,0,3,0,0,0,0,0,0,1037757,2023-11-15T00:00:00.000Z,17896120,25,Ish Wainright,0,0,0,0,0,0
1,2,2,4,3,7,4,2,1,23,1,2,12,3,0,2,1037757,2023-11-15T00:00:00.000Z,38017711,25,Jabari Walker,2,15,16,13,4,21.1
0,0,2,3,0,6,1,0,0,9,0,1,2,2,0,0,1037757,2023-11-15T00:00:00.000Z,44477062,25,Jamaree Bouyea,0,4,4,2,2,4.4
2,0,3,6,1,17,7,2,2,32,0,2,17,3,2,3,1037757,2023-11-15T00:00:00.000Z,182,25,Jerami Grant,2,20,22,19,5,26.6
0,0,0,0,0,0,0,0,0,2,0,0,0,0,0,0,1037757,2023-11-15T00:00:00.000Z,47957121,25,Justin Minaya,0,0,0,0,0,0
3,0,2,3,1,5,2,0,0,17,0,1,5,2,1,0,1037757,2023-11-15T00:00:00.000Z,56677791,25,Kris Murray,1,7,10,8,5,14.9
0,0,0,0,0,0,0,0,0,0,0,0,0,0,0,0,1037757,2023-11-15T00:00:00.000Z,65,25,Malcolm Brogdon,0,0,0,0,0,0
0,0,0,0,0,0,0,0,0,0,0,0,0,0,0,0,1037757,2023-11-15T00:00:00.000Z,666476,25,Moses Brown,0,0,0,0,0,0
0,0,0,0,0,0,0,0,0,0,0,0,0,0,0,0,1037757,2023-11-15T00:00:00.000Z,476,25,Robert Williams III,0,0,0,0,0,0
0,0,0,0,0,0,0,0,0,0,0,0,0,0,0,0,1037757,2023-11-15T00:00:00.000Z,56677747,25,Scoot Henderson,0,0,0,0,0,0
5,0,4,5,1,12,2,7,6,27,3,3,11,7,0,0,1037757,2023-11-15T00:00:00.000Z,38017690,25,Shaedon Sharpe,0,18,23,16,12,26.9
4,0,1,4,2,13,4,3,3,31,0,4,13,1,1,2,1037757,2023-11-15T00:00:00.000Z,3547289,25,Skylar Mays,1,14,18,17,5,21.2
3,0,1,3,0,4,0,0,0,22,0,1,0,1,2,1,1037757,2023-11-15T00:00:00.000Z,56677850,25,Toumani Camara,2,1,4,3,4,10.7
4,1,5,0,0,15,8,4,4,33,2,2,20,7,2,2,1037758,2023-11-16T00:00:00.000Z,4,16,Bam Adebayo,3,27,31,24,11,41.4
2,0,0,10,6,14,8,4,4,38,0,3,26,0,0,0,1037758,2023-11-16T00:00:00.000Z,397,16,Duncan Robinson,0,26,28,28,2,29
0,0,1,3,0,5,2,2,2,23,0,3,6,1,0,1,1037758,2023-11-16T00:00:00.000Z,3092,16,Haywood Highsmith,0,7,7,6,1,6.2
5,0,4,5,2,9,4,0,0,33,0,3,10,4,0,1,1037758,2023-11-16T00:00:00.000Z,56677785,16,Jaime Jaquez Jr.,0,14,19,15,9,21.3
3,3,3,5,2,19,12,11,10,35,2,0,36,5,1,4,1037758,2023-11-16T00:00:00.000Z,79,16,Jimmy Butler,4,41,44,39,8,54.5
3,0,2,5,1,7,3,1,1,26,0,2,8,2,2,0,1037758,2023-11-16T00:00:00.000Z,391,16,Josh Richardson,2,10,13,11,5,20.9
4,0,8,3,1,4,2,2,2,16,1,2,7,9,0,0,1037758,2023-11-16T00:00:00.000Z,285,16,Kevin Love,0,16,20,11,13,23.8
3,0,2,1,1,4,1,0,0,24,1,3,3,3,3,0,1037758,2023-11-16T00:00:00.000Z,286,16,Kyle Lowry,3,6,9,6,6,20.1
0,0,0,0,0,0,0,0,0,0,0,0,0,0,0,0,1037758,2023-11-16T00:00:00.000Z,38017696,16,Nikola Jovic,0,0,0,0,0,0
0,0,0,0,0,0,0,0,0,0,0,0,0,0,0,0,1037758,2023-11-16T00:00:00.000Z,74,16,Thomas Bryant,0,0,0,0,0,0
0,0,0,1,0,4,0,2,1,8,1,1,1,1,1,0,1037759,2023-11-16T00:00:00.000Z,2189,10,Gary Payton II,1,2,2,1,1,5.2
0,0,1,1,0,3,1,0,0,4,2,0,2,3,0,0,1037759,2023-11-16T00:00:00.000Z,57875092,10,Gui Santos,0,5,5,2,3,5.6
0,0,0,0,0,0,0,0,0,0,0,0,0,0,0,0,1037759,2023-11-16T00:00:00.000Z,398,10,Jerome Robinson,0,0,0,0,0,0
1,0,4,0,0,9,6,2,1,19,7,3,13,11,1,1,1037759,2023-11-16T00:00:00.000Z,282,10,Kevon Looney,1,24,25,14,12,29.7
0,0,0,2,0,3,0,0,0,4,0,1,0,0,0,0,1037759,2023-11-16T00:00:00.000Z,45658838,10,Lester Quinones,0,0,0,0,0,0
1,1,2,4,2,11,5,1,0,23,2,1,12,4,0,1,1037759,2023-11-16T00:00:00.000Z,17553992,10,Moses Moody,1,16,17,13,5,20.3
0,0,0,0,0,0,0,0,0,0,0,0,0,0,0,0,1037759,2023-11-16T00:00:00.000Z,115,10,Stephen Curry,0,0,0,0,0,0
0,0,0,0,0,0,0,0,0,0,0,0,0,0,0,0,1037759,2023-11-16T00:00:00.000Z,17896070,10,Usman Garuba,0,0,0,0,0,0
2,2,9,2,0,7,4,5,5,27,1,2,13,10,0,4,1037759,2023-11-16T00:00:00.000Z,38017685,21,Chet Holmgren,2,23,25,15,12,30
5,0,3,3,2,13,6,2,2,29,0,3,16,3,2,2,1037759,2023-11-16T00:00:00.000Z,38017703,21,Jalen Williams,2,19,24,21,8,31.1
0,0,2,3,1,5,2,0,0,24,0,2,5,2,1,1,1037759,2023-11-16T00:00:00.000Z,666541,21,Luguentz Dort,1,7,7,5,2,9.4
0,0,0,0,0,0,0,0,0,0,0,0,0,0,0,0,3277445,2023-11-17T00:00:00.000Z,56677848,4,Amari Bailey,0,0,0,0,0,0
0,0,0,0,0,0,0,0,0,0,0,0,0,0,0,0,3277445,2023-11-17T00:00:00.000Z,666748,4,Cody Martin,0,0,0,0,0,0
0,0,0,0,0,0,0,0,0,0,0,0,0,0,0,0,3277445,2023-11-17T00:00:00.000Z,347,4,Frank Ntilikina,0,0,0,0,0,0
0,0,0,0,0,0,0,0,0,0,0,0,0,0,0,0,3277445,2023-11-17T00:00:00.000Z,17896037,4,James Bouknight,0,0,0,0,0,0
0,0,1,0,0,1,1,0,0,5,0,1,2,1,0,0,3277445,2023-11-17T00:00:00.000Z,18678001,4,JT Thor,0,3,3,2,1,3.2
0,0,0,0,0,0,0,0,0,0,0,0,0,0,0,0,3277445,2023-11-17T00:00:00.000Z,56677866,4,Leaky Black,0,0,0,0,0,0
0,0,1,0,0,2,1,0,0,7,0,0,2,1,0,0,3277445,2023-11-17T00:00:00.000Z,3547282,4,Nick Richards,0,3,3,2,1,3.2
0,1,1,1,0,6,1,0,0,9,1,1,2,2,0,1,3277445,2023-11-17T00:00:00.000Z,56677846,4,Nick Smith Jr.,1,4,4,2,2,6.4
0,0,0,0,0,0,0,0,0,0,0,0,0,0,0,0,3277445,2023-11-17T00:00:00.000Z,403,4,Terry Rozier,0,0,0,0,0,0
0,0,0,0,0,0,0,0,0,0,0,0,0,0,0,0,3277445,2023-11-17T00:00:00.000Z,56677854,17,Chris Livingston,0,0,0,0,0,0
0,0,0,0,0,0,0,0,0,0,0,0,0,0,0,0,3277445,2023-11-17T00:00:00.000Z,112,17,Jae Crowder,0,0,0,0,0,0
1,0,5,7,2,11,4,2,2,22,1,3,12,6,1,1,3277445,2023-11-17T00:00:00.000Z,315,17,Khris Middleton,1,18,19,13,7,22.7
0,0,0,0,0,0,0,0,0,0,0,0,0,0,0,0,3277445,2023-11-17T00:00:00.000Z,666960,17,Lindell Wigginton,0,0,0,0,0,0
0,0,0,0,0,0,0,0,0,0,0,0,0,0,0,0,3277445,2023-11-17T00:00:00.000Z,38017676,17,MarJon Beauchamp,0,0,0,0,0,0
0,0,0,0,0,0,0,0,0,0,0,0,0,0,0,0,3277446,2023-11-17T00:00:00.000Z,666474,20,Charles Brown,0,0,0,0,0,0
0,0,0,0,0,0,0,0,0,2,0,0,0,0,0,0,3277446,2023-11-17T00:00:00.000Z,666675,20,DaQuan Jeffries,0,0,0,0,0,0
1,0,2,8,4,9,5,0,0,25,2,1,14,4,0,1,3277446,2023-11-17T00:00:00.000Z,131,20,Donte DiVincenzo,0,18,19,15,5,19.3
0,0,0,0,0,0,0,0,0,0,0,0,0,0,0,0,3277446,2023-11-17T00:00:00.000Z,17896089,20,Duane Washington Jr.,0,0,0,0,0,0
0,0,0,0,0,0,0,0,0,0,0,0,0,0,0,0,3277446,2023-11-17T00:00:00.000Z,666971,20,Dylan Windler,0,0,0,0,0,0
1,0,1,4,0,6,1,0,0,16,0,2,2,1,1,0,3277446,2023-11-17T00:00:00.000Z,160,20,Evan Fournier,1,3,4,3,2,7.7
4,0,6,7,3,18,10,5,4,33,0,5,27,6,1,1,3277446,2023-11-17T00:00:00.000Z,3547269,20,Immanuel Quickley,1,33,37,31,10,42.2
2,1,5,0,0,3,1,2,1,20,3,4,3,8,1,1,3277446,2023-11-17T00:00:00.000Z,201,20,Isaiah Hartenstein,2,11,13,5,10,20.6
0,0,0,0,0,0,0,0,0,0,0,0,0,0,0,0,3277446,2023-11-17T00:00:00.000Z,56677795,20,Jacob Toppin,0,0,0,0,0,0
7,0,4,10,6,23,10,6,6,34,3,2,32,7,0,0,3277446,2023-11-17T00:00:00.000Z,73,20,Jalen Brunson,0,39,46,39,14,50.9
0,0,1,0,0,0,0,0,0,1,0,0,0,1,0,0,3277446,2023-11-17T00:00:00.000Z,17896063,20,Jericho Sims,0,1,1,0,1,1.2
2,2,4,2,1,7,4,0,0,32,1,1,9,5,0,1,3277446,2023-11-17T00:00:00.000Z,202,20,Josh Hart,2,14,16,11,7,23
8,2,6,5,1,18,9,6,3,35,1,3,22,7,1,6,3277446,2023-11-17T00:00:00.000Z,387,20,Julius Randle,3,29,37,30,15,45.4
0,0,0,2,1,3,2,0,0,14,1,2,5,1,1,0,3277446,2023-11-17T00:00:00.000Z,17896033,20,Miles McBride,1,6,6,5,1,9.2
1,1,5,0,0,4,3,1,0,27,3,1,6,8,0,0,3277446,2023-11-17T00:00:00.000Z,399,20,Mitchell Robinson,1,14,15,7,9,20.1
0,0,0,0,0,0,0,0,0,0,0,0,0,0,0,0,3277446,2023-11-17T00:00:00.000Z,17895858,20,Quentin Grimes,0,0,0,0,0,0
0,0,0,0,0,0,0,0,0,0,0,0,0,0,0,0,3277446,2023-11-17T00:00:00.000Z,666423,20,RJ Barrett,0,0,0,0,0,0
0,0,0,0,0,0,0,0,0,1,0,0,0,0,0,0,3277446,2023-11-17T00:00:00.000Z,19,20,Ryan Arcidiacono,0,0,0,0,0,0
1,0,1,0,0,0,0,2,2,2,0,0,2,1,0,0,3277446,2023-11-17T00:00:00.000Z,3547302,30,Anthony Gill,0,3,4,3,2,4.7
4,1,3,3,0,7,2,3,2,31,0,1,6,3,0,2,3277446,2023-11-17T00:00:00.000Z,56677844,30,Bilal Coulibaly,1,9,13,10,7,16.6
1,0,1,3,1,5,3,1,1,26,2,1,8,3,1,0,3277446,2023-11-17T00:00:00.000Z,17896045,30,Corey Kispert,1,11,12,9,4,16.1
0,0,3,0,0,8,4,2,2,28,4,4,10,7,1,1,3277446,2023-11-17T00:00:00.000Z,666577,30,Daniel Gafford,1,17,17,10,7,20.4
1,2,5,3,1,7,3,0,0,17,1,3,7,6,0,0,3277446,2023-11-17T00:00:00.000Z,167,30,Danilo Gallinari,2,13,14,8,7,21.7
0,0,0,0,0,0,0,0,0,0,0,0,0,0,0,0,3277446,2023-11-17T00:00:00.000Z,487,30,Delon Wright,0,0,0,0,0,0
2,1,4,4,2,11,7,2,2,32,0,4,18,4,1,3,3277446,2023-11-17T00:00:00.000Z,3547242,30,Deni Avdija,2,22,24,20,6,28.8
0,0,0,1,1,2,2,0,0,2,0,0,5,0,0,0,3277446,2023-11-17T00:00:00.000Z,17896106,30,Eugene Omoruyi,0,5,5,5,0,5
0,0,0,0,0,0,0,0,0,2,0,0,0,0,0,0,3277446,2023-11-17T00:00:00.000Z,18677954,30,Jared Butler,0,0,0,0,0,0
0,0,0,0,0,0,0,0,0,0,0,0,0,0,0,0,3277446,2023-11-17T00:00:00.000Z,38124126,30,John Butler Jr.,0,0,0,0,0,0
0,0,0,0,0,0,0,0,0,2,0,0,0,0,0,0,3277446,2023-11-17T00:00:00.000Z,38017687,30,Johnny Davis,0,0,0,0,0,0
4,0,1,6,0,11,2,4,4,29,0,2,8,1,0,5,3277446,2023-11-17T00:00:00.000Z,666848,30,Jordan Poole,0,9,13,12,5,10.2
5,0,4,8,3,21,8,0,0,32,0,3,19,4,0,2,3277446,2023-11-17T00:00:00.000Z,265,30,Kyle Kuzma,0,23,28,24,9,29.3
2,0,0,2,1,3,2,0,0,7,0,0,5,0,0,0,3277446,2023-11-17T00:00:00.000Z,414,30,Landry Shamet,0,5,7,7,2,8
0,0,0,0,0,0,0,0,0,0,0,0,0,0,0,0,3277446,2023-11-17T00:00:00.000Z,337,30,Mike Muscala,0,0,0,0,0,0
0,0,0,0,0,0,0,0,0,0,0,0,0,0,0,0,3277446,2023-11-17T00:00:00.000Z,38017704,30,Patrick Baldwin Jr.,0,0,0,0,0,0
0,0,0,0,0,0,0,0,0,0,0,0,0,0,0,0,3277446,2023-11-17T00:00:00.000Z,38017712,30,Ryan Rollins,0,0,0,0,0,0
5,0,3,2,1,7,4,2,2,30,0,0,11,3,1,1,3277446,2023-11-17T00:00:00.000Z,249,30,Tyus Jones,1,14,19,16,8,24.1
0,0,0,0,0,0,0,0,0,0,0,0,0,0,0,0,3277447,2023-11-17T00:00:00.000Z,38017689,1,AJ Griffin,0,0,0,0,0,0
3,0,2,8,3,12,4,3,2,24,0,3,13,2,3,3,3277447,2023-11-17T00:00:00.000Z,53,1,Bogdan Bogdanovic,3,15,18,16,5,25.9
0,0,0,0,0,0,0,0,0,0,0,0,0,0,0,0,3277447,2023-11-17T00:00:00.000Z,666564,1,Bruno Fernando,0,0,0,0,0,0
2,1,3,0,0,11,7,5,3,29,8,3,17,11,0,0,3277447,2023-11-17T00:00:00.000Z,83,1,Clint Capela,1,28,30,19,13,36.2
0,0,1,2,1,7,4,0,0,18,0,1,9,1,0,0,3277447,2023-11-17T00:00:00.000Z,666656,1,De'Andre Hunter,0,10,10,9,1,10.2
3,0,1,7,3,16,5,0,0,35,0,2,13,1,2,3,3277447,2023-11-17T00:00:00.000Z,334,1,Dejounte Murray,2,14,17,16,4,21.7
0,0,0,0,0,0,0,0,0,0,0,0,0,0,0,0,3277447,2023-11-17T00:00:00.000Z,666754,1,Garrison Mathews,0,0,0,0,0,0
2,3,9,2,0,12,7,4,4,36,1,2,18,10,1,0,3277447,2023-11-17T00:00:00.000Z,17896040,1,Jalen Johnson,4,28,30,20,12,45
0,0,0,0,0,0,0,0,0,0,0,0,0,0,0,0,3277447,2023-11-17T00:00:00.000Z,56677838,1,Kobe Bufkin,0,0,0,0,0,0
0,0,0,0,0,0,0,0,0,0,0,0,0,0,0,0,3277447,2023-11-17T00:00:00.000Z,56677875,1,Miles Norris,0,0,0,0,0,0
0,0,0,0,0,0,0,0,0,0,0,0,0,0,0,0,3277447,2023-11-17T00:00:00.000Z,56677806,1,Mouhamed Gueye,0,0,0,0,0,0
0,0,3,2,1,6,2,0,0,19,2,3,5,5,0,1,3277447,2023-11-17T00:00:00.000Z,3547244,1,Onyeka Okongwu,0,10,10,5,5,10
0,0,0,0,0,0,0,0,0,0,0,0,0,0,0,0,3277447,2023-11-17T00:00:00.000Z,319,1,Patty Mills,0,0,0,0,0,0
1,0,4,4,2,9,6,4,3,31,3,1,17,7,1,2,3277447,2023-11-17T00:00:00.000Z,3547256,1,Saddiq Bey,1,24,25,18,8,27.9
0,0,0,0,0,0,0,0,0,0,0,0,0,0,0,0,3277447,2023-11-17T00:00:00.000Z,56677855,1,Seth Lundy,0,0,0,0,0,0
13,0,2,6,2,14,5,10,10,37,0,3,22,2,1,4,3277447,2023-11-17T00:00:00.000Z,490,1,Trae Young,1,24,37,35,15,42.9
0,0,0,0,0,0,0,0,0,0,0,0,0,0,0,0,3277447,2023-11-17T00:00:00.000Z,3547297,1,Trent Forrest,0,0,0,0,0,0
0,0,0,2,0,2,0,4,2,11,0,2,2,0,0,0,3277447,2023-11-17T00:00:00.000Z,301,1,Wesley Matthews,0,2,2,2,0,2
1,0,2,4,1,8,5,3,3,18,1,1,14,3,0,1,3277447,2023-11-17T00:00:00.000Z,2175,23,Danuel House Jr.,0,17,18,15,4,18.1
5,1,3,7,3,13,5,2,1,36,1,2,14,4,1,3,3277447,2023-11-17T00:00:00.000Z,313,23,De'Anthony Melton,2,18,23,19,9,29.3
0,0,0,0,0,0,0,0,0,0,0,0,0,0,0,0,3277447,2023-11-17T00:00:00.000Z,260,23,Furkan Korkmaz,0,0,0,0,0,0
2,2,0,2,0,7,3,2,2,22,3,3,8,3,2,3,3277447,2023-11-17T00:00:00.000Z,17896025,23,Jaden Springer,4,11,13,10,5,23.6
0,0,0,0,0,0,0,0,0,0,0,0,0,0,0,0,3277447,2023-11-17T00:00:00.000Z,17554001,23,Javonte Smart,0,0,0,0,0,0
8,1,5,3,1,19,10,11,11,37,2,3,32,7,2,4,3277447,2023-11-17T00:00:00.000Z,145,23,Joel Embiid,3,39,47,40,15,57.4
0,0,0,0,0,0,0,0,0,0,0,0,0,0,0,0,3277447,2023-11-17T00:00:00.000Z,360,23,Kelly Oubre Jr.,0,0,0,0,0,0
0,0,0,0,0,0,0,0,0,0,0,0,0,0,0,0,3277447,2023-11-17T00:00:00.000Z,3547294,23,Kenyon Martin Jr.,0,0,0,0,0,0
0,0,1,0,0,0,0,0,0,2,0,1,0,1,0,0,3277447,2023-11-17T00:00:00.000Z,328,23,Marcus Morris,0,1,1,0,1,1.2
0,0,0,0,0,0,0,0,0,0,0,0,0,0,0,0,3277447,2023-11-17T00:00:00.000Z,28,23,Mo Bamba,0,0,0,0,0,0
0,0,0,0,0,0,0,0,0,0,0,0,0,0,0,0,3277447,2023-11-17T00:00:00.000Z,33,23,Nicolas Batum,0,0,0,0,0,0
1,0,2,1,0,1,0,2,2,14,0,3,2,2,0,0,3277447,2023-11-17T00:00:00.000Z,45,23,Patrick Beverley,0,4,5,3,3,5.9
0,0,1,0,0,3,1,0,0,12,1,1,2,2,0,0,3277447,2023-11-17T00:00:00.000Z,3547270,23,Paul Reed,0,4,4,2,2,4.4
0,0,0,0,0,0,0,0,0,0,0,0,0,0,0,0,3277447,2023-11-17T00:00:00.000Z,56913527,23,Ricky Council IV,0,0,0,0,0,0
3,1,3,2,2,4,2,0,0,21,4,4,6,7,1,1,3277447,2023-11-17T00:00:00.000Z,108,23,Robert Covington,2,13,16,9,10,23.9
0,0,0,0,0,0,0,0,0,0,0,0,0,0,0,0,3277447,2023-11-17T00:00:00.000Z,56677788,23,Terquavion Smith,0,0,0,0,0,0
3,0,9,5,3,20,12,2,2,38,1,1,29,10,1,1,3277447,2023-11-17T00:00:00.000Z,200,23,Tobias Harris,1,39,42,32,13,47.5
8,0,4,6,3,13,5,6,6,40,0,1,19,4,2,2,3277447,2023-11-17T00:00:00.000Z,3547254,23,Tyrese Maxey,2,23,31,27,12,39.8
0,0,1,1,1,1,1,0,0,22,0,1,3,1,0,0,3277448,2023-11-17T00:00:00.000Z,666940,6,Dean Wade,0,4,4,3,1,4.2
0,0,0,0,0,0,0,0,0,0,0,0,0,0,0,0,3277448,2023-11-17T00:00:00.000Z,322,6,Donovan Mitchell,0,0,0,0,0,0
5,0,6,0,0,12,8,4,2,35,4,4,18,10,1,2,3277448,2023-11-17T00:00:00.000Z,17896076,6,Evan Mobley,1,28,33,23,15,38.5
0,0,0,0,0,0,0,0,0,0,0,0,0,0,0,0,3277448,2023-11-17T00:00:00.000Z,3547247,6,Isaac Okoro,0,0,0,0,0,0
0,0,0,0,0,0,0,0,0,0,0,0,0,0,0,0,3277448,2023-11-17T00:00:00.000Z,38017662,6,Isaiah Mobley,0,0,0,0,0,0
2,5,6,0,0,8,4,3,2,32,1,1,10,7,0,2,3277448,2023-11-17T00:00:00.000Z,9,6,Jarrett Allen,5,17,19,12,9,34.4
3,1,6,8,4,15,7,0,0,39,1,1,18,7,4,2,3277448,2023-11-17T00:00:00.000Z,666908,6,Max Strus,5,25,28,21,10,43.9
0,0,0,0,0,0,0,0,0,0,0,0,0,0,0,0,3277448,2023-11-17T00:00:00.000Z,404,6,Ricky Rubio,0,0,0,0,0,0
0,0,0,0,0,0,0,0,0,0,0,0,0,0,0,0,3277448,2023-11-17T00:00:00.000Z,666676,6,Ty Jerome,0,0,0,0,0,0
1,0,1,9,2,14,4,0,0,24,2,3,10,3,1,0,3277448,2023-11-17T00:00:00.000Z,77,9,Alec Burks,1,13,14,11,4,18.1
2,0,5,1,0,8,4,3,1,17,5,4,9,10,0,5,3277448,2023-11-17T00:00:00.000Z,56677826,9,Ausar Thompson,0,19,21,11,12,19
0,0,0,0,0,0,0,0,0,0,0,0,0,0,0,0,3277448,2023-11-17T00:00:00.000Z,54,9,Bojan Bogdanovic,0,0,0,0,0,0
8,0,4,7,2,21,9,0,0,34,1,4,20,5,0,4,3277448,2023-11-17T00:00:00.000Z,17896075,9,Cade Cunningham,0,25,33,28,13,34
0,0,0,0,0,0,0,0,0,0,0,0,0,0,0,0,3277448,2023-11-17T00:00:00.000Z,17896071,9,Isaiah Livers,0,0,0,0,0,0
2,3,6,4,1,11,4,2,2,31,4,0,11,10,1,1,3277448,2023-11-17T00:00:00.000Z,3547267,9,Isaiah Stewart,4,21,23,13,12,37
3,0,1,2,1,6,4,2,2,29,1,3,11,2,1,6,3277448,2023-11-17T00:00:00.000Z,38017682,9,Jaden Ivey,1,13,16,14,5,14.9
0,0,0,0,0,0,0,0,0,0,0,0,0,0,0,0,3277448,2023-11-17T00:00:00.000Z,38017694,9,Jalen Duren,0,0,0,0,0,0
0,0,2,0,0,0,0,0,0,4,0,0,0,2,0,0,3277448,2023-11-17T00:00:00.000Z,3547240,9,James Wiseman,0,2,2,0,2,2.4
0,0,0,0,0,0,0,0,0,0,0,0,0,0,0,0,3277448,2023-11-17T00:00:00.000Z,42097199,9,Jared Rhoden,0,0,0,0,0,0
0,0,0,0,0,0,0,0,0,0,0,0,0,0,0,0,3277448,2023-11-17T00:00:00.000Z,197,9,Joe Harris,0,0,0,0,0,0
0,1,7,4,1,10,5,0,0,31,4,3,11,11,1,0,3277448,2023-11-17T00:00:00.000Z,259,9,Kevin Knox,2,22,22,11,11,30.2
2,1,0,2,0,6,2,0,0,22,0,0,4,0,1,0,3277448,2023-11-17T00:00:00.000Z,3547241,9,Killian Hayes,2,4,6,6,2,13
0,0,0,0,0,0,0,0,0,0,0,0,0,0,0,0,3277448,2023-11-17T00:00:00.000Z,56677729,9,Malcolm Cazalon,0,0,0,0,0,0
0,0,0,3,0,7,2,2,2,15,0,1,6,0,0,0,3277448,2023-11-17T00:00:00.000Z,56677792,9,Marcus Sasser,0,6,6,6,0,6
1,1,2,0,0,5,3,2,2,16,1,0,8,3,1,1,3277448,2023-11-17T00:00:00.000Z,24,9,Marvin Bagley III,2,11,12,9,4,18.1
0,0,0,0,0,0,0,0,0,0,0,0,0,0,0,0,3277448,2023-11-17T00:00:00.000Z,330,9,Monte Morris,0,0,0,0,0,0
0,1,5,3,2,3,2,4,4,17,1,1,10,6,1,0,3277448,2023-11-17T00:00:00.000Z,44477024,9,Stanley Umude,2,16,16,10,6,23.2
2,0,3,4,3,5,4,0,0,23,1,1,11,4,0,0,3277449,2023-11-17T00:00:00.000Z,219,2,Al Horford,0,15,17,13,6,18.8
0,0,0,0,0,0,0,0,0,0,0,0,0,0,0,0,3277449,2023-11-17T00:00:00.000Z,17896094,2,Dalano Banton,0,0,0,0,0,0
5,0,4,8,3,10,4,2,2,34,0,1,13,4,0,1,3277449,2023-11-17T00:00:00.000Z,473,2,Derrick White,0,17,22,18,9,24.3
4,1,3,5,3,14,9,3,2,36,0,2,23,3,1,3,3277449,2023-11-17T00:00:00.000Z,70,2,Jaylen Brown,2,26,30,27,7,35.6
2,0,6,11,1,22,8,0,0,37,1,3,17,7,1,3,3277449,2023-11-17T00:00:00.000Z,434,2,Jayson Tatum,1,24,26,19,9,28.4
0,0,0,0,0,0,0,0,0,0,0,0,0,0,0,0,3277449,2023-11-17T00:00:00.000Z,38017707,2,JD Davison,0,0,0,0,0,0
5,0,6,4,2,14,5,2,2,35,2,2,14,8,0,1,3277449,2023-11-17T00:00:00.000Z,214,2,Jrue Holiday,0,22,27,19,13,30.1
5,3,10,3,0,13,6,2,2,35,2,3,14,12,1,2,3277449,2023-11-17T00:00:00.000Z,378,2,Kristaps Porzingis,4,26,31,19,17,45.9
0,0,0,0,0,0,0,0,0,0,0,0,0,0,0,0,3277449,2023-11-17T00:00:00.000Z,3547279,2,Lamar Stevens,0,0,0,0,0,0
0,0,0,0,0,0,0,0,0,0,0,0,0,0,0,0,3277449,2023-11-17T00:00:00.000Z,261,2,Luke Kornet,0,0,0,0,0,0
0,0,0,0,0,0,0,0,0,0,0,0,0,0,0,0,3277449,2023-11-17T00:00:00.000Z,3547295,2,Nathan Knight,0,0,0,0,0,0
0,0,0,0,0,0,0,0,0,0,0,0,0,0,0,0,3277449,2023-11-17T00:00:00.000Z,17553967,2,Neemias Queta,0,0,0,0,0,0
0,0,0,0,0,0,0,0,0,0,0,0,0,0,0,0,3277449,2023-11-17T00:00:00.000Z,666468,2,Oshae Brissett,0,0,0,0,0,0
3,0,2,5,1,7,2,0,0,17,1,1,5,3,1,0,3277449,2023-11-17T00:00:00.000Z,3547276,2,Payton Pritchard,1,8,11,8,6,16.1
3,0,2,6,3,7,4,0,0,23,1,0,11,3,1,0,3277449,2023-11-17T00:00:00.000Z,17896060,2,Sam Hauser,1,14,17,14,6,22.1
0,0,0,0,0,0,0,0,0,0,0,0,0,0,0,0,3277449,2023-11-17T00:00:00.000Z,338,2,Svi Mykhailiuk,0,0,0,0,0,0
0,0,0,0,0,0,0,0,0,0,0,0,0,0,0,0,3277449,2023-11-17T00:00:00.000Z,38017710,28,Christian Koloko,0,0,0,0,0,0
6,0,7,11,5,19,9,0,0,35,0,2,23,7,0,2,3277449,2023-11-17T00:00:00.000Z,409,28,Dennis Schroder,0,30,36,29,13,38.4
0,0,0,0,0,0,0,0,0,0,0,0,0,0,0,0,3277449,2023-11-17T00:00:00.000Z,436,28,Garrett Temple,0,0,0,0,0,0
1,0,2,5,3,9,4,4,3,31,0,0,14,2,1,0,3277449,2023-11-17T00:00:00.000Z,3089,28,Gary Trent Jr.,1,16,17,15,3,20.9
1,0,1,4,0,5,0,0,0,10,0,0,0,1,0,2,3277449,2023-11-17T00:00:00.000Z,56677828,28,Gradey Dick,0,1,2,1,2,0.7
4,0,6,0,0,5,5,2,1,34,2,0,11,8,1,3,3277449,2023-11-17T00:00:00.000Z,373,28,Jakob Poeltl,1,19,23,15,12,26.6
0,0,0,1,0,5,2,0,0,7,0,0,4,0,0,0,3277449,2023-11-17T00:00:00.000Z,666762,28,Jalen McDaniels,0,4,4,4,0,4
0,0,0,0,0,0,0,0,0,0,0,0,0,0,0,0,3277449,2023-11-17T00:00:00.000Z,56677805,28,Javon Freeman-Liberty,0,0,0,0,0,0
0,0,0,0,0,0,0,0,0,0,0,0,0,0,0,0,3277449,2023-11-17T00:00:00.000Z,56677869,28,Markquis Nowell,0,0,0,0,0,0
0,0,0,0,0,0,0,0,0,0,0,0,0,0,0,0,3277449,2023-11-17T00:00:00.000Z,18,28,OG Anunoby,0,0,0,0,0,0
0,0,0,0,0,0,0,0,0,0,0,0,0,0,0,0,3277449,2023-11-17T00:00:00.000Z,376,28,Otto Porter Jr.,0,0,0,0,0,0
5,0,5,1,0,16,11,1,1,29,1,5,23,6,0,3,3277449,2023-11-17T00:00:00.000Z,416,28,Pascal Siakam,0,29,34,28,11,34.7
1,0,9,2,0,4,2,2,1,25,0,1,5,9,2,1,3277449,2023-11-17T00:00:00.000Z,3547249,28,Precious Achiuwa,2,14,15,6,10,22.3
0,0,0,0,0,0,0,0,0,0,0,0,0,0,0,0,3277449,2023-11-17T00:00:00.000Z,38017717,28,Ron Harper Jr.,0,0,0,0,0,0
6,1,3,6,2,13,5,3,2,32,0,2,14,3,0,1,3277449,2023-11-17T00:00:00.000Z,17896055,28,Scottie Barnes,1,17,23,20,9,28.6
0,0,0,0,0,0,0,0,0,0,0,0,0,0,0,0,3277449,2023-11-17T00:00:00.000Z,489,28,Thaddeus Young,0,0,0,0,0,0
0,0,4,2,1,4,2,0,0,17,0,3,5,4,0,0,3277450,2023-11-17T00:00:00.000Z,4197162,26,Aleksandar Vezenkov,0,9,9,5,4,9.8
0,0,0,0,0,0,0,0,0,0,0,0,0,0,0,0,3277450,2023-11-17T00:00:00.000Z,273,26,Alex Len,0,0,0,0,0,0
0,0,3,3,2,4,2,0,0,15,0,2,6,3,2,2,3277450,2023-11-17T00:00:00.000Z,17896030,26,Chris Duarte,2,9,9,6,3,13.6
0,0,0,0,0,0,0,0,0,0,0,0,0,0,0,0,3277450,2023-11-17T00:00:00.000Z,56677845,26,Colby Jones,0,0,0,0,0,0
7,0,8,11,5,24,14,13,10,41,0,2,43,8,1,1,3277450,2023-11-17T00:00:00.000Z,161,26,De'Aaron Fox,1,51,58,50,15,65.1
7,1,12,3,2,13,9,8,7,35,2,5,27,14,1,4,3277450,2023-11-17T00:00:00.000Z,406,26,Domantas Sabonis,2,41,48,34,21,56.3
1,0,2,6,1,7,2,3,2,26,0,2,7,2,1,1,3277450,2023-11-17T00:00:00.000Z,30,26,Harrison Barnes,1,9,10,8,3,12.9
1,0,0,0,0,2,2,0,0,8,0,1,4,0,0,1,3277450,2023-11-17T00:00:00.000Z,306,26,JaVale McGee,0,4,5,5,1,4.5
0,0,0,0,0,0,0,0,0,0,0,0,0,0,0,0,3277450,2023-11-17T00:00:00.000Z,17895990,26,Jordan Ford,0,0,0,0,0,0
3,0,5,4,0,10,3,0,0,38,1,2,6,6,1,2,3277450,2023-11-17T00:00:00.000Z,38017688,26,Keegan Murray,1,12,15,9,9,18.7
2,0,0,0,0,1,1,0,0,10,0,0,2,0,1,1,3277450,2023-11-17T00:00:00.000Z,38017714,26,Keon Ellis,1,2,4,4,2,7
2,1,0,4,1,9,4,0,0,25,0,2,9,0,3,0,3277450,2023-11-17T00:00:00.000Z,221,26,Kevin Huerter,4,9,11,11,2,24
8,0,3,9,6,11,7,0,0,25,1,3,20,4,1,1,3277450,2023-11-17T00:00:00.000Z,324,26,Malik Monk,1,24,32,28,12,38.8
0,0,0,0,0,0,0,0,0,0,0,0,0,0,0,0,3277450,2023-11-17T00:00:00.000Z,290,26,Trey Lyles,0,0,0,0,0,0
0,0,0,0,0,0,0,0,0,4,0,1,0,0,0,0,3277450,2023-11-17T00:00:00.000Z,38017693,27,Blake Wesley,0,0,0,0,0,0
2,0,2,2,1,3,1,0,0,15,0,1,3,2,0,0,3277450,2023-11-17T00:00:00.000Z,359,27,Cedi Osman,0,5,7,5,4,8.4
0,0,0,0,0,0,0,0,0,0,0,0,0,0,0,0,3277450,2023-11-17T00:00:00.000Z,3547246,27,Devin Vassell,0,0,0,0,0,0
0,0,0,0,0,0,0,0,0,0,0,0,0,0,0,0,3277450,2023-11-17T00:00:00.000Z,38017730,27,Dominick Barlow,0,0,0,0,0,0
3,0,0,2,1,4,2,2,1,16,0,1,6,0,0,0,3277450,2023-11-17T00:00:00.000Z,305,27,Doug McDermott,0,6,9,9,3,10.5
2,0,2,0,0,2,1,4,4,12,1,1,6,3,0,1,3277450,2023-11-17T00:00:00.000Z,17896059,27,Sandro Mamukelashvili,0,9,11,8,5,11.6
0,0,0,0,0,0,0,0,0,0,0,0,0,0,0,0,3277450,2023-11-17T00:00:00.000Z,56677870,27,Sir'Jabari Rice,0,0,0,0,0,0
0,0,0,0,0,0,0,0,0,0,0,0,0,0,0,0,3277450,2023-11-17T00:00:00.000Z,3547274,27,Tre Jones,0,0,0,0,0,0
0,0,0,0,0,0,0,0,0,0,0,0,0,0,0,0,3277451,2023-11-17T00:00:00.000Z,56677860,5,Adama Sanogo,0,0,0,0,0,0
0,2,1,5,4,6,5,4,4,23,0,4,18,1,2,1,3277451,2023-11-17T00:00:00.000Z,89,5,Alex Caruso,4,19,19,18,1,30.2
0,1,4,1,0,2,1,4,3,18,2,1,5,6,3,2,3277451,2023-11-17T00:00:00.000Z,137,5,Andre Drummond,4,11,11,5,6,22.2
1,0,2,1,0,3,0,0,0,13,0,1,0,2,0,0,3277451,2023-11-17T00:00:00.000Z,17895983,5,Ayo Dosunmu,0,2,3,1,3,3.9
4,0,1,3,0,6,2,1,0,30,0,2,4,1,0,2,3277451,2023-11-17T00:00:00.000Z,666956,5,Coby White,0,5,9,8,5,9.2
0,0,0,0,0,0,0,0,0,0,0,0,0,0,0,0,3277451,2023-11-17T00:00:00.000Z,38017719,5,Dalen Terry,0,0,0,0,0,0
3,0,4,1,1,20,10,4,2,36,0,1,23,4,1,3,3277451,2023-11-17T00:00:00.000Z,125,5,DeMar DeRozan,1,27,30,26,7,32.3
1,0,1,0,0,0,0,0,0,10,0,0,0,1,0,0,3277451,2023-11-17T00:00:00.000Z,87,5,Jevon Carter,0,1,2,1,2,2.7
0,0,0,0,0,0,0,0,0,0,0,0,0,0,0,0,3277451,2023-11-17T00:00:00.000Z,56677857,5,Julian Phillips,0,0,0,0,0,0
0,0,0,0,0,0,0,0,0,0,0,0,0,0,0,0,3277451,2023-11-17T00:00:00.000Z,45969255,5,Justin Lewis,0,0,0,0,0,0
0,0,0,0,0,0,0,0,0,0,0,0,0,0,0,0,3277451,2023-11-17T00:00:00.000Z,27,5,Lonzo Ball,0,0,0,0,0,0
6,0,7,3,0,16,4,2,2,30,3,4,10,10,0,1,3277451,2023-11-17T00:00:00.000Z,460,5,Nikola Vucevic,0,20,26,16,16,30
0,0,0,0,0,0,0,0,0,0,0,0,0,0,0,0,3277451,2023-11-17T00:00:00.000Z,56677874,5,Onuralp Bitim,0,0,0,0,0,0
1,0,2,1,0,3,0,0,0,13,0,1,0,2,1,3,3277451,2023-11-17T00:00:00.000Z,3547248,5,Patrick Williams,1,2,3,1,3,3.9
0,0,0,0,0,0,0,0,0,0,0,0,0,0,0,0,3277451,2023-11-17T00:00:00.000Z,17896116,5,Terry Taylor,0,0,0,0,0,0
0,0,1,3,1,3,1,0,0,26,0,3,3,1,1,1,3277451,2023-11-17T00:00:00.000Z,110,5,Torrey Craig,1,4,4,3,1,6.2
3,0,6,11,4,20,12,7,6,41,0,4,34,6,2,3,3277451,2023-11-17T00:00:00.000Z,268,5,Zach LaVine,2,40,43,37,9,48.7
0,0,0,0,0,0,0,0,0,0,0,0,0,0,0,0,3277451,2023-11-17T00:00:00.000Z,666885,22,Admiral Schofield,0,0,0,0,0,0
0,0,0,0,0,2,1,1,0,11,0,0,2,0,0,3,3277451,2023-11-17T00:00:00.000Z,56677827,22,Anthony Black,0,2,2,2,0,-1
0,0,2,1,1,1,1,0,0,6,0,0,3,2,0,0,3277451,2023-11-17T00:00:00.000Z,38017724,22,Caleb Houstan,0,5,5,3,2,5.4
0,0,0,0,0,0,0,0,0,0,0,0,0,0,0,0,3277451,2023-11-17T00:00:00.000Z,666818,22,Chuma Okeke,0,0,0,0,0,0
7,0,6,5,1,12,3,4,4,37,2,4,11,8,1,2,3277451,2023-11-17T00:00:00.000Z,3547251,22,Cole Anthony,1,19,26,18,15,32.1
2,0,4,8,2,18,9,2,1,35,0,2,21,4,2,2,3277451,2023-11-17T00:00:00.000Z,17896026,22,Franz Wagner,2,25,27,23,6,32.8
2,2,4,7,3,10,5,2,2,29,2,3,15,6,1,0,3277451,2023-11-17T00:00:00.000Z,196,22,Gary Harris,3,21,23,17,8,34.2
0,2,4,0,0,1,0,4,2,21,0,4,2,4,1,1,3277451,2023-11-17T00:00:00.000Z,666442,22,Goga Bitadze,3,6,6,2,4,14.8
0,0,0,0,0,0,0,0,0,0,0,0,0,0,0,0,3277451,2023-11-17T00:00:00.000Z,17896073,22,Jalen Suggs,0,0,0,0,0,0
0,0,0,0,0,0,0,0,0,0,0,0,0,0,0,0,3277451,2023-11-17T00:00:00.000Z,56677839,22,Jett Howard,0,0,0,0,0,0
5,0,1,7,2,8,3,0,0,26,0,1,8,1,1,1,3277451,2023-11-17T00:00:00.000Z,226,22,Joe Ingles,1,9,14,13,6,18.7
1,1,6,4,2,8,6,4,4,20,3,2,18,9,1,1,3277451,2023-11-17T00:00:00.000Z,229,22,Jonathan Isaac,2,27,28,19,10,35.3
0,0,0,0,0,0,0,0,0,0,0,0,0,0,0,0,3277451,2023-11-17T00:00:00.000Z,38017607,22,Kevon Harris,0,0,0,0,0,0
0,0,0,0,0,0,0,0,0,0,0,0,0,0,0,0,3277451,2023-11-17T00:00:00.000Z,165,22,Markelle Fultz,0,0,0,0,0,0
3,1,4,1,0,5,4,2,2,23,0,3,10,4,0,0,3277451,2023-11-17T00:00:00.000Z,462,22,Moritz Wagner,1,14,17,13,7,22.3
4,1,5,1,0,14,6,4,1,32,3,3,13,8,0,7,3277451,2023-11-17T00:00:00.000Z,38017683,22,Paolo Banchero,1,21,25,17,12,24.6
0,0,0,0,0,0,0,0,0,0,0,0,0,0,0,0,3277451,2023-11-17T00:00:00.000Z,17553983,22,Trevelin Queen,0,0,0,0,0,0
0,0,0,0,0,0,0,0,0,0,0,0,0,0,0,0,3277451,2023-11-17T00:00:00.000Z,85,22,Wendell Carter Jr.,0,0,0,0,0,0
2,0,7,4,0,14,7,3,0,39,1,4,14,8,2,0,3277452,2023-11-17T00:00:00.000Z,177,8,Aaron Gordon,2,22,24,16,10,32.6
0,0,0,0,0,0,0,0,0,0,0,0,0,0,0,0,3277452,2023-11-17T00:00:00.000Z,17896007,8,Braxton Key,0,0,0,0,0,0
3,0,7,5,3,19,11,1,0,30,2,1,25,9,0,0,3277452,2023-11-17T00:00:00.000Z,38017709,8,Christian Braun,0,34,37,28,12,40.3
0,0,0,0,0,0,0,0,0,0,0,0,0,0,0,0,3277452,2023-11-17T00:00:00.000Z,38017727,8,Collin Gillespie,0,0,0,0,0,0
0,0,0,0,0,0,0,0,0,0,0,0,0,0,0,0,3277452,2023-11-17T00:00:00.000Z,250,8,DeAndre Jordan,0,0,0,0,0,0
0,0,0,0,0,0,0,0,0,0,0,0,0,0,0,0,3277452,2023-11-17T00:00:00.000Z,56677871,8,Hunter Tyson,0,0,0,0,0,0
1,0,1,2,0,2,0,0,0,10,0,2,0,1,0,1,3277452,2023-11-17T00:00:00.000Z,56677582,8,Jalen Pickett,0,1,2,1,2,1.7
0,0,0,0,0,0,0,0,0,0,0,0,0,0,0,0,3277452,2023-11-17T00:00:00.000Z,335,8,Jamal Murray,0,0,0,0,0,0
0,0,0,0,0,0,0,0,0,0,0,0,0,0,0,0,3277452,2023-11-17T00:00:00.000Z,17896103,8,Jay Huff,0,0,0,0,0,0
1,0,0,3,0,4,1,0,0,9,0,2,2,0,1,0,3277452,2023-11-17T00:00:00.000Z,56677776,8,Julian Strawther,1,2,3,3,1,6.5
0,0,0,0,0,0,0,0,0,0,0,0,0,0,0,0,3277452,2023-11-17T00:00:00.000Z,215,8,Justin Holiday,0,0,0,0,0,0
8,2,1,4,2,7,3,0,0,35,0,0,8,1,1,0,3277452,2023-11-17T00:00:00.000Z,81,8,Kentavious Caldwell-Pope,3,9,17,16,9,30.2
0,0,8,6,2,14,8,1,0,33,3,3,18,11,0,0,3277452,2023-11-17T00:00:00.000Z,375,8,Michael Porter Jr.,0,29,29,18,11,31.2
18,1,14,8,1,20,10,5,5,36,2,2,26,16,0,4,3277452,2023-11-17T00:00:00.000Z,246,8,Nikola Jokic,1,42,60,44,34,71.2
1,0,1,1,0,3,1,2,1,11,2,2,3,3,0,2,3277452,2023-11-17T00:00:00.000Z,38017721,8,Peyton Watson,0,6,7,4,4,6.1
3,0,1,7,2,12,6,0,0,33,1,2,14,2,0,4,3277452,2023-11-17T00:00:00.000Z,236,8,Reggie Jackson,0,16,19,17,5,16.9
0,0,0,0,0,0,0,0,0,0,0,0,0,0,0,0,3277452,2023-11-17T00:00:00.000Z,666489,8,Vlatko Cancar,0,0,0,0,0,0
0,0,0,0,0,1,0,0,0,4,0,2,0,0,0,2,3277452,2023-11-17T00:00:00.000Z,3547268,8,Zeke Nnaji,0,0,0,0,0,-2
8,0,2,4,2,19,9,1,1,38,1,3,21,3,1,2,3277452,2023-11-17T00:00:00.000Z,227,19,Brandon Ingram,1,24,32,29,11,37.6
0,0,0,0,0,0,0,0,0,0,0,0,0,0,0,0,3277452,2023-11-17T00:00:00.000Z,303,19,CJ McCollum,0,0,0,0,0,0
0,1,1,0,0,0,0,0,0,1,0,0,0,1,0,0,3277452,2023-11-17T00:00:00.000Z,491,19,Cody Zeller,1,1,1,0,1,4.2
0,0,0,0,0,0,0,0,0,0,0,0,0,0,0,0,3277452,2023-11-17T00:00:00.000Z,38017726,19,Dereon Seabron,0,0,0,0,0,0
7,0,7,1,0,6,4,3,2,33,1,1,10,8,3,0,3277452,2023-11-17T00:00:00.000Z,38017677,19,Dyson Daniels,3,18,25,17,15,39.1
0,0,0,0,0,0,0,0,0,0,0,0,0,0,0,0,3277452,2023-11-17T00:00:00.000Z,38017663,19,E.J. Liddell,0,0,0,0,0,0
4,1,5,1,0,8,3,2,2,37,0,2,8,5,3,1,3277452,2023-11-17T00:00:00.000Z,17896024,19,Herbert Jones,4,13,17,12,9,31
0,0,0,0,0,0,0,0,0,1,0,0,0,0,0,0,3277452,2023-11-17T00:00:00.000Z,17896021,19,Jeremiah Robinson-Earl,0,0,0,0,0,0
3,1,6,3,1,18,10,3,1,34,2,4,22,8,0,0,3277452,2023-11-17T00:00:00.000Z,455,19,Jonas Valanciunas,1,30,33,25,11,39.1
4,0,5,3,1,7,3,0,0,26,0,0,7,5,0,0,3277452,2023-11-17T00:00:00.000Z,56677837,19,Jordan Hawkins,0,12,16,11,9,19
0,0,0,0,0,0,0,0,0,0,0,0,0,0,0,0,3277452,2023-11-17T00:00:00.000Z,17896097,19,Jose Alvarado,0,0,0,0,0,0
0,0,0,0,0,0,0,0,0,0,0,0,0,0,0,0,3277452,2023-11-17T00:00:00.000Z,3547260,19,Kira Lewis Jr.,0,0,0,0,0,0
0,0,0,0,0,0,0,0,0,0,0,0,0,0,0,0,3277452,2023-11-17T00:00:00.000Z,340,19,Larry Nance Jr.,0,0,0,0,0,0
0,0,0,5,3,7,3,1,0,19,0,0,9,0,0,0,3277452,2023-11-17T00:00:00.000Z,17896017,19,Matt Ryan,0,9,9,9,0,9
1,0,5,5,4,6,4,0,0,18,0,0,12,5,1,2,3277452,2023-11-17T00:00:00.000Z,3547293,19,Naji Marshall,1,17,18,13,6,20.5
0,0,0,0,0,0,0,0,0,0,0,0,0,0,0,0,3277452,2023-11-17T00:00:00.000Z,18677986,19,Trey Murphy III,0,0,0,0,0,0
6,2,4,1,1,17,10,11,5,33,0,3,26,4,0,4,3277452,2023-11-17T00:00:00.000Z,666969,19,Zion Williamson,2,30,36,32,10,41.8
0,0,0,0,0,0,0,0,0,0,0,0,0,0,0,0,3277453,2023-11-17T00:00:00.000Z,666451,24,Bol Bol,0,0,0,0,0,0
0,0,0,0,0,0,0,0,0,0,0,0,0,0,0,0,3277453,2023-11-17T00:00:00.000Z,37,24,Bradley Beal,0,0,0,0,0,0
0,0,0,0,0,0,0,0,0,0,0,0,0,0,0,0,3277453,2023-11-17T00:00:00.000Z,314,24,Chimezie Metu,0,0,0,0,0,0
0,0,0,0,0,0,0,0,0,0,0,0,0,0,0,0,3277453,2023-11-17T00:00:00.000Z,272,24,Damion Lee,0,0,0,0,0,0
15,0,4,3,2,15,7,10,8,32,0,3,24,4,0,1,3277453,2023-11-17T00:00:00.000Z,57,24,Devin Booker,0,28,43,39,19,50.3
0,0,4,1,1,5,5,0,0,21,0,2,11,4,0,0,3277453,2023-11-17T00:00:00.000Z,147,24,Drew Eubanks,0,15,15,11,4,15.8
1,1,2,8,4,12,5,0,0,33,0,2,14,2,1,1,3277453,2023-11-17T00:00:00.000Z,178,24,Eric Gordon,2,16,17,15,3,22.9
1,0,1,4,2,8,3,2,2,30,0,1,10,1,0,0,3277453,2023-11-17T00:00:00.000Z,8,24,Grayson Allen,0,11,12,11,2,12.7
4,0,2,4,1,6,1,0,0,14,0,2,3,2,1,0,3277453,2023-11-17T00:00:00.000Z,18678058,24,Jordan Goodwin,1,5,9,7,6,14.4
0,0,0,0,0,1,0,2,1,13,1,2,1,1,0,1,3277453,2023-11-17T00:00:00.000Z,356,24,Josh Okogie,0,2,2,1,1,1.2
4,0,5,1,0,7,4,7,7,23,2,4,15,7,1,4,3277453,2023-11-17T00:00:00.000Z,349,24,Jusuf Nurkic,1,22,26,19,11,28.4
0,3,2,0,0,4,2,3,3,20,1,4,7,3,2,0,3277453,2023-11-17T00:00:00.000Z,32,24,Keita Bates-Diop,5,10,10,7,3,25.6
9,0,9,8,6,22,15,2,2,33,0,1,38,9,0,1,3277453,2023-11-17T00:00:00.000Z,140,24,Kevin Durant,0,47,56,47,18,61.3
1,0,1,2,1,3,2,0,0,11,0,0,5,1,0,0,3277453,2023-11-17T00:00:00.000Z,666729,24,Nassir Little,0,6,7,6,2,7.7
0,0,0,0,0,0,0,0,0,0,0,0,0,0,0,0,3277453,2023-11-17T00:00:00.000Z,3547298,24,Saben Lee,0,0,0,0,0,0
0,0,0,0,0,0,0,0,0,0,0,0,0,0,0,0,3277453,2023-11-17T00:00:00.000Z,3547095,24,Udoka Azubuike,0,0,0,0,0,0
0,0,1,2,1,3,1,0,0,10,1,1,3,2,0,0,3277453,2023-11-17T00:00:00.000Z,470,24,Yuta Watanabe,0,5,5,3,2,5.4
0,0,0,0,0,0,0,0,0,0,0,0,0,0,0,0,3277453,2023-11-17T00:00:00.000Z,56677842,29,Brice Sensabaugh,0,0,0,0,0,0
4,2,2,2,0,8,3,2,2,20,2,3,8,4,0,0,3277453,2023-11-17T00:00:00.000Z,413,29,Collin Sexton,2,12,16,12,8,24.8
1,2,10,2,1,10,5,6,4,35,4,6,15,14,0,0,3277453,2023-11-17T00:00:00.000Z,101,29,John Collins,2,29,30,16,15,39.3
0,0,0,0,0,0,0,0,0,0,0,0,0,0,0,0,3277453,2023-11-17T00:00:00.000Z,38017630,29,Johnny Juzang,0,0,0,0,0,0
5,0,2,10,5,26,14,4,4,36,1,0,37,3,1,0,3277453,2023-11-17T00:00:00.000Z,100,29,Jordan Clarkson,1,40,45,42,8,51.1
0,0,0,0,0,0,0,0,0,0,0,0,0,0,0,0,3277453,2023-11-17T00:00:00.000Z,17896023,29,Josh Christopher,0,0,0,0,0,0
7,0,3,2,1,4,3,0,0,20,1,2,7,4,0,1,3277453,2023-11-17T00:00:00.000Z,358,29,Kelly Olynyk,0,11,18,14,11,21.3
6,0,3,6,3,11,5,3,2,29,0,2,15,3,1,3,3277453,2023-11-17T00:00:00.000Z,56677834,29,Keyonte George,1,18,24,21,9,27.6
0,0,0,0,0,0,0,0,0,1,0,0,0,0,0,0,3277453,2023-11-17T00:00:00.000Z,139,29,Kris Dunn,0,0,0,0,0,0
0,2,2,4,1,12,5,12,10,40,0,1,21,2,1,0,3277453,2023-11-17T00:00:00.000Z,297,29,Lauri Markkanen,3,23,23,21,2,32.4
0,0,0,0,0,0,0,0,0,0,0,0,0,0,0,0,3277453,2023-11-17T00:00:00.000Z,666881,29,Luka Samanic,0,0,0,0,0,0
0,0,0,0,0,0,0,0,0,0,0,0,0,0,0,0,3277453,2023-11-17T00:00:00.000Z,19465584,29,Micah Potter,0,0,0,0,0,0
0,3,3,2,2,4,3,0,0,25,2,3,8,5,0,0,3277453,2023-11-17T00:00:00.000Z,38017620,29,Ochai Agbaji,3,13,13,8,5,23
0,0,0,0,0,0,0,0,0,0,0,0,0,0,0,0,3277453,2023-11-17T00:00:00.000Z,11891374,29,Omer Yurtseven,0,0,0,0,0,0
0,0,1,4,2,5,3,0,0,15,0,2,8,1,0,1,3277453,2023-11-17T00:00:00.000Z,38017739,29,Simone Fontecchio,0,9,9,8,1,8.2
4,1,3,4,1,5,2,4,4,19,0,4,9,3,0,3,3277453,2023-11-17T00:00:00.000Z,666650,29,Talen Horton-Tucker,1,12,16,13,7,18.6
0,0,0,0,0,0,0,0,0,0,0,0,0,0,0,0,3277453,2023-11-17T00:00:00.000Z,56677824,29,Taylor Hendricks,0,0,0,0,0,0
0,0,0,0,0,0,0,0,0,0,0,0,0,0,0,0,3277453,2023-11-17T00:00:00.000Z,38017705,29,Walker Kessler,0,0,0,0,0,0
0,0,0,0,0,0,0,0,0,0,0,0,0,0,0,0,3277454,2023-11-17T00:00:00.000Z,56677867,14,Alex Fudge,0,0,0,0,0,0
2,5,10,1,0,19,8,1,0,35,4,5,16,14,3,6,3277454,2023-11-17T00:00:00.000Z,117,14,Anthony Davis,8,30,32,18,16,53.8
4,0,1,1,0,4,1,6,5,18,1,0,7,2,0,3,3277454,2023-11-17T00:00:00.000Z,17553995,14,Austin Reaves,0,9,13,11,6,12.4
1,1,1,2,1,4,2,4,3,31,1,0,8,2,3,1,3277454,2023-11-17T00:00:00.000Z,666860,14,Cameron Reddish,4,10,11,9,3,22.9
0,0,8,3,0,9,5,0,0,20,2,1,10,10,0,0,3277454,2023-11-17T00:00:00.000Z,486,14,Christian Wood,0,20,20,10,10,22
0,0,0,0,0,0,0,0,0,0,0,0,0,0,0,0,3277454,2023-11-17T00:00:00.000Z,56677738,14,Colin Castleton,0,0,0,0,0,0
6,0,2,7,4,10,5,1,0,29,1,1,14,3,0,4,3277454,2023-11-17T00:00:00.000Z,405,14,D'Angelo Russell,0,17,23,20,9,22.6
0,0,0,0,0,0,0,0,0,0,0,0,0,0,0,0,3277454,2023-11-17T00:00:00.000Z,56677868,14,D'Moi Hodge,0,0,0,0,0,0
0,0,0,0,0,0,0,0,0,0,0,0,0,0,0,0,3277454,2023-11-17T00:00:00.000Z,56677835,14,Jalen Hood-Schifino,0,0,0,0,0,0
0,0,0,0,0,0,0,0,0,0,0,0,0,0,0,0,3277454,2023-11-17T00:00:00.000Z,457,14,Jarred Vanderbilt,0,0,0,0,0,0
0,0,1,0,0,0,0,1,0,8,0,0,0,1,1,0,3277454,2023-11-17T00:00:00.000Z,666626,14,Jaxson Hayes,1,1,1,0,1,4.2
9,0,5,9,5,22,13,6,4,34,0,3,35,5,2,3,3277454,2023-11-17T00:00:00.000Z,237,14,LeBron James,2,40,49,44,14,57.5
0,0,1,0,0,1,0,0,0,1,0,0,0,1,0,1,3277454,2023-11-17T00:00:00.000Z,38017697,14,Max Christie,0,1,1,0,1,0.2
0,0,0,0,0,0,0,0,0,1,0,0,0,0,0,0,3277454,2023-11-17T00:00:00.000Z,56677836,14,Maxwell Lewis,0,0,0,0,0,0
2,0,4,2,1,5,3,0,0,28,1,1,7,5,0,0,3277454,2023-11-17T00:00:00.000Z,666609,14,Rui Hachimura,0,12,14,9,7,16
3,0,0,5,1,7,3,3,3,35,1,5,10,1,2,0,3277454,2023-11-17T00:00:00.000Z,383,14,Taurean Prince,2,11,14,13,4,21.7
0,0,0,0,0,0,0,0,0,0,0,0,0,0,0,0,3277454,2023-11-17T00:00:00.000Z,419,25,Anfernee Simons,0,0,0,0,0,0
2,0,5,0,0,14,8,2,1,38,7,4,17,12,2,4,3277454,2023-11-17T00:00:00.000Z,22,25,Deandre Ayton,2,29,31,19,14,36.4
0,0,1,4,0,5,0,0,0,10,1,1,0,2,0,0,3277454,2023-11-17T00:00:00.000Z,56783340,25,Duop Reath,0,2,2,0,2,2.4
0,0,0,0,0,0,0,0,0,0,0,0,0,0,0,0,3277454,2023-11-17T00:00:00.000Z,17896120,25,Ish Wainright,0,0,0,0,0,0
1,0,3,2,0,6,2,5,3,18,2,0,7,5,0,0,3277454,2023-11-17T00:00:00.000Z,38017711,25,Jabari Walker,0,12,13,8,6,14.5
0,0,0,0,0,0,0,0,0,1,0,0,0,0,0,0,3277454,2023-11-17T00:00:00.000Z,44477062,25,Jamaree Bouyea,0,0,0,0,0,0
3,0,4,9,4,20,8,4,4,40,0,0,24,4,1,1,3277454,2023-11-17T00:00:00.000Z,182,25,Jerami Grant,1,28,31,27,7,35.3
0,0,0,0,0,0,0,0,0,5,0,0,0,0,0,0,3277454,2023-11-17T00:00:00.000Z,47957121,25,Justin Minaya,0,0,0,0,0,0
0,0,0,0,0,0,0,0,0,0,0,0,0,0,0,0,3277454,2023-11-17T00:00:00.000Z,65,25,Malcolm Brogdon,0,0,0,0,0,0
1,0,3,2,1,3,2,0,0,24,1,1,5,4,2,2,3277454,2023-11-17T00:00:00.000Z,666923,25,Matisse Thybulle,2,9,10,6,5,15.3
0,0,0,0,0,0,0,0,0,0,0,0,0,0,0,0,3277454,2023-11-17T00:00:00.000Z,666476,25,Moses Brown,0,0,0,0,0,0
0,0,0,0,0,0,0,0,0,0,0,0,0,0,0,0,3277454,2023-11-17T00:00:00.000Z,56677829,25,Rayan Rupert,0,0,0,0,0,0
0,0,0,0,0,0,0,0,0,0,0,0,0,0,0,0,3277454,2023-11-17T00:00:00.000Z,476,25,Robert Williams III,0,0,0,0,0,0
0,0,0,0,0,0,0,0,0,0,0,0,0,0,0,0,3277454,2023-11-17T00:00:00.000Z,56677747,25,Scoot Henderson,0,0,0,0,0,0
2,1,7,5,1,17,7,2,2,38,2,4,17,9,1,10,3277454,2023-11-17T00:00:00.000Z,38017690,25,Shaedon Sharpe,2,26,28,19,11,26.8
8,0,2,7,3,14,6,0,0,25,3,3,15,5,2,0,3277454,2023-11-17T00:00:00.000Z,3547289,25,Skylar Mays,2,20,28,23,13,39
0,1,4,6,1,8,3,5,3,36,2,3,10,6,2,1,3277454,2023-11-17T00:00:00.000Z,56677850,25,Toumani Camara,3,16,16,10,6,25.2
1,0,3,2,0,6,2,1,0,31,1,6,4,4,1,0,3277455,2023-11-17T00:00:00.000Z,66,11,Dillon Brooks,1,8,9,5,5,13.3
0,0,0,0,0,0,0,0,0,0,0,0,0,0,0,0,3277455,2023-11-17T00:00:00.000Z,666511,13,Amir Coffey,0,0,0,0,0,0
0,0,0,0,0,0,0,0,0,0,0,0,0,0,0,0,3277455,2023-11-17T00:00:00.000Z,17896022,13,Brandon Boston Jr.,0,0,0,0,0,0
0,0,3,1,0,3,1,2,0,11,0,2,2,3,1,0,3277455,2023-11-17T00:00:00.000Z,439,13,Daniel Theis,1,5,5,2,3,8.6
2,2,4,0,0,8,6,2,0,35,3,2,12,7,0,1,3277455,2023-11-17T00:00:00.000Z,493,13,Ivica Zubac,2,19,21,14,9,28.4
7,1,8,4,2,11,8,7,6,34,1,1,24,9,0,3,3277455,2023-11-17T00:00:00.000Z,192,13,James Harden,1,33,40,31,16,45.3
0,0,0,0,0,0,0,0,0,0,0,0,0,0,0,0,3277455,2023-11-17T00:00:00.000Z,56677856,13,Jordan Miller,0,0,0,0,0,0
2,1,7,6,3,16,8,8,7,37,1,3,26,8,5,3,3277455,2023-11-17T00:00:00.000Z,274,13,Kawhi Leonard,6,34,36,28,10,53.6
0,0,0,0,0,0,0,0,0,0,0,0,0,0,0,0,3277455,2023-11-17T00:00:00.000Z,56677849,13,Kobe Brown,0,0,0,0,0,0
0,0,0,0,0,0,0,0,0,0,0,0,0,0,0,0,3277455,2023-11-17T00:00:00.000Z,38017725,13,Moussa Diabate,0,0,0,0,0,0
0,0,0,0,0,0,0,0,0,0,0,0,0,0,0,0,3277455,2023-11-17T00:00:00.000Z,17896031,13,Nah'Shon Hyland,0,0,0,0,0,0
3,1,2,5,2,11,3,2,2,30,1,2,10,3,1,0,3277455,2023-11-17T00:00:00.000Z,380,13,Norman Powell,2,13,16,13,6,24.1
3,1,7,10,4,22,8,3,3,40,1,2,23,8,2,3,3277455,2023-11-17T00:00:00.000Z,172,13,Paul George,3,31,34,26,11,43.1
0,0,0,0,0,0,0,0,0,15,0,3,0,0,0,0,3277455,2023-11-17T00:00:00.000Z,450,13,PJ Tucker,0,0,0,0,0,0
2,0,3,6,2,9,2,4,2,17,0,1,8,3,0,2,3277455,2023-11-17T00:00:00.000Z,472,13,Russell Westbrook,0,11,13,10,5,12.6
3,1,5,2,0,3,0,2,1,21,1,3,1,6,1,0,3277455,2023-11-17T00:00:00.000Z,666743,13,Terance Mann,2,7,10,4,9,18.7
0,0,0,0,0,0,0,0,0,0,0,0,0,0,0,0,1037771,2023-11-18T00:00:00.000Z,56677848,4,Amari Bailey,0,0,0,0,0,0
1,0,1,1,0,2,0,0,0,16,1,2,0,2,0,0,1037771,2023-11-18T00:00:00.000Z,38017708,4,Bryce McGowens,0,2,3,1,3,3.9
0,0,0,0,0,0,0,0,0,0,0,0,0,0,0,0,1037771,2023-11-18T00:00:00.000Z,666748,4,Cody Martin,0,0,0,0,0,0
0,0,0,0,0,0,0,0,0,0,0,0,0,0,0,0,1037771,2023-11-18T00:00:00.000Z,347,4,Frank Ntilikina,0,0,0,0,0,0
0,0,0,0,0,0,0,0,0,0,0,0,0,0,0,0,1037771,2023-11-18T00:00:00.000Z,17896037,4,James Bouknight,0,0,0,0,0,0
0,1,1,2,1,3,2,0,0,11,1,1,5,2,0,0,1037771,2023-11-18T00:00:00.000Z,18678001,4,JT Thor,1,7,7,5,2,10.4
0,0,0,0,0,0,0,0,0,0,0,0,0,0,0,0,1037771,2023-11-18T00:00:00.000Z,56677866,4,Leaky Black,0,0,0,0,0,0
0,0,0,0,0,0,0,0,0,0,0,0,0,0,0,0,1037771,2023-11-18T00:00:00.000Z,3547282,4,Nick Richards,0,0,0,0,0,0
0,0,0,0,0,0,0,0,0,0,0,0,0,0,0,0,1037771,2023-11-18T00:00:00.000Z,56677846,4,Nick Smith Jr.,0,0,0,0,0,0
0,0,0,0,0,0,0,0,0,0,0,0,0,0,0,0,1037771,2023-11-18T00:00:00.000Z,403,4,Terry Rozier,0,0,0,0,0,0
0,0,0,0,0,0,0,0,0,0,0,0,0,0,0,0,1037771,2023-11-18T00:00:00.000Z,3547253,4,Theo Maledon,0,0,0,0,0,0
3,0,3,5,1,15,5,5,4,26,0,0,15,3,1,1,1037771,2023-11-18T00:00:00.000Z,666423,20,RJ Barrett,1,18,21,18,6,25.1
4,0,3,10,5,19,9,0,0,30,0,6,23,3,0,3,1037772,2023-11-18T00:00:00.000Z,3547238,18,Anthony Edwards,0,26,30,27,7,29.6
0,0,0,0,0,0,0,0,0,0,0,0,0,0,0,0,1037772,2023-11-18T00:00:00.000Z,17895968,18,Daishen Nix,0,0,0,0,0,0
0,0,0,0,0,0,0,0,0,0,0,0,0,0,0,0,1037772,2023-11-18T00:00:00.000Z,38017715,18,Josh Minott,0,0,0,0,0,0
5,2,4,0,0,7,4,2,1,26,1,0,9,5,1,1,1037772,2023-11-18T00:00:00.000Z,12,18,Kyle Anderson,3,14,19,14,10,30.5
5,0,3,5,1,8,2,0,0,30,0,1,5,3,1,3,1037772,2023-11-18T00:00:00.000Z,104,18,Mike Conley,1,8,13,10,8,16.1
0,1,1,6,2,8,2,2,2,19,0,0,8,1,0,1,1037772,2023-11-18T00:00:00.000Z,667378,18,Naz Reid,1,9,9,8,1,11.2
3,1,1,4,2,7,4,0,0,18,0,2,10,1,1,2,1037772,2023-11-18T00:00:00.000Z,666400,18,Nickeil Alexander-Walker,2,11,14,13,4,19.7
1,0,1,2,0,6,2,4,4,16,0,2,8,1,1,1,1037772,2023-11-18T00:00:00.000Z,320,18,Shake Milton,1,9,10,9,2,12.7
0,0,0,0,0,0,0,0,0,0,0,0,0,0,0,0,1037772,2023-11-18T00:00:00.000Z,68,18,Troy Brown Jr.,0,0,0,0,0,0
0,0,0,0,0,0,0,0,0,0,0,0,0,0,0,0,1037772,2023-11-18T00:00:00.000Z,303,19,CJ McCollum,0,0,0,0,0,0
0,0,4,0,0,4,1,0,0,13,3,3,2,7,1,1,1037772,2023-11-18T00:00:00.000Z,491,19,Cody Zeller,1,9,9,2,7,12.4
0,0,0,0,0,0,0,0,0,0,0,0,0,0,0,0,1037772,2023-11-18T00:00:00.000Z,38017663,19,E.J. Liddell,0,0,0,0,0,0
0,0,0,0,0,0,0,0,0,0,0,0,0,0,0,0,1037772,2023-11-18T00:00:00.000Z,17896097,19,Jose Alvarado,0,0,0,0,0,0
0,0,0,0,0,0,0,0,0,0,0,0,0,0,0,0,1037772,2023-11-18T00:00:00.000Z,3547260,19,Kira Lewis Jr.,0,0,0,0,0,0
0,0,0,0,0,0,0,0,0,0,0,0,0,0,0,0,1037772,2023-11-18T00:00:00.000Z,666969,19,Zion Williamson,0,0,0,0,0,0
0,0,0,0,0,0,0,0,0,0,0,0,0,0,0,0,1037773,2023-11-18T00:00:00.000Z,56677860,5,Adama Sanogo,0,0,0,0,0,0
0,1,6,0,0,3,2,2,2,15,3,3,6,9,1,1,1037773,2023-11-18T00:00:00.000Z,137,5,Andre Drummond,2,15,15,6,9,21.8
2,0,1,2,0,2,0,2,2,13,0,2,2,1,0,1,1037773,2023-11-18T00:00:00.000Z,17895983,5,Ayo Dosunmu,0,3,5,4,3,5.2
0,0,0,0,0,0,0,0,0,0,0,0,0,0,0,0,1037773,2023-11-18T00:00:00.000Z,38017719,5,Dalen Terry,0,0,0,0,0,0
1,0,1,9,3,9,3,0,0,14,0,2,9,1,0,0,1037773,2023-11-18T00:00:00.000Z,87,5,Jevon Carter,0,10,11,10,2,11.7
0,0,0,0,0,0,0,0,0,0,0,0,0,0,0,0,1037773,2023-11-18T00:00:00.000Z,56677857,5,Julian Phillips,0,0,0,0,0,0
0,0,0,0,0,0,0,0,0,0,0,0,0,0,0,0,1037773,2023-11-18T00:00:00.000Z,45969255,5,Justin Lewis,0,0,0,0,0,0
0,0,0,0,0,0,0,0,0,0,0,0,0,0,0,0,1037773,2023-11-18T00:00:00.000Z,27,5,Lonzo Ball,0,0,0,0,0,0
0,0,0,0,0,0,0,0,0,0,0,0,0,0,0,0,1037773,2023-11-18T00:00:00.000Z,56677874,5,Onuralp Bitim,0,0,0,0,0,0
1,1,1,1,0,5,1,0,0,15,3,2,2,4,1,0,1037773,2023-11-18T00:00:00.000Z,3547248,5,Patrick Williams,2,6,7,3,5,14.3
0,0,0,0,0,0,0,0,0,0,0,0,0,0,0,0,1037773,2023-11-18T00:00:00.000Z,17896116,5,Terry Taylor,0,0,0,0,0,0
2,1,4,3,1,5,3,0,0,17,1,1,7,5,0,0,1037773,2023-11-18T00:00:00.000Z,110,5,Torrey Craig,1,12,14,9,7,19
5,0,9,0,0,12,8,8,8,36,1,3,24,10,0,3,1037773,2023-11-18T00:00:00.000Z,4,16,Bam Adebayo,0,34,39,29,15,40.5
0,0,1,4,1,9,2,0,0,15,1,1,5,2,1,1,1037773,2023-11-18T00:00:00.000Z,666747,16,Caleb Martin,1,7,7,5,2,9.4
0,0,0,0,0,0,0,0,0,0,0,0,0,0,0,0,1037773,2023-11-18T00:00:00.000Z,38017736,16,Cole Swider,0,0,0,0,0,0
0,0,0,0,0,0,0,0,0,0,0,0,0,0,0,0,1037773,2023-11-18T00:00:00.000Z,19465585,16,Dru Smith,0,0,0,0,0,0
7,0,3,5,4,9,5,4,3,35,0,2,17,3,0,1,1037773,2023-11-18T00:00:00.000Z,397,16,Duncan Robinson,0,20,27,24,10,30.1
0,0,2,3,0,4,0,0,0,24,1,1,0,3,3,4,1037773,2023-11-18T00:00:00.000Z,3092,16,Haywood Highsmith,3,3,3,0,3,8.6
0,0,2,1,1,4,2,2,1,27,1,4,6,3,0,3,1037773,2023-11-18T00:00:00.000Z,56677785,16,Jaime Jaquez Jr.,0,9,9,6,3,6.6
2,0,3,6,2,16,8,7,7,33,0,2,25,3,1,2,1037773,2023-11-18T00:00:00.000Z,79,16,Jimmy Butler,1,28,30,27,5,32.6
2,0,5,6,1,7,2,2,0,12,1,2,5,6,0,0,1037773,2023-11-18T00:00:00.000Z,285,16,Kevin Love,0,11,13,7,8,15.2
5,0,3,7,2,10,3,0,0,32,0,3,8,3,3,1,1037773,2023-11-18T00:00:00.000Z,286,16,Kyle Lowry,3,11,16,13,8,27.1
0,0,0,0,0,0,0,0,0,0,0,0,0,0,0,0,1037773,2023-11-18T00:00:00.000Z,74,16,Thomas Bryant,0,0,0,0,0,0
1,0,1,2,0,5,3,0,0,11,0,0,6,1,0,0,1037774,2023-11-18T00:00:00.000Z,151,7,Dante Exum,0,7,8,7,2,8.7
2,1,7,0,0,4,3,0,0,24,3,5,6,10,0,3,1037774,2023-11-18T00:00:00.000Z,56677840,7,Dereck Lively II,1,16,18,8,12,21
1,0,6,2,0,7,0,0,0,19,2,1,0,8,0,2,1037774,2023-11-18T00:00:00.000Z,247,7,Derrick Jones Jr.,0,8,9,1,9,9.1
1,0,3,0,0,2,1,1,1,24,0,3,3,3,0,0,1037774,2023-11-18T00:00:00.000Z,379,7,Dwight Powell,0,6,7,4,4,8.1
2,1,4,10,4,11,5,0,0,38,3,1,14,7,0,1,1037774,2023-11-18T00:00:00.000Z,666965,7,Grant Williams,1,21,23,16,9,27.4
0,0,0,0,0,0,0,0,0,0,0,0,0,0,0,0,1037774,2023-11-18T00:00:00.000Z,38017679,7,Jaden Hardy,0,0,0,0,0,0
3,0,3,3,1,3,1,0,0,20,1,1,3,4,0,0,1037774,2023-11-18T00:00:00.000Z,3547258,7,Josh Green,0,7,10,6,7,12.3
6,0,3,10,3,29,16,4,4,34,1,4,39,4,1,2,1037774,2023-11-18T00:00:00.000Z,228,7,Kyrie Irving,1,43,49,45,10,53.8
9,0,8,9,4,26,15,4,1,35,1,1,35,9,0,3,1037774,2023-11-18T00:00:00.000Z,132,7,Luka Doncic,0,44,53,44,18,56.3
0,0,1,1,0,2,1,0,0,9,0,0,2,1,0,0,1037774,2023-11-18T00:00:00.000Z,114,7,Seth Curry,0,3,3,2,1,3.2
2,0,2,10,4,14,6,1,1,26,0,0,17,2,0,1,1037774,2023-11-18T00:00:00.000Z,191,7,Tim Hardaway Jr.,0,19,21,19,4,21.4
1,0,0,4,2,5,3,0,0,11,0,1,8,0,0,0,1037774,2023-11-18T00:00:00.000Z,38017733,17,A.J. Green,0,8,9,9,1,9.5
2,0,0,0,0,1,0,0,0,12,0,1,0,0,0,0,1037774,2023-11-18T00:00:00.000Z,56677852,17,Andre Jackson Jr.,0,0,2,2,2,3
2,0,6,2,1,10,5,0,0,22,1,0,11,7,0,0,1037774,2023-11-18T00:00:00.000Z,377,17,Bobby Portis,0,18,20,13,9,22.4
0,2,3,6,1,8,3,5,5,34,0,1,12,3,1,0,1037774,2023-11-18T00:00:00.000Z,283,17,Brook Lopez,3,15,15,12,3,24.6
2,0,2,4,3,5,4,0,0,17,0,4,11,2,1,0,1037774,2023-11-18T00:00:00.000Z,368,17,Cameron Payne,1,13,15,13,4,19.4
0,0,0,0,0,0,0,0,0,0,0,0,0,0,0,0,1037774,2023-11-18T00:00:00.000Z,56677854,17,Chris Livingston,0,0,0,0,0,0
12,0,3,11,4,18,7,10,9,38,0,2,27,3,1,1,1037774,2023-11-18T00:00:00.000Z,278,17,Damian Lillard,1,30,42,39,15,50.6
7,1,12,3,1,26,18,5,3,38,2,3,40,14,2,3,1037774,2023-11-18T00:00:00.000Z,15,17,Giannis Antetokounmpo,3,54,61,47,21,73.3
0,0,0,0,0,0,0,0,0,0,0,0,0,0,0,0,1037774,2023-11-18T00:00:00.000Z,112,17,Jae Crowder,0,0,0,0,0,0
0,0,0,0,0,0,0,0,0,0,0,0,0,0,0,0,1037774,2023-11-18T00:00:00.000Z,315,17,Khris Middleton,0,0,0,0,0,0
0,0,7,6,1,9,3,0,0,34,0,3,7,7,1,0,1037774,2023-11-18T00:00:00.000Z,38,17,Malik Beasley,1,14,14,7,7,18.4
0,0,0,0,0,0,0,0,0,0,0,0,0,0,0,0,1037774,2023-11-18T00:00:00.000Z,38017676,17,MarJon Beauchamp,0,0,0,0,0,0
0,0,0,0,0,0,0,0,0,0,0,0,0,0,0,0,1037774,2023-11-18T00:00:00.000Z,666453,17,Marques Bolden,0,0,0,0,0,0
3,0,2,9,4,12,6,0,0,34,2,1,16,4,2,1,1037774,2023-11-18T00:00:00.000Z,105,17,Pat Connaughton,2,20,23,19,7,30.3
0,0,0,0,0,0,0,0,0,0,0,0,0,0,0,0,1037774,2023-11-18T00:00:00.000Z,284,17,Robin Lopez,0,0,0,0,0,0
0,0,0,0,0,0,0,0,0,0,0,0,0,0,0,0,1037774,2023-11-18T00:00:00.000Z,2148,17,Thanasis Antetokounmpo,0,0,0,0,0,0
0,0,0,0,0,0,0,0,0,0,0,0,0,0,0,0,1037775,2023-11-18T00:00:00.000Z,666505,15,Brandon Clarke,0,0,0,0,0,0
1,0,2,3,0,5,0,2,0,26,2,1,0,4,2,1,1037775,2023-11-18T00:00:00.000Z,38017729,15,David Roddy,2,4,5,1,5,11.3
1,0,1,1,1,4,3,3,2,14,0,1,9,1,0,0,1037775,2023-11-18T00:00:00.000Z,401,15,Derrick Rose,0,10,11,10,2,11.7
4,0,2,6,3,15,8,7,7,34,3,5,26,5,1,2,1037775,2023-11-18T00:00:00.000Z,3547287,15,Desmond Bane,1,31,35,30,9,39
0,0,0,0,0,0,0,0,0,0,0,0,0,0,0,0,1037775,2023-11-18T00:00:00.000Z,56677830,15,GG Jackson,0,0,0,0,0,0
0,0,0,0,0,0,0,0,0,0,0,0,0,0,0,0,1037775,2023-11-18T00:00:00.000Z,666786,15,Ja Morant,0,0,0,0,0,0
1,0,0,2,1,2,1,0,0,12,0,3,3,0,0,0,1037775,2023-11-18T00:00:00.000Z,48248287,15,Jacob Gilyard,0,3,4,4,1,4.5
0,0,0,0,0,0,0,0,0,0,0,0,0,0,0,0,1037775,2023-11-18T00:00:00.000Z,38017728,15,Jake LaRavia,0,0,0,0,0,0
0,1,2,8,2,20,7,12,11,27,3,3,27,5,1,2,1037775,2023-11-18T00:00:00.000Z,231,15,Jaren Jackson Jr.,2,32,32,27,5,37
2,0,1,1,0,3,1,0,0,12,0,3,2,1,0,1,1037775,2023-11-18T00:00:00.000Z,38017732,15,Kenneth Lofton Jr.,0,3,5,4,3,5.2
0,0,0,0,0,0,0,0,0,0,0,0,0,0,0,0,1037775,2023-11-18T00:00:00.000Z,254,15,Luke Kennard,0,0,0,0,0,0
3,1,8,5,1,15,7,3,2,36,2,2,17,10,1,3,1037775,2023-11-18T00:00:00.000Z,17896067,15,Santi Aldama,2,27,30,20,13,36.5
0,0,0,0,0,0,0,0,0,0,0,0,0,0,0,0,1037775,2023-11-18T00:00:00.000Z,3,15,Steven Adams,0,0,0,0,0,0
0,0,0,0,0,0,0,0,0,0,0,0,0,0,0,0,1037775,2023-11-18T00:00:00.000Z,38017731,15,Vince Williams Jr.,0,0,0,0,0,0
5,0,6,3,2,8,4,8,7,25,1,1,17,7,1,1,1037775,2023-11-18T00:00:00.000Z,17896027,15,Ziaire Williams,1,24,29,22,12,34.9
0,0,1,0,0,0,0,0,0,4,0,3,0,1,0,1,1037775,2023-11-18T00:00:00.000Z,17895854,27,Charles Bassey,0,1,1,0,1,0.2
0,0,0,0,0,0,0,0,0,0,0,0,0,0,0,0,1037775,2023-11-18T00:00:00.000Z,3547246,27,Devin Vassell,0,0,0,0,0,0
0,0,0,0,0,0,0,0,0,0,0,0,0,0,0,0,1037775,2023-11-18T00:00:00.000Z,180,27,Devonte' Graham,0,0,0,0,0,0
0,0,1,0,0,0,0,0,0,3,0,0,0,1,0,0,1037775,2023-11-18T00:00:00.000Z,38017730,27,Dominick Barlow,0,1,1,0,1,1.2
3,0,3,2,1,8,5,6,5,32,2,3,16,5,2,3,1037775,2023-11-18T00:00:00.000Z,38017699,27,Jeremy Sochan,2,21,24,19,8,29.5
3,0,1,3,0,6,2,0,0,18,0,2,4,1,0,2,1037775,2023-11-18T00:00:00.000Z,38017692,27,Malaki Branham,0,5,8,7,4,7.7
0,0,0,0,0,0,0,0,0,0,0,0,0,0,0,0,1037775,2023-11-18T00:00:00.000Z,56677817,27,Sidy Cissoko,0,0,0,0,0,0
0,0,0,0,0,0,0,0,0,0,0,0,0,0,0,0,1037775,2023-11-18T00:00:00.000Z,56677870,27,Sir'Jabari Rice,0,0,0,0,0,0
3,1,1,8,5,19,12,4,2,35,0,4,31,1,0,0,1037776,2023-11-18T00:00:00.000Z,475,10,Andrew Wiggins,1,32,35,34,4,39.7
3,0,3,4,1,6,2,4,3,25,1,0,8,4,0,3,1037776,2023-11-18T00:00:00.000Z,56677858,10,Brandin Podziemski,0,12,15,11,7,14.3
11,1,3,7,4,9,4,0,0,38,1,3,12,4,3,0,1037776,2023-11-18T00:00:00.000Z,367,10,Chris Paul,4,16,27,23,15,45.3
0,0,0,0,0,0,0,0,0,0,0,0,0,0,0,0,1037776,2023-11-18T00:00:00.000Z,251,10,Cory Joseph,0,0,0,0,0,0
1,0,6,2,0,9,3,0,0,18,2,1,6,8,0,1,1037776,2023-11-18T00:00:00.000Z,407,10,Dario Saric,0,14,15,7,9,16.1
0,0,0,0,0,0,0,0,0,0,0,0,0,0,0,0,1037776,2023-11-18T00:00:00.000Z,185,10,Draymond Green,0,0,0,0,0,0
0,0,0,0,0,0,0,0,0,0,0,0,0,0,0,0,1037776,2023-11-18T00:00:00.000Z,2189,10,Gary Payton II,0,0,0,0,0,0
0,0,0,0,0,0,0,0,0,0,0,0,0,0,0,0,1037776,2023-11-18T00:00:00.000Z,57875092,10,Gui Santos,0,0,0,0,0,0
0,0,0,0,0,0,0,0,0,0,0,0,0,0,0,0,1037776,2023-11-18T00:00:00.000Z,398,10,Jerome Robinson,0,0,0,0,0,0
2,1,3,2,0,10,6,2,1,20,2,2,13,5,1,3,1037776,2023-11-18T00:00:00.000Z,17553979,10,Jonathan Kuminga,2,18,20,15,7,25
5,1,9,0,0,5,3,0,0,35,5,0,6,14,1,1,1037776,2023-11-18T00:00:00.000Z,282,10,Kevon Looney,2,20,25,11,19,35.3
4,0,2,9,3,13,5,3,3,36,0,4,16,2,0,4,1037776,2023-11-18T00:00:00.000Z,443,10,Klay Thompson,0,18,22,20,6,20.4
0,0,0,0,0,0,0,0,0,0,0,0,0,0,0,0,1037776,2023-11-18T00:00:00.000Z,45658838,10,Lester Quinones,0,0,0,0,0,0
1,0,2,3,0,4,1,4,4,18,2,2,6,4,1,2,1037776,2023-11-18T00:00:00.000Z,17553992,10,Moses Moody,1,10,11,7,5,13.3
3,0,6,11,5,21,8,4,4,40,0,2,25,6,0,2,1037776,2023-11-18T00:00:00.000Z,115,10,Stephen Curry,0,31,34,28,9,34.7
0,0,0,0,0,0,0,0,0,0,0,0,0,0,0,0,1037776,2023-11-18T00:00:00.000Z,56677799,10,Trayce Jackson-Davis,0,0,0,0,0,0
0,0,0,0,0,0,0,0,0,0,0,0,0,0,0,0,1037776,2023-11-18T00:00:00.000Z,17896070,10,Usman Garuba,0,0,0,0,0,0
1,0,2,0,0,0,0,0,0,6,0,0,0,2,0,2,1037776,2023-11-18T00:00:00.000Z,17896078,21,Aaron Wiggins,0,2,3,1,3,1.9
0,0,0,0,0,0,0,0,0,0,0,0,0,0,0,0,1037776,2023-11-18T00:00:00.000Z,3547271,21,Aleksej Pokusevski,0,0,0,0,0,0
2,0,1,2,0,3,1,1,1,28,0,3,3,1,0,0,1037776,2023-11-18T00:00:00.000Z,56677833,21,Cason Wallace,0,4,6,5,3,7.2
5,1,6,5,2,22,14,7,6,37,4,2,36,10,2,4,1037776,2023-11-18T00:00:00.000Z,38017685,21,Chet Holmgren,3,46,51,41,15,60.5
0,0,0,0,0,0,0,0,0,0,0,0,0,0,0,0,1037776,2023-11-18T00:00:00.000Z,44,21,Davis Bertans,0,0,0,0,0,0
3,0,6,2,0,16,8,6,6,41,0,2,22,6,1,1,1037776,2023-11-18T00:00:00.000Z,38017703,21,Jalen Williams,1,28,31,25,9,35.7
0,0,2,0,0,1,1,0,0,6,0,0,2,2,0,0,1037776,2023-11-18T00:00:00.000Z,38017706,21,Jaylin Williams,0,4,4,2,2,4.4
2,2,3,2,1,10,4,2,2,22,2,2,11,5,1,0,1037776,2023-11-18T00:00:00.000Z,17896065,21,Josh Giddey,3,16,18,13,7,29
0,0,0,0,0,0,0,0,0,0,0,0,0,0,0,0,1037776,2023-11-18T00:00:00.000Z,56677853,21,Keyontae Johnson,0,0,0,0,0,0
2,0,6,4,1,6,1,0,0,27,1,2,3,7,0,0,1037776,2023-11-18T00:00:00.000Z,666541,21,Luguentz Dort,0,10,12,5,9,14.4
0,0,0,0,0,0,0,0,0,0,0,0,0,0,0,0,1037776,2023-11-18T00:00:00.000Z,38017716,21,Ousmane Dieng,0,0,0,0,0,0
0,0,0,0,0,0,0,0,0,0,0,0,0,0,0,0,1037776,2023-11-18T00:00:00.000Z,17896036,21,Tre Mann,0,0,0,0,0,0
1,0,0,0,0,1,1,0,0,8,0,0,2,0,0,0,1037776,2023-11-18T00:00:00.000Z,4197029,21,Vasilije Micic,0,2,3,3,1,3.5
0,0,0,0,0,0,0,0,0,0,0,0,0,0,0,0,1037777,2023-11-19T00:00:00.000Z,9051997,3,Armoni Brooks,0,0,0,0,0,0
0,0,0,0,0,0,0,0,0,0,0,0,0,0,0,0,1037777,2023-11-19T00:00:00.000Z,417,3,Ben Simmons,0,0,0,0,0,0
0,0,0,0,0,0,0,0,0,0,0,0,0,0,0,0,1037777,2023-11-19T00:00:00.000Z,17896048,3,Cam Thomas,0,0,0,0,0,0
2,1,2,5,1,12,3,2,2,28,3,2,9,5,0,2,1037777,2023-11-19T00:00:00.000Z,666679,3,Cameron Johnson,1,14,16,11,7,19
0,0,0,0,0,0,0,0,0,0,0,0,0,0,0,0,1037777,2023-11-19T00:00:00.000Z,56677841,3,Dariq Whitehead,0,0,0,0,0,0
2,2,6,0,0,3,3,0,0,20,2,1,6,8,0,2,1037777,2023-11-19T00:00:00.000Z,17896038,3,Day'Ron Sharpe,2,14,16,8,10,22.6
0,0,0,0,0,0,0,0,0,0,0,0,0,0,0,0,1037777,2023-11-19T00:00:00.000Z,421,3,Dennis Smith Jr.,0,0,0,0,0,0
2,0,2,3,1,7,2,0,0,27,1,2,5,3,0,1,1037777,2023-11-19T00:00:00.000Z,158,3,Dorian Finney-Smith,0,8,10,7,5,10.6
0,0,1,1,0,3,2,1,1,6,0,1,5,1,0,0,1037777,2023-11-19T00:00:00.000Z,174,3,Harry Giles III,0,6,6,5,1,6.2
0,0,0,0,0,0,0,0,0,0,0,0,0,0,0,0,1037777,2023-11-19T00:00:00.000Z,56677722,3,Jalen Wilson,0,0,0,0,0,0
0,0,0,0,0,0,0,0,0,0,0,0,0,0,0,0,1037777,2023-11-19T00:00:00.000Z,17896041,3,Keon Johnson,0,0,0,0,0,0
2,0,6,11,6,17,9,2,2,32,0,1,26,6,0,2,1037777,2023-11-19T00:00:00.000Z,464,3,Lonnie Walker IV,0,32,34,28,8,34.2
3,0,1,2,2,12,8,0,0,29,0,0,18,1,0,2,1037777,2023-11-19T00:00:00.000Z,61,3,Mikal Bridges,0,19,22,21,4,21.7
1,1,9,0,0,6,5,3,0,23,0,3,10,9,0,2,1037777,2023-11-19T00:00:00.000Z,666508,3,Nicolas Claxton,1,19,20,11,10,23.3
0,0,0,0,0,0,0,0,0,0,0,0,0,0,0,0,1037777,2023-11-19T00:00:00.000Z,56677843,3,Noah Clowney,0,0,0,0,0,0
3,2,3,0,0,2,0,0,0,25,1,1,0,4,1,1,1037777,2023-11-19T00:00:00.000Z,351,3,Royce O'Neale,3,4,7,3,7,17.3
5,1,4,4,1,10,3,6,5,28,0,0,12,4,0,2,1037777,2023-11-19T00:00:00.000Z,130,3,Spencer Dinwiddie,1,16,21,17,9,25.3
4,1,2,2,0,9,3,2,2,22,2,3,8,4,1,1,1037777,2023-11-19T00:00:00.000Z,17896058,3,Trendon Watford,2,12,16,12,8,23.8
3,0,1,2,1,4,1,0,0,14,2,3,3,3,1,0,1037777,2023-11-19T00:00:00.000Z,2175,23,Danuel House Jr.,1,6,9,6,6,14.1
1,0,5,6,4,10,8,1,1,27,0,3,21,5,3,1,1037777,2023-11-19T00:00:00.000Z,313,23,De'Anthony Melton,3,26,27,22,6,36.5
9,1,10,2,1,24,11,10,9,31,2,3,32,12,0,1,1037777,2023-11-19T00:00:00.000Z,145,23,Joel Embiid,1,44,53,41,21,61.9
3,0,3,1,1,1,1,0,0,24,0,2,3,3,0,0,1037777,2023-11-19T00:00:00.000Z,33,23,Nicolas Batum,0,6,9,6,6,11.1
2,0,1,1,0,4,1,0,0,12,0,1,2,1,0,1,1037777,2023-11-19T00:00:00.000Z,45,23,Patrick Beverley,0,3,5,4,3,5.2
0,1,2,0,0,2,2,0,0,11,0,1,4,2,1,0,1037777,2023-11-19T00:00:00.000Z,108,23,Robert Covington,2,6,6,4,2,12.4
1,0,4,4,0,13,5,0,0,32,1,0,10,5,2,0,1037777,2023-11-19T00:00:00.000Z,200,23,Tobias Harris,2,15,16,11,6,23.5
10,0,1,11,6,20,8,3,3,37,1,0,25,2,0,1,1037777,2023-11-19T00:00:00.000Z,3547254,23,Tyrese Maxey,0,27,37,35,12,41.4
0,0,1,0,0,2,0,0,0,15,0,2,0,1,0,0,1037778,2023-11-19T00:00:00.000Z,3547250,12,Aaron Nesmith,0,1,1,0,1,1.2
3,0,6,3,1,12,4,5,5,25,0,6,14,6,1,0,1037778,2023-11-19T00:00:00.000Z,38017686,12,Bennedict Mathurin,1,20,23,17,9,28.7
1,1,5,2,1,7,4,2,2,22,0,3,11,5,0,1,1037778,2023-11-19T00:00:00.000Z,69,12,Bruce Brown,1,16,17,12,6,20.5
2,0,1,4,1,4,1,0,0,15,0,4,3,1,0,1,1037778,2023-11-19T00:00:00.000Z,210,12,Buddy Hield,0,4,6,5,3,6.2
1,1,3,0,0,2,1,6,4,12,1,2,6,4,3,0,1037778,2023-11-19T00:00:00.000Z,17896035,12,Isaiah Jackson,4,10,11,7,5,24.3
1,0,3,5,2,11,8,1,1,23,2,3,19,5,2,1,1037778,2023-11-19T00:00:00.000Z,3547207,12,Jordan Nwora,2,24,25,20,6,31.5
3,3,1,3,0,10,3,6,4,23,3,2,10,4,1,1,1037778,2023-11-19T00:00:00.000Z,452,12,Myles Turner,4,14,17,13,7,30.3
2,0,2,3,0,8,3,0,0,16,2,2,6,4,0,2,1037778,2023-11-19T00:00:00.000Z,3547243,12,Obi Toppin,0,10,12,8,6,11.8
5,0,3,1,0,9,5,3,1,21,1,1,11,4,0,2,1037778,2023-11-19T00:00:00.000Z,304,12,T.J. McConnell,0,15,20,16,9,21.3
3,1,2,3,1,14,4,3,3,25,0,2,12,2,0,4,1037778,2023-11-19T00:00:00.000Z,3547245,12,Tyrese Haliburton,1,14,17,15,5,17.9
1,0,2,2,1,8,6,6,5,18,1,1,18,3,1,0,1037778,2023-11-19T00:00:00.000Z,17896073,22,Jalen Suggs,1,21,22,19,4,26.1
0,0,0,0,0,0,0,0,0,0,0,0,0,0,0,0,1037779,2023-11-19T00:00:00.000Z,404,6,Ricky Rubio,0,0,0,0,0,0
5,2,2,2,0,11,4,6,3,32,2,2,11,4,1,1,1037779,2023-11-19T00:00:00.000Z,177,8,Aaron Gordon,3,15,20,16,9,31.3
0,0,0,0,0,0,0,0,0,0,0,0,0,0,0,0,1037779,2023-11-19T00:00:00.000Z,17896007,8,Braxton Key,0,0,0,0,0,0
0,0,0,0,0,0,0,0,0,0,0,0,0,0,0,0,1037779,2023-11-19T00:00:00.000Z,335,8,Jamal Murray,0,0,0,0,0,0
0,0,0,0,0,0,0,0,0,0,0,0,0,0,0,0,1037779,2023-11-19T00:00:00.000Z,17896103,8,Jay Huff,0,0,0,0,0,0
2,1,0,5,1,9,2,4,4,31,2,1,9,2,1,1,1037779,2023-11-19T00:00:00.000Z,81,8,Kentavious Caldwell-Pope,2,11,13,11,4,19.4
0,0,5,9,5,15,7,2,2,27,1,2,21,6,1,2,1037779,2023-11-19T00:00:00.000Z,375,8,Michael Porter Jr.,1,27,27,21,6,29.2
7,1,9,0,0,13,8,5,2,28,1,5,18,10,1,3,1037779,2023-11-19T00:00:00.000Z,246,8,Nikola Jokic,2,28,35,25,17,43.5
0,0,0,0,0,0,0,0,0,0,0,0,0,0,0,0,1037779,2023-11-19T00:00:00.000Z,38017721,8,Peyton Watson,0,0,0,0,0,0
1,0,0,1,1,5,3,0,0,21,0,2,7,0,2,2,1037779,2023-11-19T00:00:00.000Z,236,8,Reggie Jackson,2,7,8,8,1,12.5
0,0,0,0,0,0,0,0,0,0,0,0,0,0,0,0,1037779,2023-11-19T00:00:00.000Z,666489,8,Vlatko Cancar,0,0,0,0,0,0
0,0,0,0,0,0,0,0,0,0,0,0,0,0,0,0,1037780,2023-11-19T00:00:00.000Z,42097199,9,Jared Rhoden,0,0,0,0,0,0
0,0,0,0,0,0,0,0,0,0,0,0,0,0,0,0,1037780,2023-11-19T00:00:00.000Z,197,9,Joe Harris,0,0,0,0,0,0
0,0,0,0,0,0,0,0,0,0,0,0,0,0,0,0,1037780,2023-11-19T00:00:00.000Z,330,9,Monte Morris,0,0,0,0,0,0
0,0,0,0,0,0,0,0,0,0,0,0,0,0,0,0,1037781,2023-11-19T00:00:00.000Z,17554004,7,AJ Lawson,0,0,0,0,0,0
0,0,0,0,0,0,0,0,0,0,0,0,0,0,0,0,1037781,2023-11-19T00:00:00.000Z,56677873,7,Dexter Dennis,0,0,0,0,0,0
1,0,1,0,0,0,0,0,0,13,0,1,0,1,1,2,1037781,2023-11-19T00:00:00.000Z,379,7,Dwight Powell,1,1,2,1,2,3.7
0,0,0,0,0,0,0,0,0,0,0,0,0,0,0,0,1037781,2023-11-19T00:00:00.000Z,17896028,7,Greg Brown III,0,0,0,0,0,0
0,0,0,2,1,4,1,2,1,10,0,2,4,0,1,1,1037781,2023-11-19T00:00:00.000Z,38017679,7,Jaden Hardy,1,4,4,4,0,6
1,1,0,2,0,4,1,0,0,5,0,0,2,0,0,0,1037781,2023-11-19T00:00:00.000Z,329,7,Markieff Morris,1,2,3,3,1,6.5
0,0,0,0,0,0,0,0,0,0,0,0,0,0,0,0,1037781,2023-11-19T00:00:00.000Z,257,7,Maxi Kleber,0,0,0,0,0,0
0,0,3,1,0,1,0,0,0,5,0,0,0,3,0,0,1037781,2023-11-19T00:00:00.000Z,56677859,7,Olivier-Maxence Prosper,0,3,3,0,3,3.6
0,0,0,0,0,3,3,2,1,5,2,1,7,2,0,0,1037781,2023-11-19T00:00:00.000Z,217,7,Richaun Holmes,0,9,9,7,2,9.4
0,0,0,0,0,0,0,0,0,0,0,0,0,0,0,0,1037781,2023-11-19T00:00:00.000Z,114,7,Seth Curry,0,0,0,0,0,0
1,1,0,2,1,5,3,0,0,13,1,2,7,1,0,1,1037781,2023-11-19T00:00:00.000Z,4197162,26,Aleksandar Vezenkov,1,8,9,8,2,11.7
0,0,0,0,0,0,0,0,0,0,0,0,0,0,0,0,1037781,2023-11-19T00:00:00.000Z,273,26,Alex Len,0,0,0,0,0,0
4,0,8,4,3,8,5,0,0,33,0,3,13,8,2,1,1037781,2023-11-19T00:00:00.000Z,17896030,26,Chris Duarte,2,21,25,17,12,33.6
0,0,0,1,0,1,0,0,0,4,0,2,0,0,0,0,1037781,2023-11-19T00:00:00.000Z,56677845,26,Colby Jones,0,0,0,0,0,0
1,0,0,1,0,3,0,0,0,9,0,0,0,0,0,2,1037781,2023-11-19T00:00:00.000Z,17553994,26,Davion Mitchell,0,0,1,1,1,-0.5
7,0,3,10,6,20,10,5,4,31,1,1,30,4,3,0,1037781,2023-11-19T00:00:00.000Z,161,26,De'Aaron Fox,3,34,41,37,11,54.3
6,0,10,2,0,15,13,10,6,35,3,2,32,13,0,1,1037781,2023-11-19T00:00:00.000Z,406,26,Domantas Sabonis,0,45,51,38,19,55.6
0,0,0,0,0,0,0,0,0,0,0,0,0,0,0,0,1037781,2023-11-19T00:00:00.000Z,17895941,26,Filip Petrusev,0,0,0,0,0,0
6,0,2,7,1,11,4,3,3,34,2,1,12,4,1,3,1037781,2023-11-19T00:00:00.000Z,30,26,Harrison Barnes,1,16,22,18,10,25.8
0,0,1,0,0,0,0,0,0,4,0,0,0,1,0,0,1037781,2023-11-19T00:00:00.000Z,56677862,26,Jalen Slawson,0,1,1,0,1,1.2
1,1,5,0,0,4,2,2,2,9,2,1,6,7,1,1,1037781,2023-11-19T00:00:00.000Z,306,26,JaVale McGee,2,13,14,7,8,20.9
0,0,0,0,0,0,0,0,0,0,0,0,0,0,0,0,1037781,2023-11-19T00:00:00.000Z,17895990,26,Jordan Ford,0,0,0,0,0,0
4,0,0,7,2,13,7,1,1,32,3,5,17,3,1,1,1037781,2023-11-19T00:00:00.000Z,38017688,26,Keegan Murray,1,20,24,21,7,28.6
0,0,3,0,0,0,0,0,0,9,1,1,0,4,0,0,1037781,2023-11-19T00:00:00.000Z,38017714,26,Keon Ellis,0,4,4,0,4,4.8
1,0,0,0,0,1,0,0,0,9,1,0,0,1,0,0,1037781,2023-11-19T00:00:00.000Z,17896044,26,Kessler Edwards,0,1,2,1,2,2.7
0,0,0,0,0,0,0,0,0,0,0,0,0,0,0,0,1037781,2023-11-19T00:00:00.000Z,221,26,Kevin Huerter,0,0,0,0,0,0
3,1,2,6,4,9,4,0,0,18,0,2,12,2,1,2,1037781,2023-11-19T00:00:00.000Z,324,26,Malik Monk,2,14,17,15,5,22.9
0,0,0,0,0,0,0,0,0,0,0,0,0,0,0,0,1037781,2023-11-19T00:00:00.000Z,290,26,Trey Lyles,0,0,0,0,0,0
2,0,1,3,1,5,2,0,0,22,2,2,5,3,0,0,1037782,2023-11-19T00:00:00.000Z,219,2,Al Horford,0,8,10,7,5,11.6
4,1,2,5,2,9,3,2,2,34,1,2,10,3,0,2,1037782,2023-11-19T00:00:00.000Z,473,2,Derrick White,1,13,17,14,7,20.6
3,2,6,7,1,16,5,2,1,34,0,4,12,6,2,2,1037782,2023-11-19T00:00:00.000Z,70,2,Jaylen Brown,4,18,21,15,9,33.7
5,1,7,1,1,13,7,6,5,35,2,4,20,9,1,8,1037782,2023-11-19T00:00:00.000Z,434,2,Jayson Tatum,2,29,34,25,14,36.3
4,0,4,3,1,7,2,2,2,37,2,1,7,6,0,2,1037782,2023-11-19T00:00:00.000Z,214,2,Jrue Holiday,0,13,17,11,10,18.2
1,6,6,3,0,13,9,9,8,33,2,4,26,8,1,2,1037782,2023-11-19T00:00:00.000Z,378,2,Kristaps Porzingis,7,34,35,27,9,56.1
0,0,1,0,0,0,0,0,0,3,0,1,0,1,0,0,1037782,2023-11-19T00:00:00.000Z,3547279,2,Lamar Stevens,0,1,1,0,1,1.2
0,0,2,0,0,1,0,0,0,5,0,1,0,2,0,0,1037782,2023-11-19T00:00:00.000Z,17553967,2,Neemias Queta,0,2,2,0,2,2.4
1,0,3,2,1,5,2,4,2,15,0,0,7,3,0,1,1037782,2023-11-19T00:00:00.000Z,3547276,2,Payton Pritchard,0,10,11,8,4,11.1
0,0,4,7,5,8,5,0,0,22,0,0,15,4,2,0,1037782,2023-11-19T00:00:00.000Z,17896060,2,Sam Hauser,2,19,19,15,4,25.8
0,1,1,0,0,2,1,0,0,15,1,5,2,2,0,0,1037782,2023-11-19T00:00:00.000Z,48,15,Bismack Biyombo,1,4,4,2,2,7.4
0,0,0,0,0,0,0,0,0,0,0,0,0,0,0,0,1037782,2023-11-19T00:00:00.000Z,666505,15,Brandon Clarke,0,0,0,0,0,0
0,0,2,2,0,2,0,0,0,20,0,0,0,2,0,0,1037782,2023-11-19T00:00:00.000Z,38017729,15,David Roddy,0,2,2,0,2,2.4
0,0,0,0,0,0,0,0,0,0,0,0,0,0,0,0,1037782,2023-11-19T00:00:00.000Z,401,15,Derrick Rose,0,0,0,0,0,0
8,0,0,14,7,27,11,1,1,37,2,2,30,2,1,2,1037782,2023-11-19T00:00:00.000Z,3547287,15,Desmond Bane,1,32,40,38,10,45.4
0,0,0,0,0,0,0,0,0,0,0,0,0,0,0,0,1037782,2023-11-19T00:00:00.000Z,56677830,15,GG Jackson,0,0,0,0,0,0
0,0,0,0,0,0,0,0,0,0,0,0,0,0,0,0,1037782,2023-11-19T00:00:00.000Z,666786,15,Ja Morant,0,0,0,0,0,0
5,0,1,2,1,2,1,0,0,15,1,1,3,2,2,1,1037782,2023-11-19T00:00:00.000Z,48248287,15,Jacob Gilyard,2,5,10,8,7,17.9
0,0,0,0,0,0,0,0,0,0,0,0,0,0,0,0,1037782,2023-11-19T00:00:00.000Z,38017728,15,Jake LaRavia,0,0,0,0,0,0
1,1,6,3,1,12,5,7,6,34,2,5,17,8,1,2,1037782,2023-11-19T00:00:00.000Z,231,15,Jaren Jackson Jr.,2,25,26,18,9,32.1
3,1,3,0,0,3,1,0,0,26,2,2,2,5,1,1,1037782,2023-11-19T00:00:00.000Z,666703,15,John Konchar,2,7,10,5,8,17.5
0,0,0,0,0,0,0,0,0,0,0,0,0,0,0,0,1037782,2023-11-19T00:00:00.000Z,254,15,Luke Kennard,0,0,0,0,0,0
0,0,0,0,0,0,0,0,0,0,0,0,0,0,0,0,1037782,2023-11-19T00:00:00.000Z,420,15,Marcus Smart,0,0,0,0,0,0
6,0,8,15,6,27,11,0,0,39,4,2,28,12,2,1,1037782,2023-11-19T00:00:00.000Z,17896067,15,Santi Aldama,2,40,46,34,18,56.4
0,0,0,0,0,0,0,0,0,0,0,0,0,0,0,0,1037782,2023-11-19T00:00:00.000Z,3,15,Steven Adams,0,0,0,0,0,0
0,2,0,3,2,4,2,0,0,17,0,2,6,0,0,0,1037782,2023-11-19T00:00:00.000Z,38017731,15,Vince Williams Jr.,2,6,6,6,0,12
0,0,0,0,0,0,0,0,0,0,0,0,0,0,0,0,1037782,2023-11-19T00:00:00.000Z,3547285,15,Xavier Tillman,0,0,0,0,0,0
4,0,5,4,0,11,3,0,0,24,2,2,6,7,0,0,1037782,2023-11-19T00:00:00.000Z,17896027,15,Ziaire Williams,0,13,17,10,11,20.4
0,0,0,0,0,0,0,0,0,0,0,0,0,0,0,0,1037783,2023-11-19T00:00:00.000Z,666451,24,Bol Bol,0,0,0,0,0,0
0,0,0,0,0,0,0,0,0,0,0,0,0,0,0,0,1037783,2023-11-19T00:00:00.000Z,37,24,Bradley Beal,0,0,0,0,0,0
0,0,0,0,0,0,0,0,0,0,0,0,0,0,0,0,1037783,2023-11-19T00:00:00.000Z,314,24,Chimezie Metu,0,0,0,0,0,0
0,0,0,0,0,0,0,0,0,0,0,0,0,0,0,0,1037783,2023-11-19T00:00:00.000Z,272,24,Damion Lee,0,0,0,0,0,0
3,1,4,6,3,8,5,2,1,43,0,4,14,4,1,2,1037783,2023-11-19T00:00:00.000Z,8,24,Grayson Allen,2,18,21,17,7,27.3
3,0,3,0,0,0,0,0,0,11,0,0,0,3,1,1,1037783,2023-11-19T00:00:00.000Z,18678058,24,Jordan Goodwin,1,3,6,3,6,10.1
2,2,8,0,0,11,7,4,4,35,4,5,18,12,1,2,1037783,2023-11-19T00:00:00.000Z,349,24,Jusuf Nurkic,3,30,32,20,14,42.4
1,2,0,4,1,6,2,1,1,23,1,3,6,1,1,0,1037783,2023-11-19T00:00:00.000Z,32,24,Keita Bates-Diop,3,7,8,7,2,17.7
10,2,8,9,4,27,14,7,7,46,0,2,39,8,2,7,1037783,2023-11-19T00:00:00.000Z,140,24,Kevin Durant,4,47,57,49,18,68.6
0,0,0,0,0,0,0,0,0,0,0,0,0,0,0,0,1037783,2023-11-19T00:00:00.000Z,3547298,24,Saben Lee,0,0,0,0,0,0
0,0,0,0,0,0,0,0,0,0,0,0,0,0,0,0,1037783,2023-11-19T00:00:00.000Z,3547095,24,Udoka Azubuike,0,0,0,0,0,0
0,0,0,0,0,0,0,0,0,0,0,0,0,0,0,0,1037783,2023-11-19T00:00:00.000Z,470,24,Yuta Watanabe,0,0,0,0,0,0
2,0,2,6,3,13,6,3,3,23,3,0,18,5,1,2,1037783,2023-11-19T00:00:00.000Z,413,29,Collin Sexton,1,23,25,20,7,28
0,1,8,5,3,14,5,2,2,43,4,2,15,12,2,1,1037783,2023-11-19T00:00:00.000Z,101,29,John Collins,3,27,27,15,12,37.4
5,0,4,6,1,23,8,7,5,39,3,5,22,7,2,2,1037783,2023-11-19T00:00:00.000Z,100,29,Jordan Clarkson,2,29,34,27,12,41.9
5,0,2,2,0,4,1,4,4,20,3,6,6,5,0,4,1037783,2023-11-19T00:00:00.000Z,358,29,Kelly Olynyk,0,11,16,11,10,15.5
11,0,3,5,0,12,2,4,3,34,2,2,7,5,1,5,1037783,2023-11-19T00:00:00.000Z,56677834,29,Keyonte George,1,12,23,18,16,27.5
0,0,0,0,0,0,0,0,0,0,0,0,0,0,0,0,1037783,2023-11-19T00:00:00.000Z,139,29,Kris Dunn,0,0,0,0,0,0
0,2,10,10,2,27,15,9,6,50,7,3,38,17,2,1,1037783,2023-11-19T00:00:00.000Z,297,29,Lauri Markkanen,4,55,55,38,17,69.4
1,1,1,1,1,1,1,0,0,34,2,4,3,3,1,1,1037783,2023-11-19T00:00:00.000Z,38017620,29,Ochai Agbaji,2,6,7,4,4,13.1
0,1,0,1,1,3,1,0,0,18,1,1,3,1,0,1,1037783,2023-11-19T00:00:00.000Z,38017739,29,Simone Fontecchio,1,4,4,3,1,6.2
3,0,2,10,4,18,9,3,3,29,2,4,25,4,2,1,1037783,2023-11-19T00:00:00.000Z,666650,29,Talen Horton-Tucker,2,29,32,28,7,39.3
0,0,0,0,0,0,0,0,0,0,0,0,0,0,0,0,1037783,2023-11-19T00:00:00.000Z,56677824,29,Taylor Hendricks,0,0,0,0,0,0
4,0,1,1,1,3,2,0,0,9,2,1,5,3,0,0,1037784,2023-11-19T00:00:00.000Z,3547271,21,Aleksej Pokusevski,0,8,12,9,7,14.6
0,0,1,0,0,2,1,0,0,21,0,1,2,1,1,1,1037784,2023-11-19T00:00:00.000Z,56677833,21,Cason Wallace,1,3,3,2,1,5.2
0,2,6,2,2,6,6,2,2,20,0,1,16,6,0,0,1037784,2023-11-19T00:00:00.000Z,38017685,21,Chet Holmgren,2,22,22,16,6,29.2
2,1,2,5,1,5,1,0,0,11,0,0,3,2,0,0,1037784,2023-11-19T00:00:00.000Z,44,21,Davis Bertans,1,5,7,5,4,11.4
1,0,1,6,5,6,5,0,0,14,0,0,15,1,1,1,1037784,2023-11-19T00:00:00.000Z,3547272,21,Isaiah Joe,1,16,17,16,2,19.7
0,0,0,0,0,0,0,0,0,0,0,0,0,0,0,0,1037784,2023-11-19T00:00:00.000Z,38017703,21,Jalen Williams,0,0,0,0,0,0
5,0,4,0,0,6,3,0,0,23,0,1,6,4,1,4,1037784,2023-11-19T00:00:00.000Z,17896065,21,Josh Giddey,1,10,15,11,9,17.3
0,0,0,0,0,0,0,0,0,0,0,0,0,0,0,0,1037784,2023-11-19T00:00:00.000Z,56677853,21,Keyontae Johnson,0,0,0,0,0,0
1,0,3,7,4,7,4,0,0,16,0,0,12,3,0,0,1037784,2023-11-19T00:00:00.000Z,27924547,21,Lindy Waters III,0,15,16,13,4,17.1
1,0,0,3,2,6,4,2,2,22,0,1,12,0,0,0,1037784,2023-11-19T00:00:00.000Z,666541,21,Luguentz Dort,0,12,13,13,1,13.5
0,0,1,3,2,5,2,0,0,10,1,4,6,2,0,0,1037784,2023-11-19T00:00:00.000Z,24572055,21,Olivier Sarr,0,8,8,6,2,8.4
0,0,0,0,0,0,0,0,0,0,0,0,0,0,0,0,1037784,2023-11-19T00:00:00.000Z,38017716,21,Ousmane Dieng,0,0,0,0,0,0
4,0,3,1,1,13,10,7,7,22,0,2,28,3,1,3,1037784,2023-11-19T00:00:00.000Z,175,21,Shai Gilgeous-Alexander,1,31,35,32,7,37.6
2,0,3,3,1,7,3,0,0,24,2,1,7,5,0,3,1037784,2023-11-19T00:00:00.000Z,17896036,21,Tre Mann,0,12,14,9,7,13
1,0,0,0,0,1,0,0,0,6,0,0,0,0,0,2,1037784,2023-11-19T00:00:00.000Z,4197029,21,Vasilije Micic,0,0,1,1,1,-0.5
0,0,0,0,0,0,0,0,0,0,0,0,0,0,0,0,1037784,2023-11-19T00:00:00.000Z,419,25,Anfernee Simons,0,0,0,0,0,0
0,0,0,0,0,0,0,0,0,0,0,0,0,0,0,0,1037784,2023-11-19T00:00:00.000Z,17896120,25,Ish Wainright,0,0,0,0,0,0
5,0,1,2,0,4,1,0,0,16,1,0,2,2,0,2,1037784,2023-11-19T00:00:00.000Z,44477062,25,Jamaree Bouyea,0,4,9,7,7,9.9
0,1,0,4,2,6,2,2,1,13,2,0,7,2,0,0,1037784,2023-11-19T00:00:00.000Z,47957121,25,Justin Minaya,1,9,9,7,2,12.4
0,0,1,2,1,4,2,4,3,21,1,3,8,2,1,1,1037784,2023-11-19T00:00:00.000Z,56677791,25,Kris Murray,1,10,10,8,2,12.4
0,0,0,0,0,0,0,0,0,0,0,0,0,0,0,0,1037784,2023-11-19T00:00:00.000Z,65,25,Malcolm Brogdon,0,0,0,0,0,0
0,0,0,0,0,1,1,0,0,7,1,0,2,1,1,0,1037784,2023-11-19T00:00:00.000Z,666476,25,Moses Brown,1,3,3,2,1,6.2
1,0,0,3,1,5,1,2,1,12,1,0,4,1,1,1,1037784,2023-11-19T00:00:00.000Z,56677829,25,Rayan Rupert,1,5,6,5,2,8.7
0,0,0,0,0,0,0,0,0,0,0,0,0,0,0,0,1037784,2023-11-19T00:00:00.000Z,476,25,Robert Williams III,0,0,0,0,0,0
0,0,0,0,0,0,0,0,0,0,0,0,0,0,0,0,1037784,2023-11-19T00:00:00.000Z,56677747,25,Scoot Henderson,0,0,0,0,0,0
3,1,6,0,0,15,11,7,5,33,4,6,27,10,2,4,1037785,2023-11-19T00:00:00.000Z,117,14,Anthony Davis,3,37,40,30,13,48.5
6,0,6,3,2,7,5,6,5,25,0,0,17,6,0,2,1037785,2023-11-19T00:00:00.000Z,17553995,14,Austin Reaves,0,23,29,23,12,31.2
3,0,3,5,1,9,3,0,0,39,0,2,7,3,3,1,1037785,2023-11-19T00:00:00.000Z,666860,14,Cameron Reddish,3,10,13,10,6,23.1
0,0,2,3,0,4,0,0,0,18,0,3,0,2,0,1,1037785,2023-11-19T00:00:00.000Z,486,14,Christian Wood,0,2,2,0,2,1.4
2,0,5,5,1,8,1,2,1,24,0,1,4,5,3,3,1037785,2023-11-19T00:00:00.000Z,405,14,D'Angelo Russell,3,9,11,6,7,19
8,0,5,5,2,19,14,9,7,40,1,0,37,6,3,2,1037785,2023-11-19T00:00:00.000Z,237,14,LeBron James,3,43,51,45,14,63.2
2,0,3,4,0,10,4,4,3,32,1,0,11,4,2,2,1037785,2023-11-19T00:00:00.000Z,666609,14,Rui Hachimura,2,15,17,13,6,22.8
2,0,1,4,0,11,1,1,0,24,3,0,2,4,0,2,1037785,2023-11-19T00:00:00.000Z,383,14,Taurean Prince,0,6,8,4,6,7.8
0,0,0,0,0,0,0,0,0,0,0,0,0,0,0,0,1037786,2023-11-20T00:00:00.000Z,17896094,2,Dalano Banton,0,0,0,0,0,0
3,0,3,5,0,17,5,4,3,34,1,5,13,4,0,2,1037786,2023-11-20T00:00:00.000Z,70,2,Jaylen Brown,0,17,20,16,7,20.3
6,2,13,15,7,28,15,10,8,44,0,1,45,13,0,3,1037786,2023-11-20T00:00:00.000Z,434,2,Jayson Tatum,2,58,64,51,19,72.6
0,0,0,0,0,0,0,0,0,0,0,0,0,0,0,0,1037786,2023-11-20T00:00:00.000Z,38017707,2,JD Davison,0,0,0,0,0,0
5,2,3,3,1,11,5,2,0,37,3,1,11,6,1,7,1037786,2023-11-20T00:00:00.000Z,214,2,Jrue Holiday,3,17,22,16,11,27.7
0,3,5,8,1,14,5,10,6,34,3,2,17,8,2,0,1037786,2023-11-20T00:00:00.000Z,378,2,Kristaps Porzingis,5,25,25,17,8,41.6
0,1,3,0,0,2,2,0,0,19,0,0,4,3,0,0,1037786,2023-11-20T00:00:00.000Z,261,2,Luke Kornet,1,7,7,4,3,10.6
0,0,0,0,0,0,0,0,0,0,0,0,0,0,0,0,1037786,2023-11-20T00:00:00.000Z,17553967,2,Neemias Queta,0,0,0,0,0,0
1,0,5,0,0,0,0,2,1,17,2,2,1,7,0,0,1037786,2023-11-20T00:00:00.000Z,666468,2,Oshae Brissett,0,8,9,2,8,10.9
3,0,4,8,5,14,8,0,0,33,2,1,21,6,2,0,1037786,2023-11-20T00:00:00.000Z,3547276,2,Payton Pritchard,2,27,30,24,9,38.7
1,0,1,9,1,9,1,0,0,38,0,3,3,1,0,1,1037786,2023-11-20T00:00:00.000Z,17896060,2,Sam Hauser,0,4,5,4,2,4.7
0,0,0,2,1,2,1,0,0,9,0,0,3,0,1,0,1037786,2023-11-20T00:00:00.000Z,338,2,Svi Mykhailiuk,1,3,3,3,0,6
0,0,0,0,0,0,0,0,0,0,0,0,0,0,0,0,1037786,2023-11-20T00:00:00.000Z,56677848,4,Amari Bailey,0,0,0,0,0,0
4,1,3,4,1,12,4,0,0,40,4,2,9,7,2,2,1037786,2023-11-20T00:00:00.000Z,56677823,4,Brandon Miller,3,16,20,13,11,30.4
2,0,2,6,1,6,1,0,0,14,0,1,3,2,0,1,1037786,2023-11-20T00:00:00.000Z,38017708,4,Bryce McGowens,0,5,7,5,4,7.4
0,0,0,0,0,0,0,0,0,0,0,0,0,0,0,0,1037786,2023-11-20T00:00:00.000Z,666748,4,Cody Martin,0,0,0,0,0,0
0,0,0,0,0,0,0,0,0,0,0,0,0,0,0,0,1037786,2023-11-20T00:00:00.000Z,347,4,Frank Ntilikina,0,0,0,0,0,0
4,1,2,2,1,15,6,8,7,39,3,3,20,5,1,2,1037786,2023-11-20T00:00:00.000Z,204,4,Gordon Hayward,2,25,29,24,9,36
0,0,0,0,0,0,0,0,0,0,0,0,0,0,0,0,1037786,2023-11-20T00:00:00.000Z,17896037,4,James Bouknight,0,0,0,0,0,0
0,0,0,0,0,0,0,0,0,5,0,1,0,0,0,0,1037786,2023-11-20T00:00:00.000Z,18678001,4,JT Thor,0,0,0,0,0,0
8,1,7,11,5,27,15,1,1,41,2,5,36,9,2,5,1037786,2023-11-20T00:00:00.000Z,3547239,4,LaMelo Ball,3,45,53,44,17,62.8
0,0,0,0,0,0,0,0,0,0,0,0,0,0,0,0,1037786,2023-11-20T00:00:00.000Z,56677866,4,Leaky Black,0,0,0,0,0,0
2,3,8,0,0,14,8,2,2,33,8,4,18,16,1,1,1037786,2023-11-20T00:00:00.000Z,38017698,4,Mark Williams,4,34,36,20,18,51.2
5,0,15,7,2,13,3,6,6,45,0,1,14,15,1,1,1037786,2023-11-20T00:00:00.000Z,62,4,Miles Bridges,1,29,34,19,20,41.5
0,0,0,0,0,0,0,0,0,0,0,0,0,0,0,0,1037786,2023-11-20T00:00:00.000Z,3547282,4,Nick Richards,0,0,0,0,0,0
0,0,0,0,0,0,0,0,0,0,0,0,0,0,0,0,1037786,2023-11-20T00:00:00.000Z,56677846,4,Nick Smith Jr.,0,0,0,0,0,0
0,0,0,0,0,0,0,0,0,0,0,0,0,0,0,0,1037786,2023-11-20T00:00:00.000Z,403,4,Terry Rozier,0,0,0,0,0,0
7,0,4,1,0,10,4,4,3,37,4,1,11,8,1,2,1037787,2023-11-20T00:00:00.000Z,177,8,Aaron Gordon,1,19,26,18,15,32.1
2,1,5,2,2,10,5,4,3,32,1,2,15,6,1,2,1037787,2023-11-20T00:00:00.000Z,38017709,8,Christian Braun,2,21,23,17,8,29.2
0,0,0,0,0,0,0,0,0,0,0,0,0,0,0,0,1037787,2023-11-20T00:00:00.000Z,38017727,8,Collin Gillespie,0,0,0,0,0,0
0,0,0,0,0,0,0,0,0,0,0,0,0,0,0,0,1037787,2023-11-20T00:00:00.000Z,250,8,DeAndre Jordan,0,0,0,0,0,0
0,0,0,0,0,0,0,0,0,0,0,0,0,0,0,0,1037787,2023-11-20T00:00:00.000Z,56677871,8,Hunter Tyson,0,0,0,0,0,0
0,0,0,0,0,0,0,0,0,0,0,0,0,0,0,0,1037787,2023-11-20T00:00:00.000Z,335,8,Jamal Murray,0,0,0,0,0,0
0,0,0,0,0,0,0,0,0,0,0,0,0,0,0,0,1037787,2023-11-20T00:00:00.000Z,17896103,8,Jay Huff,0,0,0,0,0,0
0,0,0,0,0,0,0,0,0,0,0,0,0,0,0,0,1037787,2023-11-20T00:00:00.000Z,215,8,Justin Holiday,0,0,0,0,0,0
3,2,2,5,2,17,8,2,2,36,1,2,20,3,2,3,1037787,2023-11-20T00:00:00.000Z,81,8,Kentavious Caldwell-Pope,4,23,26,23,6,37.1
2,1,9,9,4,15,5,1,0,38,2,3,14,11,0,4,1037787,2023-11-20T00:00:00.000Z,375,8,Michael Porter Jr.,1,25,27,16,13,29.2
5,1,5,4,1,8,4,0,0,15,0,1,9,5,0,1,1037787,2023-11-20T00:00:00.000Z,246,8,Nikola Jokic,1,14,19,14,10,24.5
2,2,1,0,0,2,1,2,2,14,0,1,4,1,0,1,1037787,2023-11-20T00:00:00.000Z,38017721,8,Peyton Watson,2,5,7,6,3,13.2
6,1,3,3,1,15,9,3,2,32,0,2,21,3,1,0,1037787,2023-11-20T00:00:00.000Z,236,8,Reggie Jackson,2,24,30,27,9,39.6
0,0,0,0,0,0,0,0,0,0,0,0,0,0,0,0,1037787,2023-11-20T00:00:00.000Z,666489,8,Vlatko Cancar,0,0,0,0,0,0
2,0,3,4,0,5,1,2,1,17,0,1,3,3,1,1,1037787,2023-11-20T00:00:00.000Z,77,9,Alec Burks,1,6,8,5,5,11.6
0,2,4,0,0,10,4,0,0,24,3,5,8,7,0,0,1037787,2023-11-20T00:00:00.000Z,56677826,9,Ausar Thompson,2,15,15,8,7,22.4
0,0,0,0,0,0,0,0,0,0,0,0,0,0,0,0,1037787,2023-11-20T00:00:00.000Z,54,9,Bojan Bogdanovic,0,0,0,0,0,0
9,1,3,4,2,17,7,11,11,38,0,2,27,3,3,5,1037787,2023-11-20T00:00:00.000Z,17896075,9,Cade Cunningham,4,30,39,36,12,51.1
1,0,2,3,0,7,1,4,4,23,2,2,6,4,0,2,1037787,2023-11-20T00:00:00.000Z,17896071,9,Isaiah Livers,0,10,11,7,5,10.3
1,2,10,2,1,8,4,2,2,35,1,3,11,11,0,1,1037787,2023-11-20T00:00:00.000Z,3547267,9,Isaiah Stewart,2,22,23,12,12,30.7
3,0,2,1,1,8,7,2,2,30,1,2,17,3,1,4,1037787,2023-11-20T00:00:00.000Z,38017682,9,Jaden Ivey,1,20,23,20,6,24.1
0,0,0,0,0,0,0,0,0,0,0,0,0,0,0,0,1037787,2023-11-20T00:00:00.000Z,38017694,9,Jalen Duren,0,0,0,0,0,0
0,0,2,0,0,1,0,0,0,10,1,2,0,3,0,1,1037787,2023-11-20T00:00:00.000Z,3547240,9,James Wiseman,0,3,3,0,3,2.6
0,0,0,0,0,0,0,0,0,0,0,0,0,0,0,0,1037787,2023-11-20T00:00:00.000Z,42097199,9,Jared Rhoden,0,0,0,0,0,0
0,0,0,0,0,0,0,0,0,0,0,0,0,0,0,0,1037787,2023-11-20T00:00:00.000Z,197,9,Joe Harris,0,0,0,0,0,0
0,0,0,0,0,0,0,0,0,0,0,0,0,0,0,0,1037787,2023-11-20T00:00:00.000Z,259,9,Kevin Knox,0,0,0,0,0,0
2,0,0,1,0,2,0,0,0,14,0,2,0,0,2,2,1037787,2023-11-20T00:00:00.000Z,3547241,9,Killian Hayes,2,0,2,2,2,7
0,0,0,0,0,0,0,0,0,0,0,0,0,0,0,0,1037787,2023-11-20T00:00:00.000Z,56677729,9,Malcolm Cazalon,0,0,0,0,0,0
0,0,0,1,0,2,1,0,0,5,0,0,2,0,0,0,1037787,2023-11-20T00:00:00.000Z,56677792,9,Marcus Sasser,0,2,2,2,0,2
1,0,5,0,0,13,7,5,4,26,3,4,18,8,0,1,1037787,2023-11-20T00:00:00.000Z,24,9,Marvin Bagley III,0,26,27,19,9,28.1
0,0,0,0,0,0,0,0,0,0,0,0,0,0,0,0,1037787,2023-11-20T00:00:00.000Z,330,9,Monte Morris,0,0,0,0,0,0
2,0,1,5,3,8,4,0,0,18,0,1,11,1,0,1,1037787,2023-11-20T00:00:00.000Z,44477024,9,Stanley Umude,0,12,14,13,3,14.2
1,0,2,3,0,4,1,0,0,15,0,1,2,2,0,0,1037788,2023-11-20T00:00:00.000Z,38017733,17,A.J. Green,0,4,5,3,3,5.9
0,0,0,0,0,0,0,0,0,1,1,0,0,1,0,0,1037788,2023-11-20T00:00:00.000Z,56677852,17,Andre Jackson Jr.,0,1,1,0,1,1.2
2,0,2,4,2,5,2,0,0,17,0,1,6,2,1,1,1037788,2023-11-20T00:00:00.000Z,368,17,Cameron Payne,1,8,10,8,4,13.4
0,0,0,0,0,0,0,0,0,0,0,0,0,0,0,0,1037788,2023-11-20T00:00:00.000Z,38017676,17,MarJon Beauchamp,0,0,0,0,0,0
4,0,3,2,1,2,1,0,0,27,1,1,3,4,0,0,1037788,2023-11-20T00:00:00.000Z,105,17,Pat Connaughton,0,7,11,7,8,13.8
0,0,0,0,0,0,0,0,0,1,0,2,0,0,0,0,1037788,2023-11-20T00:00:00.000Z,284,17,Robin Lopez,0,0,0,0,0,0
0,0,0,0,0,0,0,0,0,1,0,0,0,0,0,0,1037788,2023-11-20T00:00:00.000Z,2148,17,Thanasis Antetokounmpo,0,0,0,0,0,0
2,2,4,0,0,14,7,0,0,29,2,3,14,6,0,0,1037788,2023-11-20T00:00:00.000Z,666577,30,Daniel Gafford,2,20,22,16,8,30.2
2,1,3,1,0,5,3,2,1,32,1,3,7,4,0,0,1037788,2023-11-20T00:00:00.000Z,3547242,30,Deni Avdija,1,11,13,9,6,17.8
0,0,0,0,0,0,0,0,0,1,0,0,0,0,0,0,1037788,2023-11-20T00:00:00.000Z,18677954,30,Jared Butler,0,0,0,0,0,0
0,0,0,0,0,0,0,0,0,0,0,0,0,0,0,0,1037788,2023-11-20T00:00:00.000Z,38124126,30,John Butler Jr.,0,0,0,0,0,0
1,0,1,9,3,26,11,5,5,33,0,4,30,1,0,0,1037788,2023-11-20T00:00:00.000Z,666848,30,Jordan Poole,0,31,32,31,2,32.7
13,1,3,5,2,15,10,0,0,31,0,2,22,3,2,2,1037788,2023-11-20T00:00:00.000Z,265,30,Kyle Kuzma,3,25,38,35,16,52.1
0,0,0,0,0,0,0,0,0,0,0,0,0,0,0,0,1037788,2023-11-20T00:00:00.000Z,38017704,30,Patrick Baldwin Jr.,0,0,0,0,0,0
3,0,2,1,0,13,9,0,0,26,0,0,18,2,0,0,1037788,2023-11-20T00:00:00.000Z,249,30,Tyus Jones,0,20,23,21,5,24.9
0,0,0,0,0,0,0,0,0,0,0,0,0,0,0,0,1037789,2023-11-20T00:00:00.000Z,56677860,5,Adama Sanogo,0,0,0,0,0,0
3,1,2,4,2,10,4,4,3,27,2,1,13,4,1,2,1037789,2023-11-20T00:00:00.000Z,89,5,Alex Caruso,2,17,20,16,7,26.3
3,1,5,8,4,11,7,2,2,34,1,2,20,6,1,2,1037789,2023-11-20T00:00:00.000Z,666956,5,Coby White,2,26,29,23,9,35.7
5,1,4,4,2,10,6,1,1,34,0,1,15,4,0,0,1037789,2023-11-20T00:00:00.000Z,125,5,DeMar DeRozan,1,19,24,20,9,30.3
1,1,0,4,0,5,0,0,0,14,0,2,0,0,0,1,1037789,2023-11-20T00:00:00.000Z,87,5,Jevon Carter,1,0,1,1,1,3.5
2,0,5,4,0,16,7,4,4,32,2,4,18,7,0,2,1037789,2023-11-20T00:00:00.000Z,460,5,Nikola Vucevic,0,25,27,20,9,27.4
0,0,1,3,0,5,1,0,0,16,0,1,2,1,0,0,1037789,2023-11-20T00:00:00.000Z,110,5,Torrey Craig,0,3,3,2,1,3.2
5,0,3,6,2,9,5,1,1,35,0,1,13,3,0,1,1037789,2023-11-20T00:00:00.000Z,268,5,Zach LaVine,0,16,21,18,8,23.1
6,0,8,0,0,14,8,9,7,30,3,3,23,11,1,1,1037789,2023-11-20T00:00:00.000Z,4,16,Bam Adebayo,1,34,40,29,17,47.2
2,0,5,3,0,6,1,0,0,21,0,1,2,5,0,0,1037789,2023-11-20T00:00:00.000Z,666747,16,Caleb Martin,0,7,9,4,7,11
0,0,0,0,0,0,0,0,0,0,0,0,0,0,0,0,1037789,2023-11-20T00:00:00.000Z,38017736,16,Cole Swider,0,0,0,0,0,0
0,0,1,1,0,1,0,0,0,3,0,0,0,1,1,0,1037789,2023-11-20T00:00:00.000Z,19465585,16,Dru Smith,1,1,1,0,1,4.2
2,0,2,9,6,11,7,2,2,30,0,3,22,2,0,0,1037789,2023-11-20T00:00:00.000Z,397,16,Duncan Robinson,0,24,26,24,4,27.4
3,0,1,1,1,4,3,0,0,20,1,3,7,2,1,1,1037789,2023-11-20T00:00:00.000Z,3092,16,Haywood Highsmith,1,9,12,10,5,15.9
4,0,1,4,3,13,8,0,0,33,2,1,19,3,2,0,1037789,2023-11-20T00:00:00.000Z,56677785,16,Jaime Jaquez Jr.,2,22,26,23,7,34.6
0,0,0,0,0,0,0,0,0,0,0,0,0,0,0,0,1037789,2023-11-20T00:00:00.000Z,38017734,16,Jamal Cain,0,0,0,0,0,0
6,0,3,2,0,11,4,9,8,29,0,2,16,3,1,1,1037789,2023-11-20T00:00:00.000Z,79,16,Jimmy Butler,1,19,25,22,9,30.6
1,1,2,6,2,12,4,0,0,30,2,2,10,4,0,3,1037789,2023-11-20T00:00:00.000Z,391,16,Josh Richardson,1,14,15,11,5,16.3
1,0,8,5,3,6,4,0,0,15,0,2,11,8,0,1,1037789,2023-11-20T00:00:00.000Z,285,16,Kevin Love,0,19,20,12,9,21.1
6,0,4,4,2,6,3,0,0,27,1,1,8,5,0,1,1037789,2023-11-20T00:00:00.000Z,286,16,Kyle Lowry,0,13,19,14,11,22
0,0,0,0,0,0,0,0,0,0,0,0,0,0,0,0,1037789,2023-11-20T00:00:00.000Z,38017696,16,Nikola Jovic,0,0,0,0,0,0
0,0,0,0,0,0,0,0,0,2,0,1,0,0,0,0,1037789,2023-11-20T00:00:00.000Z,39398582,16,Orlando Robinson,0,0,0,0,0,0
0,0,0,0,0,0,0,0,0,0,0,0,0,0,0,0,1037789,2023-11-20T00:00:00.000Z,3547257,16,R.J. Hampton,0,0,0,0,0,0
0,0,0,0,0,0,0,0,0,0,0,0,0,0,0,0,1037789,2023-11-20T00:00:00.000Z,74,16,Thomas Bryant,0,0,0,0,0,0
0,0,0,0,0,0,0,0,0,0,0,0,0,0,0,0,1037789,2023-11-20T00:00:00.000Z,666633,16,Tyler Herro,0,0,0,0,0,0
5,0,8,6,1,21,9,4,4,39,2,1,23,10,2,3,1037790,2023-11-20T00:00:00.000Z,3547238,18,Anthony Edwards,2,33,38,28,15,45.5
0,0,1,0,0,2,2,0,0,5,0,0,4,1,0,1,1037790,2023-11-20T00:00:00.000Z,3547259,18,Jaden McDaniels,0,5,5,4,1,4.2
0,0,0,0,0,0,0,0,0,0,0,0,0,0,0,0,1037790,2023-11-20T00:00:00.000Z,666767,18,Jordan McLaughlin,0,0,0,0,0,0
4,2,5,3,2,10,6,7,6,36,0,6,20,5,3,3,1037790,2023-11-20T00:00:00.000Z,447,18,Karl-Anthony Towns,5,25,29,24,9,44
5,2,2,0,0,4,3,5,3,23,0,2,9,2,1,1,1037790,2023-11-20T00:00:00.000Z,12,18,Kyle Anderson,3,11,16,14,7,26.9
5,1,1,8,3,9,3,2,2,28,0,3,11,1,0,0,1037790,2023-11-20T00:00:00.000Z,104,18,Mike Conley,1,12,17,16,6,22.7
1,0,3,6,1,8,3,3,3,18,0,6,10,3,1,3,1037790,2023-11-20T00:00:00.000Z,667378,18,Naz Reid,1,13,14,11,4,15.1
3,0,2,6,3,8,4,0,0,33,1,2,11,3,0,0,1037790,2023-11-20T00:00:00.000Z,666400,18,Nickeil Alexander-Walker,0,14,17,14,6,19.1
1,2,4,0,0,7,7,7,2,26,3,2,16,7,0,1,1037790,2023-11-20T00:00:00.000Z,176,18,Rudy Gobert,2,23,24,17,8,30.9
0,0,1,1,0,3,0,2,0,3,0,0,0,1,0,0,1037790,2023-11-20T00:00:00.000Z,666675,20,DaQuan Jeffries,0,1,1,0,1,1.2
5,0,1,6,1,8,2,2,2,26,2,3,7,3,1,0,1037790,2023-11-20T00:00:00.000Z,131,20,Donte DiVincenzo,1,10,15,12,8,21.1
0,0,1,7,1,14,4,6,6,17,0,3,15,1,0,0,1037790,2023-11-20T00:00:00.000Z,3547269,20,Immanuel Quickley,0,16,16,15,1,16.2
0,1,2,0,0,3,1,0,0,14,3,3,2,5,0,1,1037790,2023-11-20T00:00:00.000Z,201,20,Isaiah Hartenstein,1,7,7,2,5,10
6,0,4,6,3,15,7,8,8,36,0,2,25,4,0,1,1037790,2023-11-20T00:00:00.000Z,73,20,Jalen Brunson,0,29,35,31,10,37.8
1,0,1,2,0,6,2,0,0,24,0,0,4,1,2,0,1037790,2023-11-20T00:00:00.000Z,202,20,Josh Hart,2,5,6,5,2,12.7
2,0,1,6,0,6,0,0,0,25,0,2,0,1,2,0,1037790,2023-11-20T00:00:00.000Z,17895858,20,Quentin Grimes,2,1,3,2,3,10.2
1,0,5,4,3,13,4,4,3,22,2,5,14,7,1,4,1037790,2023-11-20T00:00:00.000Z,666423,20,RJ Barrett,1,21,22,15,8,22.9
3,0,4,5,5,18,11,4,4,26,0,0,31,4,0,1,1037791,2023-11-20T00:00:00.000Z,227,19,Brandon Ingram,0,35,38,34,7,39.3
0,0,0,0,0,0,0,0,0,0,0,0,0,0,0,0,1037791,2023-11-20T00:00:00.000Z,303,19,CJ McCollum,0,0,0,0,0,0
5,0,2,4,1,4,1,0,0,25,0,2,3,2,1,0,1037791,2023-11-20T00:00:00.000Z,38017677,19,Dyson Daniels,1,5,10,8,7,15.9
0,0,0,0,0,0,0,0,0,0,0,0,0,0,0,0,1037791,2023-11-20T00:00:00.000Z,38017663,19,E.J. Liddell,0,0,0,0,0,0
4,2,6,2,1,9,7,4,3,27,1,4,18,7,1,1,1037791,2023-11-20T00:00:00.000Z,17896024,19,Herbert Jones,3,25,29,22,11,40.4
7,3,12,0,0,4,3,4,4,21,1,3,10,13,1,0,1037791,2023-11-20T00:00:00.000Z,455,19,Jonas Valanciunas,4,23,30,17,20,48.1
2,0,4,5,2,11,3,1,1,29,1,2,9,5,0,1,1037791,2023-11-20T00:00:00.000Z,56677837,19,Jordan Hawkins,0,14,16,11,7,17
3,0,0,3,1,5,2,0,0,15,0,0,5,0,0,2,1037791,2023-11-20T00:00:00.000Z,17896097,19,Jose Alvarado,0,5,8,8,3,7.5
2,0,0,2,1,3,1,0,0,6,0,1,3,0,1,0,1037791,2023-11-20T00:00:00.000Z,3547260,19,Kira Lewis Jr.,1,3,5,5,2,9
0,0,0,0,0,0,0,0,0,0,0,0,0,0,0,0,1037791,2023-11-20T00:00:00.000Z,340,19,Larry Nance Jr.,0,0,0,0,0,0
0,0,0,0,0,0,0,0,0,0,0,0,0,0,0,0,1037791,2023-11-20T00:00:00.000Z,18677986,19,Trey Murphy III,0,0,0,0,0,0
5,1,3,0,0,16,12,2,2,30,0,2,26,3,3,1,1037791,2023-11-20T00:00:00.000Z,666969,19,Zion Williamson,4,29,34,31,8,48.1
0,0,2,2,0,2,0,0,0,8,0,1,0,2,0,0,1037791,2023-11-20T00:00:00.000Z,17896030,26,Chris Duarte,0,2,2,0,2,2.4
8,0,0,2,0,2,0,2,2,19,0,1,2,0,0,1,1037791,2023-11-20T00:00:00.000Z,17553994,26,Davion Mitchell,0,2,10,10,8,13
0,0,2,12,2,18,5,4,2,29,0,1,14,2,1,2,1037791,2023-11-20T00:00:00.000Z,161,26,De'Aaron Fox,1,16,16,14,2,17.4
8,0,5,0,0,8,4,3,2,31,5,4,10,10,0,5,1037791,2023-11-20T00:00:00.000Z,406,26,Domantas Sabonis,0,20,28,18,18,29
0,0,4,6,3,9,4,6,5,30,0,0,16,4,1,0,1037791,2023-11-20T00:00:00.000Z,30,26,Harrison Barnes,1,20,20,16,4,23.8
0,1,1,2,1,4,1,2,2,16,2,2,5,3,1,0,1037791,2023-11-20T00:00:00.000Z,38017688,26,Keegan Murray,2,8,8,5,3,14.6
3,0,0,8,2,10,4,0,0,23,0,1,10,0,0,0,1037791,2023-11-20T00:00:00.000Z,221,26,Kevin Huerter,0,10,13,13,3,14.5
5,0,0,6,2,11,3,0,0,24,0,2,8,0,0,1,1037791,2023-11-20T00:00:00.000Z,324,26,Malik Monk,0,8,13,13,5,14.5
0,0,0,0,0,1,0,0,0,4,0,0,0,0,0,0,1037792,2023-11-20T00:00:00.000Z,666511,13,Amir Coffey,0,0,0,0,0,0
0,0,0,0,0,0,0,0,0,0,0,0,0,0,0,0,1037792,2023-11-20T00:00:00.000Z,17896022,13,Brandon Boston Jr.,0,0,0,0,0,0
2,0,4,1,1,10,8,2,2,22,3,4,19,7,1,1,1037792,2023-11-20T00:00:00.000Z,439,13,Daniel Theis,1,26,28,21,9,32.4
0,1,9,0,0,5,3,2,2,22,2,0,8,11,0,1,1037792,2023-11-20T00:00:00.000Z,493,13,Ivica Zubac,1,19,19,8,11,23.2
10,0,2,8,2,12,4,3,3,28,1,2,13,3,2,0,1037792,2023-11-20T00:00:00.000Z,192,13,James Harden,2,16,26,23,13,37.6
0,0,0,0,0,0,0,0,0,0,0,0,0,0,0,0,1037792,2023-11-20T00:00:00.000Z,56677856,13,Jordan Miller,0,0,0,0,0,0
0,0,0,0,0,0,0,0,0,0,0,0,0,0,0,0,1037792,2023-11-20T00:00:00.000Z,17896051,13,Joshua Primo,0,0,0,0,0,0
3,0,2,6,2,17,8,3,3,28,2,0,21,4,1,0,1037792,2023-11-20T00:00:00.000Z,274,13,Kawhi Leonard,1,25,28,24,7,33.3
0,0,0,0,0,0,0,0,0,0,0,0,0,0,0,0,1037792,2023-11-20T00:00:00.000Z,56677849,13,Kobe Brown,0,0,0,0,0,0
0,0,0,0,0,0,0,0,0,0,0,0,0,0,0,0,1037792,2023-11-20T00:00:00.000Z,371,13,Mason Plumlee,0,0,0,0,0,0
0,0,0,0,0,2,1,2,1,4,2,0,3,2,2,0,1037792,2023-11-20T00:00:00.000Z,38017725,13,Moussa Diabate,2,5,5,3,2,11.4
1,0,1,2,1,3,1,0,0,4,0,0,3,1,0,1,1037792,2023-11-20T00:00:00.000Z,17896031,13,Nah'Shon Hyland,0,4,5,4,2,4.7
0,1,5,6,2,12,5,7,7,30,0,0,19,5,2,1,1037792,2023-11-20T00:00:00.000Z,380,13,Norman Powell,3,24,24,19,5,33
6,0,5,8,4,16,11,2,2,32,0,1,28,5,1,2,1037792,2023-11-20T00:00:00.000Z,172,13,Paul George,1,33,39,34,11,44
0,0,5,0,0,0,0,0,0,16,0,2,0,5,0,0,1037792,2023-11-20T00:00:00.000Z,450,13,PJ Tucker,0,5,5,0,5,6
2,0,6,4,0,6,0,0,0,25,0,0,0,6,3,1,1037792,2023-11-20T00:00:00.000Z,666743,13,Terance Mann,3,6,8,2,8,18.2
0,0,0,0,0,0,0,0,0,0,0,0,0,0,0,0,1037792,2023-11-20T00:00:00.000Z,24417679,13,Xavier Moon,0,0,0,0,0,0
0,0,0,0,0,0,0,0,0,0,0,0,0,0,0,0,1037792,2023-11-20T00:00:00.000Z,38017693,27,Blake Wesley,0,0,0,0,0,0
1,0,3,3,2,9,7,1,1,22,1,4,17,4,0,0,1037792,2023-11-20T00:00:00.000Z,359,27,Cedi Osman,0,21,22,18,5,23.3
0,0,0,0,0,0,0,0,0,0,0,0,0,0,0,0,1037792,2023-11-20T00:00:00.000Z,56677865,27,Charles Bediako,0,0,0,0,0,0
0,0,0,0,0,0,0,0,0,0,0,0,0,0,0,0,1037792,2023-11-20T00:00:00.000Z,3547246,27,Devin Vassell,0,0,0,0,0,0
2,0,2,3,1,3,1,0,0,14,0,1,3,2,0,0,1037792,2023-11-20T00:00:00.000Z,305,27,Doug McDermott,0,5,7,5,4,8.4
1,0,6,3,0,12,3,2,2,29,2,1,8,8,0,1,1037792,2023-11-20T00:00:00.000Z,38017699,27,Jeremy Sochan,0,16,17,9,9,18.1
1,1,3,5,1,7,2,0,0,23,1,2,5,4,1,1,1037792,2023-11-20T00:00:00.000Z,38017649,27,Julian Champagnie,2,9,10,6,5,16.3
5,0,8,8,2,16,9,4,2,32,2,2,22,10,1,1,1037792,2023-11-20T00:00:00.000Z,666682,27,Keldon Johnson,1,32,37,27,15,43.5
0,0,0,0,0,0,0,0,0,0,0,0,0,0,0,0,1037792,2023-11-20T00:00:00.000Z,56677870,27,Sir'Jabari Rice,0,0,0,0,0,0
4,2,3,4,0,12,4,1,1,26,0,1,9,3,0,2,1037792,2023-11-20T00:00:00.000Z,56677822,27,Victor Wembanyama,2,12,16,13,7,22.6
0,0,3,5,1,11,4,4,3,28,0,1,12,3,2,2,1037792,2023-11-20T00:00:00.000Z,102,27,Zach Collins,2,15,15,12,3,19.6
0,0,0,0,0,0,0,0,0,4,0,0,0,0,0,0,1037793,2023-11-20T00:00:00.000Z,56677799,10,Trayce Jackson-Davis,0,0,0,0,0,0
0,0,0,0,0,0,0,0,0,0,0,0,0,0,0,0,1037793,2023-11-20T00:00:00.000Z,47738533,11,Jeenathan Williams,0,0,0,0,0,0
0,0,0,0,0,0,0,0,0,2,0,0,0,0,0,0,3277479,2023-11-21T00:00:00.000Z,666885,22,Admiral Schofield,0,0,0,0,0,0
1,0,3,3,0,7,2,2,1,23,2,3,5,5,1,0,3277479,2023-11-21T00:00:00.000Z,56677827,22,Anthony Black,1,10,11,6,6,15.5
1,0,1,1,0,1,0,0,0,4,0,0,0,1,1,0,3277479,2023-11-21T00:00:00.000Z,38017724,22,Caleb Houstan,1,1,2,1,2,5.7
0,0,0,3,2,3,2,0,0,4,0,0,6,0,0,0,3277479,2023-11-21T00:00:00.000Z,666818,22,Chuma Okeke,0,6,6,6,0,6
10,0,3,4,2,10,5,3,3,29,2,3,15,5,0,2,3277479,2023-11-21T00:00:00.000Z,3547251,22,Cole Anthony,0,20,30,25,15,34
2,0,2,4,1,18,8,1,0,31,2,2,17,4,3,0,3277479,2023-11-21T00:00:00.000Z,17896026,22,Franz Wagner,3,21,23,19,6,33.8
1,0,1,5,2,7,4,0,0,23,0,3,10,1,1,0,3277479,2023-11-21T00:00:00.000Z,196,22,Gary Harris,1,11,12,11,2,15.7
6,5,4,0,0,6,2,4,1,31,3,1,5,7,2,1,3277479,2023-11-21T00:00:00.000Z,666442,22,Goga Bitadze,7,12,18,11,13,42.4
4,0,2,4,2,10,6,4,4,21,1,3,18,3,2,2,3277479,2023-11-21T00:00:00.000Z,17896073,22,Jalen Suggs,2,21,25,22,7,31.6
0,0,0,0,0,0,0,0,0,0,0,0,0,0,0,0,3277479,2023-11-21T00:00:00.000Z,56677839,22,Jett Howard,0,0,0,0,0,0
1,0,1,2,1,3,2,1,1,13,1,2,6,2,0,1,3277479,2023-11-21T00:00:00.000Z,226,22,Joe Ingles,0,8,9,7,3,8.9
0,2,2,2,0,6,4,2,1,12,1,0,9,3,1,2,3277479,2023-11-21T00:00:00.000Z,229,22,Jonathan Isaac,3,12,12,9,3,19.6
0,0,0,0,0,0,0,0,0,0,0,0,0,0,0,0,3277479,2023-11-21T00:00:00.000Z,38017607,22,Kevon Harris,0,0,0,0,0,0
0,0,0,0,0,0,0,0,0,0,0,0,0,0,0,0,3277479,2023-11-21T00:00:00.000Z,165,22,Markelle Fultz,0,0,0,0,0,0
2,0,2,0,0,9,5,0,0,15,2,0,10,4,1,1,3277479,2023-11-21T00:00:00.000Z,462,22,Moritz Wagner,1,14,16,12,6,19.8
3,1,4,3,2,20,10,3,3,32,1,2,25,5,0,3,3277479,2023-11-21T00:00:00.000Z,38017683,22,Paolo Banchero,1,30,33,28,8,35.5
0,0,0,0,0,0,0,0,0,0,0,0,0,0,0,0,3277479,2023-11-21T00:00:00.000Z,17553983,22,Trevelin Queen,0,0,0,0,0,0
0,0,0,0,0,0,0,0,0,0,0,0,0,0,0,0,3277479,2023-11-21T00:00:00.000Z,85,22,Wendell Carter Jr.,0,0,0,0,0,0
0,1,2,3,1,4,1,0,0,18,0,3,3,2,0,0,3277479,2023-11-21T00:00:00.000Z,58,28,Chris Boucher,1,5,5,3,2,8.4
0,0,0,0,0,0,0,0,0,0,0,0,0,0,0,0,3277479,2023-11-21T00:00:00.000Z,38017710,28,Christian Koloko,0,0,0,0,0,0
1,0,1,4,4,13,8,4,4,27,0,2,24,1,0,2,3277479,2023-11-21T00:00:00.000Z,409,28,Dennis Schroder,0,25,26,25,2,24.7
2,0,0,0,0,1,1,0,0,4,0,0,2,0,0,0,3277479,2023-11-21T00:00:00.000Z,436,28,Garrett Temple,0,2,4,4,2,5
1,0,0,2,1,6,1,0,0,21,0,1,3,0,0,0,3277479,2023-11-21T00:00:00.000Z,3089,28,Gary Trent Jr.,0,3,4,4,1,4.5
2,0,2,3,1,4,1,0,0,12,0,0,3,2,0,0,3277479,2023-11-21T00:00:00.000Z,56677828,28,Gradey Dick,0,5,7,5,4,8.4
1,1,9,0,0,7,5,0,0,23,1,6,10,10,0,4,3277479,2023-11-21T00:00:00.000Z,373,28,Jakob Poeltl,1,20,21,11,11,22.5
1,0,0,1,1,1,1,2,2,7,1,1,5,1,0,1,3277479,2023-11-21T00:00:00.000Z,666762,28,Jalen McDaniels,0,6,7,6,2,6.7
0,0,0,0,0,0,0,0,0,0,0,0,0,0,0,0,3277479,2023-11-21T00:00:00.000Z,56677805,28,Javon Freeman-Liberty,0,0,0,0,0,0
1,1,3,2,1,4,2,2,1,19,0,1,6,3,1,1,3277479,2023-11-21T00:00:00.000Z,3547275,28,Malachi Flynn,2,9,10,7,4,16.1
0,0,0,0,0,0,0,0,0,0,0,0,0,0,0,0,3277479,2023-11-21T00:00:00.000Z,56677869,28,Markquis Nowell,0,0,0,0,0,0
4,3,1,5,3,8,4,0,0,30,0,0,11,1,0,4,3277479,2023-11-21T00:00:00.000Z,18,28,OG Anunoby,3,12,16,15,5,23.2
0,0,1,1,1,2,2,0,0,4,1,1,5,2,0,1,3277479,2023-11-21T00:00:00.000Z,376,28,Otto Porter Jr.,0,7,7,5,2,6.4
8,0,2,2,0,10,5,8,6,30,0,1,16,2,1,2,3277479,2023-11-21T00:00:00.000Z,416,28,Pascal Siakam,1,18,26,24,10,31.4
4,0,4,1,0,4,2,2,1,15,2,3,5,6,1,3,3277479,2023-11-21T00:00:00.000Z,3547249,28,Precious Achiuwa,1,11,15,9,10,18.2
0,0,0,0,0,0,0,0,0,0,0,0,0,0,0,0,3277479,2023-11-21T00:00:00.000Z,38017717,28,Ron Harper Jr.,0,0,0,0,0,0
4,0,8,4,1,11,5,4,3,30,0,1,14,8,3,5,3277479,2023-11-21T00:00:00.000Z,17896055,28,Scottie Barnes,3,22,26,18,12,33.6
0,0,0,0,0,0,0,0,0,0,0,0,0,0,0,0,3277479,2023-11-21T00:00:00.000Z,489,28,Thaddeus Young,0,0,0,0,0,0
0,0,0,0,0,0,0,0,0,0,0,0,0,0,0,0,3277480,2023-11-21T00:00:00.000Z,38017689,1,AJ Griffin,0,0,0,0,0,0
0,0,2,5,2,15,10,4,4,26,0,4,26,2,0,0,3277480,2023-11-21T00:00:00.000Z,53,1,Bogdan Bogdanovic,0,28,28,26,2,28.4
0,0,0,0,0,0,0,0,0,0,0,0,0,0,0,0,3277480,2023-11-21T00:00:00.000Z,666564,1,Bruno Fernando,0,0,0,0,0,0
1,2,2,0,0,9,6,3,2,19,3,4,14,5,0,1,3277480,2023-11-21T00:00:00.000Z,83,1,Clint Capela,2,19,20,15,6,26.5
1,0,2,2,1,7,3,0,0,27,2,2,7,4,1,3,3277480,2023-11-21T00:00:00.000Z,666656,1,De'Andre Hunter,1,11,12,8,5,13.3
5,0,2,6,4,20,11,2,2,34,1,3,28,3,2,5,3277480,2023-11-21T00:00:00.000Z,334,1,Dejounte Murray,2,31,36,33,8,40.1
0,0,0,0,0,0,0,0,0,0,0,0,0,0,0,0,3277480,2023-11-21T00:00:00.000Z,666754,1,Garrison Mathews,0,0,0,0,0,0
6,1,6,2,0,12,6,5,5,33,1,2,17,7,2,1,3277480,2023-11-21T00:00:00.000Z,17896040,1,Jalen Johnson,3,24,30,23,13,42.4
0,0,0,0,0,0,0,0,0,0,0,0,0,0,0,0,3277480,2023-11-21T00:00:00.000Z,56677838,1,Kobe Bufkin,0,0,0,0,0,0
0,0,0,0,0,0,0,0,0,0,0,0,0,0,0,0,3277480,2023-11-21T00:00:00.000Z,56677875,1,Miles Norris,0,0,0,0,0,0
0,0,0,0,0,0,0,0,0,0,0,0,0,0,0,0,3277480,2023-11-21T00:00:00.000Z,56677806,1,Mouhamed Gueye,0,0,0,0,0,0
4,1,2,2,0,7,3,1,1,22,4,2,7,6,0,1,3277480,2023-11-21T00:00:00.000Z,3547244,1,Onyeka Okongwu,1,13,17,11,10,22.2
0,0,0,0,0,0,0,0,0,0,0,0,0,0,0,0,3277480,2023-11-21T00:00:00.000Z,319,1,Patty Mills,0,0,0,0,0,0
2,0,9,4,2,7,4,5,2,31,2,0,12,11,0,0,3277480,2023-11-21T00:00:00.000Z,3547256,1,Saddiq Bey,0,23,25,14,13,28.2
0,0,0,0,0,0,0,0,0,0,0,0,0,0,0,0,3277480,2023-11-21T00:00:00.000Z,56677855,1,Seth Lundy,0,0,0,0,0,0
8,0,1,8,5,17,13,8,7,39,0,3,38,1,3,3,3277480,2023-11-21T00:00:00.000Z,490,1,Trae Young,3,39,47,46,9,57.2
0,0,0,0,0,0,0,0,0,0,0,0,0,0,0,0,3277480,2023-11-21T00:00:00.000Z,3547297,1,Trent Forrest,0,0,0,0,0,0
1,0,1,2,1,2,1,0,0,9,0,3,3,1,0,1,3277480,2023-11-21T00:00:00.000Z,301,1,Wesley Matthews,0,4,5,4,2,4.7
1,1,0,3,1,9,6,5,4,25,1,4,17,1,1,0,3277480,2023-11-21T00:00:00.000Z,3547250,12,Aaron Nesmith,2,18,19,18,2,25.7
0,0,0,0,0,0,0,0,0,0,0,0,0,0,0,0,3277480,2023-11-21T00:00:00.000Z,38017507,12,Andrew Nembhard,0,0,0,0,0,0
1,0,1,4,1,5,2,0,0,5,0,0,5,1,0,0,3277480,2023-11-21T00:00:00.000Z,56677861,12,Ben Sheppard,0,6,7,6,2,7.7
1,0,2,4,2,10,7,4,3,20,0,2,19,2,0,0,3277480,2023-11-21T00:00:00.000Z,38017686,12,Bennedict Mathurin,0,21,22,20,3,22.9
3,0,0,5,2,10,5,2,1,30,0,4,13,0,2,2,3277480,2023-11-21T00:00:00.000Z,69,12,Bruce Brown,2,13,16,16,3,21.5
1,1,1,6,6,11,9,0,0,31,1,3,24,2,0,1,3277480,2023-11-21T00:00:00.000Z,210,12,Buddy Hield,1,26,27,25,3,29.9
1,4,4,0,0,1,1,0,0,12,1,5,2,5,0,1,3277480,2023-11-21T00:00:00.000Z,17896035,12,Isaiah Jackson,4,7,8,3,6,20.5
0,0,0,0,0,0,0,0,0,0,0,0,0,0,0,0,3277480,2023-11-21T00:00:00.000Z,56677794,12,Isaiah Wong,0,0,0,0,0,0
0,0,1,0,0,2,2,4,2,5,2,0,6,3,0,0,3277480,2023-11-21T00:00:00.000Z,3547264,12,Jalen Smith,0,9,9,6,3,9.6
0,0,0,0,0,0,0,0,0,0,0,0,0,0,0,0,3277480,2023-11-21T00:00:00.000Z,56677832,12,Jarace Walker,0,0,0,0,0,0
0,0,0,0,0,0,0,0,0,0,0,0,0,0,0,0,3277480,2023-11-21T00:00:00.000Z,3547207,12,Jordan Nwora,0,0,0,0,0,0
0,0,0,0,0,0,0,0,0,0,0,0,0,0,0,0,3277480,2023-11-21T00:00:00.000Z,38017701,12,Kendall Brown,0,0,0,0,0,0
1,4,8,2,0,7,4,4,3,25,1,3,11,9,0,1,3277480,2023-11-21T00:00:00.000Z,452,12,Myles Turner,4,20,21,12,10,34.3
6,1,1,6,1,16,9,2,2,34,0,3,21,1,1,2,3277480,2023-11-21T00:00:00.000Z,3547243,12,Obi Toppin,2,22,28,27,7,35.2
0,0,0,0,0,0,0,0,0,0,0,0,0,0,0,0,3277480,2023-11-21T00:00:00.000Z,56677778,12,Oscar Tshiebwe,0,0,0,0,0,0
4,0,0,0,0,5,1,0,0,14,0,1,2,0,0,0,3277480,2023-11-21T00:00:00.000Z,304,12,T.J. McConnell,0,2,6,6,4,8
16,1,4,15,9,18,11,7,6,39,1,0,37,5,3,6,3277480,2023-11-21T00:00:00.000Z,3547245,12,Tyrese Haliburton,4,42,58,53,21,73
0,0,0,0,0,0,0,0,0,0,0,0,0,0,0,0,3277481,2023-11-21T00:00:00.000Z,277,6,Caris LeVert,0,0,0,0,0,0
9,1,3,0,0,9,5,2,2,27,0,0,12,3,0,1,3277481,2023-11-21T00:00:00.000Z,56677872,6,Craig Porter,1,15,24,21,12,31.1
0,0,0,0,0,0,0,0,0,0,0,0,0,0,0,0,3277481,2023-11-21T00:00:00.000Z,248,6,Damian Jones,0,0,0,0,0,0
8,0,4,6,2,25,10,11,10,43,1,1,32,5,3,4,3277481,2023-11-21T00:00:00.000Z,666581,6,Darius Garland,3,37,45,40,13,55
2,0,4,4,0,4,0,0,0,31,4,5,0,8,3,1,3277481,2023-11-21T00:00:00.000Z,666940,6,Dean Wade,3,8,10,2,10,20.6
0,0,0,0,0,0,0,0,0,0,0,0,0,0,0,0,3277481,2023-11-21T00:00:00.000Z,322,6,Donovan Mitchell,0,0,0,0,0,0
0,0,0,0,0,0,0,0,0,0,0,0,0,0,0,0,3277481,2023-11-21T00:00:00.000Z,56677847,6,Emoni Bates,0,0,0,0,0,0
3,1,12,0,0,10,6,6,6,38,0,4,18,12,0,4,3277481,2023-11-21T00:00:00.000Z,17896076,6,Evan Mobley,1,30,33,21,15,35.9
0,0,7,4,2,9,5,0,0,26,0,2,12,7,0,1,3277481,2023-11-21T00:00:00.000Z,344,6,Georges Niang,0,19,19,12,7,19.4
0,0,0,0,0,0,0,0,0,0,0,0,0,0,0,0,3277481,2023-11-21T00:00:00.000Z,3547247,6,Isaac Okoro,0,0,0,0,0,0
0,0,0,0,0,0,0,0,0,0,0,0,0,0,0,0,3277481,2023-11-21T00:00:00.000Z,38017662,6,Isaiah Mobley,0,0,0,0,0,0
3,0,7,0,0,20,12,2,2,35,6,4,26,13,0,2,3277481,2023-11-21T00:00:00.000Z,9,6,Jarrett Allen,0,39,42,29,16,44.1
6,1,3,10,5,15,7,2,1,44,2,5,20,5,2,2,3277481,2023-11-21T00:00:00.000Z,666908,6,Max Strus,3,25,31,26,11,42
0,0,0,0,0,0,0,0,0,0,0,0,0,0,0,0,3277481,2023-11-21T00:00:00.000Z,404,6,Ricky Rubio,0,0,0,0,0,0
0,0,0,1,0,1,0,0,0,6,0,0,0,0,0,0,3277481,2023-11-21T00:00:00.000Z,3547299,6,Sam Merrill,0,0,0,0,0,0
2,1,2,0,0,1,1,2,0,15,1,0,2,3,1,0,3277481,2023-11-21T00:00:00.000Z,444,6,Tristan Thompson,2,5,7,4,5,14.6
0,0,0,0,0,0,0,0,0,0,0,0,0,0,0,0,3277481,2023-11-21T00:00:00.000Z,666676,6,Ty Jerome,0,0,0,0,0,0
0,0,0,2,1,5,2,2,2,12,0,0,7,0,0,1,3277481,2023-11-21T00:00:00.000Z,2175,23,Danuel House Jr.,0,7,7,7,0,6
3,0,2,6,1,14,5,3,2,41,4,3,13,6,2,1,3277481,2023-11-21T00:00:00.000Z,313,23,De'Anthony Melton,2,19,22,16,9,29.7
0,0,0,0,0,0,0,0,0,0,0,0,0,0,0,0,3277481,2023-11-21T00:00:00.000Z,260,23,Furkan Korkmaz,0,0,0,0,0,0
0,0,0,0,0,1,0,0,0,7,1,2,0,1,0,1,3277481,2023-11-21T00:00:00.000Z,17896025,23,Jaden Springer,0,1,1,0,1,0.2
0,0,0,0,0,0,0,0,0,0,0,0,0,0,0,0,3277481,2023-11-21T00:00:00.000Z,17554001,23,Javonte Smart,0,0,0,0,0,0
5,5,10,3,1,21,9,16,13,41,3,6,32,13,2,6,3277481,2023-11-21T00:00:00.000Z,145,23,Joel Embiid,7,45,50,37,18,70.1
0,0,0,0,0,0,0,0,0,0,0,0,0,0,0,0,3277481,2023-11-21T00:00:00.000Z,360,23,Kelly Oubre Jr.,0,0,0,0,0,0
0,0,0,0,0,0,0,0,0,0,0,0,0,0,0,0,3277481,2023-11-21T00:00:00.000Z,3547294,23,Kenyon Martin Jr.,0,0,0,0,0,0
0,0,0,0,0,0,0,0,0,3,0,0,0,0,0,0,3277481,2023-11-21T00:00:00.000Z,328,23,Marcus Morris,0,0,0,0,0,0
0,0,0,0,0,0,0,0,0,0,0,0,0,0,0,0,3277481,2023-11-21T00:00:00.000Z,28,23,Mo Bamba,0,0,0,0,0,0
2,0,4,4,1,5,2,0,0,27,0,5,5,4,0,2,3277481,2023-11-21T00:00:00.000Z,33,23,Nicolas Batum,0,9,11,7,6,10.8
0,1,3,1,0,2,1,0,0,21,1,3,2,4,2,1,3277481,2023-11-21T00:00:00.000Z,45,23,Patrick Beverley,3,6,6,2,4,14.8
0,0,1,0,0,4,2,0,0,9,2,1,4,3,1,0,3277481,2023-11-21T00:00:00.000Z,3547270,23,Paul Reed,1,7,7,4,3,10.6
0,0,0,0,0,0,0,0,0,0,0,0,0,0,0,0,3277481,2023-11-21T00:00:00.000Z,56913527,23,Ricky Council IV,0,0,0,0,0,0
1,2,4,2,1,3,1,0,0,14,3,0,3,7,2,1,3277481,2023-11-21T00:00:00.000Z,108,23,Robert Covington,4,10,11,4,8,23.9
0,0,0,0,0,0,0,0,0,0,0,0,0,0,0,0,3277481,2023-11-21T00:00:00.000Z,56677788,23,Terquavion Smith,0,0,0,0,0,0
2,0,2,5,3,13,7,6,6,43,0,3,23,2,2,0,3277481,2023-11-21T00:00:00.000Z,200,23,Tobias Harris,2,25,27,25,4,34.4
6,0,4,12,3,28,11,7,5,47,0,2,30,4,1,1,3277481,2023-11-21T00:00:00.000Z,3547254,23,Tyrese Maxey,1,34,40,36,10,45.8
0,0,0,0,0,0,0,0,0,0,0,0,0,0,0,0,3277482,2023-11-21T00:00:00.000Z,666451,24,Bol Bol,0,0,0,0,0,0
0,0,0,0,0,0,0,0,0,0,0,0,0,0,0,0,3277482,2023-11-21T00:00:00.000Z,37,24,Bradley Beal,0,0,0,0,0,0
1,0,0,0,0,0,0,0,0,6,0,1,0,0,1,0,3277482,2023-11-21T00:00:00.000Z,314,24,Chimezie Metu,1,0,1,1,1,4.5
0,0,0,0,0,0,0,0,0,0,0,0,0,0,0,0,3277482,2023-11-21T00:00:00.000Z,272,24,Damion Lee,0,0,0,0,0,0
6,1,3,3,0,20,9,10,10,34,0,1,28,3,1,1,3277482,2023-11-21T00:00:00.000Z,57,24,Devin Booker,2,31,37,34,9,45.6
0,0,0,0,0,4,1,5,5,13,2,4,7,2,0,2,3277482,2023-11-21T00:00:00.000Z,147,24,Drew Eubanks,0,9,9,7,2,7.4
4,1,2,3,2,5,4,0,0,36,0,2,10,2,1,2,3277482,2023-11-21T00:00:00.000Z,178,24,Eric Gordon,2,12,16,14,6,22.4
5,0,6,1,0,5,4,0,0,35,0,1,8,6,2,1,3277482,2023-11-21T00:00:00.000Z,8,24,Grayson Allen,2,14,19,13,11,27.7
0,0,0,1,0,3,1,0,0,5,0,0,2,0,0,0,3277482,2023-11-21T00:00:00.000Z,18678058,24,Jordan Goodwin,0,2,2,2,0,2
1,0,2,0,0,0,0,2,2,13,1,0,2,3,1,1,3277482,2023-11-21T00:00:00.000Z,356,24,Josh Okogie,1,5,6,3,4,9.1
0,4,6,4,2,11,7,2,2,29,6,4,18,12,1,3,3277482,2023-11-21T00:00:00.000Z,349,24,Jusuf Nurkic,5,30,30,18,12,44.4
0,0,1,0,0,1,0,2,1,10,0,0,1,1,0,0,3277482,2023-11-21T00:00:00.000Z,32,24,Keita Bates-Diop,0,2,2,1,1,2.2
9,1,4,2,2,21,13,3,3,37,0,4,31,4,0,3,3277482,2023-11-21T00:00:00.000Z,140,24,Kevin Durant,1,35,44,40,13,49.3
0,1,3,3,1,6,4,4,4,22,2,1,13,5,1,0,3277482,2023-11-21T00:00:00.000Z,666729,24,Nassir Little,2,18,18,13,5,25
0,0,0,0,0,0,0,0,0,0,0,0,0,0,0,0,3277482,2023-11-21T00:00:00.000Z,3547298,24,Saben Lee,0,0,0,0,0,0
0,0,0,0,0,0,0,0,0,0,0,0,0,0,0,0,3277482,2023-11-21T00:00:00.000Z,3547095,24,Udoka Azubuike,0,0,0,0,0,0
0,0,0,0,0,0,0,0,0,0,0,0,0,0,0,0,3277482,2023-11-21T00:00:00.000Z,470,24,Yuta Watanabe,0,0,0,0,0,0
0,0,0,0,0,0,0,0,0,0,0,0,0,0,0,0,3277482,2023-11-21T00:00:00.000Z,419,25,Anfernee Simons,0,0,0,0,0,0
4,1,2,0,0,14,9,0,0,31,6,1,18,8,1,2,3277482,2023-11-21T00:00:00.000Z,22,25,Deandre Ayton,2,26,30,22,12,37.6
1,0,0,3,2,6,4,0,0,13,1,1,10,1,2,0,3277482,2023-11-21T00:00:00.000Z,56783340,25,Duop Reath,2,11,12,11,2,18.7
0,0,0,0,0,0,0,0,0,0,0,0,0,0,0,0,3277482,2023-11-21T00:00:00.000Z,17896120,25,Ish Wainright,0,0,0,0,0,0
0,0,3,2,0,6,3,2,2,14,0,5,8,3,0,1,3277482,2023-11-21T00:00:00.000Z,38017711,25,Jabari Walker,0,11,11,8,3,10.6
0,0,1,0,0,0,0,0,0,2,0,0,0,1,0,1,3277482,2023-11-21T00:00:00.000Z,44477062,25,Jamaree Bouyea,0,1,1,0,1,0.2
6,1,3,8,5,19,8,6,5,36,1,1,26,4,1,1,3277482,2023-11-21T00:00:00.000Z,182,25,Jerami Grant,2,30,36,32,10,44.8
0,0,0,0,0,0,0,0,0,0,0,0,0,0,0,0,3277482,2023-11-21T00:00:00.000Z,47957121,25,Justin Minaya,0,0,0,0,0,0
0,0,0,1,1,2,1,0,0,2,0,0,3,0,0,0,3277482,2023-11-21T00:00:00.000Z,56677791,25,Kris Murray,0,3,3,3,0,3
5,0,0,5,4,14,6,4,3,25,1,2,19,1,0,2,3277482,2023-11-21T00:00:00.000Z,65,25,Malcolm Brogdon,0,20,25,24,6,25.7
0,1,1,2,0,2,0,0,0,22,1,1,0,2,1,0,3277482,2023-11-21T00:00:00.000Z,666923,25,Matisse Thybulle,2,2,2,0,2,8.4
0,0,0,0,0,1,0,0,0,2,1,0,0,1,0,0,3277482,2023-11-21T00:00:00.000Z,666476,25,Moses Brown,0,1,1,0,1,1.2
1,0,0,0,0,1,0,0,0,2,0,0,0,0,1,0,3277482,2023-11-21T00:00:00.000Z,56677829,25,Rayan Rupert,1,0,1,1,1,4.5
0,0,0,0,0,0,0,0,0,0,0,0,0,0,0,0,3277482,2023-11-21T00:00:00.000Z,476,25,Robert Williams III,0,0,0,0,0,0
0,0,0,0,0,0,0,0,0,0,0,0,0,0,0,0,3277482,2023-11-21T00:00:00.000Z,56677747,25,Scoot Henderson,0,0,0,0,0,0
0,0,2,5,0,13,3,4,4,32,1,3,10,3,1,4,3277482,2023-11-21T00:00:00.000Z,38017690,25,Shaedon Sharpe,1,13,13,10,3,12.6
3,0,2,3,2,5,2,0,0,21,0,2,6,2,0,1,3277482,2023-11-21T00:00:00.000Z,3547289,25,Skylar Mays,0,8,11,9,5,11.9
0,0,4,2,0,4,2,4,3,38,0,4,7,4,1,1,3277482,2023-11-21T00:00:00.000Z,56677850,25,Toumani Camara,1,11,11,7,4,13.8
0,0,0,0,0,0,0,0,0,0,0,0,0,0,0,0,3277483,2023-11-21T00:00:00.000Z,56677867,14,Alex Fudge,0,0,0,0,0,0
4,0,11,0,0,14,11,5,4,29,5,1,26,16,2,2,3277483,2023-11-21T00:00:00.000Z,117,14,Anthony Davis,2,42,46,30,20,55.2
5,0,5,4,1,13,7,4,4,26,0,0,19,5,3,2,3277483,2023-11-21T00:00:00.000Z,17553995,14,Austin Reaves,3,24,29,24,10,39.5
0,0,0,0,0,0,0,0,0,5,0,1,0,0,0,0,3277483,2023-11-21T00:00:00.000Z,666860,14,Cameron Reddish,0,0,0,0,0,0
2,1,7,2,1,7,6,3,3,27,1,5,16,8,0,2,3277483,2023-11-21T00:00:00.000Z,486,14,Christian Wood,1,24,26,18,10,29.6
0,0,0,0,0,0,0,0,0,0,0,0,0,0,0,0,3277483,2023-11-21T00:00:00.000Z,56677738,14,Colin Castleton,0,0,0,0,0,0
8,1,3,4,3,9,7,5,3,26,0,2,20,3,0,0,3277483,2023-11-21T00:00:00.000Z,405,14,D'Angelo Russell,1,23,31,28,11,38.6
0,0,0,0,0,0,0,0,0,0,0,0,0,0,0,0,3277483,2023-11-21T00:00:00.000Z,56677868,14,D'Moi Hodge,0,0,0,0,0,0
0,0,0,0,0,0,0,0,0,0,0,0,0,0,0,0,3277483,2023-11-21T00:00:00.000Z,1603383,14,Gabe Vincent,0,0,0,0,0,0
0,0,0,0,0,0,0,0,0,0,0,0,0,0,0,0,3277483,2023-11-21T00:00:00.000Z,56677835,14,Jalen Hood-Schifino,0,0,0,0,0,0
0,0,0,0,0,0,0,0,0,0,0,0,0,0,0,0,3277483,2023-11-21T00:00:00.000Z,457,14,Jarred Vanderbilt,0,0,0,0,0,0
1,1,2,0,0,4,4,3,2,19,0,1,10,2,0,2,3277483,2023-11-21T00:00:00.000Z,666626,14,Jaxson Hayes,1,12,13,11,3,14.9
9,0,6,5,3,10,6,2,2,24,1,0,17,7,0,2,3277483,2023-11-21T00:00:00.000Z,237,14,LeBron James,0,24,33,26,16,36.9
4,1,5,5,1,8,3,0,0,25,0,2,7,5,1,0,3277483,2023-11-21T00:00:00.000Z,38017697,14,Max Christie,2,12,16,11,9,25
0,0,0,0,0,0,0,0,0,0,0,0,0,0,0,0,3277483,2023-11-21T00:00:00.000Z,56677836,14,Maxwell Lewis,0,0,0,0,0,0
1,0,4,5,2,13,4,2,2,28,2,3,12,6,0,1,3277483,2023-11-21T00:00:00.000Z,666609,14,Rui Hachimura,0,18,19,13,7,19.7
1,1,0,4,0,8,1,3,2,31,0,0,4,0,0,2,3277483,2023-11-21T00:00:00.000Z,383,14,Taurean Prince,1,4,5,5,1,6.5
0,0,0,0,0,0,0,0,0,0,0,0,0,0,0,0,3277483,2023-11-21T00:00:00.000Z,56677842,29,Brice Sensabaugh,0,0,0,0,0,0
4,0,3,3,2,11,6,0,0,22,0,2,14,3,0,1,3277483,2023-11-21T00:00:00.000Z,413,29,Collin Sexton,0,17,21,18,7,22.6
1,1,2,5,2,12,6,2,1,25,2,3,15,4,1,1,3277483,2023-11-21T00:00:00.000Z,101,29,John Collins,2,19,20,16,5,26.3
0,0,0,0,0,0,0,0,0,0,0,0,0,0,0,0,3277483,2023-11-21T00:00:00.000Z,38017630,29,Johnny Juzang,0,0,0,0,0,0
2,0,0,3,0,9,3,1,1,24,0,1,7,0,1,2,3277483,2023-11-21T00:00:00.000Z,100,29,Jordan Clarkson,1,7,9,9,2,11
0,0,0,0,0,0,0,0,0,0,0,0,0,0,0,0,3277483,2023-11-21T00:00:00.000Z,17896023,29,Josh Christopher,0,0,0,0,0,0
5,0,3,4,0,6,1,4,2,24,2,3,4,5,0,2,3277483,2023-11-21T00:00:00.000Z,358,29,Kelly Olynyk,0,9,14,9,10,15.5
2,0,2,5,1,11,3,2,2,21,1,2,9,3,1,2,3277483,2023-11-21T00:00:00.000Z,56677834,29,Keyonte George,1,12,14,11,5,16.6
2,0,0,1,1,4,2,0,0,8,0,1,5,0,0,2,3277483,2023-11-21T00:00:00.000Z,139,29,Kris Dunn,0,5,7,7,2,6
0,0,7,7,2,10,4,0,0,23,1,2,10,8,1,0,3277483,2023-11-21T00:00:00.000Z,297,29,Lauri Markkanen,1,18,18,10,8,22.6
1,0,3,2,0,3,0,0,0,9,0,1,0,3,0,1,3277483,2023-11-21T00:00:00.000Z,666881,29,Luka Samanic,0,3,4,1,4,4.1
0,0,0,0,0,0,0,0,0,0,0,0,0,0,0,0,3277483,2023-11-21T00:00:00.000Z,19465584,29,Micah Potter,0,0,0,0,0,0
0,0,2,3,0,5,0,0,0,17,1,2,0,3,0,1,3277483,2023-11-21T00:00:00.000Z,38017620,29,Ochai Agbaji,0,3,3,0,3,2.6
1,0,2,1,0,11,8,3,2,17,4,1,18,6,0,0,3277483,2023-11-21T00:00:00.000Z,11891374,29,Omer Yurtseven,0,24,25,19,7,26.7
0,1,2,5,3,6,4,0,0,27,2,3,11,4,0,1,3277483,2023-11-21T00:00:00.000Z,38017739,29,Simone Fontecchio,1,15,15,11,4,17.8
7,1,3,5,0,10,1,4,4,23,0,1,6,3,2,1,3277483,2023-11-21T00:00:00.000Z,666650,29,Talen Horton-Tucker,3,9,16,13,10,28.1
0,0,0,0,0,0,0,0,0,0,0,0,0,0,0,0,3277483,2023-11-21T00:00:00.000Z,56677824,29,Taylor Hendricks,0,0,0,0,0,0
0,0,0,0,0,0,0,0,0,0,0,0,0,0,0,0,3277483,2023-11-21T00:00:00.000Z,38017705,29,Walker Kessler,0,0,0,0,0,0
0,0,0,0,0,0,0,0,0,0,0,0,0,0,0,0,1037799,2023-11-22T00:00:00.000Z,56677848,4,Amari Bailey,0,0,0,0,0,0
3,0,0,6,3,12,6,0,0,31,0,2,15,0,1,0,1037799,2023-11-22T00:00:00.000Z,56677823,4,Brandon Miller,1,15,18,18,3,22.5
0,1,2,4,3,5,4,2,2,23,1,1,13,3,1,1,1037799,2023-11-22T00:00:00.000Z,38017708,4,Bryce McGowens,2,16,16,13,3,21.6
0,0,0,0,0,0,0,0,0,0,0,0,0,0,0,0,1037799,2023-11-22T00:00:00.000Z,666748,4,Cody Martin,0,0,0,0,0,0
6,0,8,1,0,8,2,0,0,30,1,1,4,9,0,3,1037799,2023-11-22T00:00:00.000Z,204,4,Gordon Hayward,0,13,19,10,15,20.8
4,0,0,0,0,1,0,0,0,20,0,1,0,0,1,1,1037799,2023-11-22T00:00:00.000Z,422,4,Ish Smith,1,0,4,4,4,8
0,0,0,0,0,0,0,0,0,0,0,0,0,0,0,0,1037799,2023-11-22T00:00:00.000Z,17896037,4,James Bouknight,0,0,0,0,0,0
1,0,4,3,1,5,2,0,0,23,0,1,5,4,0,0,1037799,2023-11-22T00:00:00.000Z,18678001,4,JT Thor,0,9,10,6,5,11.3
13,0,6,16,6,31,13,3,2,40,2,2,34,8,1,4,1037799,2023-11-22T00:00:00.000Z,3547239,4,LaMelo Ball,1,42,55,47,21,62.1
0,0,0,0,0,0,0,0,0,0,0,0,0,0,0,0,1037799,2023-11-22T00:00:00.000Z,56677866,4,Leaky Black,0,0,0,0,0,0
0,3,9,0,0,10,4,6,3,35,5,4,11,14,0,0,1037799,2023-11-22T00:00:00.000Z,38017698,4,Mark Williams,3,25,25,11,14,36.8
0,0,9,7,3,19,11,10,8,37,2,2,33,11,2,2,1037799,2023-11-22T00:00:00.000Z,62,4,Miles Bridges,2,44,44,33,11,50.2
0,0,0,0,0,1,1,0,0,1,0,1,2,0,0,0,1037799,2023-11-22T00:00:00.000Z,56677846,4,Nick Smith Jr.,0,2,2,2,0,2
0,0,0,0,0,0,0,0,0,0,0,0,0,0,0,0,1037799,2023-11-22T00:00:00.000Z,666950,4,P.J. Washington,0,0,0,0,0,0
0,0,0,0,0,0,0,0,0,0,0,0,0,0,0,0,1037799,2023-11-22T00:00:00.000Z,403,4,Terry Rozier,0,0,0,0,0,0
0,0,0,0,0,0,0,0,0,0,0,0,0,0,0,0,1037799,2023-11-22T00:00:00.000Z,3547253,4,Theo Maledon,0,0,0,0,0,0
0,0,0,0,0,0,0,0,0,0,0,0,0,0,0,0,1037799,2023-11-22T00:00:00.000Z,3547302,30,Anthony Gill,0,0,0,0,0,0
2,1,0,1,0,5,2,3,3,19,0,4,7,0,0,1,1037799,2023-11-22T00:00:00.000Z,56677844,30,Bilal Coulibaly,1,7,9,9,2,12
1,0,3,4,1,7,2,1,1,18,1,1,6,4,0,1,1037799,2023-11-22T00:00:00.000Z,17896045,30,Corey Kispert,0,10,11,7,5,11.3
1,0,11,0,0,9,7,2,1,34,5,4,15,16,1,2,1037799,2023-11-22T00:00:00.000Z,666577,30,Daniel Gafford,1,31,32,16,17,36.7
1,0,5,2,0,5,0,2,1,14,0,0,1,5,0,0,1037799,2023-11-22T00:00:00.000Z,167,30,Danilo Gallinari,0,6,7,2,6,8.5
0,0,0,0,0,0,0,0,0,0,0,0,0,0,0,0,1037799,2023-11-22T00:00:00.000Z,487,30,Delon Wright,0,0,0,0,0,0
0,0,0,0,0,0,0,0,0,0,0,0,0,0,0,0,1037799,2023-11-22T00:00:00.000Z,17896106,30,Eugene Omoruyi,0,0,0,0,0,0
0,0,0,0,0,0,0,0,0,0,0,0,0,0,0,0,1037799,2023-11-22T00:00:00.000Z,18677954,30,Jared Butler,0,0,0,0,0,0
0,0,0,0,0,0,0,0,0,0,0,0,0,0,0,0,1037799,2023-11-22T00:00:00.000Z,38124126,30,John Butler Jr.,0,0,0,0,0,0
0,0,0,0,0,0,0,0,0,6,0,0,0,0,0,0,1037799,2023-11-22T00:00:00.000Z,38017687,30,Johnny Davis,0,0,0,0,0,0
2,0,4,11,4,21,8,4,4,33,2,1,24,6,2,3,1037799,2023-11-22T00:00:00.000Z,666848,30,Jordan Poole,2,30,32,26,8,37.2
1,0,1,3,1,6,2,3,2,18,1,3,7,2,0,0,1037799,2023-11-22T00:00:00.000Z,414,30,Landry Shamet,0,9,10,8,3,10.9
0,0,0,0,0,0,0,0,0,0,0,0,0,0,0,0,1037799,2023-11-22T00:00:00.000Z,337,30,Mike Muscala,0,0,0,0,0,0
0,0,0,0,0,0,0,0,0,0,0,0,0,0,0,0,1037799,2023-11-22T00:00:00.000Z,38017704,30,Patrick Baldwin Jr.,0,0,0,0,0,0
0,0,0,0,0,0,0,0,0,0,0,0,0,0,0,0,1037799,2023-11-22T00:00:00.000Z,38017712,30,Ryan Rollins,0,0,0,0,0,0
7,0,1,3,1,13,6,0,0,35,0,1,13,1,2,0,1037799,2023-11-22T00:00:00.000Z,249,30,Tyus Jones,2,14,21,20,8,30.7
1,0,3,3,1,16,7,2,0,37,7,3,15,10,2,2,1037800,2023-11-22T00:00:00.000Z,177,8,Aaron Gordon,2,25,26,16,11,32.5
0,0,0,0,0,0,0,0,0,0,0,0,0,0,0,0,1037800,2023-11-22T00:00:00.000Z,17896007,8,Braxton Key,0,0,0,0,0,0
1,0,6,2,2,7,4,3,3,21,1,4,13,7,0,3,1037800,2023-11-22T00:00:00.000Z,38017709,8,Christian Braun,0,20,21,14,8,19.9
0,0,0,0,0,0,0,0,0,0,0,0,0,0,0,0,1037800,2023-11-22T00:00:00.000Z,38017727,8,Collin Gillespie,0,0,0,0,0,0
0,0,0,0,0,0,0,0,0,0,0,0,0,0,0,0,1037800,2023-11-22T00:00:00.000Z,250,8,DeAndre Jordan,0,0,0,0,0,0
0,0,0,0,0,0,0,0,0,0,0,0,0,0,0,0,1037800,2023-11-22T00:00:00.000Z,56677871,8,Hunter Tyson,0,0,0,0,0,0
0,0,1,3,0,4,0,0,0,8,0,0,0,1,0,1,1037800,2023-11-22T00:00:00.000Z,56677582,8,Jalen Pickett,0,1,1,0,1,0.2
0,0,0,0,0,0,0,0,0,0,0,0,0,0,0,0,1037800,2023-11-22T00:00:00.000Z,335,8,Jamal Murray,0,0,0,0,0,0
0,0,0,0,0,0,0,0,0,0,0,0,0,0,0,0,1037800,2023-11-22T00:00:00.000Z,17896103,8,Jay Huff,0,0,0,0,0,0
2,0,1,4,1,6,2,2,2,17,1,5,7,2,0,0,1037800,2023-11-22T00:00:00.000Z,56677776,8,Julian Strawther,0,9,11,9,4,12.4
0,0,0,0,0,0,0,0,0,0,0,0,0,0,0,0,1037800,2023-11-22T00:00:00.000Z,215,8,Justin Holiday,0,0,0,0,0,0
0,0,2,9,5,16,9,2,2,31,0,4,25,2,1,0,1037800,2023-11-22T00:00:00.000Z,375,8,Michael Porter Jr.,1,27,27,25,2,30.4
0,0,0,0,0,1,1,2,0,10,1,1,2,1,0,0,1037800,2023-11-22T00:00:00.000Z,38017721,8,Peyton Watson,0,3,3,2,1,3.2
0,0,0,0,0,0,0,0,0,0,0,0,0,0,0,0,1037800,2023-11-22T00:00:00.000Z,666489,8,Vlatko Cancar,0,0,0,0,0,0
2,0,0,0,0,2,1,2,1,12,1,1,3,1,0,0,1037800,2023-11-22T00:00:00.000Z,3547268,8,Zeke Nnaji,0,4,6,5,3,7.2
0,0,0,0,0,0,0,0,0,0,0,0,0,0,0,0,1037800,2023-11-22T00:00:00.000Z,666885,22,Admiral Schofield,0,0,0,0,0,0
1,0,1,0,0,1,0,0,0,15,0,2,0,1,0,3,1037800,2023-11-22T00:00:00.000Z,56677827,22,Anthony Black,0,1,2,1,2,-0.3
0,0,0,0,0,0,0,0,0,0,0,0,0,0,0,0,1037800,2023-11-22T00:00:00.000Z,38017724,22,Caleb Houstan,0,0,0,0,0,0
0,0,0,0,0,0,0,0,0,0,0,0,0,0,0,0,1037800,2023-11-22T00:00:00.000Z,666818,22,Chuma Okeke,0,0,0,0,0,0
0,0,2,4,1,11,6,8,7,29,3,3,20,5,0,0,1037800,2023-11-22T00:00:00.000Z,3547251,22,Cole Anthony,0,25,25,20,5,26
3,0,3,6,1,7,1,2,2,23,0,2,5,3,3,0,1037800,2023-11-22T00:00:00.000Z,196,22,Gary Harris,3,8,11,8,6,22.1
4,0,4,3,0,8,4,2,2,29,0,5,10,4,1,2,1037800,2023-11-22T00:00:00.000Z,17896073,22,Jalen Suggs,1,14,18,14,8,21.8
0,0,0,0,0,0,0,0,0,0,0,0,0,0,0,0,1037800,2023-11-22T00:00:00.000Z,56677839,22,Jett Howard,0,0,0,0,0,0
7,0,1,2,2,4,4,2,2,17,0,3,12,1,1,0,1037800,2023-11-22T00:00:00.000Z,226,22,Joe Ingles,1,13,20,19,8,26.7
1,1,4,2,0,6,4,1,1,14,2,1,9,6,1,1,1037800,2023-11-22T00:00:00.000Z,229,22,Jonathan Isaac,2,15,16,10,7,22.7
0,0,0,0,0,0,0,0,0,0,0,0,0,0,0,0,1037800,2023-11-22T00:00:00.000Z,38017607,22,Kevon Harris,0,0,0,0,0,0
0,0,0,0,0,0,0,0,0,0,0,0,0,0,0,0,1037800,2023-11-22T00:00:00.000Z,165,22,Markelle Fultz,0,0,0,0,0,0
1,0,2,3,1,7,4,4,3,15,1,1,12,3,1,1,1037800,2023-11-22T00:00:00.000Z,462,22,Moritz Wagner,1,15,16,13,4,19.1
0,0,0,0,0,0,0,0,0,0,0,0,0,0,0,0,1037800,2023-11-22T00:00:00.000Z,17553983,22,Trevelin Queen,0,0,0,0,0,0
0,0,0,0,0,0,0,0,0,0,0,0,0,0,0,0,1037800,2023-11-22T00:00:00.000Z,85,22,Wendell Carter Jr.,0,0,0,0,0,0
0,0,0,0,0,0,0,0,0,3,0,0,0,0,0,0,1037801,2023-11-22T00:00:00.000Z,38017689,1,AJ Griffin,0,0,0,0,0,0
3,1,3,11,3,15,5,1,1,26,1,4,14,4,1,1,1037801,2023-11-22T00:00:00.000Z,53,1,Bogdan Bogdanovic,2,18,21,17,7,28.3
0,0,0,0,0,0,0,0,0,0,0,0,0,0,0,0,1037801,2023-11-22T00:00:00.000Z,666564,1,Bruno Fernando,0,0,0,0,0,0
0,3,6,0,0,8,7,0,0,28,9,1,14,15,0,0,1037801,2023-11-22T00:00:00.000Z,83,1,Clint Capela,3,29,29,14,15,41
0,2,8,7,2,16,8,7,7,39,3,3,25,11,1,1,1037801,2023-11-22T00:00:00.000Z,666656,1,De'Andre Hunter,3,36,36,25,11,46.2
8,0,3,8,3,21,6,5,5,39,3,4,20,6,2,1,1037801,2023-11-22T00:00:00.000Z,334,1,Dejounte Murray,2,26,34,28,14,44.2
0,0,0,0,0,0,0,0,0,0,0,0,0,0,0,0,1037801,2023-11-22T00:00:00.000Z,666754,1,Garrison Mathews,0,0,0,0,0,0
3,1,6,2,1,7,3,0,0,40,0,3,7,6,2,5,1037801,2023-11-22T00:00:00.000Z,17896040,1,Jalen Johnson,3,13,16,10,9,22.7
0,0,0,0,0,0,0,0,0,0,0,0,0,0,0,0,1037801,2023-11-22T00:00:00.000Z,319,1,Patty Mills,0,0,0,0,0,0
1,0,2,3,1,8,4,3,3,25,0,2,12,2,2,2,1037801,2023-11-22T00:00:00.000Z,3547256,1,Saddiq Bey,2,14,15,13,3,19.9
9,0,2,16,8,31,12,13,11,40,2,0,43,4,2,4,1037801,2023-11-22T00:00:00.000Z,490,1,Trae Young,2,47,56,52,13,63.3
0,0,0,0,0,0,0,0,0,0,0,0,0,0,0,0,1037801,2023-11-22T00:00:00.000Z,3547297,1,Trent Forrest,0,0,0,0,0,0
0,0,0,0,0,0,0,0,0,0,0,0,0,0,0,0,1037801,2023-11-22T00:00:00.000Z,301,1,Wesley Matthews,0,0,0,0,0,0
0,0,0,0,0,0,0,0,0,0,0,0,0,0,0,0,1037801,2023-11-22T00:00:00.000Z,417,3,Ben Simmons,0,0,0,0,0,0
0,0,0,0,0,0,0,0,0,0,0,0,0,0,0,0,1037801,2023-11-22T00:00:00.000Z,17896048,3,Cam Thomas,0,0,0,0,0,0
0,0,0,0,0,0,0,0,0,0,0,0,0,0,0,0,1037801,2023-11-22T00:00:00.000Z,56677841,3,Dariq Whitehead,0,0,0,0,0,0
0,1,3,0,0,6,3,0,0,14,4,2,6,7,2,1,1037801,2023-11-22T00:00:00.000Z,17896038,3,Day'Ron Sharpe,3,13,13,6,7,22.4
0,0,0,0,0,0,0,0,0,0,0,0,0,0,0,0,1037801,2023-11-22T00:00:00.000Z,56677722,3,Jalen Wilson,0,0,0,0,0,0
0,0,0,0,0,0,0,0,0,0,0,0,0,0,0,0,1037801,2023-11-22T00:00:00.000Z,17896041,3,Keon Johnson,0,0,0,0,0,0
4,0,7,6,2,31,16,12,11,44,3,2,45,10,2,1,1037801,2023-11-22T00:00:00.000Z,61,3,Mikal Bridges,2,55,59,49,14,68
3,3,4,0,0,15,10,2,2,37,7,6,22,11,1,2,1037801,2023-11-22T00:00:00.000Z,666508,3,Nicolas Claxton,4,33,36,25,14,49.7
0,0,0,0,0,0,0,0,0,0,0,0,0,0,0,0,1037801,2023-11-22T00:00:00.000Z,56677843,3,Noah Clowney,0,0,0,0,0,0
12,0,4,8,3,23,9,5,5,42,2,3,26,6,0,4,1037801,2023-11-22T00:00:00.000Z,130,3,Spencer Dinwiddie,0,32,44,38,18,47.2
6,1,7,3,2,7,4,1,1,31,1,1,11,8,0,0,1037802,2023-11-22T00:00:00.000Z,219,2,Al Horford,1,19,25,17,14,32.6
0,0,0,0,0,0,0,0,0,0,0,0,0,0,0,0,1037802,2023-11-22T00:00:00.000Z,38017707,2,JD Davison,0,0,0,0,0,0
0,0,0,0,0,0,0,0,0,0,0,0,0,0,0,0,1037802,2023-11-22T00:00:00.000Z,56677864,2,Jordan Walsh,0,0,0,0,0,0
0,0,0,0,0,0,0,0,0,0,0,0,0,0,0,0,1037802,2023-11-22T00:00:00.000Z,3547279,2,Lamar Stevens,0,0,0,0,0,0
0,0,0,0,0,0,0,0,0,0,0,0,0,0,0,0,1037802,2023-11-22T00:00:00.000Z,261,2,Luke Kornet,0,0,0,0,0,0
0,0,0,0,0,0,0,0,0,0,0,0,0,0,0,0,1037802,2023-11-22T00:00:00.000Z,3547295,2,Nathan Knight,0,0,0,0,0,0
0,0,0,0,0,0,0,0,0,0,0,0,0,0,0,0,1037802,2023-11-22T00:00:00.000Z,17553967,2,Neemias Queta,0,0,0,0,0,0
0,0,0,0,0,0,0,0,0,0,0,0,0,0,0,0,1037802,2023-11-22T00:00:00.000Z,666468,2,Oshae Brissett,0,0,0,0,0,0
1,0,2,4,2,7,4,0,0,21,0,0,10,2,0,2,1037802,2023-11-22T00:00:00.000Z,3547276,2,Payton Pritchard,0,12,13,11,3,11.9
0,0,0,0,0,0,0,0,0,0,0,0,0,0,0,0,1037802,2023-11-22T00:00:00.000Z,338,2,Svi Mykhailiuk,0,0,0,0,0,0
0,0,6,0,0,6,2,0,0,21,1,2,4,7,0,0,1037802,2023-11-22T00:00:00.000Z,377,17,Bobby Portis,0,11,11,4,7,12.4
2,0,0,3,1,5,1,0,0,10,0,0,3,0,0,0,1037802,2023-11-22T00:00:00.000Z,368,17,Cameron Payne,0,3,5,5,2,6
5,0,10,3,0,20,7,10,7,36,3,4,21,13,2,3,1037802,2023-11-22T00:00:00.000Z,15,17,Giannis Antetokounmpo,2,34,39,26,18,47.1
0,0,0,0,0,0,0,0,0,0,0,0,0,0,0,0,1037802,2023-11-22T00:00:00.000Z,112,17,Jae Crowder,0,0,0,0,0,0
7,0,3,5,2,14,4,2,2,29,2,4,12,5,1,0,1037802,2023-11-22T00:00:00.000Z,315,17,Khris Middleton,1,17,24,19,12,31.5
0,0,0,0,0,0,0,0,0,0,0,0,0,0,0,0,1037802,2023-11-22T00:00:00.000Z,666960,17,Lindell Wigginton,0,0,0,0,0,0
0,0,0,0,0,0,0,0,0,0,0,0,0,0,0,0,1037802,2023-11-22T00:00:00.000Z,666453,17,Marques Bolden,0,0,0,0,0,0
0,0,0,0,0,0,0,0,0,0,0,0,0,0,0,0,1037802,2023-11-22T00:00:00.000Z,38017691,17,TyTy Washington Jr.,0,0,0,0,0,0
3,1,2,3,2,8,4,2,2,18,0,0,12,2,0,2,1037803,2023-11-22T00:00:00.000Z,277,6,Caris LeVert,1,14,17,15,5,19.9
5,2,2,5,2,12,6,3,2,35,0,1,16,2,1,4,1037803,2023-11-22T00:00:00.000Z,56677872,6,Craig Porter,3,18,23,21,7,30.9
1,1,1,0,0,5,1,0,0,12,2,0,2,3,1,1,1037803,2023-11-22T00:00:00.000Z,248,6,Damian Jones,2,5,6,3,4,12.1
3,0,1,2,1,11,6,2,1,27,0,3,14,1,1,3,1037803,2023-11-22T00:00:00.000Z,666581,6,Darius Garland,1,15,18,17,4,19.7
1,0,1,5,1,5,1,0,0,16,0,1,3,1,1,0,1037803,2023-11-22T00:00:00.000Z,56677847,6,Emoni Bates,1,4,5,4,2,8.7
2,0,8,0,0,7,5,3,3,25,2,0,13,10,0,2,1037803,2023-11-22T00:00:00.000Z,17896076,6,Evan Mobley,0,23,25,15,12,26
1,0,2,5,3,9,4,0,0,20,1,5,11,3,0,0,1037803,2023-11-22T00:00:00.000Z,344,6,Georges Niang,0,14,15,12,4,16.1
3,0,1,1,0,3,1,0,0,9,0,1,2,1,1,1,1037803,2023-11-22T00:00:00.000Z,38017662,6,Isaiah Mobley,1,3,6,5,4,9.7
2,0,4,0,0,2,1,2,2,23,0,2,4,4,0,3,1037803,2023-11-22T00:00:00.000Z,9,6,Jarrett Allen,0,8,10,6,6,8.8
3,1,3,4,2,6,2,0,0,25,0,0,6,3,0,2,1037803,2023-11-22T00:00:00.000Z,666908,6,Max Strus,1,9,12,9,6,15.1
1,0,1,5,3,6,3,0,0,17,0,3,9,1,0,1,1037803,2023-11-22T00:00:00.000Z,3547299,6,Sam Merrill,0,10,11,10,2,10.7
0,1,1,0,0,3,2,2,0,13,2,1,4,3,0,0,1037803,2023-11-22T00:00:00.000Z,444,6,Tristan Thompson,1,7,7,4,3,10.6
0,0,0,0,0,0,0,0,0,0,0,0,0,0,0,0,1037803,2023-11-22T00:00:00.000Z,666676,6,Ty Jerome,0,0,0,0,0,0
0,0,0,0,0,0,0,0,0,0,0,0,0,0,0,0,1037803,2023-11-22T00:00:00.000Z,38017736,16,Cole Swider,0,0,0,0,0,0
0,0,0,0,0,0,0,0,0,0,0,0,0,0,0,0,1037803,2023-11-22T00:00:00.000Z,38017734,16,Jamal Cain,0,0,0,0,0,0
0,0,0,0,0,0,0,0,0,0,0,0,0,0,0,0,1037803,2023-11-22T00:00:00.000Z,285,16,Kevin Love,0,0,0,0,0,0
0,0,0,0,0,0,0,0,0,0,0,0,0,0,0,0,1037803,2023-11-22T00:00:00.000Z,38017696,16,Nikola Jovic,0,0,0,0,0,0
0,0,0,0,0,0,0,0,0,0,0,0,0,0,0,0,1037803,2023-11-22T00:00:00.000Z,3547257,16,R.J. Hampton,0,0,0,0,0,0
0,0,0,0,0,0,0,0,0,0,0,0,0,0,0,0,1037803,2023-11-22T00:00:00.000Z,666633,16,Tyler Herro,0,0,0,0,0,0
0,0,0,0,0,0,0,0,0,0,0,0,0,0,0,0,1037804,2023-11-22T00:00:00.000Z,38017507,12,Andrew Nembhard,0,0,0,0,0,0
2,1,0,1,0,7,2,2,1,24,0,1,5,0,1,0,1037804,2023-11-22T00:00:00.000Z,38017686,12,Bennedict Mathurin,2,5,7,7,2,14
3,0,4,4,1,9,5,3,3,35,0,4,14,4,2,3,1037804,2023-11-22T00:00:00.000Z,69,12,Bruce Brown,2,18,21,17,7,26.3
5,1,2,12,7,17,12,0,0,35,0,2,31,2,2,1,1037804,2023-11-22T00:00:00.000Z,210,12,Buddy Hield,3,33,38,36,7,48.9
1,0,1,2,0,5,0,0,0,14,3,3,0,4,1,1,1037804,2023-11-22T00:00:00.000Z,3547207,12,Jordan Nwora,1,4,5,1,5,8.3
0,2,7,3,2,11,7,2,1,29,1,3,17,8,1,2,1037804,2023-11-22T00:00:00.000Z,452,12,Myles Turner,3,25,25,17,8,33.6
1,0,3,5,2,9,6,2,2,36,0,1,16,3,2,3,1037804,2023-11-22T00:00:00.000Z,3547243,12,Obi Toppin,2,19,20,17,4,24.1
5,0,2,1,1,6,3,0,0,14,0,5,7,2,1,0,1037804,2023-11-22T00:00:00.000Z,304,12,T.J. McConnell,1,9,14,12,7,19.9
16,1,2,10,5,22,12,5,4,34,1,3,33,3,0,3,1037804,2023-11-22T00:00:00.000Z,3547245,12,Tyrese Haliburton,1,36,52,49,19,60.6
0,0,0,0,0,0,0,0,0,0,0,0,0,0,0,0,1037804,2023-11-22T00:00:00.000Z,38017710,28,Christian Koloko,0,0,0,0,0,0
0,0,0,0,0,0,0,0,0,0,0,0,0,0,0,0,1037804,2023-11-22T00:00:00.000Z,56677869,28,Markquis Nowell,0,0,0,0,0,0
0,0,0,0,0,0,0,0,0,0,0,0,0,0,0,0,1037804,2023-11-22T00:00:00.000Z,489,28,Thaddeus Young,0,0,0,0,0,0
3,3,6,1,1,9,4,3,2,32,1,5,11,7,0,2,1037805,2023-11-22T00:00:00.000Z,17896062,11,Alperen Sengun,3,18,21,14,10,30.9
0,0,0,0,0,0,0,0,0,0,0,0,0,0,0,0,1037805,2023-11-22T00:00:00.000Z,56677825,11,Amen Thompson,0,0,0,0,0,0
0,0,0,0,0,0,0,0,0,0,0,0,0,0,0,0,1037805,2023-11-22T00:00:00.000Z,56677831,11,Cam Whitmore,0,0,0,0,0,0
1,0,4,5,0,14,4,5,5,27,1,4,13,5,1,1,1037805,2023-11-22T00:00:00.000Z,66,11,Dillon Brooks,1,18,19,14,6,22.5
2,1,9,4,3,10,6,4,3,27,0,2,18,9,0,0,1037805,2023-11-22T00:00:00.000Z,38017684,11,Jabari Smith Jr.,1,27,29,20,11,34.8
0,0,0,0,0,0,0,0,0,0,0,0,0,0,0,0,1037805,2023-11-22T00:00:00.000Z,56677809,11,Jermaine Samuels Jr.,0,0,0,0,0,0
0,0,0,0,0,0,0,0,0,0,0,0,0,0,0,0,1037805,2023-11-22T00:00:00.000Z,357,11,Victor Oladipo,0,0,0,0,0,0
2,2,5,0,0,4,2,2,1,32,0,0,5,5,1,1,1037805,2023-11-22T00:00:00.000Z,48,15,Bismack Biyombo,3,10,12,7,7,22
0,0,0,0,0,0,0,0,0,0,0,0,0,0,0,0,1037805,2023-11-22T00:00:00.000Z,666505,15,Brandon Clarke,0,0,0,0,0,0
4,0,6,6,2,12,6,10,9,26,1,4,23,7,1,2,1037805,2023-11-22T00:00:00.000Z,3547287,15,Desmond Bane,1,30,34,27,11,38.4
0,0,2,1,0,3,0,0,0,4,1,0,0,3,0,0,1037805,2023-11-22T00:00:00.000Z,56677830,15,GG Jackson,0,3,3,0,3,3.6
0,0,0,0,0,0,0,0,0,0,0,0,0,0,0,0,1037805,2023-11-22T00:00:00.000Z,38017728,15,Jake LaRavia,0,0,0,0,0,0
0,1,6,4,0,21,7,12,9,37,1,4,23,7,1,2,1037805,2023-11-22T00:00:00.000Z,231,15,Jaren Jackson Jr.,2,30,30,23,7,35.4
1,0,0,1,0,4,1,1,1,4,1,0,3,1,0,0,1037805,2023-11-22T00:00:00.000Z,38017732,15,Kenneth Lofton Jr.,0,4,5,4,2,5.7
0,0,0,0,0,0,0,0,0,0,0,0,0,0,0,0,1037805,2023-11-22T00:00:00.000Z,254,15,Luke Kennard,0,0,0,0,0,0
0,1,2,3,1,5,2,3,3,22,0,5,8,2,0,0,1037805,2023-11-22T00:00:00.000Z,17896067,15,Santi Aldama,1,10,10,8,2,13.4
0,0,0,0,0,0,0,0,0,0,0,0,0,0,0,0,1037805,2023-11-22T00:00:00.000Z,3,15,Steven Adams,0,0,0,0,0,0
0,1,1,1,0,1,0,0,0,4,0,0,0,1,0,0,1037805,2023-11-22T00:00:00.000Z,38017731,15,Vince Williams Jr.,1,1,1,0,1,4.2
6,0,4,9,5,22,11,4,4,36,2,2,31,6,2,2,1037806,2023-11-22T00:00:00.000Z,3547238,18,Anthony Edwards,2,37,43,37,12,51.2
0,0,0,0,0,0,0,0,0,0,0,0,0,0,0,0,1037806,2023-11-22T00:00:00.000Z,56677851,18,Jaylen Clark,0,0,0,0,0,0
3,2,11,2,1,19,9,5,4,36,0,5,23,11,2,4,1037806,2023-11-22T00:00:00.000Z,447,18,Karl-Anthony Towns,4,34,37,26,14,48.7
0,0,1,1,0,1,0,2,1,2,0,0,1,1,0,1,1037806,2023-11-22T00:00:00.000Z,17896056,18,Luka Garza,0,2,2,1,1,1.2
4,1,4,4,1,6,3,0,0,29,2,4,7,6,0,0,1037806,2023-11-22T00:00:00.000Z,666400,18,Nickeil Alexander-Walker,1,13,17,11,10,23.2
3,3,8,0,0,8,6,2,1,31,3,3,13,11,0,2,1037806,2023-11-22T00:00:00.000Z,176,18,Rudy Gobert,3,24,27,16,14,37.7
0,0,1,2,1,2,1,0,0,5,1,0,3,2,1,0,1037806,2023-11-22T00:00:00.000Z,260,23,Furkan Korkmaz,1,5,5,3,2,8.4
0,0,0,0,0,0,0,0,0,0,0,0,0,0,0,0,1037806,2023-11-22T00:00:00.000Z,17554001,23,Javonte Smart,0,0,0,0,0,0
0,0,0,0,0,0,0,0,0,0,0,0,0,0,0,0,1037806,2023-11-22T00:00:00.000Z,145,23,Joel Embiid,0,0,0,0,0,0
0,0,0,0,0,0,0,0,0,0,0,0,0,0,0,0,1037806,2023-11-22T00:00:00.000Z,360,23,Kelly Oubre Jr.,0,0,0,0,0,0
0,0,1,0,0,2,1,2,1,6,0,2,3,1,0,0,1037806,2023-11-22T00:00:00.000Z,3547294,23,Kenyon Martin Jr.,0,4,4,3,1,4.2
0,0,0,0,0,0,0,0,0,0,0,0,0,0,0,0,1037806,2023-11-22T00:00:00.000Z,56913527,23,Ricky Council IV,0,0,0,0,0,0
0,2,5,1,0,4,2,2,1,20,1,2,5,6,0,0,1037806,2023-11-22T00:00:00.000Z,108,23,Robert Covington,2,11,11,5,6,18.2
0,0,0,0,0,0,0,0,0,0,0,0,0,0,0,0,1037806,2023-11-22T00:00:00.000Z,56677788,23,Terquavion Smith,0,0,0,0,0,0
3,0,4,4,1,18,9,4,4,29,0,5,23,4,1,2,1037807,2023-11-22T00:00:00.000Z,227,19,Brandon Ingram,1,27,30,26,7,33.3
0,0,1,0,0,2,0,0,0,8,2,2,0,3,0,0,1037807,2023-11-22T00:00:00.000Z,491,19,Cody Zeller,0,3,3,0,3,3.6
0,0,4,5,0,9,2,4,4,29,3,2,8,7,1,0,1037807,2023-11-22T00:00:00.000Z,38017677,19,Dyson Daniels,1,15,15,8,7,19.4
3,1,5,4,0,6,1,6,5,39,0,4,7,5,3,2,1037807,2023-11-22T00:00:00.000Z,17896024,19,Herbert Jones,4,12,15,10,8,27.5
2,0,8,0,0,9,6,4,3,28,3,5,15,11,0,1,1037807,2023-11-22T00:00:00.000Z,455,19,Jonas Valanciunas,0,26,28,17,13,30.2
3,0,1,8,2,9,3,5,5,21,1,3,13,2,0,0,1037807,2023-11-22T00:00:00.000Z,56677837,19,Jordan Hawkins,0,15,18,16,5,19.9
2,0,1,6,2,9,4,4,0,19,0,2,10,1,3,1,1037807,2023-11-22T00:00:00.000Z,17896097,19,Jose Alvarado,3,11,13,12,3,22.2
0,0,0,0,0,0,0,0,0,0,0,0,0,0,0,0,1037807,2023-11-22T00:00:00.000Z,3547260,19,Kira Lewis Jr.,0,0,0,0,0,0
4,1,4,2,2,5,4,3,2,20,2,0,12,6,1,1,1037807,2023-11-22T00:00:00.000Z,3547293,19,Naji Marshall,2,18,22,16,10,30.2
6,0,4,0,0,16,10,7,5,35,1,3,25,5,0,2,1037807,2023-11-22T00:00:00.000Z,666969,19,Zion Williamson,0,30,36,31,11,38
0,0,2,4,1,5,1,0,0,10,0,0,3,2,0,2,1037807,2023-11-22T00:00:00.000Z,4197162,26,Aleksandar Vezenkov,0,5,5,3,2,3.4
2,0,1,0,0,0,0,2,2,10,0,0,2,1,0,0,1037807,2023-11-22T00:00:00.000Z,17553994,26,Davion Mitchell,0,3,5,4,3,6.2
0,0,0,0,0,0,0,0,0,0,0,0,0,0,0,0,1037807,2023-11-22T00:00:00.000Z,17895941,26,Filip Petrusev,0,0,0,0,0,0
0,0,0,0,0,0,0,0,0,0,0,0,0,0,0,0,1037807,2023-11-22T00:00:00.000Z,56677862,26,Jalen Slawson,0,0,0,0,0,0
0,0,1,0,0,0,0,2,0,5,0,0,0,1,0,2,1037807,2023-11-22T00:00:00.000Z,306,26,JaVale McGee,0,1,1,0,1,-0.8
0,0,0,1,0,1,0,0,0,1,0,0,0,0,0,0,1037807,2023-11-22T00:00:00.000Z,17896044,26,Kessler Edwards,0,0,0,0,0,0
5,0,4,6,1,8,2,5,5,26,0,2,10,4,2,2,1037807,2023-11-22T00:00:00.000Z,324,26,Malik Monk,2,14,19,15,9,26.3
0,0,8,7,3,8,4,1,1,27,0,5,12,8,0,3,1037807,2023-11-22T00:00:00.000Z,290,26,Trey Lyles,0,20,20,12,8,18.6
0,0,0,0,0,0,0,0,0,0,0,0,0,0,0,0,1037808,2023-11-22T00:00:00.000Z,56677860,5,Adama Sanogo,0,0,0,0,0,0
1,0,5,6,2,12,5,0,0,27,1,1,12,6,1,0,1037808,2023-11-22T00:00:00.000Z,89,5,Alex Caruso,1,18,19,13,7,23.7
1,0,4,0,0,3,1,0,0,11,1,2,2,5,0,0,1037808,2023-11-22T00:00:00.000Z,137,5,Andre Drummond,0,7,8,3,6,9.5
2,1,2,5,3,7,4,0,0,21,0,4,11,2,1,2,1037808,2023-11-22T00:00:00.000Z,17895983,5,Ayo Dosunmu,2,13,15,13,4,20.4
5,0,1,12,7,17,8,0,0,37,0,5,23,1,1,3,1037808,2023-11-22T00:00:00.000Z,666956,5,Coby White,1,24,29,28,6,31.7
0,0,0,0,0,0,0,0,0,0,0,0,0,0,0,0,1037808,2023-11-22T00:00:00.000Z,38017719,5,Dalen Terry,0,0,0,0,0,0
6,1,1,2,0,17,6,13,13,36,1,3,25,2,2,1,1037808,2023-11-22T00:00:00.000Z,125,5,DeMar DeRozan,3,27,33,31,8,44.4
2,0,0,6,1,7,1,0,0,19,0,2,3,0,0,0,1037808,2023-11-22T00:00:00.000Z,87,5,Jevon Carter,0,3,5,5,2,6
0,0,0,0,0,0,0,0,0,0,0,0,0,0,0,0,1037808,2023-11-22T00:00:00.000Z,56677857,5,Julian Phillips,0,0,0,0,0,0
0,0,0,0,0,0,0,0,0,0,0,0,0,0,0,0,1037808,2023-11-22T00:00:00.000Z,45969255,5,Justin Lewis,0,0,0,0,0,0
0,0,0,0,0,0,0,0,0,0,0,0,0,0,0,0,1037808,2023-11-22T00:00:00.000Z,27,5,Lonzo Ball,0,0,0,0,0,0
3,0,7,5,2,13,6,2,2,37,5,4,16,12,2,1,1037808,2023-11-22T00:00:00.000Z,460,5,Nikola Vucevic,2,28,31,19,15,39.9
0,0,0,0,0,0,0,0,0,0,0,0,0,0,0,0,1037808,2023-11-22T00:00:00.000Z,56677874,5,Onuralp Bitim,0,0,0,0,0,0
2,0,4,5,2,9,3,2,2,37,3,1,10,7,0,2,1037808,2023-11-22T00:00:00.000Z,3547248,5,Patrick Williams,0,17,19,12,9,19.4
0,0,0,0,0,0,0,0,0,0,0,0,0,0,0,0,1037808,2023-11-22T00:00:00.000Z,17896116,5,Terry Taylor,0,0,0,0,0,0
0,0,3,3,0,3,0,0,0,15,0,4,0,3,0,1,1037808,2023-11-22T00:00:00.000Z,110,5,Torrey Craig,0,3,3,0,3,2.6
0,0,0,0,0,0,0,0,0,0,0,0,0,0,0,0,1037808,2023-11-22T00:00:00.000Z,268,5,Zach LaVine,0,0,0,0,0,0
1,0,4,0,0,2,2,2,2,11,0,1,6,4,0,1,1037808,2023-11-22T00:00:00.000Z,17896078,21,Aaron Wiggins,0,10,11,7,5,11.3
0,0,0,0,0,0,0,0,0,0,0,0,0,0,0,0,1037808,2023-11-22T00:00:00.000Z,3547271,21,Aleksej Pokusevski,0,0,0,0,0,0
0,1,2,2,1,3,2,0,0,24,1,1,5,3,0,1,1037808,2023-11-22T00:00:00.000Z,56677833,21,Cason Wallace,1,8,8,5,3,10.6
2,4,8,3,0,11,5,11,8,32,5,3,18,13,1,2,1037808,2023-11-22T00:00:00.000Z,38017685,21,Chet Holmgren,5,31,33,20,15,49.6
0,0,0,0,0,0,0,0,0,0,0,0,0,0,0,0,1037808,2023-11-22T00:00:00.000Z,44,21,Davis Bertans,0,0,0,0,0,0
0,1,1,7,5,9,6,3,3,27,0,0,20,1,0,0,1037808,2023-11-22T00:00:00.000Z,3547272,21,Isaiah Joe,1,21,21,20,1,24.2
0,0,0,0,0,0,0,0,0,0,0,0,0,0,0,0,1037808,2023-11-22T00:00:00.000Z,38017703,21,Jalen Williams,0,0,0,0,0,0
0,0,3,1,0,2,0,0,0,14,1,3,0,4,0,0,1037808,2023-11-22T00:00:00.000Z,38017706,21,Jaylin Williams,0,4,4,0,4,4.8
2,0,5,3,1,13,4,2,1,29,1,1,10,6,2,2,1037808,2023-11-22T00:00:00.000Z,17896065,21,Josh Giddey,2,16,18,12,8,24.2
2,0,4,3,3,6,5,2,0,23,1,0,13,5,0,0,1037808,2023-11-22T00:00:00.000Z,480,21,Kenrich Williams,0,18,20,15,7,22
0,0,0,0,0,0,0,0,0,0,0,0,0,0,0,0,1037808,2023-11-22T00:00:00.000Z,56677853,21,Keyontae Johnson,0,0,0,0,0,0
1,1,1,0,0,0,0,0,0,5,1,0,0,2,0,0,1037808,2023-11-22T00:00:00.000Z,27924547,21,Lindy Waters III,1,2,3,1,3,6.9
2,2,2,4,0,6,1,0,0,27,0,6,2,2,0,2,1037808,2023-11-22T00:00:00.000Z,666541,21,Luguentz Dort,2,4,6,4,4,11.4
0,0,0,0,0,0,0,0,0,0,0,0,0,0,0,0,1037808,2023-11-22T00:00:00.000Z,24572055,21,Olivier Sarr,0,0,0,0,0,0
0,0,0,0,0,0,0,0,0,0,0,0,0,0,0,0,1037808,2023-11-22T00:00:00.000Z,38017716,21,Ousmane Dieng,0,0,0,0,0,0
12,3,4,3,1,19,11,18,17,37,1,2,40,5,1,2,1037808,2023-11-22T00:00:00.000Z,175,21,Shai Gilgeous-Alexander,4,45,57,52,17,74
0,0,0,0,0,0,0,0,0,0,0,0,0,0,0,0,1037808,2023-11-22T00:00:00.000Z,17896036,21,Tre Mann,0,0,0,0,0,0
2,0,0,3,0,4,1,0,0,11,0,0,2,0,0,2,1037808,2023-11-22T00:00:00.000Z,4197029,21,Vasilije Micic,0,2,4,4,2,3
9,1,6,4,2,7,3,12,8,36,0,3,16,6,1,4,1037809,2023-11-22T00:00:00.000Z,192,13,James Harden,2,22,31,25,15,38.7
0,0,0,0,0,0,0,0,0,2,0,0,0,0,0,3,1037809,2023-11-22T00:00:00.000Z,17895854,27,Charles Bassey,0,0,0,0,0,-3
0,0,0,0,0,0,0,0,0,0,0,0,0,0,0,0,1037809,2023-11-22T00:00:00.000Z,180,27,Devonte' Graham,0,0,0,0,0,0
0,0,2,0,0,1,0,0,0,9,0,1,0,2,1,0,1037809,2023-11-22T00:00:00.000Z,38017730,27,Dominick Barlow,1,2,2,0,2,5.4
7,0,3,5,2,15,6,6,5,31,2,3,19,5,0,1,1037809,2023-11-22T00:00:00.000Z,38017699,27,Jeremy Sochan,0,24,31,26,12,34.5
0,0,0,0,0,0,0,0,0,0,0,0,0,0,0,0,1037809,2023-11-22T00:00:00.000Z,38017649,27,Julian Champagnie,0,0,0,0,0,0
6,1,1,8,2,13,5,3,3,36,2,4,15,3,0,0,1037809,2023-11-22T00:00:00.000Z,666682,27,Keldon Johnson,1,18,24,21,9,30.6
1,0,0,3,0,6,0,0,0,21,1,0,0,1,0,0,1037809,2023-11-22T00:00:00.000Z,38017692,27,Malaki Branham,0,1,2,1,2,2.7
3,3,13,2,1,13,7,7,7,33,2,2,22,15,1,2,1037809,2023-11-22T00:00:00.000Z,56677822,27,Victor Wembanyama,4,37,40,25,18,54.5
3,1,7,5,2,13,6,2,2,28,2,6,16,9,0,1,1037809,2023-11-22T00:00:00.000Z,102,27,Zach Collins,1,25,28,19,12,33.3
1,1,2,3,0,11,4,4,3,25,2,1,11,4,0,2,1037810,2023-11-22T00:00:00.000Z,475,10,Andrew Wiggins,1,15,16,12,5,18.3
2,0,2,3,1,9,4,2,1,23,2,1,10,4,3,0,1037810,2023-11-22T00:00:00.000Z,56677858,10,Brandin Podziemski,3,14,16,12,6,26.8
6,0,2,1,0,2,1,4,4,17,0,1,6,2,0,1,1037810,2023-11-22T00:00:00.000Z,367,10,Chris Paul,0,8,14,12,8,16.4
4,0,0,2,0,3,1,2,1,16,0,3,3,0,2,1,1037810,2023-11-22T00:00:00.000Z,251,10,Cory Joseph,2,3,7,7,4,14
4,0,4,3,2,9,6,5,3,22,2,4,17,6,2,1,1037810,2023-11-22T00:00:00.000Z,407,10,Dario Saric,2,23,27,21,10,35.2
0,0,0,0,0,0,0,0,0,0,0,0,0,0,0,0,1037810,2023-11-22T00:00:00.000Z,185,10,Draymond Green,0,0,0,0,0,0
0,0,0,0,0,0,0,0,0,0,0,0,0,0,0,0,1037810,2023-11-22T00:00:00.000Z,2189,10,Gary Payton II,0,0,0,0,0,0
0,0,1,0,0,1,1,0,0,8,0,2,2,1,0,2,1037810,2023-11-22T00:00:00.000Z,57875092,10,Gui Santos,0,3,3,2,1,1.2
0,0,0,0,0,0,0,0,0,0,0,0,0,0,0,0,1037810,2023-11-22T00:00:00.000Z,398,10,Jerome Robinson,0,0,0,0,0,0
2,0,1,1,0,7,3,2,1,21,0,5,7,1,1,0,1037810,2023-11-22T00:00:00.000Z,17553979,10,Jonathan Kuminga,1,8,10,9,3,14.2
2,0,5,0,0,5,3,0,0,17,1,4,6,6,1,2,1037810,2023-11-22T00:00:00.000Z,282,10,Kevon Looney,1,12,14,8,8,17.2
1,1,2,10,6,17,8,1,1,25,1,3,23,3,0,2,1037810,2023-11-22T00:00:00.000Z,443,10,Klay Thompson,1,26,27,24,4,29.1
0,0,0,0,0,0,0,0,0,0,0,0,0,0,0,0,1037810,2023-11-22T00:00:00.000Z,45658838,10,Lester Quinones,0,0,0,0,0,0
1,1,8,1,0,8,4,1,0,23,1,5,8,9,0,1,1037810,2023-11-22T00:00:00.000Z,17553992,10,Moses Moody,1,17,18,9,10,22.3
6,0,3,8,1,15,6,3,3,28,0,2,16,3,0,2,1037810,2023-11-22T00:00:00.000Z,115,10,Stephen Curry,0,19,25,22,9,26.6
0,0,2,0,0,3,2,5,2,15,2,3,6,4,1,1,1037810,2023-11-22T00:00:00.000Z,56677799,10,Trayce Jackson-Davis,1,10,10,6,4,12.8
0,0,0,0,0,0,0,0,0,0,0,0,0,0,0,0,1037810,2023-11-22T00:00:00.000Z,17896070,10,Usman Garuba,0,0,0,0,0,0
0,0,0,0,0,0,0,0,0,0,0,0,0,0,0,0,1037810,2023-11-22T00:00:00.000Z,666451,24,Bol Bol,0,0,0,0,0,0
0,0,0,0,0,0,0,0,0,0,0,0,0,0,0,0,1037810,2023-11-22T00:00:00.000Z,37,24,Bradley Beal,0,0,0,0,0,0
0,2,2,1,0,3,2,0,0,12,0,2,4,2,0,0,1037810,2023-11-22T00:00:00.000Z,314,24,Chimezie Metu,2,6,6,4,2,12.4
0,0,0,0,0,0,0,0,0,0,0,0,0,0,0,0,1037810,2023-11-22T00:00:00.000Z,272,24,Damion Lee,0,0,0,0,0,0
0,3,5,0,0,4,2,2,2,16,1,1,6,6,0,0,1037810,2023-11-22T00:00:00.000Z,147,24,Drew Eubanks,3,12,12,6,6,22.2
4,0,1,9,3,12,4,3,2,29,0,3,13,1,3,2,1037810,2023-11-22T00:00:00.000Z,178,24,Eric Gordon,3,14,18,17,5,27.2
3,0,2,4,1,4,1,8,6,34,1,5,9,3,1,2,1037810,2023-11-22T00:00:00.000Z,8,24,Grayson Allen,1,12,15,12,6,18.1
0,0,0,0,0,0,0,0,0,1,0,0,0,0,0,0,1037810,2023-11-22T00:00:00.000Z,18678058,24,Jordan Goodwin,0,0,0,0,0,0
0,0,2,1,0,8,4,2,1,17,3,4,9,5,0,0,1037810,2023-11-22T00:00:00.000Z,349,24,Jusuf Nurkic,0,14,14,9,5,15
0,0,2,1,1,2,1,2,0,12,1,1,3,3,1,1,1037810,2023-11-22T00:00:00.000Z,32,24,Keita Bates-Diop,1,6,6,3,3,8.6
2,2,8,4,3,14,7,15,15,34,0,2,32,8,0,6,1037810,2023-11-22T00:00:00.000Z,140,24,Kevin Durant,2,40,42,34,10,44.6
3,0,4,3,0,9,4,2,2,27,1,1,10,5,2,0,1037810,2023-11-22T00:00:00.000Z,666729,24,Nassir Little,2,15,18,13,8,26.5
0,0,0,0,0,0,0,0,0,0,0,0,0,0,0,0,1037810,2023-11-22T00:00:00.000Z,3547298,24,Saben Lee,0,0,0,0,0,0
0,0,0,0,0,0,0,0,0,0,0,0,0,0,0,0,1037810,2023-11-22T00:00:00.000Z,3547095,24,Udoka Azubuike,0,0,0,0,0,0
0,0,0,0,0,0,0,0,0,0,0,0,0,0,0,0,1037810,2023-11-22T00:00:00.000Z,470,24,Yuta Watanabe,0,0,0,0,0,0
0,0,0,0,0,0,0,0,0,0,0,0,0,0,0,0,1037811,2023-11-22T00:00:00.000Z,419,25,Anfernee Simons,0,0,0,0,0,0
1,1,4,4,2,5,3,0,0,20,0,2,8,4,0,1,1037811,2023-11-22T00:00:00.000Z,56783340,25,Duop Reath,1,12,13,9,5,16.3
0,0,0,0,0,0,0,0,0,0,0,0,0,0,0,0,1037811,2023-11-22T00:00:00.000Z,39613724,25,Ibou Badji,0,0,0,0,0,0
0,0,0,0,0,0,0,0,0,0,0,0,0,0,0,0,1037811,2023-11-22T00:00:00.000Z,17896120,25,Ish Wainright,0,0,0,0,0,0
4,1,2,6,5,13,10,6,5,32,0,3,30,2,1,2,1037811,2023-11-22T00:00:00.000Z,182,25,Jerami Grant,2,32,36,34,6,42.4
0,0,0,0,0,0,0,0,0,0,0,0,0,0,0,0,1037811,2023-11-22T00:00:00.000Z,47957121,25,Justin Minaya,0,0,0,0,0,0
0,0,0,3,0,5,1,1,0,17,2,0,2,2,1,0,1037811,2023-11-22T00:00:00.000Z,56677791,25,Kris Murray,1,4,4,2,2,7.4
8,0,3,5,1,16,9,1,1,24,1,0,20,4,1,0,1037811,2023-11-22T00:00:00.000Z,65,25,Malcolm Brogdon,1,24,32,28,12,39.8
2,2,0,6,3,9,5,1,0,31,1,2,13,1,3,3,1037811,2023-11-22T00:00:00.000Z,666923,25,Matisse Thybulle,5,14,16,15,3,29.2
0,0,0,0,0,0,0,0,0,0,0,0,0,0,0,0,1037811,2023-11-22T00:00:00.000Z,476,25,Robert Williams III,0,0,0,0,0,0
7,0,2,3,0,7,1,2,1,17,1,4,3,3,0,3,1037811,2023-11-22T00:00:00.000Z,56677747,25,Scoot Henderson,0,6,13,10,10,14.1
4,1,4,4,2,11,6,0,0,31,0,4,14,4,1,1,1037811,2023-11-22T00:00:00.000Z,38017690,25,Shaedon Sharpe,2,18,22,18,8,29.8
0,0,0,0,0,1,0,0,0,6,0,0,0,0,0,0,1037811,2023-11-22T00:00:00.000Z,3547289,25,Skylar Mays,0,0,0,0,0,0
3,1,4,4,2,8,4,2,2,28,3,2,12,7,0,2,1037811,2023-11-22T00:00:00.000Z,56677850,25,Toumani Camara,1,19,22,15,10,25.9
0,0,0,0,0,0,0,0,0,0,0,0,0,0,0,0,1037811,2023-11-22T00:00:00.000Z,56677842,29,Brice Sensabaugh,0,0,0,0,0,0
2,0,1,3,0,5,0,2,1,11,1,2,1,2,1,2,1037811,2023-11-22T00:00:00.000Z,413,29,Collin Sexton,1,3,5,3,4,7.4
1,0,5,1,0,12,6,0,0,32,6,0,12,11,0,0,1037811,2023-11-22T00:00:00.000Z,101,29,John Collins,0,23,24,13,12,26.7
0,0,0,0,0,0,0,0,0,0,0,0,0,0,0,0,1037811,2023-11-22T00:00:00.000Z,38017630,29,Johnny Juzang,0,0,0,0,0,0
5,0,2,4,2,11,5,2,1,32,0,0,13,2,0,7,1037811,2023-11-22T00:00:00.000Z,100,29,Jordan Clarkson,0,15,20,18,7,15.9
0,0,0,0,0,0,0,0,0,0,0,0,0,0,0,0,1037811,2023-11-22T00:00:00.000Z,17896023,29,Josh Christopher,0,0,0,0,0,0
5,1,6,0,0,5,5,3,3,32,3,1,13,9,1,3,1037811,2023-11-22T00:00:00.000Z,358,29,Kelly Olynyk,2,22,27,18,14,34.3
7,0,3,6,3,9,3,7,7,34,0,2,16,3,1,0,1037811,2023-11-22T00:00:00.000Z,56677834,29,Keyonte George,1,19,26,23,10,33.1
1,1,2,0,0,1,0,2,1,5,0,0,1,2,0,0,1037811,2023-11-22T00:00:00.000Z,139,29,Kris Dunn,1,3,4,2,3,7.9
0,0,5,6,1,18,9,6,5,34,3,2,24,8,3,2,1037811,2023-11-22T00:00:00.000Z,297,29,Lauri Markkanen,3,32,32,24,8,40.6
0,0,0,0,0,0,0,0,0,0,0,0,0,0,0,0,1037811,2023-11-22T00:00:00.000Z,666881,29,Luka Samanic,0,0,0,0,0,0
0,0,0,0,0,0,0,0,0,0,0,0,0,0,0,0,1037811,2023-11-22T00:00:00.000Z,19465584,29,Micah Potter,0,0,0,0,0,0
1,1,0,1,1,4,4,0,0,14,0,0,9,0,0,1,1037811,2023-11-22T00:00:00.000Z,38017620,29,Ochai Agbaji,1,9,10,10,1,12.5
1,0,6,2,1,3,1,0,0,16,0,1,3,6,0,2,1037811,2023-11-22T00:00:00.000Z,11891374,29,Omer Yurtseven,0,9,10,4,7,9.7
1,0,0,6,2,7,3,0,0,16,1,1,8,1,1,1,1037811,2023-11-22T00:00:00.000Z,38017739,29,Simone Fontecchio,1,9,10,9,2,12.7
1,0,0,2,0,4,1,4,3,14,0,4,5,0,0,3,1037811,2023-11-22T00:00:00.000Z,666650,29,Talen Horton-Tucker,0,5,6,6,1,3.5
0,0,0,0,0,0,0,0,0,0,0,0,0,0,0,0,1037811,2023-11-22T00:00:00.000Z,56677824,29,Taylor Hendricks,0,0,0,0,0,0
0,0,0,0,0,0,0,0,0,0,0,0,0,0,0,0,1037811,2023-11-22T00:00:00.000Z,38017705,29,Walker Kessler,0,0,0,0,0,0
0,0,0,0,0,0,0,0,0,0,0,0,0,0,0,0,1037812,2023-11-22T00:00:00.000Z,56677868,14,D'Moi Hodge,0,0,0,0,0,0
3,0,5,5,1,5,1,0,0,33,0,4,3,5,0,1,3277498,2023-11-24T00:00:00.000Z,219,2,Al Horford,0,8,11,6,8,12.5
0,0,0,0,0,1,0,0,0,1,0,0,0,0,0,0,3277498,2023-11-24T00:00:00.000Z,17896094,2,Dalano Banton,0,0,0,0,0,0
4,1,5,5,1,9,3,12,9,37,0,1,16,5,1,3,3277498,2023-11-24T00:00:00.000Z,473,2,Derrick White,2,21,25,20,9,31
2,1,3,8,2,22,6,7,4,39,0,3,18,3,3,3,3277498,2023-11-24T00:00:00.000Z,70,2,Jaylen Brown,4,21,23,20,5,33.6
3,0,5,3,0,16,7,13,12,39,0,3,26,5,2,2,3277498,2023-11-24T00:00:00.000Z,434,2,Jayson Tatum,2,31,34,29,8,40.5
0,0,0,0,0,0,0,0,0,0,0,0,0,0,0,0,3277498,2023-11-24T00:00:00.000Z,38017707,2,JD Davison,0,0,0,0,0,0
0,0,0,0,0,0,0,0,0,0,0,0,0,0,0,0,3277498,2023-11-24T00:00:00.000Z,56677864,2,Jordan Walsh,0,0,0,0,0,0
0,0,0,0,0,0,0,0,0,0,0,0,0,0,0,0,3277498,2023-11-24T00:00:00.000Z,214,2,Jrue Holiday,0,0,0,0,0,0
2,0,3,4,1,9,4,1,0,22,1,3,9,4,2,2,3277498,2023-11-24T00:00:00.000Z,378,2,Kristaps Porzingis,2,13,15,11,6,20.8
0,0,0,0,0,0,0,0,0,1,0,0,0,0,0,0,3277498,2023-11-24T00:00:00.000Z,3547279,2,Lamar Stevens,0,0,0,0,0,0
1,2,4,0,0,6,5,2,2,25,2,2,12,6,2,1,3277498,2023-11-24T00:00:00.000Z,261,2,Luke Kornet,4,18,19,13,7,31.7
0,0,0,0,0,0,0,0,0,0,0,0,0,0,0,0,3277498,2023-11-24T00:00:00.000Z,3547295,2,Nathan Knight,0,0,0,0,0,0
0,0,0,0,0,0,0,0,0,0,0,0,0,0,0,0,3277498,2023-11-24T00:00:00.000Z,17553967,2,Neemias Queta,0,0,0,0,0,0
0,0,0,0,0,0,0,2,0,5,0,2,0,0,0,0,3277498,2023-11-24T00:00:00.000Z,666468,2,Oshae Brissett,0,0,0,0,0,0
2,0,1,0,0,2,1,0,0,13,0,0,2,1,0,1,3277498,2023-11-24T00:00:00.000Z,3547276,2,Payton Pritchard,0,3,5,4,3,5.2
0,0,1,4,2,6,4,0,0,25,1,0,10,2,0,1,3277498,2023-11-24T00:00:00.000Z,17896060,2,Sam Hauser,0,12,12,10,2,11.4
0,0,0,0,0,0,0,0,0,0,0,0,0,0,0,0,3277498,2023-11-24T00:00:00.000Z,338,2,Svi Mykhailiuk,0,0,0,0,0,0
0,0,0,0,0,0,0,0,0,0,0,0,0,0,0,0,3277498,2023-11-24T00:00:00.000Z,666885,22,Admiral Schofield,0,0,0,0,0,0
0,0,1,0,0,1,0,0,0,6,0,1,0,1,0,1,3277498,2023-11-24T00:00:00.000Z,56677827,22,Anthony Black,0,1,1,0,1,0.2
0,0,1,0,0,0,0,0,0,9,1,0,0,2,1,0,3277498,2023-11-24T00:00:00.000Z,38017724,22,Caleb Houstan,1,2,2,0,2,5.4
0,0,0,0,0,0,0,0,0,0,0,0,0,0,0,0,3277498,2023-11-24T00:00:00.000Z,666818,22,Chuma Okeke,0,0,0,0,0,0
6,1,2,4,2,17,6,4,2,28,1,4,16,3,2,3,3277498,2023-11-24T00:00:00.000Z,3547251,22,Cole Anthony,3,19,25,22,9,34.6
6,1,7,6,1,17,8,0,0,35,0,2,17,7,0,3,3277498,2023-11-24T00:00:00.000Z,17896026,22,Franz Wagner,1,24,30,23,13,34.4
0,0,1,3,1,3,1,1,1,19,2,1,4,3,0,2,3277498,2023-11-24T00:00:00.000Z,196,22,Gary Harris,0,7,7,4,3,5.6
3,1,3,0,0,5,3,0,0,19,2,5,6,5,1,0,3277498,2023-11-24T00:00:00.000Z,666442,22,Goga Bitadze,2,11,14,9,8,22.5
1,0,4,4,3,8,3,2,1,28,0,2,10,4,1,3,3277498,2023-11-24T00:00:00.000Z,17896073,22,Jalen Suggs,1,14,15,11,5,16.3
0,0,0,0,0,0,0,0,0,0,0,0,0,0,0,0,3277498,2023-11-24T00:00:00.000Z,56677839,22,Jett Howard,0,0,0,0,0,0
2,0,4,1,1,3,2,0,0,21,1,1,5,5,0,2,3277498,2023-11-24T00:00:00.000Z,226,22,Joe Ingles,0,10,12,7,7,12
0,0,4,1,0,2,1,4,3,16,3,3,5,7,0,0,3277498,2023-11-24T00:00:00.000Z,229,22,Jonathan Isaac,0,12,12,5,7,13.4
0,0,0,0,0,0,0,0,0,0,0,0,0,0,0,0,3277498,2023-11-24T00:00:00.000Z,38017607,22,Kevon Harris,0,0,0,0,0,0
0,0,0,0,0,0,0,0,0,0,0,0,0,0,0,0,3277498,2023-11-24T00:00:00.000Z,165,22,Markelle Fultz,0,0,0,0,0,0
0,0,1,3,1,13,9,9,8,24,2,5,27,3,0,1,3277498,2023-11-24T00:00:00.000Z,462,22,Moritz Wagner,0,30,30,27,3,29.6
5,0,7,6,2,16,10,2,1,35,1,4,23,8,0,3,3277498,2023-11-24T00:00:00.000Z,38017683,22,Paolo Banchero,0,31,36,28,13,37.1
0,0,0,0,0,0,0,0,0,0,0,0,0,0,0,0,3277498,2023-11-24T00:00:00.000Z,17553983,22,Trevelin Queen,0,0,0,0,0,0
0,0,0,0,0,0,0,0,0,0,0,0,0,0,0,0,3277498,2023-11-24T00:00:00.000Z,85,22,Wendell Carter Jr.,0,0,0,0,0,0
1,1,3,0,0,5,3,0,0,29,1,3,6,4,0,1,3277499,2023-11-24T00:00:00.000Z,48,15,Bismack Biyombo,1,10,11,7,5,14.3
0,0,0,0,0,0,0,0,0,0,0,0,0,0,0,0,3277499,2023-11-24T00:00:00.000Z,666505,15,Brandon Clarke,0,0,0,0,0,0
0,1,4,4,2,9,5,3,2,27,0,0,14,4,2,2,3277499,2023-11-24T00:00:00.000Z,38017729,15,David Roddy,3,18,18,14,4,25.8
1,0,2,1,1,9,8,0,0,21,0,0,17,2,1,1,3277499,2023-11-24T00:00:00.000Z,401,15,Derrick Rose,1,19,20,18,3,22.9
10,0,5,5,0,12,3,0,0,34,0,3,6,5,1,3,3277499,2023-11-24T00:00:00.000Z,3547287,15,Desmond Bane,1,11,21,16,15,27
0,0,0,1,0,1,0,0,0,1,0,0,0,0,1,1,3277499,2023-11-24T00:00:00.000Z,56677830,15,GG Jackson,1,0,0,0,0,2
0,0,0,0,0,0,0,0,0,0,0,0,0,0,0,0,3277499,2023-11-24T00:00:00.000Z,666786,15,Ja Morant,0,0,0,0,0,0
5,0,0,4,1,5,2,1,1,23,0,2,6,0,0,2,3277499,2023-11-24T00:00:00.000Z,48248287,15,Jacob Gilyard,0,6,11,11,5,11.5
0,0,0,0,0,0,0,0,0,0,0,0,0,0,0,0,3277499,2023-11-24T00:00:00.000Z,38017728,15,Jake LaRavia,0,0,0,0,0,0
2,0,3,4,1,13,5,4,2,29,4,5,13,7,1,3,3277499,2023-11-24T00:00:00.000Z,231,15,Jaren Jackson Jr.,1,20,22,15,9,24.4
0,0,0,0,0,0,0,0,0,2,0,0,0,0,0,0,3277499,2023-11-24T00:00:00.000Z,666809,15,Jaylen Nowell,0,0,0,0,0,0
1,0,3,1,0,2,0,2,1,18,0,1,1,3,0,0,3277499,2023-11-24T00:00:00.000Z,666703,15,John Konchar,0,4,5,2,4,6.1
0,0,0,0,0,1,1,0,0,2,0,1,2,0,0,0,3277499,2023-11-24T00:00:00.000Z,38017732,15,Kenneth Lofton Jr.,0,2,2,2,0,2
0,0,0,0,0,0,0,0,0,0,0,0,0,0,0,0,3277499,2023-11-24T00:00:00.000Z,254,15,Luke Kennard,0,0,0,0,0,0
0,0,0,0,0,0,0,0,0,0,0,0,0,0,0,0,3277499,2023-11-24T00:00:00.000Z,420,15,Marcus Smart,0,0,0,0,0,0
0,0,4,10,3,20,9,0,0,36,1,2,21,5,0,0,3277499,2023-11-24T00:00:00.000Z,17896067,15,Santi Aldama,0,26,26,21,5,27
0,0,0,0,0,0,0,0,0,2,0,0,0,0,0,0,3277499,2023-11-24T00:00:00.000Z,199,15,Shaquille Harrison,0,0,0,0,0,0
0,0,0,0,0,0,0,0,0,0,0,0,0,0,0,0,3277499,2023-11-24T00:00:00.000Z,3,15,Steven Adams,0,0,0,0,0,0
1,0,5,2,1,2,1,0,0,14,0,4,3,5,0,0,3277499,2023-11-24T00:00:00.000Z,38017731,15,Vince Williams Jr.,0,8,9,4,6,10.5
0,0,0,0,0,0,0,0,0,0,0,0,0,0,0,0,3277499,2023-11-24T00:00:00.000Z,3547285,15,Xavier Tillman,0,0,0,0,0,0
1,0,0,1,0,1,0,0,0,2,0,1,0,0,0,0,3277499,2023-11-24T00:00:00.000Z,17896027,15,Ziaire Williams,0,0,1,1,1,1.5
0,0,0,0,0,0,0,0,0,0,0,0,0,0,0,0,3277499,2023-11-24T00:00:00.000Z,666451,24,Bol Bol,0,0,0,0,0,0
0,0,0,0,0,0,0,0,0,0,0,0,0,0,0,0,3277499,2023-11-24T00:00:00.000Z,37,24,Bradley Beal,0,0,0,0,0,0
1,0,2,1,0,3,1,2,1,15,0,2,3,2,0,0,3277499,2023-11-24T00:00:00.000Z,314,24,Chimezie Metu,0,5,6,4,3,6.9
0,0,0,0,0,0,0,0,0,0,0,0,0,0,0,0,3277499,2023-11-24T00:00:00.000Z,272,24,Damion Lee,0,0,0,0,0,0
4,1,4,4,3,21,15,9,7,33,1,3,40,5,4,5,3277499,2023-11-24T00:00:00.000Z,57,24,Devin Booker,5,45,49,44,9,62
0,0,0,0,0,0,0,0,0,0,0,0,0,0,0,0,3277499,2023-11-24T00:00:00.000Z,147,24,Drew Eubanks,0,0,0,0,0,0
2,0,1,11,4,15,6,4,4,34,0,0,20,1,0,2,3277499,2023-11-24T00:00:00.000Z,178,24,Eric Gordon,0,21,23,22,3,22.2
3,1,2,4,2,9,5,3,2,37,0,2,14,2,0,1,3277499,2023-11-24T00:00:00.000Z,8,24,Grayson Allen,1,16,19,17,5,22.9
2,0,3,3,1,8,6,1,1,20,2,0,14,5,1,1,3277499,2023-11-24T00:00:00.000Z,18678058,24,Jordan Goodwin,1,19,21,16,7,25
3,0,6,4,1,9,2,1,0,28,1,1,5,7,1,0,3277499,2023-11-24T00:00:00.000Z,356,24,Josh Okogie,1,12,15,8,10,20.9
6,2,9,2,0,4,2,4,2,33,1,2,6,10,2,2,3277499,2023-11-24T00:00:00.000Z,349,24,Jusuf Nurkic,4,16,22,12,16,37
1,2,3,1,0,5,2,2,2,24,1,0,6,4,1,0,3277499,2023-11-24T00:00:00.000Z,32,24,Keita Bates-Diop,3,10,11,7,5,21.3
0,0,0,0,0,0,0,0,0,0,0,0,0,0,0,0,3277499,2023-11-24T00:00:00.000Z,140,24,Kevin Durant,0,0,0,0,0,0
0,0,4,1,0,1,0,2,2,16,0,2,2,4,1,1,3277499,2023-11-24T00:00:00.000Z,666729,24,Nassir Little,1,6,6,2,4,8.8
0,0,0,0,0,0,0,0,0,0,0,0,0,0,0,0,3277499,2023-11-24T00:00:00.000Z,3547298,24,Saben Lee,0,0,0,0,0,0
0,0,0,0,0,0,0,0,0,0,0,0,0,0,0,0,3277499,2023-11-24T00:00:00.000Z,3547095,24,Udoka Azubuike,0,0,0,0,0,0
0,0,0,0,0,0,0,0,0,0,0,0,0,0,0,0,3277499,2023-11-24T00:00:00.000Z,470,24,Yuta Watanabe,0,0,0,0,0,0
2,0,10,1,0,16,8,6,5,35,2,4,21,12,2,2,3277500,2023-11-24T00:00:00.000Z,4,16,Bam Adebayo,2,33,35,23,14,42.4
1,0,3,3,0,5,1,0,0,18,0,3,2,3,1,0,3277500,2023-11-24T00:00:00.000Z,666747,16,Caleb Martin,1,5,6,3,4,10.1
2,0,0,2,0,3,0,0,0,6,0,0,0,0,0,0,3277500,2023-11-24T00:00:00.000Z,38017736,16,Cole Swider,0,0,2,2,2,3
0,0,0,0,0,0,0,0,0,0,0,0,0,0,0,0,3277500,2023-11-24T00:00:00.000Z,19465585,16,Dru Smith,0,0,0,0,0,0
0,0,0,0,0,0,0,0,0,0,0,0,0,0,0,0,3277500,2023-11-24T00:00:00.000Z,397,16,Duncan Robinson,0,0,0,0,0,0
3,0,3,5,1,6,1,2,2,24,0,1,5,3,2,2,3277500,2023-11-24T00:00:00.000Z,3092,16,Haywood Highsmith,2,8,11,8,6,17.1
4,0,2,6,1,17,6,2,2,35,3,3,15,5,1,0,3277500,2023-11-24T00:00:00.000Z,56677785,16,Jaime Jaquez Jr.,1,20,24,19,9,30
0,0,0,0,0,0,0,0,0,0,0,0,0,0,0,0,3277500,2023-11-24T00:00:00.000Z,38017734,16,Jamal Cain,0,0,0,0,0,0
3,0,2,5,3,14,7,6,6,37,0,1,23,2,1,2,3277500,2023-11-24T00:00:00.000Z,79,16,Jimmy Butler,1,25,28,26,5,30.9
2,0,1,4,2,10,5,3,3,34,1,3,15,2,2,2,3277500,2023-11-24T00:00:00.000Z,391,16,Josh Richardson,2,17,19,17,4,24.4
1,0,5,6,1,7,2,2,2,18,1,1,7,6,0,2,3277500,2023-11-24T00:00:00.000Z,285,16,Kevin Love,0,13,14,8,7,13.7
2,0,5,5,2,9,4,0,0,33,3,3,10,8,2,1,3277500,2023-11-24T00:00:00.000Z,286,16,Kyle Lowry,2,18,20,12,10,27.6
0,0,0,0,0,0,0,0,0,0,0,0,0,0,0,0,3277500,2023-11-24T00:00:00.000Z,38017696,16,Nikola Jovic,0,0,0,0,0,0
0,0,0,0,0,0,0,0,0,0,0,0,0,0,0,0,3277500,2023-11-24T00:00:00.000Z,39398582,16,Orlando Robinson,0,0,0,0,0,0
0,0,0,0,0,0,0,0,0,0,0,0,0,0,0,0,3277500,2023-11-24T00:00:00.000Z,3547257,16,R.J. Hampton,0,0,0,0,0,0
0,0,0,0,0,0,0,0,0,0,0,0,0,0,0,0,3277500,2023-11-24T00:00:00.000Z,74,16,Thomas Bryant,0,0,0,0,0,0
0,0,0,0,0,0,0,0,0,0,0,0,0,0,0,0,3277500,2023-11-24T00:00:00.000Z,666633,16,Tyler Herro,0,0,0,0,0,0
0,0,0,0,0,0,0,0,0,0,0,0,0,0,0,0,3277500,2023-11-24T00:00:00.000Z,666474,20,Charles Brown,0,0,0,0,0,0
0,0,0,0,0,0,0,0,0,0,0,0,0,0,0,0,3277500,2023-11-24T00:00:00.000Z,666675,20,DaQuan Jeffries,0,0,0,0,0,0
1,0,3,2,1,4,1,3,2,16,1,1,5,4,1,3,3277500,2023-11-24T00:00:00.000Z,131,20,Donte DiVincenzo,1,9,10,6,5,11.3
0,0,0,0,0,0,0,0,0,0,0,0,0,0,0,0,3277500,2023-11-24T00:00:00.000Z,17896089,20,Duane Washington Jr.,0,0,0,0,0,0
0,0,0,0,0,0,0,0,0,0,0,0,0,0,0,0,3277500,2023-11-24T00:00:00.000Z,666971,20,Dylan Windler,0,0,0,0,0,0
0,0,0,0,0,0,0,0,0,0,0,0,0,0,0,0,3277500,2023-11-24T00:00:00.000Z,160,20,Evan Fournier,0,0,0,0,0,0
2,1,4,8,4,17,8,0,0,26,0,1,20,4,0,2,3277500,2023-11-24T00:00:00.000Z,3547269,20,Immanuel Quickley,1,24,26,22,6,28.8
1,1,4,0,0,3,1,0,0,28,1,3,2,5,2,1,3277500,2023-11-24T00:00:00.000Z,201,20,Isaiah Hartenstein,3,7,8,3,6,17.5
0,0,0,0,0,0,0,0,0,0,0,0,0,0,0,0,3277500,2023-11-24T00:00:00.000Z,56677795,20,Jacob Toppin,0,0,0,0,0,0
3,0,3,4,1,16,10,5,3,34,0,1,24,3,0,2,3277500,2023-11-24T00:00:00.000Z,73,20,Jalen Brunson,0,27,30,27,6,30.1
0,0,0,0,0,0,0,0,0,0,0,0,0,0,0,0,3277500,2023-11-24T00:00:00.000Z,17896063,20,Jericho Sims,0,0,0,0,0,0
4,0,7,3,1,7,4,1,1,26,1,1,10,8,1,1,3277500,2023-11-24T00:00:00.000Z,202,20,Josh Hart,1,18,22,14,12,27.6
7,0,8,4,1,12,5,2,2,35,0,0,13,8,0,6,3277500,2023-11-24T00:00:00.000Z,387,20,Julius Randle,0,21,28,20,15,27.1
0,0,0,0,0,0,0,0,0,0,0,0,0,0,0,0,3277500,2023-11-24T00:00:00.000Z,17896033,20,Miles McBride,0,0,0,0,0,0
0,0,4,0,0,4,2,4,1,20,3,2,5,7,2,0,3277500,2023-11-24T00:00:00.000Z,399,20,Mitchell Robinson,2,12,12,5,7,19.4
2,0,0,3,1,4,1,0,0,21,0,3,3,0,1,0,3277500,2023-11-24T00:00:00.000Z,17895858,20,Quentin Grimes,1,3,5,5,2,9
1,0,7,5,1,14,7,3,3,34,0,2,18,7,0,3,3277500,2023-11-24T00:00:00.000Z,666423,20,RJ Barrett,0,25,26,19,8,24.9
0,0,0,0,0,0,0,0,0,0,0,0,0,0,0,0,3277500,2023-11-24T00:00:00.000Z,19,20,Ryan Arcidiacono,0,0,0,0,0,0
1,0,1,2,1,3,2,2,2,18,1,0,7,2,0,0,3277501,2023-11-24T00:00:00.000Z,89,5,Alex Caruso,0,9,10,8,3,10.9
0,0,2,0,0,4,1,0,0,6,3,2,2,5,0,0,3277501,2023-11-24T00:00:00.000Z,137,5,Andre Drummond,0,7,7,2,5,8
1,0,1,2,0,4,1,0,0,13,0,1,2,1,1,0,3277501,2023-11-24T00:00:00.000Z,17895983,5,Ayo Dosunmu,1,3,4,3,2,7.7
3,0,2,7,4,9,5,0,0,34,1,4,14,3,0,3,3277501,2023-11-24T00:00:00.000Z,666956,5,Coby White,0,17,20,17,6,19.1
4,1,3,1,0,16,7,9,5,39,0,3,19,3,1,2,3277501,2023-11-24T00:00:00.000Z,125,5,DeMar DeRozan,2,22,26,23,7,32.6
1,0,1,1,0,2,0,0,0,11,0,0,0,1,0,0,3277501,2023-11-24T00:00:00.000Z,87,5,Jevon Carter,0,1,2,1,2,2.7
5,0,8,2,1,8,4,0,0,36,0,3,9,8,1,1,3277501,2023-11-24T00:00:00.000Z,460,5,Nikola Vucevic,1,17,22,14,13,28.1
1,1,3,1,0,3,1,4,3,19,2,2,5,5,0,1,3277501,2023-11-24T00:00:00.000Z,110,5,Torrey Craig,1,10,11,6,6,14.5
3,0,4,8,4,23,16,0,0,38,0,4,36,4,1,5,3277501,2023-11-24T00:00:00.000Z,268,5,Zach LaVine,1,40,43,39,7,43.3
0,0,0,0,0,0,0,0,0,0,0,0,0,0,0,0,3277501,2023-11-24T00:00:00.000Z,38017710,28,Christian Koloko,0,0,0,0,0,0
2,0,1,9,4,13,6,0,0,20,0,3,16,1,1,0,3277501,2023-11-24T00:00:00.000Z,3089,28,Gary Trent Jr.,1,17,19,18,3,23.2
0,0,1,0,0,0,0,2,2,9,0,1,2,1,0,1,3277501,2023-11-24T00:00:00.000Z,56677828,28,Gradey Dick,0,3,3,2,1,2.2
1,0,1,2,0,2,0,2,2,14,0,1,2,1,1,1,3277501,2023-11-24T00:00:00.000Z,3547275,28,Malachi Flynn,1,3,4,3,2,6.7
0,0,0,0,0,0,0,0,0,0,0,0,0,0,0,0,3277501,2023-11-24T00:00:00.000Z,56677869,28,Markquis Nowell,0,0,0,0,0,0
0,0,0,0,0,0,0,0,0,0,0,0,0,0,0,0,3277501,2023-11-24T00:00:00.000Z,38017717,28,Ron Harper Jr.,0,0,0,0,0,0
1,1,2,3,2,6,2,0,0,14,0,1,6,2,1,2,3277502,2023-11-24T00:00:00.000Z,77,9,Alec Burks,2,8,9,7,3,13.9
3,1,5,0,0,5,4,0,0,30,1,2,8,6,0,1,3277502,2023-11-24T00:00:00.000Z,56677826,9,Ausar Thompson,1,14,17,11,9,21.7
0,0,0,0,0,0,0,0,0,0,0,0,0,0,0,0,3277502,2023-11-24T00:00:00.000Z,54,9,Bojan Bogdanovic,0,0,0,0,0,0
5,0,3,4,2,26,10,9,9,38,0,0,31,3,0,4,3277502,2023-11-24T00:00:00.000Z,17896075,9,Cade Cunningham,0,34,39,36,8,38.1
0,0,2,4,2,5,3,0,0,26,0,2,8,2,0,0,3277502,2023-11-24T00:00:00.000Z,17896071,9,Isaiah Livers,0,10,10,8,2,10.4
1,1,3,0,0,8,4,2,2,27,3,1,10,6,2,0,3277502,2023-11-24T00:00:00.000Z,3547267,9,Isaiah Stewart,3,16,17,11,7,27.7
3,1,0,6,1,16,9,9,6,32,2,3,25,2,1,3,3277502,2023-11-24T00:00:00.000Z,38017682,9,Jaden Ivey,2,27,30,28,5,34.9
4,1,9,1,0,10,5,4,3,29,4,5,13,13,1,2,3277502,2023-11-24T00:00:00.000Z,38017694,9,Jalen Duren,2,26,30,17,17,38.6
0,0,0,0,0,0,0,0,0,0,0,0,0,0,0,0,3277502,2023-11-24T00:00:00.000Z,3547240,9,James Wiseman,0,0,0,0,0,0
0,0,0,0,0,0,0,0,0,0,0,0,0,0,0,0,3277502,2023-11-24T00:00:00.000Z,42097199,9,Jared Rhoden,0,0,0,0,0,0
0,0,0,0,0,0,0,0,0,0,0,0,0,0,0,0,3277502,2023-11-24T00:00:00.000Z,197,9,Joe Harris,0,0,0,0,0,0
0,0,0,0,0,0,0,0,0,0,0,0,0,0,0,0,3277502,2023-11-24T00:00:00.000Z,259,9,Kevin Knox,0,0,0,0,0,0
3,0,1,0,0,6,3,0,0,17,0,0,6,1,0,0,3277502,2023-11-24T00:00:00.000Z,3547241,9,Killian Hayes,0,7,10,9,4,11.7
0,0,0,0,0,0,0,0,0,0,0,0,0,0,0,0,3277502,2023-11-24T00:00:00.000Z,56677729,9,Malcolm Cazalon,0,0,0,0,0,0
0,0,0,0,0,1,0,0,0,5,0,0,0,0,0,0,3277502,2023-11-24T00:00:00.000Z,56677792,9,Marcus Sasser,0,0,0,0,0,0
2,3,3,0,0,6,3,0,0,14,3,1,6,6,0,1,3277502,2023-11-24T00:00:00.000Z,24,9,Marvin Bagley III,3,12,14,8,8,24.2
0,0,0,0,0,0,0,0,0,0,0,0,0,0,0,0,3277502,2023-11-24T00:00:00.000Z,330,9,Monte Morris,0,0,0,0,0,0
0,2,1,0,0,1,0,0,0,8,1,3,0,2,1,1,3277502,2023-11-24T00:00:00.000Z,44477024,9,Stanley Umude,3,2,2,0,2,10.4
0,0,0,0,0,0,0,0,0,0,0,0,0,0,0,0,3277502,2023-11-24T00:00:00.000Z,3547250,12,Aaron Nesmith,0,0,0,0,0,0
4,0,0,3,1,13,6,1,0,20,3,1,13,3,1,2,3277502,2023-11-24T00:00:00.000Z,38017507,12,Andrew Nembhard,1,16,20,17,7,23.6
0,0,0,0,0,0,0,0,0,1,0,0,0,0,0,0,3277502,2023-11-24T00:00:00.000Z,56677861,12,Ben Sheppard,0,0,0,0,0,0
0,0,1,2,1,12,6,2,2,31,1,4,15,2,1,1,3277502,2023-11-24T00:00:00.000Z,38017686,12,Bennedict Mathurin,1,17,17,15,2,19.4
5,0,4,3,0,10,3,5,4,37,0,3,10,4,3,0,3277502,2023-11-24T00:00:00.000Z,69,12,Bruce Brown,3,14,19,15,9,31.3
0,0,4,6,3,10,6,3,3,28,0,2,18,4,0,0,3277502,2023-11-24T00:00:00.000Z,210,12,Buddy Hield,0,22,22,18,4,22.8
1,3,2,1,0,8,3,2,2,19,4,4,8,6,0,1,3277502,2023-11-24T00:00:00.000Z,17896035,12,Isaiah Jackson,3,14,15,9,7,24.7
0,0,0,0,0,0,0,0,0,0,0,0,0,0,0,0,3277502,2023-11-24T00:00:00.000Z,56677794,12,Isaiah Wong,0,0,0,0,0,0
0,0,5,2,2,3,2,2,2,21,1,1,8,6,1,1,3277502,2023-11-24T00:00:00.000Z,3547264,12,Jalen Smith,1,14,14,8,6,17.2
0,0,0,0,0,0,0,0,0,0,0,0,0,0,0,0,3277502,2023-11-24T00:00:00.000Z,56677832,12,Jarace Walker,0,0,0,0,0,0
0,0,0,0,0,0,0,0,0,0,0,0,0,0,0,0,3277502,2023-11-24T00:00:00.000Z,3547207,12,Jordan Nwora,0,0,0,0,0,0
0,0,0,0,0,0,0,0,0,0,0,0,0,0,0,0,3277502,2023-11-24T00:00:00.000Z,38017701,12,Kendall Brown,0,0,0,0,0,0
2,5,5,3,1,14,8,6,6,27,5,5,23,10,1,2,3277502,2023-11-24T00:00:00.000Z,452,12,Myles Turner,6,33,35,25,12,54
2,0,2,5,3,8,6,0,0,24,1,1,15,3,0,0,3277502,2023-11-24T00:00:00.000Z,3547243,12,Obi Toppin,0,18,20,17,5,21.6
0,0,0,0,0,0,0,0,0,0,0,0,0,0,0,0,3277502,2023-11-24T00:00:00.000Z,56677778,12,Oscar Tshiebwe,0,0,0,0,0,0
0,0,0,0,0,0,0,0,0,0,0,0,0,0,0,0,3277502,2023-11-24T00:00:00.000Z,304,12,T.J. McConnell,0,0,0,0,0,0
10,0,2,13,5,23,9,3,3,32,0,0,26,2,0,1,3277502,2023-11-24T00:00:00.000Z,3547245,12,Tyrese Haliburton,0,28,38,36,12,42.4
2,0,4,4,0,12,0,4,2,39,3,1,2,7,0,1,3277503,2023-11-24T00:00:00.000Z,177,8,Aaron Gordon,0,9,11,4,9,12.4
0,0,0,0,0,0,0,0,0,0,0,0,0,0,0,0,3277503,2023-11-24T00:00:00.000Z,17896007,8,Braxton Key,0,0,0,0,0,0
0,0,3,0,0,9,3,1,1,26,0,1,7,3,0,0,3277503,2023-11-24T00:00:00.000Z,38017709,8,Christian Braun,0,10,10,7,3,10.6
0,0,0,0,0,0,0,0,0,3,0,0,0,0,0,1,3277503,2023-11-24T00:00:00.000Z,38017727,8,Collin Gillespie,0,0,0,0,0,-1
0,0,0,0,0,0,0,0,0,0,0,0,0,0,0,0,3277503,2023-11-24T00:00:00.000Z,250,8,DeAndre Jordan,0,0,0,0,0,0
0,0,0,0,0,0,0,0,0,0,0,0,0,0,0,0,3277503,2023-11-24T00:00:00.000Z,56677871,8,Hunter Tyson,0,0,0,0,0,0
0,0,0,0,0,0,0,0,0,0,0,0,0,0,0,0,3277503,2023-11-24T00:00:00.000Z,56677582,8,Jalen Pickett,0,0,0,0,0,0
0,0,0,0,0,0,0,0,0,0,0,0,0,0,0,0,3277503,2023-11-24T00:00:00.000Z,335,8,Jamal Murray,0,0,0,0,0,0
0,0,0,0,0,0,0,0,0,0,0,0,0,0,0,0,3277503,2023-11-24T00:00:00.000Z,17896103,8,Jay Huff,0,0,0,0,0,0
0,0,0,0,0,0,0,0,0,6,0,1,0,0,0,0,3277503,2023-11-24T00:00:00.000Z,56677776,8,Julian Strawther,0,0,0,0,0,0
0,0,0,2,1,2,1,0,0,13,0,2,3,0,1,0,3277503,2023-11-24T00:00:00.000Z,215,8,Justin Holiday,1,3,3,3,0,6
3,0,2,5,1,15,7,5,5,39,3,4,20,5,3,2,3277503,2023-11-24T00:00:00.000Z,81,8,Kentavious Caldwell-Pope,3,25,28,23,8,37.5
1,2,6,8,2,14,6,0,0,37,1,1,14,7,1,1,3277503,2023-11-24T00:00:00.000Z,375,8,Michael Porter Jr.,3,21,22,15,8,31.9
8,0,13,8,3,31,14,11,7,42,6,3,38,19,2,3,3277503,2023-11-24T00:00:00.000Z,246,8,Nikola Jokic,2,57,65,46,27,75.8
0,1,0,1,0,3,0,0,0,6,1,1,0,1,0,0,3277503,2023-11-24T00:00:00.000Z,38017721,8,Peyton Watson,1,1,1,0,1,4.2
3,1,2,2,0,8,1,0,0,25,2,0,2,4,0,5,3277503,2023-11-24T00:00:00.000Z,236,8,Reggie Jackson,1,6,9,5,7,9.3
0,0,0,0,0,0,0,0,0,0,0,0,0,0,0,0,3277503,2023-11-24T00:00:00.000Z,666489,8,Vlatko Cancar,0,0,0,0,0,0
0,0,0,0,0,1,0,0,0,4,0,0,0,0,0,1,3277503,2023-11-24T00:00:00.000Z,3547268,8,Zeke Nnaji,0,0,0,0,0,-1
0,1,0,1,1,4,3,0,0,14,0,2,7,0,1,0,3277503,2023-11-24T00:00:00.000Z,213,11,Aaron Holiday,2,7,7,7,0,13
8,1,13,4,0,19,8,6,5,43,1,4,21,14,2,5,3277503,2023-11-24T00:00:00.000Z,17896062,11,Alperen Sengun,3,35,43,29,22,53.8
0,0,0,0,0,0,0,0,0,0,0,0,0,0,0,0,3277503,2023-11-24T00:00:00.000Z,56677825,11,Amen Thompson,0,0,0,0,0,0
0,0,0,0,0,0,0,0,0,0,0,0,0,0,0,0,3277503,2023-11-24T00:00:00.000Z,296,11,Boban Marjanovic,0,0,0,0,0,0
0,0,0,0,0,0,0,0,0,0,0,0,0,0,0,0,3277503,2023-11-24T00:00:00.000Z,56677831,11,Cam Whitmore,0,0,0,0,0,0
2,0,1,3,2,8,2,2,2,30,1,4,8,2,0,2,3277503,2023-11-24T00:00:00.000Z,66,11,Dillon Brooks,0,10,12,10,4,11.4
11,2,6,5,3,12,6,2,2,39,0,3,17,6,1,1,3277503,2023-11-24T00:00:00.000Z,458,11,Fred VanVleet,3,23,34,28,17,48.7
1,1,11,3,2,9,6,2,2,38,3,2,16,14,1,1,3277503,2023-11-24T00:00:00.000Z,38017684,11,Jabari Smith Jr.,2,30,31,17,15,39.3
0,1,3,1,0,4,2,0,0,16,0,4,4,3,0,1,3277503,2023-11-24T00:00:00.000Z,3547301,11,Jae'Sean Tate,1,7,7,4,3,9.6
2,0,6,8,3,18,10,3,2,36,0,0,25,6,2,3,3277503,2023-11-24T00:00:00.000Z,17895966,11,Jalen Green,2,31,33,27,8,38.2
0,0,0,0,0,0,0,0,0,0,0,0,0,0,0,0,3277503,2023-11-24T00:00:00.000Z,47738533,11,Jeenathan Williams,0,0,0,0,0,0
0,3,0,2,0,2,0,0,0,8,0,0,0,0,0,0,3277503,2023-11-24T00:00:00.000Z,188,11,Jeff Green,3,0,0,0,0,9
0,0,0,0,0,0,0,0,0,0,0,0,0,0,0,0,3277503,2023-11-24T00:00:00.000Z,56677809,11,Jermaine Samuels Jr.,0,0,0,0,0,0
0,0,0,0,0,0,0,0,0,0,0,0,0,0,0,0,3277503,2023-11-24T00:00:00.000Z,19465326,11,Jock Landale,0,0,0,0,0,0
0,0,0,0,0,0,0,0,0,0,0,0,0,0,0,0,3277503,2023-11-24T00:00:00.000Z,3547281,11,Nate Hinton,0,0,0,0,0,0
0,0,0,0,0,0,0,0,0,0,0,0,0,0,0,0,3277503,2023-11-24T00:00:00.000Z,75,11,Reggie Bullock,0,0,0,0,0,0
1,0,3,2,1,6,3,0,0,16,1,2,7,4,1,0,3277503,2023-11-24T00:00:00.000Z,38017695,11,Tari Eason,1,11,12,8,5,16.3
0,0,0,0,0,0,0,0,0,0,0,0,0,0,0,0,3277503,2023-11-24T00:00:00.000Z,357,11,Victor Oladipo,0,0,0,0,0,0
0,0,0,4,1,4,1,0,0,4,0,0,3,0,0,0,3277504,2023-11-24T00:00:00.000Z,38017733,17,A.J. Green,0,3,3,3,0,3
1,0,1,0,0,0,0,0,0,9,0,4,0,1,0,0,3277504,2023-11-24T00:00:00.000Z,56677852,17,Andre Jackson Jr.,0,1,2,1,2,2.7
1,1,4,1,0,5,1,0,0,25,2,3,2,6,0,0,3277504,2023-11-24T00:00:00.000Z,377,17,Bobby Portis,1,8,9,3,7,13.7
1,3,5,7,4,17,14,7,7,32,0,2,39,5,2,1,3277504,2023-11-24T00:00:00.000Z,283,17,Brook Lopez,5,44,45,40,6,60.5
3,0,3,2,0,4,2,0,0,17,0,3,4,3,0,0,3277504,2023-11-24T00:00:00.000Z,368,17,Cameron Payne,0,7,10,7,6,12.1
0,0,0,0,0,0,0,0,0,0,0,0,0,0,0,0,3277504,2023-11-24T00:00:00.000Z,56677854,17,Chris Livingston,0,0,0,0,0,0
10,0,6,5,2,18,11,8,7,37,1,1,31,7,0,1,3277504,2023-11-24T00:00:00.000Z,278,17,Damian Lillard,0,38,48,41,17,53.4
3,1,6,0,0,19,11,12,9,37,3,2,31,9,3,3,3277504,2023-11-24T00:00:00.000Z,15,17,Giannis Antetokounmpo,4,40,43,34,12,55.3
0,0,0,0,0,0,0,0,0,0,0,0,0,0,0,0,3277504,2023-11-24T00:00:00.000Z,112,17,Jae Crowder,0,0,0,0,0,0
5,0,1,3,1,8,3,0,0,13,0,1,7,1,0,1,3277504,2023-11-24T00:00:00.000Z,315,17,Khris Middleton,0,8,13,12,6,14.7
0,0,0,0,0,0,0,0,0,0,0,0,0,0,0,0,3277504,2023-11-24T00:00:00.000Z,666960,17,Lindell Wigginton,0,0,0,0,0,0
1,1,7,4,1,8,4,0,0,27,4,3,9,11,0,2,3277504,2023-11-24T00:00:00.000Z,38,17,Malik Beasley,1,20,21,10,12,24.7
2,0,3,2,0,4,0,4,3,13,0,2,3,3,0,0,3277504,2023-11-24T00:00:00.000Z,38017676,17,MarJon Beauchamp,0,6,8,5,5,9.6
0,0,0,0,0,0,0,0,0,0,0,0,0,0,0,0,3277504,2023-11-24T00:00:00.000Z,666453,17,Marques Bolden,0,0,0,0,0,0
1,0,4,3,0,5,1,2,0,26,0,1,2,4,1,1,3277504,2023-11-24T00:00:00.000Z,105,17,Pat Connaughton,1,6,7,3,5,10.3
0,0,0,0,0,0,0,0,0,0,0,0,0,0,0,0,3277504,2023-11-24T00:00:00.000Z,284,17,Robin Lopez,0,0,0,0,0,0
0,0,0,0,0,0,0,0,0,0,0,0,0,0,0,0,3277504,2023-11-24T00:00:00.000Z,2148,17,Thanasis Antetokounmpo,0,0,0,0,0,0
0,0,0,0,0,0,0,0,0,0,0,0,0,0,0,0,3277504,2023-11-24T00:00:00.000Z,38017691,17,TyTy Washington Jr.,0,0,0,0,0,0
0,0,0,0,0,0,0,0,0,0,0,0,0,0,0,0,3277504,2023-11-24T00:00:00.000Z,3547302,30,Anthony Gill,0,0,0,0,0,0
0,0,0,0,0,0,0,0,0,0,0,0,0,0,0,0,3277504,2023-11-24T00:00:00.000Z,56677844,30,Bilal Coulibaly,0,0,0,0,0,0
1,0,5,10,6,12,7,0,0,33,0,3,20,5,0,3,3277504,2023-11-24T00:00:00.000Z,17896045,30,Corey Kispert,0,25,26,21,6,24.5
4,2,4,0,0,6,3,3,2,29,5,5,8,9,1,1,3277504,2023-11-24T00:00:00.000Z,666577,30,Daniel Gafford,3,17,21,12,13,32.8
1,0,4,2,1,5,2,2,2,18,0,2,7,4,0,0,3277504,2023-11-24T00:00:00.000Z,167,30,Danilo Gallinari,0,11,12,8,5,13.3
0,0,0,0,0,0,0,0,0,0,0,0,0,0,0,0,3277504,2023-11-24T00:00:00.000Z,487,30,Delon Wright,0,0,0,0,0,0
5,0,3,0,0,6,1,0,0,28,2,3,2,5,0,0,3277504,2023-11-24T00:00:00.000Z,3547242,30,Deni Avdija,0,7,12,7,10,15.5
0,0,0,0,0,0,0,0,0,0,0,0,0,0,0,0,3277504,2023-11-24T00:00:00.000Z,17896106,30,Eugene Omoruyi,0,0,0,0,0,0
0,0,0,0,0,0,0,0,0,0,0,0,0,0,0,0,3277504,2023-11-24T00:00:00.000Z,18677954,30,Jared Butler,0,0,0,0,0,0
0,0,0,0,0,0,0,0,0,0,0,0,0,0,0,0,3277504,2023-11-24T00:00:00.000Z,38124126,30,John Butler Jr.,0,0,0,0,0,0
0,0,2,0,0,4,2,2,2,12,3,1,6,5,0,1,3277504,2023-11-24T00:00:00.000Z,38017687,30,Johnny Davis,0,11,11,6,5,11
7,0,4,6,1,20,9,9,7,34,1,5,26,5,0,2,3277504,2023-11-24T00:00:00.000Z,666848,30,Jordan Poole,0,31,38,33,12,40.5
4,2,3,8,3,22,9,1,1,31,1,3,22,4,0,1,3277504,2023-11-24T00:00:00.000Z,265,30,Kyle Kuzma,2,26,30,26,8,37.8
0,0,2,7,3,11,6,1,0,24,0,2,15,2,1,0,3277504,2023-11-24T00:00:00.000Z,414,30,Landry Shamet,1,17,17,15,2,20.4
0,0,0,0,0,0,0,0,0,0,0,0,0,0,0,0,3277504,2023-11-24T00:00:00.000Z,337,30,Mike Muscala,0,0,0,0,0,0
0,0,0,0,0,0,0,0,0,0,0,0,0,0,0,0,3277504,2023-11-24T00:00:00.000Z,38017704,30,Patrick Baldwin Jr.,0,0,0,0,0,0
0,0,0,0,0,0,0,0,0,0,0,0,0,0,0,0,3277504,2023-11-24T00:00:00.000Z,38017712,30,Ryan Rollins,0,0,0,0,0,0
7,0,7,4,1,14,9,3,3,31,0,0,22,7,1,0,3277504,2023-11-24T00:00:00.000Z,249,30,Tyus Jones,1,29,36,29,14,43.9
5,2,7,9,2,21,8,18,17,40,0,2,35,7,2,4,3277505,2023-11-24T00:00:00.000Z,3547238,18,Anthony Edwards,4,42,47,40,12,58.9
0,0,0,0,0,0,0,0,0,0,0,0,0,0,0,0,3277505,2023-11-24T00:00:00.000Z,17895968,18,Daishen Nix,0,0,0,0,0,0
0,0,0,0,0,0,0,0,0,0,0,0,0,0,0,0,3277505,2023-11-24T00:00:00.000Z,3547259,18,Jaden McDaniels,0,0,0,0,0,0
0,0,0,0,0,0,0,0,0,0,0,0,0,0,0,0,3277505,2023-11-24T00:00:00.000Z,56677851,18,Jaylen Clark,0,0,0,0,0,0
0,0,0,0,0,0,0,0,0,0,0,0,0,0,0,0,3277505,2023-11-24T00:00:00.000Z,666767,18,Jordan McLaughlin,0,0,0,0,0,0
0,0,0,0,0,0,0,0,0,0,0,0,0,0,0,0,3277505,2023-11-24T00:00:00.000Z,38017715,18,Josh Minott,0,0,0,0,0,0
4,0,10,5,4,15,9,5,5,38,1,3,27,11,0,4,3277505,2023-11-24T00:00:00.000Z,447,18,Karl-Anthony Towns,0,38,42,31,15,42.2
4,0,1,0,0,2,1,2,2,18,0,1,4,1,0,0,3277505,2023-11-24T00:00:00.000Z,12,18,Kyle Anderson,0,5,9,8,5,11.2
0,0,0,0,0,0,0,0,0,0,0,0,0,0,0,0,3277505,2023-11-24T00:00:00.000Z,56677782,18,Leonard Miller,0,0,0,0,0,0
0,0,0,0,0,0,0,0,0,0,0,0,0,0,0,0,3277505,2023-11-24T00:00:00.000Z,17896056,18,Luka Garza,0,0,0,0,0,0
8,0,2,3,2,7,2,0,0,30,1,1,6,3,1,1,3277505,2023-11-24T00:00:00.000Z,104,18,Mike Conley,1,9,17,14,11,23.6
0,1,1,3,1,7,4,0,0,18,0,0,9,1,0,3,3277505,2023-11-24T00:00:00.000Z,667378,18,Naz Reid,1,10,10,9,1,10.2
2,1,0,7,2,8,2,0,0,22,1,4,6,1,2,0,3277505,2023-11-24T00:00:00.000Z,666400,18,Nickeil Alexander-Walker,3,7,9,8,3,19.2
0,2,8,0,0,8,5,2,2,36,3,5,12,11,0,3,3277505,2023-11-24T00:00:00.000Z,176,18,Rudy Gobert,2,23,23,12,11,28.2
1,1,1,1,0,6,1,0,0,13,1,1,2,2,1,3,3277505,2023-11-24T00:00:00.000Z,320,18,Shake Milton,2,4,5,3,3,8.9
0,1,4,5,1,8,4,2,1,25,3,1,10,7,0,0,3277505,2023-11-24T00:00:00.000Z,68,18,Troy Brown Jr.,1,17,17,10,7,21.4
0,0,0,0,0,0,0,0,0,0,0,0,0,0,0,0,3277505,2023-11-24T00:00:00.000Z,38017700,18,Wendell Moore Jr.,0,0,0,0,0,0
0,0,0,0,0,0,0,0,0,0,0,0,0,0,0,0,3277505,2023-11-24T00:00:00.000Z,4197162,26,Aleksandar Vezenkov,0,0,0,0,0,0
0,0,0,0,0,0,0,0,0,0,0,0,0,0,0,0,3277505,2023-11-24T00:00:00.000Z,273,26,Alex Len,0,0,0,0,0,0
0,0,3,2,0,3,0,0,0,22,2,3,0,5,1,2,3277505,2023-11-24T00:00:00.000Z,17896030,26,Chris Duarte,1,5,5,0,5,7
0,0,0,0,0,0,0,0,0,0,0,0,0,0,0,0,3277505,2023-11-24T00:00:00.000Z,56677845,26,Colby Jones,0,0,0,0,0,0
1,0,0,1,1,2,2,0,0,9,0,1,5,0,0,1,3277505,2023-11-24T00:00:00.000Z,17553994,26,Davion Mitchell,0,5,6,6,1,5.5
12,0,5,7,3,32,14,6,5,37,2,3,36,7,1,2,3277505,2023-11-24T00:00:00.000Z,161,26,De'Aaron Fox,1,43,55,48,19,63.4
5,3,6,1,1,15,7,1,0,39,5,6,15,11,3,2,3277505,2023-11-24T00:00:00.000Z,406,26,Domantas Sabonis,6,26,31,20,16,51.7
0,0,0,0,0,0,0,0,0,0,0,0,0,0,0,0,3277505,2023-11-24T00:00:00.000Z,17895941,26,Filip Petrusev,0,0,0,0,0,0
2,0,4,4,2,11,7,2,2,33,0,0,18,4,0,2,3277505,2023-11-24T00:00:00.000Z,30,26,Harrison Barnes,0,22,24,20,6,23.8
0,0,0,0,0,0,0,0,0,0,0,0,0,0,0,0,3277505,2023-11-24T00:00:00.000Z,56677862,26,Jalen Slawson,0,0,0,0,0,0
1,0,4,0,0,2,2,0,0,8,2,1,4,6,0,0,3277505,2023-11-24T00:00:00.000Z,306,26,JaVale McGee,0,10,11,5,7,12.7
0,0,0,0,0,0,0,0,0,0,0,0,0,0,0,0,3277505,2023-11-24T00:00:00.000Z,17895990,26,Jordan Ford,0,0,0,0,0,0
0,0,0,0,0,0,0,0,0,0,0,0,0,0,0,0,3277505,2023-11-24T00:00:00.000Z,38017688,26,Keegan Murray,0,0,0,0,0,0
0,0,0,0,0,0,0,0,0,0,0,0,0,0,0,0,3277505,2023-11-24T00:00:00.000Z,38017714,26,Keon Ellis,0,0,0,0,0,0
1,0,1,3,2,7,4,0,0,18,1,1,10,2,1,0,3277505,2023-11-24T00:00:00.000Z,17896044,26,Kessler Edwards,1,12,13,11,3,16.9
3,1,1,5,2,8,4,0,0,25,1,1,10,2,0,0,3277505,2023-11-24T00:00:00.000Z,221,26,Kevin Huerter,1,12,15,13,5,19.9
0,0,2,6,3,14,6,2,2,30,0,2,17,2,1,3,3277505,2023-11-24T00:00:00.000Z,324,26,Malik Monk,1,19,19,17,2,19.4
0,0,6,6,3,6,3,0,0,19,1,1,9,7,0,1,3277505,2023-11-24T00:00:00.000Z,290,26,Trey Lyles,0,16,16,9,7,16.4
0,0,4,4,2,10,4,0,0,25,0,3,10,4,0,3,3277506,2023-11-24T00:00:00.000Z,475,10,Andrew Wiggins,0,14,14,10,4,11.8
2,0,2,2,0,5,0,0,0,12,1,0,0,3,0,1,3277506,2023-11-24T00:00:00.000Z,56677858,10,Brandin Podziemski,0,3,5,2,5,5.6
10,0,5,3,1,6,2,0,0,29,0,2,5,5,0,1,3277506,2023-11-24T00:00:00.000Z,367,10,Chris Paul,0,10,20,15,15,25
0,0,0,0,0,0,0,0,0,0,0,0,0,0,0,0,3277506,2023-11-24T00:00:00.000Z,251,10,Cory Joseph,0,0,0,0,0,0
4,0,5,7,4,11,7,2,2,26,2,3,20,7,2,3,3277506,2023-11-24T00:00:00.000Z,407,10,Dario Saric,2,27,31,24,11,37.4
0,0,0,0,0,0,0,0,0,0,0,0,0,0,0,0,3277506,2023-11-24T00:00:00.000Z,185,10,Draymond Green,0,0,0,0,0,0
0,1,3,1,0,3,2,0,0,18,0,4,4,3,1,2,3277506,2023-11-24T00:00:00.000Z,2189,10,Gary Payton II,2,7,7,4,3,11.6
0,0,0,0,0,0,0,0,0,0,0,0,0,0,0,0,3277506,2023-11-24T00:00:00.000Z,57875092,10,Gui Santos,0,0,0,0,0,0
0,0,0,0,0,0,0,0,0,0,0,0,0,0,0,0,3277506,2023-11-24T00:00:00.000Z,398,10,Jerome Robinson,0,0,0,0,0,0
2,0,1,2,1,7,5,2,1,20,0,0,12,1,0,1,3277506,2023-11-24T00:00:00.000Z,17553979,10,Jonathan Kuminga,0,13,15,14,3,15.2
4,0,7,0,0,3,2,3,2,24,1,3,6,8,2,2,3277506,2023-11-24T00:00:00.000Z,282,10,Kevon Looney,2,14,18,10,12,25.6
6,0,2,7,3,11,3,7,6,29,1,3,15,3,1,2,3277506,2023-11-24T00:00:00.000Z,443,10,Klay Thompson,1,18,24,21,9,28.6
0,0,0,0,0,0,0,0,0,0,0,0,0,0,0,0,3277506,2023-11-24T00:00:00.000Z,45658838,10,Lester Quinones,0,0,0,0,0,0
1,0,2,1,1,4,4,2,0,17,2,0,9,4,0,2,3277506,2023-11-24T00:00:00.000Z,17553992,10,Moses Moody,0,13,14,10,5,13.3
6,0,3,13,7,20,11,6,6,35,0,2,35,3,1,6,3277506,2023-11-24T00:00:00.000Z,115,10,Stephen Curry,1,38,44,41,9,44.6
0,1,0,0,0,1,0,2,2,5,0,1,2,0,0,1,3277506,2023-11-24T00:00:00.000Z,56677799,10,Trayce Jackson-Davis,1,2,2,2,0,4
0,0,0,0,0,0,0,0,0,0,0,0,0,0,0,0,3277506,2023-11-24T00:00:00.000Z,17896070,10,Usman Garuba,0,0,0,0,0,0
0,0,0,0,0,0,0,0,0,0,0,0,0,0,0,0,3277506,2023-11-24T00:00:00.000Z,38017693,27,Blake Wesley,0,0,0,0,0,0
0,0,0,6,1,11,5,0,0,18,1,3,11,1,0,1,3277506,2023-11-24T00:00:00.000Z,359,27,Cedi Osman,0,12,12,11,1,11.2
2,1,0,0,0,0,0,0,0,7,0,0,0,0,0,0,3277506,2023-11-24T00:00:00.000Z,17895854,27,Charles Bassey,1,0,2,2,2,6
0,0,0,0,0,0,0,0,0,0,0,0,0,0,0,0,3277506,2023-11-24T00:00:00.000Z,56677865,27,Charles Bediako,0,0,0,0,0,0
1,0,3,10,4,19,10,0,0,27,1,2,24,4,1,2,3277506,2023-11-24T00:00:00.000Z,3547246,27,Devin Vassell,1,28,29,25,5,31.3
0,0,0,0,0,0,0,0,0,0,0,0,0,0,0,0,3277506,2023-11-24T00:00:00.000Z,180,27,Devonte' Graham,0,0,0,0,0,0
0,0,0,0,0,0,0,0,0,0,0,0,0,0,0,0,3277506,2023-11-24T00:00:00.000Z,38017730,27,Dominick Barlow,0,0,0,0,0,0
4,0,0,3,1,6,3,0,0,19,1,0,7,1,3,0,3277506,2023-11-24T00:00:00.000Z,305,27,Doug McDermott,3,8,12,11,5,23.2
4,0,3,2,1,7,3,0,0,33,3,2,7,6,0,2,3277506,2023-11-24T00:00:00.000Z,38017699,27,Jeremy Sochan,0,13,17,11,10,18.2
0,0,0,0,0,0,0,0,0,0,0,0,0,0,0,0,3277506,2023-11-24T00:00:00.000Z,38017649,27,Julian Champagnie,0,0,0,0,0,0
4,0,8,7,3,13,8,5,3,34,4,3,22,12,2,3,3277506,2023-11-24T00:00:00.000Z,666682,27,Keldon Johnson,2,34,38,26,16,45.4
1,0,0,5,0,9,3,0,0,19,0,2,6,0,1,1,3277506,2023-11-24T00:00:00.000Z,38017692,27,Malaki Branham,1,6,7,7,1,9.5
0,0,0,0,0,0,0,0,0,0,0,0,0,0,0,0,3277506,2023-11-24T00:00:00.000Z,17896059,27,Sandro Mamukelashvili,0,0,0,0,0,0
0,0,0,0,0,0,0,0,0,0,0,0,0,0,0,0,3277506,2023-11-24T00:00:00.000Z,56677817,27,Sidy Cissoko,0,0,0,0,0,0
0,0,0,0,0,0,0,0,0,0,0,0,0,0,0,0,3277506,2023-11-24T00:00:00.000Z,56677870,27,Sir'Jabari Rice,0,0,0,0,0,0
2,0,5,1,1,5,3,0,0,17,0,1,7,5,2,1,3277506,2023-11-24T00:00:00.000Z,3547274,27,Tre Jones,2,12,14,9,7,21
4,2,7,6,1,18,8,5,5,35,2,2,22,9,1,6,3277506,2023-11-24T00:00:00.000Z,56677822,27,Victor Wembanyama,3,31,35,26,13,41.8
6,0,5,7,0,12,2,2,2,31,3,3,6,8,0,3,3277506,2023-11-24T00:00:00.000Z,102,27,Zach Collins,0,14,20,12,14,21.6
0,0,0,0,0,0,0,0,0,0,0,0,0,0,0,0,3277507,2023-11-24T00:00:00.000Z,666511,13,Amir Coffey,0,0,0,0,0,0
0,0,0,0,0,0,0,0,0,0,0,0,0,0,0,0,3277507,2023-11-24T00:00:00.000Z,17896022,13,Brandon Boston Jr.,0,0,0,0,0,0
2,3,4,2,1,3,1,0,0,21,0,2,3,4,0,1,3277507,2023-11-24T00:00:00.000Z,439,13,Daniel Theis,3,7,9,5,6,18.8
0,1,2,0,0,6,5,1,1,21,3,4,11,5,0,4,3277507,2023-11-24T00:00:00.000Z,493,13,Ivica Zubac,1,16,16,11,5,16
10,1,5,6,1,8,2,6,3,37,0,3,8,5,4,3,3277507,2023-11-24T00:00:00.000Z,192,13,James Harden,5,13,23,18,15,41
0,0,0,0,0,0,0,0,0,0,0,0,0,0,0,0,3277507,2023-11-24T00:00:00.000Z,56677856,13,Jordan Miller,0,0,0,0,0,0
0,0,0,0,0,0,0,0,0,0,0,0,0,0,0,0,3277507,2023-11-24T00:00:00.000Z,17896051,13,Joshua Primo,0,0,0,0,0,0
3,1,7,7,1,17,8,4,3,34,1,0,20,8,1,1,3277507,2023-11-24T00:00:00.000Z,274,13,Kawhi Leonard,2,28,31,23,11,39.1
0,0,0,0,0,0,0,0,0,0,0,0,0,0,0,0,3277507,2023-11-24T00:00:00.000Z,56677849,13,Kobe Brown,0,0,0,0,0,0
0,0,0,0,0,0,0,0,0,0,0,0,0,0,0,0,3277507,2023-11-24T00:00:00.000Z,371,13,Mason Plumlee,0,0,0,0,0,0
0,0,0,0,0,0,0,0,0,0,0,0,0,0,0,0,3277507,2023-11-24T00:00:00.000Z,38017725,13,Moussa Diabate,0,0,0,0,0,0
0,0,0,0,0,0,0,0,0,0,0,0,0,0,0,0,3277507,2023-11-24T00:00:00.000Z,17896031,13,Nah'Shon Hyland,0,0,0,0,0,0
0,0,1,5,3,14,8,1,1,28,0,1,20,1,3,0,3277507,2023-11-24T00:00:00.000Z,380,13,Norman Powell,3,21,21,20,1,30.2
2,0,7,12,4,30,14,3,2,39,1,3,34,8,0,2,3277507,2023-11-24T00:00:00.000Z,172,13,Paul George,0,42,44,36,10,44.6
3,0,0,2,0,2,0,0,0,22,2,4,0,2,1,0,3277507,2023-11-24T00:00:00.000Z,450,13,PJ Tucker,1,2,5,3,5,9.9
2,1,3,2,0,8,1,2,1,14,1,2,3,4,0,0,3277507,2023-11-24T00:00:00.000Z,472,13,Russell Westbrook,1,7,9,5,6,13.8
5,1,2,1,1,4,3,0,0,24,0,5,7,2,2,0,3277507,2023-11-24T00:00:00.000Z,666743,13,Terance Mann,3,9,14,12,7,25.9
0,0,0,0,0,0,0,0,0,0,0,0,0,0,0,0,3277507,2023-11-24T00:00:00.000Z,24417679,13,Xavier Moon,0,0,0,0,0,0
5,0,4,5,2,21,12,6,4,35,0,3,30,4,0,3,3277507,2023-11-24T00:00:00.000Z,227,19,Brandon Ingram,0,34,39,35,9,39.3
0,0,0,0,0,0,0,0,0,0,0,0,0,0,0,0,3277507,2023-11-24T00:00:00.000Z,303,19,CJ McCollum,0,0,0,0,0,0
0,0,0,0,0,0,0,0,0,0,0,0,0,0,0,0,3277507,2023-11-24T00:00:00.000Z,491,19,Cody Zeller,0,0,0,0,0,0
0,0,0,0,0,0,0,0,0,0,0,0,0,0,0,0,3277507,2023-11-24T00:00:00.000Z,38017726,19,Dereon Seabron,0,0,0,0,0,0
5,1,6,2,1,7,3,0,0,36,2,2,7,8,1,1,3277507,2023-11-24T00:00:00.000Z,38017677,19,Dyson Daniels,2,15,20,12,13,29.1
0,0,0,0,0,0,0,0,0,0,0,0,0,0,0,0,3277507,2023-11-24T00:00:00.000Z,38017663,19,E.J. Liddell,0,0,0,0,0,0
4,1,2,4,3,7,5,2,1,24,2,5,14,4,1,3,3277507,2023-11-24T00:00:00.000Z,17896024,19,Herbert Jones,2,18,22,18,8,27.8
0,0,0,0,0,0,0,0,0,0,0,0,0,0,0,0,3277507,2023-11-24T00:00:00.000Z,17896021,19,Jeremiah Robinson-Earl,0,0,0,0,0,0
4,0,6,2,2,6,4,2,2,28,2,4,12,8,1,1,3277507,2023-11-24T00:00:00.000Z,455,19,Jonas Valanciunas,1,20,24,16,12,29.6
1,0,4,4,2,5,3,0,0,20,0,1,8,4,0,0,3277507,2023-11-24T00:00:00.000Z,56677837,19,Jordan Hawkins,0,12,13,9,5,14.3
1,0,4,2,0,6,1,2,2,16,1,0,4,5,1,1,3277507,2023-11-24T00:00:00.000Z,17896097,19,Jose Alvarado,1,9,10,5,6,13.5
0,0,0,0,0,0,0,0,0,0,0,0,0,0,0,0,3277507,2023-11-24T00:00:00.000Z,3547260,19,Kira Lewis Jr.,0,0,0,0,0,0
0,3,1,1,0,4,2,0,0,20,1,1,4,2,0,1,3277507,2023-11-24T00:00:00.000Z,340,19,Larry Nance Jr.,3,6,6,4,2,14.4
0,0,0,0,0,0,0,0,0,0,0,0,0,0,0,0,3277507,2023-11-24T00:00:00.000Z,17896017,19,Matt Ryan,0,0,0,0,0,0
1,0,6,3,0,7,0,6,5,27,2,1,5,8,0,0,3277507,2023-11-24T00:00:00.000Z,3547293,19,Naji Marshall,0,13,14,6,9,16.1
0,0,0,0,0,0,0,0,0,0,0,0,0,0,0,0,3277507,2023-11-24T00:00:00.000Z,18677986,19,Trey Murphy III,0,0,0,0,0,0
5,0,4,1,0,25,13,9,6,34,2,2,32,6,2,5,3277507,2023-11-24T00:00:00.000Z,666969,19,Zion Williamson,2,38,43,37,11,47.7
1,0,1,3,1,4,2,4,2,20,2,1,7,3,0,0,1037823,2023-11-25T00:00:00.000Z,17896078,21,Aaron Wiggins,0,10,11,8,4,12.1
0,0,0,0,0,0,0,0,0,0,0,0,0,0,0,0,1037823,2023-11-25T00:00:00.000Z,3547271,21,Aleksej Pokusevski,0,0,0,0,0,0
1,0,0,0,0,2,0,0,0,14,1,1,0,1,0,0,1037823,2023-11-25T00:00:00.000Z,56677833,21,Cason Wallace,0,1,2,1,2,2.7
2,3,5,11,5,21,13,2,2,31,1,3,33,6,0,1,1037823,2023-11-25T00:00:00.000Z,38017685,21,Chet Holmgren,3,39,41,35,8,51.2
1,0,1,2,1,3,1,3,2,10,0,2,5,1,0,0,1037823,2023-11-25T00:00:00.000Z,44,21,Davis Bertans,0,6,7,6,2,7.7
2,0,3,12,3,14,4,2,2,26,0,3,13,3,0,0,1037823,2023-11-25T00:00:00.000Z,3547272,21,Isaiah Joe,0,16,18,15,5,19.6
0,0,0,0,0,0,0,0,0,0,0,0,0,0,0,0,1037823,2023-11-25T00:00:00.000Z,38017703,21,Jalen Williams,0,0,0,0,0,0
5,0,5,5,2,9,3,0,0,26,1,4,8,6,0,0,1037823,2023-11-25T00:00:00.000Z,38017706,21,Jaylin Williams,0,14,19,13,11,22.7
8,0,4,1,0,12,4,2,2,26,3,4,10,7,0,1,1037823,2023-11-25T00:00:00.000Z,17896065,21,Josh Giddey,0,17,25,18,15,29.4
2,0,2,3,2,5,4,2,1,19,0,2,11,2,1,0,1037823,2023-11-25T00:00:00.000Z,480,21,Kenrich Williams,1,13,15,13,4,19.4
0,0,0,0,0,0,0,0,0,0,0,0,0,0,0,0,1037823,2023-11-25T00:00:00.000Z,56677853,21,Keyontae Johnson,0,0,0,0,0,0
0,0,0,0,0,0,0,0,0,0,0,0,0,0,0,0,1037823,2023-11-25T00:00:00.000Z,27924547,21,Lindy Waters III,0,0,0,0,0,0
0,0,1,3,1,5,2,1,0,24,1,3,5,2,0,1,1037823,2023-11-25T00:00:00.000Z,666541,21,Luguentz Dort,0,7,7,5,2,6.4
0,0,0,0,0,0,0,0,0,0,0,0,0,0,0,0,1037823,2023-11-25T00:00:00.000Z,24572055,21,Olivier Sarr,0,0,0,0,0,0
2,0,0,1,0,2,0,0,0,8,1,1,0,1,0,0,1037823,2023-11-25T00:00:00.000Z,38017716,21,Ousmane Dieng,0,1,3,2,3,4.2
5,0,3,2,1,21,10,10,10,36,3,3,31,6,2,1,1037823,2023-11-25T00:00:00.000Z,175,21,Shai Gilgeous-Alexander,2,37,42,36,11,50.7
0,0,0,0,0,0,0,0,0,0,0,0,0,0,0,0,1037823,2023-11-25T00:00:00.000Z,17896036,21,Tre Mann,0,0,0,0,0,0
0,0,0,0,0,0,0,0,0,0,0,0,0,0,0,0,1037823,2023-11-25T00:00:00.000Z,4197029,21,Vasilije Micic,0,0,0,0,0,0
5,1,4,8,3,12,5,2,1,30,3,3,14,7,0,0,1037823,2023-11-25T00:00:00.000Z,313,23,De'Anthony Melton,1,21,26,19,12,32.9
0,0,0,0,0,0,0,0,0,0,0,0,0,0,0,0,1037823,2023-11-25T00:00:00.000Z,260,23,Furkan Korkmaz,0,0,0,0,0,0
0,0,0,0,0,0,0,0,0,0,0,0,0,0,0,0,1037823,2023-11-25T00:00:00.000Z,17896025,23,Jaden Springer,0,0,0,0,0,0
9,4,7,4,0,18,8,21,19,37,4,5,35,11,1,4,1037823,2023-11-25T00:00:00.000Z,145,23,Joel Embiid,5,46,55,44,20,72.7
0,0,0,0,0,0,0,0,0,0,0,0,0,0,0,0,1037823,2023-11-25T00:00:00.000Z,3547294,23,Kenyon Martin Jr.,0,0,0,0,0,0
0,0,2,2,0,2,0,0,0,15,1,3,0,3,0,1,1037823,2023-11-25T00:00:00.000Z,328,23,Marcus Morris,0,3,3,0,3,2.6
3,2,3,6,3,7,4,4,3,33,4,0,14,7,0,1,1037823,2023-11-25T00:00:00.000Z,33,23,Nicolas Batum,2,21,24,17,10,31.9
4,0,2,3,1,5,2,2,1,21,2,1,6,4,0,0,1037823,2023-11-25T00:00:00.000Z,45,23,Patrick Beverley,0,10,14,10,8,16.8
0,0,1,1,1,4,2,0,0,11,2,1,5,3,0,2,1037823,2023-11-25T00:00:00.000Z,3547270,23,Paul Reed,0,8,8,5,3,6.6
0,1,1,3,2,5,3,2,1,21,0,5,9,1,1,0,1037823,2023-11-25T00:00:00.000Z,108,23,Robert Covington,2,10,10,9,1,16.2
6,0,5,5,1,13,6,3,3,31,0,3,16,5,0,3,1037823,2023-11-25T00:00:00.000Z,200,23,Tobias Harris,0,21,27,22,11,28
3,1,7,9,3,17,8,11,9,41,1,5,28,8,0,1,1037823,2023-11-25T00:00:00.000Z,3547254,23,Tyrese Maxey,1,36,39,31,11,44.1
0,0,2,2,0,3,0,0,0,4,1,0,0,3,0,0,1037824,2023-11-25T00:00:00.000Z,9051997,3,Armoni Brooks,0,3,3,0,3,3.6
0,0,0,0,0,0,0,0,0,0,0,0,0,0,0,0,1037824,2023-11-25T00:00:00.000Z,417,3,Ben Simmons,0,0,0,0,0,0
0,0,0,0,0,0,0,0,0,0,0,0,0,0,0,0,1037824,2023-11-25T00:00:00.000Z,17896048,3,Cam Thomas,0,0,0,0,0,0
5,0,9,6,2,13,8,2,1,35,1,2,19,10,2,1,1037824,2023-11-25T00:00:00.000Z,666679,3,Cameron Johnson,2,29,34,24,15,43.5
0,1,0,0,0,0,0,2,1,3,0,0,1,0,0,0,1037824,2023-11-25T00:00:00.000Z,56677841,3,Dariq Whitehead,1,1,1,1,0,4
1,2,4,0,0,1,0,4,4,12,0,2,4,4,0,0,1037824,2023-11-25T00:00:00.000Z,17896038,3,Day'Ron Sharpe,2,8,9,5,5,16.3
0,0,0,0,0,0,0,0,0,0,0,0,0,0,0,0,1037824,2023-11-25T00:00:00.000Z,421,3,Dennis Smith Jr.,0,0,0,0,0,0
3,1,3,4,2,9,7,0,0,34,2,0,16,5,0,0,1037824,2023-11-25T00:00:00.000Z,158,3,Dorian Finney-Smith,1,21,24,19,8,29.5
0,0,0,0,0,0,0,0,0,0,0,0,0,0,0,0,1037824,2023-11-25T00:00:00.000Z,174,3,Harry Giles III,0,0,0,0,0,0
0,0,0,0,0,0,0,0,0,0,0,0,0,0,0,0,1037824,2023-11-25T00:00:00.000Z,56677722,3,Jalen Wilson,0,0,0,0,0,0
0,0,0,0,0,0,0,0,0,0,0,0,0,0,0,0,1037824,2023-11-25T00:00:00.000Z,17896041,3,Keon Johnson,0,0,0,0,0,0
0,0,1,5,2,6,2,2,2,14,0,1,8,1,0,2,1037824,2023-11-25T00:00:00.000Z,464,3,Lonnie Walker IV,0,9,9,8,1,7.2
3,1,5,6,3,19,8,5,5,33,1,2,24,6,2,3,1037824,2023-11-25T00:00:00.000Z,61,3,Mikal Bridges,3,30,33,27,9,41.7
0,3,4,0,0,7,5,4,3,24,2,1,13,6,2,0,1037824,2023-11-25T00:00:00.000Z,666508,3,Nicolas Claxton,5,19,19,13,6,35.2
0,0,1,0,0,0,0,0,0,3,0,0,0,1,0,0,1037824,2023-11-25T00:00:00.000Z,56677843,3,Noah Clowney,0,1,1,0,1,1.2
4,1,1,5,2,6,2,0,0,29,1,4,6,2,2,1,1037824,2023-11-25T00:00:00.000Z,351,3,Royce O'Neale,3,8,12,10,6,22.4
11,0,2,7,2,9,4,4,4,36,0,2,14,2,2,3,1037824,2023-11-25T00:00:00.000Z,130,3,Spencer Dinwiddie,2,16,27,25,13,35.9
0,0,2,1,1,5,3,0,0,13,0,4,7,2,1,1,1037824,2023-11-25T00:00:00.000Z,17896058,3,Trendon Watford,1,9,9,7,2,11.4
0,0,0,0,0,0,0,0,0,0,0,0,0,0,0,0,1037824,2023-11-25T00:00:00.000Z,397,16,Duncan Robinson,0,0,0,0,0,0
0,1,3,3,2,7,3,0,0,15,1,2,8,4,0,1,1037824,2023-11-25T00:00:00.000Z,3092,16,Haywood Highsmith,1,12,12,8,4,14.8
4,0,4,3,2,15,8,0,0,31,1,1,18,5,1,2,1037824,2023-11-25T00:00:00.000Z,56677785,16,Jaime Jaquez Jr.,1,23,27,22,9,31
5,1,3,5,0,11,4,3,3,37,2,1,11,5,1,2,1037824,2023-11-25T00:00:00.000Z,391,16,Josh Richardson,2,16,21,16,10,28.5
0,0,0,0,0,0,0,0,0,0,0,0,0,0,0,0,1037824,2023-11-25T00:00:00.000Z,3547257,16,R.J. Hampton,0,0,0,0,0,0
0,0,0,0,0,0,0,0,0,0,0,0,0,0,0,0,1037824,2023-11-25T00:00:00.000Z,666633,16,Tyler Herro,0,0,0,0,0,0
1,0,4,0,0,14,6,2,0,18,7,2,12,11,0,0,1037825,2023-11-25T00:00:00.000Z,83,1,Clint Capela,0,23,24,13,12,26.7
0,0,3,5,3,11,7,3,3,31,1,4,20,4,2,2,1037825,2023-11-25T00:00:00.000Z,666656,1,De'Andre Hunter,2,24,24,20,4,28.8
10,0,5,6,1,14,4,2,2,27,0,0,11,5,4,0,1037825,2023-11-25T00:00:00.000Z,334,1,Dejounte Murray,4,16,26,21,15,44
1,1,0,2,1,4,3,2,1,9,1,0,8,1,2,0,1037825,2023-11-25T00:00:00.000Z,17896040,1,Jalen Johnson,3,9,10,9,2,19.7
0,0,0,0,0,0,0,0,0,0,0,0,0,0,0,0,1037825,2023-11-25T00:00:00.000Z,56677838,1,Kobe Bufkin,0,0,0,0,0,0
0,0,0,0,0,0,0,0,0,0,0,0,0,0,0,0,1037825,2023-11-25T00:00:00.000Z,56677875,1,Miles Norris,0,0,0,0,0,0
0,0,0,0,0,0,0,0,0,0,0,0,0,0,0,0,1037825,2023-11-25T00:00:00.000Z,56677806,1,Mouhamed Gueye,0,0,0,0,0,0
0,0,0,0,0,0,0,0,0,0,0,0,0,0,0,0,1037825,2023-11-25T00:00:00.000Z,56677855,1,Seth Lundy,0,0,0,0,0,0
10,0,6,8,5,17,9,3,3,30,0,1,26,6,2,2,1037825,2023-11-25T00:00:00.000Z,490,1,Trae Young,2,32,42,36,16,52.2
2,0,1,10,1,14,3,3,3,28,0,2,10,1,0,0,1037825,2023-11-25T00:00:00.000Z,17896045,30,Corey Kispert,0,11,13,12,3,14.2
0,2,3,0,0,8,6,0,0,18,1,2,12,4,0,0,1037825,2023-11-25T00:00:00.000Z,666577,30,Daniel Gafford,2,16,16,12,4,22.8
0,0,0,0,0,0,0,0,0,0,0,0,0,0,0,0,1037825,2023-11-25T00:00:00.000Z,167,30,Danilo Gallinari,0,0,0,0,0,0
0,0,0,0,0,0,0,0,0,0,0,0,0,0,0,0,1037825,2023-11-25T00:00:00.000Z,487,30,Delon Wright,0,0,0,0,0,0
2,0,5,4,1,8,3,2,2,17,1,2,9,6,0,3,1037825,2023-11-25T00:00:00.000Z,3547242,30,Deni Avdija,0,15,17,11,8,16.2
0,0,0,0,0,0,0,0,0,0,0,0,0,0,0,0,1037825,2023-11-25T00:00:00.000Z,38124126,30,John Butler Jr.,0,0,0,0,0,0
0,0,0,0,0,0,0,0,0,0,0,0,0,0,0,0,1037825,2023-11-25T00:00:00.000Z,666848,30,Jordan Poole,0,0,0,0,0,0
8,0,5,5,2,10,4,2,2,25,2,1,12,7,0,5,1037825,2023-11-25T00:00:00.000Z,265,30,Kyle Kuzma,0,19,27,20,15,27.4
2,0,1,5,2,9,5,0,0,17,0,1,12,1,0,1,1037825,2023-11-25T00:00:00.000Z,414,30,Landry Shamet,0,13,15,14,3,15.2
0,0,0,0,0,0,0,0,0,0,0,0,0,0,0,0,1037825,2023-11-25T00:00:00.000Z,38017704,30,Patrick Baldwin Jr.,0,0,0,0,0,0
0,0,0,0,0,0,0,0,0,0,0,0,0,0,0,0,1037825,2023-11-25T00:00:00.000Z,38017712,30,Ryan Rollins,0,0,0,0,0,0
8,0,1,4,0,9,3,0,0,26,0,2,6,1,1,0,1037826,2023-11-25T00:00:00.000Z,277,6,Caris LeVert,1,7,15,14,9,22.2
1,0,1,1,1,7,5,0,0,17,0,2,11,1,0,1,1037826,2023-11-25T00:00:00.000Z,56677872,6,Craig Porter,0,12,13,12,2,12.7
0,0,0,0,0,0,0,0,0,0,0,0,0,0,0,0,1037826,2023-11-25T00:00:00.000Z,248,6,Damian Jones,0,0,0,0,0,0
3,0,1,1,0,6,2,2,2,14,0,1,6,1,1,2,1037826,2023-11-25T00:00:00.000Z,666581,6,Darius Garland,1,7,10,9,4,12.7
0,0,0,0,0,0,0,0,0,0,0,0,0,0,0,0,1037826,2023-11-25T00:00:00.000Z,666940,6,Dean Wade,0,0,0,0,0,0
6,0,5,6,2,18,4,13,12,35,0,0,22,5,1,1,1037826,2023-11-25T00:00:00.000Z,322,6,Donovan Mitchell,1,27,33,28,11,39
0,0,0,0,0,0,0,0,0,0,0,0,0,0,0,0,1037826,2023-11-25T00:00:00.000Z,56677847,6,Emoni Bates,0,0,0,0,0,0
1,0,2,9,3,13,5,0,0,23,0,2,13,2,2,1,1037826,2023-11-25T00:00:00.000Z,344,6,Georges Niang,2,15,16,14,3,21.9
0,1,2,0,0,3,2,1,1,18,1,1,5,3,0,2,1037826,2023-11-25T00:00:00.000Z,3547247,6,Isaac Okoro,1,8,8,5,3,9.6
0,0,0,0,0,0,0,0,0,0,0,0,0,0,0,0,1037826,2023-11-25T00:00:00.000Z,38017662,6,Isaiah Mobley,0,0,0,0,0,0
3,2,9,0,0,12,9,4,3,37,5,3,21,14,3,2,1037826,2023-11-25T00:00:00.000Z,9,6,Jarrett Allen,5,35,38,24,17,55.3
0,0,0,0,0,0,0,0,0,0,0,0,0,0,0,0,1037826,2023-11-25T00:00:00.000Z,404,6,Ricky Rubio,0,0,0,0,0,0
0,0,0,0,0,0,0,0,0,0,0,0,0,0,0,0,1037826,2023-11-25T00:00:00.000Z,3547299,6,Sam Merrill,0,0,0,0,0,0
0,0,0,0,0,0,0,0,0,0,0,0,0,0,0,0,1037826,2023-11-25T00:00:00.000Z,444,6,Tristan Thompson,0,0,0,0,0,0
0,0,0,0,0,0,0,0,0,0,0,0,0,0,0,0,1037826,2023-11-25T00:00:00.000Z,666676,6,Ty Jerome,0,0,0,0,0,0
0,0,0,0,0,0,0,0,0,0,0,0,0,0,0,0,1037826,2023-11-25T00:00:00.000Z,56677867,14,Alex Fudge,0,0,0,0,0,0
3,3,8,0,0,20,13,7,6,38,5,3,32,13,2,5,1037826,2023-11-25T00:00:00.000Z,117,14,Anthony Davis,5,45,48,35,16,62.1
10,0,4,2,1,8,4,6,6,32,1,1,15,5,2,2,1037826,2023-11-25T00:00:00.000Z,17553995,14,Austin Reaves,2,20,30,25,15,40
0,0,0,0,0,0,0,0,0,0,0,0,0,0,0,0,1037826,2023-11-25T00:00:00.000Z,666860,14,Cameron Reddish,0,0,0,0,0,0
0,0,2,3,2,7,5,1,1,17,1,1,13,3,0,1,1037826,2023-11-25T00:00:00.000Z,486,14,Christian Wood,0,16,16,13,3,15.6
0,0,0,0,0,0,0,0,0,0,0,0,0,0,0,0,1037826,2023-11-25T00:00:00.000Z,56677738,14,Colin Castleton,0,0,0,0,0,0
5,0,5,6,2,12,4,0,0,32,0,3,10,5,2,4,1037826,2023-11-25T00:00:00.000Z,405,14,D'Angelo Russell,2,15,20,15,10,25.5
0,0,0,0,0,0,0,0,0,0,0,0,0,0,0,0,1037826,2023-11-25T00:00:00.000Z,56677868,14,D'Moi Hodge,0,0,0,0,0,0
0,0,0,0,0,0,0,0,0,0,0,0,0,0,0,0,1037826,2023-11-25T00:00:00.000Z,1603383,14,Gabe Vincent,0,0,0,0,0,0
0,0,0,0,0,0,0,0,0,0,0,0,0,0,0,0,1037826,2023-11-25T00:00:00.000Z,56677835,14,Jalen Hood-Schifino,0,0,0,0,0,0
0,0,0,0,0,0,0,0,0,0,0,0,0,0,0,0,1037826,2023-11-25T00:00:00.000Z,457,14,Jarred Vanderbilt,0,0,0,0,0,0
1,1,3,0,0,5,5,0,0,21,0,3,10,3,0,1,1037826,2023-11-25T00:00:00.000Z,666626,14,Jaxson Hayes,1,13,14,11,4,17.1
6,2,5,9,1,23,8,7,5,35,1,1,22,6,2,4,1037826,2023-11-25T00:00:00.000Z,237,14,LeBron James,4,28,34,28,12,46.2
3,0,4,4,2,7,5,0,0,33,1,3,12,5,0,1,1037826,2023-11-25T00:00:00.000Z,38017697,14,Max Christie,0,17,20,15,8,21.5
0,0,0,0,0,0,0,0,0,0,0,0,0,0,0,0,1037826,2023-11-25T00:00:00.000Z,56677836,14,Maxwell Lewis,0,0,0,0,0,0
0,0,0,0,0,0,0,0,0,0,0,0,0,0,0,0,1037826,2023-11-25T00:00:00.000Z,666609,14,Rui Hachimura,0,0,0,0,0,0
6,2,4,3,1,8,3,0,0,32,0,0,7,4,1,0,1037826,2023-11-25T00:00:00.000Z,383,14,Taurean Prince,3,11,17,13,10,29.8
8,0,5,4,1,22,10,8,5,37,1,4,26,6,1,1,1037827,2023-11-25T00:00:00.000Z,227,19,Brandon Ingram,1,32,40,34,14,47.2
0,0,0,0,0,0,0,0,0,0,0,0,0,0,0,0,1037827,2023-11-25T00:00:00.000Z,303,19,CJ McCollum,0,0,0,0,0,0
5,1,4,0,0,2,2,0,0,21,2,0,4,6,0,0,1037827,2023-11-25T00:00:00.000Z,491,19,Cody Zeller,1,10,15,9,11,21.7
0,0,0,0,0,0,0,0,0,0,0,0,0,0,0,0,1037827,2023-11-25T00:00:00.000Z,38017726,19,Dereon Seabron,0,0,0,0,0,0
0,0,0,0,0,0,0,0,0,0,0,0,0,0,0,0,1037827,2023-11-25T00:00:00.000Z,38017663,19,E.J. Liddell,0,0,0,0,0,0
1,1,0,4,1,11,6,0,0,26,1,3,13,1,1,1,1037827,2023-11-25T00:00:00.000Z,17896024,19,Herbert Jones,2,14,15,14,2,20.7
0,0,0,0,0,0,0,0,0,0,0,0,0,0,0,0,1037827,2023-11-25T00:00:00.000Z,17896021,19,Jeremiah Robinson-Earl,0,0,0,0,0,0
2,0,2,2,0,10,3,4,2,26,5,2,8,7,1,1,1037827,2023-11-25T00:00:00.000Z,455,19,Jonas Valanciunas,1,15,17,10,9,21.4
3,0,5,12,5,17,8,5,4,40,1,1,25,6,1,4,1037827,2023-11-25T00:00:00.000Z,56677837,19,Jordan Hawkins,1,31,34,28,9,35.7
0,0,0,0,0,0,0,0,0,0,0,0,0,0,0,0,1037827,2023-11-25T00:00:00.000Z,3547260,19,Kira Lewis Jr.,0,0,0,0,0,0
0,0,0,0,0,0,0,0,0,0,0,0,0,0,0,0,1037827,2023-11-25T00:00:00.000Z,17896017,19,Matt Ryan,0,0,0,0,0,0
0,0,0,0,0,0,0,0,0,0,0,0,0,0,0,0,1037827,2023-11-25T00:00:00.000Z,18677986,19,Trey Murphy III,0,0,0,0,0,0
0,0,0,0,0,0,0,0,0,0,0,0,0,0,0,0,1037827,2023-11-25T00:00:00.000Z,666969,19,Zion Williamson,0,0,0,0,0,0
0,0,0,0,0,0,0,0,0,0,0,0,0,0,0,0,1037827,2023-11-25T00:00:00.000Z,56677842,29,Brice Sensabaugh,0,0,0,0,0,0
6,0,1,8,3,13,5,4,3,28,2,0,16,3,0,2,1037827,2023-11-25T00:00:00.000Z,413,29,Collin Sexton,0,19,25,22,9,26.6
0,0,7,2,0,11,5,2,2,24,2,1,12,9,0,3,1037827,2023-11-25T00:00:00.000Z,101,29,John Collins,0,21,21,12,9,19.8
0,0,0,0,0,0,0,0,0,0,0,0,0,0,0,0,1037827,2023-11-25T00:00:00.000Z,38017630,29,Johnny Juzang,0,0,0,0,0,0
0,0,0,0,0,0,0,0,0,0,0,0,0,0,0,0,1037827,2023-11-25T00:00:00.000Z,100,29,Jordan Clarkson,0,0,0,0,0,0
0,0,0,0,0,0,0,0,0,0,0,0,0,0,0,0,1037827,2023-11-25T00:00:00.000Z,17896023,29,Josh Christopher,0,0,0,0,0,0
3,1,5,3,3,6,4,2,2,24,1,0,13,6,1,3,1037827,2023-11-25T00:00:00.000Z,358,29,Kelly Olynyk,2,19,22,16,9,27.7
5,0,6,9,4,13,4,5,3,27,0,2,15,6,0,5,1037827,2023-11-25T00:00:00.000Z,56677834,29,Keyonte George,0,21,26,20,11,24.7
2,0,2,0,0,7,4,0,0,19,1,3,8,3,2,2,1037827,2023-11-25T00:00:00.000Z,139,29,Kris Dunn,2,11,13,10,5,18.6
0,0,0,0,0,0,0,0,0,0,0,0,0,0,0,0,1037827,2023-11-25T00:00:00.000Z,297,29,Lauri Markkanen,0,0,0,0,0,0
0,0,0,0,0,0,0,0,0,0,0,0,0,0,0,0,1037827,2023-11-25T00:00:00.000Z,666881,29,Luka Samanic,0,0,0,0,0,0
0,0,0,0,0,0,0,0,0,0,0,0,0,0,0,0,1037827,2023-11-25T00:00:00.000Z,19465584,29,Micah Potter,0,0,0,0,0,0
3,0,1,7,2,8,3,1,1,22,0,1,9,1,3,1,1037827,2023-11-25T00:00:00.000Z,38017620,29,Ochai Agbaji,3,10,13,12,4,22.7
0,2,5,3,0,6,3,0,0,27,2,0,6,7,1,0,1037827,2023-11-25T00:00:00.000Z,11891374,29,Omer Yurtseven,3,13,13,6,7,23.4
0,1,3,7,2,8,3,2,2,26,0,1,10,3,0,2,1037827,2023-11-25T00:00:00.000Z,38017739,29,Simone Fontecchio,1,13,13,10,3,14.6
4,0,3,3,1,5,2,0,0,22,0,1,5,3,0,2,1037827,2023-11-25T00:00:00.000Z,666650,29,Talen Horton-Tucker,0,8,12,9,7,12.6
0,0,0,0,0,0,0,0,0,0,0,0,0,0,0,0,1037827,2023-11-25T00:00:00.000Z,56677824,29,Taylor Hendricks,0,0,0,0,0,0
0,2,5,1,0,10,5,1,1,21,6,5,11,11,1,3,1037827,2023-11-25T00:00:00.000Z,38017705,29,Walker Kessler,3,22,22,11,11,30.2
2,0,5,1,0,4,1,0,0,18,3,1,2,8,1,1,1037828,2023-11-25T00:00:00.000Z,151,7,Dante Exum,1,10,12,4,10,16.6
1,1,1,3,1,5,1,2,1,20,0,1,4,1,1,0,1037828,2023-11-25T00:00:00.000Z,247,7,Derrick Jones Jr.,2,5,6,5,2,12.7
3,0,2,0,0,0,0,2,2,15,0,2,2,2,0,0,1037828,2023-11-25T00:00:00.000Z,379,7,Dwight Powell,0,4,7,5,5,8.9
1,0,1,2,1,3,2,0,0,35,3,4,5,4,0,1,1037828,2023-11-25T00:00:00.000Z,666965,7,Grant Williams,0,9,10,6,5,10.3
1,0,2,1,0,3,1,2,2,8,2,0,4,4,0,1,1037828,2023-11-25T00:00:00.000Z,38017679,7,Jaden Hardy,0,8,9,5,5,9.3
1,0,1,1,0,2,0,0,0,9,0,2,0,1,0,0,1037828,2023-11-25T00:00:00.000Z,3547258,7,Josh Green,0,1,2,1,2,2.7
3,0,6,7,3,22,11,1,1,32,0,3,26,6,1,1,1037828,2023-11-25T00:00:00.000Z,228,7,Kyrie Irving,1,32,35,29,9,39.7
4,2,3,8,1,27,12,5,5,38,0,4,30,3,2,4,1037828,2023-11-25T00:00:00.000Z,132,7,Luka Doncic,4,33,37,34,7,47.6
1,2,3,0,0,4,0,2,0,21,2,3,0,5,0,0,1037828,2023-11-25T00:00:00.000Z,217,7,Richaun Holmes,2,5,6,1,6,13.5
0,0,0,4,1,5,1,0,0,8,0,2,3,0,0,0,1037828,2023-11-25T00:00:00.000Z,114,7,Seth Curry,0,3,3,3,0,3
0,0,3,9,2,14,5,0,0,29,0,2,12,3,0,1,1037828,2023-11-25T00:00:00.000Z,191,7,Tim Hardaway Jr.,0,15,15,12,3,14.6
1,0,0,0,0,0,0,0,0,5,1,1,0,1,0,0,1037828,2023-11-25T00:00:00.000Z,666511,13,Amir Coffey,0,1,2,1,2,2.7
0,0,0,0,0,0,0,0,0,0,0,0,0,0,0,0,1037828,2023-11-25T00:00:00.000Z,17896022,13,Brandon Boston Jr.,0,0,0,0,0,0
0,1,1,1,0,6,2,2,1,16,2,2,5,3,0,1,1037828,2023-11-25T00:00:00.000Z,439,13,Daniel Theis,1,8,8,5,3,10.6
1,0,10,0,0,8,5,5,1,23,4,1,11,14,0,1,1037828,2023-11-25T00:00:00.000Z,493,13,Ivica Zubac,0,25,26,12,15,28.3
7,2,4,6,2,8,2,2,2,28,0,1,8,4,1,2,1037828,2023-11-25T00:00:00.000Z,192,13,James Harden,3,12,19,15,11,30.3
0,0,0,0,0,0,0,0,0,0,0,0,0,0,0,0,1037828,2023-11-25T00:00:00.000Z,56677856,13,Jordan Miller,0,0,0,0,0,0
0,0,0,0,0,0,0,0,0,0,0,0,0,0,0,0,1037828,2023-11-25T00:00:00.000Z,17896051,13,Joshua Primo,0,0,0,0,0,0
3,2,6,5,0,12,2,4,4,29,0,1,8,6,0,2,1037828,2023-11-25T00:00:00.000Z,274,13,Kawhi Leonard,2,14,17,11,9,23.7
0,0,2,1,0,2,0,0,0,5,1,0,0,3,0,0,1037828,2023-11-25T00:00:00.000Z,56677849,13,Kobe Brown,0,3,3,0,3,3.6
0,0,0,0,0,0,0,0,0,0,0,0,0,0,0,0,1037828,2023-11-25T00:00:00.000Z,371,13,Mason Plumlee,0,0,0,0,0,0
0,0,0,0,0,2,0,2,1,5,2,0,1,2,1,0,1037828,2023-11-25T00:00:00.000Z,38017725,13,Moussa Diabate,1,3,3,1,2,6.4
0,0,0,3,1,4,1,0,0,4,0,0,3,0,0,2,1037828,2023-11-25T00:00:00.000Z,17896031,13,Nah'Shon Hyland,0,3,3,3,0,1
1,0,3,3,3,4,4,4,4,24,0,2,15,3,0,1,1037828,2023-11-25T00:00:00.000Z,380,13,Norman Powell,0,18,19,16,4,19.1
4,0,8,5,2,19,9,5,5,36,1,4,25,9,0,1,1037828,2023-11-25T00:00:00.000Z,172,13,Paul George,0,34,38,29,13,40.8
0,0,1,0,0,0,0,0,0,8,0,2,0,1,0,0,1037828,2023-11-25T00:00:00.000Z,450,13,PJ Tucker,0,1,1,0,1,1.2
7,0,4,1,0,9,6,3,2,25,4,2,14,8,0,2,1037828,2023-11-25T00:00:00.000Z,472,13,Russell Westbrook,0,22,29,21,15,32.1
1,1,1,4,0,14,7,4,3,32,2,0,17,3,0,0,1037828,2023-11-25T00:00:00.000Z,666743,13,Terance Mann,1,20,21,18,4,25.1
0,0,0,0,0,0,0,0,0,0,0,0,0,0,0,0,1037828,2023-11-25T00:00:00.000Z,24417679,13,Xavier Moon,0,0,0,0,0,0
0,0,0,2,0,2,0,0,0,4,1,1,0,1,0,0,1037829,2023-11-26T00:00:00.000Z,38017733,17,A.J. Green,0,1,1,0,1,1.2
0,0,1,0,0,0,0,0,0,12,0,0,0,1,0,0,1037829,2023-11-26T00:00:00.000Z,56677852,17,Andre Jackson Jr.,0,1,1,0,1,1.2
3,4,5,6,2,11,4,0,0,31,1,3,10,6,3,0,1037829,2023-11-26T00:00:00.000Z,283,17,Brook Lopez,7,16,19,13,9,42.7
3,0,2,3,1,4,1,0,0,17,0,2,3,2,1,3,1037829,2023-11-26T00:00:00.000Z,368,17,Cameron Payne,1,5,8,6,5,9.9
0,0,0,0,0,0,0,0,0,0,0,0,0,0,0,0,1037829,2023-11-26T00:00:00.000Z,56677854,17,Chris Livingston,0,0,0,0,0,0
4,0,4,12,4,21,7,14,13,37,1,2,31,5,2,3,1037829,2023-11-26T00:00:00.000Z,278,17,Damian Lillard,2,36,40,35,9,46
6,3,10,1,0,21,11,18,11,39,6,5,33,16,1,4,1037829,2023-11-26T00:00:00.000Z,15,17,Giannis Antetokounmpo,4,49,55,39,22,69.2
0,0,5,11,4,14,5,0,0,36,1,1,14,6,3,2,1037829,2023-11-26T00:00:00.000Z,38,17,Malik Beasley,3,20,20,14,6,28.2
1,1,1,0,0,0,0,0,0,9,0,2,0,1,0,1,1037829,2023-11-26T00:00:00.000Z,38017676,17,MarJon Beauchamp,1,1,2,1,2,4.7
0,0,0,0,0,0,0,0,0,0,0,0,0,0,0,0,1037829,2023-11-26T00:00:00.000Z,666453,17,Marques Bolden,0,0,0,0,0,0
1,0,2,2,1,4,2,0,0,20,2,1,5,4,1,2,1037829,2023-11-26T00:00:00.000Z,105,17,Pat Connaughton,1,9,10,6,5,12.3
0,0,0,0,0,0,0,0,0,0,0,0,0,0,0,0,1037829,2023-11-26T00:00:00.000Z,284,17,Robin Lopez,0,0,0,0,0,0
0,0,2,0,0,0,0,0,0,4,0,0,0,2,0,0,1037829,2023-11-26T00:00:00.000Z,2148,17,Thanasis Antetokounmpo,0,2,2,0,2,2.4
0,0,0,0,0,0,0,0,0,0,0,0,0,0,0,0,1037829,2023-11-26T00:00:00.000Z,419,25,Anfernee Simons,0,0,0,0,0,0
0,0,0,4,1,5,1,0,0,12,0,2,3,0,2,1,1037829,2023-11-26T00:00:00.000Z,56783340,25,Duop Reath,2,3,3,3,0,8
0,0,0,0,0,0,0,0,0,0,0,0,0,0,0,0,1037829,2023-11-26T00:00:00.000Z,39613724,25,Ibou Badji,0,0,0,0,0,0
0,0,0,0,0,0,0,0,0,0,0,0,0,0,0,0,1037829,2023-11-26T00:00:00.000Z,17896120,25,Ish Wainright,0,0,0,0,0,0
0,0,3,1,0,3,2,0,0,16,0,4,4,3,0,1,1037829,2023-11-26T00:00:00.000Z,38017711,25,Jabari Walker,0,7,7,4,3,6.6
0,0,0,0,0,0,0,0,0,0,0,0,0,0,0,0,1037829,2023-11-26T00:00:00.000Z,47957121,25,Justin Minaya,0,0,0,0,0,0
0,0,0,0,0,0,0,0,0,0,0,0,0,0,0,0,1037829,2023-11-26T00:00:00.000Z,56677791,25,Kris Murray,0,0,0,0,0,0
12,1,6,6,2,23,7,3,2,34,2,4,18,8,2,2,1037829,2023-11-26T00:00:00.000Z,65,25,Malcolm Brogdon,3,26,38,30,20,52.6
1,1,1,4,1,4,1,2,2,26,0,1,5,1,4,2,1037829,2023-11-26T00:00:00.000Z,666923,25,Matisse Thybulle,5,6,7,6,2,20.7
0,0,0,0,0,0,0,0,0,0,0,0,0,0,0,0,1037829,2023-11-26T00:00:00.000Z,666476,25,Moses Brown,0,0,0,0,0,0
0,0,0,0,0,0,0,0,0,0,0,0,0,0,0,0,1037829,2023-11-26T00:00:00.000Z,56677829,25,Rayan Rupert,0,0,0,0,0,0
0,0,0,0,0,0,0,0,0,0,0,0,0,0,0,0,1037829,2023-11-26T00:00:00.000Z,476,25,Robert Williams III,0,0,0,0,0,0
0,0,0,0,0,0,0,0,0,0,0,0,0,0,0,0,1037829,2023-11-26T00:00:00.000Z,3547289,25,Skylar Mays,0,0,0,0,0,0
3,0,6,7,2,19,9,2,1,36,1,4,21,7,1,2,1037830,2023-11-26T00:00:00.000Z,70,2,Jaylen Brown,1,28,31,24,10,34.9
4,0,8,13,5,25,11,10,7,39,1,2,34,9,2,6,1037830,2023-11-26T00:00:00.000Z,434,2,Jayson Tatum,2,43,47,38,13,50.8
0,0,0,0,0,0,0,0,0,0,0,0,0,0,0,0,1037831,2023-11-26T00:00:00.000Z,666474,20,Charles Brown,0,0,0,0,0,0
0,0,0,0,0,0,0,0,0,0,0,0,0,0,0,0,1037831,2023-11-26T00:00:00.000Z,666675,20,DaQuan Jeffries,0,0,0,0,0,0
0,0,1,3,2,6,2,0,0,14,0,1,6,1,2,0,1037831,2023-11-26T00:00:00.000Z,131,20,Donte DiVincenzo,2,7,7,6,1,13.2
0,0,0,0,0,0,0,0,0,0,0,0,0,0,0,0,1037831,2023-11-26T00:00:00.000Z,17896089,20,Duane Washington Jr.,0,0,0,0,0,0
0,0,0,0,0,0,0,0,0,0,0,0,0,0,0,0,1037831,2023-11-26T00:00:00.000Z,160,20,Evan Fournier,0,0,0,0,0,0
1,1,2,6,3,11,4,8,7,29,0,1,18,2,1,0,1037831,2023-11-26T00:00:00.000Z,3547269,20,Immanuel Quickley,2,20,21,19,3,27.9
1,1,1,0,0,3,2,4,3,14,4,3,7,5,0,0,1037831,2023-11-26T00:00:00.000Z,201,20,Isaiah Hartenstein,1,12,13,8,6,17.5
0,0,0,0,0,0,0,0,0,0,0,0,0,0,0,0,1037831,2023-11-26T00:00:00.000Z,56677795,20,Jacob Toppin,0,0,0,0,0,0
8,1,6,10,5,25,15,2,0,38,0,5,35,6,3,3,1037831,2023-11-26T00:00:00.000Z,73,20,Jalen Brunson,4,41,49,43,14,63.2
0,0,0,0,0,0,0,0,0,0,0,0,0,0,0,0,1037831,2023-11-26T00:00:00.000Z,17896063,20,Jericho Sims,0,0,0,0,0,0
2,0,3,2,0,3,1,2,2,24,0,0,4,3,0,0,1037831,2023-11-26T00:00:00.000Z,202,20,Josh Hart,0,7,9,6,5,10.6
2,0,2,4,1,21,10,8,7,36,3,2,28,5,0,2,1037831,2023-11-26T00:00:00.000Z,387,20,Julius Randle,0,33,35,30,7,35
0,0,0,0,0,0,0,0,0,0,0,0,0,0,0,0,1037831,2023-11-26T00:00:00.000Z,17896033,20,Miles McBride,0,0,0,0,0,0
1,1,6,0,0,2,1,4,1,34,5,2,3,11,1,1,1037831,2023-11-26T00:00:00.000Z,399,20,Mitchell Robinson,2,14,15,4,12,22.7
2,0,2,3,1,5,1,0,0,20,1,2,3,3,0,1,1037831,2023-11-26T00:00:00.000Z,17895858,20,Quentin Grimes,0,6,8,5,5,8.6
1,1,2,2,0,11,3,4,3,31,0,3,9,2,0,0,1037831,2023-11-26T00:00:00.000Z,666423,20,RJ Barrett,1,11,12,10,3,15.9
0,0,0,0,0,0,0,0,0,0,0,0,0,0,0,0,1037831,2023-11-26T00:00:00.000Z,19,20,Ryan Arcidiacono,0,0,0,0,0,0
0,0,0,0,0,0,0,0,0,0,0,0,0,0,0,0,1037831,2023-11-26T00:00:00.000Z,666451,24,Bol Bol,0,0,0,0,0,0
0,0,0,0,0,0,0,0,0,0,0,0,0,0,0,0,1037831,2023-11-26T00:00:00.000Z,37,24,Bradley Beal,0,0,0,0,0,0
0,0,2,2,2,3,3,0,0,13,2,3,8,4,0,0,1037831,2023-11-26T00:00:00.000Z,314,24,Chimezie Metu,0,12,12,8,4,12.8
0,0,0,0,0,0,0,0,0,0,0,0,0,0,0,0,1037831,2023-11-26T00:00:00.000Z,272,24,Damion Lee,0,0,0,0,0,0
11,2,3,4,1,25,10,8,7,38,2,3,28,5,0,2,1037831,2023-11-26T00:00:00.000Z,57,24,Devin Booker,2,33,44,39,16,54.5
1,0,2,0,0,2,1,2,1,15,4,4,3,6,0,2,1037831,2023-11-26T00:00:00.000Z,147,24,Drew Eubanks,0,9,10,4,7,9.7
2,1,2,9,6,13,9,2,1,33,0,3,25,2,0,2,1037831,2023-11-26T00:00:00.000Z,178,24,Eric Gordon,1,27,29,27,4,31.4
0,0,0,0,0,0,0,0,0,0,0,0,0,0,0,0,1037831,2023-11-26T00:00:00.000Z,8,24,Grayson Allen,0,0,0,0,0,0
5,1,4,3,2,10,6,0,0,29,3,2,14,7,1,0,1037831,2023-11-26T00:00:00.000Z,18678058,24,Jordan Goodwin,2,21,26,19,12,35.9
2,0,3,3,0,5,0,4,3,17,1,3,3,4,1,2,1037831,2023-11-26T00:00:00.000Z,356,24,Josh Okogie,1,7,9,5,6,11.8
4,4,6,2,0,9,4,0,0,33,4,2,8,10,1,1,1037831,2023-11-26T00:00:00.000Z,349,24,Jusuf Nurkic,5,18,22,12,14,40
2,1,5,5,0,11,3,3,3,27,2,3,9,7,2,1,1037831,2023-11-26T00:00:00.000Z,32,24,Keita Bates-Diop,3,16,18,11,9,28.4
0,0,0,0,0,0,0,0,0,0,0,0,0,0,0,0,1037831,2023-11-26T00:00:00.000Z,140,24,Kevin Durant,0,0,0,0,0,0
0,2,2,6,3,9,4,0,0,20,0,1,11,2,0,1,1037831,2023-11-26T00:00:00.000Z,666729,24,Nassir Little,2,13,13,11,2,18.4
0,0,0,0,0,0,0,0,0,0,0,0,0,0,0,0,1037831,2023-11-26T00:00:00.000Z,3547298,24,Saben Lee,0,0,0,0,0,0
0,0,0,0,0,0,0,0,0,0,0,0,0,0,0,0,1037831,2023-11-26T00:00:00.000Z,3547095,24,Udoka Azubuike,0,0,0,0,0,0
0,0,0,4,2,4,2,2,1,15,0,1,7,0,0,0,1037831,2023-11-26T00:00:00.000Z,470,24,Yuta Watanabe,0,7,7,7,0,7
0,0,0,0,0,0,0,0,0,0,0,0,0,0,0,0,1037832,2023-11-26T00:00:00.000Z,56677848,4,Amari Bailey,0,0,0,0,0,0
1,0,5,3,2,11,7,5,4,33,0,5,20,5,1,2,1037832,2023-11-26T00:00:00.000Z,56677823,4,Brandon Miller,1,25,26,21,6,28.5
1,0,1,0,0,0,0,0,0,6,1,2,0,2,1,1,1037832,2023-11-26T00:00:00.000Z,38017708,4,Bryce McGowens,1,2,3,1,3,5.9
0,0,0,0,0,0,0,0,0,0,0,0,0,0,0,0,1037832,2023-11-26T00:00:00.000Z,666748,4,Cody Martin,0,0,0,0,0,0
0,0,0,0,0,0,0,0,0,0,0,0,0,0,0,0,1037832,2023-11-26T00:00:00.000Z,347,4,Frank Ntilikina,0,0,0,0,0,0
2,1,5,4,2,11,4,2,0,33,0,1,10,5,0,3,1037832,2023-11-26T00:00:00.000Z,204,4,Gordon Hayward,1,15,17,12,7,19
4,0,2,0,0,3,2,0,0,17,0,2,4,2,1,1,1037832,2023-11-26T00:00:00.000Z,422,4,Ish Smith,1,6,10,8,6,14.4
0,0,0,0,0,0,0,0,0,0,0,0,0,0,0,0,1037832,2023-11-26T00:00:00.000Z,17896037,4,James Bouknight,0,0,0,0,0,0
0,0,0,3,2,4,2,0,0,9,0,1,6,0,0,0,1037832,2023-11-26T00:00:00.000Z,18678001,4,JT Thor,0,6,6,6,0,6
2,0,1,3,1,6,3,0,0,14,0,0,7,1,0,1,1037832,2023-11-26T00:00:00.000Z,3547239,4,LaMelo Ball,0,8,10,9,3,10.2
0,0,0,0,0,0,0,0,0,0,0,0,0,0,0,0,1037832,2023-11-26T00:00:00.000Z,56677866,4,Leaky Black,0,0,0,0,0,0
1,1,5,0,0,6,5,2,2,22,1,4,12,6,1,1,1037832,2023-11-26T00:00:00.000Z,38017698,4,Mark Williams,2,18,19,13,7,25.7
2,1,7,4,1,17,9,6,4,37,3,2,23,10,1,3,1037832,2023-11-26T00:00:00.000Z,62,4,Miles Bridges,2,33,35,25,12,41
0,0,0,0,0,0,0,0,0,0,0,0,0,0,0,0,1037832,2023-11-26T00:00:00.000Z,3547282,4,Nick Richards,0,0,0,0,0,0
0,0,0,0,0,0,0,0,0,0,0,0,0,0,0,0,1037832,2023-11-26T00:00:00.000Z,56677846,4,Nick Smith Jr.,0,0,0,0,0,0
2,3,4,9,3,10,3,6,4,28,0,5,13,4,0,1,1037832,2023-11-26T00:00:00.000Z,666950,4,P.J. Washington,3,17,19,15,6,28.8
9,1,1,4,2,15,9,4,2,37,0,4,22,1,1,5,1037832,2023-11-26T00:00:00.000Z,403,4,Terry Rozier,2,23,32,31,10,37.7
3,0,0,0,0,0,0,0,0,4,0,0,0,0,0,0,1037832,2023-11-26T00:00:00.000Z,3547253,4,Theo Maledon,0,0,3,3,3,4.5
0,0,0,0,0,0,0,0,0,0,0,0,0,0,0,0,1037832,2023-11-26T00:00:00.000Z,666885,22,Admiral Schofield,0,0,0,0,0,0
3,0,0,1,0,4,1,0,0,15,0,3,2,0,0,0,1037832,2023-11-26T00:00:00.000Z,56677827,22,Anthony Black,0,2,5,5,3,6.5
0,0,1,2,1,2,1,3,3,12,1,2,6,2,0,0,1037832,2023-11-26T00:00:00.000Z,38017724,22,Caleb Houstan,0,8,8,6,2,8.4
0,0,0,0,0,0,0,0,0,0,0,0,0,0,0,0,1037832,2023-11-26T00:00:00.000Z,666818,22,Chuma Okeke,0,0,0,0,0,0
7,1,6,3,1,16,9,12,11,32,1,3,30,7,2,2,1037832,2023-11-26T00:00:00.000Z,3547251,22,Cole Anthony,3,37,44,37,14,55.9
6,0,0,5,1,6,2,0,0,24,0,2,5,0,1,0,1037832,2023-11-26T00:00:00.000Z,196,22,Gary Harris,1,5,11,11,6,17
3,0,5,0,0,7,5,1,1,20,2,4,11,7,1,2,1037832,2023-11-26T00:00:00.000Z,666442,22,Goga Bitadze,1,18,21,14,10,24.9
1,2,5,5,2,9,5,0,0,32,0,2,12,5,1,1,1037832,2023-11-26T00:00:00.000Z,17896073,22,Jalen Suggs,3,17,18,13,6,27.5
0,0,0,0,0,0,0,0,0,0,0,0,0,0,0,0,1037832,2023-11-26T00:00:00.000Z,56677839,22,Jett Howard,0,0,0,0,0,0
1,0,2,1,0,3,0,0,0,15,0,2,0,2,1,2,1037832,2023-11-26T00:00:00.000Z,226,22,Joe Ingles,1,2,3,1,3,4.9
0,0,0,0,0,0,0,0,0,0,0,0,0,0,0,0,1037832,2023-11-26T00:00:00.000Z,229,22,Jonathan Isaac,0,0,0,0,0,0
0,0,0,0,0,0,0,0,0,0,0,0,0,0,0,0,1037832,2023-11-26T00:00:00.000Z,38017607,22,Kevon Harris,0,0,0,0,0,0
0,0,0,0,0,0,0,0,0,0,0,0,0,0,0,0,1037832,2023-11-26T00:00:00.000Z,165,22,Markelle Fultz,0,0,0,0,0,0
2,0,5,2,1,7,4,2,2,18,2,3,11,7,0,2,1037832,2023-11-26T00:00:00.000Z,462,22,Moritz Wagner,0,18,20,13,9,20.4
8,0,7,5,2,18,9,6,3,37,0,2,23,7,2,2,1037832,2023-11-26T00:00:00.000Z,38017683,22,Paolo Banchero,2,30,38,31,15,47.4
0,0,0,0,0,0,0,0,0,0,0,0,0,0,0,0,1037832,2023-11-26T00:00:00.000Z,17553983,22,Trevelin Queen,0,0,0,0,0,0
0,0,0,0,0,0,0,0,0,0,0,0,0,0,0,0,1037832,2023-11-26T00:00:00.000Z,85,22,Wendell Carter Jr.,0,0,0,0,0,0
3,0,3,0,0,3,2,10,6,30,2,1,10,5,1,1,1037833,2023-11-26T00:00:00.000Z,48,15,Bismack Biyombo,1,15,18,13,8,22.5
0,0,0,0,0,0,0,0,0,0,0,0,0,0,0,0,1037833,2023-11-26T00:00:00.000Z,666505,15,Brandon Clarke,0,0,0,0,0,0
2,0,2,5,2,9,4,1,1,28,2,2,11,4,0,1,1037833,2023-11-26T00:00:00.000Z,38017729,15,David Roddy,0,15,17,13,6,17.8
4,0,0,2,0,12,5,2,2,20,2,2,12,2,1,1,1037833,2023-11-26T00:00:00.000Z,401,15,Derrick Rose,1,14,18,16,6,22.4
4,0,1,9,3,16,5,0,0,34,1,3,13,2,0,5,1037833,2023-11-26T00:00:00.000Z,3547287,15,Desmond Bane,0,15,19,17,6,16.4
0,0,0,0,0,0,0,0,0,0,0,0,0,0,0,0,1037833,2023-11-26T00:00:00.000Z,56677830,15,GG Jackson,0,0,0,0,0,0
0,0,0,0,0,0,0,0,0,0,0,0,0,0,0,0,1037833,2023-11-26T00:00:00.000Z,666786,15,Ja Morant,0,0,0,0,0,0
1,0,0,2,0,2,0,0,0,16,0,0,0,0,0,0,1037833,2023-11-26T00:00:00.000Z,48248287,15,Jacob Gilyard,0,0,1,1,1,1.5
0,0,0,0,0,0,0,0,0,0,0,0,0,0,0,0,1037833,2023-11-26T00:00:00.000Z,38017728,15,Jake LaRavia,0,0,0,0,0,0
3,3,4,6,2,14,4,10,8,37,0,3,18,4,1,2,1037833,2023-11-26T00:00:00.000Z,231,15,Jaren Jackson Jr.,4,22,25,21,7,37.3
3,0,4,1,0,4,2,0,0,14,1,1,4,5,0,0,1037833,2023-11-26T00:00:00.000Z,666809,15,Jaylen Nowell,0,9,12,7,8,14.5
0,0,0,0,0,0,0,0,0,2,0,0,0,0,0,0,1037833,2023-11-26T00:00:00.000Z,666703,15,John Konchar,0,0,0,0,0,0
0,0,0,0,0,1,1,0,0,2,0,0,2,0,0,0,1037833,2023-11-26T00:00:00.000Z,38017732,15,Kenneth Lofton Jr.,0,2,2,2,0,2
0,0,0,0,0,0,0,0,0,0,0,0,0,0,0,0,1037833,2023-11-26T00:00:00.000Z,254,15,Luke Kennard,0,0,0,0,0,0
0,0,0,0,0,0,0,0,0,0,0,0,0,0,0,0,1037833,2023-11-26T00:00:00.000Z,420,15,Marcus Smart,0,0,0,0,0,0
2,0,5,7,1,15,6,2,1,27,2,0,14,7,0,1,1037833,2023-11-26T00:00:00.000Z,17896067,15,Santi Aldama,0,21,23,16,9,24.4
0,1,1,0,0,2,1,0,0,2,0,0,2,1,0,0,1037833,2023-11-26T00:00:00.000Z,199,15,Shaquille Harrison,1,3,3,2,1,6.2
0,0,0,0,0,0,0,0,0,0,0,0,0,0,0,0,1037833,2023-11-26T00:00:00.000Z,3,15,Steven Adams,0,0,0,0,0,0
1,0,2,2,0,2,0,0,0,10,1,1,0,3,1,0,1037833,2023-11-26T00:00:00.000Z,38017731,15,Vince Williams Jr.,1,3,4,1,4,8.1
0,0,0,0,0,0,0,0,0,0,0,0,0,0,0,0,1037833,2023-11-26T00:00:00.000Z,3547285,15,Xavier Tillman,0,0,0,0,0,0
1,0,2,3,2,8,4,2,1,18,0,5,11,2,0,2,1037833,2023-11-26T00:00:00.000Z,17896027,15,Ziaire Williams,0,13,14,12,3,12.9
0,0,0,1,1,2,1,0,0,2,0,0,3,0,0,0,1037833,2023-11-26T00:00:00.000Z,17895968,18,Daishen Nix,0,3,3,3,0,3
0,0,0,0,0,0,0,0,0,0,0,0,0,0,0,0,1037833,2023-11-26T00:00:00.000Z,3547259,18,Jaden McDaniels,0,0,0,0,0,0
0,0,0,0,0,0,0,0,0,0,0,0,0,0,0,0,1037833,2023-11-26T00:00:00.000Z,56677851,18,Jaylen Clark,0,0,0,0,0,0
0,0,0,0,0,0,0,0,0,0,0,0,0,0,0,0,1037833,2023-11-26T00:00:00.000Z,666767,18,Jordan McLaughlin,0,0,0,0,0,0
0,0,0,1,0,2,1,0,0,2,0,0,2,0,0,0,1037833,2023-11-26T00:00:00.000Z,38017715,18,Josh Minott,0,2,2,2,0,2
3,1,5,1,0,7,3,0,0,23,1,3,6,6,0,0,1037833,2023-11-26T00:00:00.000Z,12,18,Kyle Anderson,1,12,15,9,9,20.7
1,0,2,0,0,1,1,0,0,2,0,0,2,2,0,0,1037833,2023-11-26T00:00:00.000Z,56677782,18,Leonard Miller,0,4,5,3,3,5.9
0,0,0,0,0,0,0,0,0,0,0,0,0,0,0,0,1037833,2023-11-26T00:00:00.000Z,17896056,18,Luka Garza,0,0,0,0,0,0
0,0,4,2,1,9,4,4,3,22,2,4,12,6,1,1,1037833,2023-11-26T00:00:00.000Z,667378,18,Naz Reid,1,18,18,12,6,21.2
3,0,1,6,2,7,3,3,1,34,0,2,9,1,1,1,1037833,2023-11-26T00:00:00.000Z,666400,18,Nickeil Alexander-Walker,1,10,13,12,4,16.7
3,0,2,3,1,6,2,2,1,19,0,2,6,2,1,1,1037833,2023-11-26T00:00:00.000Z,320,18,Shake Milton,1,8,11,9,5,14.9
1,0,2,4,2,4,2,0,0,18,2,1,6,4,0,1,1037833,2023-11-26T00:00:00.000Z,68,18,Troy Brown Jr.,0,10,11,7,5,11.3
0,0,0,0,0,0,0,0,0,0,0,0,0,0,0,0,1037833,2023-11-26T00:00:00.000Z,38017700,18,Wendell Moore Jr.,0,0,0,0,0,0
0,0,0,0,0,0,0,0,0,0,0,0,0,0,0,0,1037834,2023-11-26T00:00:00.000Z,417,3,Ben Simmons,0,0,0,0,0,0
0,0,0,0,0,0,0,0,0,0,0,0,0,0,0,0,1037834,2023-11-26T00:00:00.000Z,17896048,3,Cam Thomas,0,0,0,0,0,0
6,0,2,5,2,8,4,0,0,22,2,2,10,4,0,0,1037834,2023-11-26T00:00:00.000Z,666679,3,Cameron Johnson,0,14,20,16,10,23.8
0,0,0,0,0,0,0,0,0,0,0,0,0,0,0,0,1037834,2023-11-26T00:00:00.000Z,56677841,3,Dariq Whitehead,0,0,0,0,0,0
3,1,6,2,0,7,4,2,1,27,3,4,9,9,0,1,1037834,2023-11-26T00:00:00.000Z,17896038,3,Day'Ron Sharpe,1,18,21,12,12,26.3
0,0,0,0,0,0,0,0,0,0,0,0,0,0,0,0,1037834,2023-11-26T00:00:00.000Z,421,3,Dennis Smith Jr.,0,0,0,0,0,0
1,1,4,7,3,10,3,0,0,34,0,3,9,4,2,1,1037834,2023-11-26T00:00:00.000Z,158,3,Dorian Finney-Smith,3,13,14,10,5,23.3
0,0,0,0,0,0,0,0,0,0,0,0,0,0,0,0,1037834,2023-11-26T00:00:00.000Z,17896041,3,Keon Johnson,0,0,0,0,0,0
0,0,1,10,6,13,6,2,2,25,0,1,20,1,2,2,1037834,2023-11-26T00:00:00.000Z,464,3,Lonnie Walker IV,2,21,21,20,1,25.2
6,0,2,6,4,7,5,2,1,36,0,0,15,2,0,2,1037834,2023-11-26T00:00:00.000Z,61,3,Mikal Bridges,0,17,23,21,8,24.4
0,0,0,0,0,0,0,0,0,0,0,0,0,0,0,0,1037834,2023-11-26T00:00:00.000Z,666508,3,Nicolas Claxton,0,0,0,0,0,0
0,0,0,0,0,0,0,0,0,0,0,0,0,0,0,0,1037834,2023-11-26T00:00:00.000Z,56677843,3,Noah Clowney,0,0,0,0,0,0
4,0,9,10,6,11,7,0,0,36,0,2,20,9,1,1,1037834,2023-11-26T00:00:00.000Z,351,3,Royce O'Neale,1,29,33,24,13,38.8
7,0,3,9,3,17,7,8,7,38,2,4,24,5,1,2,1037834,2023-11-26T00:00:00.000Z,130,3,Spencer Dinwiddie,1,29,36,31,12,41.5
2,0,3,2,1,8,5,1,0,17,1,2,11,4,1,0,1037834,2023-11-26T00:00:00.000Z,17896058,3,Trendon Watford,1,15,17,13,6,21.8
4,1,4,12,5,16,7,4,4,38,1,3,23,5,0,1,1037834,2023-11-26T00:00:00.000Z,666956,5,Coby White,1,28,32,27,9,37
0,0,0,0,0,0,0,0,0,0,0,0,0,0,0,0,1037834,2023-11-26T00:00:00.000Z,38017719,5,Dalen Terry,0,0,0,0,0,0
6,0,4,4,2,22,11,5,3,38,2,2,27,6,1,1,1037834,2023-11-26T00:00:00.000Z,125,5,DeMar DeRozan,1,33,39,33,12,45.2
0,0,0,2,0,2,0,0,0,8,0,0,0,0,0,1,1037834,2023-11-26T00:00:00.000Z,87,5,Jevon Carter,0,0,0,0,0,-1
5,1,8,3,0,9,3,0,0,37,1,5,6,9,1,2,1037834,2023-11-26T00:00:00.000Z,460,5,Nikola Vucevic,2,15,20,11,14,28.3
0,0,3,5,4,9,7,2,2,35,1,2,20,4,0,1,1037834,2023-11-26T00:00:00.000Z,3547248,5,Patrick Williams,0,24,24,20,4,23.8
0,0,1,0,0,2,1,2,2,20,2,0,4,3,0,2,1037834,2023-11-26T00:00:00.000Z,110,5,Torrey Craig,0,7,7,4,3,5.6
4,0,6,5,1,18,8,4,3,39,0,1,20,6,0,0,1037834,2023-11-26T00:00:00.000Z,268,5,Zach LaVine,0,26,30,24,10,33.2
1,0,3,4,1,10,3,0,0,22,0,1,7,3,0,0,1037835,2023-11-26T00:00:00.000Z,277,6,Caris LeVert,0,10,11,8,4,12.1
0,0,0,0,0,0,0,0,0,0,0,0,0,0,0,0,1037835,2023-11-26T00:00:00.000Z,248,6,Damian Jones,0,0,0,0,0,0
8,0,2,6,3,16,10,1,1,41,0,2,24,2,0,5,1037835,2023-11-26T00:00:00.000Z,666581,6,Darius Garland,0,26,34,32,10,33.4
4,0,4,5,0,17,4,3,2,34,1,0,10,5,1,0,1037835,2023-11-26T00:00:00.000Z,322,6,Donovan Mitchell,1,15,19,14,9,25
1,2,11,1,0,14,5,2,2,38,3,3,12,14,0,3,1037835,2023-11-26T00:00:00.000Z,17896076,6,Evan Mobley,2,26,27,13,15,33.3
3,2,1,0,0,10,9,0,0,27,3,4,18,4,0,2,1037835,2023-11-26T00:00:00.000Z,9,6,Jarrett Allen,2,22,25,21,7,31.3
5,1,10,9,4,16,8,0,0,37,1,4,20,11,0,2,1037835,2023-11-26T00:00:00.000Z,666908,6,Max Strus,1,31,36,25,16,41.7
0,0,0,0,0,0,0,0,0,0,0,0,0,0,0,0,1037835,2023-11-26T00:00:00.000Z,3547299,6,Sam Merrill,0,0,0,0,0,0
0,0,2,0,0,2,1,4,3,10,2,0,5,4,1,1,1037835,2023-11-26T00:00:00.000Z,58,28,Chris Boucher,1,9,9,5,4,11.8
4,0,2,5,2,11,5,3,3,29,0,5,15,2,2,1,1037835,2023-11-26T00:00:00.000Z,409,28,Dennis Schroder,2,17,21,19,6,28.4
0,0,0,0,0,0,0,0,0,0,0,0,0,0,0,0,1037835,2023-11-26T00:00:00.000Z,436,28,Garrett Temple,0,0,0,0,0,0
0,0,1,7,1,13,5,2,2,26,0,0,13,1,1,1,1037835,2023-11-26T00:00:00.000Z,3089,28,Gary Trent Jr.,1,14,14,13,1,16.2
0,0,0,0,0,0,0,0,0,0,0,0,0,0,0,0,1037835,2023-11-26T00:00:00.000Z,56677828,28,Gradey Dick,0,0,0,0,0,0
0,0,0,0,0,0,0,0,0,0,0,0,0,0,0,0,1037835,2023-11-26T00:00:00.000Z,666762,28,Jalen McDaniels,0,0,0,0,0,0
0,0,0,0,0,0,0,0,0,0,0,0,0,0,0,0,1037835,2023-11-26T00:00:00.000Z,56677805,28,Javon Freeman-Liberty,0,0,0,0,0,0
1,1,2,5,2,12,4,3,1,34,5,1,11,7,0,1,1037835,2023-11-26T00:00:00.000Z,18,28,OG Anunoby,1,18,19,12,8,22.9
0,0,0,1,0,1,0,0,0,5,1,0,0,1,0,0,1037835,2023-11-26T00:00:00.000Z,376,28,Otto Porter Jr.,0,1,1,0,1,1.2
0,0,0,0,0,0,0,0,0,0,0,0,0,0,0,0,1037835,2023-11-26T00:00:00.000Z,38017717,28,Ron Harper Jr.,0,0,0,0,0,0
0,0,0,0,0,0,0,0,0,0,0,0,0,0,0,0,1037835,2023-11-26T00:00:00.000Z,489,28,Thaddeus Young,0,0,0,0,0,0
0,0,0,0,0,0,0,0,0,0,0,0,0,0,0,0,1037836,2023-11-26T00:00:00.000Z,177,8,Aaron Gordon,0,0,0,0,0,0
1,0,1,1,0,1,0,0,0,2,0,0,0,1,0,0,1037836,2023-11-26T00:00:00.000Z,17896007,8,Braxton Key,0,1,2,1,2,2.7
0,0,0,0,0,0,0,0,0,2,0,0,0,0,0,0,1037836,2023-11-26T00:00:00.000Z,38017727,8,Collin Gillespie,0,0,0,0,0,0
0,0,1,0,0,0,0,0,0,1,0,0,0,1,0,0,1037836,2023-11-26T00:00:00.000Z,56677871,8,Hunter Tyson,0,1,1,0,1,1.2
0,0,0,0,0,0,0,0,0,2,0,1,0,0,0,1,1037836,2023-11-26T00:00:00.000Z,56677582,8,Jalen Pickett,0,0,0,0,0,-1
0,0,0,0,0,0,0,0,0,0,0,0,0,0,0,0,1037836,2023-11-26T00:00:00.000Z,335,8,Jamal Murray,0,0,0,0,0,0
0,0,0,0,0,1,1,0,0,1,0,0,2,0,0,0,1037836,2023-11-26T00:00:00.000Z,17896103,8,Jay Huff,0,2,2,2,0,2
3,0,2,4,1,5,2,0,0,27,0,2,5,2,1,0,1037836,2023-11-26T00:00:00.000Z,215,8,Justin Holiday,1,7,10,8,5,14.9
2,1,6,9,4,14,8,6,5,33,1,0,25,7,0,3,1037836,2023-11-26T00:00:00.000Z,375,8,Michael Porter Jr.,1,32,34,27,9,36.4
2,2,3,2,0,6,2,0,0,22,1,1,4,4,1,1,1037836,2023-11-26T00:00:00.000Z,38017721,8,Peyton Watson,3,8,10,6,6,19.8
0,0,0,0,0,0,0,0,0,0,0,0,0,0,0,0,1037836,2023-11-26T00:00:00.000Z,666489,8,Vlatko Cancar,0,0,0,0,0,0
0,0,0,0,0,0,0,0,0,0,0,0,0,0,0,0,1037836,2023-11-26T00:00:00.000Z,38017693,27,Blake Wesley,0,0,0,0,0,0
3,0,2,3,1,5,1,4,4,16,1,2,7,3,0,3,1037836,2023-11-26T00:00:00.000Z,359,27,Cedi Osman,0,10,13,10,6,12.1
2,1,4,0,0,5,3,3,3,15,2,3,9,6,0,1,1037836,2023-11-26T00:00:00.000Z,17895854,27,Charles Bassey,1,15,17,11,8,21.2
0,0,0,0,0,0,0,0,0,0,0,0,0,0,0,0,1037836,2023-11-26T00:00:00.000Z,56677865,27,Charles Bediako,0,0,0,0,0,0
3,0,1,7,4,13,7,1,1,26,0,1,19,1,1,0,1037836,2023-11-26T00:00:00.000Z,3547246,27,Devin Vassell,1,20,23,22,4,27.7
3,0,0,1,0,2,1,0,0,7,0,0,2,0,0,0,1037836,2023-11-26T00:00:00.000Z,180,27,Devonte' Graham,0,2,5,5,3,6.5
0,0,0,0,0,0,0,0,0,0,0,0,0,0,0,0,1037836,2023-11-26T00:00:00.000Z,38017730,27,Dominick Barlow,0,0,0,0,0,0
1,0,0,2,0,2,0,0,0,12,0,0,0,0,0,0,1037836,2023-11-26T00:00:00.000Z,305,27,Doug McDermott,0,0,1,1,1,1.5
1,1,1,6,3,8,4,4,2,17,0,1,13,1,0,0,1037836,2023-11-26T00:00:00.000Z,38017649,27,Julian Champagnie,1,14,15,14,2,18.7
2,0,1,2,0,7,3,5,4,31,0,1,10,1,0,0,1037836,2023-11-26T00:00:00.000Z,666682,27,Keldon Johnson,0,11,13,12,3,14.2
2,0,0,0,0,0,0,0,0,6,0,1,0,0,1,0,1037836,2023-11-26T00:00:00.000Z,17896059,27,Sandro Mamukelashvili,1,0,2,2,2,6
0,0,0,0,0,0,0,0,0,0,0,0,0,0,0,0,1037836,2023-11-26T00:00:00.000Z,56677817,27,Sidy Cissoko,0,0,0,0,0,0
0,0,0,0,0,0,0,0,0,0,0,0,0,0,0,0,1037836,2023-11-26T00:00:00.000Z,56677870,27,Sir'Jabari Rice,0,0,0,0,0,0
6,0,4,1,0,8,4,2,2,22,0,2,10,4,0,1,1037836,2023-11-26T00:00:00.000Z,3547274,27,Tre Jones,0,14,20,16,10,22.8
2,4,7,5,2,17,7,7,6,25,4,4,22,11,6,3,1037836,2023-11-26T00:00:00.000Z,56677822,27,Victor Wembanyama,10,33,35,24,13,65.2
3,0,2,4,1,9,4,0,0,21,2,4,9,4,1,4,1037836,2023-11-26T00:00:00.000Z,102,27,Zach Collins,1,13,16,12,7,17.3
1,0,0,5,0,8,2,4,4,13,0,1,8,0,0,0,1037837,2023-11-27T00:00:00.000Z,77,9,Alec Burks,0,8,9,9,1,9.5
2,1,4,2,0,14,8,0,0,28,0,4,16,4,2,1,1037837,2023-11-27T00:00:00.000Z,56677826,9,Ausar Thompson,3,20,22,18,6,31.8
7,0,4,7,2,22,10,4,4,32,1,2,26,5,1,1,1037837,2023-11-27T00:00:00.000Z,17896075,9,Cade Cunningham,1,31,38,33,12,44.5
3,0,1,8,2,11,3,0,0,23,0,1,8,1,1,2,1037837,2023-11-27T00:00:00.000Z,17896071,9,Isaiah Livers,1,9,12,11,4,14.7
0,0,6,7,1,11,3,0,0,29,2,2,7,8,1,0,1037837,2023-11-27T00:00:00.000Z,3547267,9,Isaiah Stewart,1,15,15,7,8,19.6
7,1,5,3,2,12,6,2,1,33,2,3,15,7,1,3,1037837,2023-11-27T00:00:00.000Z,38017682,9,Jaden Ivey,2,22,29,22,14,36.9
3,5,7,0,0,8,5,5,2,33,7,5,12,14,1,6,1037837,2023-11-27T00:00:00.000Z,38017694,9,Jalen Duren,6,26,29,15,17,45.3
0,0,0,0,0,0,0,0,0,0,0,0,0,0,0,0,1037837,2023-11-27T00:00:00.000Z,259,9,Kevin Knox,0,0,0,0,0,0
3,3,3,0,0,1,0,0,0,16,1,1,0,4,0,0,1037837,2023-11-27T00:00:00.000Z,3547241,9,Killian Hayes,3,4,7,3,7,18.3
3,1,0,5,1,10,3,0,0,22,1,1,7,1,0,1,1037837,2023-11-27T00:00:00.000Z,56677792,9,Marcus Sasser,1,8,11,10,4,14.7
0,0,0,0,0,0,0,0,0,0,0,0,0,0,0,0,1037837,2023-11-27T00:00:00.000Z,24,9,Marvin Bagley III,0,0,0,0,0,0
0,0,0,0,0,0,0,0,0,2,0,0,0,0,0,0,1037837,2023-11-27T00:00:00.000Z,3547302,30,Anthony Gill,0,0,0,0,0,0
0,1,4,2,0,6,2,1,1,28,0,1,5,4,2,2,1037837,2023-11-27T00:00:00.000Z,56677844,30,Bilal Coulibaly,3,9,9,5,4,16.8
1,0,5,1,0,7,4,0,0,19,0,4,8,5,1,0,1037837,2023-11-27T00:00:00.000Z,17896045,30,Corey Kispert,1,13,14,9,6,18.5
2,0,2,6,3,8,5,3,3,19,0,2,16,2,0,1,1037837,2023-11-27T00:00:00.000Z,167,30,Danilo Gallinari,0,18,20,18,4,20.4
5,0,6,3,1,9,6,3,3,26,0,3,16,6,0,3,1037837,2023-11-27T00:00:00.000Z,3547242,30,Deni Avdija,0,22,27,21,11,27.7
0,0,1,1,0,1,0,0,0,2,0,1,0,1,0,0,1037837,2023-11-27T00:00:00.000Z,18677954,30,Jared Butler,0,1,1,0,1,1.2
0,0,0,0,0,2,1,0,0,7,0,0,2,0,0,1,1037837,2023-11-27T00:00:00.000Z,38017687,30,Johnny Davis,0,2,2,2,0,1
8,0,12,7,2,23,10,11,10,35,0,0,32,12,0,1,1037837,2023-11-27T00:00:00.000Z,265,30,Kyle Kuzma,0,44,52,40,20,57.4
3,1,2,3,2,7,4,2,2,22,0,2,12,2,2,1,1037837,2023-11-27T00:00:00.000Z,414,30,Landry Shamet,3,14,17,15,5,26.9
0,0,0,0,0,0,0,0,0,0,0,0,0,0,0,0,1037837,2023-11-27T00:00:00.000Z,337,30,Mike Muscala,0,0,0,0,0,0
0,0,3,2,0,10,4,5,3,22,1,3,11,4,0,2,1037838,2023-11-27T00:00:00.000Z,38017686,12,Bennedict Mathurin,0,15,15,11,4,13.8
3,0,3,5,1,10,5,0,0,33,0,4,11,3,2,2,1037838,2023-11-27T00:00:00.000Z,69,12,Bruce Brown,2,14,17,14,6,23.1
3,1,1,6,1,10,3,2,2,24,0,1,9,1,1,2,1037838,2023-11-27T00:00:00.000Z,210,12,Buddy Hield,2,10,13,12,4,18.7
1,1,4,0,0,2,1,0,0,10,1,3,2,5,0,1,1037838,2023-11-27T00:00:00.000Z,17896035,12,Isaiah Jackson,1,7,8,3,6,11.5
0,2,7,3,0,11,5,1,1,27,1,4,11,8,2,1,1037838,2023-11-27T00:00:00.000Z,452,12,Myles Turner,4,19,19,11,8,31.6
2,1,2,4,1,9,3,2,2,19,2,0,9,4,0,1,1037838,2023-11-27T00:00:00.000Z,3547243,12,Obi Toppin,1,13,15,11,6,18.8
9,0,2,6,3,17,11,9,8,36,0,1,33,2,0,3,1037838,2023-11-27T00:00:00.000Z,3547245,12,Tyrese Haliburton,0,35,44,42,11,45.9
0,0,0,0,0,0,0,0,0,0,0,0,0,0,0,0,1037838,2023-11-27T00:00:00.000Z,17896120,25,Ish Wainright,0,0,0,0,0,0
0,0,0,0,0,0,0,0,0,0,0,0,0,0,0,0,1037838,2023-11-27T00:00:00.000Z,666476,25,Moses Brown,0,0,0,0,0,0
0,0,0,0,0,0,0,0,0,0,0,0,0,0,0,0,1037838,2023-11-27T00:00:00.000Z,476,25,Robert Williams III,0,0,0,0,0,0
1,0,2,3,2,10,4,6,3,22,1,5,13,3,1,4,1037838,2023-11-27T00:00:00.000Z,56677747,25,Scoot Henderson,1,16,17,14,4,17.1
2,1,8,0,0,14,7,5,3,32,3,4,17,11,1,2,1037839,2023-11-27T00:00:00.000Z,117,14,Anthony Davis,2,28,30,19,13,37.2
2,0,2,4,1,10,4,3,3,29,0,2,12,2,0,3,1037839,2023-11-27T00:00:00.000Z,17553995,14,Austin Reaves,0,14,16,14,4,14.4
0,0,0,0,0,0,0,0,0,0,0,0,0,0,0,0,1037839,2023-11-27T00:00:00.000Z,666860,14,Cameron Reddish,0,0,0,0,0,0
1,1,7,5,0,9,3,0,0,22,0,1,6,7,0,3,1037839,2023-11-27T00:00:00.000Z,486,14,Christian Wood,1,13,14,7,8,15.9
0,0,0,0,0,0,0,0,0,0,0,0,0,0,0,0,1037839,2023-11-27T00:00:00.000Z,56677738,14,Colin Castleton,0,0,0,0,0,0
7,0,2,2,1,10,5,2,1,24,0,0,12,2,0,0,1037839,2023-11-27T00:00:00.000Z,405,14,D'Angelo Russell,0,14,21,19,9,24.9
1,1,0,2,0,6,3,1,1,19,2,3,7,2,0,2,1037839,2023-11-27T00:00:00.000Z,666626,14,Jaxson Hayes,1,9,10,8,3,11.9
5,1,0,1,1,12,8,2,1,30,0,0,18,0,1,1,1037839,2023-11-27T00:00:00.000Z,237,14,LeBron James,2,18,23,23,5,30.5
1,0,3,3,0,6,3,0,0,26,0,3,6,3,1,1,1037839,2023-11-27T00:00:00.000Z,38017697,14,Max Christie,1,9,10,7,4,13.1
0,0,0,0,0,0,0,0,0,0,0,0,0,0,0,0,1037839,2023-11-27T00:00:00.000Z,666609,14,Rui Hachimura,0,0,0,0,0,0
1,0,4,6,3,8,4,0,0,29,0,3,11,4,0,1,1037839,2023-11-27T00:00:00.000Z,383,14,Taurean Prince,0,15,16,12,5,16.3
2,0,0,6,3,6,3,0,0,25,0,2,9,0,1,0,1037839,2023-11-27T00:00:00.000Z,313,23,De'Anthony Melton,1,9,11,11,2,15
0,0,0,0,0,0,0,0,0,0,0,0,0,0,0,0,1037839,2023-11-27T00:00:00.000Z,17896025,23,Jaden Springer,0,0,0,0,0,0
0,0,0,0,0,0,0,0,0,0,0,0,0,0,0,0,1037839,2023-11-27T00:00:00.000Z,17554001,23,Javonte Smart,0,0,0,0,0,0
11,1,7,3,2,15,9,12,10,31,4,2,30,11,1,3,1037839,2023-11-27T00:00:00.000Z,145,23,Joel Embiid,2,41,52,41,22,62.7
0,0,0,0,0,0,0,0,0,0,0,0,0,0,0,0,1037839,2023-11-27T00:00:00.000Z,360,23,Kelly Oubre Jr.,0,0,0,0,0,0
0,0,1,5,4,8,6,0,0,20,0,2,16,1,1,0,1037839,2023-11-27T00:00:00.000Z,328,23,Marcus Morris,1,17,17,16,1,20.2
0,0,2,1,1,4,3,0,0,6,1,0,7,3,0,0,1037839,2023-11-27T00:00:00.000Z,28,23,Mo Bamba,0,10,10,7,3,10.6
4,0,4,3,2,7,4,0,0,29,3,3,10,7,3,0,1037839,2023-11-27T00:00:00.000Z,33,23,Nicolas Batum,3,17,21,14,11,33.4
3,0,4,8,4,9,4,0,0,24,2,2,12,6,0,1,1037839,2023-11-27T00:00:00.000Z,45,23,Patrick Beverley,0,18,21,15,9,22.7
0,0,2,1,1,5,4,0,0,17,1,1,9,3,2,0,1037839,2023-11-27T00:00:00.000Z,3547270,23,Paul Reed,2,12,12,9,3,18.6
2,1,4,2,0,3,0,0,0,18,3,1,0,7,0,0,1037839,2023-11-27T00:00:00.000Z,108,23,Robert Covington,1,7,9,2,9,14.4
0,0,0,0,0,0,0,0,0,0,0,0,0,0,0,0,1037839,2023-11-27T00:00:00.000Z,56677788,23,Terquavion Smith,0,0,0,0,0,0
0,0,5,4,0,12,3,2,2,23,0,1,8,5,0,1,1037839,2023-11-27T00:00:00.000Z,200,23,Tobias Harris,0,13,13,8,5,13
8,0,3,12,5,20,9,9,8,36,0,2,31,3,1,0,1037839,2023-11-27T00:00:00.000Z,3547254,23,Tyrese Maxey,1,34,42,39,11,49.6
0,0,0,0,0,0,0,0,0,0,0,0,0,0,0,0,1037840,2023-11-27T00:00:00.000Z,3547260,19,Kira Lewis Jr.,0,0,0,0,0,0
0,0,2,6,2,10,4,3,2,29,1,1,12,3,0,1,1037840,2023-11-27T00:00:00.000Z,101,29,John Collins,0,15,15,12,3,14.6
10,0,4,9,2,16,4,6,6,32,0,1,16,4,0,1,1037840,2023-11-27T00:00:00.000Z,100,29,Jordan Clarkson,0,20,30,26,14,34.8
3,0,4,8,3,14,6,6,4,31,1,0,19,5,2,2,1037840,2023-11-27T00:00:00.000Z,56677834,29,Keyonte George,2,24,27,22,8,33.5
0,0,0,0,0,0,0,0,0,0,0,0,0,0,0,0,1037840,2023-11-27T00:00:00.000Z,139,29,Kris Dunn,0,0,0,0,0,0
0,0,0,6,3,7,4,1,1,16,0,1,12,0,0,0,1037840,2023-11-27T00:00:00.000Z,38017620,29,Ochai Agbaji,0,12,12,12,0,12
2,2,5,2,1,4,2,2,2,22,5,4,7,10,0,2,1037840,2023-11-27T00:00:00.000Z,11891374,29,Omer Yurtseven,2,17,19,9,12,26
2,0,4,8,3,9,4,4,3,28,0,3,14,4,2,0,1037840,2023-11-27T00:00:00.000Z,38017739,29,Simone Fontecchio,2,18,20,16,6,27.8
0,0,0,0,0,0,0,0,0,0,0,0,0,0,0,0,1037840,2023-11-27T00:00:00.000Z,56677824,29,Taylor Hendricks,0,0,0,0,0,0
0,0,0,0,0,0,0,0,0,0,0,0,0,0,0,0,1037841,2023-11-27T00:00:00.000Z,177,8,Aaron Gordon,0,0,0,0,0,0
0,0,0,0,0,0,0,0,0,0,0,0,0,0,0,0,1037841,2023-11-27T00:00:00.000Z,17896007,8,Braxton Key,0,0,0,0,0,0
2,0,1,1,0,4,0,0,0,12,1,4,0,2,0,0,1037841,2023-11-27T00:00:00.000Z,38017709,8,Christian Braun,0,2,4,2,4,5.4
0,0,0,0,0,0,0,0,0,0,0,0,0,0,0,0,1037841,2023-11-27T00:00:00.000Z,38017727,8,Collin Gillespie,0,0,0,0,0,0
5,1,10,0,0,11,8,11,5,33,3,3,21,13,2,2,1037841,2023-11-27T00:00:00.000Z,250,8,DeAndre Jordan,3,34,39,26,18,51.1
0,0,0,0,0,0,0,0,0,0,0,0,0,0,0,0,1037841,2023-11-27T00:00:00.000Z,56677582,8,Jalen Pickett,0,0,0,0,0,0
0,0,0,0,0,0,0,0,0,1,0,0,0,0,0,0,1037841,2023-11-27T00:00:00.000Z,17896103,8,Jay Huff,0,0,0,0,0,0
1,1,3,5,3,8,3,0,0,19,0,1,9,3,0,1,1037841,2023-11-27T00:00:00.000Z,56677776,8,Julian Strawther,1,12,13,10,4,16.1
1,0,5,4,2,8,5,0,0,34,1,2,12,6,1,3,1037841,2023-11-27T00:00:00.000Z,215,8,Justin Holiday,1,18,19,13,7,20.7
2,0,1,1,0,14,3,6,6,38,2,2,12,3,1,0,1037841,2023-11-27T00:00:00.000Z,81,8,Kentavious Caldwell-Pope,1,15,17,14,5,21.6
3,0,7,7,2,13,3,0,0,29,3,5,8,10,0,1,1037841,2023-11-27T00:00:00.000Z,375,8,Michael Porter Jr.,0,18,21,11,13,23.5
1,1,3,0,0,7,4,2,0,23,0,0,8,3,2,1,1037841,2023-11-27T00:00:00.000Z,38017721,8,Peyton Watson,3,11,12,9,4,21.1
13,0,4,4,3,19,15,4,2,40,1,3,35,5,2,2,1037841,2023-11-27T00:00:00.000Z,236,8,Reggie Jackson,2,40,53,48,18,64.5
0,0,0,0,0,0,0,0,0,0,0,0,0,0,0,0,1037841,2023-11-27T00:00:00.000Z,666489,8,Vlatko Cancar,0,0,0,0,0,0
0,3,0,0,0,8,3,5,2,11,7,2,8,7,0,1,1037841,2023-11-27T00:00:00.000Z,3547268,8,Zeke Nnaji,3,15,15,8,7,24.4
0,0,0,0,0,0,0,0,0,0,0,0,0,0,0,0,1037841,2023-11-27T00:00:00.000Z,666511,13,Amir Coffey,0,0,0,0,0,0
0,0,0,0,0,0,0,0,0,0,0,0,0,0,0,0,1037841,2023-11-27T00:00:00.000Z,17896022,13,Brandon Boston Jr.,0,0,0,0,0,0
1,2,0,0,0,4,2,0,0,12,1,3,4,1,0,1,1037841,2023-11-27T00:00:00.000Z,439,13,Daniel Theis,2,5,6,5,2,11.7
1,1,6,0,0,15,9,8,5,32,8,2,23,14,0,1,1037841,2023-11-27T00:00:00.000Z,493,13,Ivica Zubac,1,37,38,24,15,43.3
4,0,2,5,3,7,3,2,2,36,0,3,11,2,1,3,1037841,2023-11-27T00:00:00.000Z,192,13,James Harden,1,13,17,15,6,19.4
0,0,0,0,0,0,0,0,0,0,0,0,0,0,0,0,1037841,2023-11-27T00:00:00.000Z,56677856,13,Jordan Miller,0,0,0,0,0,0
0,0,0,0,0,0,0,0,0,0,0,0,0,0,0,0,1037841,2023-11-27T00:00:00.000Z,17896051,13,Joshua Primo,0,0,0,0,0,0
3,2,7,5,2,26,10,9,9,39,1,0,31,8,1,2,1037841,2023-11-27T00:00:00.000Z,274,13,Kawhi Leonard,3,39,42,34,11,52.1
0,0,0,0,0,0,0,0,0,0,0,0,0,0,0,0,1037841,2023-11-27T00:00:00.000Z,56677849,13,Kobe Brown,0,0,0,0,0,0
0,0,0,0,0,0,0,0,0,0,0,0,0,0,0,0,1037841,2023-11-27T00:00:00.000Z,371,13,Mason Plumlee,0,0,0,0,0,0
0,0,0,0,0,0,0,0,0,0,0,0,0,0,0,0,1037841,2023-11-27T00:00:00.000Z,38017725,13,Moussa Diabate,0,0,0,0,0,0
0,0,0,0,0,0,0,0,0,0,0,0,0,0,0,0,1037841,2023-11-27T00:00:00.000Z,17896031,13,Nah'Shon Hyland,0,0,0,0,0,0
1,1,1,5,1,8,2,5,5,21,1,3,10,2,1,0,1037841,2023-11-27T00:00:00.000Z,380,13,Norman Powell,2,12,13,11,3,19.9
4,1,5,4,0,13,2,2,2,37,3,5,6,8,1,3,1037841,2023-11-27T00:00:00.000Z,172,13,Paul George,2,14,18,10,12,24.6
1,0,0,0,0,0,0,0,0,6,0,1,0,0,2,0,1037841,2023-11-27T00:00:00.000Z,450,13,PJ Tucker,2,0,1,1,1,7.5
3,1,10,0,0,9,5,6,4,27,1,4,14,11,0,2,1037841,2023-11-27T00:00:00.000Z,472,13,Russell Westbrook,1,25,28,17,14,32.7
0,1,2,1,0,3,2,2,1,30,1,2,5,3,0,1,1037841,2023-11-27T00:00:00.000Z,666743,13,Terance Mann,1,8,8,5,3,10.6
0,0,0,0,0,0,0,0,0,0,0,0,0,0,0,0,1037841,2023-11-27T00:00:00.000Z,24417679,13,Xavier Moon,0,0,0,0,0,0
6,3,9,6,4,8,6,0,0,28,0,3,16,9,2,3,3277527,2023-11-28T00:00:00.000Z,219,2,Al Horford,5,25,31,22,15,47.8
0,1,0,2,1,3,2,0,0,15,0,1,5,0,0,0,3277527,2023-11-28T00:00:00.000Z,17896094,2,Dalano Banton,1,5,5,5,0,8
7,0,3,3,2,7,5,2,2,28,0,4,14,3,2,0,3277527,2023-11-28T00:00:00.000Z,473,2,Derrick White,2,17,24,21,10,34.1
6,1,6,8,3,23,12,5,3,35,2,1,30,8,0,3,3277527,2023-11-28T00:00:00.000Z,70,2,Jaylen Brown,1,38,44,36,14,48.6
4,0,6,8,2,16,8,3,3,35,1,2,21,7,0,4,3277527,2023-11-28T00:00:00.000Z,434,2,Jayson Tatum,0,28,32,25,11,31.4
0,0,0,0,0,0,0,0,0,0,0,0,0,0,0,0,3277527,2023-11-28T00:00:00.000Z,38017707,2,JD Davison,0,0,0,0,0,0
0,0,0,0,0,0,0,0,0,0,0,0,0,0,0,0,3277527,2023-11-28T00:00:00.000Z,56677864,2,Jordan Walsh,0,0,0,0,0,0
9,0,6,5,4,8,5,0,0,33,1,3,14,7,1,3,3277527,2023-11-28T00:00:00.000Z,214,2,Jrue Holiday,1,21,30,23,16,35.9
0,0,0,0,0,0,0,0,0,0,0,0,0,0,0,0,3277527,2023-11-28T00:00:00.000Z,378,2,Kristaps Porzingis,0,0,0,0,0,0
0,1,0,0,0,0,0,0,0,1,0,0,0,0,0,0,3277527,2023-11-28T00:00:00.000Z,3547279,2,Lamar Stevens,1,0,0,0,0,3
0,3,1,0,0,3,2,0,0,19,2,3,4,3,0,1,3277527,2023-11-28T00:00:00.000Z,261,2,Luke Kornet,3,7,7,4,3,15.6
0,0,0,0,0,0,0,0,0,0,0,0,0,0,0,0,3277527,2023-11-28T00:00:00.000Z,3547295,2,Nathan Knight,0,0,0,0,0,0
0,0,0,0,0,0,0,0,0,0,0,0,0,0,0,0,3277527,2023-11-28T00:00:00.000Z,17553967,2,Neemias Queta,0,0,0,0,0,0
0,0,0,0,0,0,0,0,0,0,0,0,0,0,0,0,3277527,2023-11-28T00:00:00.000Z,666468,2,Oshae Brissett,0,0,0,0,0,0
2,0,4,7,3,10,4,0,0,23,1,0,11,5,1,0,3277527,2023-11-28T00:00:00.000Z,3547276,2,Payton Pritchard,1,16,18,13,7,23
2,0,6,10,2,12,3,2,1,21,4,1,9,10,0,2,3277527,2023-11-28T00:00:00.000Z,17896060,2,Sam Hauser,0,19,21,11,12,22
0,0,0,0,0,0,0,0,0,2,0,0,0,0,0,0,3277527,2023-11-28T00:00:00.000Z,338,2,Svi Mykhailiuk,0,0,0,0,0,0
0,0,0,0,0,0,0,0,0,0,0,0,0,0,0,0,3277527,2023-11-28T00:00:00.000Z,56677860,5,Adama Sanogo,0,0,0,0,0,0
2,0,1,6,2,9,3,0,0,19,1,2,8,2,3,1,3277527,2023-11-28T00:00:00.000Z,89,5,Alex Caruso,3,10,12,10,4,21.4
0,1,4,0,0,5,2,6,1,13,2,1,5,6,0,0,3277527,2023-11-28T00:00:00.000Z,137,5,Andre Drummond,1,11,11,5,6,15.2
2,0,0,3,1,10,4,2,1,24,0,3,10,0,1,0,3277527,2023-11-28T00:00:00.000Z,17895983,5,Ayo Dosunmu,1,10,12,12,2,16
3,0,1,5,3,12,7,2,2,30,0,0,19,1,0,0,3277527,2023-11-28T00:00:00.000Z,666956,5,Coby White,0,20,23,22,4,24.7
1,1,4,0,0,0,0,0,0,7,1,1,0,5,0,0,3277527,2023-11-28T00:00:00.000Z,38017719,5,Dalen Terry,1,5,6,1,6,10.5
6,0,2,3,1,14,7,4,4,26,0,2,19,2,0,2,3277527,2023-11-28T00:00:00.000Z,125,5,DeMar DeRozan,0,21,27,25,8,28.4
2,1,1,1,0,7,4,0,0,17,0,0,8,1,0,1,3277527,2023-11-28T00:00:00.000Z,87,5,Jevon Carter,1,9,11,10,3,14.2
1,0,2,1,0,2,0,2,1,10,0,0,1,2,0,1,3277527,2023-11-28T00:00:00.000Z,56677857,5,Julian Phillips,0,3,4,2,3,3.9
0,0,0,0,0,0,0,0,0,0,0,0,0,0,0,0,3277527,2023-11-28T00:00:00.000Z,45969255,5,Justin Lewis,0,0,0,0,0,0
0,0,0,0,0,0,0,0,0,0,0,0,0,0,0,0,3277527,2023-11-28T00:00:00.000Z,27,5,Lonzo Ball,0,0,0,0,0,0
2,1,8,2,0,11,4,0,0,25,0,1,8,8,2,1,3277527,2023-11-28T00:00:00.000Z,460,5,Nikola Vucevic,3,16,18,10,10,28.6
0,0,0,0,0,0,0,0,0,0,0,0,0,0,0,0,3277527,2023-11-28T00:00:00.000Z,56677874,5,Onuralp Bitim,0,0,0,0,0,0
2,2,3,3,1,10,6,2,1,28,4,2,14,7,1,2,3277527,2023-11-28T00:00:00.000Z,3547248,5,Patrick Williams,3,21,23,16,9,32.4
0,0,0,0,0,0,0,0,0,3,0,0,0,0,1,0,3277527,2023-11-28T00:00:00.000Z,17896116,5,Terry Taylor,1,0,0,0,0,3
0,1,1,1,1,1,1,0,0,13,0,0,3,1,1,0,3277527,2023-11-28T00:00:00.000Z,110,5,Torrey Craig,2,4,4,3,1,10.2
4,0,1,3,0,9,1,0,0,25,1,1,2,2,2,0,3277527,2023-11-28T00:00:00.000Z,268,5,Zach LaVine,2,4,8,6,6,16.4
0,0,0,0,0,0,0,0,0,0,0,0,0,0,0,0,3277528,2023-11-28T00:00:00.000Z,9051997,3,Armoni Brooks,0,0,0,0,0,0
3,0,8,4,1,11,6,5,5,27,1,1,18,9,0,2,3277528,2023-11-28T00:00:00.000Z,666679,3,Cameron Johnson,0,27,30,21,12,31.3
2,0,4,0,0,4,2,1,1,15,1,2,5,5,0,0,3277528,2023-11-28T00:00:00.000Z,17896038,3,Day'Ron Sharpe,0,10,12,7,7,14
2,1,4,4,1,9,2,0,0,26,5,4,5,9,1,0,3277528,2023-11-28T00:00:00.000Z,158,3,Dorian Finney-Smith,2,14,16,7,11,24.8
0,0,0,0,0,0,0,0,0,0,0,0,0,0,0,0,3277528,2023-11-28T00:00:00.000Z,174,3,Harry Giles III,0,0,0,0,0,0
5,0,9,3,1,17,9,3,3,38,1,3,22,10,0,5,3277528,2023-11-28T00:00:00.000Z,61,3,Mikal Bridges,0,32,37,27,15,36.5
0,4,6,0,0,10,7,4,1,32,2,1,15,8,1,0,3277528,2023-11-28T00:00:00.000Z,666508,3,Nicolas Claxton,5,23,23,15,8,39.6
4,2,5,12,6,12,6,0,0,31,2,5,18,7,1,1,3277528,2023-11-28T00:00:00.000Z,351,3,Royce O'Neale,3,25,29,22,11,40.4
8,0,8,11,3,18,5,10,10,38,1,0,23,9,4,1,3277528,2023-11-28T00:00:00.000Z,130,3,Spencer Dinwiddie,4,32,40,31,17,56.8
0,0,0,4,3,7,5,0,0,12,1,0,13,1,1,0,3277528,2023-11-28T00:00:00.000Z,58,28,Chris Boucher,1,14,14,13,1,17.2
9,0,4,5,2,15,5,3,2,32,1,3,14,5,1,0,3277528,2023-11-28T00:00:00.000Z,409,28,Dennis Schroder,1,19,28,23,14,36.5
0,0,0,0,0,0,0,0,0,0,0,0,0,0,0,0,3277528,2023-11-28T00:00:00.000Z,436,28,Garrett Temple,0,0,0,0,0,0
1,0,2,4,1,12,7,0,0,25,0,1,15,2,1,0,3277528,2023-11-28T00:00:00.000Z,3089,28,Gary Trent Jr.,1,17,18,16,3,21.9
0,0,0,0,0,0,0,0,0,0,0,0,0,0,0,0,3277528,2023-11-28T00:00:00.000Z,56677828,28,Gradey Dick,0,0,0,0,0,0
4,2,6,0,0,5,3,0,0,25,3,2,6,9,1,1,3277528,2023-11-28T00:00:00.000Z,373,28,Jakob Poeltl,3,15,19,10,13,30.8
1,1,1,1,1,4,2,0,0,13,1,2,5,2,2,0,3277528,2023-11-28T00:00:00.000Z,666762,28,Jalen McDaniels,3,7,8,6,3,17.9
0,0,0,0,0,0,0,0,0,0,0,0,0,0,0,0,3277528,2023-11-28T00:00:00.000Z,56677805,28,Javon Freeman-Liberty,0,0,0,0,0,0
1,0,0,3,1,5,2,0,0,16,0,1,5,0,0,0,3277528,2023-11-28T00:00:00.000Z,3547275,28,Malachi Flynn,0,5,6,6,1,6.5
0,0,0,0,0,0,0,0,0,0,0,0,0,0,0,0,3277528,2023-11-28T00:00:00.000Z,376,28,Otto Porter Jr.,0,0,0,0,0,0
2,0,8,4,0,18,6,7,5,35,2,2,17,10,1,2,3277528,2023-11-28T00:00:00.000Z,416,28,Pascal Siakam,1,27,29,19,12,33
1,0,2,2,0,4,0,4,1,10,1,3,1,3,1,1,3277528,2023-11-28T00:00:00.000Z,3547249,28,Precious Achiuwa,1,4,5,2,4,8.1
0,0,0,0,0,0,0,0,0,0,0,0,0,0,0,0,3277528,2023-11-28T00:00:00.000Z,38017717,28,Ron Harper Jr.,0,0,0,0,0,0
6,0,7,7,3,19,5,5,4,36,4,4,17,11,3,1,3277528,2023-11-28T00:00:00.000Z,17896055,28,Scottie Barnes,3,28,34,23,17,47.2
0,0,0,0,0,0,0,0,0,0,0,0,0,0,0,0,3277528,2023-11-28T00:00:00.000Z,489,28,Thaddeus Young,0,0,0,0,0,0
0,0,0,4,0,8,0,0,0,15,1,1,0,1,0,0,3277529,2023-11-28T00:00:00.000Z,38017689,1,AJ Griffin,0,1,1,0,1,1.2
1,0,5,10,4,16,6,2,2,31,1,2,18,6,2,1,3277529,2023-11-28T00:00:00.000Z,53,1,Bogdan Bogdanovic,2,24,25,19,7,31.7
0,0,1,0,0,6,1,0,0,4,2,1,2,3,0,1,3277529,2023-11-28T00:00:00.000Z,666564,1,Bruno Fernando,0,5,5,2,3,4.6
0,0,1,1,0,1,0,0,0,4,0,0,0,1,0,0,3277529,2023-11-28T00:00:00.000Z,666754,1,Garrison Mathews,0,1,1,0,1,1.2
0,0,0,0,0,0,0,0,0,0,0,0,0,0,0,0,3277529,2023-11-28T00:00:00.000Z,17896040,1,Jalen Johnson,0,0,0,0,0,0
0,0,0,0,0,0,0,0,0,0,0,0,0,0,0,0,3277529,2023-11-28T00:00:00.000Z,56677838,1,Kobe Bufkin,0,0,0,0,0,0
0,0,0,0,0,0,0,0,0,0,0,0,0,0,0,0,3277529,2023-11-28T00:00:00.000Z,56677875,1,Miles Norris,0,0,0,0,0,0
0,0,0,0,0,0,0,0,0,0,0,0,0,0,0,0,3277529,2023-11-28T00:00:00.000Z,56677806,1,Mouhamed Gueye,0,0,0,0,0,0
2,0,7,1,1,8,4,5,4,22,2,0,13,9,0,0,3277529,2023-11-28T00:00:00.000Z,3547244,1,Onyeka Okongwu,0,22,24,15,11,26.8
0,0,0,0,0,0,0,0,0,0,0,0,0,0,0,0,3277529,2023-11-28T00:00:00.000Z,319,1,Patty Mills,0,0,0,0,0,0
0,0,0,0,0,0,0,0,0,0,0,0,0,0,0,0,3277529,2023-11-28T00:00:00.000Z,56677855,1,Seth Lundy,0,0,0,0,0,0
10,0,1,8,2,14,3,6,5,32,0,3,13,1,1,3,3277529,2023-11-28T00:00:00.000Z,490,1,Trae Young,1,14,24,23,11,29.2
0,0,0,0,0,1,0,0,0,4,0,0,0,0,0,0,3277529,2023-11-28T00:00:00.000Z,3547297,1,Trent Forrest,0,0,0,0,0,0
2,0,3,3,0,3,0,0,0,17,0,0,0,3,0,0,3277529,2023-11-28T00:00:00.000Z,301,1,Wesley Matthews,0,3,5,2,5,6.6
0,0,0,0,0,0,0,0,0,0,0,0,0,0,0,0,3277529,2023-11-28T00:00:00.000Z,3547299,6,Sam Merrill,0,0,0,0,0,0
5,2,8,0,0,27,13,7,5,42,2,3,31,10,0,2,3277530,2023-11-28T00:00:00.000Z,4,16,Bam Adebayo,2,41,46,36,15,54.5
1,0,1,3,2,11,6,0,0,26,0,2,14,1,1,0,3277530,2023-11-28T00:00:00.000Z,666747,16,Caleb Martin,1,15,16,15,2,19.7
0,0,0,0,0,0,0,0,0,0,0,0,0,0,0,0,3277530,2023-11-28T00:00:00.000Z,38017736,16,Cole Swider,0,0,0,0,0,0
3,1,3,7,3,11,5,2,0,31,0,3,13,3,0,2,3277530,2023-11-28T00:00:00.000Z,397,16,Duncan Robinson,1,16,19,16,6,22.1
7,0,2,7,3,13,7,4,3,37,1,2,20,3,0,0,3277530,2023-11-28T00:00:00.000Z,391,16,Josh Richardson,0,23,30,27,10,34.1
4,0,6,5,2,11,2,0,0,26,4,2,6,10,0,0,3277530,2023-11-28T00:00:00.000Z,285,16,Kevin Love,0,16,20,10,14,24
6,1,4,5,3,10,7,4,4,34,0,5,21,4,1,1,3277530,2023-11-28T00:00:00.000Z,286,16,Kyle Lowry,2,25,31,27,10,39.8
0,0,0,0,0,0,0,0,0,0,0,0,0,0,0,0,3277530,2023-11-28T00:00:00.000Z,39398582,16,Orlando Robinson,0,0,0,0,0,0
2,0,3,8,4,18,7,0,0,36,0,2,18,3,1,3,3277531,2023-11-28T00:00:00.000Z,56677823,4,Brandon Miller,1,21,23,20,5,24.6
0,0,1,2,1,5,2,0,0,13,1,1,5,2,1,0,3277531,2023-11-28T00:00:00.000Z,38017708,4,Bryce McGowens,1,7,7,5,2,10.4
6,0,4,2,0,7,2,0,0,28,2,1,4,6,0,2,3277531,2023-11-28T00:00:00.000Z,204,4,Gordon Hayward,0,10,16,10,12,18.2
1,0,1,0,0,3,2,0,0,14,0,1,4,1,0,3,3277531,2023-11-28T00:00:00.000Z,422,4,Ish Smith,0,5,6,5,2,3.7
0,0,2,0,0,0,0,0,0,13,0,1,0,2,0,1,3277531,2023-11-28T00:00:00.000Z,18678001,4,JT Thor,0,2,2,0,2,1.4
0,0,0,0,0,0,0,0,0,5,0,0,0,0,1,0,3277531,2023-11-28T00:00:00.000Z,56677866,4,Leaky Black,1,0,0,0,0,3
0,0,6,0,0,9,5,2,2,25,6,2,12,12,1,0,3277531,2023-11-28T00:00:00.000Z,38017698,4,Mark Williams,1,24,24,12,12,29.4
2,1,4,3,2,12,5,2,1,32,0,2,13,4,2,2,3277531,2023-11-28T00:00:00.000Z,62,4,Miles Bridges,3,17,19,15,6,27.8
3,1,5,8,3,10,4,2,0,27,3,3,11,8,1,3,3277531,2023-11-28T00:00:00.000Z,666950,4,P.J. Washington,2,19,22,14,11,28.1
5,0,2,3,0,16,5,1,1,32,0,0,11,2,1,3,3277531,2023-11-28T00:00:00.000Z,403,4,Terry Rozier,1,13,18,16,7,20.9
0,0,2,6,2,8,2,0,0,19,0,0,6,2,1,2,3277531,2023-11-28T00:00:00.000Z,131,20,Donte DiVincenzo,1,8,8,6,2,9.4
0,0,0,0,0,0,0,0,0,0,0,0,0,0,0,0,3277531,2023-11-28T00:00:00.000Z,666971,20,Dylan Windler,0,0,0,0,0,0
0,0,0,0,0,0,0,0,0,0,0,0,0,0,0,0,3277531,2023-11-28T00:00:00.000Z,160,20,Evan Fournier,0,0,0,0,0,0
1,0,3,10,4,20,9,1,1,26,0,1,23,3,0,1,3277531,2023-11-28T00:00:00.000Z,3547269,20,Immanuel Quickley,0,26,27,24,4,27.1
2,0,3,0,0,3,2,0,0,14,3,2,4,6,0,0,3277531,2023-11-28T00:00:00.000Z,201,20,Isaiah Hartenstein,0,10,12,6,8,14.2
7,0,2,5,2,9,5,1,0,33,1,3,12,3,3,2,3277531,2023-11-28T00:00:00.000Z,73,20,Jalen Brunson,3,15,22,19,10,33.1
2,1,5,3,2,10,7,1,1,30,1,2,17,6,1,1,3277531,2023-11-28T00:00:00.000Z,202,20,Josh Hart,2,23,25,19,8,32.2
5,0,16,7,2,15,8,8,7,34,4,2,25,20,2,4,3277531,2023-11-28T00:00:00.000Z,387,20,Julius Randle,2,45,50,30,25,58.5
0,6,5,0,0,6,3,0,0,33,5,1,6,10,2,4,3277531,2023-11-28T00:00:00.000Z,399,20,Mitchell Robinson,8,16,16,6,10,38
1,0,0,3,2,4,2,0,0,19,1,0,6,1,0,1,3277531,2023-11-28T00:00:00.000Z,17895858,20,Quentin Grimes,0,7,8,7,2,7.7
2,0,3,4,1,13,3,9,9,28,0,1,16,3,1,1,3277531,2023-11-28T00:00:00.000Z,666423,20,RJ Barrett,1,19,21,18,5,24.6
0,0,0,0,0,0,0,0,0,0,0,0,0,0,0,0,3277531,2023-11-28T00:00:00.000Z,19,20,Ryan Arcidiacono,0,0,0,0,0,0
1,1,5,6,3,16,7,6,4,28,0,2,21,5,0,2,3277532,2023-11-28T00:00:00.000Z,3547238,18,Anthony Edwards,1,26,27,22,6,29.5
0,0,0,0,0,0,0,0,0,0,0,0,0,0,0,0,3277532,2023-11-28T00:00:00.000Z,17895968,18,Daishen Nix,0,0,0,0,0,0
0,0,0,0,0,0,0,0,0,0,0,0,0,0,0,0,3277532,2023-11-28T00:00:00.000Z,3547259,18,Jaden McDaniels,0,0,0,0,0,0
0,0,0,0,0,0,0,0,0,0,0,0,0,0,0,0,3277532,2023-11-28T00:00:00.000Z,56677851,18,Jaylen Clark,0,0,0,0,0,0
0,0,0,0,0,0,0,0,0,0,0,0,0,0,0,0,3277532,2023-11-28T00:00:00.000Z,666767,18,Jordan McLaughlin,0,0,0,0,0,0
0,0,0,0,0,0,0,0,0,0,0,0,0,0,0,0,3277532,2023-11-28T00:00:00.000Z,38017715,18,Josh Minott,0,0,0,0,0,0
3,0,10,3,1,8,2,8,8,32,0,4,13,10,0,6,3277532,2023-11-28T00:00:00.000Z,447,18,Karl-Anthony Towns,0,23,26,16,13,23.5
0,0,0,0,0,0,0,0,0,0,0,0,0,0,0,0,3277532,2023-11-28T00:00:00.000Z,56677782,18,Leonard Miller,0,0,0,0,0,0
0,0,0,0,0,0,0,0,0,0,0,0,0,0,0,0,3277532,2023-11-28T00:00:00.000Z,17896056,18,Luka Garza,0,0,0,0,0,0
8,0,2,10,3,14,3,0,0,37,0,2,9,2,1,0,3277532,2023-11-28T00:00:00.000Z,104,18,Mike Conley,1,11,19,17,10,26.4
2,2,6,4,3,9,6,0,0,25,1,2,15,7,0,1,3277532,2023-11-28T00:00:00.000Z,667378,18,Naz Reid,2,22,24,17,9,31.4
1,0,1,5,1,7,1,0,0,26,1,2,3,2,0,2,3277532,2023-11-28T00:00:00.000Z,666400,18,Nickeil Alexander-Walker,0,5,6,4,3,4.9
0,4,10,0,0,10,6,6,5,36,6,1,17,16,1,1,3277532,2023-11-28T00:00:00.000Z,176,18,Rudy Gobert,5,33,33,17,16,50.2
0,0,3,4,3,6,5,6,4,21,0,2,17,3,0,1,3277532,2023-11-28T00:00:00.000Z,68,18,Troy Brown Jr.,0,20,20,17,3,19.6
0,0,0,0,0,0,0,0,0,0,0,0,0,0,0,0,3277532,2023-11-28T00:00:00.000Z,38017700,18,Wendell Moore Jr.,0,0,0,0,0,0
1,0,2,2,2,4,3,0,0,16,1,2,8,3,0,0,3277532,2023-11-28T00:00:00.000Z,17896078,21,Aaron Wiggins,0,11,12,9,4,13.1
0,0,0,3,3,4,3,2,1,17,0,0,10,0,1,0,3277532,2023-11-28T00:00:00.000Z,56677833,21,Cason Wallace,1,10,10,10,0,13
6,1,6,8,3,20,6,2,1,34,2,2,16,8,1,0,3277532,2023-11-28T00:00:00.000Z,38017685,21,Chet Holmgren,2,24,30,22,14,40.6
0,0,0,0,0,0,0,0,0,0,0,0,0,0,0,0,3277532,2023-11-28T00:00:00.000Z,44,21,Davis Bertans,0,0,0,0,0,0
3,0,1,5,1,7,3,2,2,24,0,2,9,1,3,0,3277532,2023-11-28T00:00:00.000Z,3547272,21,Isaiah Joe,3,10,13,12,4,23.7
3,1,3,3,0,10,2,7,6,34,0,4,10,3,0,1,3277532,2023-11-28T00:00:00.000Z,38017703,21,Jalen Williams,1,13,16,13,6,20.1
3,0,4,3,1,6,1,0,0,11,1,1,3,5,0,1,3277532,2023-11-28T00:00:00.000Z,38017706,21,Jaylin Williams,0,8,11,6,8,12.5
1,0,3,1,0,8,4,4,2,28,3,1,10,6,0,2,3277532,2023-11-28T00:00:00.000Z,17896065,21,Josh Giddey,0,16,17,11,7,16.7
0,0,1,2,0,3,1,0,0,15,1,4,2,2,0,0,3277532,2023-11-28T00:00:00.000Z,480,21,Kenrich Williams,0,4,4,2,2,4.4
1,0,3,2,1,5,1,0,0,25,0,5,3,3,0,1,3277532,2023-11-28T00:00:00.000Z,666541,21,Luguentz Dort,0,6,7,4,4,7.1
0,0,0,0,0,0,0,0,0,0,0,0,0,0,0,0,3277532,2023-11-28T00:00:00.000Z,24572055,21,Olivier Sarr,0,0,0,0,0,0
0,0,1,0,0,1,0,0,0,2,0,0,0,1,0,0,3277532,2023-11-28T00:00:00.000Z,38017716,21,Ousmane Dieng,0,1,1,0,1,1.2
4,2,3,1,0,22,13,6,6,34,1,2,32,4,3,3,3277532,2023-11-28T00:00:00.000Z,175,21,Shai Gilgeous-Alexander,5,36,40,36,8,54.8
0,0,0,0,0,0,0,0,0,0,0,0,0,0,0,0,3277532,2023-11-28T00:00:00.000Z,17896036,21,Tre Mann,0,0,0,0,0,0
0,0,0,0,0,0,0,0,0,0,0,0,0,0,0,0,3277532,2023-11-28T00:00:00.000Z,4197029,21,Vasilije Micic,0,0,0,0,0,0
0,0,0,0,0,0,0,0,0,0,0,0,0,0,0,0,3277533,2023-11-28T00:00:00.000Z,56677825,11,Amen Thompson,0,0,0,0,0,0
0,0,0,0,0,0,0,0,0,0,0,0,0,0,0,0,3277533,2023-11-28T00:00:00.000Z,296,11,Boban Marjanovic,0,0,0,0,0,0
0,0,0,0,0,0,0,0,0,0,0,0,0,0,0,0,3277533,2023-11-28T00:00:00.000Z,56677831,11,Cam Whitmore,0,0,0,0,0,0
2,0,1,1,0,2,1,3,3,11,1,2,5,2,1,0,3277533,2023-11-28T00:00:00.000Z,3547301,11,Jae'Sean Tate,1,7,9,7,4,13.4
0,0,0,0,0,0,0,0,0,0,0,0,0,0,0,0,3277533,2023-11-28T00:00:00.000Z,47738533,11,Jeenathan Williams,0,0,0,0,0,0
0,0,0,0,0,0,0,0,0,0,0,0,0,0,0,0,3277533,2023-11-28T00:00:00.000Z,56677809,11,Jermaine Samuels Jr.,0,0,0,0,0,0
0,0,0,0,0,0,0,0,0,0,0,0,0,0,0,0,3277533,2023-11-28T00:00:00.000Z,357,11,Victor Oladipo,0,0,0,0,0,0
3,0,8,5,2,18,11,6,5,36,2,5,29,10,0,3,3277534,2023-11-28T00:00:00.000Z,475,10,Andrew Wiggins,0,39,42,32,13,42.5
0,0,0,0,0,0,0,0,0,0,0,0,0,0,0,0,3277534,2023-11-28T00:00:00.000Z,56677858,10,Brandin Podziemski,0,0,0,0,0,0
0,0,0,2,1,2,1,0,0,5,0,1,3,0,2,0,3277534,2023-11-28T00:00:00.000Z,367,10,Chris Paul,2,3,3,3,0,9
3,0,4,0,0,2,1,2,2,8,0,0,4,4,0,0,3277534,2023-11-28T00:00:00.000Z,251,10,Cory Joseph,0,8,11,7,7,13.3
3,0,1,4,2,7,3,2,2,17,1,3,10,2,0,0,3277534,2023-11-28T00:00:00.000Z,407,10,Dario Saric,0,12,15,13,5,16.9
3,2,6,4,2,8,3,0,0,33,0,4,8,6,0,4,3277534,2023-11-28T00:00:00.000Z,185,10,Draymond Green,2,14,17,11,9,21.7
1,1,4,1,0,4,3,1,1,16,1,3,7,5,2,1,3277534,2023-11-28T00:00:00.000Z,2189,10,Gary Payton II,3,12,13,8,6,22.5
0,0,0,0,0,0,0,0,0,0,0,0,0,0,0,0,3277534,2023-11-28T00:00:00.000Z,57875092,10,Gui Santos,0,0,0,0,0,0
0,0,0,0,0,0,0,0,0,0,0,0,0,0,0,0,3277534,2023-11-28T00:00:00.000Z,398,10,Jerome Robinson,0,0,0,0,0,0
0,0,1,1,0,3,0,0,0,10,0,3,0,1,0,2,3277534,2023-11-28T00:00:00.000Z,17553979,10,Jonathan Kuminga,0,1,1,0,1,-0.8
2,0,3,0,0,1,0,4,2,29,1,4,2,4,1,0,3277534,2023-11-28T00:00:00.000Z,282,10,Kevon Looney,1,6,8,4,6,12.8
2,2,9,9,3,14,6,6,5,36,0,2,20,9,1,3,3277534,2023-11-28T00:00:00.000Z,443,10,Klay Thompson,3,29,31,22,11,39.8
0,0,0,0,0,0,0,0,0,0,0,0,0,0,0,0,3277534,2023-11-28T00:00:00.000Z,45658838,10,Lester Quinones,0,0,0,0,0,0
2,0,0,3,3,4,4,0,0,13,1,1,11,1,0,0,3277534,2023-11-28T00:00:00.000Z,17553992,10,Moses Moody,0,12,14,13,3,15.2
6,1,7,12,4,20,8,9,9,37,3,5,29,10,0,5,3277534,2023-11-28T00:00:00.000Z,115,10,Stephen Curry,1,39,45,35,16,48
0,0,0,0,0,0,0,0,0,0,0,0,0,0,0,0,3277534,2023-11-28T00:00:00.000Z,56677799,10,Trayce Jackson-Davis,0,0,0,0,0,0
0,0,0,0,0,0,0,0,0,0,0,0,0,0,0,0,3277534,2023-11-28T00:00:00.000Z,17896070,10,Usman Garuba,0,0,0,0,0,0
0,2,3,6,2,9,3,0,0,15,1,1,8,4,0,0,3277534,2023-11-28T00:00:00.000Z,4197162,26,Aleksandar Vezenkov,2,12,12,8,4,18.8
0,0,0,0,0,0,0,0,0,0,0,0,0,0,0,0,3277534,2023-11-28T00:00:00.000Z,273,26,Alex Len,0,0,0,0,0,0
0,0,0,1,0,4,2,2,1,14,0,2,5,0,2,0,3277534,2023-11-28T00:00:00.000Z,17896030,26,Chris Duarte,2,5,5,5,0,11
0,0,0,0,0,0,0,0,0,0,0,0,0,0,0,0,3277534,2023-11-28T00:00:00.000Z,56677845,26,Colby Jones,0,0,0,0,0,0
0,0,0,2,0,4,1,2,2,9,0,2,4,0,1,0,3277534,2023-11-28T00:00:00.000Z,17553994,26,Davion Mitchell,1,4,4,4,0,7
7,0,9,8,2,20,9,17,9,40,1,4,29,10,2,2,3277534,2023-11-28T00:00:00.000Z,161,26,De'Aaron Fox,2,39,46,36,17,55.5
10,0,6,1,0,7,2,6,5,37,2,3,9,8,1,1,3277534,2023-11-28T00:00:00.000Z,406,26,Domantas Sabonis,1,17,27,19,18,35.6
1,1,4,5,2,8,5,0,0,26,0,1,12,4,1,1,3277534,2023-11-28T00:00:00.000Z,30,26,Harrison Barnes,2,16,17,13,5,23.3
0,0,0,0,0,0,0,0,0,0,0,0,0,0,0,0,3277534,2023-11-28T00:00:00.000Z,56677862,26,Jalen Slawson,0,0,0,0,0,0
0,2,0,0,0,1,0,2,1,5,1,1,1,1,0,1,3277534,2023-11-28T00:00:00.000Z,306,26,JaVale McGee,2,2,2,1,1,7.2
0,0,0,0,0,0,0,0,0,0,0,0,0,0,0,0,3277534,2023-11-28T00:00:00.000Z,17895990,26,Jordan Ford,0,0,0,0,0,0
0,0,0,0,0,0,0,0,0,0,0,0,0,0,0,0,3277534,2023-11-28T00:00:00.000Z,38017688,26,Keegan Murray,0,0,0,0,0,0
0,0,0,2,1,2,1,0,0,6,0,0,3,0,0,0,3277534,2023-11-28T00:00:00.000Z,38017714,26,Keon Ellis,0,3,3,3,0,3
0,0,2,1,0,1,0,0,0,5,0,0,0,2,0,0,3277534,2023-11-28T00:00:00.000Z,17896044,26,Kessler Edwards,0,2,2,0,2,2.4
5,0,6,7,4,14,8,2,1,33,3,5,21,9,0,1,3277534,2023-11-28T00:00:00.000Z,221,26,Kevin Huerter,0,30,35,26,14,38.3
2,1,2,7,3,15,8,2,2,26,1,2,21,3,1,3,3277534,2023-11-28T00:00:00.000Z,324,26,Malik Monk,2,24,26,23,5,30.6
0,1,3,4,1,6,2,9,6,24,3,2,11,6,0,1,3277534,2023-11-28T00:00:00.000Z,290,26,Trey Lyles,1,17,17,11,6,20.2
0,0,0,3,1,7,2,1,1,10,1,1,6,1,0,0,1037850,2023-11-29T00:00:00.000Z,77,9,Alec Burks,0,7,7,6,1,7.2
0,0,0,0,0,0,0,0,0,0,0,0,0,0,0,0,1037850,2023-11-29T00:00:00.000Z,54,9,Bojan Bogdanovic,0,0,0,0,0,0
0,0,0,0,0,0,0,0,0,0,0,0,0,0,0,0,1037850,2023-11-29T00:00:00.000Z,42097199,9,Jared Rhoden,0,0,0,0,0,0
0,0,0,0,0,0,0,0,0,0,0,0,0,0,0,0,1037850,2023-11-29T00:00:00.000Z,197,9,Joe Harris,0,0,0,0,0,0
0,0,0,1,1,1,1,0,0,6,0,0,3,0,0,0,1037850,2023-11-29T00:00:00.000Z,259,9,Kevin Knox,0,3,3,3,0,3
8,0,1,3,0,9,3,1,1,22,0,2,7,1,2,0,1037850,2023-11-29T00:00:00.000Z,3547241,9,Killian Hayes,2,8,16,15,9,26.2
0,0,0,0,0,0,0,0,0,0,0,0,0,0,0,0,1037850,2023-11-29T00:00:00.000Z,56677729,9,Malcolm Cazalon,0,0,0,0,0,0
0,0,1,0,0,4,2,2,0,14,1,0,4,2,0,0,1037850,2023-11-29T00:00:00.000Z,24,9,Marvin Bagley III,0,6,6,4,2,6.4
0,0,0,0,0,0,0,0,0,0,0,0,0,0,0,0,1037850,2023-11-29T00:00:00.000Z,330,9,Monte Morris,0,0,0,0,0,0
2,0,6,5,2,9,2,2,2,20,0,5,8,6,1,3,1037850,2023-11-29T00:00:00.000Z,44477024,9,Stanley Umude,1,14,16,10,8,18.2
4,3,12,0,0,15,9,13,10,29,4,1,28,16,1,0,1037850,2023-11-29T00:00:00.000Z,117,14,Anthony Davis,4,44,48,32,20,65.2
4,1,2,4,0,8,3,0,0,24,1,2,6,3,0,2,1037850,2023-11-29T00:00:00.000Z,17553995,14,Austin Reaves,1,9,13,10,7,16.6
2,0,3,2,0,3,0,0,0,20,0,2,0,3,0,1,1037850,2023-11-29T00:00:00.000Z,666860,14,Cameron Reddish,0,3,5,2,5,5.6
0,2,9,4,0,9,4,4,4,25,0,1,12,9,1,1,1037850,2023-11-29T00:00:00.000Z,486,14,Christian Wood,3,21,21,12,9,30.8
0,0,0,0,0,0,0,0,0,0,0,0,0,0,0,0,1037850,2023-11-29T00:00:00.000Z,56677738,14,Colin Castleton,0,0,0,0,0,0
9,2,4,7,5,17,13,5,4,34,0,0,35,4,1,3,1037850,2023-11-29T00:00:00.000Z,405,14,D'Angelo Russell,3,39,48,44,13,59.3
0,0,0,2,1,3,1,0,0,5,0,1,3,0,0,0,1037850,2023-11-29T00:00:00.000Z,56677868,14,D'Moi Hodge,0,3,3,3,0,3
0,0,0,0,0,0,0,0,0,0,0,0,0,0,0,0,1037850,2023-11-29T00:00:00.000Z,1603383,14,Gabe Vincent,0,0,0,0,0,0
1,0,1,2,1,4,3,6,3,11,0,2,10,1,1,1,1037850,2023-11-29T00:00:00.000Z,56677835,14,Jalen Hood-Schifino,1,11,12,11,2,14.7
0,0,0,0,0,0,0,0,0,0,0,0,0,0,0,0,1037850,2023-11-29T00:00:00.000Z,457,14,Jarred Vanderbilt,0,0,0,0,0,0
4,0,6,6,2,19,9,5,5,29,2,0,25,8,0,1,1037850,2023-11-29T00:00:00.000Z,237,14,LeBron James,0,33,37,29,12,39.6
0,1,2,2,0,3,0,5,5,22,0,1,5,2,0,2,1037850,2023-11-29T00:00:00.000Z,38017697,14,Max Christie,1,7,7,5,2,8.4
2,0,0,0,0,0,0,0,0,7,0,1,0,0,2,0,1037850,2023-11-29T00:00:00.000Z,56677836,14,Maxwell Lewis,2,0,2,2,2,9
0,0,0,0,0,0,0,0,0,0,0,0,0,0,0,0,1037850,2023-11-29T00:00:00.000Z,666609,14,Rui Hachimura,0,0,0,0,0,0
1,0,1,4,3,4,3,0,0,23,0,0,9,1,1,1,1037850,2023-11-29T00:00:00.000Z,383,14,Taurean Prince,1,10,11,10,2,13.7
3,1,5,2,1,5,3,0,0,27,0,1,7,5,0,2,1037851,2023-11-29T00:00:00.000Z,56677827,22,Anthony Black,1,12,15,10,8,18.5
1,0,3,3,3,3,3,0,0,10,0,3,9,3,0,1,1037851,2023-11-29T00:00:00.000Z,38017724,22,Caleb Houstan,0,12,13,10,4,13.1
2,0,0,1,0,2,0,0,0,5,0,0,0,0,0,0,1037851,2023-11-29T00:00:00.000Z,666818,22,Chuma Okeke,0,0,2,2,2,3
5,2,3,5,3,16,9,5,4,26,3,4,25,6,0,1,1037851,2023-11-29T00:00:00.000Z,3547251,22,Cole Anthony,2,31,36,30,11,44.7
3,1,3,6,4,14,11,6,5,31,3,1,31,6,0,2,1037851,2023-11-29T00:00:00.000Z,17896026,22,Franz Wagner,1,37,40,34,9,43.7
4,0,2,2,2,2,2,3,2,19,0,3,8,2,2,1,1037851,2023-11-29T00:00:00.000Z,196,22,Gary Harris,2,10,14,12,6,21.4
2,1,6,0,0,5,2,4,4,24,1,1,8,7,0,1,1037851,2023-11-29T00:00:00.000Z,666442,22,Goga Bitadze,1,15,17,10,9,21.4
3,0,2,6,3,15,9,1,1,29,1,4,22,3,2,2,1037851,2023-11-29T00:00:00.000Z,17896073,22,Jalen Suggs,2,25,28,25,6,34.1
0,0,0,0,0,0,0,0,0,0,0,0,0,0,0,0,1037851,2023-11-29T00:00:00.000Z,56677839,22,Jett Howard,0,0,0,0,0,0
6,0,4,1,1,7,5,1,1,20,0,1,12,4,1,2,1037851,2023-11-29T00:00:00.000Z,226,22,Joe Ingles,1,16,22,18,10,26.8
4,0,3,0,0,8,2,3,2,27,1,2,6,4,0,4,1037851,2023-11-29T00:00:00.000Z,38017683,22,Paolo Banchero,0,10,14,10,8,12.8
0,0,0,0,0,0,0,0,0,0,0,0,0,0,0,0,1037851,2023-11-29T00:00:00.000Z,17553983,22,Trevelin Queen,0,0,0,0,0,0
0,0,4,1,1,5,2,2,2,25,1,1,7,5,0,2,1037851,2023-11-29T00:00:00.000Z,56677844,30,Bilal Coulibaly,0,12,12,7,5,11
4,2,2,0,0,2,2,0,0,26,1,3,4,3,1,0,1037851,2023-11-29T00:00:00.000Z,666577,30,Daniel Gafford,3,7,11,8,7,22.6
5,0,1,2,1,12,9,4,3,28,3,1,22,4,2,0,1037851,2023-11-29T00:00:00.000Z,3547242,30,Deni Avdija,2,26,31,27,9,40.3
3,0,0,1,0,2,1,2,2,5,0,0,4,0,2,0,1037851,2023-11-29T00:00:00.000Z,18677954,30,Jared Butler,2,4,7,7,3,14.5
2,1,5,7,4,12,5,6,5,26,0,3,19,5,2,2,1037851,2023-11-29T00:00:00.000Z,666848,30,Jordan Poole,3,24,26,21,7,35
6,0,3,4,1,20,9,6,5,34,0,1,24,3,0,4,1037851,2023-11-29T00:00:00.000Z,265,30,Kyle Kuzma,0,27,33,30,9,32.6
0,0,0,0,0,0,0,0,0,0,0,0,0,0,0,0,1037851,2023-11-29T00:00:00.000Z,38017704,30,Patrick Baldwin Jr.,0,0,0,0,0,0
4,0,3,2,0,10,3,2,1,21,0,1,7,3,2,0,1037851,2023-11-29T00:00:00.000Z,249,30,Tyus Jones,2,10,14,11,7,22.6
0,0,0,0,0,0,0,0,0,0,0,0,0,0,0,0,1037852,2023-11-29T00:00:00.000Z,666451,24,Bol Bol,0,0,0,0,0,0
0,0,2,1,1,3,2,0,0,15,0,3,5,2,0,1,1037852,2023-11-29T00:00:00.000Z,314,24,Chimezie Metu,0,7,7,5,2,6.4
1,1,3,0,0,6,2,0,0,18,1,0,4,4,0,0,1037852,2023-11-29T00:00:00.000Z,147,24,Drew Eubanks,1,8,9,5,5,13.3
1,0,1,5,2,9,4,0,0,34,0,2,10,1,1,0,1037852,2023-11-29T00:00:00.000Z,178,24,Eric Gordon,1,11,12,11,2,15.7
0,0,0,0,0,0,0,0,0,0,0,0,0,0,0,0,1037852,2023-11-29T00:00:00.000Z,8,24,Grayson Allen,0,0,0,0,0,0
4,0,3,3,1,8,4,0,0,23,3,2,9,6,0,2,1037852,2023-11-29T00:00:00.000Z,18678058,24,Jordan Goodwin,0,15,19,13,10,20.2
2,0,3,0,0,4,2,6,6,24,4,1,10,7,0,0,1037852,2023-11-29T00:00:00.000Z,356,24,Josh Okogie,0,17,19,12,9,21.4
6,2,13,1,1,12,8,2,2,30,1,3,19,14,0,2,1037852,2023-11-29T00:00:00.000Z,349,24,Jusuf Nurkic,2,33,39,25,20,48.8
6,0,4,8,2,30,11,6,6,35,0,1,30,4,1,1,1037852,2023-11-29T00:00:00.000Z,140,24,Kevin Durant,1,34,40,36,10,45.8
0,0,0,0,0,0,0,0,0,0,0,0,0,0,0,0,1037852,2023-11-29T00:00:00.000Z,3547298,24,Saben Lee,0,0,0,0,0,0
0,2,0,3,0,5,0,2,1,16,1,0,1,1,1,1,1037852,2023-11-29T00:00:00.000Z,470,24,Yuta Watanabe,3,2,2,1,1,10.2
0,0,0,0,0,0,0,0,0,3,0,0,0,0,0,0,1037852,2023-11-29T00:00:00.000Z,58,28,Chris Boucher,0,0,0,0,0,0
0,0,0,0,0,0,0,0,0,0,0,0,0,0,0,0,1037852,2023-11-29T00:00:00.000Z,38017710,28,Christian Koloko,0,0,0,0,0,0
12,0,5,2,1,11,3,1,1,34,1,2,8,6,1,0,1037852,2023-11-29T00:00:00.000Z,409,28,Dennis Schroder,1,14,26,20,18,36.2
0,0,0,0,0,0,0,0,0,0,0,0,0,0,0,0,1037852,2023-11-29T00:00:00.000Z,436,28,Garrett Temple,0,0,0,0,0,0
0,0,0,0,0,0,0,0,0,0,0,0,0,0,0,0,1037852,2023-11-29T00:00:00.000Z,56677828,28,Gradey Dick,0,0,0,0,0,0
1,1,2,0,0,9,8,2,1,30,2,4,17,4,0,2,1037852,2023-11-29T00:00:00.000Z,373,28,Jakob Poeltl,1,21,22,18,5,24.3
0,0,0,0,0,0,0,0,0,0,0,0,0,0,0,0,1037852,2023-11-29T00:00:00.000Z,56677805,28,Javon Freeman-Liberty,0,0,0,0,0,0
1,0,4,3,0,3,0,2,2,14,1,0,2,5,0,1,1037852,2023-11-29T00:00:00.000Z,3547275,28,Malachi Flynn,0,7,8,3,6,8.5
0,0,0,0,0,0,0,0,0,0,0,0,0,0,0,0,1037852,2023-11-29T00:00:00.000Z,56677869,28,Markquis Nowell,0,0,0,0,0,0
1,1,3,5,3,10,5,1,0,33,0,3,13,3,3,0,1037852,2023-11-29T00:00:00.000Z,18,28,OG Anunoby,4,16,17,14,4,30.1
0,0,0,0,0,0,0,0,0,0,0,0,0,0,0,0,1037852,2023-11-29T00:00:00.000Z,376,28,Otto Porter Jr.,0,0,0,0,0,0
3,0,6,5,1,21,9,3,3,36,3,4,22,9,1,3,1037852,2023-11-29T00:00:00.000Z,416,28,Pascal Siakam,1,31,34,25,12,37.3
1,0,4,1,1,10,5,4,3,18,6,2,14,10,2,1,1037852,2023-11-29T00:00:00.000Z,3547249,28,Precious Achiuwa,2,24,25,15,11,32.5
0,0,0,0,0,0,0,0,0,0,0,0,0,0,0,0,1037852,2023-11-29T00:00:00.000Z,38017717,28,Ron Harper Jr.,0,0,0,0,0,0
4,3,5,3,1,15,7,8,8,38,2,4,23,7,0,0,1037852,2023-11-29T00:00:00.000Z,17896055,28,Scottie Barnes,3,30,34,27,11,46.4
0,0,0,0,0,0,0,0,0,0,0,0,0,0,0,0,1037852,2023-11-29T00:00:00.000Z,489,28,Thaddeus Young,0,0,0,0,0,0
2,3,6,0,0,3,3,0,0,30,0,3,6,6,1,5,1037853,2023-11-29T00:00:00.000Z,48,15,Bismack Biyombo,4,12,14,8,8,23.2
1,0,5,9,5,11,7,0,0,25,1,2,19,6,0,0,1037853,2023-11-29T00:00:00.000Z,38017729,15,David Roddy,0,25,26,20,7,27.7
9,0,4,3,0,11,7,0,0,27,0,2,14,4,0,1,1037853,2023-11-29T00:00:00.000Z,401,15,Derrick Rose,0,18,27,23,13,31.3
9,0,6,11,3,17,7,0,0,36,1,2,17,7,3,3,1037853,2023-11-29T00:00:00.000Z,3547287,15,Desmond Bane,3,24,33,26,16,44.9
0,0,0,0,0,0,0,0,0,0,0,0,0,0,0,0,1037853,2023-11-29T00:00:00.000Z,48248287,15,Jacob Gilyard,0,0,0,0,0,0
1,6,3,3,0,19,8,4,4,35,3,2,20,6,1,1,1037853,2023-11-29T00:00:00.000Z,231,15,Jaren Jackson Jr.,7,26,27,21,7,48.7
1,0,1,3,0,6,0,0,0,18,1,0,0,2,0,0,1037853,2023-11-29T00:00:00.000Z,666809,15,Jaylen Nowell,0,2,3,1,3,3.9
0,0,0,0,0,0,0,0,0,0,0,0,0,0,0,0,1037853,2023-11-29T00:00:00.000Z,666703,15,John Konchar,0,0,0,0,0,0
0,0,0,0,0,0,0,0,0,0,0,0,0,0,0,0,1037853,2023-11-29T00:00:00.000Z,38017732,15,Kenneth Lofton Jr.,0,0,0,0,0,0
0,0,0,0,0,0,0,0,0,0,0,0,0,0,0,0,1037853,2023-11-29T00:00:00.000Z,420,15,Marcus Smart,0,0,0,0,0,0
1,1,2,4,1,9,4,4,2,25,2,1,11,4,1,1,1037853,2023-11-29T00:00:00.000Z,17896067,15,Santi Aldama,2,15,16,12,5,22.3
0,0,0,0,0,0,0,0,0,0,0,0,0,0,0,0,1037853,2023-11-29T00:00:00.000Z,199,15,Shaquille Harrison,0,0,0,0,0,0
2,0,6,3,1,3,1,0,0,19,2,3,3,8,1,2,1037853,2023-11-29T00:00:00.000Z,38017731,15,Vince Williams Jr.,1,11,13,5,10,16.6
0,0,0,0,0,0,0,0,0,0,0,0,0,0,0,0,1037853,2023-11-29T00:00:00.000Z,3547285,15,Xavier Tillman,0,0,0,0,0,0
0,0,6,3,3,8,6,0,0,25,2,0,15,8,2,2,1037853,2023-11-29T00:00:00.000Z,17896027,15,Ziaire Williams,2,23,23,15,8,28.6
0,0,0,0,0,0,0,0,0,0,0,0,0,0,0,0,1037853,2023-11-29T00:00:00.000Z,56677842,29,Brice Sensabaugh,0,0,0,0,0,0
3,0,1,4,1,10,3,3,2,22,1,3,9,2,1,2,1037853,2023-11-29T00:00:00.000Z,413,29,Collin Sexton,1,11,14,12,5,16.9
1,0,3,5,3,14,7,2,0,29,1,2,17,4,1,1,1037853,2023-11-29T00:00:00.000Z,101,29,John Collins,1,21,22,18,5,25.3
0,0,0,0,0,0,0,0,0,0,0,0,0,0,0,0,1037853,2023-11-29T00:00:00.000Z,38017630,29,Johnny Juzang,0,0,0,0,0,0
5,0,2,5,2,10,4,3,2,27,1,0,12,3,0,4,1037853,2023-11-29T00:00:00.000Z,100,29,Jordan Clarkson,0,15,20,17,8,19.1
0,0,0,0,0,0,0,0,0,0,0,0,0,0,0,0,1037853,2023-11-29T00:00:00.000Z,17896023,29,Josh Christopher,0,0,0,0,0,0
2,0,2,1,1,2,2,0,0,18,0,3,5,2,2,1,1037853,2023-11-29T00:00:00.000Z,358,29,Kelly Olynyk,2,7,9,7,4,15.4
2,0,2,4,2,6,2,2,2,24,1,0,8,3,0,2,1037853,2023-11-29T00:00:00.000Z,56677834,29,Keyonte George,0,11,13,10,5,12.6
0,0,0,0,0,0,0,0,0,0,0,0,0,0,0,0,1037853,2023-11-29T00:00:00.000Z,139,29,Kris Dunn,0,0,0,0,0,0
0,0,0,0,0,0,0,0,0,0,0,0,0,0,0,0,1037853,2023-11-29T00:00:00.000Z,297,29,Lauri Markkanen,0,0,0,0,0,0
0,1,1,1,1,2,2,0,0,6,1,0,5,2,0,1,1037853,2023-11-29T00:00:00.000Z,666881,29,Luka Samanic,1,7,7,5,2,9.4
0,0,0,0,0,0,0,0,0,0,0,0,0,0,0,0,1037853,2023-11-29T00:00:00.000Z,19465584,29,Micah Potter,0,0,0,0,0,0
3,0,2,4,1,5,2,0,0,21,1,1,5,3,0,1,1037853,2023-11-29T00:00:00.000Z,38017620,29,Ochai Agbaji,0,8,11,8,6,12.1
1,0,2,0,0,5,2,0,0,15,2,2,4,4,1,2,1037853,2023-11-29T00:00:00.000Z,11891374,29,Omer Yurtseven,1,8,9,5,5,11.3
4,0,4,8,4,13,4,0,0,26,0,1,12,4,1,0,1037853,2023-11-29T00:00:00.000Z,38017739,29,Simone Fontecchio,1,16,20,16,8,25.8
0,0,0,0,0,0,0,0,0,0,0,0,0,0,0,0,1037853,2023-11-29T00:00:00.000Z,56677824,29,Taylor Hendricks,0,0,0,0,0,0
2,6,5,2,0,11,4,2,1,28,3,0,9,8,1,1,1037853,2023-11-29T00:00:00.000Z,38017705,29,Walker Kessler,7,17,19,11,10,41.6
6,1,4,4,2,7,4,5,5,35,0,1,15,4,1,1,1037854,2023-11-29T00:00:00.000Z,227,19,Brandon Ingram,2,19,25,21,10,33.8
5,1,2,8,3,16,7,3,3,28,1,3,20,3,2,2,1037854,2023-11-29T00:00:00.000Z,303,19,CJ McCollum,3,23,28,25,8,38.1
0,0,0,0,0,0,0,0,0,0,0,0,0,0,0,0,1037854,2023-11-29T00:00:00.000Z,38017726,19,Dereon Seabron,0,0,0,0,0,0
1,1,4,1,0,5,2,0,0,14,2,2,4,6,2,1,1037854,2023-11-29T00:00:00.000Z,38017677,19,Dyson Daniels,3,10,11,5,7,20.7
0,0,0,0,0,0,0,0,0,0,0,0,0,0,0,0,1037854,2023-11-29T00:00:00.000Z,38017663,19,E.J. Liddell,0,0,0,0,0,0
6,0,2,3,0,8,3,1,1,33,1,2,7,3,0,5,1037854,2023-11-29T00:00:00.000Z,17896024,19,Herbert Jones,0,10,16,13,9,14.6
0,0,0,0,0,0,0,0,0,0,0,0,0,0,0,0,1037854,2023-11-29T00:00:00.000Z,17896021,19,Jeremiah Robinson-Earl,0,0,0,0,0,0
3,0,3,1,0,9,8,3,3,32,3,5,19,6,0,2,1037854,2023-11-29T00:00:00.000Z,455,19,Jonas Valanciunas,0,25,28,22,9,28.7
2,0,3,8,3,10,4,6,5,24,2,2,16,5,0,2,1037854,2023-11-29T00:00:00.000Z,56677837,19,Jordan Hawkins,0,21,23,18,7,23
1,0,0,2,1,5,2,0,0,9,2,1,5,2,1,2,1037854,2023-11-29T00:00:00.000Z,17896097,19,Jose Alvarado,1,7,8,6,3,9.9
0,0,0,0,0,0,0,0,0,0,0,0,0,0,0,0,1037854,2023-11-29T00:00:00.000Z,3547260,19,Kira Lewis Jr.,0,0,0,0,0,0
0,0,0,0,0,0,0,0,0,0,0,0,0,0,0,0,1037854,2023-11-29T00:00:00.000Z,340,19,Larry Nance Jr.,0,0,0,0,0,0
0,0,0,0,0,0,0,0,0,0,0,0,0,0,0,0,1037854,2023-11-29T00:00:00.000Z,17896017,19,Matt Ryan,0,0,0,0,0,0
0,0,0,0,0,0,0,0,0,0,0,0,0,0,0,0,1037854,2023-11-29T00:00:00.000Z,18677986,19,Trey Murphy III,0,0,0,0,0,0
6,0,7,0,0,11,11,12,11,33,1,1,33,8,3,2,1037854,2023-11-29T00:00:00.000Z,666969,19,Zion Williamson,3,41,47,39,14,58.6
0,0,0,0,0,0,0,0,0,0,0,0,0,0,0,0,1037854,2023-11-29T00:00:00.000Z,2175,23,Danuel House Jr.,0,0,0,0,0,0
0,0,0,0,0,0,0,0,0,2,0,0,0,0,0,0,1037854,2023-11-29T00:00:00.000Z,260,23,Furkan Korkmaz,0,0,0,0,0,0
0,0,0,0,0,0,0,0,0,0,0,0,0,0,0,0,1037854,2023-11-29T00:00:00.000Z,17896025,23,Jaden Springer,0,0,0,0,0,0
0,0,0,0,0,0,0,0,0,0,0,0,0,0,0,0,1037854,2023-11-29T00:00:00.000Z,17554001,23,Javonte Smart,0,0,0,0,0,0
0,0,0,0,0,0,0,0,0,0,0,0,0,0,0,0,1037854,2023-11-29T00:00:00.000Z,145,23,Joel Embiid,0,0,0,0,0,0
0,0,0,0,0,0,0,0,0,0,0,0,0,0,0,0,1037854,2023-11-29T00:00:00.000Z,360,23,Kelly Oubre Jr.,0,0,0,0,0,0
2,0,2,1,0,4,2,0,0,17,0,4,4,2,0,2,1037854,2023-11-29T00:00:00.000Z,3547294,23,Kenyon Martin Jr.,0,6,8,6,4,7.4
2,1,2,3,1,7,3,0,0,17,1,4,7,3,1,1,1037854,2023-11-29T00:00:00.000Z,328,23,Marcus Morris,2,10,12,9,5,18.6
0,0,1,1,1,1,1,0,0,14,0,1,3,1,0,1,1037854,2023-11-29T00:00:00.000Z,33,23,Nicolas Batum,0,4,4,3,1,3.2
5,0,2,1,0,4,3,3,3,27,2,4,9,4,1,3,1037854,2023-11-29T00:00:00.000Z,3547270,23,Paul Reed,1,13,18,14,9,21.3
0,0,0,0,0,0,0,0,0,0,0,0,0,0,0,0,1037854,2023-11-29T00:00:00.000Z,56913527,23,Ricky Council IV,0,0,0,0,0,0
0,0,0,0,0,0,0,0,0,0,0,0,0,0,0,0,1037854,2023-11-29T00:00:00.000Z,56677788,23,Terquavion Smith,0,0,0,0,0,0
2,0,4,2,0,10,5,2,2,29,0,2,12,4,0,5,1037854,2023-11-29T00:00:00.000Z,200,23,Tobias Harris,0,16,18,14,6,14.8
0,0,0,0,0,0,0,0,0,0,0,0,0,0,0,0,1037855,2023-11-29T00:00:00.000Z,177,8,Aaron Gordon,0,0,0,0,0,0
1,0,1,0,0,0,0,2,1,3,0,1,1,1,0,0,1037855,2023-11-29T00:00:00.000Z,17896007,8,Braxton Key,0,2,3,2,2,3.7
1,0,2,2,1,7,4,2,2,19,1,2,11,3,0,2,1037855,2023-11-29T00:00:00.000Z,38017709,8,Christian Braun,0,14,15,12,4,14.1
0,0,0,1,0,1,0,0,0,3,0,0,0,0,0,1,1037855,2023-11-29T00:00:00.000Z,38017727,8,Collin Gillespie,0,0,0,0,0,-1
0,0,0,0,0,1,1,2,0,6,1,0,2,1,0,0,1037855,2023-11-29T00:00:00.000Z,250,8,DeAndre Jordan,0,3,3,2,1,3.2
0,0,0,0,0,0,0,0,0,3,0,1,0,0,0,0,1037855,2023-11-29T00:00:00.000Z,56677871,8,Hunter Tyson,0,0,0,0,0,0
0,0,0,1,0,1,0,0,0,3,0,0,0,0,0,0,1037855,2023-11-29T00:00:00.000Z,56677582,8,Jalen Pickett,0,0,0,0,0,0
6,0,6,8,3,14,4,5,5,22,0,2,16,6,0,0,1037855,2023-11-29T00:00:00.000Z,335,8,Jamal Murray,0,22,28,22,12,32.2
0,0,0,0,0,0,0,0,0,0,0,0,0,0,0,0,1037855,2023-11-29T00:00:00.000Z,17896103,8,Jay Huff,0,0,0,0,0,0
1,0,1,2,0,4,0,0,0,13,0,1,0,1,0,0,1037855,2023-11-29T00:00:00.000Z,56677776,8,Julian Strawther,0,1,2,1,2,2.7
4,0,2,5,3,7,4,0,0,27,1,2,11,3,2,0,1037855,2023-11-29T00:00:00.000Z,215,8,Justin Holiday,2,14,18,15,7,26.6
2,0,1,3,2,6,4,0,0,32,0,0,10,1,0,0,1037855,2023-11-29T00:00:00.000Z,81,8,Kentavious Caldwell-Pope,0,11,13,12,3,14.2
5,0,8,12,7,17,11,3,1,34,2,2,30,10,1,0,1037855,2023-11-29T00:00:00.000Z,375,8,Michael Porter Jr.,1,40,45,35,15,52.5
15,0,4,2,1,19,12,8,7,33,6,2,32,10,1,0,1037855,2023-11-29T00:00:00.000Z,246,8,Nikola Jokic,1,42,57,47,25,69.5
0,0,0,0,0,0,0,0,0,0,0,0,0,0,0,0,1037855,2023-11-29T00:00:00.000Z,38017721,8,Peyton Watson,0,0,0,0,0,0
2,1,2,7,2,14,6,0,0,24,0,3,14,2,0,0,1037855,2023-11-29T00:00:00.000Z,236,8,Reggie Jackson,1,16,18,16,4,22.4
0,0,0,0,0,0,0,0,0,0,0,0,0,0,0,0,1037855,2023-11-29T00:00:00.000Z,666489,8,Vlatko Cancar,0,0,0,0,0,0
0,1,1,0,0,4,2,4,3,18,2,2,7,3,0,0,1037855,2023-11-29T00:00:00.000Z,3547268,8,Zeke Nnaji,1,10,10,7,3,13.6
5,0,3,5,0,10,4,1,1,35,0,2,9,3,0,0,1037855,2023-11-29T00:00:00.000Z,213,11,Aaron Holiday,0,12,17,14,8,20.1
4,0,5,6,2,18,10,0,0,28,2,3,22,7,1,1,1037855,2023-11-29T00:00:00.000Z,17896062,11,Alperen Sengun,1,29,33,26,11,38.4
0,0,0,0,0,0,0,0,0,0,0,0,0,0,0,0,1037855,2023-11-29T00:00:00.000Z,56677825,11,Amen Thompson,0,0,0,0,0,0
0,0,0,0,0,0,0,0,0,0,0,0,0,0,0,0,1037855,2023-11-29T00:00:00.000Z,296,11,Boban Marjanovic,0,0,0,0,0,0
0,0,2,2,1,4,3,2,1,6,0,1,8,2,0,0,1037855,2023-11-29T00:00:00.000Z,56677831,11,Cam Whitmore,0,10,10,8,2,10.4
2,0,0,4,1,7,4,3,2,23,1,4,11,1,0,4,1037855,2023-11-29T00:00:00.000Z,66,11,Dillon Brooks,0,12,14,13,3,11.2
2,1,6,7,2,14,6,2,1,32,1,3,15,7,0,0,1037855,2023-11-29T00:00:00.000Z,38017684,11,Jabari Smith Jr.,1,22,24,17,9,29.4
0,0,0,0,0,0,0,0,0,0,0,0,0,0,0,0,1037855,2023-11-29T00:00:00.000Z,3547301,11,Jae'Sean Tate,0,0,0,0,0,0
9,1,6,8,5,12,8,6,5,34,0,0,26,6,0,2,1037855,2023-11-29T00:00:00.000Z,17895966,11,Jalen Green,1,32,41,35,15,47.7
1,0,0,0,0,2,1,0,0,6,0,1,2,0,0,0,1037855,2023-11-29T00:00:00.000Z,47738533,11,Jeenathan Williams,0,2,3,3,1,3.5
2,1,2,3,2,6,4,3,2,22,0,1,12,2,1,0,1037855,2023-11-29T00:00:00.000Z,188,11,Jeff Green,2,14,16,14,4,23.4
2,0,2,1,0,1,0,0,0,6,0,0,0,2,0,0,1037855,2023-11-29T00:00:00.000Z,56677809,11,Jermaine Samuels Jr.,0,2,4,2,4,5.4
0,0,1,1,0,4,2,2,2,14,0,2,6,1,1,1,1037855,2023-11-29T00:00:00.000Z,19465326,11,Jock Landale,1,7,7,6,1,9.2
0,0,0,1,1,1,1,0,0,5,1,0,3,1,0,0,1037855,2023-11-29T00:00:00.000Z,3547281,11,Nate Hinton,0,4,4,3,1,4.2
0,0,0,2,2,2,2,0,0,12,1,3,6,1,0,0,1037855,2023-11-29T00:00:00.000Z,75,11,Reggie Bullock,0,7,7,6,1,7.2
0,2,0,1,0,5,2,0,0,17,2,0,4,2,0,0,1037855,2023-11-29T00:00:00.000Z,38017695,11,Tari Eason,2,6,6,4,2,12.4
0,0,0,0,0,0,0,0,0,0,0,0,0,0,0,0,1037855,2023-11-29T00:00:00.000Z,357,11,Victor Oladipo,0,0,0,0,0,0
0,0,0,0,0,0,0,0,0,1,0,0,0,0,0,0,1037856,2023-11-29T00:00:00.000Z,666511,13,Amir Coffey,0,0,0,0,0,0
0,0,0,0,0,0,0,0,0,0,0,0,0,0,0,0,1037856,2023-11-29T00:00:00.000Z,17896022,13,Brandon Boston Jr.,0,0,0,0,0,0
0,0,0,0,0,0,0,0,0,0,0,0,0,0,0,0,1037856,2023-11-29T00:00:00.000Z,56677856,13,Jordan Miller,0,0,0,0,0,0
0,0,0,0,0,0,0,0,0,0,0,0,0,0,0,0,1037856,2023-11-29T00:00:00.000Z,17896051,13,Joshua Primo,0,0,0,0,0,0
0,0,0,0,0,0,0,0,0,0,0,0,0,0,0,0,1037856,2023-11-29T00:00:00.000Z,371,13,Mason Plumlee,0,0,0,0,0,0
0,0,0,0,0,0,0,0,0,0,0,0,0,0,0,0,1037856,2023-11-29T00:00:00.000Z,38017725,13,Moussa Diabate,0,0,0,0,0,0
0,0,0,0,0,0,0,0,0,1,0,0,0,0,1,0,1037856,2023-11-29T00:00:00.000Z,17896031,13,Nah'Shon Hyland,1,0,0,0,0,3
0,0,0,0,0,0,0,0,0,0,0,0,0,0,0,0,1037856,2023-11-29T00:00:00.000Z,450,13,PJ Tucker,0,0,0,0,0,0
0,0,0,0,0,0,0,0,0,0,0,0,0,0,0,0,1037856,2023-11-29T00:00:00.000Z,24417679,13,Xavier Moon,0,0,0,0,0,0
2,0,1,4,1,9,2,0,0,26,1,3,5,2,0,2,1037857,2023-11-30T00:00:00.000Z,277,6,Caris LeVert,0,7,9,7,4,8.4
0,0,0,0,0,0,0,0,0,0,0,0,0,0,0,0,1037857,2023-11-30T00:00:00.000Z,56677872,6,Craig Porter,0,0,0,0,0,0
0,0,0,0,0,0,0,0,0,0,0,0,0,0,0,0,1037857,2023-11-30T00:00:00.000Z,248,6,Damian Jones,0,0,0,0,0,0
7,0,3,8,2,18,6,1,1,37,1,0,15,4,1,8,1037857,2023-11-30T00:00:00.000Z,666581,6,Darius Garland,1,19,26,22,11,25.3
6,0,4,9,1,20,7,8,8,33,3,1,23,7,4,1,1037857,2023-11-30T00:00:00.000Z,322,6,Donovan Mitchell,4,30,36,29,13,51.4
0,0,0,0,0,0,0,0,0,0,0,0,0,0,0,0,1037857,2023-11-30T00:00:00.000Z,56677847,6,Emoni Bates,0,0,0,0,0,0
3,0,6,1,0,14,9,2,2,34,2,1,20,8,2,3,1037857,2023-11-30T00:00:00.000Z,17896076,6,Evan Mobley,2,28,31,23,11,37.1
2,0,0,3,1,6,3,1,1,19,1,0,8,1,2,0,1037857,2023-11-30T00:00:00.000Z,344,6,Georges Niang,2,9,11,10,3,18.2
0,0,0,1,1,2,1,0,0,17,0,1,3,0,1,0,1037857,2023-11-30T00:00:00.000Z,3547247,6,Isaac Okoro,1,3,3,3,0,6
0,0,0,0,0,0,0,0,0,0,0,0,0,0,0,0,1037857,2023-11-30T00:00:00.000Z,38017662,6,Isaiah Mobley,0,0,0,0,0,0
2,2,4,0,0,9,6,0,0,38,6,3,12,10,0,1,1037857,2023-11-30T00:00:00.000Z,9,6,Jarrett Allen,2,22,24,14,12,32
3,0,3,6,1,11,4,0,0,36,0,6,9,3,2,2,1037857,2023-11-30T00:00:00.000Z,666908,6,Max Strus,2,12,15,12,6,21.1
0,0,0,0,0,0,0,0,0,0,0,0,0,0,0,0,1037857,2023-11-30T00:00:00.000Z,404,6,Ricky Rubio,0,0,0,0,0,0
0,0,0,0,0,0,0,0,0,0,0,0,0,0,0,0,1037857,2023-11-30T00:00:00.000Z,3547299,6,Sam Merrill,0,0,0,0,0,0
0,0,0,0,0,0,0,0,0,0,0,0,0,0,0,0,1037857,2023-11-30T00:00:00.000Z,444,6,Tristan Thompson,0,0,0,0,0,0
0,0,0,0,0,0,0,0,0,0,0,0,0,0,0,0,1037857,2023-11-30T00:00:00.000Z,666676,6,Ty Jerome,0,0,0,0,0,0
0,0,0,0,0,0,0,0,0,0,0,0,0,0,0,0,1037858,2023-11-30T00:00:00.000Z,417,3,Ben Simmons,0,0,0,0,0,0
1,1,2,5,2,21,11,3,2,25,0,1,26,2,0,1,1037858,2023-11-30T00:00:00.000Z,17896048,3,Cam Thomas,1,28,29,27,3,31.9
2,0,0,9,3,18,6,0,0,28,6,1,15,6,0,2,1037858,2023-11-30T00:00:00.000Z,666679,3,Cameron Johnson,0,21,23,17,8,23.2
0,0,0,0,0,0,0,0,0,0,0,0,0,0,0,0,1037858,2023-11-30T00:00:00.000Z,56677841,3,Dariq Whitehead,0,0,0,0,0,0
0,0,3,0,0,5,4,3,1,18,2,3,9,5,2,0,1037858,2023-11-30T00:00:00.000Z,17896038,3,Day'Ron Sharpe,2,14,14,9,5,21
0,0,0,0,0,0,0,0,0,0,0,0,0,0,0,0,1037858,2023-11-30T00:00:00.000Z,421,3,Dennis Smith Jr.,0,0,0,0,0,0
1,1,3,6,4,7,5,0,0,39,3,0,14,6,2,1,1037858,2023-11-30T00:00:00.000Z,158,3,Dorian Finney-Smith,3,20,21,15,7,30.7
0,0,0,0,0,0,0,0,0,0,0,0,0,0,0,0,1037858,2023-11-30T00:00:00.000Z,174,3,Harry Giles III,0,0,0,0,0,0
0,0,0,0,0,0,0,0,0,0,0,0,0,0,0,0,1037858,2023-11-30T00:00:00.000Z,56677722,3,Jalen Wilson,0,0,0,0,0,0
1,0,1,4,2,5,2,2,1,14,1,1,7,2,0,1,1037858,2023-11-30T00:00:00.000Z,464,3,Lonnie Walker IV,0,9,10,8,3,9.9
4,0,9,5,2,22,9,3,2,38,0,1,22,9,1,2,1037858,2023-11-30T00:00:00.000Z,61,3,Mikal Bridges,1,31,35,26,13,39.8
2,2,5,0,0,13,9,2,2,30,9,1,20,14,1,1,1037858,2023-11-30T00:00:00.000Z,666508,3,Nicolas Claxton,3,34,36,22,16,47.8
0,0,0,0,0,0,0,0,0,0,0,0,0,0,0,0,1037858,2023-11-30T00:00:00.000Z,351,3,Royce O'Neale,0,0,0,0,0,0
8,0,4,6,1,9,3,2,2,34,0,1,9,4,0,1,1037858,2023-11-30T00:00:00.000Z,130,3,Spencer Dinwiddie,0,13,21,17,12,24.8
0,0,0,0,0,0,0,0,0,0,0,0,0,0,0,0,1037858,2023-11-30T00:00:00.000Z,56677823,4,Brandon Miller,0,0,0,0,0,0
3,1,2,5,4,7,5,0,0,22,0,1,14,2,0,0,1037858,2023-11-30T00:00:00.000Z,38017708,4,Bryce McGowens,1,16,19,17,5,23.9
6,0,4,4,2,14,8,4,4,32,2,1,22,6,0,2,1037858,2023-11-30T00:00:00.000Z,204,4,Gordon Hayward,0,28,34,28,12,36.2
0,0,0,0,0,0,0,0,0,13,1,4,0,1,0,2,1037858,2023-11-30T00:00:00.000Z,422,4,Ish Smith,0,1,1,0,1,-0.8
0,0,0,0,0,0,0,0,0,0,0,0,0,0,0,0,1037858,2023-11-30T00:00:00.000Z,17896037,4,James Bouknight,0,0,0,0,0,0
0,0,0,0,0,0,0,0,0,0,0,0,0,0,0,0,1037858,2023-11-30T00:00:00.000Z,56677866,4,Leaky Black,0,0,0,0,0,0
1,3,7,0,0,12,5,2,2,32,5,2,12,12,1,0,1037858,2023-11-30T00:00:00.000Z,38017698,4,Mark Williams,4,24,25,13,13,39.9
2,0,4,4,3,15,9,2,2,38,1,2,23,5,0,0,1037858,2023-11-30T00:00:00.000Z,62,4,Miles Bridges,0,28,30,25,7,32
0,1,0,3,3,4,3,0,0,14,1,2,9,1,0,0,1037858,2023-11-30T00:00:00.000Z,56677846,4,Nick Smith Jr.,1,10,10,9,1,13.2
13,0,4,9,7,25,13,4,4,40,0,1,37,4,2,3,1037858,2023-11-30T00:00:00.000Z,403,4,Terry Rozier,2,41,54,50,17,64.3
0,0,0,0,0,0,0,0,0,0,0,0,0,0,0,0,1037858,2023-11-30T00:00:00.000Z,3547253,4,Theo Maledon,0,0,0,0,0,0
1,0,2,1,0,5,4,1,1,22,3,6,9,5,4,1,1037859,2023-11-30T00:00:00.000Z,3547250,12,Aaron Nesmith,4,14,15,10,6,27.5
5,0,1,1,0,4,1,0,0,22,0,6,2,1,2,2,1037859,2023-11-30T00:00:00.000Z,38017507,12,Andrew Nembhard,2,3,8,7,6,14.7
1,0,1,0,0,0,0,0,0,6,0,3,0,1,1,0,1037859,2023-11-30T00:00:00.000Z,17896035,12,Isaiah Jackson,1,1,2,1,2,5.7
0,0,0,0,0,0,0,0,0,0,0,0,0,0,0,0,1037859,2023-11-30T00:00:00.000Z,56677794,12,Isaiah Wong,0,0,0,0,0,0
0,0,0,0,0,0,0,0,0,0,0,0,0,0,0,0,1037859,2023-11-30T00:00:00.000Z,3547264,12,Jalen Smith,0,0,0,0,0,0
0,0,0,0,0,0,0,0,0,0,0,0,0,0,0,0,1037859,2023-11-30T00:00:00.000Z,3547207,12,Jordan Nwora,0,0,0,0,0,0
0,0,0,0,0,0,0,0,0,0,0,0,0,0,0,0,1037859,2023-11-30T00:00:00.000Z,38017701,12,Kendall Brown,0,0,0,0,0,0
0,0,0,0,0,0,0,0,0,0,0,0,0,0,0,0,1037859,2023-11-30T00:00:00.000Z,304,12,T.J. McConnell,0,0,0,0,0,0
2,0,4,0,0,9,3,2,1,12,0,1,7,4,0,0,1037859,2023-11-30T00:00:00.000Z,4,16,Bam Adebayo,0,11,13,9,6,14.8
3,0,3,2,0,9,5,6,4,25,2,4,14,5,1,4,1037859,2023-11-30T00:00:00.000Z,666747,16,Caleb Martin,1,19,22,17,8,23.5
0,0,0,0,0,0,0,0,0,0,0,0,0,0,0,0,1037859,2023-11-30T00:00:00.000Z,38017736,16,Cole Swider,0,0,0,0,0,0
2,0,1,6,4,9,5,2,2,29,0,3,16,1,1,1,1037859,2023-11-30T00:00:00.000Z,397,16,Duncan Robinson,1,17,19,18,3,22.2
1,0,1,1,0,2,1,0,0,15,0,4,2,1,0,1,1037859,2023-11-30T00:00:00.000Z,3092,16,Haywood Highsmith,0,3,4,3,2,3.7
1,0,5,3,1,13,8,7,7,33,0,3,24,5,1,3,1037859,2023-11-30T00:00:00.000Z,56677785,16,Jaime Jaquez Jr.,1,29,30,25,6,31.5
3,0,7,1,0,18,9,20,18,38,3,1,36,10,0,3,1037859,2023-11-30T00:00:00.000Z,79,16,Jimmy Butler,0,46,49,39,13,49.5
3,0,3,2,0,11,8,4,3,32,1,3,19,4,0,2,1037859,2023-11-30T00:00:00.000Z,391,16,Josh Richardson,0,23,26,22,7,26.3
6,0,7,0,0,1,1,4,3,17,1,2,5,8,1,0,1037859,2023-11-30T00:00:00.000Z,285,16,Kevin Love,1,13,19,11,14,26.6
3,1,2,6,3,10,6,0,0,26,1,5,15,3,0,0,1037859,2023-11-30T00:00:00.000Z,286,16,Kyle Lowry,1,18,21,18,6,26.1
0,0,0,0,0,0,0,0,0,0,0,0,0,0,0,0,1037859,2023-11-30T00:00:00.000Z,38017696,16,Nikola Jovic,0,0,0,0,0,0
1,0,3,0,0,1,1,0,0,6,1,1,2,4,0,0,1037859,2023-11-30T00:00:00.000Z,74,16,Thomas Bryant,0,6,7,3,5,8.3
0,0,0,0,0,0,0,0,0,0,0,0,0,0,0,0,1037860,2023-11-30T00:00:00.000Z,54,9,Bojan Bogdanovic,0,0,0,0,0,0
0,0,0,0,0,0,0,0,0,0,0,0,0,0,0,0,1037860,2023-11-30T00:00:00.000Z,42097199,9,Jared Rhoden,0,0,0,0,0,0
0,0,0,0,0,0,0,0,0,0,0,0,0,0,0,0,1037860,2023-11-30T00:00:00.000Z,197,9,Joe Harris,0,0,0,0,0,0
0,0,0,0,0,0,0,0,0,0,0,0,0,0,0,0,1037860,2023-11-30T00:00:00.000Z,56677729,9,Malcolm Cazalon,0,0,0,0,0,0
0,0,0,0,0,0,0,0,0,0,0,0,0,0,0,0,1037860,2023-11-30T00:00:00.000Z,330,9,Monte Morris,0,0,0,0,0,0
5,1,1,5,3,9,4,0,0,29,0,1,11,1,2,7,1037861,2023-11-30T00:00:00.000Z,89,5,Alex Caruso,3,12,17,16,6,21.7
6,0,5,3,1,8,6,2,1,39,1,2,14,6,3,2,1037861,2023-11-30T00:00:00.000Z,17895983,5,Ayo Dosunmu,3,20,26,20,12,37.2
7,1,4,11,4,20,7,6,5,45,0,3,23,4,1,3,1037861,2023-11-30T00:00:00.000Z,666956,5,Coby White,2,27,34,30,11,41.3
1,0,1,2,1,10,5,0,0,18,1,1,11,2,3,0,1037861,2023-11-30T00:00:00.000Z,87,5,Jevon Carter,3,13,14,12,3,23.9
6,0,9,4,2,21,11,6,5,40,1,2,29,10,1,4,1037861,2023-11-30T00:00:00.000Z,460,5,Nikola Vucevic,1,39,45,35,16,49
0,0,0,0,0,0,0,0,0,0,0,0,0,0,0,0,1037861,2023-11-30T00:00:00.000Z,56677874,5,Onuralp Bitim,0,0,0,0,0,0
1,1,1,4,0,14,6,0,0,36,1,1,12,2,2,1,1037861,2023-11-30T00:00:00.000Z,3547248,5,Patrick Williams,3,14,15,13,3,23.9
2,1,5,6,2,10,4,0,0,27,3,4,10,8,1,2,1037861,2023-11-30T00:00:00.000Z,110,5,Torrey Craig,2,18,20,12,10,26.6
0,0,0,0,0,0,0,0,0,0,0,0,0,0,0,0,1037861,2023-11-30T00:00:00.000Z,38017733,17,A.J. Green,0,0,0,0,0,0
2,0,8,2,0,8,2,0,0,31,1,3,4,9,2,0,1037861,2023-11-30T00:00:00.000Z,377,17,Bobby Portis,2,13,15,6,11,23.8
0,0,4,10,6,12,7,0,0,39,0,5,20,4,0,1,1037861,2023-11-30T00:00:00.000Z,283,17,Brook Lopez,0,24,24,20,4,23.8
0,0,0,0,0,0,0,0,0,0,0,0,0,0,0,0,1037861,2023-11-30T00:00:00.000Z,56677854,17,Chris Livingston,0,0,0,0,0,0
13,1,4,6,1,16,7,4,3,43,1,1,18,5,2,7,1037861,2023-11-30T00:00:00.000Z,278,17,Damian Lillard,3,23,36,31,18,45.5
5,5,8,1,0,17,11,4,4,39,6,5,26,14,2,5,1037861,2023-11-30T00:00:00.000Z,15,17,Giannis Antetokounmpo,7,40,45,31,19,66.3
0,0,0,0,0,0,0,0,0,0,0,0,0,0,0,0,1037861,2023-11-30T00:00:00.000Z,112,17,Jae Crowder,0,0,0,0,0,0
3,0,3,4,1,10,3,5,2,27,0,3,9,3,2,3,1037861,2023-11-30T00:00:00.000Z,315,17,Khris Middleton,2,12,15,12,6,20.1
3,0,3,15,5,19,7,0,0,41,0,2,19,3,2,1,1037861,2023-11-30T00:00:00.000Z,38,17,Malik Beasley,2,22,25,22,6,32.1
0,0,3,4,1,7,3,0,0,22,0,1,7,3,0,2,1037861,2023-11-30T00:00:00.000Z,38017676,17,MarJon Beauchamp,0,10,10,7,3,8.6
0,0,0,0,0,0,0,0,0,0,0,0,0,0,0,0,1037861,2023-11-30T00:00:00.000Z,666453,17,Marques Bolden,0,0,0,0,0,0
0,0,0,0,0,0,0,0,0,0,0,0,0,0,0,0,1037861,2023-11-30T00:00:00.000Z,105,17,Pat Connaughton,0,0,0,0,0,0
0,0,0,0,0,0,0,0,0,0,0,0,0,0,0,0,1037861,2023-11-30T00:00:00.000Z,284,17,Robin Lopez,0,0,0,0,0,0
0,0,0,0,0,0,0,0,0,0,0,0,0,0,0,0,1037861,2023-11-30T00:00:00.000Z,2148,17,Thanasis Antetokounmpo,0,0,0,0,0,0
0,0,0,0,0,0,0,0,0,0,0,0,0,0,0,0,1037861,2023-11-30T00:00:00.000Z,38017691,17,TyTy Washington Jr.,0,0,0,0,0,0
0,0,0,0,0,0,0,0,0,0,0,0,0,0,0,0,1037862,2023-11-30T00:00:00.000Z,3547238,18,Anthony Edwards,0,0,0,0,0,0
0,0,1,4,1,5,1,0,0,10,0,0,3,1,0,0,1037862,2023-11-30T00:00:00.000Z,17895968,18,Daishen Nix,0,4,4,3,1,4.2
0,0,0,0,0,0,0,0,0,0,0,0,0,0,0,0,1037862,2023-11-30T00:00:00.000Z,3547259,18,Jaden McDaniels,0,0,0,0,0,0
0,0,0,0,0,0,0,0,0,0,0,0,0,0,0,0,1037862,2023-11-30T00:00:00.000Z,56677851,18,Jaylen Clark,0,0,0,0,0,0
0,0,0,0,0,0,0,0,0,0,0,0,0,0,0,0,1037862,2023-11-30T00:00:00.000Z,38017715,18,Josh Minott,0,0,0,0,0,0
5,1,7,7,4,22,12,5,4,37,4,3,32,11,2,4,1037862,2023-11-30T00:00:00.000Z,447,18,Karl-Anthony Towns,3,43,48,37,16,57.7
6,0,1,1,0,7,2,0,0,19,0,0,4,1,0,0,1037862,2023-11-30T00:00:00.000Z,12,18,Kyle Anderson,0,5,11,10,7,14.2
0,0,0,0,0,0,0,0,0,0,0,0,0,0,0,0,1037862,2023-11-30T00:00:00.000Z,17896056,18,Luka Garza,0,0,0,0,0,0
7,0,3,6,2,6,2,2,2,29,0,3,8,3,2,2,1037862,2023-11-30T00:00:00.000Z,104,18,Mike Conley,2,11,18,15,10,26.1
0,1,2,4,0,9,3,0,0,22,1,2,6,3,1,0,1037862,2023-11-30T00:00:00.000Z,667378,18,Naz Reid,2,9,9,6,3,15.6
7,2,3,8,4,16,8,0,0,36,2,4,20,5,5,4,1037862,2023-11-30T00:00:00.000Z,666400,18,Nickeil Alexander-Walker,7,25,32,27,12,53.5
0,3,10,0,0,11,6,4,3,38,3,4,15,13,0,0,1037862,2023-11-30T00:00:00.000Z,176,18,Rudy Gobert,3,28,28,15,13,39.6
3,0,2,2,0,7,2,2,1,20,0,0,5,2,2,0,1037862,2023-11-30T00:00:00.000Z,320,18,Shake Milton,2,7,10,8,5,17.9
2,0,3,3,2,6,3,0,0,29,0,0,8,3,1,1,1037862,2023-11-30T00:00:00.000Z,68,18,Troy Brown Jr.,1,11,13,10,5,16.6
0,0,0,0,0,0,0,0,0,0,0,0,0,0,0,0,1037862,2023-11-30T00:00:00.000Z,38017700,18,Wendell Moore Jr.,0,0,0,0,0,0
0,0,0,0,0,0,0,0,0,0,0,0,0,0,0,0,1037862,2023-11-30T00:00:00.000Z,38017630,29,Johnny Juzang,0,0,0,0,0,0
3,0,3,2,2,5,3,0,0,14,1,3,8,4,0,2,1037862,2023-11-30T00:00:00.000Z,358,29,Kelly Olynyk,0,12,15,11,7,15.3
4,0,3,6,1,19,4,3,3,33,1,2,12,4,0,2,1037862,2023-11-30T00:00:00.000Z,56677834,29,Keyonte George,0,16,20,16,8,20.8
0,0,3,1,0,4,1,0,0,12,1,0,2,4,0,2,1037862,2023-11-30T00:00:00.000Z,666881,29,Luka Samanic,0,6,6,2,4,4.8
0,0,0,0,0,0,0,0,0,0,0,0,0,0,0,0,1037862,2023-11-30T00:00:00.000Z,19465584,29,Micah Potter,0,0,0,0,0,0
3,0,3,6,3,10,5,0,0,36,3,1,13,6,4,1,1037862,2023-11-30T00:00:00.000Z,38017620,29,Ochai Agbaji,4,19,22,16,9,35.7
0,1,6,1,0,4,1,0,0,14,1,3,2,7,0,2,1037862,2023-11-30T00:00:00.000Z,11891374,29,Omer Yurtseven,1,9,9,2,7,11.4
1,0,1,3,1,7,3,0,0,19,0,1,7,1,0,0,1037862,2023-11-30T00:00:00.000Z,666650,29,Talen Horton-Tucker,0,8,9,8,2,9.7
2,3,5,2,0,6,3,2,1,27,0,1,7,5,1,1,1037862,2023-11-30T00:00:00.000Z,38017705,29,Walker Kessler,4,12,14,9,7,27
0,0,0,1,0,1,0,2,2,4,1,0,2,1,0,0,1037863,2023-11-30T00:00:00.000Z,56677867,14,Alex Fudge,0,3,3,2,1,3.2
0,0,0,0,0,0,0,0,0,0,0,0,0,0,0,0,1037863,2023-11-30T00:00:00.000Z,666860,14,Cameron Reddish,0,0,0,0,0,0
1,0,3,2,0,6,1,7,5,20,1,1,7,4,0,1,1037863,2023-11-30T00:00:00.000Z,486,14,Christian Wood,0,11,12,8,5,12.3
0,1,2,0,0,1,0,2,2,4,1,0,2,3,0,0,1037863,2023-11-30T00:00:00.000Z,56677738,14,Colin Castleton,1,5,5,2,3,8.6
10,0,2,5,2,13,6,2,2,32,1,3,16,3,1,2,1037863,2023-11-30T00:00:00.000Z,405,14,D'Angelo Russell,1,19,29,26,13,35.6
0,0,0,1,0,1,0,0,0,4,0,0,0,0,0,0,1037863,2023-11-30T00:00:00.000Z,56677868,14,D'Moi Hodge,0,0,0,0,0,0
0,0,1,3,0,6,1,2,1,19,0,3,3,1,0,1,1037863,2023-11-30T00:00:00.000Z,56677835,14,Jalen Hood-Schifino,0,4,4,3,1,3.2
0,0,0,0,0,0,0,0,0,0,0,0,0,0,0,0,1037863,2023-11-30T00:00:00.000Z,666626,14,Jaxson Hayes,0,0,0,0,0,0
6,1,10,8,4,12,7,4,3,35,2,1,21,12,1,5,1037863,2023-11-30T00:00:00.000Z,237,14,LeBron James,2,33,39,27,18,45.4
0,0,0,0,0,0,0,0,0,4,0,0,0,0,0,0,1037863,2023-11-30T00:00:00.000Z,56677836,14,Maxwell Lewis,0,0,0,0,0,0
0,0,0,0,0,0,0,0,0,0,0,0,0,0,0,0,1037863,2023-11-30T00:00:00.000Z,666609,14,Rui Hachimura,0,0,0,0,0,0
2,0,1,5,2,7,2,0,0,32,0,5,6,1,0,1,1037863,2023-11-30T00:00:00.000Z,383,14,Taurean Prince,0,7,9,8,3,9.2
0,0,0,0,0,0,0,0,0,0,0,0,0,0,0,0,1037863,2023-11-30T00:00:00.000Z,44,21,Davis Bertans,0,0,0,0,0,0
0,0,0,0,0,0,0,0,0,0,0,0,0,0,0,0,1037863,2023-11-30T00:00:00.000Z,56677853,21,Keyontae Johnson,0,0,0,0,0,0
1,0,1,4,1,5,2,0,0,12,0,3,5,1,0,0,1037863,2023-11-30T00:00:00.000Z,27924547,21,Lindy Waters III,0,6,7,6,2,7.7
0,0,0,0,0,0,0,0,0,0,0,0,0,0,0,0,1037863,2023-11-30T00:00:00.000Z,24572055,21,Olivier Sarr,0,0,0,0,0,0
0,0,0,0,0,0,0,0,0,0,0,0,0,0,0,0,1037863,2023-11-30T00:00:00.000Z,38017716,21,Ousmane Dieng,0,0,0,0,0,0
0,0,0,0,0,0,0,0,0,0,0,0,0,0,0,0,1037863,2023-11-30T00:00:00.000Z,4197029,21,Vasilije Micic,0,0,0,0,0,0
1,1,5,0,0,9,6,0,0,23,4,4,12,9,0,2,1037864,2023-11-30T00:00:00.000Z,83,1,Clint Capela,1,21,22,13,10,25.3
2,0,6,4,2,8,3,4,4,22,0,6,12,6,1,3,1037864,2023-11-30T00:00:00.000Z,666656,1,De'Andre Hunter,1,18,20,14,8,22.2
2,0,3,4,2,21,10,2,2,35,0,1,24,3,5,0,1037864,2023-11-30T00:00:00.000Z,334,1,Dejounte Murray,5,27,29,26,5,45.6
0,0,0,0,0,0,0,0,0,0,0,0,0,0,0,0,1037864,2023-11-30T00:00:00.000Z,17896040,1,Jalen Johnson,0,0,0,0,0,0
0,0,0,0,0,0,0,0,0,0,0,0,0,0,0,0,1037864,2023-11-30T00:00:00.000Z,56677838,1,Kobe Bufkin,0,0,0,0,0,0
0,0,0,0,0,0,0,0,0,0,0,0,0,0,0,0,1037864,2023-11-30T00:00:00.000Z,56677875,1,Miles Norris,0,0,0,0,0,0
0,0,0,0,0,0,0,0,0,0,0,0,0,0,0,0,1037864,2023-11-30T00:00:00.000Z,56677806,1,Mouhamed Gueye,0,0,0,0,0,0
0,0,0,0,0,0,0,0,0,0,0,0,0,0,0,0,1037864,2023-11-30T00:00:00.000Z,319,1,Patty Mills,0,0,0,0,0,0
0,0,2,4,3,8,5,0,0,34,2,3,13,4,3,1,1037864,2023-11-30T00:00:00.000Z,3547256,1,Saddiq Bey,3,17,17,13,4,25.8
0,0,0,0,0,0,0,0,0,0,0,0,0,0,0,0,1037864,2023-11-30T00:00:00.000Z,56677855,1,Seth Lundy,0,0,0,0,0,0
0,0,0,0,0,0,0,0,0,0,0,0,0,0,0,0,1037864,2023-11-30T00:00:00.000Z,38017693,27,Blake Wesley,0,0,0,0,0,0
2,0,1,5,1,7,1,0,0,16,0,3,3,1,0,1,1037864,2023-11-30T00:00:00.000Z,359,27,Cedi Osman,0,4,6,5,3,6.2
0,0,0,0,0,0,0,0,0,0,0,0,0,0,0,0,1037864,2023-11-30T00:00:00.000Z,56677865,27,Charles Bediako,0,0,0,0,0,0
4,0,4,10,4,14,8,5,5,27,0,1,25,4,0,2,1037864,2023-11-30T00:00:00.000Z,3547246,27,Devin Vassell,0,29,33,29,8,33.8
0,0,0,0,0,0,0,0,0,0,0,0,0,0,0,0,1037864,2023-11-30T00:00:00.000Z,180,27,Devonte' Graham,0,0,0,0,0,0
0,0,0,0,0,0,0,0,0,0,0,0,0,0,0,0,1037864,2023-11-30T00:00:00.000Z,305,27,Doug McDermott,0,0,0,0,0,0
0,0,2,8,5,8,5,0,0,20,1,2,15,3,0,1,1037864,2023-11-30T00:00:00.000Z,38017649,27,Julian Champagnie,0,18,18,15,3,17.6
0,0,0,0,0,0,0,0,0,0,0,0,0,0,0,0,1037864,2023-11-30T00:00:00.000Z,17896059,27,Sandro Mamukelashvili,0,0,0,0,0,0
0,0,0,0,0,0,0,0,0,0,0,0,0,0,0,0,1037864,2023-11-30T00:00:00.000Z,56677817,27,Sidy Cissoko,0,0,0,0,0,0
0,0,0,0,0,0,0,0,0,0,0,0,0,0,0,0,1037864,2023-11-30T00:00:00.000Z,56677870,27,Sir'Jabari Rice,0,0,0,0,0,0
7,0,2,3,1,5,1,1,0,24,0,1,3,2,0,2,1037864,2023-11-30T00:00:00.000Z,3547274,27,Tre Jones,0,5,12,10,9,13.9
0,0,0,0,0,0,0,0,0,0,0,0,0,0,0,0,1037865,2023-11-30T00:00:00.000Z,475,10,Andrew Wiggins,0,0,0,0,0,0
0,0,0,0,0,0,0,0,0,0,0,0,0,0,0,0,1037865,2023-11-30T00:00:00.000Z,367,10,Chris Paul,0,0,0,0,0,0
2,0,2,2,0,2,0,2,1,22,0,1,1,2,0,0,1037865,2023-11-30T00:00:00.000Z,251,10,Cory Joseph,0,3,5,3,4,6.4
5,0,5,4,2,7,4,4,3,27,0,2,13,5,1,0,1037865,2023-11-30T00:00:00.000Z,407,10,Dario Saric,1,18,23,18,10,29.5
0,0,0,0,0,0,0,0,0,0,0,0,0,0,0,0,1037865,2023-11-30T00:00:00.000Z,2189,10,Gary Payton II,0,0,0,0,0,0
0,0,0,0,0,0,0,0,0,0,0,0,0,0,0,0,1037865,2023-11-30T00:00:00.000Z,57875092,10,Gui Santos,0,0,0,0,0,0
0,0,0,0,0,0,0,0,0,0,0,0,0,0,0,0,1037865,2023-11-30T00:00:00.000Z,398,10,Jerome Robinson,0,0,0,0,0,0
3,1,5,5,3,8,6,4,2,23,1,0,17,6,1,1,1037865,2023-11-30T00:00:00.000Z,17553979,10,Jonathan Kuminga,2,23,26,20,9,33.7
0,0,0,0,0,0,0,0,0,0,0,0,0,0,0,0,1037865,2023-11-30T00:00:00.000Z,45658838,10,Lester Quinones,0,0,0,0,0,0
0,0,0,0,0,0,0,0,0,0,0,0,0,0,0,0,1037865,2023-11-30T00:00:00.000Z,56677799,10,Trayce Jackson-Davis,0,0,0,0,0,0
0,0,0,0,0,0,0,0,0,0,0,0,0,0,0,0,1037865,2023-11-30T00:00:00.000Z,17896070,10,Usman Garuba,0,0,0,0,0,0
0,0,0,0,0,0,0,0,0,1,0,2,0,0,0,0,1037865,2023-11-30T00:00:00.000Z,666511,13,Amir Coffey,0,0,0,0,0,0
0,0,0,0,0,0,0,0,0,0,0,0,0,0,0,0,1037865,2023-11-30T00:00:00.000Z,17896022,13,Brandon Boston Jr.,0,0,0,0,0,0
2,0,1,1,1,9,4,2,1,15,1,2,10,2,0,0,1037865,2023-11-30T00:00:00.000Z,439,13,Daniel Theis,0,12,14,12,4,15.4
0,1,9,0,0,11,7,5,4,26,4,1,18,13,0,0,1037865,2023-11-30T00:00:00.000Z,493,13,Ivica Zubac,1,31,31,18,13,36.6
7,0,3,10,5,13,6,2,1,37,0,3,18,3,1,1,1037865,2023-11-30T00:00:00.000Z,192,13,James Harden,1,21,28,25,10,34.1
0,0,0,0,0,0,0,0,0,0,0,0,0,0,0,0,1037865,2023-11-30T00:00:00.000Z,56677856,13,Jordan Miller,0,0,0,0,0,0
0,0,6,2,2,17,9,4,3,35,1,2,23,7,2,0,1037865,2023-11-30T00:00:00.000Z,274,13,Kawhi Leonard,2,30,30,23,7,37.4
0,0,1,1,0,1,0,0,0,6,0,2,0,1,0,0,1037865,2023-11-30T00:00:00.000Z,56677849,13,Kobe Brown,0,1,1,0,1,1.2
0,0,0,0,0,0,0,0,0,0,0,0,0,0,0,0,1037865,2023-11-30T00:00:00.000Z,371,13,Mason Plumlee,0,0,0,0,0,0
0,0,0,0,0,0,0,2,2,1,0,0,2,0,0,0,1037865,2023-11-30T00:00:00.000Z,38017725,13,Moussa Diabate,0,2,2,2,0,2
0,0,0,1,0,1,0,0,0,4,0,1,0,0,0,0,1037865,2023-11-30T00:00:00.000Z,17896031,13,Nah'Shon Hyland,0,0,0,0,0,0
0,0,0,0,0,2,1,3,3,18,0,1,5,0,1,2,1037865,2023-11-30T00:00:00.000Z,380,13,Norman Powell,1,5,5,5,0,6
10,0,1,10,3,18,6,0,0,37,0,5,15,1,0,1,1037865,2023-11-30T00:00:00.000Z,172,13,Paul George,0,16,26,25,11,30.2
0,0,0,0,0,0,0,0,0,0,0,0,0,0,0,0,1037865,2023-11-30T00:00:00.000Z,450,13,PJ Tucker,0,0,0,0,0,0
6,0,5,3,0,13,5,6,4,26,6,1,14,11,0,0,1037865,2023-11-30T00:00:00.000Z,472,13,Russell Westbrook,0,25,31,20,17,36.2
1,0,2,4,1,10,4,0,0,34,3,1,9,5,1,2,1037865,2023-11-30T00:00:00.000Z,666743,13,Terance Mann,1,14,15,10,6,17.5
0,0,0,0,0,0,0,0,0,0,0,0,0,0,0,0,1037865,2023-11-30T00:00:00.000Z,24417679,13,Xavier Moon,0,0,0,0,0,0
0,0,0,6,1,9,3,2,1,22,0,0,8,0,0,1,1037866,2023-12-01T00:00:00.000Z,196,22,Gary Harris,0,8,8,8,0,7
0,0,0,0,0,0,0,0,0,0,0,0,0,0,0,0,1037866,2023-12-01T00:00:00.000Z,3547302,30,Anthony Gill,0,0,0,0,0,0
3,0,1,6,4,11,4,4,3,23,0,2,15,1,0,0,1037866,2023-12-01T00:00:00.000Z,17896045,30,Corey Kispert,0,16,19,18,4,20.7
0,0,0,0,0,0,0,0,0,0,0,0,0,0,0,0,1037866,2023-12-01T00:00:00.000Z,487,30,Delon Wright,0,0,0,0,0,0
0,0,0,0,0,0,0,0,0,0,0,0,0,0,0,0,1037866,2023-12-01T00:00:00.000Z,17896106,30,Eugene Omoruyi,0,0,0,0,0,0
0,0,0,0,0,0,0,0,0,0,0,0,0,0,0,0,1037866,2023-12-01T00:00:00.000Z,38124126,30,John Butler Jr.,0,0,0,0,0,0
2,0,0,3,3,8,5,3,0,18,0,4,13,0,0,2,1037866,2023-12-01T00:00:00.000Z,414,30,Landry Shamet,0,13,15,15,2,14
0,0,0,0,0,0,0,0,0,0,0,0,0,0,0,0,1037866,2023-12-01T00:00:00.000Z,337,30,Mike Muscala,0,0,0,0,0,0
0,0,0,0,0,0,0,0,0,0,0,0,0,0,0,0,1037866,2023-12-01T00:00:00.000Z,38017712,30,Ryan Rollins,0,0,0,0,0,0
0,0,0,0,0,0,0,0,0,0,0,0,0,0,0,0,1037867,2023-12-01T00:00:00.000Z,2175,23,Danuel House Jr.,0,0,0,0,0,0
2,1,3,12,4,19,7,4,3,37,1,6,21,4,1,4,1037867,2023-12-01T00:00:00.000Z,313,23,De'Anthony Melton,2,25,27,23,6,30.8
8,0,5,8,3,21,9,1,1,37,0,2,22,5,1,2,1037868,2023-12-01T00:00:00.000Z,73,20,Jalen Brunson,1,27,35,30,13,41
9,0,8,4,1,15,8,3,3,35,2,3,20,10,0,2,1037868,2023-12-01T00:00:00.000Z,387,20,Julius Randle,0,30,39,29,19,43.5
1,1,3,0,0,3,3,0,0,32,2,3,6,5,4,2,1037868,2023-12-01T00:00:00.000Z,399,20,Mitchell Robinson,5,11,12,7,6,26.5
6,0,3,6,1,18,6,3,2,27,1,1,15,4,0,2,1037868,2023-12-01T00:00:00.000Z,666423,20,RJ Barrett,0,19,25,21,10,26.8
0,0,0,0,0,0,0,0,0,0,0,0,0,0,0,0,1037868,2023-12-01T00:00:00.000Z,38017710,28,Christian Koloko,0,0,0,0,0,0
0,0,0,0,0,0,0,0,0,0,0,0,0,0,0,0,1037868,2023-12-01T00:00:00.000Z,56677828,28,Gradey Dick,0,0,0,0,0,0
1,2,8,0,0,9,6,0,0,28,4,4,12,12,0,1,1037868,2023-12-01T00:00:00.000Z,373,28,Jakob Poeltl,2,24,25,13,13,32.9
0,0,0,0,0,0,0,0,0,0,0,0,0,0,0,0,1037868,2023-12-01T00:00:00.000Z,56677869,28,Markquis Nowell,0,0,0,0,0,0
3,2,4,6,1,13,4,0,0,27,1,5,9,5,1,3,1037868,2023-12-01T00:00:00.000Z,18,28,OG Anunoby,3,14,17,12,8,25.5
3,0,5,4,0,16,7,8,7,34,3,3,21,8,0,3,1037868,2023-12-01T00:00:00.000Z,416,28,Pascal Siakam,0,29,32,24,11,32.1
0,0,0,0,0,0,0,0,0,0,0,0,0,0,0,0,1037868,2023-12-01T00:00:00.000Z,38017717,28,Ron Harper Jr.,0,0,0,0,0,0
4,1,6,7,3,19,13,1,0,37,3,2,29,9,5,2,1037868,2023-12-01T00:00:00.000Z,17896055,28,Scottie Barnes,6,38,42,33,13,61.8
0,0,0,0,0,0,0,0,0,0,0,0,0,0,0,0,1037868,2023-12-01T00:00:00.000Z,489,28,Thaddeus Young,0,0,0,0,0,0
0,0,1,1,0,1,0,2,1,4,0,0,1,1,0,0,1037869,2023-12-01T00:00:00.000Z,17554004,7,AJ Lawson,0,2,2,1,1,2.2
0,0,0,0,0,0,0,0,0,0,0,0,0,0,0,0,1037869,2023-12-01T00:00:00.000Z,151,7,Dante Exum,0,0,0,0,0,0
1,2,4,0,0,5,2,0,0,23,1,1,4,5,1,2,1037869,2023-12-01T00:00:00.000Z,56677840,7,Dereck Lively II,3,9,10,5,6,18.5
1,0,1,7,4,14,6,0,0,31,3,1,16,4,1,1,1037869,2023-12-01T00:00:00.000Z,247,7,Derrick Jones Jr.,1,20,21,17,5,24.3
0,0,0,1,0,4,2,1,0,4,0,0,4,0,1,0,1037869,2023-12-01T00:00:00.000Z,56677873,7,Dexter Dennis,1,4,4,4,0,7
0,0,0,0,0,0,0,0,0,0,0,0,0,0,0,0,1037869,2023-12-01T00:00:00.000Z,379,7,Dwight Powell,0,0,0,0,0,0
3,1,6,9,3,12,4,6,5,31,2,3,16,8,1,1,1037869,2023-12-01T00:00:00.000Z,666965,7,Grant Williams,2,24,27,19,11,35.1
0,0,0,0,0,0,0,0,0,0,0,0,0,0,0,0,1037869,2023-12-01T00:00:00.000Z,17896028,7,Greg Brown III,0,0,0,0,0,0
5,0,3,4,0,9,4,2,0,21,2,1,8,5,0,2,1037869,2023-12-01T00:00:00.000Z,38017679,7,Jaden Hardy,0,13,18,13,10,19.5
5,0,2,3,1,10,4,1,1,31,0,0,10,2,3,3,1037869,2023-12-01T00:00:00.000Z,3547258,7,Josh Green,3,12,17,15,7,25.9
5,0,5,5,0,15,3,5,4,36,0,2,10,5,0,1,1037869,2023-12-01T00:00:00.000Z,228,7,Kyrie Irving,0,15,20,15,10,22.5
0,0,0,0,0,0,0,0,0,0,0,0,0,0,0,0,1037869,2023-12-01T00:00:00.000Z,132,7,Luka Doncic,0,0,0,0,0,0
1,0,1,4,2,7,2,0,0,14,2,2,6,3,0,0,1037869,2023-12-01T00:00:00.000Z,329,7,Markieff Morris,0,9,10,7,4,11.1
0,0,0,0,0,0,0,0,0,0,0,0,0,0,0,0,1037869,2023-12-01T00:00:00.000Z,257,7,Maxi Kleber,0,0,0,0,0,0
2,0,0,1,0,1,0,2,2,11,0,0,2,0,0,0,1037869,2023-12-01T00:00:00.000Z,56677859,7,Olivier-Maxence Prosper,0,2,4,4,2,5
2,2,4,0,0,4,2,2,1,18,3,1,5,7,1,1,1037869,2023-12-01T00:00:00.000Z,217,7,Richaun Holmes,3,12,14,7,9,24.4
2,0,2,4,2,10,5,0,0,16,0,2,12,2,1,0,1037869,2023-12-01T00:00:00.000Z,114,7,Seth Curry,1,14,16,14,4,20.4
0,0,0,0,0,0,0,0,0,0,0,0,0,0,0,0,1037869,2023-12-01T00:00:00.000Z,191,7,Tim Hardaway Jr.,0,0,0,0,0,0
0,0,0,0,0,0,0,0,0,0,0,0,0,0,0,0,1037869,2023-12-01T00:00:00.000Z,666505,15,Brandon Clarke,0,0,0,0,0,0
3,1,5,3,0,9,2,2,2,24,1,2,6,6,1,1,1037869,2023-12-01T00:00:00.000Z,38017729,15,David Roddy,2,12,15,9,9,22.7
0,0,0,0,0,0,0,0,0,0,0,0,0,0,0,0,1037869,2023-12-01T00:00:00.000Z,56677830,15,GG Jackson,0,0,0,0,0,0
0,0,0,0,0,0,0,0,0,0,0,0,0,0,0,0,1037869,2023-12-01T00:00:00.000Z,666786,15,Ja Morant,0,0,0,0,0,0
0,0,0,0,0,0,0,0,0,0,0,0,0,0,0,0,1037869,2023-12-01T00:00:00.000Z,38017728,15,Jake LaRavia,0,0,0,0,0,0
2,2,3,3,0,8,2,0,0,14,1,5,4,4,0,1,1037869,2023-12-01T00:00:00.000Z,231,15,Jaren Jackson Jr.,2,8,10,6,6,16.8
0,0,0,0,0,0,0,0,0,0,0,0,0,0,0,0,1037869,2023-12-01T00:00:00.000Z,254,15,Luke Kennard,0,0,0,0,0,0
0,0,0,0,0,0,0,0,0,0,0,0,0,0,0,0,1037869,2023-12-01T00:00:00.000Z,420,15,Marcus Smart,0,0,0,0,0,0
0,0,0,0,0,0,0,0,0,0,0,0,0,0,0,0,1037869,2023-12-01T00:00:00.000Z,3,15,Steven Adams,0,0,0,0,0,0
1,0,0,1,1,2,1,0,0,10,0,1,3,0,1,2,1037869,2023-12-01T00:00:00.000Z,17896027,15,Ziaire Williams,1,3,4,4,1,5.5
1,0,2,0,0,0,0,2,2,13,1,1,2,3,0,0,1037870,2023-12-01T00:00:00.000Z,491,19,Cody Zeller,0,5,6,3,4,7.1
0,0,0,0,0,0,0,0,0,0,0,0,0,0,0,0,1037870,2023-12-01T00:00:00.000Z,38017726,19,Dereon Seabron,0,0,0,0,0,0
1,0,2,1,0,4,1,0,0,11,0,2,2,2,0,0,1037870,2023-12-01T00:00:00.000Z,38017677,19,Dyson Daniels,0,4,5,3,3,5.9
0,0,0,0,0,0,0,0,0,0,0,0,0,0,0,0,1037870,2023-12-01T00:00:00.000Z,38017663,19,E.J. Liddell,0,0,0,0,0,0
0,0,0,0,0,0,0,0,0,0,0,0,0,0,0,0,1037870,2023-12-01T00:00:00.000Z,17896021,19,Jeremiah Robinson-Earl,0,0,0,0,0,0
0,0,0,2,1,3,1,0,0,15,0,1,3,0,0,1,1037870,2023-12-01T00:00:00.000Z,56677837,19,Jordan Hawkins,0,3,3,3,0,2
0,0,0,0,0,0,0,0,0,0,0,0,0,0,0,0,1037870,2023-12-01T00:00:00.000Z,3547260,19,Kira Lewis Jr.,0,0,0,0,0,0
0,0,0,0,0,0,0,0,0,0,0,0,0,0,0,0,1037870,2023-12-01T00:00:00.000Z,340,19,Larry Nance Jr.,0,0,0,0,0,0
0,0,0,0,0,0,0,0,0,0,0,0,0,0,0,0,1037870,2023-12-01T00:00:00.000Z,17896017,19,Matt Ryan,0,0,0,0,0,0
0,0,4,1,1,4,3,3,3,19,2,1,10,6,0,2,1037870,2023-12-01T00:00:00.000Z,3547293,19,Naji Marshall,0,16,16,10,6,15.2
2,0,0,0,0,0,0,0,0,3,0,0,0,0,0,0,1037870,2023-12-01T00:00:00.000Z,38017693,27,Blake Wesley,0,0,2,2,2,3
5,1,2,5,2,9,4,2,1,27,0,3,11,2,0,0,1037870,2023-12-01T00:00:00.000Z,359,27,Cedi Osman,1,13,18,16,7,23.9
3,3,10,0,0,4,4,0,0,19,1,4,8,11,0,1,1037870,2023-12-01T00:00:00.000Z,17895854,27,Charles Bassey,3,19,22,11,14,33.7
0,0,0,0,0,0,0,0,0,0,0,0,0,0,0,0,1037870,2023-12-01T00:00:00.000Z,56677865,27,Charles Bediako,0,0,0,0,0,0
1,0,0,7,2,12,5,2,2,27,0,2,14,0,2,3,1037870,2023-12-01T00:00:00.000Z,3547246,27,Devin Vassell,2,14,15,15,1,18.5
0,0,0,0,0,0,0,0,0,0,0,0,0,0,0,0,1037870,2023-12-01T00:00:00.000Z,180,27,Devonte' Graham,0,0,0,0,0,0
0,0,0,0,0,1,1,0,0,3,0,0,2,0,0,0,1037870,2023-12-01T00:00:00.000Z,38017730,27,Dominick Barlow,0,2,2,2,0,2
0,0,0,0,0,0,0,0,0,0,0,0,0,0,0,0,1037870,2023-12-01T00:00:00.000Z,305,27,Doug McDermott,0,0,0,0,0,0
4,0,3,4,2,13,4,4,3,31,0,2,13,3,0,2,1037870,2023-12-01T00:00:00.000Z,38017699,27,Jeremy Sochan,0,16,20,17,7,20.6
3,0,4,6,3,7,4,1,1,22,1,3,12,5,0,3,1037870,2023-12-01T00:00:00.000Z,38017649,27,Julian Champagnie,0,17,20,15,8,19.5
3,0,6,3,1,7,4,2,2,33,1,2,11,7,1,2,1037870,2023-12-01T00:00:00.000Z,666682,27,Keldon Johnson,1,18,21,14,10,24.9
0,0,2,3,2,7,4,0,0,22,0,1,10,2,0,3,1037870,2023-12-01T00:00:00.000Z,38017692,27,Malaki Branham,0,12,12,10,2,9.4
1,0,0,2,1,2,1,0,0,6,0,1,3,0,0,0,1037870,2023-12-01T00:00:00.000Z,17896059,27,Sandro Mamukelashvili,0,3,4,4,1,4.5
0,0,0,0,0,0,0,0,0,0,0,0,0,0,0,0,1037870,2023-12-01T00:00:00.000Z,56677817,27,Sidy Cissoko,0,0,0,0,0,0
0,0,0,0,0,0,0,0,0,0,0,0,0,0,0,0,1037870,2023-12-01T00:00:00.000Z,56677870,27,Sir'Jabari Rice,0,0,0,0,0,0
3,0,2,4,2,9,4,0,0,23,1,1,10,3,0,2,1037870,2023-12-01T00:00:00.000Z,3547274,27,Tre Jones,0,13,16,13,6,16.1
0,0,0,0,0,0,0,0,0,0,0,0,0,0,0,0,1037870,2023-12-01T00:00:00.000Z,56677822,27,Victor Wembanyama,0,0,0,0,0,0
3,1,2,5,1,11,3,6,5,24,3,2,12,5,2,3,1037870,2023-12-01T00:00:00.000Z,102,27,Zach Collins,3,17,20,15,8,28.5
0,0,0,0,0,0,0,0,0,0,0,0,0,0,0,0,1037871,2023-12-01T00:00:00.000Z,177,8,Aaron Gordon,0,0,0,0,0,0
0,0,0,0,0,0,0,0,0,0,0,0,0,0,0,0,1037871,2023-12-01T00:00:00.000Z,56677871,8,Hunter Tyson,0,0,0,0,0,0
0,0,0,0,0,0,0,0,0,0,0,0,0,0,0,0,1037871,2023-12-01T00:00:00.000Z,56677582,8,Jalen Pickett,0,0,0,0,0,0
0,0,0,0,0,0,0,0,0,0,0,0,0,0,0,0,1037871,2023-12-01T00:00:00.000Z,335,8,Jamal Murray,0,0,0,0,0,0
0,0,0,0,0,0,0,0,0,0,0,0,0,0,0,0,1037871,2023-12-01T00:00:00.000Z,17896103,8,Jay Huff,0,0,0,0,0,0
5,0,1,5,3,8,6,0,0,26,1,2,15,2,1,0,1037871,2023-12-01T00:00:00.000Z,215,8,Justin Holiday,1,17,22,20,7,27.9
5,0,1,6,3,10,6,0,0,35,0,2,15,1,3,0,1037871,2023-12-01T00:00:00.000Z,81,8,Kentavious Caldwell-Pope,3,16,21,20,6,32.7
4,1,9,4,0,16,8,3,3,37,1,1,19,10,2,2,1037871,2023-12-01T00:00:00.000Z,375,8,Michael Porter Jr.,3,29,33,23,14,44
16,2,4,3,0,18,9,6,3,35,1,4,21,5,1,3,1037871,2023-12-01T00:00:00.000Z,246,8,Nikola Jokic,3,26,42,37,21,57
4,0,2,4,3,11,8,2,1,29,0,3,20,2,0,1,1037871,2023-12-01T00:00:00.000Z,236,8,Reggie Jackson,0,22,26,24,6,27.4
0,0,0,0,0,0,0,0,0,0,0,0,0,0,0,0,1037871,2023-12-01T00:00:00.000Z,666451,24,Bol Bol,0,0,0,0,0,0
0,0,0,0,0,0,0,0,0,0,0,0,0,0,0,0,1037871,2023-12-01T00:00:00.000Z,37,24,Bradley Beal,0,0,0,0,0,0
1,0,1,1,0,2,0,0,0,4,0,0,0,1,0,0,1037871,2023-12-01T00:00:00.000Z,314,24,Chimezie Metu,0,1,2,1,2,2.7
0,0,0,0,0,0,0,0,0,0,0,0,0,0,0,0,1037871,2023-12-01T00:00:00.000Z,272,24,Damion Lee,0,0,0,0,0,0
0,0,0,0,0,0,0,0,0,0,0,0,0,0,0,0,1037871,2023-12-01T00:00:00.000Z,57,24,Devin Booker,0,0,0,0,0,0
1,0,6,0,0,1,0,0,0,15,0,2,0,6,0,0,1037871,2023-12-01T00:00:00.000Z,147,24,Drew Eubanks,0,6,7,1,7,8.7
3,1,3,7,4,11,6,0,0,33,1,1,16,4,1,3,1037871,2023-12-01T00:00:00.000Z,178,24,Eric Gordon,2,20,23,19,7,28.3
3,0,9,4,1,9,5,2,2,37,0,2,13,9,1,0,1037871,2023-12-01T00:00:00.000Z,8,24,Grayson Allen,1,22,25,16,12,31.3
0,0,4,1,0,3,1,0,0,20,2,1,2,6,0,0,1037871,2023-12-01T00:00:00.000Z,18678058,24,Jordan Goodwin,0,8,8,2,6,9.2
0,3,2,5,1,9,5,2,2,26,2,3,13,4,1,2,1037871,2023-12-01T00:00:00.000Z,356,24,Josh Okogie,4,17,17,13,4,27.8
2,1,3,6,2,22,13,5,3,33,3,6,31,6,0,6,1037871,2023-12-01T00:00:00.000Z,349,24,Jusuf Nurkic,1,37,39,33,8,38.2
1,0,1,0,0,1,0,4,4,17,0,0,4,1,0,0,1037871,2023-12-01T00:00:00.000Z,32,24,Keita Bates-Diop,0,5,6,5,2,6.7
11,3,4,3,1,25,8,13,13,36,0,2,30,4,1,1,1037871,2023-12-01T00:00:00.000Z,140,24,Kevin Durant,4,34,45,41,15,62.3
0,0,2,0,0,1,1,0,0,19,0,0,2,2,0,0,1037871,2023-12-01T00:00:00.000Z,666729,24,Nassir Little,0,4,4,2,2,4.4
0,0,0,0,0,0,0,0,0,0,0,0,0,0,0,0,1037871,2023-12-01T00:00:00.000Z,3547298,24,Saben Lee,0,0,0,0,0,0
0,0,0,0,0,0,0,0,0,0,0,0,0,0,0,0,1037871,2023-12-01T00:00:00.000Z,3547095,24,Udoka Azubuike,0,0,0,0,0,0
0,0,0,0,0,0,0,0,0,0,0,0,0,0,0,0,1037871,2023-12-01T00:00:00.000Z,470,24,Yuta Watanabe,0,0,0,0,0,0
0,0,0,0,0,0,0,0,0,0,0,0,0,0,0,0,1037872,2023-12-02T00:00:00.000Z,475,10,Andrew Wiggins,0,0,0,0,0,0
0,0,0,0,0,0,0,0,0,0,0,0,0,0,0,0,1037872,2023-12-02T00:00:00.000Z,2189,10,Gary Payton II,0,0,0,0,0,0
0,0,0,0,0,0,0,0,0,0,0,0,0,0,0,0,1037872,2023-12-02T00:00:00.000Z,57875092,10,Gui Santos,0,0,0,0,0,0
0,0,0,0,0,0,0,0,0,0,0,0,0,0,0,0,1037872,2023-12-02T00:00:00.000Z,45658838,10,Lester Quinones,0,0,0,0,0,0
0,0,0,0,0,0,0,0,0,0,0,0,0,0,0,0,1037872,2023-12-02T00:00:00.000Z,666511,13,Amir Coffey,0,0,0,0,0,0
1,2,2,2,0,11,6,0,0,22,2,3,12,4,1,1,1037872,2023-12-02T00:00:00.000Z,439,13,Daniel Theis,3,16,17,13,5,26.3
1,3,6,0,0,6,6,0,0,23,1,4,12,7,0,3,1037872,2023-12-02T00:00:00.000Z,493,13,Ivica Zubac,3,19,20,13,8,27.9
9,0,5,7,2,14,7,5,5,35,0,4,21,5,1,1,1037872,2023-12-02T00:00:00.000Z,192,13,James Harden,1,26,35,30,14,42.5
7,0,8,5,2,16,9,0,0,39,0,2,20,8,1,3,1037872,2023-12-02T00:00:00.000Z,274,13,Kawhi Leonard,1,28,35,27,15,40.1
3,0,1,3,0,3,0,0,0,11,0,1,0,1,0,0,1037872,2023-12-02T00:00:00.000Z,56677849,13,Kobe Brown,0,1,4,3,4,5.7
0,0,0,0,0,0,0,0,0,0,0,0,0,0,0,0,1037872,2023-12-02T00:00:00.000Z,38017725,13,Moussa Diabate,0,0,0,0,0,0
0,0,0,0,0,0,0,0,0,0,0,0,0,0,0,0,1037872,2023-12-02T00:00:00.000Z,17896031,13,Nah'Shon Hyland,0,0,0,0,0,0
0,0,0,5,2,12,5,0,0,29,1,1,12,1,0,2,1037872,2023-12-02T00:00:00.000Z,380,13,Norman Powell,0,13,13,12,1,11.2
6,0,6,8,4,17,8,5,5,38,0,5,25,6,1,1,1037872,2023-12-02T00:00:00.000Z,172,13,Paul George,1,31,37,31,12,43.2
0,0,0,0,0,0,0,0,0,0,0,0,0,0,0,0,1037872,2023-12-02T00:00:00.000Z,450,13,PJ Tucker,0,0,0,0,0,0
2,1,6,4,2,5,2,4,2,19,0,0,8,6,0,0,1037872,2023-12-02T00:00:00.000Z,472,13,Russell Westbrook,1,14,16,10,8,21.2
2,0,1,5,1,6,1,0,0,24,1,1,3,2,1,0,1037872,2023-12-02T00:00:00.000Z,666743,13,Terance Mann,1,5,7,5,4,11.4
0,0,0,0,0,0,0,0,0,0,0,0,0,0,0,0,1037872,2023-12-02T00:00:00.000Z,24417679,13,Xavier Moon,0,0,0,0,0,0
0,0,0,0,0,0,0,0,0,0,0,0,0,0,0,0,1037873,2023-12-02T00:00:00.000Z,56677848,4,Amari Bailey,0,0,0,0,0,0
3,2,4,4,2,13,5,2,2,36,1,3,14,5,0,2,1037873,2023-12-02T00:00:00.000Z,56677823,4,Brandon Miller,2,19,22,17,8,28.5
1,0,1,0,0,4,1,0,0,16,0,1,2,1,0,0,1037873,2023-12-02T00:00:00.000Z,38017708,4,Bryce McGowens,0,3,4,3,2,4.7
0,0,0,0,0,0,0,0,0,0,0,0,0,0,0,0,1037873,2023-12-02T00:00:00.000Z,666748,4,Cody Martin,0,0,0,0,0,0
0,0,0,0,0,0,0,0,0,0,0,0,0,0,0,0,1037873,2023-12-02T00:00:00.000Z,347,4,Frank Ntilikina,0,0,0,0,0,0
5,0,3,0,0,3,3,0,0,16,1,0,6,4,0,0,1037873,2023-12-02T00:00:00.000Z,422,4,Ish Smith,0,10,15,11,9,18.3
0,0,0,0,0,0,0,0,0,0,0,0,0,0,0,0,1037873,2023-12-02T00:00:00.000Z,17896037,4,James Bouknight,0,0,0,0,0,0
0,0,0,0,0,0,0,0,0,0,0,0,0,0,0,0,1037873,2023-12-02T00:00:00.000Z,18678001,4,JT Thor,0,0,0,0,0,0
0,0,0,0,0,0,0,0,0,0,0,0,0,0,0,0,1037873,2023-12-02T00:00:00.000Z,3547239,4,LaMelo Ball,0,0,0,0,0,0
0,0,0,0,0,0,0,0,0,0,0,0,0,0,0,0,1037873,2023-12-02T00:00:00.000Z,56677866,4,Leaky Black,0,0,0,0,0,0
0,0,4,0,0,6,4,4,3,29,2,6,11,6,0,1,1037873,2023-12-02T00:00:00.000Z,38017698,4,Mark Williams,0,17,17,11,6,17.2
4,0,2,5,2,18,8,4,4,36,1,5,22,3,1,1,1037873,2023-12-02T00:00:00.000Z,62,4,Miles Bridges,1,25,29,26,7,33.6
1,1,2,0,0,3,1,2,2,9,1,1,4,3,1,0,1037873,2023-12-02T00:00:00.000Z,3547282,4,Nick Richards,2,7,8,5,4,15.1
0,0,0,0,0,0,0,0,0,0,0,0,0,0,0,0,1037873,2023-12-02T00:00:00.000Z,56677846,4,Nick Smith Jr.,0,0,0,0,0,0
5,1,4,7,4,14,7,0,0,31,3,1,18,7,0,1,1037873,2023-12-02T00:00:00.000Z,666950,4,P.J. Washington,1,25,30,23,12,35.9
7,0,5,7,3,20,8,5,4,36,1,4,23,6,2,1,1037873,2023-12-02T00:00:00.000Z,403,4,Terry Rozier,2,29,36,30,13,45.7
0,0,0,0,0,0,0,0,0,0,0,0,0,0,0,0,1037873,2023-12-02T00:00:00.000Z,3547253,4,Theo Maledon,0,0,0,0,0,0
0,0,0,0,0,0,0,0,0,0,0,0,0,0,0,0,1037873,2023-12-02T00:00:00.000Z,3547238,18,Anthony Edwards,0,0,0,0,0,0
0,0,0,0,0,0,0,0,0,0,0,0,0,0,0,0,1037873,2023-12-02T00:00:00.000Z,17895968,18,Daishen Nix,0,0,0,0,0,0
0,0,0,0,0,0,0,0,0,0,0,0,0,0,0,0,1037873,2023-12-02T00:00:00.000Z,3547259,18,Jaden McDaniels,0,0,0,0,0,0
0,0,0,0,0,0,0,0,0,0,0,0,0,0,0,0,1037873,2023-12-02T00:00:00.000Z,56677851,18,Jaylen Clark,0,0,0,0,0,0
0,0,0,0,0,0,0,0,0,0,0,0,0,0,0,0,1037873,2023-12-02T00:00:00.000Z,666767,18,Jordan McLaughlin,0,0,0,0,0,0
0,0,0,0,0,0,0,0,0,0,0,0,0,0,0,0,1037873,2023-12-02T00:00:00.000Z,38017715,18,Josh Minott,0,0,0,0,0,0
5,1,4,8,4,23,12,0,0,32,3,3,28,7,0,3,1037873,2023-12-02T00:00:00.000Z,447,18,Karl-Anthony Towns,1,35,40,33,12,43.9
4,0,4,0,0,6,2,7,7,26,2,3,11,6,2,2,1037873,2023-12-02T00:00:00.000Z,12,18,Kyle Anderson,2,17,21,15,10,28.2
0,0,0,0,0,0,0,0,0,0,0,0,0,0,0,0,1037873,2023-12-02T00:00:00.000Z,56677782,18,Leonard Miller,0,0,0,0,0,0
0,0,0,0,0,0,0,0,0,0,0,0,0,0,0,0,1037873,2023-12-02T00:00:00.000Z,17896056,18,Luka Garza,0,0,0,0,0,0
10,0,5,7,1,9,3,8,7,34,0,2,14,5,0,1,1037873,2023-12-02T00:00:00.000Z,104,18,Mike Conley,0,19,29,24,15,34
2,0,3,6,3,14,9,2,2,24,2,0,23,5,1,2,1037873,2023-12-02T00:00:00.000Z,667378,18,Naz Reid,1,28,30,25,7,33
2,0,2,2,0,5,2,2,2,30,0,1,6,2,0,1,1037873,2023-12-02T00:00:00.000Z,666400,18,Nickeil Alexander-Walker,0,8,10,8,4,10.4
0,3,10,0,0,12,10,9,6,39,2,1,26,12,0,1,1037873,2023-12-02T00:00:00.000Z,176,18,Rudy Gobert,3,38,38,26,12,48.4
2,0,1,2,0,8,2,2,2,23,0,2,6,1,1,0,1037873,2023-12-02T00:00:00.000Z,320,18,Shake Milton,1,7,9,8,3,13.2
1,0,2,6,3,7,3,0,0,32,1,4,9,3,1,1,1037873,2023-12-02T00:00:00.000Z,68,18,Troy Brown Jr.,1,12,13,10,4,16.1
0,0,0,0,0,0,0,0,0,0,0,0,0,0,0,0,1037873,2023-12-02T00:00:00.000Z,38017700,18,Wendell Moore Jr.,0,0,0,0,0,0
0,0,0,0,0,0,0,0,0,0,0,0,0,0,0,0,1037874,2023-12-02T00:00:00.000Z,9051997,3,Armoni Brooks,0,0,0,0,0,0
0,0,0,0,0,0,0,0,0,0,0,0,0,0,0,0,1037874,2023-12-02T00:00:00.000Z,417,3,Ben Simmons,0,0,0,0,0,0
5,0,7,9,4,23,7,2,2,38,0,3,20,7,0,2,1037874,2023-12-02T00:00:00.000Z,17896048,3,Cam Thomas,0,27,32,25,12,33.9
3,0,4,6,3,10,5,2,1,30,3,2,14,7,0,0,1037874,2023-12-02T00:00:00.000Z,666679,3,Cameron Johnson,0,21,24,17,10,26.9
2,1,5,0,0,2,2,3,1,24,1,3,5,6,0,1,1037874,2023-12-02T00:00:00.000Z,17896038,3,Day'Ron Sharpe,1,11,13,7,8,17.2
6,1,10,3,0,10,5,1,0,21,1,0,10,11,2,1,1037874,2023-12-02T00:00:00.000Z,421,3,Dennis Smith Jr.,3,21,27,16,17,40.2
0,0,0,0,0,0,0,0,0,0,0,0,0,0,0,0,1037874,2023-12-02T00:00:00.000Z,158,3,Dorian Finney-Smith,0,0,0,0,0,0
0,0,0,0,0,0,0,0,0,0,0,0,0,0,0,0,1037874,2023-12-02T00:00:00.000Z,174,3,Harry Giles III,0,0,0,0,0,0
0,0,0,0,0,0,0,0,0,0,0,0,0,0,0,0,1037874,2023-12-02T00:00:00.000Z,56677722,3,Jalen Wilson,0,0,0,0,0,0
0,0,0,0,0,0,0,0,0,0,0,0,0,0,0,0,1037874,2023-12-02T00:00:00.000Z,17896041,3,Keon Johnson,0,0,0,0,0,0
0,0,0,0,0,0,0,0,0,0,0,0,0,0,0,0,1037874,2023-12-02T00:00:00.000Z,464,3,Lonnie Walker IV,0,0,0,0,0,0
3,3,4,6,3,20,12,18,15,35,1,3,42,5,1,3,1037874,2023-12-02T00:00:00.000Z,61,3,Mikal Bridges,4,47,50,45,8,61.5
1,1,3,0,0,4,3,0,0,24,4,4,6,7,0,1,1037874,2023-12-02T00:00:00.000Z,666508,3,Nicolas Claxton,1,13,14,7,8,17.9
7,0,5,3,1,3,1,0,0,26,1,3,3,6,1,0,1037874,2023-12-02T00:00:00.000Z,351,3,Royce O'Neale,1,9,16,10,13,23.7
3,0,4,7,3,15,8,4,3,35,0,2,22,4,0,2,1037874,2023-12-02T00:00:00.000Z,130,3,Spencer Dinwiddie,0,26,29,25,7,29.3
1,1,1,0,0,4,3,1,1,7,3,1,7,4,0,1,1037874,2023-12-02T00:00:00.000Z,17896058,3,Trendon Watford,1,11,12,8,5,15.3
1,0,1,2,0,2,0,0,0,4,0,0,0,1,0,0,1037874,2023-12-02T00:00:00.000Z,666885,22,Admiral Schofield,0,1,2,1,2,2.7
1,0,3,0,0,1,1,0,0,19,0,3,2,3,0,0,1037874,2023-12-02T00:00:00.000Z,56677827,22,Anthony Black,0,5,6,3,4,7.1
0,0,0,3,1,3,1,0,0,16,0,1,3,0,0,0,1037874,2023-12-02T00:00:00.000Z,38017724,22,Caleb Houstan,0,3,3,3,0,3
0,0,0,2,0,2,0,0,0,4,0,0,0,0,0,1,1037874,2023-12-02T00:00:00.000Z,666818,22,Chuma Okeke,0,0,0,0,0,-1
1,1,5,6,2,16,8,2,2,31,0,3,20,5,0,1,1037874,2023-12-02T00:00:00.000Z,3547251,22,Cole Anthony,1,25,26,21,6,29.5
5,1,6,3,2,16,6,6,6,34,1,5,20,7,0,1,1037874,2023-12-02T00:00:00.000Z,17896026,22,Franz Wagner,1,27,32,25,12,37.9
2,0,1,5,0,8,2,0,0,21,0,1,4,1,0,0,1037874,2023-12-02T00:00:00.000Z,196,22,Gary Harris,0,5,7,6,3,8.2
0,1,2,0,0,6,1,2,1,15,3,2,3,5,0,0,1037874,2023-12-02T00:00:00.000Z,666442,22,Goga Bitadze,1,8,8,3,5,12
2,1,0,3,1,7,3,0,0,23,0,5,7,0,1,4,1037874,2023-12-02T00:00:00.000Z,17896073,22,Jalen Suggs,2,7,9,9,2,12
0,0,0,0,0,0,0,0,0,0,0,0,0,0,0,0,1037874,2023-12-02T00:00:00.000Z,56677839,22,Jett Howard,0,0,0,0,0,0
2,0,1,1,1,2,1,3,2,17,1,2,5,2,1,1,1037874,2023-12-02T00:00:00.000Z,226,22,Joe Ingles,1,7,9,7,4,12.4
0,0,0,0,0,0,0,0,0,0,0,0,0,0,0,0,1037874,2023-12-02T00:00:00.000Z,229,22,Jonathan Isaac,0,0,0,0,0,0
0,0,0,0,0,0,0,0,0,0,0,0,0,0,0,0,1037874,2023-12-02T00:00:00.000Z,38017607,22,Kevon Harris,0,0,0,0,0,0
0,0,0,0,0,0,0,0,0,0,0,0,0,0,0,0,1037874,2023-12-02T00:00:00.000Z,165,22,Markelle Fultz,0,0,0,0,0,0
2,1,1,2,2,9,6,5,4,22,1,2,18,2,0,2,1037874,2023-12-02T00:00:00.000Z,462,22,Moritz Wagner,1,20,22,20,4,24.4
8,0,9,2,0,15,6,9,7,34,1,3,19,10,1,1,1037874,2023-12-02T00:00:00.000Z,38017683,22,Paolo Banchero,1,29,37,27,18,45
0,0,0,0,0,0,0,0,0,0,0,0,0,0,0,0,1037874,2023-12-02T00:00:00.000Z,17553983,22,Trevelin Queen,0,0,0,0,0,0
0,0,0,0,0,0,0,0,0,0,0,0,0,0,0,0,1037874,2023-12-02T00:00:00.000Z,85,22,Wendell Carter Jr.,0,0,0,0,0,0
0,0,0,0,0,0,0,0,0,0,0,0,0,0,0,0,1037875,2023-12-02T00:00:00.000Z,277,6,Caris LeVert,0,0,0,0,0,0
0,0,0,0,0,0,0,0,0,4,0,1,0,0,0,0,1037875,2023-12-02T00:00:00.000Z,56677872,6,Craig Porter,0,0,0,0,0,0
0,0,0,0,0,0,0,0,0,0,0,0,0,0,0,0,1037875,2023-12-02T00:00:00.000Z,248,6,Damian Jones,0,0,0,0,0,0
6,1,1,7,2,23,9,3,2,34,0,1,22,1,3,2,1037875,2023-12-02T00:00:00.000Z,666581,6,Darius Garland,4,23,29,28,7,42.2
0,0,0,0,0,0,0,0,0,0,0,0,0,0,0,0,1037875,2023-12-02T00:00:00.000Z,666940,6,Dean Wade,0,0,0,0,0,0
4,0,2,5,2,19,7,5,4,33,1,2,20,3,2,4,1037875,2023-12-02T00:00:00.000Z,322,6,Donovan Mitchell,2,23,27,24,7,31.6
0,0,0,0,0,0,0,0,0,0,0,0,0,0,0,0,1037875,2023-12-02T00:00:00.000Z,56677847,6,Emoni Bates,0,0,0,0,0,0
1,0,9,0,0,5,2,3,2,36,1,3,6,10,0,2,1037875,2023-12-02T00:00:00.000Z,17896076,6,Evan Mobley,0,16,17,7,11,17.5
2,0,3,4,1,8,5,2,1,22,0,1,12,3,0,0,1037875,2023-12-02T00:00:00.000Z,344,6,Georges Niang,0,15,17,14,5,18.6
4,0,7,3,1,6,4,0,0,33,0,3,9,7,4,1,1037875,2023-12-02T00:00:00.000Z,3547247,6,Isaac Okoro,4,16,20,13,11,34.4
1,0,7,0,0,9,8,5,3,34,5,2,19,12,1,2,1037875,2023-12-02T00:00:00.000Z,9,6,Jarrett Allen,1,31,32,20,13,35.9
5,0,5,10,4,16,9,0,0,38,0,4,22,5,1,1,1037875,2023-12-02T00:00:00.000Z,666908,6,Max Strus,1,27,32,27,10,37.5
0,0,0,0,0,0,0,0,0,0,0,0,0,0,0,0,1037875,2023-12-02T00:00:00.000Z,404,6,Ricky Rubio,0,0,0,0,0,0
1,0,0,1,0,1,0,0,0,3,0,1,0,0,0,0,1037875,2023-12-02T00:00:00.000Z,3547299,6,Sam Merrill,0,0,1,1,1,1.5
0,0,1,0,0,1,0,0,0,3,1,0,0,2,0,0,1037875,2023-12-02T00:00:00.000Z,444,6,Tristan Thompson,0,2,2,0,2,2.4
0,0,0,0,0,0,0,0,0,0,0,0,0,0,0,0,1037875,2023-12-02T00:00:00.000Z,666676,6,Ty Jerome,0,0,0,0,0,0
0,0,0,0,0,0,0,0,0,0,0,0,0,0,0,0,1037875,2023-12-02T00:00:00.000Z,77,9,Alec Burks,0,0,0,0,0,0
0,0,4,2,0,6,2,0,0,16,3,5,4,7,0,2,1037875,2023-12-02T00:00:00.000Z,56677826,9,Ausar Thompson,0,11,11,4,7,10.4
2,0,1,9,3,15,7,6,5,28,1,1,22,2,1,1,1037875,2023-12-02T00:00:00.000Z,54,9,Bojan Bogdanovic,1,24,26,24,4,29.4
11,0,8,6,3,20,8,4,4,37,0,3,23,8,3,1,1037875,2023-12-02T00:00:00.000Z,17896075,9,Cade Cunningham,3,31,42,34,19,57.1
0,0,0,1,0,1,0,0,0,14,0,1,0,0,0,2,1037875,2023-12-02T00:00:00.000Z,17896071,9,Isaiah Livers,0,0,0,0,0,-2
5,0,6,5,1,9,4,2,2,30,1,0,11,7,2,3,1037875,2023-12-02T00:00:00.000Z,3547267,9,Isaiah Stewart,2,18,23,16,12,29.9
1,0,2,3,0,7,2,4,3,29,0,3,7,2,0,1,1037875,2023-12-02T00:00:00.000Z,38017682,9,Jaden Ivey,0,9,10,8,3,9.9
1,2,7,0,0,8,8,6,1,30,4,3,17,11,1,2,1037875,2023-12-02T00:00:00.000Z,38017694,9,Jalen Duren,3,28,29,18,12,38.7
0,0,0,0,0,0,0,0,0,0,0,0,0,0,0,0,1037875,2023-12-02T00:00:00.000Z,3547240,9,James Wiseman,0,0,0,0,0,0
0,0,0,0,0,0,0,0,0,0,0,0,0,0,0,0,1037875,2023-12-02T00:00:00.000Z,42097199,9,Jared Rhoden,0,0,0,0,0,0
0,0,0,0,0,0,0,0,0,0,0,0,0,0,0,0,1037875,2023-12-02T00:00:00.000Z,197,9,Joe Harris,0,0,0,0,0,0
3,0,6,1,1,11,6,1,0,33,0,2,13,6,2,2,1037875,2023-12-02T00:00:00.000Z,3547241,9,Killian Hayes,2,19,22,16,9,28.7
0,0,0,0,0,0,0,0,0,0,0,0,0,0,0,0,1037875,2023-12-02T00:00:00.000Z,56677729,9,Malcolm Cazalon,0,0,0,0,0,0
1,0,2,2,0,5,2,0,0,16,0,1,4,2,0,2,1037875,2023-12-02T00:00:00.000Z,56677792,9,Marcus Sasser,0,6,7,5,3,5.9
0,0,2,0,0,1,0,0,0,7,1,1,0,3,1,0,1037875,2023-12-02T00:00:00.000Z,24,9,Marvin Bagley III,1,3,3,0,3,6.6
0,0,0,0,0,0,0,0,0,0,0,0,0,0,0,0,1037875,2023-12-02T00:00:00.000Z,330,9,Monte Morris,0,0,0,0,0,0
0,0,0,0,0,0,0,0,0,0,0,0,0,0,0,0,1037875,2023-12-02T00:00:00.000Z,44477024,9,Stanley Umude,0,0,0,0,0,0
1,1,4,6,4,9,7,4,2,29,0,4,20,4,0,0,1037876,2023-12-02T00:00:00.000Z,3547250,12,Aaron Nesmith,1,24,25,21,5,29.3
11,0,1,4,0,9,1,2,2,23,0,1,4,1,1,0,1037876,2023-12-02T00:00:00.000Z,38017507,12,Andrew Nembhard,1,5,16,15,12,24.7
0,0,0,0,0,0,0,0,0,4,0,2,0,0,0,0,1037876,2023-12-02T00:00:00.000Z,56677861,12,Ben Sheppard,0,0,0,0,0,0
4,0,4,3,2,10,6,3,2,25,1,4,16,5,0,4,1037876,2023-12-02T00:00:00.000Z,38017686,12,Bennedict Mathurin,0,21,25,20,9,24
2,0,4,6,4,16,11,5,4,37,0,0,30,4,0,1,1037876,2023-12-02T00:00:00.000Z,69,12,Bruce Brown,0,34,36,32,6,36.8
1,1,3,0,0,3,3,2,2,8,0,1,8,3,0,0,1037876,2023-12-02T00:00:00.000Z,17896035,12,Isaiah Jackson,1,11,12,9,4,16.1
0,0,0,0,0,0,0,0,0,0,0,0,0,0,0,0,1037876,2023-12-02T00:00:00.000Z,56677794,12,Isaiah Wong,0,0,0,0,0,0
0,0,0,0,0,0,0,0,0,0,0,0,0,0,0,0,1037876,2023-12-02T00:00:00.000Z,3547264,12,Jalen Smith,0,0,0,0,0,0
0,0,0,0,0,0,0,0,0,0,0,0,0,0,0,0,1037876,2023-12-02T00:00:00.000Z,56677832,12,Jarace Walker,0,0,0,0,0,0
0,0,0,0,0,0,0,0,0,0,0,0,0,0,0,0,1037876,2023-12-02T00:00:00.000Z,38017701,12,Kendall Brown,0,0,0,0,0,0
1,2,8,4,1,12,8,0,0,30,2,4,17,10,0,2,1037876,2023-12-02T00:00:00.000Z,452,12,Myles Turner,2,27,28,18,11,34.5
2,4,2,5,4,8,7,4,4,35,0,5,22,2,1,0,1037876,2023-12-02T00:00:00.000Z,3547243,12,Obi Toppin,5,24,26,24,4,42.4
0,0,0,0,0,0,0,0,0,0,0,0,0,0,0,0,1037876,2023-12-02T00:00:00.000Z,56677778,12,Oscar Tshiebwe,0,0,0,0,0,0
11,0,2,0,0,11,10,0,0,25,0,0,20,2,0,1,1037876,2023-12-02T00:00:00.000Z,304,12,T.J. McConnell,0,22,33,31,13,37.9
0,0,0,0,0,0,0,0,0,0,0,0,0,0,0,0,1037876,2023-12-02T00:00:00.000Z,3547245,12,Tyrese Haliburton,0,0,0,0,0,0
0,0,0,0,0,0,0,0,0,0,0,0,0,0,0,0,1037876,2023-12-02T00:00:00.000Z,4,16,Bam Adebayo,0,0,0,0,0,0
3,0,1,4,2,15,8,0,0,35,1,3,18,2,1,3,1037876,2023-12-02T00:00:00.000Z,666747,16,Caleb Martin,1,20,23,21,5,24.9
0,0,0,0,0,0,0,0,0,0,0,0,0,0,0,0,1037876,2023-12-02T00:00:00.000Z,19465585,16,Dru Smith,0,0,0,0,0,0
3,0,1,3,2,11,7,1,1,30,1,6,17,2,0,2,1037876,2023-12-02T00:00:00.000Z,397,16,Duncan Robinson,0,19,22,20,5,21.9
3,0,3,2,1,9,4,5,2,29,0,1,11,3,2,0,1037876,2023-12-02T00:00:00.000Z,56677785,16,Jaime Jaquez Jr.,2,14,17,14,6,25.1
0,0,0,0,0,0,0,0,0,5,0,2,0,0,0,0,1037876,2023-12-02T00:00:00.000Z,38017734,16,Jamal Cain,0,0,0,0,0,0
3,1,2,4,2,9,6,2,2,24,0,1,16,2,0,2,1037876,2023-12-02T00:00:00.000Z,391,16,Josh Richardson,1,18,21,19,5,23.9
5,0,1,5,3,6,4,3,3,19,0,4,14,1,0,0,1037876,2023-12-02T00:00:00.000Z,285,16,Kevin Love,0,15,20,19,6,22.7
2,0,7,3,0,4,0,4,4,29,1,2,4,8,0,0,1037876,2023-12-02T00:00:00.000Z,286,16,Kyle Lowry,0,12,14,6,10,16.6
0,0,0,0,0,0,0,0,0,0,0,0,0,0,0,0,1037876,2023-12-02T00:00:00.000Z,38017696,16,Nikola Jovic,0,0,0,0,0,0
3,0,4,2,2,11,7,0,0,29,1,1,16,5,0,1,1037876,2023-12-02T00:00:00.000Z,39398582,16,Orlando Robinson,0,21,24,19,8,25.5
0,0,0,0,0,0,0,0,0,0,0,0,0,0,0,0,1037876,2023-12-02T00:00:00.000Z,3547257,16,R.J. Hampton,0,0,0,0,0,0
0,0,0,0,0,0,0,0,0,0,0,0,0,0,0,0,1037876,2023-12-02T00:00:00.000Z,74,16,Thomas Bryant,0,0,0,0,0,0
0,0,0,0,0,0,0,0,0,0,0,0,0,0,0,0,1037876,2023-12-02T00:00:00.000Z,666633,16,Tyler Herro,0,0,0,0,0,0
1,1,5,0,0,7,3,2,1,15,3,2,7,8,0,1,1037877,2023-12-02T00:00:00.000Z,137,5,Andre Drummond,1,15,16,8,9,20.1
3,0,0,4,1,9,6,2,2,33,0,2,15,0,2,2,1037877,2023-12-02T00:00:00.000Z,17895983,5,Ayo Dosunmu,2,15,18,18,3,23.5
6,0,7,13,8,17,10,3,3,40,2,4,31,9,1,3,1037877,2023-12-02T00:00:00.000Z,666956,5,Coby White,1,40,46,37,15,50.8
2,0,0,1,0,2,1,0,0,15,0,1,2,0,0,1,1037877,2023-12-02T00:00:00.000Z,87,5,Jevon Carter,0,2,4,4,2,4
2,1,3,4,3,6,5,2,2,19,3,3,15,6,0,1,1037877,2023-12-02T00:00:00.000Z,110,5,Torrey Craig,1,21,23,17,8,27.2
0,0,0,0,0,0,0,0,0,0,0,0,0,0,0,0,1037877,2023-12-02T00:00:00.000Z,303,19,CJ McCollum,0,0,0,0,0,0
0,0,1,0,0,4,1,2,2,12,3,2,4,4,0,0,1037877,2023-12-02T00:00:00.000Z,491,19,Cody Zeller,0,8,8,4,4,8.8
0,0,0,0,0,0,0,0,0,1,0,0,0,0,0,0,1037877,2023-12-02T00:00:00.000Z,17896021,19,Jeremiah Robinson-Earl,0,0,0,0,0,0
2,0,1,4,1,7,2,2,2,26,2,3,7,3,1,1,1037877,2023-12-02T00:00:00.000Z,3547293,19,Naji Marshall,1,10,12,9,5,15.6
0,1,3,7,2,18,6,0,0,25,0,2,14,3,2,0,1037878,2023-12-02T00:00:00.000Z,53,1,Bogdan Bogdanovic,3,17,17,14,3,26.6
0,0,1,2,0,10,3,6,6,31,0,2,12,1,2,2,1037878,2023-12-02T00:00:00.000Z,666656,1,De'Andre Hunter,2,13,13,12,1,17.2
0,0,0,0,0,0,0,0,0,8,1,1,0,1,0,1,1037878,2023-12-02T00:00:00.000Z,666754,1,Garrison Mathews,0,1,1,0,1,0.2
0,0,0,0,0,0,0,0,0,0,0,0,0,0,0,0,1037878,2023-12-02T00:00:00.000Z,17896040,1,Jalen Johnson,0,0,0,0,0,0
0,0,0,0,0,0,0,0,0,0,0,0,0,0,0,0,1037878,2023-12-02T00:00:00.000Z,56677838,1,Kobe Bufkin,0,0,0,0,0,0
0,0,0,0,0,0,0,0,0,0,0,0,0,0,0,0,1037878,2023-12-02T00:00:00.000Z,56677875,1,Miles Norris,0,0,0,0,0,0
0,0,0,0,0,0,0,0,0,0,0,0,0,0,0,0,1037878,2023-12-02T00:00:00.000Z,56677806,1,Mouhamed Gueye,0,0,0,0,0,0
3,0,3,2,0,4,2,3,1,27,1,3,5,4,0,0,1037878,2023-12-02T00:00:00.000Z,3547244,1,Onyeka Okongwu,0,9,12,8,7,14.3
0,0,0,0,0,0,0,0,0,0,0,0,0,0,0,0,1037878,2023-12-02T00:00:00.000Z,319,1,Patty Mills,0,0,0,0,0,0
0,0,0,0,0,0,0,0,0,0,0,0,0,0,0,0,1037878,2023-12-02T00:00:00.000Z,56677855,1,Seth Lundy,0,0,0,0,0,0
12,0,0,13,5,28,13,2,1,37,2,0,32,2,2,4,1037878,2023-12-02T00:00:00.000Z,490,1,Trae Young,2,34,46,44,14,54.4
0,0,1,2,0,2,0,2,1,12,0,0,1,1,2,0,1037878,2023-12-02T00:00:00.000Z,301,1,Wesley Matthews,2,2,2,1,1,8.2
0,0,0,0,0,0,0,0,0,9,1,1,0,1,0,0,1037878,2023-12-02T00:00:00.000Z,38017733,17,A.J. Green,0,1,1,0,1,1.2
2,0,3,6,2,11,7,2,2,20,0,5,18,3,0,1,1037878,2023-12-02T00:00:00.000Z,368,17,Cameron Payne,0,21,23,20,5,23.6
0,0,0,0,0,0,0,0,0,0,0,0,0,0,0,0,1037878,2023-12-02T00:00:00.000Z,56677854,17,Chris Livingston,0,0,0,0,0,0
0,0,0,0,0,0,0,0,0,0,0,0,0,0,0,0,1037878,2023-12-02T00:00:00.000Z,666453,17,Marques Bolden,0,0,0,0,0,0
0,0,0,0,0,0,0,0,0,0,0,0,0,0,0,0,1037878,2023-12-02T00:00:00.000Z,284,17,Robin Lopez,0,0,0,0,0,0
0,0,0,0,0,0,0,0,0,0,0,0,0,0,0,0,1037878,2023-12-02T00:00:00.000Z,2148,17,Thanasis Antetokounmpo,0,0,0,0,0,0
0,0,0,0,0,0,0,0,0,0,0,0,0,0,0,0,1037879,2023-12-02T00:00:00.000Z,151,7,Dante Exum,0,0,0,0,0,0
0,0,0,0,0,0,0,0,0,0,0,0,0,0,0,0,1037879,2023-12-02T00:00:00.000Z,3547258,7,Josh Green,0,0,0,0,0,0
0,0,0,0,0,0,0,0,0,0,0,0,0,0,0,0,1037879,2023-12-02T00:00:00.000Z,228,7,Kyrie Irving,0,0,0,0,0,0
0,0,0,0,0,0,0,0,0,0,0,0,0,0,0,0,1037879,2023-12-02T00:00:00.000Z,257,7,Maxi Kleber,0,0,0,0,0,0
1,0,0,1,0,2,0,2,2,14,1,2,2,1,0,0,1037879,2023-12-02T00:00:00.000Z,56677859,7,Olivier-Maxence Prosper,0,3,4,3,2,4.7
0,0,0,0,0,0,0,0,0,0,0,0,0,0,0,0,1037879,2023-12-02T00:00:00.000Z,191,7,Tim Hardaway Jr.,0,0,0,0,0,0
1,0,1,3,3,3,3,6,6,11,0,3,15,1,1,0,1037879,2023-12-02T00:00:00.000Z,44,21,Davis Bertans,1,16,17,16,2,20.7
2,0,6,5,2,6,2,0,0,25,1,1,6,7,0,0,1037879,2023-12-02T00:00:00.000Z,3547272,21,Isaiah Joe,0,13,15,8,9,17.4
3,0,4,6,1,13,4,2,1,32,1,4,10,5,0,2,1037879,2023-12-02T00:00:00.000Z,666541,21,Luguentz Dort,0,15,18,13,8,18.5
0,0,0,0,0,0,0,0,0,0,0,0,0,0,0,0,1037880,2023-12-02T00:00:00.000Z,666505,15,Brandon Clarke,0,0,0,0,0,0
0,0,0,0,0,0,0,0,0,0,0,0,0,0,0,0,1037880,2023-12-02T00:00:00.000Z,56677830,15,GG Jackson,0,0,0,0,0,0
0,0,0,0,0,0,0,0,0,0,0,0,0,0,0,0,1037880,2023-12-02T00:00:00.000Z,48248287,15,Jacob Gilyard,0,0,0,0,0,0
0,0,0,0,0,0,0,0,0,0,0,0,0,0,0,0,1037880,2023-12-02T00:00:00.000Z,38017728,15,Jake LaRavia,0,0,0,0,0,0
0,0,0,0,0,0,0,0,0,0,0,0,0,0,0,0,1037880,2023-12-02T00:00:00.000Z,38017732,15,Kenneth Lofton Jr.,0,0,0,0,0,0
0,0,0,0,0,0,0,0,0,0,0,0,0,0,0,0,1037880,2023-12-02T00:00:00.000Z,254,15,Luke Kennard,0,0,0,0,0,0
0,0,0,0,0,0,0,0,0,0,0,0,0,0,0,0,1037880,2023-12-02T00:00:00.000Z,199,15,Shaquille Harrison,0,0,0,0,0,0
0,0,0,0,0,0,0,0,0,0,0,0,0,0,0,0,1037880,2023-12-02T00:00:00.000Z,3,15,Steven Adams,0,0,0,0,0,0
0,0,0,0,0,0,0,0,0,0,0,0,0,0,0,0,1037880,2023-12-02T00:00:00.000Z,666451,24,Bol Bol,0,0,0,0,0,0
0,0,0,0,0,0,0,0,0,0,0,0,0,0,0,0,1037880,2023-12-02T00:00:00.000Z,37,24,Bradley Beal,0,0,0,0,0,0
0,0,0,0,0,0,0,0,0,0,0,0,0,0,0,0,1037880,2023-12-02T00:00:00.000Z,314,24,Chimezie Metu,0,0,0,0,0,0
1,2,2,0,0,5,2,2,2,18,1,3,6,3,0,1,1037880,2023-12-02T00:00:00.000Z,147,24,Drew Eubanks,2,9,10,7,4,16.1
0,0,0,0,0,0,0,0,0,0,0,0,0,0,0,0,1037880,2023-12-02T00:00:00.000Z,178,24,Eric Gordon,0,0,0,0,0,0
0,0,0,0,0,0,0,0,0,0,0,0,0,0,0,0,1037880,2023-12-02T00:00:00.000Z,3547095,24,Udoka Azubuike,0,0,0,0,0,0
0,0,1,2,1,2,1,2,1,15,1,3,4,2,1,2,1037880,2023-12-02T00:00:00.000Z,470,24,Yuta Watanabe,1,6,6,4,2,7.4
0,1,3,5,0,9,1,7,7,26,0,2,9,3,0,3,1037881,2023-12-02T00:00:00.000Z,182,25,Jerami Grant,1,12,12,9,3,12.6
0,1,1,3,0,8,4,0,0,30,2,4,8,3,4,0,1037881,2023-12-02T00:00:00.000Z,56677850,25,Toumani Camara,5,11,11,8,3,26.6
0,0,0,0,0,0,0,0,0,0,0,0,0,0,0,0,1037881,2023-12-02T00:00:00.000Z,56677842,29,Brice Sensabaugh,0,0,0,0,0,0
5,0,3,2,0,13,9,7,7,30,1,2,25,4,0,3,1037881,2023-12-02T00:00:00.000Z,413,29,Collin Sexton,0,29,34,30,9,34.3
3,3,7,4,1,14,6,6,5,35,2,2,18,9,1,2,1037881,2023-12-02T00:00:00.000Z,101,29,John Collins,4,27,30,21,12,43.3
0,0,0,0,0,0,0,0,0,0,0,0,0,0,0,0,1037881,2023-12-02T00:00:00.000Z,38017630,29,Johnny Juzang,0,0,0,0,0,0
0,0,0,0,0,0,0,0,0,0,0,0,0,0,0,0,1037881,2023-12-02T00:00:00.000Z,100,29,Jordan Clarkson,0,0,0,0,0,0
0,0,0,0,0,0,0,0,0,0,0,0,0,0,0,0,1037881,2023-12-02T00:00:00.000Z,17896023,29,Josh Christopher,0,0,0,0,0,0
0,0,0,0,0,0,0,0,0,0,0,0,0,0,0,0,1037881,2023-12-02T00:00:00.000Z,358,29,Kelly Olynyk,0,0,0,0,0,0
6,0,4,8,1,17,7,8,5,36,2,2,20,6,0,4,1037881,2023-12-02T00:00:00.000Z,56677834,29,Keyonte George,0,26,32,26,12,32.2
0,0,0,0,0,0,0,0,0,0,0,0,0,0,0,0,1037881,2023-12-02T00:00:00.000Z,139,29,Kris Dunn,0,0,0,0,0,0
0,0,0,0,0,0,0,0,0,0,0,0,0,0,0,0,1037881,2023-12-02T00:00:00.000Z,297,29,Lauri Markkanen,0,0,0,0,0,0
0,1,2,2,0,5,1,0,0,12,1,3,2,3,0,0,1037881,2023-12-02T00:00:00.000Z,666881,29,Luka Samanic,1,5,5,2,3,8.6
0,0,0,0,0,0,0,0,0,0,0,0,0,0,0,0,1037881,2023-12-02T00:00:00.000Z,19465584,29,Micah Potter,0,0,0,0,0,0
0,0,2,0,0,4,3,0,0,26,0,2,6,2,0,2,1037881,2023-12-02T00:00:00.000Z,38017620,29,Ochai Agbaji,0,8,8,6,2,6.4
4,1,11,1,0,8,4,1,1,27,4,3,9,15,1,1,1037881,2023-12-02T00:00:00.000Z,11891374,29,Omer Yurtseven,2,24,28,13,19,38
5,1,4,8,1,12,3,0,0,35,1,2,7,5,0,2,1037881,2023-12-02T00:00:00.000Z,38017739,29,Simone Fontecchio,1,12,17,12,10,21.5
4,0,2,5,3,8,5,2,1,21,0,3,14,2,3,1,1037881,2023-12-02T00:00:00.000Z,666650,29,Talen Horton-Tucker,3,16,20,18,6,30.4
0,2,1,4,1,7,2,0,0,18,1,1,5,2,0,0,1037881,2023-12-02T00:00:00.000Z,56677824,29,Taylor Hendricks,2,7,7,5,2,13.4
0,2,4,0,0,6,6,0,0,25,4,1,12,8,0,2,1037881,2023-12-02T00:00:00.000Z,38017705,29,Walker Kessler,2,20,20,12,8,25.6
0,0,2,1,1,3,1,3,1,14,1,0,4,3,0,1,1037882,2023-12-02T00:00:00.000Z,4197162,26,Aleksandar Vezenkov,0,7,7,4,3,6.6
0,0,0,0,0,0,0,0,0,0,0,0,0,0,0,0,1037882,2023-12-02T00:00:00.000Z,17896030,26,Chris Duarte,0,0,0,0,0,0
0,0,0,0,0,0,0,0,0,0,0,0,0,0,0,0,1037882,2023-12-02T00:00:00.000Z,56677845,26,Colby Jones,0,0,0,0,0,0
16,1,3,6,3,22,10,4,3,38,1,1,26,4,3,1,1037882,2023-12-02T00:00:00.000Z,161,26,De'Aaron Fox,4,30,46,42,20,65.8
0,3,3,0,0,4,4,0,0,12,1,3,8,4,0,0,1037882,2023-12-02T00:00:00.000Z,306,26,JaVale McGee,3,12,12,8,4,21.8
2,0,0,1,0,1,0,0,0,8,0,1,0,0,0,0,1037882,2023-12-02T00:00:00.000Z,38017714,26,Keon Ellis,0,0,2,2,2,3
0,0,0,0,0,0,0,0,0,0,0,0,0,0,0,0,1037882,2023-12-02T00:00:00.000Z,17896044,26,Kessler Edwards,0,0,0,0,0,0
2,1,6,6,4,10,6,0,0,29,0,0,16,6,1,2,1037882,2023-12-02T00:00:00.000Z,221,26,Kevin Huerter,2,22,24,18,8,30.2
4,0,3,7,4,14,9,4,4,28,0,1,26,3,2,3,1037882,2023-12-02T00:00:00.000Z,324,26,Malik Monk,2,29,33,30,7,38.6
1,0,2,3,0,8,3,1,1,18,2,2,7,4,0,0,1037882,2023-12-02T00:00:00.000Z,290,26,Trey Lyles,0,11,12,8,5,13.3
3,0,0,2,1,6,5,0,0,14,1,2,11,1,0,0,1037883,2023-12-02T00:00:00.000Z,213,11,Aaron Holiday,0,12,15,14,4,16.7
5,2,10,8,3,25,8,2,2,34,3,2,21,13,2,0,1037883,2023-12-02T00:00:00.000Z,17896062,11,Alperen Sengun,4,34,39,26,18,56.1
0,0,0,0,0,0,0,0,0,0,0,0,0,0,0,0,1037883,2023-12-02T00:00:00.000Z,56677825,11,Amen Thompson,0,0,0,0,0,0
0,0,0,0,0,0,0,0,0,0,0,0,0,0,0,0,1037883,2023-12-02T00:00:00.000Z,296,11,Boban Marjanovic,0,0,0,0,0,0
1,0,2,0,0,2,1,6,3,3,1,0,5,3,0,0,1037883,2023-12-02T00:00:00.000Z,56677831,11,Cam Whitmore,0,8,9,6,4,10.1
1,0,1,4,2,9,4,0,0,33,1,4,10,2,0,1,1037883,2023-12-02T00:00:00.000Z,66,11,Dillon Brooks,0,12,13,11,3,12.9
7,0,4,7,4,15,7,4,4,40,1,1,22,5,0,3,1037883,2023-12-02T00:00:00.000Z,458,11,Fred VanVleet,0,27,34,29,12,35.5
3,3,8,3,0,7,4,2,2,30,1,5,10,9,2,3,1037883,2023-12-02T00:00:00.000Z,38017684,11,Jabari Smith Jr.,5,19,22,13,12,37.3
0,0,2,0,0,2,1,0,0,14,0,2,2,2,0,0,1037883,2023-12-02T00:00:00.000Z,3547301,11,Jae'Sean Tate,0,4,4,2,2,4.4
2,0,6,6,1,15,4,2,1,32,1,1,10,7,0,6,1037883,2023-12-02T00:00:00.000Z,17895966,11,Jalen Green,0,17,19,12,9,15.4
0,0,0,0,0,0,0,0,0,0,0,0,0,0,0,0,1037883,2023-12-02T00:00:00.000Z,47738533,11,Jeenathan Williams,0,0,0,0,0,0
0,0,1,0,0,2,0,0,0,11,0,3,0,1,0,2,1037883,2023-12-02T00:00:00.000Z,188,11,Jeff Green,0,1,1,0,1,-0.8
0,0,2,0,0,0,0,0,0,3,0,0,0,2,0,0,1037883,2023-12-02T00:00:00.000Z,56677809,11,Jermaine Samuels Jr.,0,2,2,0,2,2.4
0,1,0,0,0,0,0,0,0,3,0,0,0,0,0,0,1037883,2023-12-02T00:00:00.000Z,19465326,11,Jock Landale,1,0,0,0,0,3
0,0,2,0,0,1,0,0,0,3,0,1,0,2,0,0,1037883,2023-12-02T00:00:00.000Z,3547281,11,Nate Hinton,0,2,2,0,2,2.4
0,0,0,0,0,0,0,0,0,0,0,0,0,0,0,0,1037883,2023-12-02T00:00:00.000Z,75,11,Reggie Bullock,0,0,0,0,0,0
2,1,5,1,0,5,2,2,2,20,2,2,6,7,1,1,1037883,2023-12-02T00:00:00.000Z,38017695,11,Tari Eason,2,13,15,8,9,22.4
0,0,0,0,0,0,0,0,0,0,0,0,0,0,0,0,1037883,2023-12-02T00:00:00.000Z,357,11,Victor Oladipo,0,0,0,0,0,0
3,5,8,0,0,22,10,9,7,37,6,2,27,14,0,1,1037883,2023-12-02T00:00:00.000Z,117,14,Anthony Davis,5,41,44,30,17,62.3
1,1,4,1,0,7,4,3,3,25,1,3,11,5,0,0,1037883,2023-12-02T00:00:00.000Z,666860,14,Cameron Reddish,1,16,17,12,6,21.5
7,0,2,5,1,10,4,0,0,26,0,2,9,2,5,0,1037883,2023-12-02T00:00:00.000Z,405,14,D'Angelo Russell,5,11,18,16,9,36.9
0,0,0,0,0,0,0,0,0,0,0,0,0,0,0,0,1037883,2023-12-02T00:00:00.000Z,56677868,14,D'Moi Hodge,0,0,0,0,0,0
0,0,0,0,0,0,0,0,0,0,0,0,0,0,0,0,1037883,2023-12-02T00:00:00.000Z,1603383,14,Gabe Vincent,0,0,0,0,0,0
1,0,3,2,0,2,0,0,0,14,1,1,0,4,0,0,1037883,2023-12-02T00:00:00.000Z,457,14,Jarred Vanderbilt,0,4,5,1,5,6.3
7,1,4,4,0,17,7,5,2,35,0,0,16,4,1,5,1037883,2023-12-02T00:00:00.000Z,237,14,LeBron James,2,20,27,23,11,32.3
2,0,7,3,3,7,4,2,1,29,0,3,12,7,0,0,1037883,2023-12-02T00:00:00.000Z,38017697,14,Max Christie,0,19,21,14,9,23.4
1,0,6,5,3,7,4,0,0,29,0,0,11,6,2,1,1037883,2023-12-02T00:00:00.000Z,383,14,Taurean Prince,2,17,18,12,7,24.7
0,0,0,0,0,0,0,0,0,0,0,0,0,0,0,0,7045521,2023-12-04T00:00:00.000Z,56677864,2,Jordan Walsh,0,0,0,0,0,0
6,0,6,6,3,20,10,9,7,40,2,2,30,8,1,2,7045522,2023-12-04T00:00:00.000Z,227,19,Brandon Ingram,1,38,44,36,14,49.6
7,2,2,5,3,14,7,0,0,36,0,2,17,2,2,2,7045522,2023-12-04T00:00:00.000Z,303,19,CJ McCollum,4,19,26,24,9,39.9
0,0,0,0,0,0,0,0,0,5,0,0,0,0,1,0,7045522,2023-12-04T00:00:00.000Z,491,19,Cody Zeller,1,0,0,0,0,3
0,0,0,0,0,0,0,0,0,0,0,0,0,0,0,0,7045522,2023-12-04T00:00:00.000Z,38017726,19,Dereon Seabron,0,0,0,0,0,0
0,0,0,0,0,1,0,0,0,6,1,1,0,1,2,0,7045522,2023-12-04T00:00:00.000Z,38017677,19,Dyson Daniels,2,1,1,0,1,7.2
0,0,0,0,0,0,0,0,0,0,0,0,0,0,0,0,7045522,2023-12-04T00:00:00.000Z,38017663,19,E.J. Liddell,0,0,0,0,0,0
5,2,2,5,3,13,8,4,4,35,3,5,23,5,0,1,7045522,2023-12-04T00:00:00.000Z,17896024,19,Herbert Jones,2,28,33,28,10,41.5
0,0,0,0,0,0,0,0,0,0,0,0,0,0,0,0,7045522,2023-12-04T00:00:00.000Z,17896021,19,Jeremiah Robinson-Earl,0,0,0,0,0,0
0,0,7,0,0,11,7,4,4,29,4,6,18,11,0,1,7045522,2023-12-04T00:00:00.000Z,455,19,Jonas Valanciunas,0,29,29,18,11,30.2
0,0,0,0,0,0,0,0,0,0,0,0,0,0,0,0,7045522,2023-12-04T00:00:00.000Z,56677837,19,Jordan Hawkins,0,0,0,0,0,0
2,2,3,3,2,4,3,2,1,18,0,1,9,3,2,1,7045522,2023-12-04T00:00:00.000Z,17896097,19,Jose Alvarado,4,12,14,11,5,26.6
0,0,0,0,0,0,0,0,0,0,0,0,0,0,0,0,7045522,2023-12-04T00:00:00.000Z,3547260,19,Kira Lewis Jr.,0,0,0,0,0,0
0,0,0,0,0,0,0,0,0,0,0,0,0,0,0,0,7045522,2023-12-04T00:00:00.000Z,340,19,Larry Nance Jr.,0,0,0,0,0,0
0,0,0,0,0,0,0,0,0,0,0,0,0,0,0,0,7045522,2023-12-04T00:00:00.000Z,17896017,19,Matt Ryan,0,0,0,0,0,0
2,0,2,2,0,3,1,2,2,13,2,1,4,4,1,1,7045522,2023-12-04T00:00:00.000Z,3547293,19,Naji Marshall,1,8,10,6,6,13.8
1,1,2,8,3,13,6,2,1,30,0,1,16,2,0,0,7045522,2023-12-04T00:00:00.000Z,18677986,19,Trey Murphy III,1,18,19,17,3,22.9
6,0,5,2,0,8,5,0,0,28,1,3,10,6,3,4,7045522,2023-12-04T00:00:00.000Z,666969,19,Zion Williamson,3,16,22,16,12,31.2
0,0,0,1,0,3,0,0,0,6,2,2,0,2,0,0,7045522,2023-12-04T00:00:00.000Z,4197162,26,Aleksandar Vezenkov,0,2,2,0,2,2.4
0,0,0,0,0,0,0,0,0,0,0,0,0,0,0,0,7045522,2023-12-04T00:00:00.000Z,273,26,Alex Len,0,0,0,0,0,0
0,0,0,0,0,0,0,0,0,0,0,0,0,0,0,0,7045522,2023-12-04T00:00:00.000Z,17896030,26,Chris Duarte,0,0,0,0,0,0
0,0,0,0,0,0,0,0,0,0,0,0,0,0,0,0,7045522,2023-12-04T00:00:00.000Z,56677845,26,Colby Jones,0,0,0,0,0,0
0,0,0,0,0,0,0,0,0,0,0,0,0,0,0,0,7045522,2023-12-04T00:00:00.000Z,17553994,26,Davion Mitchell,0,0,0,0,0,0
0,0,0,0,0,0,0,0,0,0,0,0,0,0,0,0,7045522,2023-12-04T00:00:00.000Z,56677862,26,Jalen Slawson,0,0,0,0,0,0
1,0,0,4,3,4,3,0,0,15,0,0,9,0,0,0,7045523,2023-12-05T00:00:00.000Z,38017733,17,A.J. Green,0,9,10,10,1,10.5
0,0,0,0,0,0,0,0,0,1,0,0,0,0,0,0,7045523,2023-12-05T00:00:00.000Z,56677852,17,Andre Jackson Jr.,0,0,0,0,0,0
1,2,2,3,1,9,5,2,2,24,2,4,13,4,0,1,7045523,2023-12-05T00:00:00.000Z,377,17,Bobby Portis,2,17,18,14,5,24.3
3,3,6,4,1,8,4,0,0,34,2,4,9,8,3,0,7045523,2023-12-05T00:00:00.000Z,283,17,Brook Lopez,6,17,20,12,11,41.1
2,0,2,3,2,6,5,0,0,14,0,2,12,2,1,1,7045523,2023-12-05T00:00:00.000Z,368,17,Cameron Payne,1,14,16,14,4,19.4
0,0,1,0,0,1,0,0,0,2,1,0,0,2,1,1,7045523,2023-12-05T00:00:00.000Z,56677854,17,Chris Livingston,1,2,2,0,2,4.4
7,1,2,7,5,13,8,8,7,34,1,4,28,3,1,3,7045523,2023-12-05T00:00:00.000Z,278,17,Damian Lillard,2,31,38,35,10,45.1
10,0,5,1,1,22,15,9,4,34,3,3,35,8,3,4,7045523,2023-12-05T00:00:00.000Z,15,17,Giannis Antetokounmpo,3,43,53,45,18,64.6
7,0,2,3,2,12,6,0,0,26,2,1,14,4,1,2,7045523,2023-12-05T00:00:00.000Z,315,17,Khris Middleton,1,18,25,21,11,30.3
0,0,3,10,6,11,6,0,0,33,0,4,18,3,0,0,7045523,2023-12-05T00:00:00.000Z,38,17,Malik Beasley,0,21,21,18,3,21.6
1,0,2,2,2,3,2,0,0,19,0,1,6,2,1,0,7045523,2023-12-05T00:00:00.000Z,38017676,17,MarJon Beauchamp,1,8,9,7,3,12.9
0,0,0,0,0,0,0,0,0,0,0,0,0,0,0,0,7045523,2023-12-05T00:00:00.000Z,666453,17,Marques Bolden,0,0,0,0,0,0
0,0,0,1,0,1,0,0,0,2,0,0,0,0,0,0,7045523,2023-12-05T00:00:00.000Z,284,17,Robin Lopez,0,0,0,0,0,0
0,0,0,0,0,1,1,0,0,2,1,0,2,1,1,0,7045523,2023-12-05T00:00:00.000Z,2148,17,Thanasis Antetokounmpo,1,3,3,2,1,6.2
0,0,0,1,1,1,1,0,0,3,0,0,3,0,0,0,7045523,2023-12-05T00:00:00.000Z,17896033,20,Miles McBride,0,3,3,3,0,3
0,0,0,0,0,0,0,0,0,0,0,0,0,0,0,0,7045524,2023-12-05T00:00:00.000Z,56677867,14,Alex Fudge,0,0,0,0,0,0
0,0,0,0,0,0,0,0,0,0,0,0,0,0,0,0,7045524,2023-12-05T00:00:00.000Z,486,14,Christian Wood,0,0,0,0,0,0
0,0,0,0,0,0,0,0,0,0,0,0,0,0,0,0,7045524,2023-12-05T00:00:00.000Z,56677738,14,Colin Castleton,0,0,0,0,0,0
0,0,0,0,0,0,0,0,0,0,0,0,0,0,0,0,7045524,2023-12-05T00:00:00.000Z,56677868,14,D'Moi Hodge,0,0,0,0,0,0
0,0,0,0,0,0,0,0,0,0,0,0,0,0,0,0,7045524,2023-12-05T00:00:00.000Z,1603383,14,Gabe Vincent,0,0,0,0,0,0
0,0,0,0,0,0,0,0,0,0,0,0,0,0,0,0,7045524,2023-12-05T00:00:00.000Z,56677835,14,Jalen Hood-Schifino,0,0,0,0,0,0
0,0,1,0,0,2,0,0,0,9,1,2,0,2,1,0,7045524,2023-12-05T00:00:00.000Z,666626,14,Jaxson Hayes,1,2,2,0,2,5.4
0,0,0,0,0,0,0,0,0,0,0,0,0,0,0,0,7045524,2023-12-05T00:00:00.000Z,56677836,14,Maxwell Lewis,0,0,0,0,0,0
1,0,2,4,1,8,3,0,0,21,0,1,7,2,0,0,7045524,2023-12-05T00:00:00.000Z,666609,14,Rui Hachimura,0,9,10,8,3,10.9
0,0,0,0,0,0,0,0,0,0,0,0,0,0,0,0,7045524,2023-12-05T00:00:00.000Z,666451,24,Bol Bol,0,0,0,0,0,0
0,0,0,0,0,0,0,0,0,0,0,0,0,0,0,0,7045524,2023-12-05T00:00:00.000Z,37,24,Bradley Beal,0,0,0,0,0,0
0,0,0,0,0,0,0,0,0,0,0,0,0,0,0,0,7045524,2023-12-05T00:00:00.000Z,314,24,Chimezie Metu,0,0,0,0,0,0
0,0,0,0,0,0,0,0,0,0,0,0,0,0,0,0,7045524,2023-12-05T00:00:00.000Z,272,24,Damion Lee,0,0,0,0,0,0
6,1,9,1,1,16,6,8,8,37,2,5,21,11,1,7,7045524,2023-12-05T00:00:00.000Z,57,24,Devin Booker,2,32,38,27,17,42.2
1,0,0,0,0,3,3,0,0,17,2,2,6,2,1,3,7045524,2023-12-05T00:00:00.000Z,147,24,Drew Eubanks,1,8,9,7,3,9.9
4,1,4,4,1,8,3,0,0,35,0,1,7,4,2,1,7045524,2023-12-05T00:00:00.000Z,178,24,Eric Gordon,3,11,15,11,8,25.8
2,1,2,8,4,14,6,5,5,39,0,2,21,2,2,0,7045524,2023-12-05T00:00:00.000Z,8,24,Grayson Allen,3,23,25,23,4,35.4
0,0,1,1,0,1,0,0,0,9,0,0,0,1,1,0,7045524,2023-12-05T00:00:00.000Z,356,24,Josh Okogie,1,1,1,0,1,4.2
4,0,8,0,0,3,1,4,1,29,0,4,3,8,1,2,7045524,2023-12-05T00:00:00.000Z,349,24,Jusuf Nurkic,1,11,15,7,12,19.6
4,1,7,7,4,17,12,4,3,39,0,5,31,7,0,5,7045524,2023-12-05T00:00:00.000Z,140,24,Kevin Durant,1,38,42,35,11,43.4
2,0,1,1,1,4,2,0,0,14,1,1,5,2,0,1,7045524,2023-12-05T00:00:00.000Z,666729,24,Nassir Little,0,7,9,7,4,9.4
0,0,0,0,0,0,0,0,0,0,0,0,0,0,0,0,7045524,2023-12-05T00:00:00.000Z,3547298,24,Saben Lee,0,0,0,0,0,0
0,0,0,0,0,0,0,0,0,0,0,0,0,0,0,0,7045524,2023-12-05T00:00:00.000Z,470,24,Yuta Watanabe,0,0,0,0,0,0
0,0,0,0,0,0,0,0,0,0,0,0,0,0,0,0,7049313,2023-12-06T00:00:00.000Z,56677847,6,Emoni Bates,0,0,0,0,0,0
0,0,0,0,0,0,0,0,0,0,0,0,0,0,0,0,7049313,2023-12-06T00:00:00.000Z,17553983,22,Trevelin Queen,0,0,0,0,0,0
0,0,0,0,0,0,0,0,0,0,0,0,0,0,0,0,7049314,2023-12-06T00:00:00.000Z,330,9,Monte Morris,0,0,0,0,0,0
0,0,0,0,0,0,0,0,0,0,0,0,0,0,0,0,7049314,2023-12-06T00:00:00.000Z,666505,15,Brandon Clarke,0,0,0,0,0,0
0,0,0,0,0,0,0,0,0,0,0,0,0,0,0,0,7049314,2023-12-06T00:00:00.000Z,56677830,15,GG Jackson,0,0,0,0,0,0
0,0,0,0,0,0,0,0,0,0,0,0,0,0,0,0,7049314,2023-12-06T00:00:00.000Z,254,15,Luke Kennard,0,0,0,0,0,0
0,0,0,0,0,0,0,0,0,0,0,0,0,0,0,0,7049314,2023-12-06T00:00:00.000Z,3,15,Steven Adams,0,0,0,0,0,0
0,0,0,0,0,0,0,0,0,1,0,0,0,0,0,0,7049314,2023-12-06T00:00:00.000Z,17896027,15,Ziaire Williams,0,0,0,0,0,0
0,0,0,0,0,0,0,0,0,0,0,0,0,0,0,0,7049315,2023-12-06T00:00:00.000Z,4,16,Bam Adebayo,0,0,0,0,0,0
3,1,10,7,4,16,9,4,2,31,2,1,24,12,0,0,7049315,2023-12-06T00:00:00.000Z,666747,16,Caleb Martin,1,36,39,27,15,45.9
7,0,5,10,3,19,9,0,0,32,1,1,21,6,1,0,7049315,2023-12-06T00:00:00.000Z,397,16,Duncan Robinson,1,27,34,28,13,41.7
0,0,0,0,0,0,0,0,0,0,0,0,0,0,0,0,7049315,2023-12-06T00:00:00.000Z,3092,16,Haywood Highsmith,0,0,0,0,0,0
2,0,0,4,1,13,6,2,2,32,0,2,15,0,0,2,7049315,2023-12-06T00:00:00.000Z,56677785,16,Jaime Jaquez Jr.,0,15,17,17,2,16
0,0,0,0,0,0,0,0,0,0,0,0,0,0,0,0,7049315,2023-12-06T00:00:00.000Z,38017734,16,Jamal Cain,0,0,0,0,0,0
8,0,2,1,1,16,7,5,4,35,0,2,19,2,1,0,7049315,2023-12-06T00:00:00.000Z,79,16,Jimmy Butler,1,21,29,27,10,36.4
2,0,3,4,1,6,2,2,2,31,1,3,7,4,0,1,7049315,2023-12-06T00:00:00.000Z,391,16,Josh Richardson,0,11,13,9,6,13.8
4,0,1,4,1,5,2,3,3,15,1,2,8,2,0,0,7049315,2023-12-06T00:00:00.000Z,285,16,Kevin Love,0,10,14,12,6,16.4
3,2,4,4,1,4,1,0,0,28,0,2,3,4,0,2,7049315,2023-12-06T00:00:00.000Z,286,16,Kyle Lowry,2,7,10,6,7,16.3
0,0,2,1,0,1,0,0,0,3,0,2,0,2,0,1,7049315,2023-12-06T00:00:00.000Z,38017696,16,Nikola Jovic,0,2,2,0,2,1.4
4,1,9,3,2,9,5,3,3,33,3,3,15,12,3,1,7049315,2023-12-06T00:00:00.000Z,39398582,16,Orlando Robinson,4,27,31,19,16,46.4
0,0,0,0,0,0,0,0,0,0,0,0,0,0,0,0,7049315,2023-12-06T00:00:00.000Z,74,16,Thomas Bryant,0,0,0,0,0,0
0,0,4,1,0,2,0,0,0,10,0,0,0,4,0,1,7049315,2023-12-06T00:00:00.000Z,58,28,Chris Boucher,0,4,4,0,4,3.8
0,0,0,0,0,0,0,0,0,0,0,0,0,0,0,0,7049315,2023-12-06T00:00:00.000Z,38017710,28,Christian Koloko,0,0,0,0,0,0
5,0,3,5,1,18,4,0,0,35,2,5,9,5,0,3,7049315,2023-12-06T00:00:00.000Z,409,28,Dennis Schroder,0,14,19,14,10,19.5
0,0,0,0,0,0,0,0,0,0,0,0,0,0,0,0,7049315,2023-12-06T00:00:00.000Z,436,28,Garrett Temple,0,0,0,0,0,0
2,0,2,7,3,11,5,2,2,25,0,3,15,2,0,1,7049315,2023-12-06T00:00:00.000Z,3089,28,Gary Trent Jr.,0,17,19,17,4,19.4
0,0,0,0,0,0,0,0,0,0,0,0,0,0,0,0,7049315,2023-12-06T00:00:00.000Z,56677828,28,Gradey Dick,0,0,0,0,0,0
1,4,5,0,0,2,1,2,0,28,1,2,2,6,0,0,7049315,2023-12-06T00:00:00.000Z,373,28,Jakob Poeltl,4,8,9,3,7,22.7
0,0,0,0,0,0,0,0,0,0,0,0,0,0,0,0,7049315,2023-12-06T00:00:00.000Z,666762,28,Jalen McDaniels,0,0,0,0,0,0
0,0,0,0,0,0,0,0,0,0,0,0,0,0,0,0,7049315,2023-12-06T00:00:00.000Z,56677805,28,Javon Freeman-Liberty,0,0,0,0,0,0
1,0,1,1,1,1,1,0,0,6,0,1,3,1,0,0,7049315,2023-12-06T00:00:00.000Z,3547275,28,Malachi Flynn,0,4,5,4,2,5.7
0,0,0,0,0,0,0,0,0,0,0,0,0,0,0,0,7049315,2023-12-06T00:00:00.000Z,56677869,28,Markquis Nowell,0,0,0,0,0,0
6,1,7,10,5,13,8,2,2,39,1,2,23,8,1,2,7049315,2023-12-06T00:00:00.000Z,18,28,OG Anunoby,2,31,37,29,14,45.6
1,1,2,2,0,2,0,0,0,14,0,2,0,2,1,1,7049315,2023-12-06T00:00:00.000Z,376,28,Otto Porter Jr.,2,2,3,1,3,8.9
6,1,3,1,1,13,9,11,11,36,1,1,30,4,0,2,7049315,2023-12-06T00:00:00.000Z,416,28,Pascal Siakam,1,34,40,36,10,44.8
2,0,3,3,1,7,4,0,0,13,0,0,9,3,1,1,7049315,2023-12-06T00:00:00.000Z,3547249,28,Precious Achiuwa,1,12,14,11,5,17.6
0,0,0,0,0,0,0,0,0,0,0,0,0,0,0,0,7049315,2023-12-06T00:00:00.000Z,38017717,28,Ron Harper Jr.,0,0,0,0,0,0
5,1,8,7,2,17,5,0,0,34,3,2,12,11,0,3,7049315,2023-12-06T00:00:00.000Z,17896055,28,Scottie Barnes,1,23,28,17,16,32.7
0,0,0,0,0,0,0,0,0,0,0,0,0,0,0,0,7049315,2023-12-06T00:00:00.000Z,489,28,Thaddeus Young,0,0,0,0,0,0
0,0,0,0,0,0,0,0,0,0,0,0,0,0,0,0,7049316,2023-12-06T00:00:00.000Z,2175,23,Danuel House Jr.,0,0,0,0,0,0
0,0,0,0,0,0,0,0,0,0,0,0,0,0,0,0,7049316,2023-12-06T00:00:00.000Z,260,23,Furkan Korkmaz,0,0,0,0,0,0
0,0,0,0,0,0,0,0,0,0,0,0,0,0,0,0,7049316,2023-12-06T00:00:00.000Z,17896025,23,Jaden Springer,0,0,0,0,0,0
0,0,0,0,0,0,0,0,0,0,0,0,0,0,0,0,7049316,2023-12-06T00:00:00.000Z,17554001,23,Javonte Smart,0,0,0,0,0,0
1,0,1,3,1,8,5,1,1,19,1,1,12,2,1,1,7049316,2023-12-06T00:00:00.000Z,360,23,Kelly Oubre Jr.,1,14,15,13,3,17.9
0,0,0,0,0,0,0,0,0,0,0,0,0,0,0,0,7049316,2023-12-06T00:00:00.000Z,3547294,23,Kenyon Martin Jr.,0,0,0,0,0,0
0,0,2,1,0,4,1,2,2,15,1,0,4,3,0,0,7049316,2023-12-06T00:00:00.000Z,328,23,Marcus Morris,0,7,7,4,3,7.6
0,0,0,0,0,0,0,0,0,0,0,0,0,0,0,0,7049316,2023-12-06T00:00:00.000Z,28,23,Mo Bamba,0,0,0,0,0,0
4,0,4,5,1,7,2,0,0,21,0,0,5,4,1,2,7049316,2023-12-06T00:00:00.000Z,45,23,Patrick Beverley,1,9,13,9,8,16.8
0,0,1,1,0,1,0,0,0,10,0,3,0,1,0,0,7049316,2023-12-06T00:00:00.000Z,3547270,23,Paul Reed,0,1,1,0,1,1.2
0,0,0,0,0,0,0,0,0,0,0,0,0,0,0,0,7049316,2023-12-06T00:00:00.000Z,56913527,23,Ricky Council IV,0,0,0,0,0,0
0,0,1,0,0,0,0,0,0,4,0,1,0,1,0,1,7049316,2023-12-06T00:00:00.000Z,108,23,Robert Covington,0,1,1,0,1,0.2
0,0,0,0,0,0,0,0,0,0,0,0,0,0,0,0,7049316,2023-12-06T00:00:00.000Z,56677788,23,Terquavion Smith,0,0,0,0,0,0
8,0,8,4,0,10,4,0,0,31,0,2,8,8,0,2,7049316,2023-12-06T00:00:00.000Z,3547242,30,Deni Avdija,0,16,24,16,16,27.6
0,0,0,0,0,0,0,0,0,0,0,0,0,0,0,0,7049317,2023-12-06T00:00:00.000Z,38017689,1,AJ Griffin,0,0,0,0,0,0
1,0,4,9,4,14,7,2,2,27,0,2,20,4,0,0,7049317,2023-12-06T00:00:00.000Z,53,1,Bogdan Bogdanovic,0,24,25,21,5,26.3
0,0,0,0,0,0,0,0,0,0,0,0,0,0,0,0,7049317,2023-12-06T00:00:00.000Z,666564,1,Bruno Fernando,0,0,0,0,0,0
1,2,8,0,0,6,4,2,1,29,4,5,9,12,0,1,7049317,2023-12-06T00:00:00.000Z,83,1,Clint Capela,2,21,22,10,13,29.9
2,0,4,3,1,15,6,1,1,36,0,1,14,4,0,1,7049317,2023-12-06T00:00:00.000Z,666656,1,De'Andre Hunter,0,18,20,16,6,20.8
9,0,10,5,1,16,6,0,0,32,0,3,13,10,1,0,7049317,2023-12-06T00:00:00.000Z,334,1,Dejounte Murray,1,23,32,22,19,41.5
0,0,1,0,0,0,0,0,0,7,0,3,0,1,1,1,7049317,2023-12-06T00:00:00.000Z,666754,1,Garrison Mathews,1,1,1,0,1,3.2
0,0,0,0,0,0,0,0,0,0,0,0,0,0,0,0,7049317,2023-12-06T00:00:00.000Z,17896040,1,Jalen Johnson,0,0,0,0,0,0
0,0,0,0,0,0,0,0,0,0,0,0,0,0,0,0,7049317,2023-12-06T00:00:00.000Z,56677838,1,Kobe Bufkin,0,0,0,0,0,0
0,0,0,0,0,0,0,0,0,0,0,0,0,0,0,0,7049317,2023-12-06T00:00:00.000Z,56677875,1,Miles Norris,0,0,0,0,0,0
0,0,0,0,0,0,0,0,0,0,0,0,0,0,0,0,7049317,2023-12-06T00:00:00.000Z,56677806,1,Mouhamed Gueye,0,0,0,0,0,0
2,0,7,2,0,5,1,0,0,24,2,4,2,9,1,1,7049317,2023-12-06T00:00:00.000Z,3547244,1,Onyeka Okongwu,1,11,13,4,11,17.8
0,0,0,0,0,0,0,0,0,0,0,0,0,0,0,0,7049317,2023-12-06T00:00:00.000Z,319,1,Patty Mills,0,0,0,0,0,0
1,0,3,6,3,13,7,4,4,37,4,1,21,7,1,3,7049317,2023-12-06T00:00:00.000Z,3547256,1,Saddiq Bey,1,28,29,22,8,30.9
0,0,0,0,0,0,0,0,0,0,0,0,0,0,0,0,7049317,2023-12-06T00:00:00.000Z,56677855,1,Seth Lundy,0,0,0,0,0,0
9,2,0,9,3,24,11,5,5,37,1,2,30,1,0,5,7049317,2023-12-06T00:00:00.000Z,490,1,Trae Young,2,31,40,39,10,45.7
0,0,0,0,0,0,0,0,0,0,0,0,0,0,0,0,7049317,2023-12-06T00:00:00.000Z,3547297,1,Trent Forrest,0,0,0,0,0,0
0,0,0,0,0,0,0,0,0,0,0,0,0,0,0,0,7049317,2023-12-06T00:00:00.000Z,417,3,Ben Simmons,0,0,0,0,0,0
0,0,0,0,0,0,0,0,0,0,0,0,0,0,0,0,7049317,2023-12-06T00:00:00.000Z,56677841,3,Dariq Whitehead,0,0,0,0,0,0
0,2,6,0,0,5,3,5,2,19,4,4,8,10,0,3,7049317,2023-12-06T00:00:00.000Z,17896038,3,Day'Ron Sharpe,2,18,18,8,10,23
0,1,3,6,3,10,6,0,0,30,2,3,15,5,1,1,7049317,2023-12-06T00:00:00.000Z,158,3,Dorian Finney-Smith,2,20,20,15,5,26
0,0,0,0,0,0,0,0,0,0,0,0,0,0,0,0,7049317,2023-12-06T00:00:00.000Z,56677722,3,Jalen Wilson,0,0,0,0,0,0
0,0,0,0,0,0,0,0,0,0,0,0,0,0,0,0,7049317,2023-12-06T00:00:00.000Z,17896041,3,Keon Johnson,0,0,0,0,0,0
2,0,3,4,1,6,2,2,1,21,0,2,6,3,1,0,7049317,2023-12-06T00:00:00.000Z,351,3,Royce O'Neale,1,9,11,8,5,15.6
4,1,1,5,1,19,5,3,2,28,1,0,13,2,1,2,7049317,2023-12-06T00:00:00.000Z,130,3,Spencer Dinwiddie,2,15,19,17,6,25.4
6,1,6,5,2,17,4,8,7,37,1,2,17,7,1,3,7049318,2023-12-06T00:00:00.000Z,3547238,18,Anthony Edwards,2,24,30,23,13,37.4
0,0,0,0,0,0,0,0,0,0,0,0,0,0,0,0,7049318,2023-12-06T00:00:00.000Z,17895968,18,Daishen Nix,0,0,0,0,0,0
0,0,0,0,0,0,0,0,0,0,0,0,0,0,0,0,7049318,2023-12-06T00:00:00.000Z,3547259,18,Jaden McDaniels,0,0,0,0,0,0
0,0,0,0,0,0,0,0,0,0,0,0,0,0,0,0,7049318,2023-12-06T00:00:00.000Z,56677851,18,Jaylen Clark,0,0,0,0,0,0
0,0,0,0,0,0,0,0,0,0,0,0,0,0,0,0,7049318,2023-12-06T00:00:00.000Z,666767,18,Jordan McLaughlin,0,0,0,0,0,0
0,0,0,0,0,0,0,0,0,0,0,0,0,0,0,0,7049318,2023-12-06T00:00:00.000Z,38017715,18,Josh Minott,0,0,0,0,0,0
2,1,9,3,2,6,5,3,2,32,1,2,14,10,0,6,7049318,2023-12-06T00:00:00.000Z,447,18,Karl-Anthony Towns,1,24,26,16,12,26
2,4,1,0,0,6,2,4,3,22,0,2,7,1,0,0,7049318,2023-12-06T00:00:00.000Z,12,18,Kyle Anderson,4,8,10,9,3,23.2
0,0,0,0,0,0,0,0,0,0,0,0,0,0,0,0,7049318,2023-12-06T00:00:00.000Z,56677782,18,Leonard Miller,0,0,0,0,0,0
0,0,0,0,0,0,0,0,0,0,0,0,0,0,0,0,7049318,2023-12-06T00:00:00.000Z,17896056,18,Luka Garza,0,0,0,0,0,0
4,0,4,10,4,13,5,4,4,33,0,3,18,4,3,1,7049318,2023-12-06T00:00:00.000Z,104,18,Mike Conley,3,22,26,22,8,36.8
2,1,5,7,1,18,7,0,0,29,3,2,15,8,0,1,7049318,2023-12-06T00:00:00.000Z,667378,18,Naz Reid,1,23,25,17,10,29.6
0,0,2,6,1,8,3,0,0,20,0,1,7,2,0,1,7049318,2023-12-06T00:00:00.000Z,666400,18,Nickeil Alexander-Walker,0,9,9,7,2,8.4
2,2,15,0,0,8,7,2,2,30,6,3,16,21,0,1,7049318,2023-12-06T00:00:00.000Z,176,18,Rudy Gobert,2,37,39,18,23,49.2
0,0,1,1,0,2,0,0,0,12,0,0,0,1,0,0,7049318,2023-12-06T00:00:00.000Z,320,18,Shake Milton,0,1,1,0,1,1.2
2,1,1,8,2,9,3,0,0,25,0,1,8,1,0,1,7049318,2023-12-06T00:00:00.000Z,68,18,Troy Brown Jr.,1,9,11,10,3,14.2
0,0,0,0,0,0,0,0,0,0,0,0,0,0,0,0,7049318,2023-12-06T00:00:00.000Z,38017700,18,Wendell Moore Jr.,0,0,0,0,0,0
6,0,6,3,0,8,3,2,0,32,2,2,6,8,2,1,7049318,2023-12-06T00:00:00.000Z,359,27,Cedi Osman,2,14,20,12,14,29.6
0,0,0,0,0,0,0,0,0,0,0,0,0,0,0,0,7049318,2023-12-06T00:00:00.000Z,17895854,27,Charles Bassey,0,0,0,0,0,0
0,0,0,0,0,0,0,0,0,0,0,0,0,0,0,0,7049318,2023-12-06T00:00:00.000Z,56677865,27,Charles Bediako,0,0,0,0,0,0
2,1,3,8,4,16,9,0,0,31,0,1,22,3,1,0,7049318,2023-12-06T00:00:00.000Z,3547246,27,Devin Vassell,2,25,27,24,5,34.6
0,0,0,0,0,0,0,0,0,0,0,0,0,0,0,0,7049318,2023-12-06T00:00:00.000Z,180,27,Devonte' Graham,0,0,0,0,0,0
0,0,0,0,0,0,0,0,0,0,0,0,0,0,0,0,7049318,2023-12-06T00:00:00.000Z,38017730,27,Dominick Barlow,0,0,0,0,0,0
2,0,3,8,3,8,3,2,2,22,0,1,11,3,0,0,7049318,2023-12-06T00:00:00.000Z,305,27,Doug McDermott,0,14,16,13,5,17.6
0,1,1,2,0,10,3,0,0,22,1,1,6,2,0,1,7049318,2023-12-06T00:00:00.000Z,38017699,27,Jeremy Sochan,1,8,8,6,2,10.4
0,0,1,1,0,1,0,0,0,4,0,0,0,1,0,0,7049318,2023-12-06T00:00:00.000Z,38017649,27,Julian Champagnie,0,1,1,0,1,1.2
3,1,9,3,1,16,8,5,4,32,1,4,21,10,2,4,7049318,2023-12-06T00:00:00.000Z,666682,27,Keldon Johnson,3,31,34,24,13,42.5
0,0,0,1,0,2,0,0,0,10,2,2,0,2,0,0,7049318,2023-12-06T00:00:00.000Z,38017692,27,Malaki Branham,0,2,2,0,2,2.4
0,0,0,0,0,0,0,0,0,0,0,0,0,0,0,0,7049318,2023-12-06T00:00:00.000Z,17896059,27,Sandro Mamukelashvili,0,0,0,0,0,0
5,0,2,3,0,8,2,0,0,24,0,2,4,2,1,0,7049318,2023-12-06T00:00:00.000Z,3547274,27,Tre Jones,1,6,11,9,7,16.9
1,1,7,2,0,13,4,6,4,33,3,1,12,10,1,2,7049318,2023-12-06T00:00:00.000Z,56677822,27,Victor Wembanyama,2,22,23,13,11,29.5
4,0,4,6,0,20,6,0,0,30,4,3,12,8,0,3,7049318,2023-12-06T00:00:00.000Z,102,27,Zach Collins,0,20,24,16,12,24.6
4,1,6,6,3,14,4,1,1,39,0,3,12,6,1,2,7049319,2023-12-06T00:00:00.000Z,56677823,4,Brandon Miller,2,18,22,16,10,29.2
0,0,0,0,0,0,0,0,0,0,0,0,0,0,0,0,7049319,2023-12-06T00:00:00.000Z,666748,4,Cody Martin,0,0,0,0,0,0
0,0,0,0,0,0,0,0,0,0,0,0,0,0,0,0,7049319,2023-12-06T00:00:00.000Z,347,4,Frank Ntilikina,0,0,0,0,0,0
4,1,2,4,2,18,10,5,5,35,2,2,27,4,2,5,7049319,2023-12-06T00:00:00.000Z,204,4,Gordon Hayward,3,31,35,31,8,41.8
3,0,1,0,0,0,0,0,0,14,0,1,0,1,0,2,7049319,2023-12-06T00:00:00.000Z,422,4,Ish Smith,0,1,4,3,4,3.7
0,0,0,0,0,0,0,0,0,0,0,0,0,0,0,0,7049319,2023-12-06T00:00:00.000Z,38017698,4,Mark Williams,0,0,0,0,0,0
2,0,6,8,2,15,7,0,0,40,2,3,16,8,3,1,7049319,2023-12-06T00:00:00.000Z,62,4,Miles Bridges,3,24,26,18,10,36.6
0,3,5,0,0,4,2,2,2,28,6,3,6,11,1,2,7049319,2023-12-06T00:00:00.000Z,3547282,4,Nick Richards,4,17,17,6,11,29.2
4,2,5,7,1,13,4,0,0,28,1,5,9,6,1,1,7049319,2023-12-06T00:00:00.000Z,666950,4,P.J. Washington,3,15,19,13,10,30.2
7,2,4,11,1,24,10,4,4,40,1,4,25,5,1,2,7049319,2023-12-06T00:00:00.000Z,403,4,Terry Rozier,3,30,37,32,12,48.5
0,0,0,0,0,0,0,0,0,0,0,0,0,0,0,0,7049319,2023-12-06T00:00:00.000Z,56677860,5,Adama Sanogo,0,0,0,0,0,0
2,2,2,2,1,7,4,4,3,30,4,2,12,6,0,1,7049319,2023-12-06T00:00:00.000Z,89,5,Alex Caruso,2,18,20,14,8,27.2
1,0,4,0,0,8,3,2,1,14,5,3,7,9,1,3,7049319,2023-12-06T00:00:00.000Z,137,5,Andre Drummond,1,16,17,8,10,19.3
2,0,2,4,2,9,3,0,0,22,0,2,8,2,1,4,7049319,2023-12-06T00:00:00.000Z,17895983,5,Ayo Dosunmu,1,10,12,10,4,12.4
5,0,9,7,3,16,6,5,4,38,0,3,19,9,0,0,7049319,2023-12-06T00:00:00.000Z,666956,5,Coby White,0,28,33,24,14,37.3
0,0,0,0,0,0,0,0,0,3,0,0,0,0,0,0,7049319,2023-12-06T00:00:00.000Z,38017719,5,Dalen Terry,0,0,0,0,0,0
3,1,6,3,1,20,8,14,12,36,0,1,29,6,0,2,7049319,2023-12-06T00:00:00.000Z,125,5,DeMar DeRozan,1,35,38,32,9,41.7
3,0,0,1,0,1,0,0,0,11,0,1,0,0,1,1,7049319,2023-12-06T00:00:00.000Z,87,5,Jevon Carter,1,0,3,3,3,6.5
1,0,0,1,0,2,1,0,0,6,0,0,2,0,0,0,7049319,2023-12-06T00:00:00.000Z,56677857,5,Julian Phillips,0,2,3,3,1,3.5
0,0,0,0,0,0,0,0,0,0,0,0,0,0,0,0,7049319,2023-12-06T00:00:00.000Z,45969255,5,Justin Lewis,0,0,0,0,0,0
0,0,0,0,0,0,0,0,0,0,0,0,0,0,0,0,7049319,2023-12-06T00:00:00.000Z,27,5,Lonzo Ball,0,0,0,0,0,0
3,1,6,3,2,17,8,2,2,34,6,0,20,12,0,2,7049319,2023-12-06T00:00:00.000Z,460,5,Nikola Vucevic,1,32,35,23,15,39.9
0,0,0,0,0,0,0,0,0,0,0,0,0,0,0,0,7049319,2023-12-06T00:00:00.000Z,56677874,5,Onuralp Bitim,0,0,0,0,0,0
1,2,6,2,1,6,3,2,1,29,3,2,8,9,2,3,7049319,2023-12-06T00:00:00.000Z,3547248,5,Patrick Williams,4,17,18,9,10,29.3
0,0,0,0,0,0,0,0,0,0,0,0,0,0,0,0,7049319,2023-12-06T00:00:00.000Z,17896116,5,Terry Taylor,0,0,0,0,0,0
2,0,1,2,2,4,2,0,0,17,3,2,6,4,1,0,7049319,2023-12-06T00:00:00.000Z,110,5,Torrey Craig,1,10,12,8,6,16.8
0,0,0,0,0,0,0,0,0,0,0,0,0,0,0,0,7049319,2023-12-06T00:00:00.000Z,268,5,Zach LaVine,0,0,0,0,0,0
4,0,5,7,6,13,8,0,0,27,1,3,22,6,1,0,7049320,2023-12-06T00:00:00.000Z,213,11,Aaron Holiday,1,28,32,26,10,38.2
7,2,5,2,0,13,8,11,5,35,1,4,21,6,1,4,7049320,2023-12-06T00:00:00.000Z,17896062,11,Alperen Sengun,3,27,34,28,13,43.7
0,0,0,0,0,0,0,0,0,0,0,0,0,0,0,0,7049320,2023-12-06T00:00:00.000Z,56677825,11,Amen Thompson,0,0,0,0,0,0
0,0,0,0,0,0,0,0,0,0,0,0,0,0,0,0,7049320,2023-12-06T00:00:00.000Z,296,11,Boban Marjanovic,0,0,0,0,0,0
0,0,0,0,0,0,0,0,0,0,0,0,0,0,0,0,7049320,2023-12-06T00:00:00.000Z,56677831,11,Cam Whitmore,0,0,0,0,0,0
2,0,2,7,2,17,9,3,3,40,2,2,23,4,1,3,7049320,2023-12-06T00:00:00.000Z,66,11,Dillon Brooks,1,27,29,25,6,30.8
9,1,3,7,3,14,4,0,0,38,0,0,11,3,3,3,7049320,2023-12-06T00:00:00.000Z,458,11,Fred VanVleet,4,14,23,20,12,37.1
1,0,14,1,1,4,2,1,1,32,4,1,6,18,0,3,7049320,2023-12-06T00:00:00.000Z,38017684,11,Jabari Smith Jr.,0,24,25,7,19,26.1
0,0,1,1,0,2,0,0,0,15,0,1,0,1,0,2,7049320,2023-12-06T00:00:00.000Z,3547301,11,Jae'Sean Tate,0,1,1,0,1,-0.8
1,0,7,3,1,12,6,2,2,25,0,3,15,7,0,3,7049320,2023-12-06T00:00:00.000Z,17895966,11,Jalen Green,0,22,23,16,8,21.9
0,0,0,0,0,0,0,0,0,0,0,0,0,0,0,0,7049320,2023-12-06T00:00:00.000Z,47738533,11,Jeenathan Williams,0,0,0,0,0,0
0,0,0,0,0,0,0,0,0,0,0,0,0,0,0,0,7049320,2023-12-06T00:00:00.000Z,188,11,Jeff Green,0,0,0,0,0,0
0,0,0,0,0,0,0,0,0,0,0,0,0,0,0,0,7049320,2023-12-06T00:00:00.000Z,56677809,11,Jermaine Samuels Jr.,0,0,0,0,0,0
0,0,0,0,0,0,0,0,0,0,0,0,0,0,0,0,7049320,2023-12-06T00:00:00.000Z,19465326,11,Jock Landale,0,0,0,0,0,0
0,0,0,0,0,0,0,0,0,0,0,0,0,0,0,0,7049320,2023-12-06T00:00:00.000Z,3547281,11,Nate Hinton,0,0,0,0,0,0
0,0,0,1,0,2,1,1,1,6,0,0,3,0,0,0,7049320,2023-12-06T00:00:00.000Z,75,11,Reggie Bullock,0,3,3,3,0,3
4,2,6,4,2,6,2,4,3,22,2,2,9,8,0,1,7049320,2023-12-06T00:00:00.000Z,38017695,11,Tari Eason,2,17,21,13,12,29.6
0,0,0,0,0,0,0,0,0,0,0,0,0,0,0,0,7049320,2023-12-06T00:00:00.000Z,357,11,Victor Oladipo,0,0,0,0,0,0
0,0,1,0,0,4,4,4,3,15,0,3,11,1,1,0,7049320,2023-12-06T00:00:00.000Z,17896078,21,Aaron Wiggins,1,12,12,11,1,15.2
0,0,0,0,0,0,0,0,0,0,0,0,0,0,0,0,7049320,2023-12-06T00:00:00.000Z,3547271,21,Aleksej Pokusevski,0,0,0,0,0,0
0,1,3,2,1,5,2,0,0,25,0,3,5,3,2,0,7049320,2023-12-06T00:00:00.000Z,56677833,21,Cason Wallace,3,8,8,5,3,17.6
2,6,4,4,0,9,2,0,0,26,1,2,4,5,1,1,7049320,2023-12-06T00:00:00.000Z,38017685,21,Chet Holmgren,7,9,11,6,7,33
0,0,0,0,0,0,0,0,0,0,0,0,0,0,0,0,7049320,2023-12-06T00:00:00.000Z,44,21,Davis Bertans,0,0,0,0,0,0
0,0,1,4,1,5,1,0,0,14,0,1,3,1,0,1,7049320,2023-12-06T00:00:00.000Z,3547272,21,Isaiah Joe,0,4,4,3,1,3.2
3,0,5,1,0,13,5,3,3,33,0,2,13,5,1,2,7049320,2023-12-06T00:00:00.000Z,38017703,21,Jalen Williams,1,18,21,16,8,24.5
0,0,0,2,0,4,0,2,2,12,0,1,2,0,0,0,7049320,2023-12-06T00:00:00.000Z,38017706,21,Jaylin Williams,0,2,2,2,0,2
6,0,3,5,2,11,3,0,0,25,1,3,8,4,1,0,7049320,2023-12-06T00:00:00.000Z,17896065,21,Josh Giddey,1,12,18,14,10,24.8
1,2,2,4,2,5,3,2,0,15,0,1,8,2,0,0,7049320,2023-12-06T00:00:00.000Z,480,21,Kenrich Williams,2,10,11,9,3,17.9
0,0,0,0,0,0,0,0,0,0,0,0,0,0,0,0,7049320,2023-12-06T00:00:00.000Z,56677853,21,Keyontae Johnson,0,0,0,0,0,0
0,0,1,3,0,5,0,4,4,14,2,1,4,3,0,1,7049320,2023-12-06T00:00:00.000Z,666541,21,Luguentz Dort,0,7,7,4,3,6.6
0,0,0,0,0,0,0,0,0,0,0,0,0,0,0,0,7049320,2023-12-06T00:00:00.000Z,24572055,21,Olivier Sarr,0,0,0,0,0,0
0,0,0,0,0,0,0,0,0,0,0,0,0,0,0,0,7049320,2023-12-06T00:00:00.000Z,38017716,21,Ousmane Dieng,0,0,0,0,0,0
6,1,3,0,0,18,13,9,7,37,0,4,33,3,6,2,7049320,2023-12-06T00:00:00.000Z,175,21,Shai Gilgeous-Alexander,7,36,42,39,9,64.6
4,0,3,4,2,8,4,0,0,24,0,0,10,3,2,1,7049320,2023-12-06T00:00:00.000Z,17896036,21,Tre Mann,2,13,17,14,7,24.6
0,0,0,0,0,0,0,0,0,0,0,0,0,0,0,0,7049320,2023-12-06T00:00:00.000Z,4197029,21,Vasilije Micic,0,0,0,0,0,0
7,0,6,5,1,9,2,0,0,26,0,1,5,6,2,0,7049321,2023-12-06T00:00:00.000Z,151,7,Dante Exum,2,11,18,12,13,28.7
0,0,0,0,0,0,0,0,0,0,0,0,0,0,0,0,7049321,2023-12-06T00:00:00.000Z,56677873,7,Dexter Dennis,0,0,0,0,0,0
0,0,0,0,0,0,0,0,0,0,0,0,0,0,0,0,7049321,2023-12-06T00:00:00.000Z,666965,7,Grant Williams,0,0,0,0,0,0
0,0,0,0,0,0,0,0,0,0,0,0,0,0,0,0,7049321,2023-12-06T00:00:00.000Z,17896028,7,Greg Brown III,0,0,0,0,0,0
0,0,0,0,0,0,0,0,0,0,0,0,0,0,0,0,7049321,2023-12-06T00:00:00.000Z,3547258,7,Josh Green,0,0,0,0,0,0
0,0,1,2,1,3,1,0,0,5,0,0,3,1,0,0,7049321,2023-12-06T00:00:00.000Z,329,7,Markieff Morris,0,4,4,3,1,4.2
0,0,0,0,0,0,0,0,0,0,0,0,0,0,0,0,7049321,2023-12-06T00:00:00.000Z,257,7,Maxi Kleber,0,0,0,0,0,0
0,0,0,0,0,0,0,0,0,0,0,0,0,0,0,0,7049321,2023-12-06T00:00:00.000Z,56677842,29,Brice Sensabaugh,0,0,0,0,0,0
0,0,6,2,0,11,5,0,0,23,2,2,10,8,0,2,7049321,2023-12-06T00:00:00.000Z,101,29,John Collins,0,18,18,10,8,17.6
0,0,0,0,0,0,0,0,0,0,0,0,0,0,0,0,7049321,2023-12-06T00:00:00.000Z,19465584,29,Micah Potter,0,0,0,0,0,0
3,1,2,3,1,5,2,2,2,24,0,1,7,2,0,1,7049321,2023-12-06T00:00:00.000Z,38017739,29,Simone Fontecchio,1,9,12,10,5,15.9
1,0,2,1,0,12,3,3,3,27,1,1,9,3,0,1,7049322,2023-12-06T00:00:00.000Z,475,10,Andrew Wiggins,0,12,13,10,4,13.1
1,0,4,1,1,3,1,2,0,21,1,2,3,5,0,1,7049322,2023-12-06T00:00:00.000Z,56677858,10,Brandin Podziemski,0,8,9,4,6,9.5
6,0,2,2,0,4,1,0,0,21,1,2,2,3,0,2,7049322,2023-12-06T00:00:00.000Z,367,10,Chris Paul,0,5,11,8,9,12.6
0,0,4,3,2,7,4,4,3,20,2,3,13,6,0,4,7049322,2023-12-06T00:00:00.000Z,407,10,Dario Saric,0,19,19,13,6,16.2
9,2,4,2,0,7,3,4,4,31,6,3,10,10,0,4,7049322,2023-12-06T00:00:00.000Z,185,10,Draymond Green,2,20,29,19,19,37.5
0,0,0,0,0,0,0,0,0,0,0,0,0,0,0,0,7049322,2023-12-06T00:00:00.000Z,2189,10,Gary Payton II,0,0,0,0,0,0
0,0,0,0,0,0,0,0,0,0,0,0,0,0,0,0,7049322,2023-12-06T00:00:00.000Z,57875092,10,Gui Santos,0,0,0,0,0,0
0,0,0,0,0,0,0,0,0,0,0,0,0,0,0,0,7049322,2023-12-06T00:00:00.000Z,398,10,Jerome Robinson,0,0,0,0,0,0
1,0,1,0,0,6,6,2,1,17,0,2,13,1,2,0,7049322,2023-12-06T00:00:00.000Z,17553979,10,Jonathan Kuminga,2,14,15,14,2,21.7
0,0,6,0,0,6,2,2,2,16,2,2,6,8,1,0,7049322,2023-12-06T00:00:00.000Z,282,10,Kevon Looney,1,14,14,6,8,18.6
1,0,5,8,1,13,3,4,4,27,0,0,11,5,0,0,7049322,2023-12-06T00:00:00.000Z,443,10,Klay Thompson,0,16,17,12,6,18.5
0,0,0,0,0,0,0,0,0,0,0,0,0,0,0,0,7049322,2023-12-06T00:00:00.000Z,45658838,10,Lester Quinones,0,0,0,0,0,0
0,1,2,4,1,10,5,1,1,26,2,2,12,4,1,1,7049322,2023-12-06T00:00:00.000Z,17553992,10,Moses Moody,2,16,16,12,4,21.8
1,0,5,13,5,18,8,11,10,34,0,2,31,5,0,4,7049322,2023-12-06T00:00:00.000Z,115,10,Stephen Curry,0,36,37,32,6,34.5
0,0,0,0,0,0,0,0,0,0,0,0,0,0,0,0,7049322,2023-12-06T00:00:00.000Z,56677799,10,Trayce Jackson-Davis,0,0,0,0,0,0
0,0,0,0,0,0,0,0,0,0,0,0,0,0,0,0,7049322,2023-12-06T00:00:00.000Z,17896070,10,Usman Garuba,0,0,0,0,0,0
4,0,0,13,6,27,10,2,2,37,1,3,28,1,0,1,7049322,2023-12-06T00:00:00.000Z,419,25,Anfernee Simons,0,29,33,32,5,34.2
0,0,0,0,0,0,0,0,0,0,0,0,0,0,0,0,7049322,2023-12-06T00:00:00.000Z,22,25,Deandre Ayton,0,0,0,0,0,0
2,1,5,5,1,6,2,6,5,22,1,5,10,6,1,0,7049322,2023-12-06T00:00:00.000Z,56783340,25,Duop Reath,2,16,18,12,8,26.2
0,0,0,0,0,0,0,0,0,0,0,0,0,0,0,0,7049322,2023-12-06T00:00:00.000Z,17896120,25,Ish Wainright,0,0,0,0,0,0
0,0,0,0,0,0,0,0,0,0,0,0,0,0,0,0,7049322,2023-12-06T00:00:00.000Z,182,25,Jerami Grant,0,0,0,0,0,0
0,0,0,0,0,0,0,0,0,0,0,0,0,0,0,0,7049322,2023-12-06T00:00:00.000Z,47957121,25,Justin Minaya,0,0,0,0,0,0
0,0,0,0,0,0,0,0,0,0,0,0,0,0,0,0,7049322,2023-12-06T00:00:00.000Z,666476,25,Moses Brown,0,0,0,0,0,0
0,0,0,0,0,0,0,0,0,0,0,0,0,0,0,0,7049322,2023-12-06T00:00:00.000Z,56677829,25,Rayan Rupert,0,0,0,0,0,0
0,0,0,0,0,0,0,0,0,0,0,0,0,0,0,0,7049322,2023-12-06T00:00:00.000Z,476,25,Robert Williams III,0,0,0,0,0,0
5,0,6,9,4,18,10,4,2,42,0,1,26,6,0,1,7049322,2023-12-06T00:00:00.000Z,38017690,25,Shaedon Sharpe,0,32,37,31,11,39.7
0,0,0,0,0,0,0,0,0,0,0,0,0,0,0,0,7049322,2023-12-06T00:00:00.000Z,3547289,25,Skylar Mays,0,0,0,0,0,0
2,0,8,4,0,14,3,0,0,27,5,6,6,13,0,3,7049322,2023-12-06T00:00:00.000Z,56677850,25,Toumani Camara,0,19,21,8,15,21.6
2,0,4,0,0,8,4,0,0,31,1,2,8,5,2,0,7049323,2023-12-06T00:00:00.000Z,177,8,Aaron Gordon,2,13,15,10,7,23
0,0,0,0,0,0,0,0,0,0,0,0,0,0,0,0,7049323,2023-12-06T00:00:00.000Z,17896007,8,Braxton Key,0,0,0,0,0,0
0,1,2,0,0,6,2,0,0,11,3,0,4,5,0,0,7049323,2023-12-06T00:00:00.000Z,250,8,DeAndre Jordan,1,9,9,4,5,13
0,0,0,0,0,0,0,0,0,0,0,0,0,0,0,0,7049323,2023-12-06T00:00:00.000Z,56677871,8,Hunter Tyson,0,0,0,0,0,0
0,0,0,0,0,0,0,0,0,0,0,0,0,0,0,0,7049323,2023-12-06T00:00:00.000Z,56677582,8,Jalen Pickett,0,0,0,0,0,0
6,1,0,7,2,18,10,1,1,29,0,4,23,0,1,1,7049323,2023-12-06T00:00:00.000Z,335,8,Jamal Murray,2,23,29,29,6,37
0,0,0,0,0,0,0,0,0,0,0,0,0,0,0,0,7049323,2023-12-06T00:00:00.000Z,17896103,8,Jay Huff,0,0,0,0,0,0
2,0,1,2,0,2,0,0,0,13,0,4,0,1,0,1,7049323,2023-12-06T00:00:00.000Z,56677776,8,Julian Strawther,0,1,3,2,3,3.2
3,0,1,3,1,4,1,0,0,34,0,1,3,1,1,0,7049323,2023-12-06T00:00:00.000Z,81,8,Kentavious Caldwell-Pope,1,4,7,6,4,11.7
0,1,6,5,4,8,7,0,0,34,3,2,18,9,0,2,7049323,2023-12-06T00:00:00.000Z,375,8,Michael Porter Jr.,1,27,27,18,9,29.8
10,0,10,7,2,32,9,2,2,37,5,2,22,15,1,4,7049323,2023-12-06T00:00:00.000Z,246,8,Nikola Jokic,1,37,47,32,25,54
3,1,3,2,0,3,0,2,2,16,0,1,2,3,1,1,7049323,2023-12-06T00:00:00.000Z,38017721,8,Peyton Watson,2,5,8,5,6,15.1
3,0,1,4,3,10,4,4,3,19,0,1,14,1,1,2,7049323,2023-12-06T00:00:00.000Z,236,8,Reggie Jackson,1,15,18,17,4,20.7
0,0,0,0,0,0,0,0,0,0,0,0,0,0,0,0,7049323,2023-12-06T00:00:00.000Z,666489,8,Vlatko Cancar,0,0,0,0,0,0
0,0,0,0,0,0,0,0,0,0,0,0,0,0,0,0,7049323,2023-12-06T00:00:00.000Z,3547268,8,Zeke Nnaji,0,0,0,0,0,0
0,0,0,0,0,0,0,0,0,0,0,0,0,0,0,0,7049323,2023-12-06T00:00:00.000Z,666511,13,Amir Coffey,0,0,0,0,0,0
0,0,0,0,0,0,0,0,0,0,0,0,0,0,0,0,7049323,2023-12-06T00:00:00.000Z,17896022,13,Brandon Boston Jr.,0,0,0,0,0,0
0,3,6,4,2,8,3,0,0,21,5,2,8,11,0,1,7049323,2023-12-06T00:00:00.000Z,439,13,Daniel Theis,3,19,19,8,11,29.2
0,1,7,0,0,7,4,6,2,27,2,3,10,9,2,0,7049323,2023-12-06T00:00:00.000Z,493,13,Ivica Zubac,3,19,19,10,9,29.8
11,0,1,3,2,10,6,7,6,32,0,0,20,1,3,4,7049323,2023-12-06T00:00:00.000Z,192,13,James Harden,3,21,32,31,12,42.7
0,0,0,0,0,0,0,0,0,0,0,0,0,0,0,0,7049323,2023-12-06T00:00:00.000Z,56677856,13,Jordan Miller,0,0,0,0,0,0
0,0,0,0,0,0,0,0,0,0,0,0,0,0,0,0,7049323,2023-12-06T00:00:00.000Z,17896051,13,Joshua Primo,0,0,0,0,0,0
5,1,3,3,1,16,8,0,0,38,1,2,17,4,1,2,7049323,2023-12-06T00:00:00.000Z,274,13,Kawhi Leonard,2,21,26,22,9,33.3
1,0,4,3,1,4,1,0,0,17,0,4,3,4,0,0,7049323,2023-12-06T00:00:00.000Z,56677849,13,Kobe Brown,0,7,8,4,5,9.3
0,0,0,0,0,0,0,0,0,0,0,0,0,0,0,0,7049323,2023-12-06T00:00:00.000Z,371,13,Mason Plumlee,0,0,0,0,0,0
0,0,0,0,0,0,0,0,0,0,0,0,0,0,0,0,7049323,2023-12-06T00:00:00.000Z,38017725,13,Moussa Diabate,0,0,0,0,0,0
0,0,0,0,0,0,0,0,0,0,0,0,0,0,0,0,7049323,2023-12-06T00:00:00.000Z,17896031,13,Nah'Shon Hyland,0,0,0,0,0,0
2,0,4,3,1,12,5,6,6,31,0,0,17,4,1,1,7049323,2023-12-06T00:00:00.000Z,380,13,Norman Powell,1,21,23,19,6,26.8
1,1,7,9,5,20,8,4,4,38,1,1,25,8,0,2,7049323,2023-12-06T00:00:00.000Z,172,13,Paul George,1,33,34,26,9,37.1
0,0,0,0,0,0,0,0,0,0,0,0,0,0,0,0,7049323,2023-12-06T00:00:00.000Z,450,13,PJ Tucker,0,0,0,0,0,0
1,1,4,2,0,8,4,2,1,16,4,1,9,8,0,1,7049323,2023-12-06T00:00:00.000Z,472,13,Russell Westbrook,1,17,18,10,9,22.1
0,0,1,0,0,2,1,0,0,20,0,1,2,1,0,0,7049323,2023-12-06T00:00:00.000Z,666743,13,Terance Mann,0,3,3,2,1,3.2
0,0,0,0,0,0,0,0,0,0,0,0,0,0,0,0,7049323,2023-12-06T00:00:00.000Z,24417679,13,Xavier Moon,0,0,0,0,0,0
0,0,0,0,0,1,0,0,0,4,0,0,0,0,0,0,7981414,2023-12-07T00:00:00.000Z,38017733,17,A.J. Green,0,0,0,0,0,0
0,0,0,0,0,0,0,0,0,1,0,1,0,0,0,0,7981414,2023-12-07T00:00:00.000Z,56677852,17,Andre Jackson Jr.,0,0,0,0,0,0
1,1,2,1,0,5,2,0,0,18,4,2,4,6,0,1,7981414,2023-12-07T00:00:00.000Z,377,17,Bobby Portis,1,10,11,5,7,14.7
2,4,4,10,3,17,7,3,1,37,2,5,18,6,0,1,7981414,2023-12-07T00:00:00.000Z,283,17,Brook Lopez,4,24,26,20,8,39.2
2,0,1,3,0,9,2,0,0,16,0,0,4,1,0,2,7981414,2023-12-07T00:00:00.000Z,368,17,Cameron Payne,0,5,7,6,3,6.2
0,0,0,0,0,0,0,0,0,0,0,0,0,0,0,0,7981414,2023-12-07T00:00:00.000Z,56677854,17,Chris Livingston,0,0,0,0,0,0
7,1,7,9,4,20,7,6,6,42,0,2,24,7,1,3,7981414,2023-12-07T00:00:00.000Z,278,17,Damian Lillard,2,31,38,31,14,45.9
2,2,9,1,0,19,13,13,11,41,1,3,37,10,0,1,7981414,2023-12-07T00:00:00.000Z,15,17,Giannis Antetokounmpo,2,47,49,39,12,57
4,0,6,5,4,13,7,2,2,30,1,2,20,7,2,4,7981414,2023-12-07T00:00:00.000Z,315,17,Khris Middleton,2,27,31,24,11,36.4
0,0,0,0,0,0,0,0,0,0,0,0,0,0,0,0,7981414,2023-12-07T00:00:00.000Z,666960,17,Lindell Wigginton,0,0,0,0,0,0
1,0,2,4,1,9,3,0,0,36,1,2,7,3,0,0,7981414,2023-12-07T00:00:00.000Z,38,17,Malik Beasley,0,10,11,8,4,12.1
0,1,3,0,0,3,2,4,1,15,3,0,5,6,0,0,7981414,2023-12-07T00:00:00.000Z,38017676,17,MarJon Beauchamp,1,11,11,5,6,15.2
0,0,0,0,0,0,0,0,0,0,0,0,0,0,0,0,7981414,2023-12-07T00:00:00.000Z,666453,17,Marques Bolden,0,0,0,0,0,0
0,0,0,0,0,0,0,0,0,0,0,0,0,0,0,0,7981414,2023-12-07T00:00:00.000Z,284,17,Robin Lopez,0,0,0,0,0,0
0,0,0,0,0,0,0,0,0,0,0,0,0,0,0,0,7981414,2023-12-07T00:00:00.000Z,2148,17,Thanasis Antetokounmpo,0,0,0,0,0,0
0,0,0,0,0,0,0,0,0,0,0,0,0,0,0,0,7981414,2023-12-07T00:00:00.000Z,38017691,17,TyTy Washington Jr.,0,0,0,0,0,0
5,2,10,2,0,10,5,8,6,31,5,1,16,15,2,2,7996352,2023-12-07T00:00:00.000Z,117,14,Anthony Davis,4,31,36,21,20,51.5
1,0,3,5,2,10,6,0,0,22,0,1,14,3,1,4,7996352,2023-12-07T00:00:00.000Z,405,14,D'Angelo Russell,1,17,18,15,4,18.1
1,1,3,0,0,3,0,2,1,8,1,1,1,4,0,1,7996352,2023-12-07T00:00:00.000Z,56677835,14,Jalen Hood-Schifino,1,5,6,2,5,9.3
1,1,5,0,0,2,1,0,0,15,0,0,2,5,0,0,7996352,2023-12-07T00:00:00.000Z,457,14,Jarred Vanderbilt,1,7,8,3,6,12.5
0,0,4,1,0,3,2,1,0,17,0,4,4,4,0,1,7996352,2023-12-07T00:00:00.000Z,666626,14,Jaxson Hayes,0,8,8,4,4,7.8
8,0,5,4,4,12,9,8,8,23,0,1,30,5,0,0,7996352,2023-12-07T00:00:00.000Z,237,14,LeBron James,0,35,43,38,13,48
0,0,2,1,0,5,3,2,0,17,0,1,6,2,1,0,7996352,2023-12-07T00:00:00.000Z,38017697,14,Max Christie,1,8,8,6,2,11.4
1,0,1,2,1,4,1,0,0,8,0,0,3,1,0,1,7996352,2023-12-07T00:00:00.000Z,56677836,14,Maxwell Lewis,0,4,5,4,2,4.7
2,0,1,3,1,9,5,2,1,21,0,3,12,1,0,0,7996352,2023-12-07T00:00:00.000Z,666609,14,Rui Hachimura,0,13,15,14,3,16.2
1,0,3,8,5,9,5,0,0,23,0,3,15,3,1,0,7996352,2023-12-07T00:00:00.000Z,383,14,Taurean Prince,1,18,19,16,4,23.1
2,0,3,4,1,14,4,0,0,25,1,2,9,4,2,1,7996352,2023-12-07T00:00:00.000Z,303,19,CJ McCollum,2,13,15,11,6,21.8
1,0,1,0,0,1,0,2,2,12,1,2,2,2,0,0,7996352,2023-12-07T00:00:00.000Z,491,19,Cody Zeller,0,4,5,3,3,5.9
0,0,0,0,0,0,0,0,0,0,0,0,0,0,0,0,7996352,2023-12-07T00:00:00.000Z,38017726,19,Dereon Seabron,0,0,0,0,0,0
0,1,6,2,0,5,1,2,2,17,2,1,4,8,0,0,7996352,2023-12-07T00:00:00.000Z,38017677,19,Dyson Daniels,1,12,12,4,8,16.6
0,0,0,0,0,0,0,0,0,0,0,0,0,0,0,0,7996352,2023-12-07T00:00:00.000Z,38017663,19,E.J. Liddell,0,0,0,0,0,0
1,1,3,3,0,10,4,2,2,26,4,4,10,7,2,1,7996352,2023-12-07T00:00:00.000Z,17896024,19,Herbert Jones,3,17,18,11,8,27.9
1,0,2,0,0,2,0,0,0,6,0,0,0,2,0,0,7996352,2023-12-07T00:00:00.000Z,17896021,19,Jeremiah Robinson-Earl,0,2,3,1,3,3.9
0,0,2,3,0,8,2,0,0,12,0,1,4,2,0,0,7996352,2023-12-07T00:00:00.000Z,56677837,19,Jordan Hawkins,0,6,6,4,2,6.4
4,0,2,3,2,7,3,0,0,20,0,1,8,2,2,1,7996352,2023-12-07T00:00:00.000Z,17896097,19,Jose Alvarado,2,10,14,12,6,21.4
0,0,0,1,0,3,1,0,0,7,0,0,2,0,0,1,7996352,2023-12-07T00:00:00.000Z,3547260,19,Kira Lewis Jr.,0,2,2,2,0,1
0,0,0,0,0,0,0,0,0,0,0,0,0,0,0,0,7996352,2023-12-07T00:00:00.000Z,340,19,Larry Nance Jr.,0,0,0,0,0,0
0,0,0,0,0,0,0,0,0,0,0,0,0,0,0,0,7996352,2023-12-07T00:00:00.000Z,17896017,19,Matt Ryan,0,0,0,0,0,0
0,0,2,1,1,2,1,2,2,12,2,1,5,4,0,1,7996352,2023-12-07T00:00:00.000Z,3547293,19,Naji Marshall,0,9,9,5,4,8.8
1,0,3,7,2,13,5,2,2,23,0,1,14,3,0,0,7996352,2023-12-07T00:00:00.000Z,18677986,19,Trey Murphy III,0,17,18,15,4,19.1
0,0,0,0,0,0,0,0,0,0,0,0,0,0,0,0,7050282,2023-12-08T00:00:00.000Z,56677848,4,Amari Bailey,0,0,0,0,0,0
3,2,5,7,4,15,7,2,2,35,0,1,20,5,0,4,7050282,2023-12-08T00:00:00.000Z,56677823,4,Brandon Miller,2,25,28,23,8,32.5
0,0,0,0,0,0,0,0,0,7,0,0,0,0,0,0,7050282,2023-12-08T00:00:00.000Z,38017708,4,Bryce McGowens,0,0,0,0,0,0
0,0,0,0,0,0,0,0,0,0,0,0,0,0,0,0,7050282,2023-12-08T00:00:00.000Z,666748,4,Cody Martin,0,0,0,0,0,0
0,0,0,0,0,0,0,0,0,0,0,0,0,0,0,0,7050282,2023-12-08T00:00:00.000Z,347,4,Frank Ntilikina,0,0,0,0,0,0
4,0,1,2,1,15,10,4,3,35,3,1,24,4,1,3,7050282,2023-12-08T00:00:00.000Z,204,4,Gordon Hayward,1,28,32,28,8,34.8
4,0,0,0,0,1,1,0,0,14,0,0,2,0,0,1,7050282,2023-12-08T00:00:00.000Z,422,4,Ish Smith,0,2,6,6,4,7
0,0,0,0,0,0,0,0,0,0,0,0,0,0,0,0,7050282,2023-12-08T00:00:00.000Z,17896037,4,James Bouknight,0,0,0,0,0,0
0,0,0,0,0,0,0,0,0,0,0,0,0,0,0,0,7050282,2023-12-08T00:00:00.000Z,18678001,4,JT Thor,0,0,0,0,0,0
0,0,0,0,0,0,0,0,0,0,0,0,0,0,0,0,7050282,2023-12-08T00:00:00.000Z,3547239,4,LaMelo Ball,0,0,0,0,0,0
0,0,0,0,0,0,0,0,0,0,0,0,0,0,0,0,7050282,2023-12-08T00:00:00.000Z,56677866,4,Leaky Black,0,0,0,0,0,0
1,2,1,0,0,4,2,0,0,20,2,2,4,3,1,1,7050282,2023-12-08T00:00:00.000Z,38017698,4,Mark Williams,3,7,8,5,4,17.1
3,0,8,6,3,15,8,3,3,38,0,0,22,8,2,1,7050282,2023-12-08T00:00:00.000Z,62,4,Miles Bridges,2,30,33,25,11,41.1
0,0,6,0,0,7,5,6,5,26,2,2,15,8,1,1,7050282,2023-12-08T00:00:00.000Z,3547282,4,Nick Richards,1,23,23,15,8,26.6
0,0,0,0,0,0,0,0,0,0,0,0,0,0,0,0,7050282,2023-12-08T00:00:00.000Z,56677846,4,Nick Smith Jr.,0,0,0,0,0,0
2,0,1,5,3,7,4,0,0,25,0,4,11,1,2,2,7050282,2023-12-08T00:00:00.000Z,666950,4,P.J. Washington,2,12,14,13,3,19.2
13,0,2,5,2,15,7,5,5,40,0,5,21,2,0,2,7050282,2023-12-08T00:00:00.000Z,403,4,Terry Rozier,0,23,36,34,15,40.9
0,0,0,0,0,0,0,0,0,0,0,0,0,0,0,0,7050282,2023-12-08T00:00:00.000Z,3547253,4,Theo Maledon,0,0,0,0,0,0
0,1,2,3,0,9,4,1,1,13,1,4,9,3,0,1,7050282,2023-12-08T00:00:00.000Z,58,28,Chris Boucher,1,12,12,9,3,14.6
0,0,0,0,0,0,0,0,0,0,0,0,0,0,0,0,7050282,2023-12-08T00:00:00.000Z,38017710,28,Christian Koloko,0,0,0,0,0,0
5,0,1,4,0,10,3,1,1,30,0,4,7,1,1,2,7050282,2023-12-08T00:00:00.000Z,409,28,Dennis Schroder,1,8,13,12,6,16.7
0,0,0,0,0,0,0,0,0,0,0,0,0,0,0,0,7050282,2023-12-08T00:00:00.000Z,436,28,Garrett Temple,0,0,0,0,0,0
2,0,2,3,0,7,0,0,0,20,0,0,0,2,0,0,7050282,2023-12-08T00:00:00.000Z,3089,28,Gary Trent Jr.,0,2,4,2,4,5.4
0,0,0,0,0,0,0,0,0,0,0,0,0,0,0,0,7050282,2023-12-08T00:00:00.000Z,56677828,28,Gradey Dick,0,0,0,0,0,0
0,0,0,0,0,0,0,0,0,0,0,0,0,0,0,0,7050282,2023-12-08T00:00:00.000Z,666762,28,Jalen McDaniels,0,0,0,0,0,0
0,0,0,0,0,0,0,0,0,0,0,0,0,0,0,0,7050282,2023-12-08T00:00:00.000Z,56677805,28,Javon Freeman-Liberty,0,0,0,0,0,0
4,0,0,4,0,7,3,2,2,18,0,1,8,0,2,1,7050282,2023-12-08T00:00:00.000Z,3547275,28,Malachi Flynn,2,8,12,12,4,19
0,0,0,0,0,0,0,0,0,0,0,0,0,0,0,0,7050282,2023-12-08T00:00:00.000Z,56677869,28,Markquis Nowell,0,0,0,0,0,0
4,0,3,6,0,12,3,5,5,36,0,3,11,3,1,0,7050282,2023-12-08T00:00:00.000Z,18,28,OG Anunoby,1,14,18,15,7,23.6
1,0,0,1,0,1,0,0,0,6,0,0,0,0,0,0,7050282,2023-12-08T00:00:00.000Z,376,28,Otto Porter Jr.,0,0,1,1,1,1.5
4,0,4,1,0,15,11,4,3,33,1,2,25,5,1,1,7050282,2023-12-08T00:00:00.000Z,416,28,Pascal Siakam,1,30,34,29,9,39
1,0,6,4,3,10,7,0,0,22,4,4,17,10,0,4,7050282,2023-12-08T00:00:00.000Z,3547249,28,Precious Achiuwa,0,27,28,18,11,26.5
0,0,0,0,0,0,0,0,0,0,0,0,0,0,0,0,7050282,2023-12-08T00:00:00.000Z,489,28,Thaddeus Young,0,0,0,0,0,0
0,0,2,3,2,7,4,4,4,12,1,1,14,3,0,1,7050283,2023-12-08T00:00:00.000Z,77,9,Alec Burks,0,17,17,14,3,16.6
2,0,1,5,0,12,2,2,1,20,1,3,5,2,1,0,7050283,2023-12-08T00:00:00.000Z,56677826,9,Ausar Thompson,1,7,9,7,4,13.4
1,0,3,3,1,10,4,1,0,29,0,1,9,3,1,2,7050283,2023-12-08T00:00:00.000Z,54,9,Bojan Bogdanovic,1,12,13,10,4,15.1
6,0,2,6,2,15,8,4,3,32,0,1,21,2,1,3,7050283,2023-12-08T00:00:00.000Z,17896075,9,Cade Cunningham,1,23,29,27,8,32.4
1,0,1,3,0,5,0,0,0,12,0,2,0,1,0,0,7050283,2023-12-08T00:00:00.000Z,17896071,9,Isaiah Livers,0,1,2,1,2,2.7
3,1,6,3,1,3,1,0,0,29,1,3,3,7,0,1,7050283,2023-12-08T00:00:00.000Z,3547267,9,Isaiah Stewart,1,10,13,6,10,17.9
0,0,2,4,0,7,2,4,4,21,0,2,8,2,0,0,7050283,2023-12-08T00:00:00.000Z,38017682,9,Jaden Ivey,0,10,10,8,2,10.4
0,0,0,0,0,0,0,0,0,0,0,0,0,0,0,0,7050283,2023-12-08T00:00:00.000Z,38017694,9,Jalen Duren,0,0,0,0,0,0
0,0,3,0,0,0,0,4,2,16,2,2,2,5,0,1,7050283,2023-12-08T00:00:00.000Z,3547240,9,James Wiseman,0,7,7,2,5,7
0,0,0,0,0,0,0,0,0,0,0,0,0,0,0,0,7050283,2023-12-08T00:00:00.000Z,42097199,9,Jared Rhoden,0,0,0,0,0,0
0,1,0,0,0,1,0,0,0,4,0,0,0,0,0,0,7050283,2023-12-08T00:00:00.000Z,197,9,Joe Harris,1,0,0,0,0,3
0,0,1,0,0,0,0,0,0,5,0,0,0,1,0,1,7050283,2023-12-08T00:00:00.000Z,259,9,Kevin Knox,0,1,1,0,1,0.2
4,1,6,2,0,11,7,3,2,32,1,1,16,7,0,2,7050283,2023-12-08T00:00:00.000Z,3547241,9,Killian Hayes,1,23,27,20,11,31.4
0,0,0,0,0,0,0,0,0,0,0,0,0,0,0,0,7050283,2023-12-08T00:00:00.000Z,56677729,9,Malcolm Cazalon,0,0,0,0,0,0
1,0,0,1,0,3,2,0,0,5,0,0,4,0,0,0,7050283,2023-12-08T00:00:00.000Z,56677792,9,Marcus Sasser,0,4,5,5,1,5.5
0,0,3,0,0,7,4,2,1,23,2,1,9,5,0,4,7050283,2023-12-08T00:00:00.000Z,24,9,Marvin Bagley III,0,14,14,9,5,11
0,0,0,0,0,0,0,0,0,0,0,0,0,0,0,0,7050283,2023-12-08T00:00:00.000Z,330,9,Monte Morris,0,0,0,0,0,0
0,0,0,0,0,0,0,0,0,0,0,0,0,0,0,0,7050283,2023-12-08T00:00:00.000Z,44477024,9,Stanley Umude,0,0,0,0,0,0
0,0,2,0,0,2,1,0,0,4,0,3,2,2,0,2,7050283,2023-12-08T00:00:00.000Z,666885,22,Admiral Schofield,0,4,4,2,2,2.4
3,0,4,1,0,4,2,4,2,25,1,2,6,5,0,1,7050283,2023-12-08T00:00:00.000Z,56677827,22,Anthony Black,0,11,14,9,8,15.5
1,0,4,6,2,6,2,0,0,25,0,1,6,4,0,0,7050283,2023-12-08T00:00:00.000Z,38017724,22,Caleb Houstan,0,10,11,7,5,12.3
0,0,4,0,0,1,1,0,0,13,0,0,2,4,1,1,7050283,2023-12-08T00:00:00.000Z,666818,22,Chuma Okeke,1,6,6,2,4,8.8
6,0,3,3,1,12,6,3,3,24,0,4,16,3,0,1,7050283,2023-12-08T00:00:00.000Z,3547251,22,Cole Anthony,0,19,25,22,9,27.6
3,0,2,4,2,20,12,1,1,31,0,0,27,2,0,0,7050283,2023-12-08T00:00:00.000Z,17896026,22,Franz Wagner,0,29,32,30,5,33.9
1,0,3,5,2,8,4,1,1,23,0,3,11,3,2,1,7050283,2023-12-08T00:00:00.000Z,196,22,Gary Harris,2,14,15,12,4,21.1
2,4,4,0,0,7,6,1,1,28,4,1,13,8,0,1,7050283,2023-12-08T00:00:00.000Z,666442,22,Goga Bitadze,4,21,23,15,10,36.6
0,0,0,0,0,0,0,0,0,0,0,0,0,0,0,0,7050283,2023-12-08T00:00:00.000Z,17896073,22,Jalen Suggs,0,0,0,0,0,0
1,0,1,1,1,2,2,2,1,5,0,1,6,1,0,0,7050283,2023-12-08T00:00:00.000Z,56677839,22,Jett Howard,0,7,8,7,2,8.7
5,0,4,3,2,6,2,0,0,16,0,1,6,4,0,0,7050283,2023-12-08T00:00:00.000Z,226,22,Joe Ingles,0,10,15,11,9,18.3
0,0,0,0,0,0,0,0,0,0,0,0,0,0,0,0,7050283,2023-12-08T00:00:00.000Z,229,22,Jonathan Isaac,0,0,0,0,0,0
0,0,0,0,0,0,0,0,0,0,0,0,0,0,0,0,7050283,2023-12-08T00:00:00.000Z,38017607,22,Kevon Harris,0,0,0,0,0,0
0,0,0,0,0,0,0,0,0,0,0,0,0,0,0,0,7050283,2023-12-08T00:00:00.000Z,165,22,Markelle Fultz,0,0,0,0,0,0
2,0,4,0,0,4,2,0,0,16,1,1,4,5,0,2,7050283,2023-12-08T00:00:00.000Z,462,22,Moritz Wagner,0,9,11,6,7,11
2,0,4,3,0,17,9,7,6,30,0,3,24,4,2,0,7050283,2023-12-08T00:00:00.000Z,38017683,22,Paolo Banchero,2,28,30,26,6,37.8
0,0,0,0,0,0,0,0,0,0,0,0,0,0,0,0,7050283,2023-12-08T00:00:00.000Z,17553983,22,Trevelin Queen,0,0,0,0,0,0
0,0,0,0,0,0,0,0,0,0,0,0,0,0,0,0,7050283,2023-12-08T00:00:00.000Z,85,22,Wendell Carter Jr.,0,0,0,0,0,0
0,0,0,0,0,0,0,0,0,0,0,0,0,0,0,0,7050284,2023-12-08T00:00:00.000Z,38017689,1,AJ Griffin,0,0,0,0,0,0
2,0,8,11,3,17,7,3,3,39,1,5,20,9,1,2,7050284,2023-12-08T00:00:00.000Z,53,1,Bogdan Bogdanovic,1,29,31,22,11,34.8
0,0,0,0,0,0,0,0,0,0,0,0,0,0,0,0,7050284,2023-12-08T00:00:00.000Z,666564,1,Bruno Fernando,0,0,0,0,0,0
2,1,6,0,0,12,6,4,3,30,10,5,15,16,0,2,7050284,2023-12-08T00:00:00.000Z,83,1,Clint Capela,1,31,33,17,18,38.2
1,0,6,7,4,18,9,2,2,37,1,2,24,7,0,3,7050284,2023-12-08T00:00:00.000Z,666656,1,De'Andre Hunter,0,31,32,25,8,30.9
9,0,3,5,2,17,7,4,4,36,1,1,20,4,1,4,7050284,2023-12-08T00:00:00.000Z,334,1,Dejounte Murray,1,24,33,29,13,37.3
0,0,0,0,0,0,0,0,0,0,0,0,0,0,0,0,7050284,2023-12-08T00:00:00.000Z,17896040,1,Jalen Johnson,0,0,0,0,0,0
0,0,0,0,0,0,0,0,0,0,0,0,0,0,0,0,7050284,2023-12-08T00:00:00.000Z,56677838,1,Kobe Bufkin,0,0,0,0,0,0
0,0,0,0,0,0,0,0,0,0,0,0,0,0,0,0,7050284,2023-12-08T00:00:00.000Z,56677875,1,Miles Norris,0,0,0,0,0,0
0,0,0,0,0,0,0,0,0,0,0,0,0,0,0,0,7050284,2023-12-08T00:00:00.000Z,56677806,1,Mouhamed Gueye,0,0,0,0,0,0
2,2,4,2,0,7,3,2,1,18,4,5,7,8,0,0,7050284,2023-12-08T00:00:00.000Z,3547244,1,Onyeka Okongwu,2,15,17,9,10,25.6
2,1,1,3,1,4,1,0,0,17,0,2,3,1,1,1,7050284,2023-12-08T00:00:00.000Z,319,1,Patty Mills,2,4,6,5,3,12.2
1,0,3,9,3,20,6,1,1,38,5,1,16,8,0,0,7050284,2023-12-08T00:00:00.000Z,3547256,1,Saddiq Bey,0,24,25,17,9,27.1
0,0,0,0,0,0,0,0,0,0,0,0,0,0,0,0,7050284,2023-12-08T00:00:00.000Z,56677855,1,Seth Lundy,0,0,0,0,0,0
0,0,0,0,0,0,0,0,0,0,0,0,0,0,0,0,7050284,2023-12-08T00:00:00.000Z,490,1,Trae Young,0,0,0,0,0,0
1,0,0,0,0,5,2,2,2,12,1,2,6,1,0,1,7050284,2023-12-08T00:00:00.000Z,3547297,1,Trent Forrest,0,7,8,7,2,7.7
0,0,0,0,0,0,0,0,0,0,0,0,0,0,0,0,7050284,2023-12-08T00:00:00.000Z,17554001,23,Javonte Smart,0,0,0,0,0,0
4,0,2,3,2,4,3,0,0,29,2,1,8,4,0,0,7050284,2023-12-08T00:00:00.000Z,33,23,Nicolas Batum,0,12,16,12,8,18.8
0,0,0,0,0,0,0,0,0,0,0,0,0,0,0,0,7050284,2023-12-08T00:00:00.000Z,56913527,23,Ricky Council IV,0,0,0,0,0,0
0,0,0,0,0,0,0,0,0,0,0,0,0,0,0,0,7050284,2023-12-08T00:00:00.000Z,56677788,23,Terquavion Smith,0,0,0,0,0,0
0,0,0,0,0,0,0,0,0,0,0,0,0,0,0,0,7050285,2023-12-08T00:00:00.000Z,9051997,3,Armoni Brooks,0,0,0,0,0,0
0,0,0,0,0,0,0,0,0,0,0,0,0,0,0,0,7050285,2023-12-08T00:00:00.000Z,417,3,Ben Simmons,0,0,0,0,0,0
0,0,3,5,1,8,3,0,0,25,2,3,7,5,0,1,7050285,2023-12-08T00:00:00.000Z,666679,3,Cameron Johnson,0,12,12,7,5,12
0,0,0,0,0,0,0,0,0,0,0,0,0,0,0,0,7050285,2023-12-08T00:00:00.000Z,56677841,3,Dariq Whitehead,0,0,0,0,0,0
0,0,0,0,0,0,0,0,0,0,0,0,0,0,0,0,7050285,2023-12-08T00:00:00.000Z,56677722,3,Jalen Wilson,0,0,0,0,0,0
0,0,0,0,0,0,0,0,0,0,0,0,0,0,0,0,7050285,2023-12-08T00:00:00.000Z,17896041,3,Keon Johnson,0,0,0,0,0,0
3,2,3,3,2,15,9,1,1,31,1,0,21,4,0,2,7050285,2023-12-08T00:00:00.000Z,61,3,Mikal Bridges,2,25,28,24,7,34.3
0,0,0,0,0,0,0,0,0,0,0,0,0,0,0,0,7050285,2023-12-08T00:00:00.000Z,56677843,3,Noah Clowney,0,0,0,0,0,0
0,0,0,1,0,4,1,0,0,4,3,1,2,3,0,0,7050285,2023-12-08T00:00:00.000Z,3547302,30,Anthony Gill,0,5,5,2,3,5.6
2,0,6,2,1,6,4,4,2,25,4,3,11,10,0,2,7050285,2023-12-08T00:00:00.000Z,56677844,30,Bilal Coulibaly,0,21,23,13,12,24
2,1,2,7,1,11,3,0,0,21,0,2,7,2,0,0,7050285,2023-12-08T00:00:00.000Z,17896045,30,Corey Kispert,1,9,11,9,4,15.4
1,0,2,5,0,9,2,0,0,19,0,3,4,2,0,0,7050285,2023-12-08T00:00:00.000Z,167,30,Danilo Gallinari,0,6,7,5,3,7.9
0,0,0,0,0,0,0,0,0,0,0,0,0,0,0,0,7050285,2023-12-08T00:00:00.000Z,487,30,Delon Wright,0,0,0,0,0,0
4,2,7,4,1,9,6,3,2,27,0,1,15,7,1,0,7050285,2023-12-08T00:00:00.000Z,3547242,30,Deni Avdija,3,22,26,19,11,38.4
0,1,1,1,0,2,1,1,1,4,0,0,3,1,0,1,7050285,2023-12-08T00:00:00.000Z,17896106,30,Eugene Omoruyi,1,4,4,3,1,6.2
0,0,3,2,0,4,1,4,3,14,0,1,5,3,0,3,7050285,2023-12-08T00:00:00.000Z,18677954,30,Jared Butler,0,8,8,5,3,5.6
0,0,0,0,0,0,0,0,0,0,0,0,0,0,0,0,7050285,2023-12-08T00:00:00.000Z,38017687,30,Johnny Davis,0,0,0,0,0,0
2,0,2,4,1,17,8,1,0,30,1,2,17,3,0,3,7050285,2023-12-08T00:00:00.000Z,265,30,Kyle Kuzma,0,20,22,19,5,20.6
0,0,0,0,0,0,0,0,0,0,0,0,0,0,0,0,7050285,2023-12-08T00:00:00.000Z,414,30,Landry Shamet,0,0,0,0,0,0
0,0,0,3,2,3,2,2,2,15,0,1,8,0,1,1,7050285,2023-12-08T00:00:00.000Z,337,30,Mike Muscala,1,8,8,8,0,10
0,0,2,0,0,3,0,0,0,4,2,1,0,4,0,0,7050285,2023-12-08T00:00:00.000Z,38017704,30,Patrick Baldwin Jr.,0,4,4,0,4,4.8
0,0,0,0,0,0,0,0,0,0,0,0,0,0,0,0,7050285,2023-12-08T00:00:00.000Z,38017712,30,Ryan Rollins,0,0,0,0,0,0
3,1,2,1,0,10,6,2,2,28,0,0,14,2,1,1,7050285,2023-12-08T00:00:00.000Z,249,30,Tyus Jones,2,16,19,17,5,25.9
0,0,0,0,0,0,0,0,0,0,0,0,0,0,0,0,7050286,2023-12-08T00:00:00.000Z,277,6,Caris LeVert,0,0,0,0,0,0
0,0,0,0,0,0,0,0,0,0,0,0,0,0,0,0,7050286,2023-12-08T00:00:00.000Z,17896076,6,Evan Mobley,0,0,0,0,0,0
0,0,0,0,0,0,0,0,0,0,0,0,0,0,0,0,7050286,2023-12-08T00:00:00.000Z,404,6,Ricky Rubio,0,0,0,0,0,0
0,0,0,0,0,0,0,0,0,0,0,0,0,0,0,0,7050286,2023-12-08T00:00:00.000Z,38017736,16,Cole Swider,0,0,0,0,0,0
0,0,0,0,0,0,0,0,0,0,0,0,0,0,0,0,7050286,2023-12-08T00:00:00.000Z,38017734,16,Jamal Cain,0,0,0,0,0,0
0,0,0,0,0,0,0,0,0,0,0,0,0,0,0,0,7050286,2023-12-08T00:00:00.000Z,38017696,16,Nikola Jovic,0,0,0,0,0,0
2,0,3,0,0,2,1,0,0,20,0,4,2,3,0,0,7050287,2023-12-08T00:00:00.000Z,48,15,Bismack Biyombo,0,5,7,4,5,8.6
0,0,0,0,0,0,0,0,0,0,0,0,0,0,0,0,7050287,2023-12-08T00:00:00.000Z,666505,15,Brandon Clarke,0,0,0,0,0,0
0,0,3,4,1,11,6,0,0,25,0,0,13,3,0,0,7050287,2023-12-08T00:00:00.000Z,38017729,15,David Roddy,0,16,16,13,3,16.6
7,0,1,1,0,7,2,2,2,22,0,1,6,1,0,1,7050287,2023-12-08T00:00:00.000Z,401,15,Derrick Rose,0,7,14,13,8,16.7
1,1,2,6,4,13,6,0,0,37,0,5,16,2,0,4,7050287,2023-12-08T00:00:00.000Z,3547287,15,Desmond Bane,1,18,19,17,3,18.9
0,0,0,0,0,0,0,0,0,0,0,0,0,0,0,0,7050287,2023-12-08T00:00:00.000Z,56677830,15,GG Jackson,0,0,0,0,0,0
0,0,0,0,0,0,0,0,0,0,0,0,0,0,0,0,7050287,2023-12-08T00:00:00.000Z,666786,15,Ja Morant,0,0,0,0,0,0
2,0,0,1,0,1,0,0,0,4,0,0,0,0,0,0,7050287,2023-12-08T00:00:00.000Z,48248287,15,Jacob Gilyard,0,0,2,2,2,3
0,0,0,0,0,0,0,0,0,0,0,0,0,0,0,0,7050287,2023-12-08T00:00:00.000Z,38017728,15,Jake LaRavia,0,0,0,0,0,0
1,1,1,4,3,14,7,4,4,29,1,5,21,2,1,2,7050287,2023-12-08T00:00:00.000Z,231,15,Jaren Jackson Jr.,2,23,24,22,3,28.9
2,0,0,4,2,6,3,0,0,20,0,4,8,0,0,1,7050287,2023-12-08T00:00:00.000Z,666809,15,Jaylen Nowell,0,8,10,10,2,10
0,1,3,4,1,5,1,0,0,17,0,1,3,3,1,0,7050287,2023-12-08T00:00:00.000Z,666703,15,John Konchar,2,6,6,3,3,12.6
2,0,0,2,1,3,1,2,2,4,0,0,5,0,1,0,7050287,2023-12-08T00:00:00.000Z,38017732,15,Kenneth Lofton Jr.,1,5,7,7,2,11
0,0,0,0,0,0,0,0,0,0,0,0,0,0,0,0,7050287,2023-12-08T00:00:00.000Z,254,15,Luke Kennard,0,0,0,0,0,0
0,0,0,0,0,0,0,0,0,0,0,0,0,0,0,0,7050287,2023-12-08T00:00:00.000Z,420,15,Marcus Smart,0,0,0,0,0,0
6,1,6,3,1,8,2,6,4,24,4,1,9,10,0,0,7050287,2023-12-08T00:00:00.000Z,17896067,15,Santi Aldama,1,19,25,15,16,33
0,0,0,0,0,0,0,0,0,0,0,0,0,0,0,0,7050287,2023-12-08T00:00:00.000Z,3,15,Steven Adams,0,0,0,0,0,0
0,0,0,2,1,8,5,3,1,17,2,1,12,2,4,0,7050287,2023-12-08T00:00:00.000Z,3547285,15,Xavier Tillman,4,14,14,12,2,26.4
0,0,0,0,0,3,2,0,0,4,0,0,4,0,0,0,7050287,2023-12-08T00:00:00.000Z,17896027,15,Ziaire Williams,0,4,4,4,0,4
0,0,0,0,0,0,0,0,0,0,0,0,0,0,0,0,7050287,2023-12-08T00:00:00.000Z,17895968,18,Daishen Nix,0,0,0,0,0,0
0,0,0,0,0,0,0,0,0,0,0,0,0,0,0,0,7050287,2023-12-08T00:00:00.000Z,3547259,18,Jaden McDaniels,0,0,0,0,0,0
0,0,0,0,0,0,0,0,0,0,0,0,0,0,0,0,7050287,2023-12-08T00:00:00.000Z,56677851,18,Jaylen Clark,0,0,0,0,0,0
0,0,0,0,0,0,0,0,0,0,0,0,0,0,0,0,7050287,2023-12-08T00:00:00.000Z,38017715,18,Josh Minott,0,0,0,0,0,0
0,0,0,0,0,0,0,0,0,0,0,0,0,0,0,0,7050287,2023-12-08T00:00:00.000Z,56677782,18,Leonard Miller,0,0,0,0,0,0
2,1,0,8,4,9,4,2,2,34,2,2,14,2,0,2,7050287,2023-12-08T00:00:00.000Z,666400,18,Nickeil Alexander-Walker,1,16,18,16,4,20.4
1,0,0,1,0,1,0,0,0,4,0,0,0,0,0,0,7050287,2023-12-08T00:00:00.000Z,38017700,18,Wendell Moore Jr.,0,0,1,1,1,1.5
1,0,4,4,2,11,4,2,2,32,2,3,12,6,0,6,7050288,2023-12-08T00:00:00.000Z,475,10,Andrew Wiggins,0,18,19,13,7,14.7
4,0,1,4,1,11,5,1,1,23,5,2,12,6,1,1,7050288,2023-12-08T00:00:00.000Z,56677858,10,Brandin Podziemski,1,18,22,16,10,27.2
0,0,0,0,0,0,0,0,0,0,0,0,0,0,0,0,7050288,2023-12-08T00:00:00.000Z,367,10,Chris Paul,0,0,0,0,0,0
3,0,1,1,0,3,1,0,0,13,0,0,2,1,0,0,7050288,2023-12-08T00:00:00.000Z,251,10,Cory Joseph,0,3,6,5,4,7.7
3,0,6,6,2,8,3,4,3,22,5,2,11,11,1,3,7050288,2023-12-08T00:00:00.000Z,407,10,Dario Saric,1,22,25,14,14,28.7
13,1,4,2,1,7,5,2,1,35,1,6,12,5,0,4,7050288,2023-12-08T00:00:00.000Z,185,10,Draymond Green,1,17,30,25,18,36.5
0,0,0,0,0,0,0,0,0,0,0,0,0,0,0,0,7050288,2023-12-08T00:00:00.000Z,2189,10,Gary Payton II,0,0,0,0,0,0
0,0,0,0,0,0,0,0,0,0,0,0,0,0,0,0,7050288,2023-12-08T00:00:00.000Z,57875092,10,Gui Santos,0,0,0,0,0,0
0,0,0,0,0,0,0,0,0,0,0,0,0,0,0,0,7050288,2023-12-08T00:00:00.000Z,398,10,Jerome Robinson,0,0,0,0,0,0
0,0,6,6,3,21,10,1,1,29,6,6,24,12,0,3,7050288,2023-12-08T00:00:00.000Z,17553979,10,Jonathan Kuminga,0,36,36,24,12,35.4
2,0,3,0,0,2,2,3,1,16,1,1,5,4,0,2,7050288,2023-12-08T00:00:00.000Z,282,10,Kevon Looney,0,9,11,7,6,10.8
0,1,3,9,4,15,8,2,2,39,1,4,22,4,0,4,7050288,2023-12-08T00:00:00.000Z,443,10,Klay Thompson,1,26,26,22,4,25.8
0,0,0,0,0,0,0,0,0,0,0,0,0,0,0,0,7050288,2023-12-08T00:00:00.000Z,45658838,10,Lester Quinones,0,0,0,0,0,0
0,0,2,3,0,5,1,0,0,16,2,4,2,4,0,2,7050288,2023-12-08T00:00:00.000Z,17553992,10,Moses Moody,0,6,6,2,4,4.8
3,0,6,12,6,20,10,8,8,40,0,0,34,6,1,3,7050288,2023-12-08T00:00:00.000Z,115,10,Stephen Curry,1,40,43,37,9,45.7
0,0,0,0,0,0,0,0,0,0,0,0,0,0,0,0,7050288,2023-12-08T00:00:00.000Z,56677799,10,Trayce Jackson-Davis,0,0,0,0,0,0
0,0,0,0,0,0,0,0,0,0,0,0,0,0,0,0,7050288,2023-12-08T00:00:00.000Z,17896070,10,Usman Garuba,0,0,0,0,0,0
1,0,2,2,1,5,4,0,0,22,1,2,9,3,2,1,7050288,2023-12-08T00:00:00.000Z,17896078,21,Aaron Wiggins,2,12,13,10,4,19.1
0,0,0,0,0,0,0,0,0,0,0,0,0,0,0,0,7050288,2023-12-08T00:00:00.000Z,3547271,21,Aleksej Pokusevski,0,0,0,0,0,0
0,0,0,0,0,0,0,0,0,1,0,0,0,0,0,0,7050288,2023-12-08T00:00:00.000Z,44,21,Davis Bertans,0,0,0,0,0,0
2,1,5,1,1,15,12,4,3,40,0,3,28,5,3,1,7050288,2023-12-08T00:00:00.000Z,38017703,21,Jalen Williams,4,33,35,30,7,48
0,0,2,3,0,4,1,0,0,9,0,1,2,2,0,0,7050288,2023-12-08T00:00:00.000Z,480,21,Kenrich Williams,0,4,4,2,2,4.4
0,0,0,0,0,0,0,0,0,0,0,0,0,0,0,0,7050288,2023-12-08T00:00:00.000Z,56677853,21,Keyontae Johnson,0,0,0,0,0,0
0,0,0,0,0,0,0,0,0,0,0,0,0,0,0,0,7050288,2023-12-08T00:00:00.000Z,27924547,21,Lindy Waters III,0,0,0,0,0,0
1,1,1,3,0,9,4,8,8,39,4,4,16,5,0,1,7050288,2023-12-08T00:00:00.000Z,666541,21,Luguentz Dort,1,21,22,17,6,25.5
0,0,0,0,0,0,0,0,0,0,0,0,0,0,0,0,7050288,2023-12-08T00:00:00.000Z,24572055,21,Olivier Sarr,0,0,0,0,0,0
0,0,0,0,0,0,0,0,0,0,0,0,0,0,0,0,7050288,2023-12-08T00:00:00.000Z,38017716,21,Ousmane Dieng,0,0,0,0,0,0
0,0,0,0,0,0,0,0,0,0,0,0,0,0,0,0,7050288,2023-12-08T00:00:00.000Z,17896036,21,Tre Mann,0,0,0,0,0,0
0,0,0,0,0,0,0,0,0,0,0,0,0,0,0,0,7050288,2023-12-08T00:00:00.000Z,4197029,21,Vasilije Micic,0,0,0,0,0,0
0,0,0,0,0,0,0,0,0,0,0,0,0,0,0,0,7050289,2023-12-08T00:00:00.000Z,56677860,5,Adama Sanogo,0,0,0,0,0,0
2,0,2,2,0,5,2,0,0,18,1,2,4,3,1,2,7050289,2023-12-08T00:00:00.000Z,89,5,Alex Caruso,1,7,9,6,5,11.6
0,0,2,0,0,7,3,4,1,12,6,2,7,8,0,0,7050289,2023-12-08T00:00:00.000Z,137,5,Andre Drummond,0,15,15,7,8,16.6
3,0,3,2,0,5,2,0,0,26,0,1,4,3,1,0,7050289,2023-12-08T00:00:00.000Z,17895983,5,Ayo Dosunmu,1,7,10,7,6,15.1
6,0,4,7,5,15,9,1,1,39,0,0,24,4,1,3,7050289,2023-12-08T00:00:00.000Z,666956,5,Coby White,1,28,34,30,10,37.8
0,0,0,0,0,0,0,0,0,0,0,0,0,0,0,0,7050289,2023-12-08T00:00:00.000Z,38017719,5,Dalen Terry,0,0,0,0,0,0
10,0,5,2,0,24,7,10,6,39,1,2,20,6,3,2,7050289,2023-12-08T00:00:00.000Z,125,5,DeMar DeRozan,3,26,36,30,16,49.2
1,0,0,3,1,4,1,0,0,9,0,2,3,0,0,0,7050289,2023-12-08T00:00:00.000Z,87,5,Jevon Carter,0,3,4,4,1,4.5
0,0,1,0,0,1,1,0,0,4,1,2,2,2,0,0,7050289,2023-12-08T00:00:00.000Z,56677857,5,Julian Phillips,0,4,4,2,2,4.4
0,0,0,0,0,0,0,0,0,0,0,0,0,0,0,0,7050289,2023-12-08T00:00:00.000Z,45969255,5,Justin Lewis,0,0,0,0,0,0
0,0,0,0,0,0,0,0,0,0,0,0,0,0,0,0,7050289,2023-12-08T00:00:00.000Z,27,5,Lonzo Ball,0,0,0,0,0,0
2,1,6,2,0,22,9,3,3,36,10,2,21,16,0,0,7050289,2023-12-08T00:00:00.000Z,460,5,Nikola Vucevic,1,37,39,23,18,46.2
0,0,0,0,0,0,0,0,0,0,0,0,0,0,0,0,7050289,2023-12-08T00:00:00.000Z,56677874,5,Onuralp Bitim,0,0,0,0,0,0
3,1,5,3,2,11,8,4,2,34,1,3,20,6,1,0,7050289,2023-12-08T00:00:00.000Z,3547248,5,Patrick Williams,2,26,29,23,9,37.7
0,0,0,0,0,0,0,0,0,0,0,0,0,0,0,0,7050289,2023-12-08T00:00:00.000Z,17896116,5,Terry Taylor,0,0,0,0,0,0
0,0,4,7,5,8,5,2,1,23,4,3,16,8,2,0,7050289,2023-12-08T00:00:00.000Z,110,5,Torrey Craig,2,24,24,16,8,31.6
0,0,0,0,0,0,0,0,0,0,0,0,0,0,0,0,7050289,2023-12-08T00:00:00.000Z,268,5,Zach LaVine,0,0,0,0,0,0
0,0,0,0,0,0,0,0,0,0,0,0,0,0,0,0,7050289,2023-12-08T00:00:00.000Z,56677865,27,Charles Bediako,0,0,0,0,0,0
0,0,0,0,0,0,0,0,0,0,0,0,0,0,0,0,7050289,2023-12-08T00:00:00.000Z,56677817,27,Sidy Cissoko,0,0,0,0,0,0
0,0,0,0,0,0,0,0,0,0,0,0,0,0,0,0,7050289,2023-12-08T00:00:00.000Z,56677870,27,Sir'Jabari Rice,0,0,0,0,0,0
3,0,5,2,0,5,1,5,1,22,1,1,3,6,0,1,7050290,2023-12-08T00:00:00.000Z,177,8,Aaron Gordon,0,9,12,6,9,13.7
0,0,0,0,0,0,0,0,0,0,0,0,0,0,0,0,7050290,2023-12-08T00:00:00.000Z,17896007,8,Braxton Key,0,0,0,0,0,0
1,0,1,2,0,4,1,0,0,14,0,3,2,1,2,1,7050290,2023-12-08T00:00:00.000Z,38017709,8,Christian Braun,2,3,4,3,2,9.7
0,0,0,0,0,0,0,0,0,0,0,0,0,0,0,0,7050290,2023-12-08T00:00:00.000Z,38017727,8,Collin Gillespie,0,0,0,0,0,0
2,0,3,0,0,2,1,0,0,12,1,2,2,4,1,1,7050290,2023-12-08T00:00:00.000Z,250,8,DeAndre Jordan,1,6,8,4,6,11.8
0,0,0,0,0,0,0,0,0,0,0,0,0,0,0,0,7050290,2023-12-08T00:00:00.000Z,56677871,8,Hunter Tyson,0,0,0,0,0,0
0,0,0,0,0,0,0,0,0,0,0,0,0,0,0,0,7050290,2023-12-08T00:00:00.000Z,56677582,8,Jalen Pickett,0,0,0,0,0,0
3,0,5,8,4,17,6,5,5,32,0,2,21,5,0,1,7050290,2023-12-08T00:00:00.000Z,335,8,Jamal Murray,0,26,29,24,8,30.5
0,0,0,0,0,0,0,0,0,4,0,1,0,0,0,0,7050290,2023-12-08T00:00:00.000Z,56677776,8,Julian Strawther,0,0,0,0,0,0
0,0,0,0,0,1,1,0,0,6,0,1,2,0,1,0,7050290,2023-12-08T00:00:00.000Z,215,8,Justin Holiday,1,2,2,2,0,5
0,1,0,3,2,6,5,2,2,25,0,1,14,0,0,0,7050290,2023-12-08T00:00:00.000Z,81,8,Kentavious Caldwell-Pope,1,14,14,14,0,17
0,2,7,6,3,12,8,1,1,40,1,3,20,8,0,2,7050290,2023-12-08T00:00:00.000Z,375,8,Michael Porter Jr.,2,28,28,20,8,33.6
5,2,9,2,1,26,9,7,4,34,7,5,23,16,0,3,7050290,2023-12-08T00:00:00.000Z,246,8,Nikola Jokic,2,39,44,28,21,52.7
2,0,3,1,0,9,4,5,5,26,1,3,13,4,0,1,7050290,2023-12-08T00:00:00.000Z,38017721,8,Peyton Watson,0,17,19,15,6,19.8
6,0,2,4,0,8,2,2,2,25,1,2,6,3,0,0,7050290,2023-12-08T00:00:00.000Z,236,8,Reggie Jackson,0,9,15,12,9,18.6
0,0,0,0,0,0,0,0,0,0,0,0,0,0,0,0,7050290,2023-12-08T00:00:00.000Z,666489,8,Vlatko Cancar,0,0,0,0,0,0
0,0,0,0,0,0,0,0,0,0,0,0,0,0,0,0,7050290,2023-12-08T00:00:00.000Z,3547268,8,Zeke Nnaji,0,0,0,0,0,0
7,1,8,1,0,14,7,5,3,34,2,3,17,10,0,1,7050290,2023-12-08T00:00:00.000Z,17896062,11,Alperen Sengun,1,27,34,24,17,41.5
0,0,0,0,0,0,0,0,0,0,0,0,0,0,0,0,7050290,2023-12-08T00:00:00.000Z,56677825,11,Amen Thompson,0,0,0,0,0,0
0,0,0,0,0,0,0,0,0,0,0,0,0,0,0,0,7050290,2023-12-08T00:00:00.000Z,56677831,11,Cam Whitmore,0,0,0,0,0,0
1,0,4,10,4,12,6,0,0,33,1,5,16,5,2,3,7050290,2023-12-08T00:00:00.000Z,66,11,Dillon Brooks,2,21,22,17,6,26.5
3,1,3,10,4,17,6,13,10,40,2,3,26,5,0,1,7050290,2023-12-08T00:00:00.000Z,458,11,Fred VanVleet,1,31,34,29,8,38.5
5,0,6,2,0,9,3,4,3,25,4,1,9,10,0,1,7050290,2023-12-08T00:00:00.000Z,38017684,11,Jabari Smith Jr.,0,19,24,14,15,27.5
1,0,3,9,2,17,8,9,7,35,0,0,25,3,0,1,7050290,2023-12-08T00:00:00.000Z,17895966,11,Jalen Green,0,28,29,26,4,29.1
0,0,0,0,0,0,0,0,0,0,0,0,0,0,0,0,7050290,2023-12-08T00:00:00.000Z,56677809,11,Jermaine Samuels Jr.,0,0,0,0,0,0
0,0,0,0,0,0,0,0,0,0,0,0,0,0,0,0,7050290,2023-12-08T00:00:00.000Z,19465326,11,Jock Landale,0,0,0,0,0,0
0,0,0,0,0,0,0,0,0,0,0,0,0,0,0,0,7050290,2023-12-08T00:00:00.000Z,3547281,11,Nate Hinton,0,0,0,0,0,0
0,0,0,0,0,0,0,0,0,0,0,0,0,0,0,0,7050290,2023-12-08T00:00:00.000Z,357,11,Victor Oladipo,0,0,0,0,0,0
0,0,0,0,0,0,0,0,0,0,0,0,0,0,0,0,7050291,2023-12-08T00:00:00.000Z,666511,13,Amir Coffey,0,0,0,0,0,0
3,2,7,0,0,15,9,0,0,42,5,5,18,12,0,1,7050291,2023-12-08T00:00:00.000Z,493,13,Ivica Zubac,2,30,33,21,15,41.9
8,1,7,6,2,8,2,7,6,34,0,2,12,7,0,2,7050291,2023-12-08T00:00:00.000Z,192,13,James Harden,1,19,27,20,15,33.4
5,1,2,8,6,23,14,7,7,38,3,1,41,5,0,2,7050291,2023-12-08T00:00:00.000Z,274,13,Kawhi Leonard,1,46,51,46,10,55.5
1,1,1,0,0,2,0,2,1,14,2,3,1,3,0,0,7050291,2023-12-08T00:00:00.000Z,56677849,13,Kobe Brown,1,4,5,2,4,9.1
0,0,0,0,0,0,0,0,0,0,0,0,0,0,0,0,7050291,2023-12-08T00:00:00.000Z,17896031,13,Nah'Shon Hyland,0,0,0,0,0,0
1,0,1,8,2,11,4,0,0,28,0,0,10,1,0,1,7050291,2023-12-08T00:00:00.000Z,380,13,Norman Powell,0,11,12,11,2,11.7
2,1,3,5,2,13,8,3,2,37,0,2,20,3,6,1,7050291,2023-12-08T00:00:00.000Z,172,13,Paul George,7,23,25,22,5,46.6
1,1,3,5,2,9,4,2,0,30,1,3,10,4,1,2,7050291,2023-12-08T00:00:00.000Z,666743,13,Terance Mann,2,14,15,11,5,20.3
0,0,0,0,0,0,0,0,0,0,0,0,0,0,0,0,7050291,2023-12-08T00:00:00.000Z,56677842,29,Brice Sensabaugh,0,0,0,0,0,0
3,0,3,4,1,12,5,2,2,18,0,2,13,3,1,1,7050291,2023-12-08T00:00:00.000Z,413,29,Collin Sexton,1,16,19,16,6,23.1
2,4,10,5,1,12,7,5,5,35,3,1,20,13,2,2,7050291,2023-12-08T00:00:00.000Z,101,29,John Collins,6,33,35,22,15,54.6
0,0,0,0,0,0,0,0,0,0,0,0,0,0,0,0,7050291,2023-12-08T00:00:00.000Z,38017630,29,Johnny Juzang,0,0,0,0,0,0
5,0,3,3,0,9,2,3,2,28,1,2,6,4,1,1,7050291,2023-12-08T00:00:00.000Z,100,29,Jordan Clarkson,1,10,15,11,9,20.3
0,0,0,0,0,0,0,0,0,0,0,0,0,0,0,0,7050291,2023-12-08T00:00:00.000Z,17896023,29,Josh Christopher,0,0,0,0,0,0
2,0,4,1,1,5,4,4,4,18,0,3,13,4,1,0,7050291,2023-12-08T00:00:00.000Z,358,29,Kelly Olynyk,1,17,19,15,6,23.8
3,0,0,5,2,11,5,5,3,28,0,1,15,0,1,1,7050291,2023-12-08T00:00:00.000Z,56677834,29,Keyonte George,1,15,18,18,3,21.5
0,0,0,0,0,0,0,0,0,0,0,0,0,0,0,0,7050291,2023-12-08T00:00:00.000Z,139,29,Kris Dunn,0,0,0,0,0,0
0,0,0,0,0,0,0,0,0,0,0,0,0,0,0,0,7050291,2023-12-08T00:00:00.000Z,297,29,Lauri Markkanen,0,0,0,0,0,0
0,0,0,0,0,0,0,0,0,0,0,0,0,0,0,0,7050291,2023-12-08T00:00:00.000Z,666881,29,Luka Samanic,0,0,0,0,0,0
0,0,0,0,0,0,0,0,0,0,0,0,0,0,0,0,7050291,2023-12-08T00:00:00.000Z,19465584,29,Micah Potter,0,0,0,0,0,0
0,0,1,2,1,4,2,0,0,17,0,2,5,1,0,1,7050291,2023-12-08T00:00:00.000Z,38017620,29,Ochai Agbaji,0,6,6,5,1,5.2
0,0,0,0,0,0,0,0,0,0,0,0,0,0,0,0,7050291,2023-12-08T00:00:00.000Z,11891374,29,Omer Yurtseven,0,0,0,0,0,0
0,0,2,5,2,8,3,2,0,31,0,4,8,2,0,2,7050291,2023-12-08T00:00:00.000Z,38017739,29,Simone Fontecchio,0,10,10,8,2,8.4
5,1,1,4,1,11,6,3,2,22,0,0,15,1,1,2,7050291,2023-12-08T00:00:00.000Z,666650,29,Talen Horton-Tucker,2,16,21,20,6,27.7
0,0,0,2,0,3,0,0,0,12,0,0,0,0,1,1,7050291,2023-12-08T00:00:00.000Z,56677824,29,Taylor Hendricks,1,0,0,0,0,2
3,4,8,0,0,9,4,0,0,31,4,2,8,12,2,2,7050291,2023-12-08T00:00:00.000Z,38017705,29,Walker Kessler,6,20,23,11,15,42.9
8,0,3,10,4,21,10,6,6,36,2,4,30,5,1,6,7050292,2023-12-08T00:00:00.000Z,419,25,Anfernee Simons,1,35,43,38,13,45
0,0,0,0,0,0,0,0,0,0,0,0,0,0,0,0,7050292,2023-12-08T00:00:00.000Z,22,25,Deandre Ayton,0,0,0,0,0,0
1,0,4,6,2,9,4,0,0,21,2,4,10,6,2,1,7050292,2023-12-08T00:00:00.000Z,56783340,25,Duop Reath,2,16,17,11,7,23.7
0,0,0,0,0,0,0,0,0,0,0,0,0,0,0,0,7050292,2023-12-08T00:00:00.000Z,39613724,25,Ibou Badji,0,0,0,0,0,0
2,0,2,3,1,10,3,3,3,27,1,2,10,3,0,0,7050292,2023-12-08T00:00:00.000Z,38017711,25,Jabari Walker,0,13,15,12,5,16.6
0,0,0,0,0,0,0,0,0,0,0,0,0,0,0,0,7050292,2023-12-08T00:00:00.000Z,182,25,Jerami Grant,0,0,0,0,0,0
0,0,0,0,0,0,0,0,0,8,0,1,0,0,0,0,7050292,2023-12-08T00:00:00.000Z,47957121,25,Justin Minaya,0,0,0,0,0,0
0,0,4,3,1,6,2,0,0,18,1,0,5,5,1,0,7050292,2023-12-08T00:00:00.000Z,56677791,25,Kris Murray,1,10,10,5,5,14
0,0,0,0,0,0,0,0,0,0,0,0,0,0,0,0,7050292,2023-12-08T00:00:00.000Z,65,25,Malcolm Brogdon,0,0,0,0,0,0
1,1,5,5,3,7,3,0,0,36,3,0,9,8,3,2,7050292,2023-12-08T00:00:00.000Z,666923,25,Matisse Thybulle,4,17,18,10,9,30.1
0,0,0,0,0,0,0,0,0,0,0,0,0,0,0,0,7050292,2023-12-08T00:00:00.000Z,666476,25,Moses Brown,0,0,0,0,0,0
0,0,0,0,0,0,0,0,0,0,0,0,0,0,0,0,7050292,2023-12-08T00:00:00.000Z,56677829,25,Rayan Rupert,0,0,0,0,0,0
3,0,2,6,0,17,4,3,2,30,1,4,10,3,0,4,7050292,2023-12-08T00:00:00.000Z,56677747,25,Scoot Henderson,0,13,16,13,6,14.1
5,0,7,10,5,15,7,6,5,32,2,4,24,9,1,2,7050292,2023-12-08T00:00:00.000Z,38017690,25,Shaedon Sharpe,1,33,38,29,14,43.3
0,0,0,0,0,0,0,0,0,0,0,0,0,0,0,0,7050292,2023-12-08T00:00:00.000Z,3547289,25,Skylar Mays,0,0,0,0,0,0
0,0,3,10,2,20,6,0,0,32,6,5,14,9,1,0,7050292,2023-12-08T00:00:00.000Z,56677850,25,Toumani Camara,1,23,23,14,9,27.8
2,0,8,6,3,8,5,1,1,27,2,1,14,10,0,2,7981426,2023-12-08T00:00:00.000Z,219,2,Al Horford,0,24,26,16,12,27
0,0,0,0,0,0,0,0,0,1,0,0,0,0,0,0,7981426,2023-12-08T00:00:00.000Z,17896094,2,Dalano Banton,0,0,0,0,0,0
3,2,1,10,6,16,10,4,4,32,2,4,30,3,2,0,7981426,2023-12-08T00:00:00.000Z,473,2,Derrick White,4,33,36,33,6,50.1
4,1,0,5,2,13,7,1,1,27,0,5,17,0,1,2,7981426,2023-12-08T00:00:00.000Z,70,2,Jaylen Brown,2,17,21,21,4,27
5,0,6,9,3,18,8,8,6,38,0,3,25,6,1,0,7981426,2023-12-08T00:00:00.000Z,434,2,Jayson Tatum,1,31,36,30,11,42.7
0,0,0,0,0,0,0,0,0,0,0,0,0,0,0,0,7981426,2023-12-08T00:00:00.000Z,38017707,2,JD Davison,0,0,0,0,0,0
0,0,0,0,0,0,0,0,0,0,0,0,0,0,0,0,7981426,2023-12-08T00:00:00.000Z,56677864,2,Jordan Walsh,0,0,0,0,0,0
5,1,6,3,1,11,7,1,1,35,0,1,16,6,2,1,7981426,2023-12-08T00:00:00.000Z,214,2,Jrue Holiday,3,22,27,21,11,38.7
1,0,2,6,3,13,7,4,4,29,1,2,21,3,2,2,7981426,2023-12-08T00:00:00.000Z,378,2,Kristaps Porzingis,2,24,25,22,4,30.1
0,0,0,0,0,0,0,0,0,0,0,0,0,0,0,0,7981426,2023-12-08T00:00:00.000Z,3547279,2,Lamar Stevens,0,0,0,0,0,0
1,0,0,0,0,3,2,0,0,11,1,0,4,1,0,0,7981426,2023-12-08T00:00:00.000Z,261,2,Luke Kornet,0,5,6,5,2,6.7
0,0,0,0,0,0,0,0,0,0,0,0,0,0,0,0,7981426,2023-12-08T00:00:00.000Z,3547295,2,Nathan Knight,0,0,0,0,0,0
0,0,0,0,0,0,0,0,0,0,0,0,0,0,0,0,7981426,2023-12-08T00:00:00.000Z,17553967,2,Neemias Queta,0,0,0,0,0,0
0,0,0,0,0,0,0,0,0,1,0,0,0,0,0,0,7981426,2023-12-08T00:00:00.000Z,666468,2,Oshae Brissett,0,0,0,0,0,0
2,0,1,3,1,4,2,0,0,18,1,2,5,2,0,0,7981426,2023-12-08T00:00:00.000Z,3547276,2,Payton Pritchard,0,7,9,7,4,10.4
1,1,2,5,0,5,0,2,1,21,1,1,1,3,0,0,7981426,2023-12-08T00:00:00.000Z,17896060,2,Sam Hauser,1,4,5,2,4,9.1
0,0,0,0,0,0,0,0,0,0,0,0,0,0,0,0,7981426,2023-12-08T00:00:00.000Z,338,2,Svi Mykhailiuk,0,0,0,0,0,0
0,0,0,0,0,0,0,0,0,0,0,0,0,0,0,0,7981426,2023-12-08T00:00:00.000Z,666474,20,Charles Brown,0,0,0,0,0,0
0,0,0,0,0,0,0,0,0,0,0,0,0,0,0,0,7981426,2023-12-08T00:00:00.000Z,666675,20,DaQuan Jeffries,0,0,0,0,0,0
2,0,4,5,2,6,2,0,0,22,0,2,6,4,0,1,7981426,2023-12-08T00:00:00.000Z,131,20,Donte DiVincenzo,0,10,12,8,6,12.8
0,0,0,0,0,0,0,0,0,0,0,0,0,0,0,0,7981426,2023-12-08T00:00:00.000Z,666971,20,Dylan Windler,0,0,0,0,0,0
0,0,0,0,0,0,0,0,0,0,0,0,0,0,0,0,7981426,2023-12-08T00:00:00.000Z,160,20,Evan Fournier,0,0,0,0,0,0
1,0,0,8,3,10,4,6,6,25,0,2,17,0,0,0,7981426,2023-12-08T00:00:00.000Z,3547269,20,Immanuel Quickley,0,17,18,18,1,18.5
4,2,12,0,0,4,2,2,1,29,4,4,5,16,0,1,7981426,2023-12-08T00:00:00.000Z,201,20,Isaiah Hartenstein,2,21,25,9,20,35.2
0,0,0,0,0,0,0,0,0,0,0,0,0,0,0,0,7981426,2023-12-08T00:00:00.000Z,56677795,20,Jacob Toppin,0,0,0,0,0,0
4,0,1,5,0,17,8,9,7,34,0,3,23,1,1,1,7981426,2023-12-08T00:00:00.000Z,73,20,Jalen Brunson,1,24,28,27,5,32.2
0,0,0,0,0,0,0,0,0,0,0,0,0,0,0,0,7981426,2023-12-08T00:00:00.000Z,59421201,20,Jaylen Martin,0,0,0,0,0,0
0,0,0,0,0,0,0,0,0,0,0,0,0,0,0,0,7981426,2023-12-08T00:00:00.000Z,17896063,20,Jericho Sims,0,0,0,0,0,0
3,1,4,4,3,15,7,4,3,34,1,2,20,5,1,6,7981426,2023-12-08T00:00:00.000Z,387,20,Julius Randle,2,25,28,23,8,30.5
0,0,0,0,0,0,0,0,0,0,0,0,0,0,0,0,7981426,2023-12-08T00:00:00.000Z,17896033,20,Miles McBride,0,0,0,0,0,0
2,0,3,0,0,6,5,2,0,19,5,2,10,8,1,1,7981426,2023-12-08T00:00:00.000Z,399,20,Mitchell Robinson,1,18,20,12,10,24.6
2,0,1,7,3,10,5,0,0,19,0,1,13,1,0,2,7981426,2023-12-08T00:00:00.000Z,17895858,20,Quentin Grimes,0,14,16,15,3,15.2
3,0,2,5,2,16,9,4,3,31,1,0,23,3,1,0,7981426,2023-12-08T00:00:00.000Z,666423,20,RJ Barrett,1,26,29,26,6,34.1
0,0,0,0,0,0,0,0,0,0,0,0,0,0,0,0,7981426,2023-12-08T00:00:00.000Z,19,20,Ryan Arcidiacono,0,0,0,0,0,0
0,0,0,0,0,0,0,0,0,1,0,0,0,0,0,0,7996365,2023-12-08T00:00:00.000Z,666451,24,Bol Bol,0,0,0,0,0,0
1,2,4,4,0,9,4,2,2,23,0,1,10,4,2,0,7996365,2023-12-08T00:00:00.000Z,314,24,Chimezie Metu,4,14,15,11,5,28.3
0,0,0,0,0,0,0,0,0,0,0,0,0,0,0,0,7996365,2023-12-08T00:00:00.000Z,272,24,Damion Lee,0,0,0,0,0,0
7,0,7,2,2,14,10,9,6,37,0,4,28,7,1,3,7996365,2023-12-08T00:00:00.000Z,57,24,Devin Booker,1,35,42,35,14,46.9
0,0,4,0,0,8,4,0,0,16,2,3,8,6,0,1,7996365,2023-12-08T00:00:00.000Z,147,24,Drew Eubanks,0,14,14,8,6,14.2
3,1,0,7,3,13,7,2,2,38,0,3,19,0,2,4,7996365,2023-12-08T00:00:00.000Z,178,24,Eric Gordon,3,19,22,22,3,28.5
6,0,3,1,0,6,3,2,2,20,2,2,8,5,0,2,7996365,2023-12-08T00:00:00.000Z,18678058,24,Jordan Goodwin,0,13,19,14,11,21
3,2,0,3,0,5,0,0,0,29,2,3,0,2,2,1,7996365,2023-12-08T00:00:00.000Z,356,24,Josh Okogie,4,2,5,3,5,17.9
3,0,8,4,2,13,6,4,1,30,1,3,15,9,1,0,7996365,2023-12-08T00:00:00.000Z,349,24,Jusuf Nurkic,1,24,27,18,12,33.3
2,0,3,3,1,6,2,2,0,17,1,0,5,4,0,0,7996365,2023-12-08T00:00:00.000Z,32,24,Keita Bates-Diop,0,9,11,7,6,12.8
0,0,0,0,0,0,0,0,0,0,0,0,0,0,0,0,7996365,2023-12-08T00:00:00.000Z,140,24,Kevin Durant,0,0,0,0,0,0
0,0,1,0,0,0,0,0,0,4,0,0,0,1,0,0,7996365,2023-12-08T00:00:00.000Z,666729,24,Nassir Little,0,1,1,0,1,1.2
0,0,0,0,0,1,1,2,2,1,0,0,4,0,0,0,7996365,2023-12-08T00:00:00.000Z,3547298,24,Saben Lee,0,4,4,4,0,4
1,0,2,8,3,8,3,0,0,24,0,0,9,2,0,0,7996365,2023-12-08T00:00:00.000Z,470,24,Yuta Watanabe,0,11,12,10,3,12.9
5,0,13,0,0,11,6,4,3,38,4,4,15,17,0,4,7996365,2023-12-08T00:00:00.000Z,406,26,Domantas Sabonis,0,32,37,20,22,38.9
2,0,4,4,1,11,3,3,2,32,4,0,9,8,1,0,7996365,2023-12-08T00:00:00.000Z,30,26,Harrison Barnes,1,17,19,11,10,24.6
0,0,2,7,1,13,6,0,0,30,2,6,13,4,1,1,7996365,2023-12-08T00:00:00.000Z,38017688,26,Keegan Murray,1,17,17,13,4,19.8
1,0,3,3,0,4,0,1,1,17,0,3,1,3,1,0,7996365,2023-12-08T00:00:00.000Z,221,26,Kevin Huerter,1,4,5,2,4,9.1
1,0,2,5,1,10,4,7,6,27,1,5,15,3,1,1,8258317,2023-12-09T00:00:00.000Z,3547250,12,Aaron Nesmith,1,18,19,16,4,22.1
0,0,0,0,0,0,0,0,0,0,0,0,0,0,0,0,8258317,2023-12-09T00:00:00.000Z,38017507,12,Andrew Nembhard,0,0,0,0,0,0
0,0,0,0,0,0,0,0,0,1,0,0,0,0,0,0,8258317,2023-12-09T00:00:00.000Z,56677861,12,Ben Sheppard,0,0,0,0,0,0
0,1,2,5,1,11,5,9,9,30,0,4,20,2,1,0,8258317,2023-12-09T00:00:00.000Z,38017686,12,Bennedict Mathurin,2,22,22,20,2,28.4
1,1,2,2,0,9,2,0,0,20,0,2,4,2,2,0,8258317,2023-12-09T00:00:00.000Z,69,12,Bruce Brown,3,6,7,5,3,16.9
4,0,4,9,2,11,3,0,0,32,1,3,8,5,1,2,8258317,2023-12-09T00:00:00.000Z,210,12,Buddy Hield,1,13,17,12,9,21
0,4,4,0,0,6,2,6,6,19,1,3,10,5,0,1,8258317,2023-12-09T00:00:00.000Z,17896035,12,Isaiah Jackson,4,15,15,10,5,27
0,0,0,0,0,0,0,0,0,1,0,0,0,0,0,0,8258317,2023-12-09T00:00:00.000Z,56677794,12,Isaiah Wong,0,0,0,0,0,0
0,0,0,0,0,0,0,0,0,0,0,0,0,0,0,0,8258317,2023-12-09T00:00:00.000Z,3547264,12,Jalen Smith,0,0,0,0,0,0
0,0,0,0,0,0,0,0,0,1,0,0,0,0,0,0,8258317,2023-12-09T00:00:00.000Z,56677832,12,Jarace Walker,0,0,0,0,0,0
0,0,0,0,0,0,0,0,0,0,0,0,0,0,0,0,8258317,2023-12-09T00:00:00.000Z,3547207,12,Jordan Nwora,0,0,0,0,0,0
0,0,0,0,0,1,0,0,0,1,0,0,0,0,0,0,8258317,2023-12-09T00:00:00.000Z,38017701,12,Kendall Brown,0,0,0,0,0,0
1,0,6,5,1,11,3,4,3,25,1,6,10,7,1,2,8258317,2023-12-09T00:00:00.000Z,452,12,Myles Turner,1,17,18,11,8,20.9
0,0,1,7,3,11,5,0,0,29,1,5,13,2,0,0,8258317,2023-12-09T00:00:00.000Z,3547243,12,Obi Toppin,0,15,15,13,2,15.4
0,0,0,0,0,0,0,2,1,1,1,0,1,1,0,0,8258317,2023-12-09T00:00:00.000Z,56677778,12,Oscar Tshiebwe,0,2,2,1,1,2.2
9,0,1,0,0,11,3,2,2,18,3,4,8,4,3,0,8258317,2023-12-09T00:00:00.000Z,304,12,T.J. McConnell,3,12,21,17,13,35.3
11,1,1,8,2,14,8,3,2,35,0,1,20,1,1,3,8258317,2023-12-09T00:00:00.000Z,3547245,12,Tyrese Haliburton,2,21,32,31,12,40.7
0,0,0,0,0,0,0,0,0,0,0,0,0,0,0,0,8258317,2023-12-09T00:00:00.000Z,56677867,14,Alex Fudge,0,0,0,0,0,0
0,0,0,0,0,0,0,0,0,0,0,0,0,0,0,0,8258317,2023-12-09T00:00:00.000Z,56677738,14,Colin Castleton,0,0,0,0,0,0
0,0,0,0,0,0,0,0,0,0,0,0,0,0,0,0,8258317,2023-12-09T00:00:00.000Z,56677868,14,D'Moi Hodge,0,0,0,0,0,0
0,0,0,0,0,0,0,0,0,0,0,0,0,0,0,0,8258317,2023-12-09T00:00:00.000Z,1603383,14,Gabe Vincent,0,0,0,0,0,0
0,0,0,0,0,0,0,0,0,0,0,0,0,0,0,0,1037884,2023-12-11T00:00:00.000Z,56677848,4,Amari Bailey,0,0,0,0,0,0
2,0,4,8,3,14,6,1,1,30,0,5,16,4,0,2,1037884,2023-12-11T00:00:00.000Z,56677823,4,Brandon Miller,0,20,22,18,6,21.8
0,0,0,0,0,0,0,0,0,0,0,0,0,0,0,0,1037884,2023-12-11T00:00:00.000Z,666748,4,Cody Martin,0,0,0,0,0,0
0,0,0,0,0,0,0,0,0,0,0,0,0,0,0,0,1037884,2023-12-11T00:00:00.000Z,347,4,Frank Ntilikina,0,0,0,0,0,0
7,0,6,3,1,12,7,4,2,32,0,4,17,6,1,0,1037884,2023-12-11T00:00:00.000Z,204,4,Gordon Hayward,1,23,30,24,13,37.7
0,0,0,0,0,0,0,0,0,0,0,0,0,0,0,0,1037884,2023-12-11T00:00:00.000Z,17896037,4,James Bouknight,0,0,0,0,0,0
0,1,0,2,0,2,0,0,0,9,0,0,0,0,1,0,1037884,2023-12-11T00:00:00.000Z,18678001,4,JT Thor,2,0,0,0,0,6
0,0,0,0,0,0,0,0,0,0,0,0,0,0,0,0,1037884,2023-12-11T00:00:00.000Z,3547239,4,LaMelo Ball,0,0,0,0,0,0
0,0,0,0,0,0,0,0,0,0,0,0,0,0,0,0,1037884,2023-12-11T00:00:00.000Z,56677866,4,Leaky Black,0,0,0,0,0,0
1,0,3,6,2,14,7,2,2,34,1,3,18,4,0,2,1037884,2023-12-11T00:00:00.000Z,62,4,Miles Bridges,0,22,23,19,5,22.3
1,0,3,0,0,6,2,2,2,26,3,1,6,6,0,0,1037884,2023-12-11T00:00:00.000Z,3547282,4,Nick Richards,0,12,13,7,7,14.7
0,0,0,0,0,0,0,0,0,0,0,0,0,0,0,0,1037884,2023-12-11T00:00:00.000Z,56677846,4,Nick Smith Jr.,0,0,0,0,0,0
13,0,1,13,8,17,10,7,6,39,1,4,34,2,0,3,1037884,2023-12-11T00:00:00.000Z,403,4,Terry Rozier,0,36,49,47,15,52.9
0,0,0,0,0,0,0,0,0,0,0,0,0,0,0,0,1037884,2023-12-11T00:00:00.000Z,3547253,4,Theo Maledon,0,0,0,0,0,0
0,0,0,3,2,6,4,4,4,13,0,0,14,0,1,1,1037885,2023-12-11T00:00:00.000Z,77,9,Alec Burks,1,14,14,14,0,16
2,1,4,2,1,10,8,5,3,33,2,4,20,6,1,1,1037885,2023-12-11T00:00:00.000Z,56677826,9,Ausar Thompson,2,26,28,22,8,35.2
2,0,1,9,3,14,5,7,4,34,0,2,17,1,3,2,1037885,2023-12-11T00:00:00.000Z,54,9,Bojan Bogdanovic,3,18,20,19,3,28.2
7,0,6,6,1,21,11,0,0,38,0,3,23,6,1,3,1037885,2023-12-11T00:00:00.000Z,17896075,9,Cade Cunningham,1,29,36,30,13,40.7
3,0,2,5,2,5,2,2,2,17,0,1,8,2,2,0,1037885,2023-12-11T00:00:00.000Z,17896071,9,Isaiah Livers,2,10,13,11,5,20.9
2,0,6,1,1,5,5,4,2,34,1,3,13,7,0,2,1037885,2023-12-11T00:00:00.000Z,3547267,9,Isaiah Stewart,0,20,22,15,9,22.4
2,0,2,3,0,15,7,4,4,34,1,2,18,3,1,2,1037885,2023-12-11T00:00:00.000Z,38017682,9,Jaden Ivey,1,21,23,20,5,25.6
0,0,0,0,0,0,0,0,0,0,0,0,0,0,0,0,1037885,2023-12-11T00:00:00.000Z,197,9,Joe Harris,0,0,0,0,0,0
0,0,0,0,0,0,0,0,0,1,0,0,0,0,0,0,1037885,2023-12-11T00:00:00.000Z,259,9,Kevin Knox,0,0,0,0,0,0
7,0,1,0,0,4,2,2,2,23,0,0,6,1,1,2,1037885,2023-12-11T00:00:00.000Z,3547241,9,Killian Hayes,1,7,14,13,8,18.7
0,0,0,0,0,0,0,0,0,0,0,0,0,0,0,0,1037885,2023-12-11T00:00:00.000Z,56677792,9,Marcus Sasser,0,0,0,0,0,0
0,0,0,0,0,0,0,0,0,0,0,0,0,0,0,0,1037885,2023-12-11T00:00:00.000Z,24,9,Marvin Bagley III,0,0,0,0,0,0
0,0,0,0,0,0,0,0,0,0,0,0,0,0,0,0,1037886,2023-12-11T00:00:00.000Z,277,6,Caris LeVert,0,0,0,0,0,0
0,0,0,0,0,0,0,0,0,0,0,0,0,0,0,0,1037886,2023-12-11T00:00:00.000Z,56677872,6,Craig Porter,0,0,0,0,0,0
0,0,0,0,0,0,0,0,0,0,0,0,0,0,0,0,1037886,2023-12-11T00:00:00.000Z,248,6,Damian Jones,0,0,0,0,0,0
5,0,5,9,3,23,11,12,11,39,1,0,36,6,2,3,1037886,2023-12-11T00:00:00.000Z,666581,6,Darius Garland,2,42,47,41,11,53.7
0,0,2,4,2,5,3,2,1,29,4,2,9,6,3,2,1037886,2023-12-11T00:00:00.000Z,666940,6,Dean Wade,3,15,15,9,6,23.2
3,1,2,10,2,18,6,9,8,37,1,3,22,3,3,2,1037886,2023-12-11T00:00:00.000Z,322,6,Donovan Mitchell,4,25,28,25,6,40.1
0,0,0,0,0,0,0,0,0,0,0,0,0,0,0,0,1037886,2023-12-11T00:00:00.000Z,56677847,6,Emoni Bates,0,0,0,0,0,0
0,0,0,0,0,0,0,0,0,0,0,0,0,0,0,0,1037886,2023-12-11T00:00:00.000Z,17896076,6,Evan Mobley,0,0,0,0,0,0
0,0,3,5,0,10,0,0,0,22,1,3,0,4,0,0,1037886,2023-12-11T00:00:00.000Z,344,6,Georges Niang,0,4,4,0,4,4.8
0,0,1,4,0,4,0,4,1,26,3,2,1,4,0,1,1037886,2023-12-11T00:00:00.000Z,3547247,6,Isaac Okoro,0,5,5,1,4,4.8
0,0,0,0,0,0,0,0,0,0,0,0,0,0,0,0,1037886,2023-12-11T00:00:00.000Z,38017662,6,Isaiah Mobley,0,0,0,0,0,0
1,0,5,0,0,3,2,0,0,15,2,6,4,7,1,1,1037886,2023-12-11T00:00:00.000Z,9,6,Jarrett Allen,1,11,12,5,8,15.9
3,0,1,5,0,9,1,6,4,26,1,4,6,2,1,3,1037886,2023-12-11T00:00:00.000Z,666908,6,Max Strus,1,8,11,9,5,12.9
0,0,0,0,0,0,0,0,0,0,0,0,0,0,0,0,1037886,2023-12-11T00:00:00.000Z,404,6,Ricky Rubio,0,0,0,0,0,0
1,0,2,4,2,6,2,0,0,17,1,2,6,3,0,1,1037886,2023-12-11T00:00:00.000Z,3547299,6,Sam Merrill,0,9,10,7,4,10.1
2,2,9,0,0,7,5,0,0,29,3,1,10,12,0,0,1037886,2023-12-11T00:00:00.000Z,444,6,Tristan Thompson,2,22,24,12,14,33.4
0,0,0,0,0,0,0,0,0,0,0,0,0,0,0,0,1037886,2023-12-11T00:00:00.000Z,666676,6,Ty Jerome,0,0,0,0,0,0
0,0,0,0,0,0,0,0,0,0,0,0,0,0,0,0,1037886,2023-12-11T00:00:00.000Z,666885,22,Admiral Schofield,0,0,0,0,0,0
0,0,0,0,0,0,0,0,0,0,0,0,0,0,0,0,1037886,2023-12-11T00:00:00.000Z,38017724,22,Caleb Houstan,0,0,0,0,0,0
0,0,0,0,0,0,0,0,0,0,0,0,0,0,0,0,1037886,2023-12-11T00:00:00.000Z,666818,22,Chuma Okeke,0,0,0,0,0,0
4,0,1,1,1,6,3,2,1,18,1,3,8,2,0,0,1037886,2023-12-11T00:00:00.000Z,3547251,22,Cole Anthony,0,10,14,12,6,16.4
0,0,0,0,0,0,0,0,0,0,0,0,0,0,0,0,1037886,2023-12-11T00:00:00.000Z,56677839,22,Jett Howard,0,0,0,0,0,0
1,0,3,3,1,6,3,0,0,13,1,0,7,4,2,0,1037886,2023-12-11T00:00:00.000Z,229,22,Jonathan Isaac,2,11,12,8,5,19.3
0,0,0,0,0,0,0,0,0,0,0,0,0,0,0,0,1037886,2023-12-11T00:00:00.000Z,165,22,Markelle Fultz,0,0,0,0,0,0
0,0,0,0,0,0,0,0,0,0,0,0,0,0,0,0,1037886,2023-12-11T00:00:00.000Z,85,22,Wendell Carter Jr.,0,0,0,0,0,0
5,0,2,7,1,11,2,0,0,27,1,3,5,3,5,2,1037887,2023-12-11T00:00:00.000Z,313,23,De'Anthony Melton,5,8,13,10,8,29.1
0,0,0,1,0,5,2,2,2,9,0,3,6,0,2,1,1037887,2023-12-11T00:00:00.000Z,17896025,23,Jaden Springer,2,6,6,6,0,11
0,0,0,0,0,0,0,0,0,0,0,0,0,0,0,0,1037887,2023-12-11T00:00:00.000Z,17554001,23,Javonte Smart,0,0,0,0,0,0
6,1,10,5,2,20,14,4,4,30,0,4,34,10,2,7,1037887,2023-12-11T00:00:00.000Z,145,23,Joel Embiid,3,44,50,40,16,57
1,0,4,4,1,8,3,0,0,17,1,3,7,5,1,0,1037887,2023-12-11T00:00:00.000Z,360,23,Kelly Oubre Jr.,1,12,13,8,6,17.5
1,0,2,3,2,6,5,0,0,12,0,3,12,2,1,0,1037887,2023-12-11T00:00:00.000Z,328,23,Marcus Morris,1,14,15,13,3,18.9
1,2,2,3,0,5,2,0,0,20,0,0,4,2,1,0,1037887,2023-12-11T00:00:00.000Z,33,23,Nicolas Batum,3,6,7,5,3,16.9
3,1,4,0,0,2,2,1,0,13,2,3,4,6,0,0,1037887,2023-12-11T00:00:00.000Z,3547270,23,Paul Reed,1,10,13,7,9,18.7
0,0,0,0,0,0,0,0,0,0,0,0,0,0,0,0,1037887,2023-12-11T00:00:00.000Z,56913527,23,Ricky Council IV,0,0,0,0,0,0
0,0,0,0,0,0,0,0,0,0,0,0,0,0,0,0,1037887,2023-12-11T00:00:00.000Z,56677788,23,Terquavion Smith,0,0,0,0,0,0
6,0,4,2,1,5,2,6,5,30,0,1,10,4,0,0,1037887,2023-12-11T00:00:00.000Z,200,23,Tobias Harris,0,14,20,16,10,23.8
0,1,3,0,0,2,1,2,1,10,1,2,3,4,0,2,1037887,2023-12-11T00:00:00.000Z,3547302,30,Anthony Gill,1,7,7,3,4,8.8
4,1,5,7,2,11,4,6,3,31,3,0,13,8,1,3,1037887,2023-12-11T00:00:00.000Z,56677844,30,Bilal Coulibaly,2,21,25,17,12,31.6
1,0,1,3,1,6,3,4,2,23,1,4,9,2,0,3,1037887,2023-12-11T00:00:00.000Z,17896045,30,Corey Kispert,0,11,12,10,3,9.9
0,0,0,0,0,0,0,0,0,0,0,0,0,0,0,0,1037887,2023-12-11T00:00:00.000Z,666577,30,Daniel Gafford,0,0,0,0,0,0
0,0,1,0,0,0,0,2,2,11,0,2,2,1,0,2,1037887,2023-12-11T00:00:00.000Z,167,30,Danilo Gallinari,0,3,3,2,1,1.2
0,0,0,0,0,0,0,0,0,0,0,0,0,0,0,0,1037887,2023-12-11T00:00:00.000Z,487,30,Delon Wright,0,0,0,0,0,0
3,0,4,3,1,8,3,2,2,26,2,1,9,6,1,3,1037887,2023-12-11T00:00:00.000Z,3547242,30,Deni Avdija,1,15,18,12,9,20.7
0,0,0,0,0,1,0,0,0,2,0,1,0,0,0,0,1037887,2023-12-11T00:00:00.000Z,17896106,30,Eugene Omoruyi,0,0,0,0,0,0
4,0,0,0,0,7,5,3,2,19,0,2,12,0,2,1,1037887,2023-12-11T00:00:00.000Z,18677954,30,Jared Butler,2,12,16,16,4,23
0,0,0,0,0,0,0,0,0,0,0,0,0,0,0,0,1037887,2023-12-11T00:00:00.000Z,38017687,30,Johnny Davis,0,0,0,0,0,0
3,0,0,3,1,11,3,4,4,26,0,1,11,0,0,3,1037887,2023-12-11T00:00:00.000Z,666848,30,Jordan Poole,0,11,14,14,3,12.5
1,0,7,2,1,17,9,4,2,28,2,0,21,9,0,2,1037887,2023-12-11T00:00:00.000Z,265,30,Kyle Kuzma,0,30,31,22,10,31.3
0,0,0,0,0,0,0,0,0,0,0,0,0,0,0,0,1037887,2023-12-11T00:00:00.000Z,414,30,Landry Shamet,0,0,0,0,0,0
1,0,1,3,0,4,0,2,0,20,3,3,0,4,0,0,1037887,2023-12-11T00:00:00.000Z,337,30,Mike Muscala,0,4,5,1,5,6.3
1,0,4,3,2,5,3,2,2,17,0,2,10,4,0,0,1037887,2023-12-11T00:00:00.000Z,38017704,30,Patrick Baldwin Jr.,0,14,15,11,5,16.3
0,0,0,0,0,0,0,0,0,0,0,0,0,0,0,0,1037887,2023-12-11T00:00:00.000Z,38017712,30,Ryan Rollins,0,0,0,0,0,0
3,0,5,5,1,9,4,0,0,21,0,0,9,5,1,2,1037887,2023-12-11T00:00:00.000Z,249,30,Tyus Jones,1,14,17,12,8,20.5
2,0,4,0,0,11,6,2,2,28,4,5,14,8,1,0,1037888,2023-12-11T00:00:00.000Z,83,1,Clint Capela,1,22,24,16,10,29.6
0,0,0,0,0,0,0,0,0,0,0,0,0,0,0,0,1037888,2023-12-11T00:00:00.000Z,666656,1,De'Andre Hunter,0,0,0,0,0,0
3,0,2,8,3,23,8,2,2,38,4,2,21,6,1,2,1037888,2023-12-11T00:00:00.000Z,334,1,Dejounte Murray,1,27,30,24,9,33.7
1,0,0,5,1,5,1,0,0,17,0,1,3,0,1,0,1037888,2023-12-11T00:00:00.000Z,666754,1,Garrison Mathews,1,3,4,4,1,7.5
0,0,0,0,0,0,0,0,0,0,0,0,0,0,0,0,1037888,2023-12-11T00:00:00.000Z,17896040,1,Jalen Johnson,0,0,0,0,0,0
0,0,0,0,0,0,0,0,0,0,0,0,0,0,0,0,1037888,2023-12-11T00:00:00.000Z,56677875,1,Miles Norris,0,0,0,0,0,0
2,1,3,4,1,11,6,4,3,40,1,2,16,4,1,0,1037888,2023-12-11T00:00:00.000Z,3547256,1,Saddiq Bey,2,20,22,18,6,29.8
9,0,1,5,2,11,5,7,7,26,0,2,19,1,1,5,1037888,2023-12-11T00:00:00.000Z,490,1,Trae Young,1,20,29,28,10,31.7
1,0,5,0,0,10,7,5,4,29,7,2,18,12,0,2,1037888,2023-12-11T00:00:00.000Z,177,8,Aaron Gordon,0,30,31,19,13,31.9
0,0,0,0,0,0,0,0,0,0,0,0,0,0,0,0,1037888,2023-12-11T00:00:00.000Z,17896007,8,Braxton Key,0,0,0,0,0,0
1,0,2,0,0,3,2,2,2,11,0,2,6,2,0,0,1037888,2023-12-11T00:00:00.000Z,38017709,8,Christian Braun,0,8,9,7,3,9.9
0,0,0,0,0,0,0,0,0,0,0,0,0,0,0,0,1037888,2023-12-11T00:00:00.000Z,38017727,8,Collin Gillespie,0,0,0,0,0,0
0,0,0,0,0,0,0,0,0,0,0,0,0,0,0,0,1037888,2023-12-11T00:00:00.000Z,250,8,DeAndre Jordan,0,0,0,0,0,0
0,0,0,0,0,0,0,0,0,0,0,0,0,0,0,0,1037888,2023-12-11T00:00:00.000Z,56677871,8,Hunter Tyson,0,0,0,0,0,0
0,0,0,0,0,0,0,0,0,0,0,0,0,0,0,0,1037888,2023-12-11T00:00:00.000Z,56677582,8,Jalen Pickett,0,0,0,0,0,0
4,2,8,5,4,15,12,1,1,29,1,1,29,9,1,6,1037888,2023-12-11T00:00:00.000Z,335,8,Jamal Murray,3,38,42,33,13,48.8
0,0,0,0,0,0,0,0,0,0,0,0,0,0,0,0,1037888,2023-12-11T00:00:00.000Z,17896103,8,Jay Huff,0,0,0,0,0,0
2,0,1,11,6,16,8,0,0,28,0,1,22,1,5,2,1037888,2023-12-11T00:00:00.000Z,56677776,8,Julian Strawther,5,23,25,24,3,39.2
0,0,0,0,0,0,0,0,0,0,0,0,0,0,0,0,1037888,2023-12-11T00:00:00.000Z,215,8,Justin Holiday,0,0,0,0,0,0
2,1,3,2,0,6,1,8,6,30,0,2,8,3,0,2,1037888,2023-12-11T00:00:00.000Z,81,8,Kentavious Caldwell-Pope,1,11,13,10,5,15.6
3,0,5,4,0,11,1,2,1,26,2,3,3,7,0,1,1037888,2023-12-11T00:00:00.000Z,375,8,Michael Porter Jr.,0,10,13,6,10,14.9
8,2,6,1,1,13,9,7,6,36,2,3,25,8,3,1,1037888,2023-12-11T00:00:00.000Z,246,8,Nikola Jokic,5,33,41,33,16,60.6
0,1,1,0,0,2,1,2,1,20,1,2,3,2,0,0,1037888,2023-12-11T00:00:00.000Z,38017721,8,Peyton Watson,1,5,5,3,2,8.4
6,0,1,5,1,10,5,1,1,19,0,0,12,1,0,1,1037888,2023-12-11T00:00:00.000Z,236,8,Reggie Jackson,0,13,19,18,7,21.2
0,0,0,0,0,0,0,0,0,0,0,0,0,0,0,0,1037888,2023-12-11T00:00:00.000Z,666489,8,Vlatko Cancar,0,0,0,0,0,0
1,2,3,1,0,2,1,1,1,12,1,3,3,4,0,1,1037888,2023-12-11T00:00:00.000Z,3547268,8,Zeke Nnaji,2,7,8,4,5,14.3
0,0,0,0,0,0,0,0,0,0,0,0,0,0,0,0,1037889,2023-12-11T00:00:00.000Z,666675,20,DaQuan Jeffries,0,0,0,0,0,0
0,0,0,0,0,0,0,0,0,0,0,0,0,0,0,0,1037889,2023-12-11T00:00:00.000Z,666971,20,Dylan Windler,0,0,0,0,0,0
0,0,0,0,0,0,0,0,0,0,0,0,0,0,0,0,1037889,2023-12-11T00:00:00.000Z,3547269,20,Immanuel Quickley,0,0,0,0,0,0
2,1,3,0,0,7,4,4,3,27,5,4,11,8,2,2,1037889,2023-12-11T00:00:00.000Z,201,20,Isaiah Hartenstein,3,19,21,13,10,30.6
8,0,4,3,3,8,6,2,1,31,3,4,16,7,1,1,1037889,2023-12-11T00:00:00.000Z,202,20,Josh Hart,1,23,31,24,15,38.4
3,0,0,1,1,2,1,0,0,10,0,1,3,0,0,0,1037889,2023-12-11T00:00:00.000Z,17896033,20,Miles McBride,0,3,6,6,3,7.5
1,0,3,7,5,11,7,0,0,27,0,0,19,3,0,0,1037889,2023-12-11T00:00:00.000Z,17895858,20,Quentin Grimes,0,22,23,20,4,24.1
10,0,2,4,2,12,6,7,6,33,0,2,20,2,4,0,1037889,2023-12-11T00:00:00.000Z,409,28,Dennis Schroder,4,22,32,30,12,49.4
0,0,0,0,0,0,0,0,0,0,0,0,0,0,0,0,1037889,2023-12-11T00:00:00.000Z,2309958,28,Jontay Porter,0,0,0,0,0,0
0,0,0,0,0,0,0,0,0,0,0,0,0,0,0,0,1037889,2023-12-11T00:00:00.000Z,56677869,28,Markquis Nowell,0,0,0,0,0,0
0,0,0,0,0,0,0,0,0,0,0,0,0,0,0,0,1037889,2023-12-11T00:00:00.000Z,376,28,Otto Porter Jr.,0,0,0,0,0,0
4,0,2,2,1,15,8,7,3,37,2,5,20,4,4,1,1037889,2023-12-11T00:00:00.000Z,416,28,Pascal Siakam,4,24,28,24,8,41.8
0,0,0,0,0,0,0,0,0,0,0,0,0,0,0,0,1037890,2023-12-11T00:00:00.000Z,56677831,11,Cam Whitmore,0,0,0,0,0,0
0,0,0,0,0,0,0,0,0,0,0,0,0,0,0,0,1037890,2023-12-11T00:00:00.000Z,38017693,27,Blake Wesley,0,0,0,0,0,0
1,0,2,2,0,7,4,4,2,13,0,1,10,2,0,2,1037890,2023-12-11T00:00:00.000Z,359,27,Cedi Osman,0,12,13,11,3,11.9
0,0,0,0,0,0,0,0,0,0,0,0,0,0,0,0,1037890,2023-12-11T00:00:00.000Z,17895854,27,Charles Bassey,0,0,0,0,0,0
0,0,0,0,0,0,0,0,0,0,0,0,0,0,0,0,1037890,2023-12-11T00:00:00.000Z,56677865,27,Charles Bediako,0,0,0,0,0,0
2,0,3,9,1,16,5,5,3,31,3,1,14,6,0,1,1037890,2023-12-11T00:00:00.000Z,3547246,27,Devin Vassell,0,20,22,16,8,23.2
0,0,0,0,0,0,0,0,0,0,0,0,0,0,0,0,1037890,2023-12-11T00:00:00.000Z,180,27,Devonte' Graham,0,0,0,0,0,0
0,0,0,0,0,0,0,0,0,0,0,0,0,0,0,0,1037890,2023-12-11T00:00:00.000Z,38017730,27,Dominick Barlow,0,0,0,0,0,0
1,0,0,5,2,5,2,0,0,15,0,0,6,0,1,0,1037890,2023-12-11T00:00:00.000Z,305,27,Doug McDermott,1,6,7,7,1,10.5
2,0,4,5,1,11,3,0,0,35,2,2,7,6,1,1,1037890,2023-12-11T00:00:00.000Z,38017699,27,Jeremy Sochan,1,13,15,9,8,19.2
2,0,5,9,0,14,3,6,6,37,2,1,12,7,4,3,1037890,2023-12-11T00:00:00.000Z,666682,27,Keldon Johnson,4,19,21,14,9,32.4
7,0,6,3,0,13,6,1,1,34,0,0,13,6,1,3,1037890,2023-12-11T00:00:00.000Z,38017692,27,Malaki Branham,1,19,26,20,13,30.7
0,0,1,0,0,0,0,0,0,4,0,1,0,1,0,0,1037890,2023-12-11T00:00:00.000Z,17896059,27,Sandro Mamukelashvili,0,1,1,0,1,1.2
0,0,0,0,0,0,0,0,0,0,0,0,0,0,0,0,1037890,2023-12-11T00:00:00.000Z,56677817,27,Sidy Cissoko,0,0,0,0,0,0
0,0,0,0,0,0,0,0,0,0,0,0,0,0,0,0,1037890,2023-12-11T00:00:00.000Z,56677870,27,Sir'Jabari Rice,0,0,0,0,0,0
2,0,0,1,0,1,0,5,3,16,0,1,3,0,2,0,1037890,2023-12-11T00:00:00.000Z,3547274,27,Tre Jones,2,3,5,5,2,12
3,5,16,6,1,15,7,1,0,33,2,3,15,18,0,5,1037890,2023-12-11T00:00:00.000Z,56677822,27,Victor Wembanyama,5,33,36,18,21,51.1
0,0,0,0,0,0,0,0,0,0,0,0,0,0,0,0,1037891,2023-12-11T00:00:00.000Z,228,7,Kyrie Irving,0,0,0,0,0,0
0,0,0,0,0,0,0,0,0,0,0,0,0,0,0,0,1037891,2023-12-11T00:00:00.000Z,191,7,Tim Hardaway Jr.,0,0,0,0,0,0
0,0,0,0,0,0,0,0,0,0,0,0,0,0,0,0,1037892,2023-12-11T00:00:00.000Z,56677860,5,Adama Sanogo,0,0,0,0,0,0
0,0,0,0,0,0,0,0,0,0,0,0,0,0,0,0,1037892,2023-12-11T00:00:00.000Z,89,5,Alex Caruso,0,0,0,0,0,0
1,0,5,0,0,12,3,3,3,14,11,1,9,16,1,0,1037892,2023-12-11T00:00:00.000Z,137,5,Andre Drummond,1,25,26,10,17,32.7
1,1,0,2,1,2,1,0,0,11,0,2,3,0,0,0,1037892,2023-12-11T00:00:00.000Z,38017719,5,Dalen Terry,1,3,4,4,1,7.5
0,1,4,2,1,5,3,0,0,13,1,0,7,5,0,0,1037892,2023-12-11T00:00:00.000Z,87,5,Jevon Carter,1,12,12,7,5,16
0,0,0,0,0,0,0,0,0,4,0,0,0,0,0,0,1037892,2023-12-11T00:00:00.000Z,56677857,5,Julian Phillips,0,0,0,0,0,0
0,0,0,0,0,0,0,0,0,0,0,0,0,0,0,0,1037892,2023-12-11T00:00:00.000Z,45969255,5,Justin Lewis,0,0,0,0,0,0
0,0,0,0,0,0,0,0,0,0,0,0,0,0,0,0,1037892,2023-12-11T00:00:00.000Z,27,5,Lonzo Ball,0,0,0,0,0,0
0,0,0,0,0,0,0,0,0,0,0,0,0,0,0,0,1037892,2023-12-11T00:00:00.000Z,56677874,5,Onuralp Bitim,0,0,0,0,0,0
0,0,0,0,0,0,0,0,0,0,0,0,0,0,0,0,1037892,2023-12-11T00:00:00.000Z,17896116,5,Terry Taylor,0,0,0,0,0,0
1,1,4,5,1,9,2,4,2,29,1,6,7,5,0,0,1037892,2023-12-11T00:00:00.000Z,110,5,Torrey Craig,1,12,13,8,6,17.5
0,0,0,0,0,0,0,0,0,0,0,0,0,0,0,0,1037892,2023-12-11T00:00:00.000Z,268,5,Zach LaVine,0,0,0,0,0,0
3,0,5,5,4,6,4,0,0,13,0,1,12,5,0,0,1037892,2023-12-11T00:00:00.000Z,38017733,17,A.J. Green,0,17,20,15,8,22.5
0,0,0,0,0,0,0,0,0,0,0,0,0,0,0,0,1037892,2023-12-11T00:00:00.000Z,56677852,17,Andre Jackson Jr.,0,0,0,0,0,0
3,3,1,6,2,11,6,6,5,40,2,4,19,3,1,1,1037892,2023-12-11T00:00:00.000Z,283,17,Brook Lopez,4,22,25,22,6,38.1
5,0,0,2,1,4,2,0,0,18,0,2,5,0,0,1,1037892,2023-12-11T00:00:00.000Z,368,17,Cameron Payne,0,5,10,10,5,11.5
9,1,4,9,2,17,3,7,6,41,0,2,14,4,0,2,1037892,2023-12-11T00:00:00.000Z,278,17,Damian Lillard,1,18,27,23,13,33.3
6,0,11,0,0,13,9,18,14,41,1,2,32,12,2,2,1037892,2023-12-11T00:00:00.000Z,15,17,Giannis Antetokounmpo,2,44,50,38,18,59.4
6,0,12,3,0,11,5,4,3,33,1,4,13,13,1,4,1037892,2023-12-11T00:00:00.000Z,315,17,Khris Middleton,1,26,32,19,19,36.6
2,0,4,8,5,11,7,0,0,40,0,2,19,4,1,0,1037892,2023-12-11T00:00:00.000Z,38,17,Malik Beasley,1,23,25,21,6,29.8
0,0,0,1,0,2,1,0,0,14,0,1,2,0,0,0,1037892,2023-12-11T00:00:00.000Z,38017676,17,MarJon Beauchamp,0,2,2,2,0,2
0,0,0,0,0,0,0,0,0,0,0,0,0,0,0,0,1037892,2023-12-11T00:00:00.000Z,284,17,Robin Lopez,0,0,0,0,0,0
0,0,0,0,0,0,0,0,0,0,0,0,0,0,0,0,1037892,2023-12-11T00:00:00.000Z,2148,17,Thanasis Antetokounmpo,0,0,0,0,0,0
1,0,9,3,1,11,5,7,6,33,3,6,17,12,0,1,1037893,2023-12-11T00:00:00.000Z,447,18,Karl-Anthony Towns,0,29,30,18,13,31.9
0,0,0,0,0,0,0,0,0,0,0,0,0,0,0,0,1037893,2023-12-11T00:00:00.000Z,56677782,18,Leonard Miller,0,0,0,0,0,0
5,1,1,4,1,7,2,2,2,24,0,4,7,1,1,4,1037893,2023-12-11T00:00:00.000Z,666400,18,Nickeil Alexander-Walker,2,8,13,12,6,17.7
0,2,6,0,0,8,4,0,0,25,2,4,8,8,0,1,1037893,2023-12-11T00:00:00.000Z,176,18,Rudy Gobert,2,16,16,8,8,22.6
5,0,3,5,2,13,5,9,8,29,0,2,20,3,0,4,1037893,2023-12-11T00:00:00.000Z,227,19,Brandon Ingram,0,23,28,25,8,27.1
4,1,4,7,4,15,8,3,3,29,0,2,23,4,1,1,1037893,2023-12-11T00:00:00.000Z,303,19,CJ McCollum,2,27,31,27,8,38.8
0,0,0,0,0,0,0,0,0,0,0,0,0,0,0,0,1037893,2023-12-11T00:00:00.000Z,491,19,Cody Zeller,0,0,0,0,0,0
0,0,0,0,0,0,0,0,0,0,0,0,0,0,0,0,1037893,2023-12-11T00:00:00.000Z,38017726,19,Dereon Seabron,0,0,0,0,0,0
2,1,1,1,1,3,1,4,3,28,1,3,6,2,2,0,1037893,2023-12-11T00:00:00.000Z,38017677,19,Dyson Daniels,3,8,10,8,4,20.4
0,0,0,0,0,0,0,0,0,0,0,0,0,0,0,0,1037893,2023-12-11T00:00:00.000Z,38017663,19,E.J. Liddell,0,0,0,0,0,0
5,0,7,3,1,7,2,3,2,32,3,4,7,10,0,0,1037893,2023-12-11T00:00:00.000Z,17896024,19,Herbert Jones,0,17,22,12,15,26.5
0,0,0,0,0,0,0,0,0,0,0,0,0,0,0,0,1037893,2023-12-11T00:00:00.000Z,17896021,19,Jeremiah Robinson-Earl,0,0,0,0,0,0
4,2,10,1,0,9,5,7,4,35,3,3,14,13,2,3,1037893,2023-12-11T00:00:00.000Z,455,19,Jonas Valanciunas,4,27,31,18,17,44.6
0,0,0,0,0,1,0,0,0,1,0,0,0,0,0,0,1037893,2023-12-11T00:00:00.000Z,56677837,19,Jordan Hawkins,0,0,0,0,0,0
3,1,1,3,0,5,0,0,0,15,1,3,0,2,1,1,1037893,2023-12-11T00:00:00.000Z,17896097,19,Jose Alvarado,2,2,5,3,5,11.9
0,0,0,0,0,0,0,0,0,0,0,0,0,0,0,0,1037893,2023-12-11T00:00:00.000Z,3547260,19,Kira Lewis Jr.,0,0,0,0,0,0
0,0,0,0,0,0,0,0,0,0,0,0,0,0,0,0,1037893,2023-12-11T00:00:00.000Z,340,19,Larry Nance Jr.,0,0,0,0,0,0
0,0,0,0,0,0,0,0,0,0,0,0,0,0,0,0,1037893,2023-12-11T00:00:00.000Z,17896017,19,Matt Ryan,0,0,0,0,0,0
1,1,5,2,1,4,2,0,0,14,0,2,5,5,0,1,1037893,2023-12-11T00:00:00.000Z,3547293,19,Naji Marshall,1,10,11,6,6,14.5
1,0,3,5,1,8,4,2,1,24,0,0,10,3,0,2,1037893,2023-12-11T00:00:00.000Z,18677986,19,Trey Murphy III,0,13,14,11,4,13.1
2,1,3,0,0,17,13,12,10,33,2,1,36,5,1,1,1037893,2023-12-11T00:00:00.000Z,666969,19,Zion Williamson,2,41,43,38,7,50
0,0,0,1,1,4,1,0,0,4,1,0,3,1,0,0,1037894,2023-12-11T00:00:00.000Z,17896078,21,Aaron Wiggins,0,4,4,3,1,4.2
0,0,1,2,0,2,0,0,0,9,0,0,0,1,0,0,1037894,2023-12-11T00:00:00.000Z,3547271,21,Aleksej Pokusevski,0,1,1,0,1,1.2
2,2,3,4,2,8,4,0,0,25,0,4,10,3,1,0,1037894,2023-12-11T00:00:00.000Z,56677833,21,Cason Wallace,3,13,15,12,5,25.6
2,2,6,3,2,9,6,2,2,25,2,2,16,8,1,3,1037894,2023-12-11T00:00:00.000Z,38017685,21,Chet Holmgren,3,24,26,18,10,34.6
1,1,0,2,1,2,1,0,0,9,0,1,3,0,0,0,1037894,2023-12-11T00:00:00.000Z,44,21,Davis Bertans,1,3,4,4,1,7.5
1,1,0,7,3,8,3,0,0,14,0,1,9,0,0,0,1037894,2023-12-11T00:00:00.000Z,3547272,21,Isaiah Joe,1,9,10,10,1,13.5
3,0,2,2,2,10,5,3,3,22,1,1,15,3,0,2,1037894,2023-12-11T00:00:00.000Z,38017703,21,Jalen Williams,0,18,21,18,6,21.1
1,0,1,1,1,2,2,2,2,10,0,0,7,1,1,1,1037894,2023-12-11T00:00:00.000Z,38017706,21,Jaylin Williams,1,8,9,8,2,11.7
8,1,8,3,2,11,5,0,0,24,2,1,12,10,1,3,1037894,2023-12-11T00:00:00.000Z,17896065,21,Josh Giddey,2,22,30,20,18,39
1,0,2,0,0,1,1,0,0,7,0,0,2,2,1,0,1037894,2023-12-11T00:00:00.000Z,480,21,Kenrich Williams,1,4,5,3,3,8.9
0,0,0,0,0,0,0,0,0,0,0,0,0,0,0,0,1037894,2023-12-11T00:00:00.000Z,56677853,21,Keyontae Johnson,0,0,0,0,0,0
1,0,0,4,1,4,1,0,0,8,0,2,3,0,0,0,1037894,2023-12-11T00:00:00.000Z,27924547,21,Lindy Waters III,0,3,4,4,1,4.5
0,0,0,0,0,0,0,0,0,0,0,0,0,0,0,0,1037894,2023-12-11T00:00:00.000Z,666541,21,Luguentz Dort,0,0,0,0,0,0
0,0,0,0,0,0,0,0,0,0,0,0,0,0,0,0,1037894,2023-12-11T00:00:00.000Z,24572055,21,Olivier Sarr,0,0,0,0,0,0
3,0,3,4,3,7,6,4,3,26,0,2,18,3,0,1,1037894,2023-12-11T00:00:00.000Z,38017716,21,Ousmane Dieng,0,21,24,21,6,25.1
7,0,3,1,0,17,12,6,6,28,1,1,30,4,3,1,1037894,2023-12-11T00:00:00.000Z,175,21,Shai Gilgeous-Alexander,3,34,41,37,11,53.3
0,0,2,1,0,6,2,0,0,13,0,2,4,2,0,1,1037894,2023-12-11T00:00:00.000Z,17896036,21,Tre Mann,0,6,6,4,2,5.4
5,0,1,3,0,5,1,0,0,16,0,0,2,1,1,0,1037894,2023-12-11T00:00:00.000Z,4197029,21,Vasilije Micic,1,3,8,7,6,13.7
2,0,2,4,1,13,7,6,5,26,2,1,20,4,2,0,1037894,2023-12-11T00:00:00.000Z,413,29,Collin Sexton,2,24,26,22,6,33.8
0,0,0,0,0,0,0,0,0,0,0,0,0,0,0,0,1037894,2023-12-11T00:00:00.000Z,101,29,John Collins,0,0,0,0,0,0
0,0,0,0,0,0,0,0,0,0,0,0,0,0,0,0,1037894,2023-12-11T00:00:00.000Z,38017630,29,Johnny Juzang,0,0,0,0,0,0
5,1,2,4,0,13,3,2,2,22,2,1,8,4,1,2,1037894,2023-12-11T00:00:00.000Z,100,29,Jordan Clarkson,2,12,17,13,9,24.3
0,0,0,0,0,0,0,0,0,0,0,0,0,0,0,0,1037894,2023-12-11T00:00:00.000Z,17896023,29,Josh Christopher,0,0,0,0,0,0
3,0,6,2,0,5,1,0,0,21,0,2,2,6,0,2,1037894,2023-12-11T00:00:00.000Z,358,29,Kelly Olynyk,0,8,11,5,9,11.7
7,0,3,9,5,17,10,5,5,33,0,0,30,3,1,3,1037894,2023-12-11T00:00:00.000Z,56677834,29,Keyonte George,1,33,40,37,10,44.1
1,0,7,4,1,10,6,1,1,17,0,3,14,7,0,2,1037894,2023-12-11T00:00:00.000Z,666881,29,Luka Samanic,0,21,22,15,8,21.9
2,1,1,1,0,4,1,0,0,22,0,1,2,1,3,1,1037894,2023-12-11T00:00:00.000Z,38017620,29,Ochai Agbaji,4,3,5,4,3,17.2
0,1,3,0,0,2,1,0,0,10,2,3,2,5,0,3,1037894,2023-12-11T00:00:00.000Z,11891374,29,Omer Yurtseven,1,7,7,2,5,8
1,4,1,6,3,11,7,2,2,23,1,1,19,2,0,0,1037894,2023-12-11T00:00:00.000Z,38017739,29,Simone Fontecchio,4,21,22,20,3,34.9
2,1,1,3,1,7,3,4,4,15,0,5,11,1,0,2,1037894,2023-12-11T00:00:00.000Z,666650,29,Talen Horton-Tucker,1,12,14,13,3,16.2
2,1,2,4,1,6,3,1,1,26,0,2,8,2,1,0,1037894,2023-12-11T00:00:00.000Z,56677824,29,Taylor Hendricks,2,10,12,10,4,19.4
0,0,0,0,0,0,0,0,0,0,0,0,0,0,0,0,1037894,2023-12-11T00:00:00.000Z,38017705,29,Walker Kessler,0,0,0,0,0,0
1,0,0,0,0,1,1,0,0,4,0,0,2,0,0,0,1037895,2023-12-11T00:00:00.000Z,9051997,3,Armoni Brooks,0,2,3,3,1,3.5
3,0,0,6,2,20,7,2,2,31,0,2,18,0,0,2,1037895,2023-12-11T00:00:00.000Z,17896048,3,Cam Thomas,0,18,21,21,3,20.5
2,0,4,4,3,13,6,0,0,31,0,0,15,4,1,1,1037895,2023-12-11T00:00:00.000Z,666679,3,Cameron Johnson,1,19,21,17,6,24.8
2,1,6,0,0,4,2,0,0,14,1,2,4,7,1,1,1037895,2023-12-11T00:00:00.000Z,17896038,3,Day'Ron Sharpe,2,11,13,6,9,20.4
1,2,3,4,3,6,5,0,0,25,0,0,13,3,1,0,1037895,2023-12-11T00:00:00.000Z,158,3,Dorian Finney-Smith,3,16,17,14,4,27.1
5,0,3,5,3,13,6,7,7,37,2,1,22,5,0,5,1037895,2023-12-11T00:00:00.000Z,61,3,Mikal Bridges,0,27,32,27,10,30.5
0,3,6,0,0,6,3,2,2,26,4,2,8,10,0,0,1037895,2023-12-11T00:00:00.000Z,666508,3,Nicolas Claxton,3,18,18,8,10,29
7,0,2,8,2,15,6,5,4,34,0,2,18,2,0,3,1037895,2023-12-11T00:00:00.000Z,130,3,Spencer Dinwiddie,0,20,27,25,9,27.9
0,1,4,2,0,4,1,0,0,11,1,2,2,5,0,1,1037895,2023-12-11T00:00:00.000Z,4197162,26,Aleksandar Vezenkov,1,7,7,2,5,10
0,0,0,0,0,0,0,0,0,0,0,0,0,0,0,0,1037895,2023-12-11T00:00:00.000Z,273,26,Alex Len,0,0,0,0,0,0
1,0,0,1,0,1,0,0,0,3,0,0,0,0,0,0,1037895,2023-12-11T00:00:00.000Z,17896030,26,Chris Duarte,0,0,1,1,1,1.5
0,0,0,0,0,0,0,0,0,1,0,1,0,0,0,0,1037895,2023-12-11T00:00:00.000Z,56677845,26,Colby Jones,0,0,0,0,0,0
8,0,3,10,5,22,10,6,4,33,0,4,29,3,0,3,1037895,2023-12-11T00:00:00.000Z,161,26,De'Aaron Fox,0,32,40,37,11,41.6
9,0,12,1,1,14,6,4,2,34,4,2,15,16,2,4,1037895,2023-12-11T00:00:00.000Z,406,26,Domantas Sabonis,2,31,40,24,25,49.7
1,1,2,4,3,7,5,1,1,27,0,1,14,2,0,1,1037895,2023-12-11T00:00:00.000Z,30,26,Harrison Barnes,1,16,17,15,3,19.9
2,0,1,0,0,2,0,0,0,8,2,3,0,3,0,1,1037895,2023-12-11T00:00:00.000Z,306,26,JaVale McGee,0,3,5,2,5,5.6
0,0,0,0,0,0,0,0,0,0,0,0,0,0,0,0,1037895,2023-12-11T00:00:00.000Z,17895990,26,Jordan Ford,0,0,0,0,0,0
3,0,2,4,4,13,9,2,2,34,1,4,24,3,0,0,1037895,2023-12-11T00:00:00.000Z,38017688,26,Keegan Murray,0,27,30,27,6,32.1
2,0,1,4,1,4,1,0,0,14,0,1,3,1,1,0,1037895,2023-12-11T00:00:00.000Z,38017714,26,Keon Ellis,1,4,6,5,3,10.2
0,0,0,0,0,0,0,0,0,3,0,0,0,0,0,0,1037895,2023-12-11T00:00:00.000Z,17896044,26,Kessler Edwards,0,0,0,0,0,0
1,0,1,5,2,6,2,0,0,17,0,4,6,1,0,0,1037895,2023-12-11T00:00:00.000Z,221,26,Kevin Huerter,0,7,8,7,2,8.7
1,1,6,6,5,7,6,0,0,23,0,0,17,6,0,0,1037895,2023-12-11T00:00:00.000Z,290,26,Trey Lyles,1,23,24,18,7,28.7
0,0,0,0,0,0,0,0,0,0,0,0,0,0,0,0,1037896,2023-12-11T00:00:00.000Z,17896022,13,Brandon Boston Jr.,0,0,0,0,0,0
2,2,3,0,0,13,9,0,0,34,3,2,18,6,0,0,1037896,2023-12-11T00:00:00.000Z,493,13,Ivica Zubac,2,24,26,20,8,34.2
7,2,7,6,3,14,7,3,3,37,0,2,20,7,1,3,1037896,2023-12-11T00:00:00.000Z,192,13,James Harden,3,27,34,27,14,44.9
5,0,6,8,3,19,11,9,9,39,0,2,34,6,3,1,1037896,2023-12-11T00:00:00.000Z,274,13,Kawhi Leonard,3,40,45,39,11,56.7
0,0,0,1,0,1,0,0,0,5,0,1,0,0,0,0,1037896,2023-12-11T00:00:00.000Z,56677849,13,Kobe Brown,0,0,0,0,0,0
8,1,5,8,2,17,7,4,4,41,3,4,20,8,1,1,1037896,2023-12-11T00:00:00.000Z,172,13,Paul George,2,28,36,28,16,46.6
6,1,1,2,1,7,5,2,1,16,1,1,12,2,0,4,1037896,2023-12-11T00:00:00.000Z,472,13,Russell Westbrook,1,14,20,18,8,22.4
4,0,1,4,1,6,3,2,2,29,2,2,9,3,0,0,1037896,2023-12-11T00:00:00.000Z,666743,13,Terance Mann,0,12,16,13,7,18.6
1,0,3,2,0,3,1,0,0,22,2,0,2,5,1,0,1037897,2023-12-12T00:00:00.000Z,219,2,Al Horford,1,7,8,3,6,12.5
0,0,0,0,0,0,0,0,0,0,0,0,0,0,0,0,1037897,2023-12-12T00:00:00.000Z,17896094,2,Dalano Banton,0,0,0,0,0,0
0,0,0,0,0,0,0,0,0,0,0,0,0,0,0,0,1037897,2023-12-12T00:00:00.000Z,38017707,2,JD Davison,0,0,0,0,0,0
0,0,0,0,0,0,0,0,0,0,0,0,0,0,0,0,1037897,2023-12-12T00:00:00.000Z,56677864,2,Jordan Walsh,0,0,0,0,0,0
2,1,2,5,3,7,4,0,0,34,2,3,11,4,3,1,1037897,2023-12-12T00:00:00.000Z,214,2,Jrue Holiday,4,15,17,13,6,29.8
0,0,0,0,0,0,0,0,0,0,0,0,0,0,0,0,1037897,2023-12-12T00:00:00.000Z,3547279,2,Lamar Stevens,0,0,0,0,0,0
0,0,1,0,0,3,1,2,2,8,3,0,4,4,0,0,1037897,2023-12-12T00:00:00.000Z,261,2,Luke Kornet,0,8,8,4,4,8.8
0,0,0,0,0,0,0,0,0,0,0,0,0,0,0,0,1037897,2023-12-12T00:00:00.000Z,17553967,2,Neemias Queta,0,0,0,0,0,0
0,0,0,0,0,0,0,0,0,0,0,0,0,0,0,0,1037897,2023-12-12T00:00:00.000Z,666468,2,Oshae Brissett,0,0,0,0,0,0
3,1,3,5,2,5,2,0,0,12,0,1,6,3,2,1,1037897,2023-12-12T00:00:00.000Z,3547276,2,Payton Pritchard,3,9,12,9,6,22.1
1,0,2,4,3,5,3,0,0,20,1,1,9,3,0,0,1037897,2023-12-12T00:00:00.000Z,17896060,2,Sam Hauser,0,12,13,10,4,14.1
0,0,0,0,0,0,0,0,0,0,0,0,0,0,0,0,1037897,2023-12-12T00:00:00.000Z,338,2,Svi Mykhailiuk,0,0,0,0,0,0
3,1,2,4,1,11,5,0,0,23,0,1,11,2,0,2,1037897,2023-12-12T00:00:00.000Z,277,6,Caris LeVert,1,13,16,14,5,18.9
0,0,0,0,0,0,0,0,0,0,0,0,0,0,0,0,1037897,2023-12-12T00:00:00.000Z,248,6,Damian Jones,0,0,0,0,0,0
7,0,2,8,4,23,11,0,0,38,0,1,26,2,1,2,1037897,2023-12-12T00:00:00.000Z,666581,6,Darius Garland,1,28,35,33,9,39.9
3,1,2,6,2,6,2,2,2,20,1,3,8,3,0,0,1037897,2023-12-12T00:00:00.000Z,666940,6,Dean Wade,1,11,14,11,6,19.1
3,0,6,13,5,22,11,2,2,35,0,3,29,6,1,3,1037897,2023-12-12T00:00:00.000Z,322,6,Donovan Mitchell,1,35,38,32,9,40.7
0,0,0,0,0,0,0,0,0,0,0,0,0,0,0,0,1037897,2023-12-12T00:00:00.000Z,56677847,6,Emoni Bates,0,0,0,0,0,0
0,0,0,0,0,0,0,0,0,0,0,0,0,0,0,0,1037897,2023-12-12T00:00:00.000Z,17896076,6,Evan Mobley,0,0,0,0,0,0
1,0,2,1,1,1,1,0,0,23,0,1,3,2,0,1,1037897,2023-12-12T00:00:00.000Z,344,6,Georges Niang,0,5,6,4,3,5.9
1,0,2,2,1,4,1,0,0,16,0,1,3,2,1,1,1037897,2023-12-12T00:00:00.000Z,3547247,6,Isaac Okoro,1,5,6,4,3,8.9
0,0,0,0,0,0,0,0,0,0,0,0,0,0,0,0,1037897,2023-12-12T00:00:00.000Z,38017662,6,Isaiah Mobley,0,0,0,0,0,0
5,2,3,0,0,9,6,5,2,36,2,4,14,5,3,2,1037897,2023-12-12T00:00:00.000Z,9,6,Jarrett Allen,5,19,24,19,10,40.5
3,0,9,11,5,15,6,0,0,37,0,4,17,9,0,1,1037897,2023-12-12T00:00:00.000Z,666908,6,Max Strus,0,26,29,20,12,31.3
0,0,0,0,0,0,0,0,0,0,0,0,0,0,0,0,1037897,2023-12-12T00:00:00.000Z,404,6,Ricky Rubio,0,0,0,0,0,0
0,0,0,0,0,0,0,0,0,0,0,0,0,0,0,0,1037897,2023-12-12T00:00:00.000Z,3547299,6,Sam Merrill,0,0,0,0,0,0
1,0,1,0,0,1,1,0,0,12,3,0,2,4,0,0,1037897,2023-12-12T00:00:00.000Z,444,6,Tristan Thompson,0,6,7,3,5,8.3
0,0,0,0,0,0,0,0,0,0,0,0,0,0,0,0,1037897,2023-12-12T00:00:00.000Z,666676,6,Ty Jerome,0,0,0,0,0,0
0,0,0,0,0,0,0,0,0,0,0,0,0,0,0,0,1037898,2023-12-12T00:00:00.000Z,247,7,Derrick Jones Jr.,0,0,0,0,0,0
0,0,0,0,0,0,0,0,0,0,0,0,0,0,0,0,1037898,2023-12-12T00:00:00.000Z,379,7,Dwight Powell,0,0,0,0,0,0
0,0,0,0,0,0,0,0,0,0,0,0,0,0,0,0,1037898,2023-12-12T00:00:00.000Z,3547258,7,Josh Green,0,0,0,0,0,0
0,0,0,0,0,0,0,0,0,0,0,0,0,0,0,0,1037898,2023-12-12T00:00:00.000Z,228,7,Kyrie Irving,0,0,0,0,0,0
0,0,0,0,0,0,0,0,0,0,0,0,0,0,0,0,1037898,2023-12-12T00:00:00.000Z,56677867,14,Alex Fudge,0,0,0,0,0,0
8,0,5,7,4,14,7,5,4,32,0,2,22,5,0,3,1037898,2023-12-12T00:00:00.000Z,17553995,14,Austin Reaves,0,27,35,30,13,37
0,0,0,0,0,0,0,0,0,0,0,0,0,0,0,0,1037898,2023-12-12T00:00:00.000Z,486,14,Christian Wood,0,0,0,0,0,0
0,0,0,0,0,0,0,0,0,0,0,0,0,0,0,0,1037898,2023-12-12T00:00:00.000Z,56677738,14,Colin Castleton,0,0,0,0,0,0
0,0,0,0,0,0,0,0,0,0,0,0,0,0,0,0,1037898,2023-12-12T00:00:00.000Z,56677868,14,D'Moi Hodge,0,0,0,0,0,0
0,0,0,0,0,0,0,0,0,0,0,0,0,0,0,0,1037898,2023-12-12T00:00:00.000Z,1603383,14,Gabe Vincent,0,0,0,0,0,0
0,0,0,0,0,0,0,0,0,0,0,0,0,0,0,0,1037898,2023-12-12T00:00:00.000Z,457,14,Jarred Vanderbilt,0,0,0,0,0,0
1,0,2,0,0,1,0,0,0,13,2,4,0,4,0,0,1037898,2023-12-12T00:00:00.000Z,666626,14,Jaxson Hayes,0,4,5,1,5,6.3
1,0,0,0,0,0,0,0,0,6,0,1,0,0,0,0,1037898,2023-12-12T00:00:00.000Z,38017697,14,Max Christie,0,0,1,1,1,1.5
2,0,3,2,1,9,3,0,0,28,0,3,7,3,1,1,1037898,2023-12-12T00:00:00.000Z,666609,14,Rui Hachimura,1,10,12,9,5,15.6
0,0,0,0,0,0,0,0,0,0,0,0,0,0,0,0,1037899,2023-12-12T00:00:00.000Z,56677860,5,Adama Sanogo,0,0,0,0,0,0
1,1,0,2,0,2,0,2,2,11,0,1,2,0,0,0,1037899,2023-12-12T00:00:00.000Z,38017719,5,Dalen Terry,1,2,3,3,1,6.5
5,2,4,4,1,13,3,7,7,37,0,5,14,4,1,0,1037899,2023-12-12T00:00:00.000Z,125,5,DeMar DeRozan,3,18,23,19,9,35.3
1,0,1,1,0,1,0,0,0,7,0,1,0,1,0,1,1037899,2023-12-12T00:00:00.000Z,56677857,5,Julian Phillips,0,1,2,1,2,1.7
0,0,0,0,0,0,0,0,0,0,0,0,0,0,0,0,1037899,2023-12-12T00:00:00.000Z,45969255,5,Justin Lewis,0,0,0,0,0,0
0,0,0,0,0,0,0,0,0,0,0,0,0,0,0,0,1037899,2023-12-12T00:00:00.000Z,27,5,Lonzo Ball,0,0,0,0,0,0
5,2,12,4,1,21,12,1,1,33,4,1,26,16,0,3,1037899,2023-12-12T00:00:00.000Z,460,5,Nikola Vucevic,2,42,47,31,21,55.7
0,0,0,0,0,0,0,0,0,0,0,0,0,0,0,0,1037899,2023-12-12T00:00:00.000Z,56677874,5,Onuralp Bitim,0,0,0,0,0,0
0,1,2,5,2,8,2,2,1,31,0,1,7,2,0,1,1037899,2023-12-12T00:00:00.000Z,3547248,5,Patrick Williams,1,9,9,7,2,11.4
0,0,0,0,0,1,1,0,0,1,1,0,2,1,0,0,1037899,2023-12-12T00:00:00.000Z,17896116,5,Terry Taylor,0,3,3,2,1,3.2
1,0,3,2,0,4,1,0,0,19,2,4,2,5,1,2,1037899,2023-12-12T00:00:00.000Z,110,5,Torrey Craig,1,7,8,3,6,10.5
0,0,0,0,0,0,0,0,0,0,0,0,0,0,0,0,1037899,2023-12-12T00:00:00.000Z,268,5,Zach LaVine,0,0,0,0,0,0
6,0,2,2,1,13,6,2,1,32,5,1,14,7,0,0,1037899,2023-12-12T00:00:00.000Z,177,8,Aaron Gordon,0,21,27,20,13,31.4
0,0,0,0,0,0,0,0,0,0,0,0,0,0,0,0,1037899,2023-12-12T00:00:00.000Z,17896007,8,Braxton Key,0,0,0,0,0,0
2,1,1,4,2,6,4,4,3,23,1,1,13,2,0,3,1037899,2023-12-12T00:00:00.000Z,38017709,8,Christian Braun,1,15,17,15,4,18.4
0,0,0,0,0,0,0,0,0,0,0,0,0,0,0,0,1037899,2023-12-12T00:00:00.000Z,38017727,8,Collin Gillespie,0,0,0,0,0,0
2,2,6,0,0,4,2,10,5,24,4,5,9,10,1,2,1037899,2023-12-12T00:00:00.000Z,250,8,DeAndre Jordan,3,19,21,11,12,31
0,0,0,0,0,0,0,0,0,0,0,0,0,0,0,0,1037899,2023-12-12T00:00:00.000Z,56677871,8,Hunter Tyson,0,0,0,0,0,0
0,0,0,0,0,0,0,0,0,0,0,0,0,0,0,0,1037899,2023-12-12T00:00:00.000Z,335,8,Jamal Murray,0,0,0,0,0,0
0,0,0,0,0,0,0,0,0,0,0,0,0,0,0,0,1037899,2023-12-12T00:00:00.000Z,17896103,8,Jay Huff,0,0,0,0,0,0
3,0,6,5,2,9,4,8,6,23,0,1,16,6,1,2,1037899,2023-12-12T00:00:00.000Z,56677776,8,Julian Strawther,1,22,25,19,9,28.7
2,0,0,3,2,4,3,0,0,23,1,3,8,1,0,0,1037899,2023-12-12T00:00:00.000Z,215,8,Justin Holiday,0,9,11,10,3,12.2
0,0,1,0,0,4,2,0,0,12,0,2,4,1,0,0,1037899,2023-12-12T00:00:00.000Z,81,8,Kentavious Caldwell-Pope,0,5,5,4,1,5.2
0,0,7,8,2,16,6,4,3,32,0,1,17,7,1,0,1037899,2023-12-12T00:00:00.000Z,375,8,Michael Porter Jr.,1,24,24,17,7,28.4
6,0,6,0,0,5,2,0,0,16,3,1,4,9,0,0,1037899,2023-12-12T00:00:00.000Z,246,8,Nikola Jokic,0,13,19,10,15,23.8
1,1,0,0,0,6,1,2,2,23,1,1,4,1,1,1,1037899,2023-12-12T00:00:00.000Z,38017721,8,Peyton Watson,2,5,6,5,2,11.7
6,0,2,8,5,16,9,2,2,32,0,4,25,2,0,2,1037899,2023-12-12T00:00:00.000Z,236,8,Reggie Jackson,0,27,33,31,8,34.4
0,0,0,0,0,0,0,0,0,0,0,0,0,0,0,0,1037899,2023-12-12T00:00:00.000Z,666489,8,Vlatko Cancar,0,0,0,0,0,0
0,0,0,0,0,0,0,0,0,0,0,0,0,0,0,0,1037899,2023-12-12T00:00:00.000Z,3547268,8,Zeke Nnaji,0,0,0,0,0,0
1,0,2,3,1,7,1,0,0,15,2,1,3,4,0,3,1037900,2023-12-12T00:00:00.000Z,475,10,Andrew Wiggins,0,7,8,4,5,6.3
5,0,6,4,2,14,9,1,0,29,5,2,20,11,1,3,1037900,2023-12-12T00:00:00.000Z,56677858,10,Brandin Podziemski,1,31,36,25,16,40.7
11,0,5,4,3,8,5,3,2,30,0,4,15,5,2,1,1037900,2023-12-12T00:00:00.000Z,367,10,Chris Paul,2,20,31,26,16,42.5
0,0,0,0,0,0,0,0,0,0,0,0,0,0,0,0,1037900,2023-12-12T00:00:00.000Z,251,10,Cory Joseph,0,0,0,0,0,0
1,0,3,4,2,9,5,4,3,20,1,5,15,4,0,0,1037900,2023-12-12T00:00:00.000Z,407,10,Dario Saric,0,19,20,16,5,21.3
2,0,2,2,0,3,1,0,0,17,0,3,2,2,0,3,1037900,2023-12-12T00:00:00.000Z,185,10,Draymond Green,0,4,6,4,4,4.4
0,0,0,0,0,0,0,0,0,0,0,0,0,0,0,0,1037900,2023-12-12T00:00:00.000Z,2189,10,Gary Payton II,0,0,0,0,0,0
0,0,0,0,0,0,0,0,0,0,0,0,0,0,0,0,1037900,2023-12-12T00:00:00.000Z,57875092,10,Gui Santos,0,0,0,0,0,0
0,0,0,0,0,0,0,0,0,0,0,0,0,0,0,0,1037900,2023-12-12T00:00:00.000Z,398,10,Jerome Robinson,0,0,0,0,0,0
0,0,4,3,1,10,6,7,3,28,2,4,16,6,1,1,1037900,2023-12-12T00:00:00.000Z,17553979,10,Jonathan Kuminga,1,22,22,16,6,25.2
2,0,3,0,0,0,0,0,0,11,2,2,0,5,1,0,1037900,2023-12-12T00:00:00.000Z,282,10,Kevon Looney,1,5,7,2,7,12
0,0,5,8,1,10,2,2,2,27,0,1,7,5,0,1,1037900,2023-12-12T00:00:00.000Z,443,10,Klay Thompson,0,12,12,7,5,12
0,0,0,0,0,0,0,0,0,0,0,0,0,0,0,0,1037900,2023-12-12T00:00:00.000Z,45658838,10,Lester Quinones,0,0,0,0,0,0
0,0,3,3,2,6,3,6,4,24,1,3,12,4,0,2,1037900,2023-12-12T00:00:00.000Z,17553992,10,Moses Moody,0,16,16,12,4,14.8
4,0,5,15,4,24,8,4,4,32,0,2,24,5,3,1,1037900,2023-12-12T00:00:00.000Z,115,10,Stephen Curry,3,29,33,28,9,44
0,1,0,0,0,1,1,0,0,7,0,1,2,0,1,0,1037900,2023-12-12T00:00:00.000Z,56677799,10,Trayce Jackson-Davis,2,2,2,2,0,8
0,0,0,0,0,0,0,0,0,0,0,0,0,0,0,0,1037900,2023-12-12T00:00:00.000Z,17896070,10,Usman Garuba,0,0,0,0,0,0
0,0,0,0,0,0,0,0,0,0,0,0,0,0,0,0,1037900,2023-12-12T00:00:00.000Z,272,24,Damion Lee,0,0,0,0,0,0
1,2,5,0,0,1,1,1,1,17,1,1,3,6,1,3,1037900,2023-12-12T00:00:00.000Z,147,24,Drew Eubanks,3,9,10,4,7,17.7
0,0,0,6,1,11,3,1,1,32,0,1,8,0,0,1,1037900,2023-12-12T00:00:00.000Z,178,24,Eric Gordon,0,8,8,8,0,7
0,0,0,0,0,0,0,0,0,0,0,0,0,0,0,0,1037900,2023-12-12T00:00:00.000Z,8,24,Grayson Allen,0,0,0,0,0,0
6,1,5,5,1,10,5,5,5,30,0,3,16,5,2,1,1037900,2023-12-12T00:00:00.000Z,18678058,24,Jordan Goodwin,3,21,27,22,11,39
0,0,0,0,0,0,0,0,0,0,0,0,0,0,0,0,1037900,2023-12-12T00:00:00.000Z,140,24,Kevin Durant,0,0,0,0,0,0
0,0,0,0,0,0,0,0,0,0,0,0,0,0,0,0,1037900,2023-12-12T00:00:00.000Z,666729,24,Nassir Little,0,0,0,0,0,0
0,0,0,0,0,0,0,0,0,0,0,0,0,0,0,0,1037900,2023-12-12T00:00:00.000Z,3547298,24,Saben Lee,0,0,0,0,0,0
0,0,0,0,0,0,0,0,0,0,0,0,0,0,0,0,1037900,2023-12-12T00:00:00.000Z,3547095,24,Udoka Azubuike,0,0,0,0,0,0
1,1,1,4,1,4,1,0,0,20,0,2,3,1,1,1,1037900,2023-12-12T00:00:00.000Z,470,24,Yuta Watanabe,2,4,5,4,2,10.7
0,0,0,0,0,1,1,0,0,9,1,0,2,1,0,0,1037901,2023-12-12T00:00:00.000Z,666511,13,Amir Coffey,0,3,3,2,1,3.2
0,0,0,0,0,0,0,0,0,0,0,0,0,0,0,0,1037901,2023-12-12T00:00:00.000Z,17896022,13,Brandon Boston Jr.,0,0,0,0,0,0
0,0,2,1,0,8,4,0,0,16,1,2,8,3,1,0,1037901,2023-12-12T00:00:00.000Z,439,13,Daniel Theis,1,11,11,8,3,14.6
0,0,9,0,0,5,3,1,0,23,0,4,6,9,0,1,1037901,2023-12-12T00:00:00.000Z,493,13,Ivica Zubac,0,15,15,6,9,15.8
7,0,6,4,0,9,4,7,7,28,0,3,15,6,2,2,1037901,2023-12-12T00:00:00.000Z,192,13,James Harden,2,21,28,22,13,36.7
0,0,0,0,0,0,0,0,0,0,0,0,0,0,0,0,1037901,2023-12-12T00:00:00.000Z,56677856,13,Jordan Miller,0,0,0,0,0,0
0,0,0,0,0,0,0,0,0,0,0,0,0,0,0,0,1037901,2023-12-12T00:00:00.000Z,17896051,13,Joshua Primo,0,0,0,0,0,0
3,1,4,3,2,14,11,7,7,31,0,0,31,4,1,1,1037901,2023-12-12T00:00:00.000Z,274,13,Kawhi Leonard,2,35,38,34,7,45.3
0,1,5,3,1,5,3,0,0,24,1,5,7,6,0,1,1037901,2023-12-12T00:00:00.000Z,56677849,13,Kobe Brown,1,13,13,7,6,16.2
0,0,0,0,0,0,0,0,0,0,0,0,0,0,0,0,1037901,2023-12-12T00:00:00.000Z,371,13,Mason Plumlee,0,0,0,0,0,0
0,0,0,0,0,0,0,0,0,0,0,0,0,0,0,0,1037901,2023-12-12T00:00:00.000Z,38017725,13,Moussa Diabate,0,0,0,0,0,0
1,0,1,4,2,8,2,0,0,9,0,0,6,1,0,0,1037901,2023-12-12T00:00:00.000Z,17896031,13,Nah'Shon Hyland,0,7,8,7,2,8.7
2,0,1,4,2,11,5,3,3,27,0,1,15,1,0,1,1037901,2023-12-12T00:00:00.000Z,380,13,Norman Powell,0,16,18,17,3,18.2
1,0,6,5,2,7,3,1,1,16,0,0,9,6,2,3,1037901,2023-12-12T00:00:00.000Z,172,13,Paul George,2,15,16,10,7,20.7
0,0,0,0,0,0,0,0,0,0,0,0,0,0,0,0,1037901,2023-12-12T00:00:00.000Z,450,13,PJ Tucker,0,0,0,0,0,0
3,0,5,1,0,8,4,0,0,20,2,0,8,7,0,4,1037901,2023-12-12T00:00:00.000Z,472,13,Russell Westbrook,0,15,18,11,10,16.9
2,0,4,3,2,6,3,2,2,30,1,1,10,5,1,1,1037901,2023-12-12T00:00:00.000Z,666743,13,Terance Mann,1,15,17,12,7,21
2,0,0,1,0,2,1,0,0,7,0,1,2,0,0,1,1037901,2023-12-12T00:00:00.000Z,24417679,13,Xavier Moon,0,2,4,4,2,4
3,0,3,3,1,7,4,0,0,20,0,0,9,3,1,0,1037901,2023-12-12T00:00:00.000Z,4197162,26,Aleksandar Vezenkov,1,12,15,12,6,20.1
0,0,0,0,0,0,0,0,0,0,0,0,0,0,0,0,1037901,2023-12-12T00:00:00.000Z,273,26,Alex Len,0,0,0,0,0,0
1,1,2,2,0,3,1,4,4,12,0,1,6,2,0,0,1037901,2023-12-12T00:00:00.000Z,17896030,26,Chris Duarte,1,8,9,7,3,12.9
0,0,0,0,0,0,0,0,0,0,0,0,0,0,0,0,1037901,2023-12-12T00:00:00.000Z,56677845,26,Colby Jones,0,0,0,0,0,0
2,0,0,1,0,3,0,2,1,15,0,1,1,0,0,0,1037901,2023-12-12T00:00:00.000Z,17553994,26,Davion Mitchell,0,1,3,3,2,4
3,0,3,7,3,16,5,1,1,25,0,3,14,3,0,4,1037901,2023-12-12T00:00:00.000Z,161,26,De'Aaron Fox,0,17,20,17,6,18.1
3,0,5,2,0,11,5,8,5,26,5,3,15,10,2,2,1037901,2023-12-12T00:00:00.000Z,406,26,Domantas Sabonis,2,25,28,18,13,35.5
1,0,1,2,0,3,1,0,0,19,0,2,2,1,0,0,1037901,2023-12-12T00:00:00.000Z,30,26,Harrison Barnes,0,3,4,3,2,4.7
0,0,0,0,0,0,0,0,0,0,0,0,0,0,0,0,1037901,2023-12-12T00:00:00.000Z,56677862,26,Jalen Slawson,0,0,0,0,0,0
0,0,0,0,0,3,3,1,0,6,1,1,6,1,0,1,1037901,2023-12-12T00:00:00.000Z,306,26,JaVale McGee,0,7,7,6,1,6.2
1,0,1,1,1,2,2,0,0,8,0,0,5,1,0,1,1037901,2023-12-12T00:00:00.000Z,17895990,26,Jordan Ford,0,6,7,6,2,6.7
1,0,7,5,0,14,6,6,5,31,0,2,17,7,3,0,1037901,2023-12-12T00:00:00.000Z,38017688,26,Keegan Murray,3,24,25,18,8,35.9
1,1,0,1,1,1,1,0,0,12,0,0,3,0,0,2,1037901,2023-12-12T00:00:00.000Z,38017714,26,Keon Ellis,1,3,4,4,1,5.5
0,0,0,1,1,3,3,0,0,8,0,0,7,0,0,0,1037901,2023-12-12T00:00:00.000Z,17896044,26,Kessler Edwards,0,7,7,7,0,7
3,0,4,4,1,8,1,0,0,16,0,1,3,4,1,0,1037901,2023-12-12T00:00:00.000Z,221,26,Kevin Huerter,1,7,10,6,7,15.3
5,0,0,5,2,8,3,0,0,22,0,4,8,0,0,4,1037901,2023-12-12T00:00:00.000Z,324,26,Malik Monk,0,8,13,13,5,11.5
3,0,5,3,0,4,1,2,1,20,1,1,3,6,1,0,1037901,2023-12-12T00:00:00.000Z,290,26,Trey Lyles,1,9,12,6,9,17.7
0,0,2,3,1,7,1,0,0,13,1,1,3,3,1,0,1037902,2023-12-13T00:00:00.000Z,77,9,Alec Burks,1,6,6,3,3,9.6
3,0,6,1,0,7,5,0,0,30,2,3,10,8,1,0,1037902,2023-12-13T00:00:00.000Z,56677826,9,Ausar Thompson,1,18,21,13,11,27.1
2,0,1,9,5,19,11,8,6,34,0,1,33,1,1,1,1037902,2023-12-13T00:00:00.000Z,54,9,Bojan Bogdanovic,1,34,36,35,3,39.2
7,0,5,8,1,17,5,12,10,30,1,3,21,6,0,1,1037902,2023-12-13T00:00:00.000Z,17896075,9,Cade Cunningham,0,27,34,28,13,37.7
0,0,3,2,0,4,1,0,0,27,0,1,2,3,1,0,1037902,2023-12-13T00:00:00.000Z,17896071,9,Isaiah Livers,1,5,5,2,3,8.6
2,0,2,1,0,3,1,2,2,22,2,3,4,4,0,2,1037902,2023-12-13T00:00:00.000Z,3547267,9,Isaiah Stewart,0,8,10,6,6,9.8
1,1,2,3,0,8,2,6,3,21,0,2,7,2,0,0,1037902,2023-12-13T00:00:00.000Z,38017682,9,Jaden Ivey,1,9,10,8,3,13.9
0,0,0,0,0,0,0,0,0,0,0,0,0,0,0,0,1037902,2023-12-13T00:00:00.000Z,38017694,9,Jalen Duren,0,0,0,0,0,0
0,1,3,0,0,7,5,0,0,16,0,6,10,3,1,1,1037902,2023-12-13T00:00:00.000Z,3547240,9,James Wiseman,2,13,13,10,3,18.6
0,0,0,0,0,0,0,0,0,0,0,0,0,0,0,0,1037902,2023-12-13T00:00:00.000Z,197,9,Joe Harris,0,0,0,0,0,0
2,1,2,4,1,5,2,2,2,10,0,0,7,2,0,2,1037902,2023-12-13T00:00:00.000Z,259,9,Kevin Knox,1,9,11,9,4,13.4
6,0,3,0,0,8,3,0,0,32,0,2,6,3,1,1,1037902,2023-12-13T00:00:00.000Z,3547241,9,Killian Hayes,1,9,15,12,9,20.6
0,0,0,0,0,0,0,0,0,0,0,0,0,0,0,0,1037902,2023-12-13T00:00:00.000Z,56677729,9,Malcolm Cazalon,0,0,0,0,0,0
1,0,0,2,2,3,3,0,0,5,0,0,8,0,0,1,1037902,2023-12-13T00:00:00.000Z,56677792,9,Marcus Sasser,0,8,9,9,1,8.5
0,0,0,0,0,0,0,0,0,0,0,0,0,0,0,0,1037902,2023-12-13T00:00:00.000Z,24,9,Marvin Bagley III,0,0,0,0,0,0
0,0,0,0,0,0,0,0,0,0,0,0,0,0,0,0,1037902,2023-12-13T00:00:00.000Z,330,9,Monte Morris,0,0,0,0,0,0
1,0,0,1,0,3,0,0,0,7,0,0,0,0,0,0,1037902,2023-12-13T00:00:00.000Z,2175,23,Danuel House Jr.,0,0,1,1,1,1.5
1,2,5,4,2,9,4,0,0,21,1,4,10,6,1,0,1037902,2023-12-13T00:00:00.000Z,313,23,De'Anthony Melton,3,16,17,11,7,27.7
0,0,0,1,0,1,0,0,0,5,0,0,0,0,0,0,1037902,2023-12-13T00:00:00.000Z,260,23,Furkan Korkmaz,0,0,0,0,0,0
2,0,0,1,1,2,1,4,2,7,0,1,5,0,0,0,1037902,2023-12-13T00:00:00.000Z,17896025,23,Jaden Springer,0,5,7,7,2,8
0,0,0,0,0,0,0,0,0,0,0,0,0,0,0,0,1037902,2023-12-13T00:00:00.000Z,17554001,23,Javonte Smart,0,0,0,0,0,0
1,0,3,4,2,9,7,2,1,23,0,2,17,3,2,2,1037902,2023-12-13T00:00:00.000Z,360,23,Kelly Oubre Jr.,2,20,21,18,4,26.1
1,0,1,0,0,1,1,0,0,4,1,0,2,2,1,0,1037902,2023-12-13T00:00:00.000Z,3547294,23,Kenyon Martin Jr.,1,4,5,3,3,8.9
2,1,7,0,0,2,2,0,0,16,1,2,4,8,0,0,1037902,2023-12-13T00:00:00.000Z,328,23,Marcus Morris,1,12,14,6,10,19.6
0,0,0,0,0,1,1,0,0,4,0,0,2,0,0,0,1037902,2023-12-13T00:00:00.000Z,28,23,Mo Bamba,0,2,2,2,0,2
1,0,1,2,1,3,1,2,0,13,0,2,3,1,0,0,1037902,2023-12-13T00:00:00.000Z,45,23,Patrick Beverley,0,4,5,4,2,5.7
0,0,3,0,0,3,1,3,3,13,1,2,5,4,0,3,1037902,2023-12-13T00:00:00.000Z,3547270,23,Paul Reed,0,9,9,5,4,6.8
0,0,0,0,0,0,0,0,0,0,0,0,0,0,0,0,1037902,2023-12-13T00:00:00.000Z,56913527,23,Ricky Council IV,0,0,0,0,0,0
2,0,6,2,0,4,2,1,1,17,0,2,5,6,0,1,1037902,2023-12-13T00:00:00.000Z,108,23,Robert Covington,0,11,13,7,8,14.2
0,0,0,0,0,0,0,0,0,0,0,0,0,0,0,0,1037902,2023-12-13T00:00:00.000Z,56677788,23,Terquavion Smith,0,0,0,0,0,0
9,0,3,6,0,13,2,6,5,33,1,1,9,4,0,1,1037902,2023-12-13T00:00:00.000Z,3547254,23,Tyrese Maxey,0,13,22,18,13,26.3
3,1,1,4,1,23,14,12,11,31,1,2,40,2,0,1,1037903,2023-12-13T00:00:00.000Z,227,19,Brandon Ingram,1,42,45,43,5,48.9
6,0,3,6,4,14,8,2,2,32,0,3,22,3,0,0,1037903,2023-12-13T00:00:00.000Z,303,19,CJ McCollum,0,25,31,28,9,34.6
2,0,2,4,0,6,1,0,0,16,2,0,2,4,2,0,1037903,2023-12-13T00:00:00.000Z,38017677,19,Dyson Daniels,2,6,8,4,6,15.8
1,0,1,1,0,9,3,0,0,20,1,3,6,2,2,1,1037903,2023-12-13T00:00:00.000Z,17896024,19,Herbert Jones,2,8,9,7,3,14.9
3,1,15,1,1,9,6,4,3,33,3,4,16,18,1,4,1037903,2023-12-13T00:00:00.000Z,455,19,Jonas Valanciunas,2,34,37,19,21,44.1
1,0,2,2,0,7,1,0,0,19,1,1,2,3,0,0,1037903,2023-12-13T00:00:00.000Z,56677837,19,Jordan Hawkins,0,5,6,3,4,7.1
1,0,1,3,2,3,2,2,1,18,0,2,7,1,2,2,1037903,2023-12-13T00:00:00.000Z,17896097,19,Jose Alvarado,2,8,9,8,2,13.7
7,0,4,5,2,11,6,2,2,27,0,1,16,4,2,1,1037903,2023-12-13T00:00:00.000Z,3547293,19,Naji Marshall,2,20,27,23,11,36.3
4,1,6,7,6,10,7,8,7,33,0,0,27,6,2,0,1037903,2023-12-13T00:00:00.000Z,18677986,19,Trey Murphy III,3,33,37,31,10,49.2
2,0,2,1,0,2,1,0,0,10,0,2,2,2,0,0,1037903,2023-12-13T00:00:00.000Z,3547302,30,Anthony Gill,0,4,6,4,4,7.4
1,1,4,6,4,9,6,2,0,32,1,3,16,5,1,2,1037903,2023-12-13T00:00:00.000Z,56677844,30,Bilal Coulibaly,2,21,22,17,6,27.5
0,1,3,6,3,7,4,2,1,21,0,2,12,3,0,1,1037903,2023-12-13T00:00:00.000Z,17896045,30,Corey Kispert,1,15,15,12,3,17.6
0,2,5,0,0,6,5,4,3,24,1,3,13,6,1,1,1037903,2023-12-13T00:00:00.000Z,666577,30,Daniel Gafford,3,19,19,13,6,28.2
1,0,1,3,1,6,2,4,4,16,0,0,9,1,0,1,1037903,2023-12-13T00:00:00.000Z,167,30,Danilo Gallinari,0,10,11,10,2,10.7
0,0,0,0,0,0,0,0,0,0,0,0,0,0,0,0,1037903,2023-12-13T00:00:00.000Z,487,30,Delon Wright,0,0,0,0,0,0
7,0,5,3,1,8,4,4,4,30,1,1,13,6,0,2,1037903,2023-12-13T00:00:00.000Z,3547242,30,Deni Avdija,0,19,26,20,13,28.7
0,0,0,0,0,0,0,0,0,0,0,0,0,0,0,0,1037903,2023-12-13T00:00:00.000Z,17896106,30,Eugene Omoruyi,0,0,0,0,0,0
4,0,1,4,2,4,2,2,2,13,0,1,8,1,1,1,1037903,2023-12-13T00:00:00.000Z,18677954,30,Jared Butler,1,9,13,12,5,17.2
0,0,0,0,0,0,0,0,0,0,0,0,0,0,0,0,1037903,2023-12-13T00:00:00.000Z,38017687,30,Johnny Davis,0,0,0,0,0,0
4,1,1,5,1,12,5,0,0,31,0,2,11,1,2,5,1037903,2023-12-13T00:00:00.000Z,666848,30,Jordan Poole,3,12,16,15,5,22.2
4,1,7,8,4,19,10,4,3,29,0,1,27,7,1,1,1037903,2023-12-13T00:00:00.000Z,265,30,Kyle Kuzma,2,34,38,31,11,46.4
0,0,0,0,0,0,0,0,0,0,0,0,0,0,0,0,1037903,2023-12-13T00:00:00.000Z,414,30,Landry Shamet,0,0,0,0,0,0
0,0,1,2,0,2,0,0,0,4,0,0,0,1,0,0,1037903,2023-12-13T00:00:00.000Z,337,30,Mike Muscala,0,1,1,0,1,1.2
1,0,0,1,1,1,1,2,2,4,0,1,5,0,0,0,1037903,2023-12-13T00:00:00.000Z,38017704,30,Patrick Baldwin Jr.,0,5,6,6,1,6.5
0,0,0,0,0,0,0,0,0,0,0,0,0,0,0,0,1037903,2023-12-13T00:00:00.000Z,38017712,30,Ryan Rollins,0,0,0,0,0,0
4,0,0,5,2,6,2,0,0,26,0,0,6,0,1,1,1037903,2023-12-13T00:00:00.000Z,249,30,Tyus Jones,1,6,10,10,4,14
0,0,0,0,0,0,0,0,0,0,0,0,0,0,0,0,1037904,2023-12-13T00:00:00.000Z,56677848,4,Amari Bailey,0,0,0,0,0,0
2,0,2,10,4,16,7,0,0,39,0,3,18,2,2,5,1037904,2023-12-13T00:00:00.000Z,56677823,4,Brandon Miller,2,20,22,20,4,24.4
0,0,0,0,0,0,0,0,0,0,0,0,0,0,0,0,1037904,2023-12-13T00:00:00.000Z,666748,4,Cody Martin,0,0,0,0,0,0
0,0,0,0,0,0,0,0,0,0,0,0,0,0,0,0,1037904,2023-12-13T00:00:00.000Z,347,4,Frank Ntilikina,0,0,0,0,0,0
7,0,4,2,1,12,7,5,5,35,1,2,20,5,0,4,1037904,2023-12-13T00:00:00.000Z,204,4,Gordon Hayward,0,25,32,27,12,32.5
4,0,2,1,0,5,3,0,0,17,0,3,6,2,0,3,1037904,2023-12-13T00:00:00.000Z,422,4,Ish Smith,0,8,12,10,6,11.4
0,0,0,0,0,0,0,0,0,0,0,0,0,0,0,0,1037904,2023-12-13T00:00:00.000Z,3547239,4,LaMelo Ball,0,0,0,0,0,0
0,0,0,0,0,0,0,0,0,0,0,0,0,0,0,0,1037904,2023-12-13T00:00:00.000Z,56677866,4,Leaky Black,0,0,0,0,0,0
0,0,0,0,0,0,0,0,0,0,0,0,0,0,0,0,1037904,2023-12-13T00:00:00.000Z,38017698,4,Mark Williams,0,0,0,0,0,0
4,1,4,8,1,19,9,0,0,34,1,2,19,5,2,4,1037904,2023-12-13T00:00:00.000Z,62,4,Miles Bridges,3,24,28,23,9,36
0,4,10,0,0,5,3,1,0,40,1,1,6,11,0,2,1037904,2023-12-13T00:00:00.000Z,3547282,4,Nick Richards,4,17,17,6,11,29.2
0,0,0,0,0,0,0,0,0,0,0,0,0,0,0,0,1037904,2023-12-13T00:00:00.000Z,56677846,4,Nick Smith Jr.,0,0,0,0,0,0
1,0,0,0,0,0,0,0,0,4,0,0,0,0,1,1,1037904,2023-12-13T00:00:00.000Z,666950,4,P.J. Washington,1,0,1,1,1,3.5
7,1,3,6,5,14,10,3,3,37,0,2,28,3,4,1,1037904,2023-12-13T00:00:00.000Z,403,4,Terry Rozier,5,31,38,35,10,56.1
0,0,0,0,0,0,0,0,0,0,0,0,0,0,0,0,1037904,2023-12-13T00:00:00.000Z,3547253,4,Theo Maledon,0,0,0,0,0,0
0,0,0,0,0,0,0,0,0,0,0,0,0,0,0,0,1037904,2023-12-13T00:00:00.000Z,4,16,Bam Adebayo,0,0,0,0,0,0
4,1,3,3,1,13,4,0,0,36,3,2,9,6,0,4,1037904,2023-12-13T00:00:00.000Z,666747,16,Caleb Martin,1,15,19,13,10,21.2
0,0,0,0,0,0,0,0,0,0,0,0,0,0,0,0,1037904,2023-12-13T00:00:00.000Z,38017736,16,Cole Swider,0,0,0,0,0,0
0,0,0,0,0,0,0,0,0,0,0,0,0,0,0,0,1037904,2023-12-13T00:00:00.000Z,19465585,16,Dru Smith,0,0,0,0,0,0
3,0,2,9,6,12,7,3,3,41,0,2,23,2,2,3,1037904,2023-12-13T00:00:00.000Z,397,16,Duncan Robinson,2,25,28,26,5,32.9
0,0,0,0,0,0,0,0,0,0,0,0,0,0,0,0,1037904,2023-12-13T00:00:00.000Z,3092,16,Haywood Highsmith,0,0,0,0,0,0
8,0,4,2,2,16,7,1,1,33,2,0,17,6,1,2,1037904,2023-12-13T00:00:00.000Z,56677785,16,Jaime Jaquez Jr.,1,23,31,25,14,37.2
1,1,1,6,2,12,5,2,2,29,2,0,14,3,2,0,1037904,2023-12-13T00:00:00.000Z,38017734,16,Jamal Cain,3,17,18,15,4,28.1
10,0,4,0,0,8,4,7,7,29,2,1,15,6,1,4,1037904,2023-12-13T00:00:00.000Z,79,16,Jimmy Butler,1,21,31,25,16,36.2
0,0,0,0,0,0,0,0,0,0,0,0,0,0,0,0,1037904,2023-12-13T00:00:00.000Z,391,16,Josh Richardson,0,0,0,0,0,0
1,1,9,6,0,9,1,2,1,20,0,1,3,9,2,2,1037904,2023-12-13T00:00:00.000Z,285,16,Kevin Love,3,12,13,4,10,22.3
1,0,2,4,4,5,5,3,3,24,0,2,17,2,2,2,1037904,2023-12-13T00:00:00.000Z,286,16,Kyle Lowry,2,19,20,18,3,24.9
0,0,0,0,0,0,0,0,0,0,0,0,0,0,0,0,1037904,2023-12-13T00:00:00.000Z,38017696,16,Nikola Jovic,0,0,0,0,0,0
1,0,2,0,0,5,3,0,0,12,2,2,6,4,0,3,1037904,2023-12-13T00:00:00.000Z,39398582,16,Orlando Robinson,0,10,11,7,5,9.3
0,0,0,0,0,0,0,0,0,0,0,0,0,0,0,0,1037904,2023-12-13T00:00:00.000Z,3547257,16,R.J. Hampton,0,0,0,0,0,0
0,0,3,0,0,7,5,1,1,16,6,2,11,9,0,1,1037904,2023-12-13T00:00:00.000Z,74,16,Thomas Bryant,0,20,20,11,9,20.8
0,0,0,0,0,0,0,0,0,0,0,0,0,0,0,0,1037904,2023-12-13T00:00:00.000Z,666633,16,Tyler Herro,0,0,0,0,0,0
0,0,0,0,0,0,0,0,0,0,0,0,0,0,0,0,1037905,2023-12-13T00:00:00.000Z,38017689,1,AJ Griffin,0,0,0,0,0,0
5,0,2,7,4,13,7,3,2,32,1,4,20,3,3,1,1037905,2023-12-13T00:00:00.000Z,53,1,Bogdan Bogdanovic,3,23,28,25,8,39.1
0,0,0,0,0,0,0,0,0,0,0,0,0,0,0,0,1037905,2023-12-13T00:00:00.000Z,666564,1,Bruno Fernando,0,0,0,0,0,0
1,3,4,0,0,12,7,4,3,34,6,3,17,10,0,0,1037905,2023-12-13T00:00:00.000Z,83,1,Clint Capela,3,27,28,18,11,39.5
0,0,0,0,0,0,0,0,0,0,0,0,0,0,0,0,1037905,2023-12-13T00:00:00.000Z,666656,1,De'Andre Hunter,0,0,0,0,0,0
5,2,3,9,4,17,8,1,0,34,0,2,20,3,0,0,1037905,2023-12-13T00:00:00.000Z,334,1,Dejounte Murray,2,23,28,25,8,37.1
0,0,2,2,2,2,2,0,0,19,0,2,6,2,1,0,1037905,2023-12-13T00:00:00.000Z,666754,1,Garrison Mathews,1,8,8,6,2,11.4
0,0,0,0,0,0,0,0,0,0,0,0,0,0,0,0,1037905,2023-12-13T00:00:00.000Z,17896040,1,Jalen Johnson,0,0,0,0,0,0
0,0,0,0,0,0,0,0,0,0,0,0,0,0,0,0,1037905,2023-12-13T00:00:00.000Z,56677838,1,Kobe Bufkin,0,0,0,0,0,0
0,0,0,0,0,0,0,0,0,0,0,0,0,0,0,0,1037905,2023-12-13T00:00:00.000Z,56677875,1,Miles Norris,0,0,0,0,0,0
0,0,0,0,0,0,0,0,0,0,0,0,0,0,0,0,1037905,2023-12-13T00:00:00.000Z,56677806,1,Mouhamed Gueye,0,0,0,0,0,0
1,2,6,5,3,9,5,0,0,30,2,0,13,8,1,0,1037905,2023-12-13T00:00:00.000Z,3547244,1,Onyeka Okongwu,3,21,22,14,9,33.1
2,0,7,5,0,14,5,3,2,38,3,1,12,10,2,1,1037905,2023-12-13T00:00:00.000Z,3547256,1,Saddiq Bey,2,22,24,14,12,32
17,1,4,9,4,27,13,6,5,39,0,3,35,4,0,5,1037905,2023-12-13T00:00:00.000Z,490,1,Trae Young,1,39,56,52,21,63.3
1,0,1,4,1,6,1,2,2,14,1,3,5,2,2,0,1037905,2023-12-13T00:00:00.000Z,301,1,Wesley Matthews,2,7,8,6,3,14.9
0,2,0,1,0,2,1,0,0,10,0,0,2,0,0,0,1037905,2023-12-13T00:00:00.000Z,58,28,Chris Boucher,2,2,2,2,0,8
0,0,0,0,0,0,0,0,0,0,0,0,0,0,0,0,1037905,2023-12-13T00:00:00.000Z,38017710,28,Christian Koloko,0,0,0,0,0,0
7,1,3,4,3,11,5,4,4,37,0,5,17,3,1,2,1037905,2023-12-13T00:00:00.000Z,409,28,Dennis Schroder,2,20,27,24,10,35.1
0,0,0,0,0,0,0,0,0,0,0,0,0,0,0,0,1037905,2023-12-13T00:00:00.000Z,436,28,Garrett Temple,0,0,0,0,0,0
1,0,0,8,4,11,4,0,0,20,0,0,12,0,0,0,1037905,2023-12-13T00:00:00.000Z,3089,28,Gary Trent Jr.,0,12,13,13,1,13.5
0,0,0,0,0,0,0,0,0,0,0,0,0,0,0,0,1037905,2023-12-13T00:00:00.000Z,56677828,28,Gradey Dick,0,0,0,0,0,0
6,3,9,0,0,8,5,8,5,32,4,4,15,13,0,1,1037905,2023-12-13T00:00:00.000Z,373,28,Jakob Poeltl,3,28,34,21,19,47.6
0,0,0,0,0,0,0,0,0,0,0,0,0,0,0,0,1037905,2023-12-13T00:00:00.000Z,666762,28,Jalen McDaniels,0,0,0,0,0,0
0,0,0,0,0,0,0,0,0,0,0,0,0,0,0,0,1037905,2023-12-13T00:00:00.000Z,56677805,28,Javon Freeman-Liberty,0,0,0,0,0,0
0,0,0,0,0,0,0,0,0,0,0,0,0,0,0,0,1037905,2023-12-13T00:00:00.000Z,2309958,28,Jontay Porter,0,0,0,0,0,0
8,0,2,3,0,4,0,0,0,17,0,2,0,2,0,2,1037905,2023-12-13T00:00:00.000Z,3547275,28,Malachi Flynn,0,2,10,8,10,12.4
0,0,0,0,0,0,0,0,0,0,0,0,0,0,0,0,1037905,2023-12-13T00:00:00.000Z,56677869,28,Markquis Nowell,0,0,0,0,0,0
3,0,3,5,2,13,10,0,0,37,2,4,22,5,1,2,1037905,2023-12-13T00:00:00.000Z,18,28,OG Anunoby,1,27,30,25,8,33.5
0,0,0,0,0,0,0,0,0,0,0,0,0,0,0,0,1037905,2023-12-13T00:00:00.000Z,376,28,Otto Porter Jr.,0,0,0,0,0,0
7,0,6,6,5,19,12,7,4,36,1,0,33,7,0,2,1037905,2023-12-13T00:00:00.000Z,416,28,Pascal Siakam,0,40,47,40,14,49.9
1,2,6,3,1,5,2,2,2,17,1,0,7,7,1,2,1037905,2023-12-13T00:00:00.000Z,3547249,28,Precious Achiuwa,3,14,15,8,8,23.9
6,1,9,4,3,14,11,3,2,34,1,3,27,10,0,3,1037905,2023-12-13T00:00:00.000Z,17896055,28,Scottie Barnes,1,37,43,33,16,48
0,0,0,0,0,0,0,0,0,0,0,0,0,0,0,0,1037905,2023-12-13T00:00:00.000Z,489,28,Thaddeus Young,0,0,0,0,0,0
2,1,0,3,2,6,2,0,0,14,0,2,6,0,0,1,1037906,2023-12-13T00:00:00.000Z,213,11,Aaron Holiday,1,6,8,8,2,11
2,0,9,1,0,8,2,6,5,24,1,4,9,10,0,2,1037906,2023-12-13T00:00:00.000Z,17896062,11,Alperen Sengun,0,19,21,11,12,22
0,0,0,0,0,0,0,0,0,0,0,0,0,0,0,0,1037906,2023-12-13T00:00:00.000Z,56677825,11,Amen Thompson,0,0,0,0,0,0
0,0,0,0,0,0,0,0,0,0,0,0,0,0,0,0,1037906,2023-12-13T00:00:00.000Z,56677831,11,Cam Whitmore,0,0,0,0,0,0
9,0,5,3,0,8,2,9,7,39,0,4,11,5,3,3,1037906,2023-12-13T00:00:00.000Z,458,11,Fred VanVleet,3,16,25,20,14,36.5
3,0,4,4,1,9,4,3,1,23,3,1,10,7,1,0,1037906,2023-12-13T00:00:00.000Z,3547301,11,Jae'Sean Tate,1,17,20,13,10,25.9
4,0,4,5,0,12,2,4,4,24,0,3,8,4,0,3,1037906,2023-12-13T00:00:00.000Z,17895966,11,Jalen Green,0,12,16,12,8,15.8
0,0,0,0,0,0,0,0,0,0,0,0,0,0,0,0,1037906,2023-12-13T00:00:00.000Z,56677809,11,Jermaine Samuels Jr.,0,0,0,0,0,0
0,0,1,0,0,2,1,0,0,11,2,2,2,3,0,0,1037906,2023-12-13T00:00:00.000Z,19465326,11,Jock Landale,0,5,5,2,3,5.6
0,0,0,4,2,4,2,0,0,7,0,0,6,0,0,0,1037906,2023-12-13T00:00:00.000Z,75,11,Reggie Bullock,0,6,6,6,0,6
1,1,8,4,3,16,10,4,2,27,6,2,25,14,1,3,1037906,2023-12-13T00:00:00.000Z,38017695,11,Tari Eason,2,39,40,26,15,46.3
1,0,5,0,0,2,1,6,1,24,1,5,3,6,0,2,1037906,2023-12-13T00:00:00.000Z,48,15,Bismack Biyombo,0,9,10,4,7,9.7
0,0,0,0,0,0,0,0,0,0,0,0,0,0,0,0,1037906,2023-12-13T00:00:00.000Z,666505,15,Brandon Clarke,0,0,0,0,0,0
4,0,5,7,2,14,3,2,1,32,1,1,9,6,1,1,1037906,2023-12-13T00:00:00.000Z,38017729,15,David Roddy,1,15,19,13,10,24.2
6,1,3,4,1,14,7,4,4,31,1,4,19,4,0,1,1037906,2023-12-13T00:00:00.000Z,401,15,Derrick Rose,1,23,29,25,10,34.8
0,0,0,0,0,0,0,0,0,0,0,0,0,0,0,0,1037906,2023-12-13T00:00:00.000Z,3547287,15,Desmond Bane,0,0,0,0,0,0
0,0,0,0,0,0,0,0,0,0,0,0,0,0,0,0,1037906,2023-12-13T00:00:00.000Z,56677830,15,GG Jackson,0,0,0,0,0,0
3,0,0,1,1,1,1,0,0,13,0,0,3,0,0,0,1037906,2023-12-13T00:00:00.000Z,48248287,15,Jacob Gilyard,0,3,6,6,3,7.5
2,0,0,3,0,6,2,0,0,15,0,3,4,0,0,1,1037906,2023-12-13T00:00:00.000Z,38017728,15,Jake LaRavia,0,4,6,6,2,6
2,1,6,8,3,24,15,13,11,40,1,4,44,7,4,3,1037906,2023-12-13T00:00:00.000Z,231,15,Jaren Jackson Jr.,5,51,53,46,9,67.4
1,0,0,2,0,3,0,0,0,8,0,1,0,0,0,1,1037906,2023-12-13T00:00:00.000Z,666809,15,Jaylen Nowell,0,0,1,1,1,0.5
1,0,0,1,0,1,0,0,0,7,0,0,0,0,1,0,1037906,2023-12-13T00:00:00.000Z,666703,15,John Konchar,1,0,1,1,1,4.5
0,0,0,0,0,0,0,0,0,0,0,0,0,0,0,0,1037906,2023-12-13T00:00:00.000Z,38017732,15,Kenneth Lofton Jr.,0,0,0,0,0,0
0,0,0,0,0,0,0,0,0,0,0,0,0,0,0,0,1037906,2023-12-13T00:00:00.000Z,420,15,Marcus Smart,0,0,0,0,0,0
1,2,5,2,1,4,3,0,0,16,0,4,7,5,0,1,1037906,2023-12-13T00:00:00.000Z,17896067,15,Santi Aldama,2,12,13,8,6,19.5
0,0,0,0,0,0,0,0,0,0,0,0,0,0,0,0,1037906,2023-12-13T00:00:00.000Z,3,15,Steven Adams,0,0,0,0,0,0
1,0,6,4,2,5,2,6,4,28,1,6,10,7,1,0,1037906,2023-12-13T00:00:00.000Z,38017731,15,Vince Williams Jr.,1,17,18,11,8,22.9
0,0,0,0,0,0,0,0,0,0,0,0,0,0,0,0,1037906,2023-12-13T00:00:00.000Z,3547285,15,Xavier Tillman,0,0,0,0,0,0
3,0,4,6,0,8,1,3,3,26,0,2,5,4,0,1,1037906,2023-12-13T00:00:00.000Z,17896027,15,Ziaire Williams,0,9,12,8,7,13.3
1,0,1,3,0,8,2,10,10,25,0,3,14,1,0,3,1037907,2023-12-13T00:00:00.000Z,38017686,12,Bennedict Mathurin,0,15,16,15,2,13.7
9,0,5,3,0,10,4,4,1,27,3,2,9,8,2,1,1037907,2023-12-13T00:00:00.000Z,69,12,Bruce Brown,2,17,26,18,17,37.1
2,0,1,6,1,9,3,0,0,27,2,1,7,3,0,1,1037907,2023-12-13T00:00:00.000Z,210,12,Buddy Hield,0,10,12,9,5,12.6
0,1,5,2,2,14,8,4,4,33,4,4,22,9,0,2,1037907,2023-12-13T00:00:00.000Z,452,12,Myles Turner,1,31,31,22,9,33.8
1,1,4,3,1,7,2,0,0,19,3,6,5,7,0,0,1037907,2023-12-13T00:00:00.000Z,3547243,12,Obi Toppin,1,12,13,6,8,17.9
5,0,4,2,0,9,4,1,1,16,1,1,9,5,2,3,1037907,2023-12-13T00:00:00.000Z,304,12,T.J. McConnell,2,14,19,14,10,25.5
7,0,4,4,1,16,8,7,5,31,1,0,22,5,0,3,1037907,2023-12-13T00:00:00.000Z,3547245,12,Tyrese Haliburton,0,27,34,29,12,35.5
0,0,0,0,0,0,0,0,0,1,0,0,0,0,0,0,1037907,2023-12-13T00:00:00.000Z,38017733,17,A.J. Green,0,0,0,0,0,0
2,0,1,1,0,2,1,0,0,14,1,4,2,2,0,0,1037907,2023-12-13T00:00:00.000Z,56677852,17,Andre Jackson Jr.,0,4,6,4,4,7.4
2,0,1,4,3,13,8,0,0,23,1,2,19,2,0,0,1037907,2023-12-13T00:00:00.000Z,377,17,Bobby Portis,0,21,23,21,4,24.4
1,6,1,2,0,6,1,4,4,33,2,5,6,3,0,1,1037907,2023-12-13T00:00:00.000Z,283,17,Brook Lopez,6,9,10,7,4,28.1
4,0,0,2,0,4,0,2,1,14,0,1,1,0,0,1,1037907,2023-12-13T00:00:00.000Z,368,17,Cameron Payne,0,1,5,5,4,6
0,0,0,0,0,0,0,0,0,0,0,0,0,0,0,0,1037907,2023-12-13T00:00:00.000Z,56677854,17,Chris Livingston,0,0,0,0,0,0
6,0,4,8,2,14,6,9,7,36,0,2,21,4,1,5,1037907,2023-12-13T00:00:00.000Z,278,17,Damian Lillard,1,25,31,27,10,32.8
3,1,11,3,0,28,20,32,24,37,3,1,64,14,4,3,1037907,2023-12-13T00:00:00.000Z,15,17,Giannis Antetokounmpo,5,78,81,67,17,97.3
0,0,0,0,0,0,0,0,0,0,0,0,0,0,0,0,1037907,2023-12-13T00:00:00.000Z,112,17,Jae Crowder,0,0,0,0,0,0
7,0,8,3,1,11,6,1,1,29,1,3,14,9,1,1,1037907,2023-12-13T00:00:00.000Z,315,17,Khris Middleton,1,23,30,21,16,37.3
0,0,0,0,0,0,0,0,0,0,0,0,0,0,0,0,1037907,2023-12-13T00:00:00.000Z,666960,17,Lindell Wigginton,0,0,0,0,0,0
2,1,2,4,1,7,3,0,0,36,4,3,7,6,2,0,1037907,2023-12-13T00:00:00.000Z,38,17,Malik Beasley,3,13,15,9,8,26.2
0,0,3,0,0,4,3,0,0,15,0,2,6,3,0,3,1037907,2023-12-13T00:00:00.000Z,38017676,17,MarJon Beauchamp,0,9,9,6,3,6.6
0,0,0,0,0,0,0,0,0,0,0,0,0,0,0,0,1037907,2023-12-13T00:00:00.000Z,666453,17,Marques Bolden,0,0,0,0,0,0
0,0,0,0,0,0,0,0,0,0,0,0,0,0,0,0,1037907,2023-12-13T00:00:00.000Z,105,17,Pat Connaughton,0,0,0,0,0,0
0,0,0,0,0,0,0,0,0,1,0,1,0,0,0,0,1037907,2023-12-13T00:00:00.000Z,284,17,Robin Lopez,0,0,0,0,0,0
0,0,0,0,0,0,0,0,0,1,0,0,0,0,0,1,1037907,2023-12-13T00:00:00.000Z,2148,17,Thanasis Antetokounmpo,0,0,0,0,0,-1
0,0,0,0,0,0,0,0,0,0,0,0,0,0,0,0,1037907,2023-12-13T00:00:00.000Z,38017691,17,TyTy Washington Jr.,0,0,0,0,0,0
0,0,0,0,0,0,0,0,0,0,0,0,0,0,0,0,1037908,2023-12-13T00:00:00.000Z,1603383,14,Gabe Vincent,0,0,0,0,0,0
0,0,0,0,0,0,0,0,0,0,0,0,0,0,0,0,1037908,2023-12-13T00:00:00.000Z,56677835,14,Jalen Hood-Schifino,0,0,0,0,0,0
0,0,0,0,0,0,0,0,0,0,0,0,0,0,0,0,1037908,2023-12-13T00:00:00.000Z,56677836,14,Maxwell Lewis,0,0,0,0,0,0
0,0,0,0,0,0,0,0,0,0,0,0,0,0,0,0,1037908,2023-12-13T00:00:00.000Z,38017693,27,Blake Wesley,0,0,0,0,0,0
2,0,7,2,1,4,2,0,0,17,0,0,5,7,0,0,1037908,2023-12-13T00:00:00.000Z,359,27,Cedi Osman,0,12,14,7,9,16.4
0,0,0,0,0,0,0,0,0,0,0,0,0,0,0,0,1037908,2023-12-13T00:00:00.000Z,17895854,27,Charles Bassey,0,0,0,0,0,0
0,0,0,0,0,0,0,0,0,0,0,0,0,0,0,0,1037908,2023-12-13T00:00:00.000Z,56677865,27,Charles Bediako,0,0,0,0,0,0
0,0,0,0,0,0,0,0,0,0,0,0,0,0,0,0,1037908,2023-12-13T00:00:00.000Z,38017730,27,Dominick Barlow,0,0,0,0,0,0
1,0,1,3,1,5,1,0,0,15,0,0,3,1,1,0,1037908,2023-12-13T00:00:00.000Z,305,27,Doug McDermott,1,4,5,4,2,8.7
0,0,0,0,0,0,0,0,0,0,0,0,0,0,0,0,1037908,2023-12-13T00:00:00.000Z,17896059,27,Sandro Mamukelashvili,0,0,0,0,0,0
0,0,0,0,0,0,0,0,0,0,0,0,0,0,0,0,1037908,2023-12-13T00:00:00.000Z,56677817,27,Sidy Cissoko,0,0,0,0,0,0
0,0,0,0,0,0,0,0,0,0,0,0,0,0,0,0,1037908,2023-12-13T00:00:00.000Z,56677870,27,Sir'Jabari Rice,0,0,0,0,0,0
0,0,0,0,0,0,0,0,0,0,0,0,0,0,0,0,1037909,2023-12-13T00:00:00.000Z,9051997,3,Armoni Brooks,0,0,0,0,0,0
0,0,0,0,0,0,0,0,0,0,0,0,0,0,0,0,1037909,2023-12-13T00:00:00.000Z,417,3,Ben Simmons,0,0,0,0,0,0
4,1,1,8,4,17,6,8,8,28,1,0,24,2,1,2,1037909,2023-12-13T00:00:00.000Z,17896048,3,Cam Thomas,2,26,30,28,6,36.4
4,2,4,7,3,10,5,2,2,34,1,1,15,5,2,1,1037909,2023-12-13T00:00:00.000Z,666679,3,Cameron Johnson,4,20,24,19,9,38
0,0,0,0,0,0,0,0,0,0,0,0,0,0,0,0,1037909,2023-12-13T00:00:00.000Z,56677841,3,Dariq Whitehead,0,0,0,0,0,0
0,0,0,1,0,3,1,2,1,8,3,0,3,3,0,0,1037909,2023-12-13T00:00:00.000Z,17896038,3,Day'Ron Sharpe,0,6,6,3,3,6.6
0,0,0,0,0,0,0,0,0,0,0,0,0,0,0,0,1037909,2023-12-13T00:00:00.000Z,421,3,Dennis Smith Jr.,0,0,0,0,0,0
1,0,3,4,0,9,4,0,0,26,3,3,8,6,2,2,1037909,2023-12-13T00:00:00.000Z,158,3,Dorian Finney-Smith,2,14,15,9,7,20.7
0,0,0,0,0,0,0,0,0,0,0,0,0,0,0,0,1037909,2023-12-13T00:00:00.000Z,174,3,Harry Giles III,0,0,0,0,0,0
0,0,0,0,0,0,0,0,0,0,0,0,0,0,0,0,1037909,2023-12-13T00:00:00.000Z,56677722,3,Jalen Wilson,0,0,0,0,0,0
0,0,0,0,0,0,0,0,0,0,0,0,0,0,0,0,1037909,2023-12-13T00:00:00.000Z,17896041,3,Keon Johnson,0,0,0,0,0,0
0,0,0,0,0,0,0,0,0,0,0,0,0,0,0,0,1037909,2023-12-13T00:00:00.000Z,464,3,Lonnie Walker IV,0,0,0,0,0,0
2,0,3,9,3,19,7,5,4,39,0,3,21,3,1,0,1037909,2023-12-13T00:00:00.000Z,61,3,Mikal Bridges,1,24,26,23,5,30.6
1,1,7,1,1,10,6,2,1,33,0,4,14,7,0,0,1037909,2023-12-13T00:00:00.000Z,666508,3,Nicolas Claxton,1,21,22,15,8,26.9
0,0,0,0,0,0,0,0,0,0,0,0,0,0,0,0,1037909,2023-12-13T00:00:00.000Z,56677843,3,Noah Clowney,0,0,0,0,0,0
4,0,1,4,2,5,3,0,0,19,0,1,8,1,0,0,1037909,2023-12-13T00:00:00.000Z,351,3,Royce O'Neale,0,9,13,12,5,15.2
7,0,6,5,2,11,6,4,2,35,2,4,16,8,2,2,1037909,2023-12-13T00:00:00.000Z,130,3,Spencer Dinwiddie,2,24,31,23,15,40.1
1,0,1,2,0,5,3,1,1,18,0,1,7,1,1,0,1037909,2023-12-13T00:00:00.000Z,17896058,3,Trendon Watford,1,8,9,8,2,12.7
0,0,0,0,0,0,0,0,0,0,0,0,0,0,0,0,1037909,2023-12-13T00:00:00.000Z,666451,24,Bol Bol,0,0,0,0,0,0
4,0,1,2,2,9,6,0,0,34,0,1,14,1,1,2,1037909,2023-12-13T00:00:00.000Z,37,24,Bradley Beal,1,15,19,18,5,22.2
0,0,1,3,2,8,3,0,0,20,3,2,8,4,2,1,1037909,2023-12-13T00:00:00.000Z,314,24,Chimezie Metu,2,12,12,8,4,17.8
0,0,0,0,0,0,0,0,0,0,0,0,0,0,0,0,1037909,2023-12-13T00:00:00.000Z,272,24,Damion Lee,0,0,0,0,0,0
12,0,5,6,2,15,9,15,14,40,1,5,34,6,0,2,1037909,2023-12-13T00:00:00.000Z,57,24,Devin Booker,0,40,52,46,18,57.2
0,0,0,0,0,1,0,0,0,4,0,0,0,0,0,0,1037909,2023-12-13T00:00:00.000Z,147,24,Drew Eubanks,0,0,0,0,0,0
0,0,0,0,0,0,0,0,0,0,0,0,0,0,0,0,1037909,2023-12-13T00:00:00.000Z,178,24,Eric Gordon,0,0,0,0,0,0
0,0,0,0,0,0,0,0,0,0,0,0,0,0,0,0,1037909,2023-12-13T00:00:00.000Z,8,24,Grayson Allen,0,0,0,0,0,0
1,0,0,2,0,6,1,0,0,27,0,1,2,0,1,2,1037909,2023-12-13T00:00:00.000Z,18678058,24,Jordan Goodwin,1,2,3,3,1,4.5
0,0,0,0,0,0,0,0,0,0,0,0,0,0,0,0,1037909,2023-12-13T00:00:00.000Z,356,24,Josh Okogie,0,0,0,0,0,0
3,2,16,2,0,15,7,2,1,31,6,3,15,22,0,0,1037909,2023-12-13T00:00:00.000Z,349,24,Jusuf Nurkic,2,37,40,18,25,51.9
1,0,2,1,0,3,1,0,0,12,0,1,2,2,0,1,1037909,2023-12-13T00:00:00.000Z,32,24,Keita Bates-Diop,0,4,5,3,3,4.9
4,2,5,5,1,18,9,10,8,38,1,3,27,6,1,2,1037909,2023-12-13T00:00:00.000Z,140,24,Kevin Durant,3,33,37,31,10,47.2
3,0,5,5,2,7,4,0,0,27,2,2,10,7,0,2,1037909,2023-12-13T00:00:00.000Z,666729,24,Nassir Little,0,17,20,13,10,20.9
0,0,0,0,0,0,0,0,0,0,0,0,0,0,0,0,1037909,2023-12-13T00:00:00.000Z,3547298,24,Saben Lee,0,0,0,0,0,0
0,0,0,0,0,0,0,0,0,0,0,0,0,0,0,0,1037909,2023-12-13T00:00:00.000Z,3547095,24,Udoka Azubuike,0,0,0,0,0,0
0,0,0,2,0,2,0,0,0,7,1,2,0,1,0,0,1037909,2023-12-13T00:00:00.000Z,470,24,Yuta Watanabe,0,1,1,0,1,1.2
0,0,0,0,0,0,0,0,0,0,0,0,0,0,0,0,1037910,2023-12-13T00:00:00.000Z,666474,20,Charles Brown,0,0,0,0,0,0
0,0,0,0,0,0,0,0,0,0,0,0,0,0,0,0,1037910,2023-12-13T00:00:00.000Z,666675,20,DaQuan Jeffries,0,0,0,0,0,0
1,0,4,9,4,13,6,7,5,27,3,2,21,7,4,0,1037910,2023-12-13T00:00:00.000Z,131,20,Donte DiVincenzo,4,28,29,22,8,42.9
0,0,0,0,0,0,0,0,0,0,0,0,0,0,0,0,1037910,2023-12-13T00:00:00.000Z,160,20,Evan Fournier,0,0,0,0,0,0
1,0,1,4,3,8,6,0,0,18,1,1,15,2,2,1,1037910,2023-12-13T00:00:00.000Z,3547269,20,Immanuel Quickley,2,17,18,16,3,23.9
0,1,3,0,0,4,3,1,1,30,3,3,7,6,0,0,1037910,2023-12-13T00:00:00.000Z,201,20,Isaiah Hartenstein,1,13,13,7,6,17.2
0,0,0,0,0,0,0,0,0,0,0,0,0,0,0,0,1037910,2023-12-13T00:00:00.000Z,56677795,20,Jacob Toppin,0,0,0,0,0,0
8,0,5,6,0,19,6,16,11,39,2,4,23,7,2,3,1037910,2023-12-13T00:00:00.000Z,73,20,Jalen Brunson,2,30,38,31,15,46.4
0,0,0,0,0,0,0,0,0,0,0,0,0,0,0,0,1037910,2023-12-13T00:00:00.000Z,59421201,20,Jaylen Martin,0,0,0,0,0,0
0,1,1,0,0,2,2,0,0,18,1,2,4,2,0,1,1037910,2023-12-13T00:00:00.000Z,17896063,20,Jericho Sims,1,6,6,4,2,8.4
2,0,2,4,0,5,0,0,0,29,0,2,0,2,1,0,1037910,2023-12-13T00:00:00.000Z,202,20,Josh Hart,1,2,4,2,4,8.4
6,1,9,6,2,23,14,2,2,39,3,4,32,12,1,2,1037910,2023-12-13T00:00:00.000Z,387,20,Julius Randle,2,44,50,38,18,59.4
0,0,0,0,0,0,0,0,0,0,0,0,0,0,0,0,1037910,2023-12-13T00:00:00.000Z,17896033,20,Miles McBride,0,0,0,0,0,0
0,0,0,0,0,0,0,0,0,0,0,0,0,0,0,0,1037910,2023-12-13T00:00:00.000Z,399,20,Mitchell Robinson,0,0,0,0,0,0
1,0,2,3,0,4,1,2,0,16,0,1,2,2,0,1,1037910,2023-12-13T00:00:00.000Z,17895858,20,Quentin Grimes,0,4,5,3,3,4.9
2,0,5,7,0,16,3,4,3,24,1,2,9,6,0,0,1037910,2023-12-13T00:00:00.000Z,666423,20,RJ Barrett,0,15,17,11,8,19.2
0,0,0,0,0,0,0,0,0,0,0,0,0,0,0,0,1037910,2023-12-13T00:00:00.000Z,19,20,Ryan Arcidiacono,0,0,0,0,0,0
0,0,0,0,0,0,0,0,0,0,0,0,0,0,0,0,1037910,2023-12-13T00:00:00.000Z,56677842,29,Brice Sensabaugh,0,0,0,0,0,0
7,0,3,8,3,18,10,3,3,30,1,4,26,4,0,2,1037910,2023-12-13T00:00:00.000Z,413,29,Collin Sexton,0,30,37,33,11,39.3
0,0,0,0,0,0,0,0,0,0,0,0,0,0,0,0,1037910,2023-12-13T00:00:00.000Z,101,29,John Collins,0,0,0,0,0,0
0,0,0,0,0,0,0,0,0,0,0,0,0,0,0,0,1037910,2023-12-13T00:00:00.000Z,38017630,29,Johnny Juzang,0,0,0,0,0,0
0,0,0,0,0,0,0,0,0,0,0,0,0,0,0,0,1037910,2023-12-13T00:00:00.000Z,100,29,Jordan Clarkson,0,0,0,0,0,0
0,0,0,0,0,0,0,0,0,0,0,0,0,0,0,0,1037910,2023-12-13T00:00:00.000Z,17896023,29,Josh Christopher,0,0,0,0,0,0
8,0,9,2,1,9,3,2,2,30,1,3,9,10,0,4,1037910,2023-12-13T00:00:00.000Z,358,29,Kelly Olynyk,0,19,27,17,18,29
0,0,0,1,0,1,0,0,0,4,0,1,0,0,0,2,1037910,2023-12-13T00:00:00.000Z,56677834,29,Keyonte George,0,0,0,0,0,-2
7,0,2,2,2,4,4,0,0,18,0,3,10,2,1,1,1037910,2023-12-13T00:00:00.000Z,139,29,Kris Dunn,1,12,19,17,9,24.9
0,0,7,8,4,13,7,7,5,25,1,2,23,8,0,0,1037910,2023-12-13T00:00:00.000Z,297,29,Lauri Markkanen,0,31,31,23,8,32.6
0,0,0,0,0,0,0,0,0,0,0,0,0,0,0,0,1037910,2023-12-13T00:00:00.000Z,666881,29,Luka Samanic,0,0,0,0,0,0
0,0,0,0,0,0,0,0,0,0,0,0,0,0,0,0,1037910,2023-12-13T00:00:00.000Z,19465584,29,Micah Potter,0,0,0,0,0,0
2,0,1,5,1,12,2,0,0,30,3,2,5,4,0,0,1037910,2023-12-13T00:00:00.000Z,38017620,29,Ochai Agbaji,0,9,11,7,6,12.8
0,0,2,0,0,1,0,0,0,5,1,0,0,3,0,0,1037910,2023-12-13T00:00:00.000Z,11891374,29,Omer Yurtseven,0,3,3,0,3,3.6
2,0,3,10,3,12,4,4,4,31,3,4,15,6,2,2,1037910,2023-12-13T00:00:00.000Z,38017739,29,Simone Fontecchio,2,21,23,17,8,29.2
3,0,4,3,1,14,7,2,0,24,0,2,15,4,0,1,1037910,2023-12-13T00:00:00.000Z,666650,29,Talen Horton-Tucker,0,19,22,18,7,23.3
1,1,2,3,1,7,2,0,0,20,2,3,5,4,2,1,1037910,2023-12-13T00:00:00.000Z,56677824,29,Taylor Hendricks,3,9,10,6,5,19.3
1,3,5,0,0,7,4,3,1,23,3,3,9,8,0,2,1037910,2023-12-13T00:00:00.000Z,38017705,29,Walker Kessler,3,17,18,10,9,27.1
3,1,7,2,1,4,3,0,0,24,3,1,7,10,0,0,1037911,2023-12-14T00:00:00.000Z,219,2,Al Horford,1,17,20,10,13,26.5
0,0,0,0,0,0,0,0,0,0,0,0,0,0,0,0,1037911,2023-12-14T00:00:00.000Z,17896094,2,Dalano Banton,0,0,0,0,0,0
3,0,3,4,2,10,5,2,2,35,2,0,14,5,3,3,1037911,2023-12-14T00:00:00.000Z,473,2,Derrick White,3,19,22,17,8,30.5
5,0,3,5,2,20,10,0,0,36,2,3,22,5,2,2,1037911,2023-12-14T00:00:00.000Z,70,2,Jaylen Brown,2,27,32,27,10,39.5
3,3,8,10,3,22,9,8,6,36,3,1,27,11,0,3,1037911,2023-12-14T00:00:00.000Z,434,2,Jayson Tatum,3,38,41,30,14,50.7
0,0,0,0,0,0,0,0,0,0,0,0,0,0,0,0,1037911,2023-12-14T00:00:00.000Z,38017707,2,JD Davison,0,0,0,0,0,0
0,0,0,0,0,0,0,0,0,0,0,0,0,0,0,0,1037911,2023-12-14T00:00:00.000Z,56677864,2,Jordan Walsh,0,0,0,0,0,0
4,0,1,3,1,11,7,0,0,37,2,2,15,3,0,2,1037911,2023-12-14T00:00:00.000Z,214,2,Jrue Holiday,0,18,22,19,7,22.6
0,2,5,6,1,11,5,8,7,31,1,2,18,6,1,3,1037911,2023-12-14T00:00:00.000Z,378,2,Kristaps Porzingis,3,24,24,18,6,31.2
1,1,1,2,0,3,1,2,2,9,0,3,4,1,1,0,1037911,2023-12-14T00:00:00.000Z,3547279,2,Lamar Stevens,2,5,6,5,2,12.7
0,0,0,0,0,0,0,0,0,0,0,0,0,0,0,0,1037911,2023-12-14T00:00:00.000Z,261,2,Luke Kornet,0,0,0,0,0,0
0,0,0,0,0,0,0,0,0,0,0,0,0,0,0,0,1037911,2023-12-14T00:00:00.000Z,17553967,2,Neemias Queta,0,0,0,0,0,0
0,0,0,0,0,0,0,0,0,0,0,0,0,0,0,0,1037911,2023-12-14T00:00:00.000Z,666468,2,Oshae Brissett,0,0,0,0,0,0
2,1,3,1,0,1,0,0,0,14,0,1,0,3,0,0,1037911,2023-12-14T00:00:00.000Z,3547276,2,Payton Pritchard,1,3,5,2,5,9.6
1,0,0,3,3,3,3,0,0,18,0,2,9,0,0,0,1037911,2023-12-14T00:00:00.000Z,17896060,2,Sam Hauser,0,9,10,10,1,10.5
0,0,0,0,0,0,0,0,0,0,0,0,0,0,0,0,1037911,2023-12-14T00:00:00.000Z,338,2,Svi Mykhailiuk,0,0,0,0,0,0
5,1,2,6,3,16,9,6,5,35,1,2,26,3,3,1,1037911,2023-12-14T00:00:00.000Z,277,6,Caris LeVert,4,29,34,31,8,48.1
0,0,0,0,0,0,0,0,0,0,0,0,0,0,0,0,1037911,2023-12-14T00:00:00.000Z,56677872,6,Craig Porter,0,0,0,0,0,0
0,0,0,0,0,0,0,0,0,0,0,0,0,0,0,0,1037911,2023-12-14T00:00:00.000Z,248,6,Damian Jones,0,0,0,0,0,0
3,0,1,7,3,19,8,0,0,36,1,2,19,2,2,5,1037911,2023-12-14T00:00:00.000Z,666581,6,Darius Garland,2,21,24,22,5,26.9
0,0,3,5,1,5,1,2,2,16,1,0,5,4,0,0,1037911,2023-12-14T00:00:00.000Z,666940,6,Dean Wade,0,9,9,5,4,9.8
6,0,7,8,2,24,12,5,5,40,1,2,31,8,1,3,1037911,2023-12-14T00:00:00.000Z,322,6,Donovan Mitchell,1,39,45,37,14,49.6
0,0,0,0,0,0,0,0,0,0,0,0,0,0,0,0,1037911,2023-12-14T00:00:00.000Z,56677847,6,Emoni Bates,0,0,0,0,0,0
0,0,0,0,0,0,0,0,0,0,0,0,0,0,0,0,1037911,2023-12-14T00:00:00.000Z,17896076,6,Evan Mobley,0,0,0,0,0,0
0,0,2,2,0,4,1,2,2,22,0,2,4,2,0,1,1037911,2023-12-14T00:00:00.000Z,344,6,Georges Niang,0,6,6,4,2,5.4
2,0,3,1,1,2,2,2,2,18,1,3,7,4,1,1,1037911,2023-12-14T00:00:00.000Z,3547247,6,Isaac Okoro,1,11,13,9,6,16.8
0,0,0,0,0,0,0,0,0,0,0,0,0,0,0,0,1037911,2023-12-14T00:00:00.000Z,38017662,6,Isaiah Mobley,0,0,0,0,0,0
3,0,9,0,0,7,4,0,0,39,1,1,8,10,0,3,1037911,2023-12-14T00:00:00.000Z,9,6,Jarrett Allen,0,18,21,11,13,21.5
2,0,2,4,1,5,2,0,0,31,2,5,5,4,0,1,1037911,2023-12-14T00:00:00.000Z,666908,6,Max Strus,0,9,11,7,6,11.8
0,0,0,0,0,0,0,0,0,0,0,0,0,0,0,0,1037911,2023-12-14T00:00:00.000Z,404,6,Ricky Rubio,0,0,0,0,0,0
0,0,0,0,0,0,0,0,0,0,0,0,0,0,0,0,1037911,2023-12-14T00:00:00.000Z,3547299,6,Sam Merrill,0,0,0,0,0,0
0,0,1,0,0,1,1,0,0,3,1,1,2,2,0,1,1037911,2023-12-14T00:00:00.000Z,444,6,Tristan Thompson,0,4,4,2,2,3.4
0,0,0,0,0,0,0,0,0,0,0,0,0,0,0,0,1037911,2023-12-14T00:00:00.000Z,666676,6,Ty Jerome,0,0,0,0,0,0
0,0,0,0,0,0,0,0,0,0,0,0,0,0,0,0,1037912,2023-12-14T00:00:00.000Z,56677860,5,Adama Sanogo,0,0,0,0,0,0
1,0,0,3,2,4,2,0,0,5,0,0,6,0,0,0,1037912,2023-12-14T00:00:00.000Z,89,5,Alex Caruso,0,6,7,7,1,7.5
11,0,6,11,4,20,9,8,4,40,1,1,26,7,1,0,1037912,2023-12-14T00:00:00.000Z,666956,5,Coby White,1,33,44,37,18,53.9
4,0,3,3,1,14,6,11,10,41,2,2,23,5,0,3,1037912,2023-12-14T00:00:00.000Z,125,5,DeMar DeRozan,0,28,32,27,9,32
1,0,0,2,0,2,0,0,0,13,0,3,0,0,1,1,1037912,2023-12-14T00:00:00.000Z,87,5,Jevon Carter,1,0,1,1,1,3.5
0,0,0,0,0,0,0,0,0,0,0,0,0,0,0,0,1037912,2023-12-14T00:00:00.000Z,56677857,5,Julian Phillips,0,0,0,0,0,0
0,0,0,0,0,0,0,0,0,0,0,0,0,0,0,0,1037912,2023-12-14T00:00:00.000Z,45969255,5,Justin Lewis,0,0,0,0,0,0
0,0,0,0,0,0,0,0,0,0,0,0,0,0,0,0,1037912,2023-12-14T00:00:00.000Z,27,5,Lonzo Ball,0,0,0,0,0,0
7,0,10,5,2,21,10,2,2,36,2,2,24,12,3,0,1037912,2023-12-14T00:00:00.000Z,460,5,Nikola Vucevic,3,36,43,31,19,57.9
0,0,0,0,0,0,0,0,0,0,0,0,0,0,0,0,1037912,2023-12-14T00:00:00.000Z,56677874,5,Onuralp Bitim,0,0,0,0,0,0
3,2,0,5,2,9,3,2,1,32,2,5,9,2,2,0,1037912,2023-12-14T00:00:00.000Z,3547248,5,Patrick Williams,4,11,14,12,5,27.9
0,0,0,0,0,0,0,0,0,0,0,0,0,0,0,0,1037912,2023-12-14T00:00:00.000Z,17896116,5,Terry Taylor,0,0,0,0,0,0
0,0,2,3,0,7,2,1,1,23,1,3,5,3,1,0,1037912,2023-12-14T00:00:00.000Z,110,5,Torrey Craig,1,8,8,5,3,11.6
0,0,0,0,0,0,0,0,0,0,0,0,0,0,0,0,1037912,2023-12-14T00:00:00.000Z,268,5,Zach LaVine,0,0,0,0,0,0
0,0,0,0,0,0,0,0,0,0,0,0,0,0,0,0,1037912,2023-12-14T00:00:00.000Z,4,16,Bam Adebayo,0,0,0,0,0,0
4,0,9,4,3,13,7,0,0,39,2,3,17,11,0,1,1037912,2023-12-14T00:00:00.000Z,666747,16,Caleb Martin,0,28,32,21,15,35.2
0,0,0,0,0,0,0,0,0,0,0,0,0,0,0,0,1037912,2023-12-14T00:00:00.000Z,38017736,16,Cole Swider,0,0,0,0,0,0
0,0,0,0,0,0,0,0,0,0,0,0,0,0,0,0,1037912,2023-12-14T00:00:00.000Z,19465585,16,Dru Smith,0,0,0,0,0,0
3,0,2,6,3,9,4,2,0,27,0,2,11,2,0,2,1037912,2023-12-14T00:00:00.000Z,397,16,Duncan Robinson,0,13,16,14,5,15.9
0,0,0,0,0,0,0,0,0,0,0,0,0,0,0,0,1037912,2023-12-14T00:00:00.000Z,3092,16,Haywood Highsmith,0,0,0,0,0,0
4,0,4,4,1,14,6,10,9,34,0,4,22,4,0,2,1037912,2023-12-14T00:00:00.000Z,56677785,16,Jaime Jaquez Jr.,0,26,30,26,8,30.8
0,1,0,0,0,0,0,4,3,8,0,1,3,0,0,0,1037912,2023-12-14T00:00:00.000Z,38017734,16,Jamal Cain,1,3,3,3,0,6
7,0,5,1,0,15,6,10,8,36,2,0,20,7,0,1,1037912,2023-12-14T00:00:00.000Z,79,16,Jimmy Butler,0,27,34,27,14,37.9
0,0,0,0,0,0,0,0,0,0,0,0,0,0,0,0,1037912,2023-12-14T00:00:00.000Z,391,16,Josh Richardson,0,0,0,0,0,0
4,0,8,8,3,12,5,4,3,22,1,1,16,9,1,2,1037912,2023-12-14T00:00:00.000Z,285,16,Kevin Love,1,25,29,20,13,33.8
3,0,2,9,4,12,6,1,1,39,1,5,17,3,1,1,1037912,2023-12-14T00:00:00.000Z,286,16,Kyle Lowry,1,20,23,20,6,27.1
0,0,0,0,0,0,0,0,0,0,0,0,0,0,0,0,1037912,2023-12-14T00:00:00.000Z,38017696,16,Nikola Jovic,0,0,0,0,0,0
0,0,0,1,0,2,0,2,1,14,2,2,1,2,0,1,1037912,2023-12-14T00:00:00.000Z,39398582,16,Orlando Robinson,0,3,3,1,2,2.4
1,0,2,0,0,2,2,2,2,12,0,1,6,2,0,0,1037912,2023-12-14T00:00:00.000Z,74,16,Thomas Bryant,0,8,9,7,3,9.9
0,0,0,0,0,0,0,0,0,0,0,0,0,0,0,0,1037912,2023-12-14T00:00:00.000Z,666633,16,Tyler Herro,0,0,0,0,0,0
0,0,0,0,0,1,1,0,0,2,0,0,2,0,0,0,1037913,2023-12-14T00:00:00.000Z,17554004,7,AJ Lawson,0,2,2,2,0,2
4,0,4,3,2,6,5,2,2,28,0,2,14,4,0,2,1037913,2023-12-14T00:00:00.000Z,151,7,Dante Exum,0,18,22,18,8,22.8
0,2,3,0,0,9,7,2,1,32,3,3,15,6,1,2,1037913,2023-12-14T00:00:00.000Z,56677840,7,Dereck Lively II,3,21,21,15,6,29.2
0,0,4,6,1,8,1,0,0,30,0,3,3,4,2,0,1037913,2023-12-14T00:00:00.000Z,247,7,Derrick Jones Jr.,2,7,7,3,4,13.8
0,0,0,0,0,0,0,0,0,0,0,0,0,0,0,0,1037913,2023-12-14T00:00:00.000Z,56677873,7,Dexter Dennis,0,0,0,0,0,0
1,0,3,7,1,11,2,0,0,36,0,3,5,3,1,1,1037913,2023-12-14T00:00:00.000Z,666965,7,Grant Williams,1,8,9,6,4,12.1
1,0,0,0,0,0,0,0,0,2,0,0,0,0,0,0,1037913,2023-12-14T00:00:00.000Z,17896028,7,Greg Brown III,0,0,1,1,1,1.5
0,0,0,0,0,0,0,0,0,0,0,0,0,0,0,0,1037913,2023-12-14T00:00:00.000Z,228,7,Kyrie Irving,0,0,0,0,0,0
13,0,5,7,2,27,15,7,7,39,1,2,39,6,2,8,1037913,2023-12-14T00:00:00.000Z,132,7,Luka Doncic,2,45,58,52,19,63.7
0,0,0,0,0,0,0,0,0,0,0,0,0,0,0,0,1037913,2023-12-14T00:00:00.000Z,257,7,Maxi Kleber,0,0,0,0,0,0
11,0,1,3,0,19,3,6,3,35,1,2,9,2,2,5,1037913,2023-12-14T00:00:00.000Z,3547238,18,Anthony Edwards,2,11,22,20,13,28.9
0,0,0,0,0,0,0,0,0,0,0,0,0,0,0,0,1037913,2023-12-14T00:00:00.000Z,17895968,18,Daishen Nix,0,0,0,0,0,0
1,1,1,2,0,9,5,1,1,24,1,3,11,2,0,0,1037913,2023-12-14T00:00:00.000Z,3547259,18,Jaden McDaniels,1,13,14,12,3,17.9
0,0,0,0,0,0,0,0,0,0,0,0,0,0,0,0,1037913,2023-12-14T00:00:00.000Z,56677851,18,Jaylen Clark,0,0,0,0,0,0
1,0,0,0,0,0,0,0,0,2,0,0,0,0,0,0,1037913,2023-12-14T00:00:00.000Z,666767,18,Jordan McLaughlin,0,0,1,1,1,1.5
0,0,0,0,0,1,1,1,1,2,0,0,3,0,0,0,1037913,2023-12-14T00:00:00.000Z,38017715,18,Josh Minott,0,3,3,3,0,3
2,0,12,3,1,14,8,5,4,31,5,1,21,17,0,3,1037913,2023-12-14T00:00:00.000Z,447,18,Karl-Anthony Towns,0,38,40,23,19,41.4
2,1,2,1,0,7,3,0,0,18,0,2,6,2,2,1,1037913,2023-12-14T00:00:00.000Z,12,18,Kyle Anderson,3,8,10,8,4,19.4
0,0,0,0,0,0,0,0,0,0,0,0,0,0,0,0,1037913,2023-12-14T00:00:00.000Z,56677782,18,Leonard Miller,0,0,0,0,0,0
0,0,0,0,0,0,0,0,0,0,0,0,0,0,0,0,1037913,2023-12-14T00:00:00.000Z,17896056,18,Luka Garza,0,0,0,0,0,0
3,0,2,4,2,9,5,2,2,29,0,2,14,2,1,1,1037913,2023-12-14T00:00:00.000Z,104,18,Mike Conley,1,16,19,17,5,22.9
3,0,4,11,7,14,8,4,4,31,2,2,27,6,1,2,1037913,2023-12-14T00:00:00.000Z,667378,18,Naz Reid,1,33,36,30,9,39.7
1,1,0,4,3,6,5,0,0,20,1,2,13,1,0,1,1037913,2023-12-14T00:00:00.000Z,666400,18,Nickeil Alexander-Walker,1,14,15,14,2,17.7
5,1,10,0,0,4,3,6,2,30,2,4,8,12,3,2,1037913,2023-12-14T00:00:00.000Z,176,18,Rudy Gobert,4,20,25,13,17,39.9
0,0,0,0,0,1,1,0,0,2,0,0,2,0,0,0,1037913,2023-12-14T00:00:00.000Z,320,18,Shake Milton,0,2,2,2,0,2
1,0,1,3,1,4,2,0,0,14,0,0,5,1,0,0,1037913,2023-12-14T00:00:00.000Z,68,18,Troy Brown Jr.,0,6,7,6,2,7.7
0,0,0,0,0,0,0,0,0,2,0,1,0,0,0,0,1037913,2023-12-14T00:00:00.000Z,38017700,18,Wendell Moore Jr.,0,0,0,0,0,0
2,0,0,6,2,9,2,0,0,15,2,0,6,2,0,1,1037914,2023-12-14T00:00:00.000Z,9051997,3,Armoni Brooks,0,8,10,8,4,10.4
0,0,0,0,0,0,0,0,0,0,0,0,0,0,0,0,1037914,2023-12-14T00:00:00.000Z,417,3,Ben Simmons,0,0,0,0,0,0
0,0,3,2,0,13,5,6,3,27,0,3,13,3,0,0,1037914,2023-12-14T00:00:00.000Z,17896048,3,Cam Thomas,0,16,16,13,3,16.6
0,0,2,7,2,10,4,0,0,22,1,2,10,3,0,1,1037914,2023-12-14T00:00:00.000Z,666679,3,Cameron Johnson,0,13,13,10,3,12.6
5,1,9,1,0,9,4,0,0,26,4,4,8,13,0,3,1037914,2023-12-14T00:00:00.000Z,17896038,3,Day'Ron Sharpe,1,21,26,13,18,31.1
0,0,0,0,0,0,0,0,0,0,0,0,0,0,0,0,1037914,2023-12-14T00:00:00.000Z,421,3,Dennis Smith Jr.,0,0,0,0,0,0
0,0,0,1,0,3,0,0,0,16,4,2,0,4,1,1,1037914,2023-12-14T00:00:00.000Z,158,3,Dorian Finney-Smith,1,4,4,0,4,6.8
1,0,3,1,0,9,4,3,3,15,3,1,11,6,1,0,1037914,2023-12-14T00:00:00.000Z,174,3,Harry Giles III,1,17,18,12,7,22.7
2,0,3,1,1,4,2,2,2,17,1,0,7,4,0,0,1037914,2023-12-14T00:00:00.000Z,56677722,3,Jalen Wilson,0,11,13,9,6,14.8
0,0,0,0,0,0,0,0,0,0,0,0,0,0,0,0,1037914,2023-12-14T00:00:00.000Z,17896041,3,Keon Johnson,0,0,0,0,0,0
1,0,0,6,2,8,3,2,1,25,0,0,9,0,1,4,1037914,2023-12-14T00:00:00.000Z,61,3,Mikal Bridges,1,9,10,10,1,9.5
2,0,8,0,0,9,5,0,0,17,1,5,10,9,0,2,1037914,2023-12-14T00:00:00.000Z,666508,3,Nicolas Claxton,0,19,21,12,11,21.8
0,0,0,0,0,0,0,0,0,0,0,0,0,0,0,0,1037914,2023-12-14T00:00:00.000Z,56677843,3,Noah Clowney,0,0,0,0,0,0
1,0,1,0,0,1,1,0,0,14,0,1,2,1,1,1,1037914,2023-12-14T00:00:00.000Z,351,3,Royce O'Neale,1,3,4,3,2,6.7
8,0,4,4,1,11,5,7,6,24,0,3,17,4,1,2,1037914,2023-12-14T00:00:00.000Z,130,3,Spencer Dinwiddie,1,21,29,25,12,34.8
6,2,2,1,0,9,4,0,0,22,2,2,8,4,0,2,1037914,2023-12-14T00:00:00.000Z,17896058,3,Trendon Watford,2,12,18,14,10,25.8
2,1,2,1,0,9,6,1,1,24,0,0,13,2,1,2,1037914,2023-12-14T00:00:00.000Z,177,8,Aaron Gordon,2,15,17,15,4,22.4
0,0,0,0,0,0,0,0,0,0,0,0,0,0,0,0,1037914,2023-12-14T00:00:00.000Z,17896007,8,Braxton Key,0,0,0,0,0,0
2,2,3,3,1,10,4,1,1,24,1,0,10,4,1,1,1037914,2023-12-14T00:00:00.000Z,38017709,8,Christian Braun,3,14,16,12,6,25.8
0,0,0,0,0,0,0,0,0,0,0,0,0,0,0,0,1037914,2023-12-14T00:00:00.000Z,38017727,8,Collin Gillespie,0,0,0,0,0,0
0,1,2,0,0,2,1,0,0,12,2,2,2,4,0,1,1037914,2023-12-14T00:00:00.000Z,250,8,DeAndre Jordan,1,6,6,2,4,8.8
0,0,1,0,0,0,0,0,0,2,0,0,0,1,0,0,1037914,2023-12-14T00:00:00.000Z,56677871,8,Hunter Tyson,0,1,1,0,1,1.2
1,0,0,1,1,1,1,0,0,2,0,0,3,0,0,0,1037914,2023-12-14T00:00:00.000Z,56677582,8,Jalen Pickett,0,3,4,4,1,4.5
2,1,1,4,2,15,7,0,0,22,0,2,16,1,3,0,1037914,2023-12-14T00:00:00.000Z,335,8,Jamal Murray,4,17,19,18,3,32.2
0,0,0,0,0,0,0,0,0,0,0,0,0,0,0,0,1037914,2023-12-14T00:00:00.000Z,17896103,8,Jay Huff,0,0,0,0,0,0
1,0,4,6,2,10,3,0,0,20,0,0,8,4,0,0,1037914,2023-12-14T00:00:00.000Z,56677776,8,Julian Strawther,0,12,13,9,5,14.3
2,0,1,5,0,6,1,0,0,27,0,2,2,1,4,1,1037914,2023-12-14T00:00:00.000Z,215,8,Justin Holiday,4,3,5,4,3,17.2
0,0,0,0,0,0,0,0,0,0,0,0,0,0,0,0,1037914,2023-12-14T00:00:00.000Z,81,8,Kentavious Caldwell-Pope,0,0,0,0,0,0
1,0,4,4,1,8,3,2,2,24,2,0,9,6,1,0,1037914,2023-12-14T00:00:00.000Z,375,8,Michael Porter Jr.,1,15,16,10,7,20.7
10,0,14,2,0,12,8,12,10,30,1,2,26,15,1,1,1037914,2023-12-14T00:00:00.000Z,246,8,Nikola Jokic,1,41,51,36,25,61
5,1,4,5,2,10,7,3,2,24,3,3,18,7,1,1,1037914,2023-12-14T00:00:00.000Z,38017721,8,Peyton Watson,2,25,30,23,12,38.9
4,0,0,4,2,13,4,2,2,23,0,3,12,0,2,1,1037914,2023-12-14T00:00:00.000Z,236,8,Reggie Jackson,2,12,16,16,4,23
0,0,0,0,0,0,0,0,0,0,0,0,0,0,0,0,1037914,2023-12-14T00:00:00.000Z,666489,8,Vlatko Cancar,0,0,0,0,0,0
1,0,0,1,1,2,2,0,0,6,3,1,5,3,0,0,1037914,2023-12-14T00:00:00.000Z,3547268,8,Zeke Nnaji,0,8,9,6,4,10.1
6,0,1,6,2,8,3,2,1,22,0,1,9,1,1,2,1037915,2023-12-14T00:00:00.000Z,419,25,Anfernee Simons,1,10,16,15,7,20.2
0,1,3,6,3,11,6,0,0,13,2,1,15,5,1,0,1037915,2023-12-14T00:00:00.000Z,56783340,25,Duop Reath,2,20,20,15,5,27
0,0,0,0,0,0,0,0,0,0,0,0,0,0,0,0,1037915,2023-12-14T00:00:00.000Z,39613724,25,Ibou Badji,0,0,0,0,0,0
0,0,0,0,0,0,0,0,0,0,0,0,0,0,0,0,1037915,2023-12-14T00:00:00.000Z,17896120,25,Ish Wainright,0,0,0,0,0,0
1,0,5,2,0,10,5,5,3,28,4,0,13,9,1,0,1037915,2023-12-14T00:00:00.000Z,38017711,25,Jabari Walker,1,22,23,14,10,28.3
0,0,0,0,0,0,0,0,0,0,0,0,0,0,0,0,1037915,2023-12-14T00:00:00.000Z,182,25,Jerami Grant,0,0,0,0,0,0
0,0,0,0,0,0,0,0,0,0,0,0,0,0,0,0,1037915,2023-12-14T00:00:00.000Z,47957121,25,Justin Minaya,0,0,0,0,0,0
3,1,2,5,2,7,2,0,0,17,3,0,6,5,2,0,1037915,2023-12-14T00:00:00.000Z,56677791,25,Kris Murray,3,11,14,9,8,25.5
1,0,0,6,3,6,3,2,0,14,0,0,9,0,0,0,1037915,2023-12-14T00:00:00.000Z,65,25,Malcolm Brogdon,0,9,10,10,1,10.5
0,0,1,0,0,0,0,0,0,5,0,0,0,1,0,0,1037915,2023-12-14T00:00:00.000Z,666476,25,Moses Brown,0,1,1,0,1,1.2
0,0,0,0,0,0,0,0,0,0,0,0,0,0,0,0,1037915,2023-12-14T00:00:00.000Z,56677829,25,Rayan Rupert,0,0,0,0,0,0
0,0,0,0,0,0,0,0,0,0,0,0,0,0,0,0,1037915,2023-12-14T00:00:00.000Z,476,25,Robert Williams III,0,0,0,0,0,0
10,0,2,7,2,21,9,3,3,35,0,1,23,2,1,4,1037915,2023-12-14T00:00:00.000Z,56677747,25,Scoot Henderson,1,25,35,33,12,39.4
2,1,5,5,0,12,1,2,2,27,2,3,4,7,0,0,1037915,2023-12-14T00:00:00.000Z,38017690,25,Shaedon Sharpe,1,11,13,6,9,18.4
5,0,0,0,0,0,0,0,0,17,1,0,0,1,1,0,1037915,2023-12-14T00:00:00.000Z,3547289,25,Skylar Mays,1,1,6,5,6,11.7
0,0,0,0,0,0,0,0,0,0,0,0,0,0,0,0,1037915,2023-12-14T00:00:00.000Z,56677842,29,Brice Sensabaugh,0,0,0,0,0,0
4,0,1,5,2,17,11,3,3,32,1,2,27,2,1,2,1037915,2023-12-14T00:00:00.000Z,413,29,Collin Sexton,1,29,33,31,6,36.4
0,0,0,0,0,0,0,0,0,0,0,0,0,0,0,0,1037915,2023-12-14T00:00:00.000Z,101,29,John Collins,0,0,0,0,0,0
0,0,0,0,0,0,0,0,0,0,0,0,0,0,0,0,1037915,2023-12-14T00:00:00.000Z,38017630,29,Johnny Juzang,0,0,0,0,0,0
0,0,0,0,0,0,0,0,0,0,0,0,0,0,0,0,1037915,2023-12-14T00:00:00.000Z,100,29,Jordan Clarkson,0,0,0,0,0,0
0,0,0,0,0,0,0,0,0,0,0,0,0,0,0,0,1037915,2023-12-14T00:00:00.000Z,17896023,29,Josh Christopher,0,0,0,0,0,0
7,0,9,3,0,6,1,0,0,24,1,1,2,10,0,0,1037915,2023-12-14T00:00:00.000Z,358,29,Kelly Olynyk,0,12,19,9,17,24.5
0,0,0,0,0,0,0,0,0,0,0,0,0,0,0,0,1037915,2023-12-14T00:00:00.000Z,56677834,29,Keyonte George,0,0,0,0,0,0
5,0,1,2,0,8,3,0,0,26,1,2,6,2,0,0,1037915,2023-12-14T00:00:00.000Z,139,29,Kris Dunn,0,8,13,11,7,15.9
0,0,0,0,0,0,0,0,0,0,0,0,0,0,0,0,1037915,2023-12-14T00:00:00.000Z,297,29,Lauri Markkanen,0,0,0,0,0,0
0,0,0,0,0,0,0,0,0,0,0,0,0,0,0,0,1037915,2023-12-14T00:00:00.000Z,666881,29,Luka Samanic,0,0,0,0,0,0
0,0,0,0,0,0,0,0,0,3,0,0,0,0,0,0,1037915,2023-12-14T00:00:00.000Z,19465584,29,Micah Potter,0,0,0,0,0,0
2,0,3,6,2,12,7,0,0,26,0,3,16,3,0,1,1037915,2023-12-14T00:00:00.000Z,38017620,29,Ochai Agbaji,0,19,21,18,5,21.6
1,2,1,0,0,7,2,0,0,22,3,3,4,4,1,2,1037915,2023-12-14T00:00:00.000Z,11891374,29,Omer Yurtseven,3,8,9,5,5,17.3
0,0,4,5,5,8,7,5,5,25,1,0,24,5,1,0,1037915,2023-12-14T00:00:00.000Z,38017739,29,Simone Fontecchio,1,29,29,24,5,33
4,0,1,6,0,19,9,6,5,30,1,2,23,2,4,3,1037915,2023-12-14T00:00:00.000Z,666650,29,Talen Horton-Tucker,4,25,29,27,6,40.4
0,0,4,5,2,9,4,0,0,25,3,1,10,7,1,2,1037915,2023-12-14T00:00:00.000Z,56677824,29,Taylor Hendricks,1,17,17,10,7,19.4
4,7,8,1,0,6,5,0,0,27,2,0,10,10,1,1,1037915,2023-12-14T00:00:00.000Z,38017705,29,Walker Kessler,8,20,24,14,14,51
0,0,0,0,0,4,3,0,0,7,1,0,6,1,0,1,1037916,2023-12-14T00:00:00.000Z,17896078,21,Aaron Wiggins,0,7,7,6,1,6.2
3,0,5,3,1,3,1,0,0,15,1,2,3,6,0,0,1037916,2023-12-14T00:00:00.000Z,38017706,21,Jaylin Williams,0,9,12,6,9,14.7
1,0,0,2,0,5,1,0,0,11,0,1,2,0,0,0,1037916,2023-12-14T00:00:00.000Z,480,21,Kenrich Williams,0,2,3,3,1,3.5
0,0,3,4,1,4,1,0,0,10,1,1,3,4,0,0,1037916,2023-12-14T00:00:00.000Z,4197162,26,Aleksandar Vezenkov,0,7,7,3,4,7.8
0,0,0,0,0,0,0,0,0,0,0,0,0,0,0,0,1037916,2023-12-14T00:00:00.000Z,273,26,Alex Len,0,0,0,0,0,0
0,0,0,0,0,0,0,0,0,0,0,0,0,0,0,0,1037916,2023-12-14T00:00:00.000Z,17896030,26,Chris Duarte,0,0,0,0,0,0
0,0,0,0,0,0,0,0,0,0,0,0,0,0,0,0,1037916,2023-12-14T00:00:00.000Z,56677845,26,Colby Jones,0,0,0,0,0,0
0,0,0,0,0,0,0,0,0,0,0,0,0,0,0,0,1037916,2023-12-14T00:00:00.000Z,17553994,26,Davion Mitchell,0,0,0,0,0,0
7,0,3,11,5,23,14,11,8,34,0,3,41,3,2,6,1037916,2023-12-14T00:00:00.000Z,161,26,De'Aaron Fox,2,44,51,48,10,55.1
7,0,14,2,1,13,8,2,1,40,2,2,18,16,0,2,1037916,2023-12-14T00:00:00.000Z,406,26,Domantas Sabonis,0,34,41,25,23,45.7
2,0,1,4,1,7,2,0,0,21,2,1,5,3,0,2,1037916,2023-12-14T00:00:00.000Z,30,26,Harrison Barnes,0,8,10,7,5,9.6
0,0,2,0,0,1,1,0,0,4,0,1,2,2,0,2,1037916,2023-12-14T00:00:00.000Z,306,26,JaVale McGee,0,4,4,2,2,2.4
0,0,0,0,0,0,0,0,0,0,0,0,0,0,0,0,1037916,2023-12-14T00:00:00.000Z,17895990,26,Jordan Ford,0,0,0,0,0,0
1,0,1,2,0,8,4,8,7,31,2,4,15,3,1,1,1037916,2023-12-14T00:00:00.000Z,38017688,26,Keegan Murray,1,18,19,16,4,22.1
3,1,4,7,5,8,6,0,0,27,2,5,17,6,1,0,1037916,2023-12-14T00:00:00.000Z,38017714,26,Keon Ellis,2,23,26,20,9,34.7
0,0,0,0,0,0,0,0,0,1,0,0,0,0,0,0,1037916,2023-12-14T00:00:00.000Z,17896044,26,Kessler Edwards,0,0,0,0,0,0
2,1,1,3,0,8,2,0,0,20,1,1,4,2,2,1,1037916,2023-12-14T00:00:00.000Z,221,26,Kevin Huerter,3,6,8,6,4,17.4
9,1,1,8,4,15,7,0,0,33,0,2,18,1,0,4,1037916,2023-12-14T00:00:00.000Z,324,26,Malik Monk,1,19,28,27,10,31.7
1,1,6,4,1,5,2,0,0,19,1,2,5,7,0,0,1037916,2023-12-14T00:00:00.000Z,290,26,Trey Lyles,1,12,13,6,8,17.9
0,1,1,4,0,9,4,2,1,22,2,5,9,3,0,0,1037917,2023-12-14T00:00:00.000Z,475,10,Andrew Wiggins,1,12,12,9,3,15.6
3,0,2,5,2,9,4,2,2,29,0,4,12,2,0,2,1037917,2023-12-14T00:00:00.000Z,367,10,Chris Paul,0,14,17,15,5,16.9
1,0,6,4,1,5,2,0,0,17,0,2,5,6,0,1,1037917,2023-12-14T00:00:00.000Z,407,10,Dario Saric,0,11,12,6,7,12.7
0,0,0,0,0,0,0,0,0,0,0,0,0,0,0,0,1037917,2023-12-14T00:00:00.000Z,57875092,10,Gui Santos,0,0,0,0,0,0
0,0,0,0,0,0,0,0,0,0,0,0,0,0,0,0,1037917,2023-12-14T00:00:00.000Z,398,10,Jerome Robinson,0,0,0,0,0,0
5,0,1,12,8,15,9,4,4,32,0,1,30,1,2,0,1037917,2023-12-14T00:00:00.000Z,443,10,Klay Thompson,2,31,36,35,6,44.7
0,0,0,0,0,0,0,0,0,0,0,0,0,0,0,0,1037917,2023-12-14T00:00:00.000Z,45658838,10,Lester Quinones,0,0,0,0,0,0
1,0,3,1,0,6,4,4,3,16,2,1,11,5,1,2,1037917,2023-12-14T00:00:00.000Z,17553992,10,Moses Moody,1,16,17,12,6,19.5
4,0,4,13,3,17,5,4,4,34,0,3,17,4,0,1,1037917,2023-12-14T00:00:00.000Z,115,10,Stephen Curry,0,21,25,21,8,26.8
0,0,0,0,0,3,1,0,0,5,3,0,2,3,0,0,1037917,2023-12-14T00:00:00.000Z,56677799,10,Trayce Jackson-Davis,0,5,5,2,3,5.6
1,0,3,11,4,15,6,3,2,30,1,2,18,4,0,1,1037917,2023-12-14T00:00:00.000Z,666511,13,Amir Coffey,0,22,23,19,5,23.3
0,0,0,0,0,0,0,0,0,0,0,0,0,0,0,0,1037917,2023-12-14T00:00:00.000Z,17896022,13,Brandon Boston Jr.,0,0,0,0,0,0
1,1,1,1,0,2,0,4,4,16,0,2,4,1,1,0,1037917,2023-12-14T00:00:00.000Z,439,13,Daniel Theis,2,5,6,5,2,12.7
2,2,5,0,0,10,5,0,0,30,3,5,10,8,0,3,1037917,2023-12-14T00:00:00.000Z,493,13,Ivica Zubac,2,18,20,12,10,25.6
15,4,5,6,5,12,6,12,11,43,2,3,28,7,1,4,1037917,2023-12-14T00:00:00.000Z,192,13,James Harden,5,35,50,43,22,69.9
0,0,0,0,0,0,0,0,0,0,0,0,0,0,0,0,1037917,2023-12-14T00:00:00.000Z,56677856,13,Jordan Miller,0,0,0,0,0,0
2,1,5,4,2,16,9,9,7,39,3,2,27,8,1,2,1037917,2023-12-14T00:00:00.000Z,274,13,Kawhi Leonard,2,35,37,29,10,43.6
0,0,0,0,0,1,1,0,0,7,0,2,2,0,1,0,1037917,2023-12-14T00:00:00.000Z,56677849,13,Kobe Brown,1,2,2,2,0,5
0,0,0,0,0,0,0,0,0,0,0,0,0,0,0,0,1037917,2023-12-14T00:00:00.000Z,38017725,13,Moussa Diabate,0,0,0,0,0,0
0,0,0,0,0,0,0,0,0,0,0,0,0,0,0,0,1037917,2023-12-14T00:00:00.000Z,17896031,13,Nah'Shon Hyland,0,0,0,0,0,0
2,0,5,4,1,13,9,2,2,36,0,3,21,5,1,1,1037917,2023-12-14T00:00:00.000Z,380,13,Norman Powell,1,26,28,23,7,32
0,0,0,0,0,0,0,0,0,0,0,0,0,0,0,0,1037917,2023-12-14T00:00:00.000Z,172,13,Paul George,0,0,0,0,0,0
0,0,0,0,0,0,0,0,0,0,0,0,0,0,0,0,1037917,2023-12-14T00:00:00.000Z,450,13,PJ Tucker,0,0,0,0,0,0
2,1,4,2,1,7,4,0,0,19,0,0,9,4,0,2,1037917,2023-12-14T00:00:00.000Z,472,13,Russell Westbrook,1,13,15,11,6,17.8
2,0,2,4,0,5,1,0,0,20,1,1,2,3,1,0,1037917,2023-12-14T00:00:00.000Z,666743,13,Terance Mann,1,5,7,4,5,11.6
0,0,0,0,0,0,0,0,0,0,0,0,0,0,0,0,1037917,2023-12-14T00:00:00.000Z,24417679,13,Xavier Moon,0,0,0,0,0,0
0,0,0,0,0,0,0,0,0,0,0,0,0,0,0,0,1037918,2023-12-15T00:00:00.000Z,56677848,4,Amari Bailey,0,0,0,0,0,0
3,0,4,5,2,16,7,2,0,35,0,3,16,4,1,0,1037918,2023-12-15T00:00:00.000Z,56677823,4,Brandon Miller,1,20,23,19,7,28.3
0,0,1,2,0,5,2,5,3,21,1,2,7,2,1,0,1037918,2023-12-15T00:00:00.000Z,38017708,4,Bryce McGowens,1,9,9,7,2,12.4
0,0,0,0,0,0,0,0,0,0,0,0,0,0,0,0,1037918,2023-12-15T00:00:00.000Z,666748,4,Cody Martin,0,0,0,0,0,0
0,0,0,0,0,0,0,0,0,0,0,0,0,0,0,0,1037918,2023-12-15T00:00:00.000Z,347,4,Frank Ntilikina,0,0,0,0,0,0
4,1,3,4,1,10,4,0,0,34,0,2,9,3,1,1,1037918,2023-12-15T00:00:00.000Z,204,4,Gordon Hayward,2,12,16,13,7,23.6
2,0,0,0,0,2,0,0,0,15,1,0,0,1,0,0,1037918,2023-12-15T00:00:00.000Z,422,4,Ish Smith,0,1,3,2,3,4.2
0,0,0,0,0,0,0,0,0,0,0,0,0,0,0,0,1037918,2023-12-15T00:00:00.000Z,17896037,4,James Bouknight,0,0,0,0,0,0
0,2,1,1,0,2,0,0,0,14,1,1,0,2,0,0,1037918,2023-12-15T00:00:00.000Z,18678001,4,JT Thor,2,2,2,0,2,8.4
0,0,0,0,0,0,0,0,0,0,0,0,0,0,0,0,1037918,2023-12-15T00:00:00.000Z,3547239,4,LaMelo Ball,0,0,0,0,0,0
0,0,0,0,0,0,0,0,0,0,0,0,0,0,0,0,1037918,2023-12-15T00:00:00.000Z,56677866,4,Leaky Black,0,0,0,0,0,0
0,0,0,0,0,0,0,0,0,0,0,0,0,0,0,0,1037918,2023-12-15T00:00:00.000Z,38017698,4,Mark Williams,0,0,0,0,0,0
2,0,8,8,2,24,10,6,5,39,2,5,27,10,1,3,1037918,2023-12-15T00:00:00.000Z,62,4,Miles Bridges,1,37,39,29,12,42
1,1,5,0,0,7,7,2,2,30,1,5,16,6,0,0,1037918,2023-12-15T00:00:00.000Z,3547282,4,Nick Richards,1,22,23,17,7,27.7
0,0,0,0,0,0,0,0,0,0,0,0,0,0,0,0,1037918,2023-12-15T00:00:00.000Z,56677846,4,Nick Smith Jr.,0,0,0,0,0,0
0,0,0,0,0,0,0,0,0,0,0,0,0,0,0,0,1037918,2023-12-15T00:00:00.000Z,666950,4,P.J. Washington,0,0,0,0,0,0
6,0,4,11,4,25,11,4,4,39,0,0,30,4,3,2,1037918,2023-12-15T00:00:00.000Z,403,4,Terry Rozier,3,34,40,36,10,50.8
0,0,0,0,0,0,0,0,0,0,0,0,0,0,0,0,1037918,2023-12-15T00:00:00.000Z,3547253,4,Theo Maledon,0,0,0,0,0,0
7,0,3,1,0,8,3,2,2,32,0,3,8,3,0,9,1037918,2023-12-15T00:00:00.000Z,227,19,Brandon Ingram,0,11,18,15,10,13.1
0,0,0,0,0,0,0,0,0,0,0,0,0,0,0,0,1037918,2023-12-15T00:00:00.000Z,491,19,Cody Zeller,0,0,0,0,0,0
0,0,0,0,0,0,0,0,0,0,0,0,0,0,0,0,1037918,2023-12-15T00:00:00.000Z,38017726,19,Dereon Seabron,0,0,0,0,0,0
0,0,0,0,0,0,0,0,0,0,0,0,0,0,0,0,1037918,2023-12-15T00:00:00.000Z,17896021,19,Jeremiah Robinson-Earl,0,0,0,0,0,0
0,0,0,1,0,1,0,0,0,4,0,0,0,0,0,0,1037918,2023-12-15T00:00:00.000Z,56677837,19,Jordan Hawkins,0,0,0,0,0,0
0,0,0,0,0,0,0,0,0,0,0,0,0,0,0,0,1037918,2023-12-15T00:00:00.000Z,3547260,19,Kira Lewis Jr.,0,0,0,0,0,0
0,0,0,0,0,0,0,0,0,0,0,0,0,0,0,0,1037918,2023-12-15T00:00:00.000Z,17896017,19,Matt Ryan,0,0,0,0,0,0
4,0,8,0,0,16,9,4,3,30,3,4,21,11,0,1,1037918,2023-12-15T00:00:00.000Z,666969,19,Zion Williamson,0,32,36,25,15,39.2
0,0,0,0,0,0,0,0,0,0,0,0,0,0,0,0,1037919,2023-12-15T00:00:00.000Z,38017694,9,Jalen Duren,0,0,0,0,0,0
1,1,10,0,0,12,9,2,2,28,3,2,20,13,0,2,1037919,2023-12-15T00:00:00.000Z,3547240,9,James Wiseman,1,33,34,21,14,38.1
0,0,0,0,0,0,0,0,0,0,0,0,0,0,0,0,1037919,2023-12-15T00:00:00.000Z,42097199,9,Jared Rhoden,0,0,0,0,0,0
0,0,0,0,0,0,0,0,0,0,0,0,0,0,0,0,1037919,2023-12-15T00:00:00.000Z,56677729,9,Malcolm Cazalon,0,0,0,0,0,0
4,1,2,1,1,4,4,4,2,17,0,1,11,2,1,2,1037919,2023-12-15T00:00:00.000Z,56677792,9,Marcus Sasser,2,13,17,15,6,23.4
0,0,0,0,0,0,0,0,0,0,0,0,0,0,0,0,1037919,2023-12-15T00:00:00.000Z,330,9,Monte Morris,0,0,0,0,0,0
0,0,0,0,0,0,0,0,0,0,0,0,0,0,0,0,1037919,2023-12-15T00:00:00.000Z,44477024,9,Stanley Umude,0,0,0,0,0,0
2,0,1,3,1,5,1,0,0,12,3,2,3,4,0,0,1037919,2023-12-15T00:00:00.000Z,2175,23,Danuel House Jr.,0,7,9,5,6,10.8
1,1,1,3,0,6,1,2,2,23,2,4,4,3,1,0,1037919,2023-12-15T00:00:00.000Z,313,23,De'Anthony Melton,2,7,8,5,4,15.1
1,0,1,3,1,3,1,0,0,7,0,1,3,1,0,0,1037919,2023-12-15T00:00:00.000Z,260,23,Furkan Korkmaz,0,4,5,4,2,5.7
2,4,13,3,2,19,9,16,15,29,0,2,35,13,2,4,1037919,2023-12-15T00:00:00.000Z,145,23,Joel Embiid,6,48,50,37,15,67.6
1,0,2,5,1,11,4,2,2,17,1,3,11,3,0,0,1037919,2023-12-15T00:00:00.000Z,360,23,Kelly Oubre Jr.,0,14,15,12,4,16.1
1,0,0,0,0,3,2,0,0,7,1,0,4,1,0,0,1037919,2023-12-15T00:00:00.000Z,3547294,23,Kenyon Martin Jr.,0,5,6,5,2,6.7
1,0,2,5,5,8,5,0,0,15,0,1,15,2,1,1,1037919,2023-12-15T00:00:00.000Z,328,23,Marcus Morris,1,17,18,16,3,20.9
0,1,3,1,1,2,1,0,0,9,1,2,3,4,0,0,1037919,2023-12-15T00:00:00.000Z,28,23,Mo Bamba,1,7,7,3,4,10.8
4,0,3,1,0,4,2,0,0,22,2,0,4,5,2,0,1037919,2023-12-15T00:00:00.000Z,33,23,Nicolas Batum,2,9,13,8,9,22
0,0,0,0,0,1,0,2,1,12,0,0,1,0,3,0,1037919,2023-12-15T00:00:00.000Z,45,23,Patrick Beverley,3,1,1,1,0,10
0,0,2,1,0,2,0,0,0,13,1,0,0,3,1,1,1037919,2023-12-15T00:00:00.000Z,108,23,Robert Covington,1,3,3,0,3,5.6
2,1,5,3,1,8,4,4,4,23,2,3,13,7,3,2,1037919,2023-12-15T00:00:00.000Z,200,23,Tobias Harris,4,20,22,15,9,34.4
4,0,1,6,1,16,7,5,4,27,0,1,19,1,2,1,1037919,2023-12-15T00:00:00.000Z,3547254,23,Tyrese Maxey,2,20,24,23,5,31.2
1,1,1,8,3,10,4,3,1,24,2,5,12,3,2,0,1037920,2023-12-15T00:00:00.000Z,3547250,12,Aaron Nesmith,3,15,16,13,4,26.1
0,0,0,0,0,0,0,0,0,0,0,0,0,0,0,0,1037920,2023-12-15T00:00:00.000Z,38017507,12,Andrew Nembhard,0,0,0,0,0,0
2,0,2,1,1,9,4,4,4,22,1,2,13,3,1,2,1037920,2023-12-15T00:00:00.000Z,38017686,12,Bennedict Mathurin,1,16,18,15,5,20.6
3,3,3,11,3,14,4,0,0,27,0,1,11,3,2,2,1037920,2023-12-15T00:00:00.000Z,210,12,Buddy Hield,5,14,17,14,6,32.1
1,1,7,0,0,13,10,0,0,20,6,5,20,13,0,1,1037920,2023-12-15T00:00:00.000Z,17896035,12,Isaiah Jackson,1,33,34,21,14,39.1
0,0,0,0,0,0,0,0,0,0,0,0,0,0,0,0,1037920,2023-12-15T00:00:00.000Z,56677794,12,Isaiah Wong,0,0,0,0,0,0
0,0,0,0,0,0,0,0,0,0,0,0,0,0,0,0,1037920,2023-12-15T00:00:00.000Z,3547264,12,Jalen Smith,0,0,0,0,0,0
0,0,0,0,0,0,0,0,0,0,0,0,0,0,0,0,1037920,2023-12-15T00:00:00.000Z,242,12,James Johnson,0,0,0,0,0,0
0,0,1,2,2,3,2,0,0,4,0,0,6,1,0,1,1037920,2023-12-15T00:00:00.000Z,3547207,12,Jordan Nwora,0,7,7,6,1,6.2
0,0,0,0,0,0,0,0,0,0,0,0,0,0,0,0,1037920,2023-12-15T00:00:00.000Z,38017701,12,Kendall Brown,0,0,0,0,0,0
1,0,0,0,0,1,1,0,0,4,0,0,2,0,0,0,1037920,2023-12-15T00:00:00.000Z,56677778,12,Oscar Tshiebwe,0,2,3,3,1,3.5
11,0,1,6,2,17,7,3,3,28,1,2,19,2,0,4,1037920,2023-12-15T00:00:00.000Z,3547245,12,Tyrese Haliburton,0,21,32,30,13,33.9
0,0,0,0,0,0,0,0,0,3,0,0,0,0,0,0,1037920,2023-12-15T00:00:00.000Z,3547302,30,Anthony Gill,0,0,0,0,0,0
0,1,4,3,2,9,6,3,3,30,1,2,17,5,2,4,1037920,2023-12-15T00:00:00.000Z,56677844,30,Bilal Coulibaly,3,22,22,17,5,28
1,1,1,7,3,14,9,3,2,28,0,2,23,1,1,1,1037920,2023-12-15T00:00:00.000Z,17896045,30,Corey Kispert,2,24,25,24,2,30.7
4,3,5,0,0,6,3,4,3,28,5,4,9,10,0,2,1037920,2023-12-15T00:00:00.000Z,666577,30,Daniel Gafford,3,19,23,13,14,34
1,0,4,1,0,2,1,2,2,10,1,0,4,5,0,0,1037920,2023-12-15T00:00:00.000Z,167,30,Danilo Gallinari,0,9,10,5,6,11.5
0,0,0,0,0,0,0,0,0,0,0,0,0,0,0,0,1037920,2023-12-15T00:00:00.000Z,487,30,Delon Wright,0,0,0,0,0,0
4,0,5,0,0,9,2,2,2,25,1,0,6,6,0,1,1037920,2023-12-15T00:00:00.000Z,3547242,30,Deni Avdija,0,12,16,10,10,18.2
0,0,0,0,0,0,0,0,0,0,0,0,0,0,0,0,1037920,2023-12-15T00:00:00.000Z,17896106,30,Eugene Omoruyi,0,0,0,0,0,0
1,0,0,0,0,1,1,0,0,3,0,0,2,0,0,1,1037920,2023-12-15T00:00:00.000Z,18677954,30,Jared Butler,0,2,3,3,1,2.5
0,0,0,0,0,0,0,0,0,0,0,0,0,0,0,0,1037920,2023-12-15T00:00:00.000Z,38017687,30,Johnny Davis,0,0,0,0,0,0
8,0,4,4,3,18,12,4,3,32,0,4,30,4,1,2,1037920,2023-12-15T00:00:00.000Z,666848,30,Jordan Poole,1,34,42,38,12,47.8
4,0,5,9,4,23,11,8,5,30,0,3,31,5,1,3,1037920,2023-12-15T00:00:00.000Z,265,30,Kyle Kuzma,1,36,40,35,9,43
0,0,0,0,0,0,0,0,0,0,0,0,0,0,0,0,1037920,2023-12-15T00:00:00.000Z,414,30,Landry Shamet,0,0,0,0,0,0
2,1,0,1,0,1,0,0,0,19,0,1,0,0,0,0,1037920,2023-12-15T00:00:00.000Z,337,30,Mike Muscala,1,0,2,2,2,6
0,0,1,0,0,2,1,0,0,3,0,0,2,1,0,1,1037920,2023-12-15T00:00:00.000Z,38017704,30,Patrick Baldwin Jr.,0,3,3,2,1,2.2
0,0,0,0,0,0,0,0,0,0,0,0,0,0,0,0,1037920,2023-12-15T00:00:00.000Z,38017712,30,Ryan Rollins,0,0,0,0,0,0
11,2,10,2,1,7,6,0,0,29,0,2,13,10,2,2,1037920,2023-12-15T00:00:00.000Z,249,30,Tyus Jones,4,23,34,24,21,51.5
0,0,0,0,0,0,0,0,0,0,0,0,0,0,0,0,1037921,2023-12-15T00:00:00.000Z,219,2,Al Horford,0,0,0,0,0,0
8,1,3,7,3,15,7,2,2,30,1,0,19,4,4,1,1037921,2023-12-15T00:00:00.000Z,473,2,Derrick White,5,23,31,27,12,49.8
4,1,3,5,0,15,8,3,2,30,0,0,18,3,0,2,1037921,2023-12-15T00:00:00.000Z,70,2,Jaylen Brown,1,21,25,22,7,28.6
4,0,6,9,2,22,11,9,6,39,0,3,30,6,0,2,1037921,2023-12-15T00:00:00.000Z,434,2,Jayson Tatum,0,36,40,34,10,41.2
0,0,0,0,0,0,0,0,0,0,0,0,0,0,0,0,1037921,2023-12-15T00:00:00.000Z,56677864,2,Jordan Walsh,0,0,0,0,0,0
4,1,3,3,2,7,2,0,0,28,1,2,6,4,2,0,1037921,2023-12-15T00:00:00.000Z,214,2,Jrue Holiday,3,10,14,10,8,25.8
0,1,2,3,1,7,3,2,1,14,1,2,8,3,2,1,1037921,2023-12-15T00:00:00.000Z,3547279,2,Lamar Stevens,3,11,11,8,3,19.6
0,0,0,0,0,0,0,0,0,0,0,0,0,0,0,0,1037921,2023-12-15T00:00:00.000Z,261,2,Luke Kornet,0,0,0,0,0,0
1,0,0,1,1,4,4,2,2,16,1,4,11,1,0,2,1037921,2023-12-15T00:00:00.000Z,666468,2,Oshae Brissett,0,12,13,12,2,11.7
4,0,5,6,3,8,4,0,0,32,2,1,11,7,4,1,1037921,2023-12-15T00:00:00.000Z,17896060,2,Sam Hauser,4,18,22,15,11,36.4
0,0,2,0,0,1,0,0,0,3,0,1,0,2,0,1,1037921,2023-12-15T00:00:00.000Z,666885,22,Admiral Schofield,0,2,2,0,2,1.4
1,0,1,4,1,5,2,0,0,11,1,0,5,2,0,0,1037921,2023-12-15T00:00:00.000Z,38017724,22,Caleb Houstan,0,7,8,6,3,8.9
0,0,0,0,0,1,0,0,0,4,0,0,0,0,0,0,1037921,2023-12-15T00:00:00.000Z,666818,22,Chuma Okeke,0,0,0,0,0,0
4,0,0,3,2,8,5,6,5,20,0,3,17,0,1,1,1037921,2023-12-15T00:00:00.000Z,3547251,22,Cole Anthony,1,17,21,21,4,25
0,0,0,2,0,3,1,0,0,16,0,3,2,0,2,0,1037921,2023-12-15T00:00:00.000Z,196,22,Gary Harris,2,2,2,2,0,8
0,0,1,1,0,1,0,0,0,3,0,0,0,1,0,0,1037921,2023-12-15T00:00:00.000Z,56677839,22,Jett Howard,0,1,1,0,1,1.2
0,0,3,2,1,5,3,0,0,16,1,1,7,4,0,0,1037921,2023-12-15T00:00:00.000Z,229,22,Jonathan Isaac,0,11,11,7,4,11.8
0,0,0,0,0,0,0,0,0,0,0,0,0,0,0,0,1037921,2023-12-15T00:00:00.000Z,38017607,22,Kevon Harris,0,0,0,0,0,0
0,0,0,0,0,0,0,0,0,0,0,0,0,0,0,0,1037921,2023-12-15T00:00:00.000Z,165,22,Markelle Fultz,0,0,0,0,0,0
2,0,0,1,0,3,1,0,0,13,1,3,2,1,0,3,1037921,2023-12-15T00:00:00.000Z,462,22,Moritz Wagner,0,3,5,4,3,3.2
0,0,0,0,0,0,0,0,0,0,0,0,0,0,0,0,1037921,2023-12-15T00:00:00.000Z,17553983,22,Trevelin Queen,0,0,0,0,0,0
0,0,0,0,0,0,0,0,0,0,0,0,0,0,0,0,1037921,2023-12-15T00:00:00.000Z,85,22,Wendell Carter Jr.,0,0,0,0,0,0
0,0,0,0,0,0,0,0,0,0,0,0,0,0,0,0,1037922,2023-12-15T00:00:00.000Z,38017689,1,AJ Griffin,0,0,0,0,0,0
6,0,3,7,3,16,7,3,3,33,0,2,20,3,0,0,1037922,2023-12-15T00:00:00.000Z,53,1,Bogdan Bogdanovic,0,23,29,26,9,32.6
0,3,9,0,0,12,9,0,0,35,6,2,18,15,0,1,1037922,2023-12-15T00:00:00.000Z,83,1,Clint Capela,3,33,33,18,15,44
0,0,0,0,0,0,0,0,0,0,0,0,0,0,0,0,1037922,2023-12-15T00:00:00.000Z,666656,1,De'Andre Hunter,0,0,0,0,0,0
9,0,6,6,1,18,8,0,0,33,1,3,17,7,1,1,1037922,2023-12-15T00:00:00.000Z,334,1,Dejounte Murray,1,24,33,26,16,40.9
0,0,1,2,2,2,2,0,0,18,0,2,6,1,1,0,1037922,2023-12-15T00:00:00.000Z,666754,1,Garrison Mathews,1,7,7,6,1,10.2
0,0,0,0,0,0,0,0,0,0,0,0,0,0,0,0,1037922,2023-12-15T00:00:00.000Z,17896040,1,Jalen Johnson,0,0,0,0,0,0
0,0,0,0,0,0,0,0,0,0,0,0,0,0,0,0,1037922,2023-12-15T00:00:00.000Z,56677838,1,Kobe Bufkin,0,0,0,0,0,0
0,0,0,0,0,0,0,0,0,0,0,0,0,0,0,0,1037922,2023-12-15T00:00:00.000Z,56677875,1,Miles Norris,0,0,0,0,0,0
0,1,7,2,1,7,6,1,1,33,4,3,14,11,0,1,1037922,2023-12-15T00:00:00.000Z,3547244,1,Onyeka Okongwu,1,25,25,14,11,29.2
0,0,0,0,0,0,0,0,0,1,0,0,0,0,0,0,1037922,2023-12-15T00:00:00.000Z,319,1,Patty Mills,0,0,0,0,0,0
4,0,7,8,2,12,4,0,0,38,3,3,10,10,0,1,1037922,2023-12-15T00:00:00.000Z,3547256,1,Saddiq Bey,0,20,24,14,14,27
0,0,0,0,0,1,1,0,0,1,0,1,2,0,0,0,1037922,2023-12-15T00:00:00.000Z,56677855,1,Seth Lundy,0,2,2,2,0,2
11,0,4,15,7,29,15,2,1,36,1,2,38,5,1,8,1037922,2023-12-15T00:00:00.000Z,490,1,Trae Young,1,43,54,49,16,55.5
4,0,2,1,0,4,0,0,0,11,1,1,0,3,1,0,1037922,2023-12-15T00:00:00.000Z,3547297,1,Trent Forrest,1,3,7,4,7,12.6
0,0,0,0,0,0,0,0,0,0,0,0,0,0,0,0,1037922,2023-12-15T00:00:00.000Z,301,1,Wesley Matthews,0,0,0,0,0,0
0,0,0,0,0,0,0,0,0,0,0,0,0,0,0,0,1037922,2023-12-15T00:00:00.000Z,38017710,28,Christian Koloko,0,0,0,0,0,0
3,0,2,5,2,8,3,0,0,20,0,1,8,2,0,1,1037922,2023-12-15T00:00:00.000Z,3089,28,Gary Trent Jr.,0,10,13,11,5,13.9
0,0,0,3,1,3,1,0,0,3,0,0,3,0,0,0,1037922,2023-12-15T00:00:00.000Z,56677828,28,Gradey Dick,0,3,3,3,0,3
0,0,0,2,0,3,0,0,0,3,0,0,0,0,0,0,1037922,2023-12-15T00:00:00.000Z,666762,28,Jalen McDaniels,0,0,0,0,0,0
0,0,0,0,0,0,0,0,0,0,0,0,0,0,0,0,1037922,2023-12-15T00:00:00.000Z,56677805,28,Javon Freeman-Liberty,0,0,0,0,0,0
0,0,0,0,0,0,0,0,0,0,0,0,0,0,0,0,1037922,2023-12-15T00:00:00.000Z,2309958,28,Jontay Porter,0,0,0,0,0,0
1,1,4,2,2,4,3,4,3,19,0,4,11,4,0,2,1037922,2023-12-15T00:00:00.000Z,3547275,28,Malachi Flynn,1,15,16,12,5,18.3
0,0,0,0,0,0,0,0,0,0,0,0,0,0,0,0,1037922,2023-12-15T00:00:00.000Z,56677869,28,Markquis Nowell,0,0,0,0,0,0
0,0,0,0,0,0,0,0,0,0,0,0,0,0,0,0,1037922,2023-12-15T00:00:00.000Z,376,28,Otto Porter Jr.,0,0,0,0,0,0
0,0,0,0,0,0,0,0,0,3,0,0,0,0,0,0,1037922,2023-12-15T00:00:00.000Z,489,28,Thaddeus Young,0,0,0,0,0,0
0,0,0,0,0,0,0,0,0,0,0,0,0,0,0,0,1037923,2023-12-15T00:00:00.000Z,117,14,Anthony Davis,0,0,0,0,0,0
4,0,5,10,4,18,8,2,2,34,2,0,22,7,0,2,1037923,2023-12-15T00:00:00.000Z,17553995,14,Austin Reaves,0,29,33,26,11,34.4
3,2,6,5,2,10,6,8,3,30,2,1,17,8,1,0,1037923,2023-12-15T00:00:00.000Z,486,14,Christian Wood,3,25,28,20,11,40.1
1,0,1,0,0,3,3,0,0,6,0,0,6,1,0,0,1037923,2023-12-15T00:00:00.000Z,56677738,14,Colin Castleton,0,7,8,7,2,8.7
3,0,0,2,1,3,2,0,0,8,0,0,5,0,0,0,1037923,2023-12-15T00:00:00.000Z,56677868,14,D'Moi Hodge,0,5,8,8,3,9.5
1,0,5,1,0,3,0,0,0,13,0,4,0,5,0,0,1037923,2023-12-15T00:00:00.000Z,457,14,Jarred Vanderbilt,0,5,6,1,6,7.5
0,1,4,0,0,4,3,3,2,20,3,5,8,7,1,0,1037923,2023-12-15T00:00:00.000Z,666626,14,Jaxson Hayes,2,15,15,8,7,22.4
14,0,5,6,2,17,7,10,7,36,2,1,23,7,2,2,1037923,2023-12-15T00:00:00.000Z,237,14,LeBron James,2,30,44,37,21,56.4
1,0,0,1,0,6,1,0,0,23,0,1,2,0,0,1,1037923,2023-12-15T00:00:00.000Z,38017697,14,Max Christie,0,2,3,3,1,2.5
4,1,5,5,0,15,8,5,4,34,0,1,20,5,0,0,1037923,2023-12-15T00:00:00.000Z,666609,14,Rui Hachimura,1,25,29,24,9,35
1,1,3,6,2,10,5,0,0,36,0,2,12,3,1,1,1037923,2023-12-15T00:00:00.000Z,383,14,Taurean Prince,2,15,16,13,4,22.1
6,0,2,6,3,11,6,0,0,25,0,2,15,2,0,0,1037923,2023-12-15T00:00:00.000Z,359,27,Cedi Osman,0,17,23,21,8,26.4
0,0,0,0,0,0,0,0,0,0,0,0,0,0,0,0,1037923,2023-12-15T00:00:00.000Z,17896049,27,David Duke Jr.,0,0,0,0,0,0
3,1,6,10,5,19,12,7,7,35,0,1,36,6,1,1,1037923,2023-12-15T00:00:00.000Z,3547246,27,Devin Vassell,2,42,45,39,9,52.7
3,0,1,1,0,2,0,0,0,10,0,0,0,1,0,0,1037923,2023-12-15T00:00:00.000Z,180,27,Devonte' Graham,0,1,4,3,4,5.7
0,0,1,4,2,4,2,0,0,17,0,1,6,1,0,1,1037923,2023-12-15T00:00:00.000Z,305,27,Doug McDermott,0,7,7,6,1,6.2
2,1,7,3,0,10,5,1,1,27,1,3,11,8,1,1,1037923,2023-12-15T00:00:00.000Z,38017699,27,Jeremy Sochan,2,19,21,13,10,28.6
0,0,0,2,0,2,0,0,0,9,0,1,0,0,0,0,1037923,2023-12-15T00:00:00.000Z,38017649,27,Julian Champagnie,0,0,0,0,0,0
6,0,1,8,3,16,6,2,2,31,1,1,17,2,0,2,1037923,2023-12-15T00:00:00.000Z,666682,27,Keldon Johnson,0,19,25,23,8,26.4
8,1,4,3,2,8,5,0,0,32,0,3,12,4,1,0,1037923,2023-12-15T00:00:00.000Z,38017692,27,Malaki Branham,2,16,24,20,12,34.8
0,0,0,0,0,0,0,0,0,0,0,0,0,0,0,0,1037923,2023-12-15T00:00:00.000Z,56677817,27,Sidy Cissoko,0,0,0,0,0,0
0,0,0,0,0,0,0,0,0,0,0,0,0,0,0,0,1037923,2023-12-15T00:00:00.000Z,3547274,27,Tre Jones,0,0,0,0,0,0
5,2,12,2,1,13,5,3,2,31,3,3,13,15,2,2,1037923,2023-12-15T00:00:00.000Z,56677822,27,Victor Wembanyama,4,28,33,18,20,48.5
1,0,2,2,1,9,5,6,5,19,4,4,16,6,0,1,1037923,2023-12-15T00:00:00.000Z,102,27,Zach Collins,0,22,23,17,7,23.7
0,0,0,0,0,0,0,0,0,0,0,0,0,0,0,0,1037924,2023-12-15T00:00:00.000Z,56677825,11,Amen Thompson,0,0,0,0,0,0
0,0,0,0,0,0,0,0,0,0,0,0,0,0,0,0,1037924,2023-12-15T00:00:00.000Z,296,11,Boban Marjanovic,0,0,0,0,0,0
0,0,0,0,0,0,0,0,0,0,0,0,0,0,0,0,1037924,2023-12-15T00:00:00.000Z,3547301,11,Jae'Sean Tate,0,0,0,0,0,0
0,0,0,0,0,0,0,0,0,0,0,0,0,0,0,0,1037924,2023-12-15T00:00:00.000Z,47738533,11,Jeenathan Williams,0,0,0,0,0,0
0,0,0,0,0,0,0,0,0,0,0,0,0,0,0,0,1037924,2023-12-15T00:00:00.000Z,56677809,11,Jermaine Samuels Jr.,0,0,0,0,0,0
0,0,0,0,0,0,0,0,0,0,0,0,0,0,0,0,1037924,2023-12-15T00:00:00.000Z,3547281,11,Nate Hinton,0,0,0,0,0,0
0,0,0,0,0,0,0,0,0,0,0,0,0,0,0,0,1037924,2023-12-15T00:00:00.000Z,357,11,Victor Oladipo,0,0,0,0,0,0
1,1,8,0,0,9,5,1,0,33,1,2,10,9,0,2,1037924,2023-12-15T00:00:00.000Z,48,15,Bismack Biyombo,1,19,20,11,10,23.3
2,0,1,2,1,3,1,0,0,9,0,0,3,1,0,0,1037924,2023-12-15T00:00:00.000Z,401,15,Derrick Rose,0,4,6,5,3,7.2
3,0,7,12,4,25,11,3,2,40,6,4,28,13,2,4,1037924,2023-12-15T00:00:00.000Z,3547287,15,Desmond Bane,2,41,44,31,16,50.1
0,0,0,0,0,0,0,0,0,0,0,0,0,0,0,0,1037924,2023-12-15T00:00:00.000Z,666786,15,Ja Morant,0,0,0,0,0,0
3,0,1,2,0,3,0,0,0,16,0,1,0,1,1,2,1037924,2023-12-15T00:00:00.000Z,48248287,15,Jacob Gilyard,1,1,4,3,4,6.7
2,4,2,7,0,23,8,7,6,33,1,5,22,3,0,1,1037924,2023-12-15T00:00:00.000Z,231,15,Jaren Jackson Jr.,4,25,27,24,5,39.6
0,0,2,4,2,8,4,2,1,26,2,3,11,4,0,2,1037924,2023-12-15T00:00:00.000Z,17896067,15,Santi Aldama,0,15,15,11,4,13.8
3,2,7,6,3,8,4,0,0,30,1,2,11,8,1,3,1037924,2023-12-15T00:00:00.000Z,38017731,15,Vince Williams Jr.,3,19,22,14,11,31.1
0,0,0,0,0,0,0,0,0,0,0,0,0,0,0,0,1037925,2023-12-15T00:00:00.000Z,666474,20,Charles Brown,0,0,0,0,0,0
0,0,0,0,0,0,0,0,0,1,0,0,0,0,0,0,1037925,2023-12-15T00:00:00.000Z,666675,20,DaQuan Jeffries,0,0,0,0,0,0
1,0,1,2,1,3,2,0,0,19,0,4,5,1,1,0,1037925,2023-12-15T00:00:00.000Z,131,20,Donte DiVincenzo,1,6,7,6,2,10.7
0,0,0,0,0,0,0,0,0,0,0,0,0,0,0,0,1037925,2023-12-15T00:00:00.000Z,160,20,Evan Fournier,0,0,0,0,0,0
3,0,5,3,1,8,3,4,3,24,0,2,10,5,2,1,1037925,2023-12-15T00:00:00.000Z,3547269,20,Immanuel Quickley,2,15,18,13,8,25.5
2,3,7,0,0,2,2,4,3,31,1,3,7,8,1,2,1037925,2023-12-15T00:00:00.000Z,201,20,Isaiah Hartenstein,4,15,17,9,10,29.6
0,0,0,0,0,0,0,0,0,0,0,0,0,0,0,0,1037925,2023-12-15T00:00:00.000Z,56677795,20,Jacob Toppin,0,0,0,0,0,0
9,0,5,9,9,23,17,9,7,35,1,0,50,6,5,2,1037925,2023-12-15T00:00:00.000Z,73,20,Jalen Brunson,5,56,65,59,15,83.7
0,0,0,0,0,0,0,0,0,0,0,0,0,0,0,0,1037925,2023-12-15T00:00:00.000Z,59421201,20,Jaylen Martin,0,0,0,0,0,0
0,0,2,0,0,4,2,1,1,18,1,3,5,3,0,0,1037925,2023-12-15T00:00:00.000Z,17896063,20,Jericho Sims,0,8,8,5,3,8.6
2,0,0,3,0,8,3,0,0,29,2,0,6,2,0,0,1037925,2023-12-15T00:00:00.000Z,202,20,Josh Hart,0,8,10,8,4,11.4
6,1,7,3,1,16,10,2,2,35,1,4,23,8,0,5,1037925,2023-12-15T00:00:00.000Z,387,20,Julius Randle,1,31,37,29,14,39.6
0,0,0,1,1,1,1,0,0,2,0,0,3,0,0,0,1037925,2023-12-15T00:00:00.000Z,17896033,20,Miles McBride,0,3,3,3,0,3
0,0,0,0,0,0,0,0,0,0,0,0,0,0,0,0,1037925,2023-12-15T00:00:00.000Z,399,20,Mitchell Robinson,0,0,0,0,0,0
1,0,0,6,3,7,3,0,0,15,2,2,9,2,0,0,1037925,2023-12-15T00:00:00.000Z,17895858,20,Quentin Grimes,0,11,12,10,3,12.9
3,1,1,2,1,10,6,8,8,29,1,2,21,2,0,1,1037925,2023-12-15T00:00:00.000Z,666423,20,RJ Barrett,1,23,26,24,5,29.9
1,0,1,0,0,0,0,0,0,1,0,0,0,1,0,0,1037925,2023-12-15T00:00:00.000Z,19,20,Ryan Arcidiacono,0,1,2,1,2,2.7
0,0,0,0,0,0,0,0,0,1,0,0,0,0,0,0,1037925,2023-12-15T00:00:00.000Z,173,20,Taj Gibson,0,0,0,0,0,0
0,0,0,0,0,1,1,0,0,2,0,0,2,0,0,0,1037925,2023-12-15T00:00:00.000Z,666451,24,Bol Bol,0,2,2,2,0,2
1,0,0,1,1,2,2,1,1,4,0,0,6,0,0,0,1037925,2023-12-15T00:00:00.000Z,37,24,Bradley Beal,0,6,7,7,1,7.5
1,0,1,2,0,3,1,2,1,10,0,0,3,1,0,1,1037925,2023-12-15T00:00:00.000Z,314,24,Chimezie Metu,0,4,5,4,2,4.7
0,0,0,0,0,0,0,0,0,0,0,0,0,0,0,0,1037925,2023-12-15T00:00:00.000Z,272,24,Damion Lee,0,0,0,0,0,0
9,0,1,5,1,26,11,6,5,37,1,4,28,2,0,3,1037925,2023-12-15T00:00:00.000Z,57,24,Devin Booker,0,30,39,37,11,40.9
0,2,2,0,0,4,3,2,2,15,1,1,8,3,1,1,1037925,2023-12-15T00:00:00.000Z,147,24,Drew Eubanks,3,11,11,8,3,19.6
0,0,0,0,0,0,0,0,0,0,0,0,0,0,0,0,1037925,2023-12-15T00:00:00.000Z,178,24,Eric Gordon,0,0,0,0,0,0
1,1,0,2,2,5,5,1,1,36,2,4,13,2,2,2,1037925,2023-12-15T00:00:00.000Z,8,24,Grayson Allen,3,15,16,14,3,23.9
9,0,3,3,1,5,1,0,0,23,0,3,3,3,0,1,1037925,2023-12-15T00:00:00.000Z,18678058,24,Jordan Goodwin,0,6,15,12,12,19.1
0,0,0,0,0,0,0,0,0,0,0,0,0,0,0,0,1037925,2023-12-15T00:00:00.000Z,356,24,Josh Okogie,0,0,0,0,0,0
2,0,8,2,1,13,9,2,2,30,4,2,21,12,1,3,1037925,2023-12-15T00:00:00.000Z,349,24,Jusuf Nurkic,1,33,35,23,14,38.4
0,0,3,1,0,5,2,0,0,14,0,0,4,3,0,0,1037925,2023-12-15T00:00:00.000Z,32,24,Keita Bates-Diop,0,7,7,4,3,7.6
6,0,3,9,4,21,10,7,5,36,0,1,29,3,0,0,1037925,2023-12-15T00:00:00.000Z,140,24,Kevin Durant,0,32,38,35,9,41.6
1,0,2,3,1,5,2,0,0,26,2,2,5,4,0,0,1037925,2023-12-15T00:00:00.000Z,666729,24,Nassir Little,0,9,10,6,5,11.3
0,0,0,0,0,0,0,0,0,0,0,0,0,0,0,0,1037925,2023-12-15T00:00:00.000Z,3547298,24,Saben Lee,0,0,0,0,0,0
0,0,0,0,0,0,0,0,0,0,0,0,0,0,0,0,1037925,2023-12-15T00:00:00.000Z,3547095,24,Udoka Azubuike,0,0,0,0,0,0
0,0,0,0,0,0,0,0,0,7,0,0,0,0,0,0,1037925,2023-12-15T00:00:00.000Z,470,24,Yuta Watanabe,0,0,0,0,0,0
0,0,1,2,0,2,0,2,1,4,0,0,1,1,0,0,1037926,2023-12-16T00:00:00.000Z,77,9,Alec Burks,0,2,2,1,1,2.2
1,0,6,3,1,6,3,0,0,24,0,4,7,6,0,0,1037926,2023-12-16T00:00:00.000Z,56677826,9,Ausar Thompson,0,13,14,8,7,15.7
2,0,1,6,2,15,8,6,6,31,1,3,24,2,1,2,1037926,2023-12-16T00:00:00.000Z,54,9,Bojan Bogdanovic,1,26,28,26,4,30.4
6,0,1,2,0,17,10,6,5,31,0,3,25,1,1,2,1037926,2023-12-16T00:00:00.000Z,17896075,9,Cade Cunningham,1,26,32,31,7,36.2
1,1,2,5,0,8,1,0,0,27,2,1,2,4,3,0,1037926,2023-12-16T00:00:00.000Z,17896071,9,Isaiah Livers,4,6,7,3,5,20.3
0,0,0,0,0,0,0,0,0,0,0,0,0,0,0,0,1037926,2023-12-16T00:00:00.000Z,3547267,9,Isaiah Stewart,0,0,0,0,0,0
2,1,3,6,2,17,5,2,1,28,1,0,13,4,1,1,1037926,2023-12-16T00:00:00.000Z,38017682,9,Jaden Ivey,2,17,19,15,6,25.8
0,0,0,0,0,0,0,0,0,0,0,0,0,0,0,0,1037926,2023-12-16T00:00:00.000Z,38017694,9,Jalen Duren,0,0,0,0,0,0
5,0,3,0,0,9,7,3,3,26,3,4,17,6,1,0,1037926,2023-12-16T00:00:00.000Z,3547240,9,James Wiseman,1,23,28,22,11,34.7
0,0,0,0,0,0,0,0,0,0,0,0,0,0,0,0,1037926,2023-12-16T00:00:00.000Z,42097199,9,Jared Rhoden,0,0,0,0,0,0
0,0,0,1,0,1,0,0,0,7,0,1,0,0,0,0,1037926,2023-12-16T00:00:00.000Z,197,9,Joe Harris,0,0,0,0,0,0
0,0,0,1,0,2,0,0,0,9,0,2,0,0,0,0,1037926,2023-12-16T00:00:00.000Z,259,9,Kevin Knox,0,0,0,0,0,0
5,0,4,0,0,4,1,0,0,14,0,0,2,4,0,1,1037926,2023-12-16T00:00:00.000Z,3547241,9,Killian Hayes,0,6,11,7,9,13.3
0,0,0,0,0,0,0,0,0,0,0,0,0,0,0,0,1037926,2023-12-16T00:00:00.000Z,56677729,9,Malcolm Cazalon,0,0,0,0,0,0
2,0,1,2,1,4,2,6,6,17,0,2,11,1,2,2,1037926,2023-12-16T00:00:00.000Z,56677792,9,Marcus Sasser,2,12,14,13,3,19.2
1,2,4,0,0,11,6,1,0,22,3,3,12,7,1,0,1037926,2023-12-16T00:00:00.000Z,24,9,Marvin Bagley III,3,19,20,13,8,30.9
0,0,0,0,0,0,0,0,0,0,0,0,0,0,0,0,1037926,2023-12-16T00:00:00.000Z,330,9,Monte Morris,0,0,0,0,0,0
0,0,0,0,0,0,0,0,0,0,0,0,0,0,0,0,1037926,2023-12-16T00:00:00.000Z,44477024,9,Stanley Umude,0,0,0,0,0,0
1,0,0,6,3,6,3,0,0,20,1,5,9,1,0,0,1037926,2023-12-16T00:00:00.000Z,38017733,17,A.J. Green,0,10,11,10,2,11.7
1,0,7,5,2,8,4,0,0,26,1,4,10,8,0,1,1037926,2023-12-16T00:00:00.000Z,56677852,17,Andre Jackson Jr.,0,18,19,11,9,20.1
1,0,9,7,4,18,11,5,5,27,3,3,31,12,1,4,1037926,2023-12-16T00:00:00.000Z,377,17,Bobby Portis,1,43,44,32,13,45.9
1,5,1,2,1,3,2,0,0,26,0,3,5,1,0,2,1037926,2023-12-16T00:00:00.000Z,283,17,Brook Lopez,5,6,7,6,2,20.7
5,0,1,3,1,5,3,4,4,15,0,2,11,1,1,2,1037926,2023-12-16T00:00:00.000Z,368,17,Cameron Payne,1,12,17,16,6,20.7
0,0,3,0,0,1,1,0,0,9,0,2,2,3,0,0,1037926,2023-12-16T00:00:00.000Z,56677854,17,Chris Livingston,0,5,5,2,3,5.6
5,1,4,14,6,22,11,5,5,30,0,3,33,4,0,2,1037926,2023-12-16T00:00:00.000Z,278,17,Damian Lillard,1,37,42,38,9,46.3
6,0,7,0,0,9,7,13,8,26,1,1,22,8,1,0,1037926,2023-12-16T00:00:00.000Z,15,17,Giannis Antetokounmpo,1,30,36,28,14,43.6
0,0,0,0,0,0,0,0,0,0,0,0,0,0,0,0,1037926,2023-12-16T00:00:00.000Z,112,17,Jae Crowder,0,0,0,0,0,0
0,0,0,0,0,0,0,0,0,0,0,0,0,0,0,0,1037926,2023-12-16T00:00:00.000Z,315,17,Khris Middleton,0,0,0,0,0,0
0,0,0,1,0,4,2,2,2,5,0,0,6,0,0,0,1037926,2023-12-16T00:00:00.000Z,666960,17,Lindell Wigginton,0,6,6,6,0,6
0,0,0,0,0,0,0,0,0,0,0,0,0,0,0,0,1037926,2023-12-16T00:00:00.000Z,38,17,Malik Beasley,0,0,0,0,0,0
1,0,5,2,1,8,4,2,2,33,1,0,11,6,2,3,1037926,2023-12-16T00:00:00.000Z,38017676,17,MarJon Beauchamp,2,17,18,12,7,22.7
0,0,0,0,0,0,0,0,0,0,0,0,0,0,0,0,1037926,2023-12-16T00:00:00.000Z,666453,17,Marques Bolden,0,0,0,0,0,0
2,1,3,1,1,2,2,1,1,12,1,1,6,4,0,0,1037926,2023-12-16T00:00:00.000Z,105,17,Pat Connaughton,1,10,12,8,6,16.8
1,1,0,1,0,2,0,0,0,6,0,0,0,0,0,0,1037926,2023-12-16T00:00:00.000Z,284,17,Robin Lopez,1,0,1,1,1,4.5
0,0,1,0,0,0,0,0,0,5,0,0,0,1,0,0,1037926,2023-12-16T00:00:00.000Z,2148,17,Thanasis Antetokounmpo,0,1,1,0,1,1.2
0,0,0,0,0,0,0,0,0,0,0,0,0,0,0,0,1037926,2023-12-16T00:00:00.000Z,38017691,17,TyTy Washington Jr.,0,0,0,0,0,0
0,0,0,2,0,3,1,2,1,7,0,0,3,0,0,1,1037927,2023-12-16T00:00:00.000Z,56677848,4,Amari Bailey,0,3,3,3,0,2
4,1,4,7,2,16,4,4,4,29,0,0,14,4,0,3,1037927,2023-12-16T00:00:00.000Z,56677823,4,Brandon Miller,1,18,22,18,8,24.8
0,0,2,2,0,10,5,3,2,24,0,1,12,2,0,0,1037927,2023-12-16T00:00:00.000Z,38017708,4,Bryce McGowens,0,14,14,12,2,14.4
0,0,0,0,0,0,0,0,0,0,0,0,0,0,0,0,1037927,2023-12-16T00:00:00.000Z,666748,4,Cody Martin,0,0,0,0,0,0
0,0,0,0,0,0,0,0,0,0,0,0,0,0,0,0,1037927,2023-12-16T00:00:00.000Z,347,4,Frank Ntilikina,0,0,0,0,0,0
0,0,0,0,0,0,0,0,0,0,0,0,0,0,0,0,1037927,2023-12-16T00:00:00.000Z,204,4,Gordon Hayward,0,0,0,0,0,0
4,0,1,0,0,7,3,0,0,18,0,0,6,1,1,0,1037927,2023-12-16T00:00:00.000Z,422,4,Ish Smith,1,7,11,10,5,16.2
0,0,1,5,3,5,3,0,0,7,0,1,9,1,0,0,1037927,2023-12-16T00:00:00.000Z,17896037,4,James Bouknight,0,10,10,9,1,10.2
0,0,1,3,0,8,1,0,0,22,1,1,2,2,0,1,1037927,2023-12-16T00:00:00.000Z,18678001,4,JT Thor,0,4,4,2,2,3.4
0,0,0,0,0,0,0,0,0,0,0,0,0,0,0,0,1037927,2023-12-16T00:00:00.000Z,3547239,4,LaMelo Ball,0,0,0,0,0,0
2,1,1,0,0,1,1,0,0,7,0,0,2,1,1,1,1037927,2023-12-16T00:00:00.000Z,56677866,4,Leaky Black,2,3,5,4,3,11.2
0,0,10,7,1,14,3,2,2,31,0,1,9,10,0,1,1037927,2023-12-16T00:00:00.000Z,62,4,Miles Bridges,0,19,19,9,10,20
1,2,2,0,0,6,4,0,0,20,2,3,8,4,1,1,1037927,2023-12-16T00:00:00.000Z,3547282,4,Nick Richards,3,12,13,9,5,22.3
1,0,0,4,1,8,4,0,0,26,1,2,9,1,0,0,1037927,2023-12-16T00:00:00.000Z,56677846,4,Nick Smith Jr.,0,10,11,10,2,11.7
0,0,0,0,0,0,0,0,0,0,0,0,0,0,0,0,1037927,2023-12-16T00:00:00.000Z,666950,4,P.J. Washington,0,0,0,0,0,0
2,0,1,5,0,10,3,0,0,20,1,2,6,2,0,2,1037927,2023-12-16T00:00:00.000Z,403,4,Terry Rozier,0,8,10,8,4,9.4
2,0,1,2,2,3,3,2,2,7,0,0,10,1,0,0,1037927,2023-12-16T00:00:00.000Z,2175,23,Danuel House Jr.,0,11,13,12,3,14.2
2,0,2,6,2,6,2,0,0,25,0,2,6,2,4,1,1037927,2023-12-16T00:00:00.000Z,313,23,De'Anthony Melton,4,8,10,8,4,22.4
0,0,0,0,0,0,0,0,0,4,0,0,0,0,0,0,1037927,2023-12-16T00:00:00.000Z,260,23,Furkan Korkmaz,0,0,0,0,0,0
1,0,1,0,0,5,2,2,2,12,1,0,6,2,1,2,1037927,2023-12-16T00:00:00.000Z,17896025,23,Jaden Springer,1,8,9,7,3,10.9
0,0,0,0,0,0,0,0,0,0,0,0,0,0,0,0,1037927,2023-12-16T00:00:00.000Z,17554001,23,Javonte Smart,0,0,0,0,0,0
0,0,2,5,2,10,5,0,0,21,2,2,12,4,0,1,1037927,2023-12-16T00:00:00.000Z,360,23,Kelly Oubre Jr.,0,16,16,12,4,15.8
2,0,0,0,0,0,0,0,0,4,0,1,0,0,2,0,1037927,2023-12-16T00:00:00.000Z,3547294,23,Kenyon Martin Jr.,2,0,2,2,2,9
1,0,4,2,0,7,3,0,0,16,0,1,6,4,0,0,1037927,2023-12-16T00:00:00.000Z,328,23,Marcus Morris,0,10,11,7,5,12.3
1,0,1,1,1,3,3,1,0,7,0,2,7,1,0,0,1037927,2023-12-16T00:00:00.000Z,28,23,Mo Bamba,0,8,9,8,2,9.7
2,0,0,1,0,1,0,4,3,8,0,1,3,0,0,0,1037927,2023-12-16T00:00:00.000Z,45,23,Patrick Beverley,0,3,5,5,2,6
1,1,2,0,0,4,2,0,0,14,1,1,4,3,0,0,1037927,2023-12-16T00:00:00.000Z,3547270,23,Paul Reed,1,7,8,5,4,12.1
0,0,0,0,0,0,0,0,0,0,0,0,0,0,0,0,1037927,2023-12-16T00:00:00.000Z,56913527,23,Ricky Council IV,0,0,0,0,0,0
0,1,3,0,0,0,0,0,0,14,0,2,0,3,0,1,1037927,2023-12-16T00:00:00.000Z,108,23,Robert Covington,1,3,3,0,3,5.6
0,0,0,0,0,0,0,0,0,0,0,0,0,0,0,0,1037927,2023-12-16T00:00:00.000Z,56677788,23,Terquavion Smith,0,0,0,0,0,0
7,1,2,8,5,13,8,0,0,33,0,1,21,2,2,0,1037927,2023-12-16T00:00:00.000Z,3547254,23,Tyrese Maxey,3,23,30,28,9,42.9
0,0,0,0,0,0,0,0,0,0,0,0,0,0,0,0,1037928,2023-12-16T00:00:00.000Z,38017689,1,AJ Griffin,0,0,0,0,0,0
0,0,0,0,0,0,0,0,0,0,0,0,0,0,0,0,1037928,2023-12-16T00:00:00.000Z,53,1,Bogdan Bogdanovic,0,0,0,0,0,0
1,1,6,0,0,7,5,5,3,16,2,2,13,8,0,0,1037928,2023-12-16T00:00:00.000Z,666564,1,Bruno Fernando,1,21,22,14,9,27.1
0,0,0,0,0,0,0,0,0,0,0,0,0,0,0,0,1037928,2023-12-16T00:00:00.000Z,83,1,Clint Capela,0,0,0,0,0,0
0,0,2,2,2,7,5,6,6,26,0,1,18,2,1,0,1037928,2023-12-16T00:00:00.000Z,666656,1,De'Andre Hunter,1,20,20,18,2,23.4
6,1,3,5,0,19,8,6,5,37,0,2,21,3,1,0,1037928,2023-12-16T00:00:00.000Z,334,1,Dejounte Murray,2,24,30,27,9,39.6
0,0,0,2,2,2,2,0,0,14,0,4,6,0,0,1,1037928,2023-12-16T00:00:00.000Z,666754,1,Garrison Mathews,0,6,6,6,0,5
0,0,0,0,0,0,0,0,0,0,0,0,0,0,0,0,1037928,2023-12-16T00:00:00.000Z,17896040,1,Jalen Johnson,0,0,0,0,0,0
0,0,0,0,0,0,0,0,0,0,0,0,0,0,0,0,1037928,2023-12-16T00:00:00.000Z,56677838,1,Kobe Bufkin,0,0,0,0,0,0
0,0,0,0,0,0,0,0,0,0,0,0,0,0,0,0,1037928,2023-12-16T00:00:00.000Z,56677875,1,Miles Norris,0,0,0,0,0,0
0,0,0,0,0,0,0,0,0,0,0,0,0,0,0,0,1037928,2023-12-16T00:00:00.000Z,56677806,1,Mouhamed Gueye,0,0,0,0,0,0
1,1,2,4,2,12,7,0,0,32,2,4,16,4,0,1,1037928,2023-12-16T00:00:00.000Z,3547244,1,Onyeka Okongwu,1,20,21,17,5,24.3
2,0,2,3,1,4,1,0,0,13,0,2,3,2,0,1,1037928,2023-12-16T00:00:00.000Z,319,1,Patty Mills,0,5,7,5,4,7.4
0,0,5,7,1,9,1,2,2,36,1,0,5,6,2,2,1037928,2023-12-16T00:00:00.000Z,3547256,1,Saddiq Bey,2,11,11,5,6,16.2
0,0,0,0,0,0,0,0,0,0,0,0,0,0,0,0,1037928,2023-12-16T00:00:00.000Z,56677855,1,Seth Lundy,0,0,0,0,0,0
10,1,4,12,7,21,11,6,6,38,0,3,35,4,0,5,1037928,2023-12-16T00:00:00.000Z,490,1,Trae Young,1,39,49,45,14,52.8
0,0,2,0,0,2,0,0,0,7,1,0,0,3,1,1,1037928,2023-12-16T00:00:00.000Z,3547297,1,Trent Forrest,1,3,3,0,3,5.6
1,0,2,1,0,2,1,0,0,21,0,3,2,2,0,0,1037928,2023-12-16T00:00:00.000Z,301,1,Wesley Matthews,0,4,5,3,3,5.9
1,1,3,4,1,15,6,2,1,25,2,1,14,5,1,3,1037928,2023-12-16T00:00:00.000Z,277,6,Caris LeVert,2,19,20,15,6,24.5
3,0,1,1,0,8,3,0,0,15,1,1,6,2,0,1,1037928,2023-12-16T00:00:00.000Z,56677872,6,Craig Porter,0,8,11,9,5,11.9
0,0,0,0,0,0,0,0,0,0,0,0,0,0,0,0,1037928,2023-12-16T00:00:00.000Z,666581,6,Darius Garland,0,0,0,0,0,0
3,0,4,7,4,8,5,2,2,22,1,5,16,5,1,0,1037928,2023-12-16T00:00:00.000Z,666940,6,Dean Wade,1,21,24,19,8,29.5
13,0,2,9,4,21,7,4,4,41,3,4,22,5,2,1,1037928,2023-12-16T00:00:00.000Z,322,6,Donovan Mitchell,2,27,40,35,18,52.5
0,0,0,0,0,0,0,0,0,0,0,0,0,0,0,0,1037928,2023-12-16T00:00:00.000Z,17896076,6,Evan Mobley,0,0,0,0,0,0
2,0,2,3,0,4,0,0,0,15,1,2,0,3,0,0,1037928,2023-12-16T00:00:00.000Z,344,6,Georges Niang,0,3,5,2,5,6.6
3,0,0,4,3,9,6,4,3,32,3,2,18,3,1,0,1037928,2023-12-16T00:00:00.000Z,3547247,6,Isaac Okoro,1,21,24,21,6,29.1
1,1,10,0,0,14,12,1,1,35,4,1,25,14,2,4,1037928,2023-12-16T00:00:00.000Z,9,6,Jarrett Allen,3,39,40,26,15,48.3
5,1,5,8,1,13,4,2,2,34,1,2,11,6,1,1,1037928,2023-12-16T00:00:00.000Z,666908,6,Max Strus,2,17,22,16,11,30.7
0,0,0,0,0,0,0,0,0,0,0,0,0,0,0,0,1037928,2023-12-16T00:00:00.000Z,404,6,Ricky Rubio,0,0,0,0,0,0
1,0,1,6,3,6,3,0,0,8,0,1,9,1,0,0,1037928,2023-12-16T00:00:00.000Z,3547299,6,Sam Merrill,0,10,11,10,2,11.7
0,0,0,0,0,0,0,0,0,0,0,0,0,0,0,0,1037928,2023-12-16T00:00:00.000Z,666676,6,Ty Jerome,0,0,0,0,0,0
0,0,0,0,0,0,0,0,0,0,0,0,0,0,0,0,1037929,2023-12-16T00:00:00.000Z,56677860,5,Adama Sanogo,0,0,0,0,0,0
3,1,3,7,2,11,3,0,0,41,1,4,8,4,2,2,1037929,2023-12-16T00:00:00.000Z,17895983,5,Ayo Dosunmu,3,12,15,11,7,24.3
5,0,6,10,4,15,7,4,4,39,1,3,22,7,1,1,1037929,2023-12-16T00:00:00.000Z,666956,5,Coby White,1,29,34,27,12,39.9
5,3,2,2,1,13,9,9,8,42,1,1,27,3,2,3,1037929,2023-12-16T00:00:00.000Z,125,5,DeMar DeRozan,5,30,35,32,8,50.1
3,0,7,4,1,13,3,6,5,32,4,1,12,11,1,2,1037929,2023-12-16T00:00:00.000Z,460,5,Nikola Vucevic,1,23,26,15,14,30.7
0,0,0,0,0,0,0,0,0,0,0,0,0,0,0,0,1037929,2023-12-16T00:00:00.000Z,56677874,5,Onuralp Bitim,0,0,0,0,0,0
4,0,6,5,4,10,8,5,5,33,1,3,25,7,0,3,1037929,2023-12-16T00:00:00.000Z,3547248,5,Patrick Williams,0,32,36,29,11,36.4
0,0,0,0,0,0,0,0,0,0,0,0,0,0,0,0,1037929,2023-12-16T00:00:00.000Z,268,5,Zach LaVine,0,0,0,0,0,0
0,0,0,0,0,0,0,0,0,0,0,0,0,0,0,0,1037929,2023-12-16T00:00:00.000Z,4,16,Bam Adebayo,0,0,0,0,0,0
2,0,2,0,0,8,6,8,5,37,2,4,17,4,2,2,1037929,2023-12-16T00:00:00.000Z,666747,16,Caleb Martin,2,21,23,19,6,28.8
0,0,0,0,0,0,0,0,0,0,0,0,0,0,0,0,1037929,2023-12-16T00:00:00.000Z,38017736,16,Cole Swider,0,0,0,0,0,0
6,0,1,9,3,9,3,0,0,24,0,0,9,1,0,2,1037929,2023-12-16T00:00:00.000Z,397,16,Duncan Robinson,0,10,16,15,7,17.2
1,0,0,1,0,2,1,1,0,14,1,2,2,1,0,0,1037929,2023-12-16T00:00:00.000Z,3092,16,Haywood Highsmith,0,3,4,3,2,4.7
4,0,4,3,1,14,8,1,1,35,1,1,18,5,2,2,1037929,2023-12-16T00:00:00.000Z,56677785,16,Jaime Jaquez Jr.,2,23,27,22,9,34
0,0,0,0,0,0,0,0,0,0,0,0,0,0,0,0,1037929,2023-12-16T00:00:00.000Z,38017734,16,Jamal Cain,0,0,0,0,0,0
2,0,3,2,0,18,9,11,10,35,1,3,28,4,2,2,1037929,2023-12-16T00:00:00.000Z,79,16,Jimmy Butler,2,32,34,30,6,39.8
2,0,1,5,2,7,3,0,0,20,1,1,8,2,0,1,1037929,2023-12-16T00:00:00.000Z,391,16,Josh Richardson,0,10,12,10,4,12.4
1,0,6,10,6,12,8,0,0,26,1,2,22,7,1,1,1037929,2023-12-16T00:00:00.000Z,285,16,Kevin Love,1,29,30,23,8,33.9
7,1,3,3,1,7,3,4,3,32,0,2,10,3,0,0,1037929,2023-12-16T00:00:00.000Z,286,16,Kyle Lowry,1,13,20,17,10,27.1
0,0,0,0,0,0,0,0,0,0,0,0,0,0,0,0,1037929,2023-12-16T00:00:00.000Z,38017696,16,Nikola Jovic,0,0,0,0,0,0
1,0,1,2,0,4,1,0,0,11,1,2,2,2,0,0,1037929,2023-12-16T00:00:00.000Z,39398582,16,Orlando Robinson,0,4,5,3,3,5.9
0,0,0,0,0,0,0,0,0,0,0,0,0,0,0,0,1037929,2023-12-16T00:00:00.000Z,3547257,16,R.J. Hampton,0,0,0,0,0,0
0,1,2,0,0,2,1,0,0,6,0,2,2,2,0,0,1037929,2023-12-16T00:00:00.000Z,74,16,Thomas Bryant,1,4,4,2,2,7.4
0,0,0,0,0,0,0,0,0,0,0,0,0,0,0,0,1037929,2023-12-16T00:00:00.000Z,666633,16,Tyler Herro,0,0,0,0,0,0
0,1,2,4,2,14,7,1,1,26,3,1,17,5,0,0,1037930,2023-12-16T00:00:00.000Z,3547250,12,Aaron Nesmith,1,22,22,17,5,26
2,0,1,3,0,4,0,0,0,18,0,1,0,1,0,3,1037930,2023-12-16T00:00:00.000Z,210,12,Buddy Hield,0,1,3,2,3,1.2
0,0,2,0,0,0,0,0,0,3,0,1,0,2,0,0,1037930,2023-12-16T00:00:00.000Z,242,12,James Johnson,0,2,2,0,2,2.4
3,0,2,2,1,3,2,0,0,24,0,2,5,2,2,1,1037930,2023-12-16T00:00:00.000Z,56677832,12,Jarace Walker,2,7,10,8,5,16.9
3,0,1,1,0,4,3,1,1,10,0,0,7,1,0,1,1037930,2023-12-16T00:00:00.000Z,3547207,12,Jordan Nwora,0,8,11,10,4,11.7
0,0,0,0,0,0,0,0,0,0,0,0,0,0,0,0,1037930,2023-12-16T00:00:00.000Z,38017701,12,Kendall Brown,0,0,0,0,0,0
1,0,2,2,1,4,3,0,0,17,2,2,7,4,0,1,1037930,2023-12-16T00:00:00.000Z,3547243,12,Obi Toppin,0,11,12,8,5,12.3
1,0,2,0,0,6,3,2,2,7,2,0,8,4,0,0,1037930,2023-12-16T00:00:00.000Z,56677778,12,Oscar Tshiebwe,0,12,13,9,5,14.3
0,0,0,0,0,0,0,0,0,0,0,0,0,0,0,0,1037930,2023-12-16T00:00:00.000Z,3547245,12,Tyrese Haliburton,0,0,0,0,0,0
4,0,2,10,7,23,14,2,2,34,0,3,37,2,3,4,1037930,2023-12-16T00:00:00.000Z,3547238,18,Anthony Edwards,3,39,43,41,6,50.4
0,0,0,0,0,0,0,0,0,0,0,0,0,0,0,0,1037930,2023-12-16T00:00:00.000Z,17895968,18,Daishen Nix,0,0,0,0,0,0
0,0,0,0,0,0,0,0,0,0,0,0,0,0,0,0,1037930,2023-12-16T00:00:00.000Z,38017715,18,Josh Minott,0,0,0,0,0,0
4,2,7,3,2,25,15,8,8,35,5,2,40,12,3,3,1037930,2023-12-16T00:00:00.000Z,447,18,Karl-Anthony Towns,5,52,56,44,16,72.4
10,0,3,0,0,4,2,0,0,23,1,4,4,4,0,2,1037930,2023-12-16T00:00:00.000Z,12,18,Kyle Anderson,0,8,18,14,14,21.8
9,0,2,3,1,5,2,0,0,24,0,0,5,2,1,0,1037930,2023-12-16T00:00:00.000Z,104,18,Mike Conley,1,7,16,14,11,23.9
1,0,2,2,1,6,1,0,0,26,0,0,3,2,1,1,1037930,2023-12-16T00:00:00.000Z,666400,18,Nickeil Alexander-Walker,1,5,6,4,3,8.9
1,1,5,0,0,3,2,4,1,25,2,1,5,7,1,2,1037930,2023-12-16T00:00:00.000Z,176,18,Rudy Gobert,2,12,13,6,8,18.9
0,0,0,0,0,0,0,0,0,0,0,0,0,0,0,0,1037931,2023-12-16T00:00:00.000Z,9051997,3,Armoni Brooks,0,0,0,0,0,0
0,0,0,0,0,0,0,0,0,0,0,0,0,0,0,0,1037931,2023-12-16T00:00:00.000Z,417,3,Ben Simmons,0,0,0,0,0,0
2,0,5,13,5,24,15,6,6,37,0,5,41,5,1,5,1037931,2023-12-16T00:00:00.000Z,17896048,3,Cam Thomas,1,46,48,43,7,48
0,0,0,0,0,0,0,0,0,0,0,0,0,0,0,0,1037931,2023-12-16T00:00:00.000Z,56677841,3,Dariq Whitehead,0,0,0,0,0,0
2,2,1,0,0,3,0,0,0,9,3,3,0,4,0,0,1037931,2023-12-16T00:00:00.000Z,17896038,3,Day'Ron Sharpe,2,4,6,2,6,13.8
0,0,0,0,0,0,0,0,0,0,0,0,0,0,0,0,1037931,2023-12-16T00:00:00.000Z,421,3,Dennis Smith Jr.,0,0,0,0,0,0
0,0,0,0,0,0,0,0,0,0,0,0,0,0,0,0,1037931,2023-12-16T00:00:00.000Z,174,3,Harry Giles III,0,0,0,0,0,0
0,0,0,0,0,1,1,0,0,8,1,1,2,1,0,1,1037931,2023-12-16T00:00:00.000Z,56677722,3,Jalen Wilson,0,3,3,2,1,2.2
0,0,0,0,0,0,0,0,0,0,0,0,0,0,0,0,1037931,2023-12-16T00:00:00.000Z,17896041,3,Keon Johnson,0,0,0,0,0,0
0,0,0,0,0,0,0,0,0,0,0,0,0,0,0,0,1037931,2023-12-16T00:00:00.000Z,464,3,Lonnie Walker IV,0,0,0,0,0,0
1,4,7,0,0,12,8,3,3,33,5,1,19,12,0,2,1037931,2023-12-16T00:00:00.000Z,666508,3,Nicolas Claxton,4,31,32,20,13,44.9
0,0,0,0,0,0,0,0,0,0,0,0,0,0,0,0,1037931,2023-12-16T00:00:00.000Z,56677843,3,Noah Clowney,0,0,0,0,0,0
14,1,4,10,3,13,6,2,1,40,1,1,16,5,3,2,1037931,2023-12-16T00:00:00.000Z,130,3,Spencer Dinwiddie,4,21,35,30,19,53
1,0,3,1,1,9,4,5,5,26,2,0,14,5,1,0,1037931,2023-12-16T00:00:00.000Z,475,10,Andrew Wiggins,1,19,20,15,6,24.5
0,0,0,0,0,0,0,0,0,0,0,0,0,0,0,0,1037931,2023-12-16T00:00:00.000Z,251,10,Cory Joseph,0,0,0,0,0,0
2,0,3,3,2,8,5,0,0,21,3,3,12,6,1,2,1037931,2023-12-16T00:00:00.000Z,407,10,Dario Saric,1,18,20,14,8,23.2
0,0,0,0,0,0,0,0,0,0,0,0,0,0,0,0,1037931,2023-12-16T00:00:00.000Z,185,10,Draymond Green,0,0,0,0,0,0
1,0,1,0,0,3,1,0,0,12,2,0,2,3,0,0,1037931,2023-12-16T00:00:00.000Z,17553992,10,Moses Moody,0,5,6,3,4,7.1
0,0,0,0,0,0,0,0,0,0,0,0,0,0,0,0,1037931,2023-12-16T00:00:00.000Z,56677799,10,Trayce Jackson-Davis,0,0,0,0,0,0
0,0,0,0,0,0,0,0,0,0,0,0,0,0,0,0,1037932,2023-12-16T00:00:00.000Z,3547271,21,Aleksej Pokusevski,0,0,0,0,0,0
0,0,0,0,0,0,0,0,0,0,0,0,0,0,0,0,1037932,2023-12-16T00:00:00.000Z,56677853,21,Keyontae Johnson,0,0,0,0,0,0
0,0,0,0,0,0,0,0,0,0,0,0,0,0,0,0,1037932,2023-12-16T00:00:00.000Z,27924547,21,Lindy Waters III,0,0,0,0,0,0
0,0,0,0,0,0,0,0,0,0,0,0,0,0,0,0,1037932,2023-12-16T00:00:00.000Z,24572055,21,Olivier Sarr,0,0,0,0,0,0
0,0,0,0,0,0,0,0,0,0,0,0,0,0,0,0,1037932,2023-12-16T00:00:00.000Z,4197029,21,Vasilije Micic,0,0,0,0,0,0
0,0,0,0,0,0,0,0,0,1,0,0,0,0,0,0,1037933,2023-12-16T00:00:00.000Z,17554004,7,AJ Lawson,0,0,0,0,0,0
0,0,0,0,0,0,0,0,0,0,0,0,0,0,0,0,1037933,2023-12-16T00:00:00.000Z,3547258,7,Josh Green,0,0,0,0,0,0
0,0,0,0,0,0,0,0,0,0,0,0,0,0,0,0,1037933,2023-12-16T00:00:00.000Z,228,7,Kyrie Irving,0,0,0,0,0,0
4,0,5,5,2,9,4,0,0,20,0,0,10,5,1,2,1037933,2023-12-16T00:00:00.000Z,329,7,Markieff Morris,1,15,19,14,9,23
0,0,0,0,0,0,0,0,0,0,0,0,0,0,0,0,1037933,2023-12-16T00:00:00.000Z,257,7,Maxi Kleber,0,0,0,0,0,0
0,0,0,0,0,0,0,0,0,0,0,0,0,0,0,0,1037933,2023-12-16T00:00:00.000Z,217,7,Richaun Holmes,0,0,0,0,0,0
1,0,6,15,5,21,8,4,4,36,0,0,25,6,1,1,1037933,2023-12-16T00:00:00.000Z,191,7,Tim Hardaway Jr.,1,31,32,26,7,35.7
2,0,4,2,1,3,1,0,0,11,0,0,3,4,0,0,1037934,2023-12-16T00:00:00.000Z,4197162,26,Aleksandar Vezenkov,0,7,9,5,6,10.8
0,0,1,0,0,2,0,0,0,4,0,0,0,1,0,1,1037934,2023-12-16T00:00:00.000Z,17896030,26,Chris Duarte,0,1,1,0,1,0.2
1,0,0,1,0,5,2,0,0,18,0,3,4,0,0,0,1037934,2023-12-16T00:00:00.000Z,17553994,26,Davion Mitchell,0,4,5,5,1,5.5
0,0,0,0,0,0,0,0,0,0,0,0,0,0,0,0,1037934,2023-12-16T00:00:00.000Z,161,26,De'Aaron Fox,0,0,0,0,0,0
8,0,8,1,0,10,9,4,2,35,2,1,20,10,2,6,1037934,2023-12-16T00:00:00.000Z,406,26,Domantas Sabonis,2,30,38,28,18,44
2,0,2,5,3,11,6,1,1,33,2,1,16,4,1,0,1037934,2023-12-16T00:00:00.000Z,30,26,Harrison Barnes,1,20,22,18,6,26.8
0,0,0,0,0,3,2,0,0,4,0,1,4,0,0,1,1037934,2023-12-16T00:00:00.000Z,306,26,JaVale McGee,0,4,4,4,0,3
2,0,7,15,12,23,16,4,3,36,1,1,47,8,2,0,1037934,2023-12-16T00:00:00.000Z,38017688,26,Keegan Murray,2,55,57,49,10,65.6
7,0,1,3,0,3,0,2,2,26,0,2,2,1,1,3,1037934,2023-12-16T00:00:00.000Z,38017714,26,Keon Ellis,1,3,10,9,8,13.7
5,0,2,4,2,6,4,2,1,25,1,4,11,3,0,0,1037934,2023-12-16T00:00:00.000Z,221,26,Kevin Huerter,0,14,19,16,8,22.1
8,1,4,12,4,16,6,2,2,26,0,0,18,4,0,1,1037934,2023-12-16T00:00:00.000Z,324,26,Malik Monk,1,22,30,26,12,36.8
0,1,7,2,0,2,0,0,0,18,1,4,0,8,0,2,1037934,2023-12-16T00:00:00.000Z,290,26,Trey Lyles,1,8,8,0,8,10.6
1,0,2,6,2,18,10,7,6,33,1,2,28,3,1,1,1037934,2023-12-16T00:00:00.000Z,413,29,Collin Sexton,1,31,32,29,4,35.1
1,0,0,2,0,2,0,0,0,4,0,0,0,0,0,0,1037934,2023-12-16T00:00:00.000Z,38017630,29,Johnny Juzang,0,0,1,1,1,1.5
0,0,0,0,0,0,0,0,0,0,0,0,0,0,0,0,1037934,2023-12-16T00:00:00.000Z,100,29,Jordan Clarkson,0,0,0,0,0,0
0,0,0,0,0,0,0,0,0,0,0,0,0,0,0,0,1037934,2023-12-16T00:00:00.000Z,17896023,29,Josh Christopher,0,0,0,0,0,0
13,1,5,2,1,7,4,0,0,29,0,3,9,5,1,1,1037934,2023-12-16T00:00:00.000Z,358,29,Kelly Olynyk,2,14,27,22,18,39.5
3,1,3,4,1,10,5,0,0,27,1,1,11,4,1,6,1037934,2023-12-16T00:00:00.000Z,139,29,Kris Dunn,2,15,18,14,7,20.3
3,0,5,5,2,13,7,2,2,28,1,2,18,6,0,2,1037934,2023-12-16T00:00:00.000Z,297,29,Lauri Markkanen,0,24,27,21,9,27.7
0,0,4,1,0,1,0,0,0,4,0,0,0,4,0,0,1037934,2023-12-16T00:00:00.000Z,19465584,29,Micah Potter,0,4,4,0,4,4.8
0,0,1,3,1,7,2,0,0,23,3,2,5,4,1,0,1037934,2023-12-16T00:00:00.000Z,38017620,29,Ochai Agbaji,1,9,9,5,4,12.8
0,0,2,5,1,9,3,0,0,25,0,0,7,2,0,0,1037934,2023-12-16T00:00:00.000Z,38017739,29,Simone Fontecchio,0,9,9,7,2,9.4
5,0,2,4,2,11,4,3,2,26,1,0,12,3,3,1,1037934,2023-12-16T00:00:00.000Z,666650,29,Talen Horton-Tucker,3,15,20,17,8,31.1
1,0,2,5,2,8,3,5,4,22,1,0,12,3,1,0,1037934,2023-12-16T00:00:00.000Z,56677824,29,Taylor Hendricks,1,15,16,13,4,20.1
1,1,2,0,0,0,0,4,2,19,1,2,2,3,0,1,1037934,2023-12-16T00:00:00.000Z,38017705,29,Walker Kessler,1,5,6,3,4,9.1
0,0,1,3,1,3,1,0,0,17,0,3,3,1,0,0,1037935,2023-12-16T00:00:00.000Z,666511,13,Amir Coffey,0,4,4,3,1,4.2
2,0,2,3,1,3,1,0,0,5,0,1,3,2,0,0,1037935,2023-12-16T00:00:00.000Z,17896022,13,Brandon Boston Jr.,0,5,7,5,4,8.4
0,0,1,0,0,3,1,6,5,15,0,4,7,1,1,0,1037935,2023-12-16T00:00:00.000Z,439,13,Daniel Theis,1,8,8,7,1,11.2
2,2,7,0,0,9,5,4,3,28,4,2,13,11,1,0,1037935,2023-12-16T00:00:00.000Z,493,13,Ivica Zubac,3,24,26,15,13,38.2
12,2,4,4,1,6,2,7,5,28,0,3,10,4,1,1,1037935,2023-12-16T00:00:00.000Z,192,13,James Harden,3,14,26,22,16,40.8
0,0,1,0,0,0,0,0,0,5,0,0,0,1,0,1,1037935,2023-12-16T00:00:00.000Z,56677856,13,Jordan Miller,0,1,1,0,1,0.2
0,1,0,1,0,2,1,0,0,5,0,0,2,0,0,3,1037935,2023-12-16T00:00:00.000Z,17896051,13,Joshua Primo,1,2,2,2,0,2
4,0,6,6,5,16,12,7,7,30,1,1,36,7,2,0,1037935,2023-12-16T00:00:00.000Z,274,13,Kawhi Leonard,2,43,47,40,11,56.4
0,0,0,3,2,3,2,0,0,5,0,0,6,0,0,0,1037935,2023-12-16T00:00:00.000Z,56677849,13,Kobe Brown,0,6,6,6,0,6
0,0,0,0,0,0,0,0,0,0,0,0,0,0,0,0,1037935,2023-12-16T00:00:00.000Z,38017725,13,Moussa Diabate,0,0,0,0,0,0
0,0,0,0,0,0,0,0,0,0,0,0,0,0,0,0,1037935,2023-12-16T00:00:00.000Z,17896031,13,Nah'Shon Hyland,0,0,0,0,0,0
0,1,2,2,1,10,6,3,3,24,0,1,16,2,0,1,1037935,2023-12-16T00:00:00.000Z,380,13,Norman Powell,1,18,18,16,2,20.4
7,0,4,6,3,18,11,0,0,31,0,4,25,4,2,2,1037935,2023-12-16T00:00:00.000Z,172,13,Paul George,2,29,36,32,11,44.3
0,0,0,0,0,0,0,0,0,0,0,0,0,0,0,0,1037935,2023-12-16T00:00:00.000Z,450,13,PJ Tucker,0,0,0,0,0,0
4,0,3,1,0,7,4,4,2,15,3,1,10,6,1,0,1037935,2023-12-16T00:00:00.000Z,472,13,Russell Westbrook,1,16,20,14,10,26.2
4,0,1,4,2,8,4,3,3,27,0,1,13,1,0,0,1037935,2023-12-16T00:00:00.000Z,666743,13,Terance Mann,0,14,18,17,5,20.2
1,0,2,0,0,0,0,0,0,5,0,0,0,2,0,0,1037935,2023-12-16T00:00:00.000Z,24417679,13,Xavier Moon,0,2,3,1,3,3.9
0,0,0,0,0,0,0,0,0,0,0,0,0,0,0,0,1037935,2023-12-16T00:00:00.000Z,666474,20,Charles Brown,0,0,0,0,0,0
0,0,0,0,0,0,0,0,0,0,0,0,0,0,0,0,1037935,2023-12-16T00:00:00.000Z,56677795,20,Jacob Toppin,0,0,0,0,0,0
0,0,0,0,0,0,0,0,0,0,0,0,0,0,0,0,1037935,2023-12-16T00:00:00.000Z,59421201,20,Jaylen Martin,0,0,0,0,0,0
2,0,1,0,0,4,2,0,0,11,0,2,4,1,2,0,1037935,2023-12-16T00:00:00.000Z,17896033,20,Miles McBride,2,5,7,6,3,14.2
0,0,0,0,0,0,0,0,0,0,0,0,0,0,0,0,1037935,2023-12-16T00:00:00.000Z,399,20,Mitchell Robinson,0,0,0,0,0,0
2,1,7,3,2,7,3,0,0,24,1,2,8,8,0,0,1037936,2023-12-17T00:00:00.000Z,219,2,Al Horford,1,16,18,10,10,23.6
0,0,0,1,0,2,1,0,0,2,0,0,2,0,0,0,1037936,2023-12-17T00:00:00.000Z,17896094,2,Dalano Banton,0,2,2,2,0,2
4,3,5,5,1,9,4,1,1,27,0,1,10,5,1,2,1037936,2023-12-17T00:00:00.000Z,473,2,Derrick White,4,15,19,14,9,32
0,0,0,0,0,0,0,0,0,0,0,0,0,0,0,0,1037936,2023-12-17T00:00:00.000Z,38017707,2,JD Davison,0,0,0,0,0,0
0,0,0,0,0,0,0,0,0,0,0,0,0,0,0,0,1037936,2023-12-17T00:00:00.000Z,56677864,2,Jordan Walsh,0,0,0,0,0,0
0,2,5,5,2,12,6,0,0,34,1,2,14,6,0,3,1037936,2023-12-17T00:00:00.000Z,214,2,Jrue Holiday,2,20,20,14,6,24.2
0,1,9,4,2,12,6,1,1,29,1,2,15,10,1,4,1037936,2023-12-17T00:00:00.000Z,378,2,Kristaps Porzingis,2,25,25,15,10,29
0,0,0,0,0,0,0,0,0,2,0,1,0,0,0,0,1037936,2023-12-17T00:00:00.000Z,3547279,2,Lamar Stevens,0,0,0,0,0,0
0,0,0,0,0,0,0,0,0,0,0,0,0,0,0,0,1037936,2023-12-17T00:00:00.000Z,261,2,Luke Kornet,0,0,0,0,0,0
0,0,3,0,0,2,1,0,0,16,0,1,2,3,0,0,1037936,2023-12-17T00:00:00.000Z,17553967,2,Neemias Queta,0,5,5,2,3,5.6
0,0,2,0,0,0,0,0,0,3,0,0,0,2,0,0,1037936,2023-12-17T00:00:00.000Z,666468,2,Oshae Brissett,0,2,2,0,2,2.4
3,1,4,1,1,5,2,0,0,21,2,3,5,6,0,1,1037936,2023-12-17T00:00:00.000Z,3547276,2,Payton Pritchard,1,11,14,8,9,18.7
0,0,1,3,0,5,2,0,0,17,1,0,4,2,1,1,1037936,2023-12-17T00:00:00.000Z,17896060,2,Sam Hauser,1,6,6,4,2,8.4
0,0,0,0,0,0,0,0,0,0,0,0,0,0,0,0,1037936,2023-12-17T00:00:00.000Z,338,2,Svi Mykhailiuk,0,0,0,0,0,0
1,0,0,0,0,0,0,0,0,2,0,0,0,0,0,0,1037936,2023-12-17T00:00:00.000Z,666885,22,Admiral Schofield,0,0,1,1,1,1.5
3,0,1,3,1,5,2,3,0,17,1,1,5,2,1,0,1037936,2023-12-17T00:00:00.000Z,56677827,22,Anthony Black,1,7,10,8,5,14.9
0,0,1,3,1,4,2,3,3,16,2,2,8,3,0,0,1037936,2023-12-17T00:00:00.000Z,38017724,22,Caleb Houstan,0,11,11,8,3,11.6
0,0,1,0,0,0,0,0,0,2,0,0,0,1,0,0,1037936,2023-12-17T00:00:00.000Z,666818,22,Chuma Okeke,0,1,1,0,1,1.2
4,0,0,2,0,8,2,2,2,19,1,0,6,1,0,1,1037936,2023-12-17T00:00:00.000Z,3547251,22,Cole Anthony,0,7,11,10,5,12.2
6,0,6,4,0,14,3,2,2,37,2,2,8,8,0,0,1037936,2023-12-17T00:00:00.000Z,17896026,22,Franz Wagner,0,16,22,14,14,26.6
2,0,1,3,0,3,0,0,0,26,0,1,0,1,0,0,1037936,2023-12-17T00:00:00.000Z,196,22,Gary Harris,0,1,3,2,3,4.2
1,3,6,0,0,6,2,0,0,26,2,3,4,8,2,1,1037936,2023-12-17T00:00:00.000Z,666442,22,Goga Bitadze,5,12,13,5,9,29.1
0,0,5,4,1,9,5,2,2,28,0,4,13,5,1,2,1037936,2023-12-17T00:00:00.000Z,17896073,22,Jalen Suggs,1,18,18,13,5,20
0,0,0,1,1,2,1,0,0,2,0,0,3,0,0,0,1037936,2023-12-17T00:00:00.000Z,56677839,22,Jett Howard,0,3,3,3,0,3
0,0,0,0,0,0,0,0,0,0,0,0,0,0,0,0,1037936,2023-12-17T00:00:00.000Z,226,22,Joe Ingles,0,0,0,0,0,0
0,1,2,4,2,5,2,2,2,17,0,0,8,2,1,0,1037936,2023-12-17T00:00:00.000Z,229,22,Jonathan Isaac,2,10,10,8,2,16.4
0,0,0,0,0,0,0,0,0,0,0,0,0,0,0,0,1037936,2023-12-17T00:00:00.000Z,38017607,22,Kevon Harris,0,0,0,0,0,0
0,0,0,0,0,0,0,0,0,0,0,0,0,0,0,0,1037936,2023-12-17T00:00:00.000Z,165,22,Markelle Fultz,0,0,0,0,0,0
0,0,2,2,1,3,1,4,3,12,0,3,6,2,0,0,1037936,2023-12-17T00:00:00.000Z,462,22,Moritz Wagner,0,8,8,6,2,8.4
1,0,8,10,4,30,14,6,4,36,2,0,36,10,2,4,1037936,2023-12-17T00:00:00.000Z,38017683,22,Paolo Banchero,2,46,47,37,11,51.5
0,0,0,0,0,0,0,0,0,0,0,0,0,0,0,0,1037936,2023-12-17T00:00:00.000Z,17553983,22,Trevelin Queen,0,0,0,0,0,0
0,0,0,0,0,0,0,0,0,0,0,0,0,0,0,0,1037936,2023-12-17T00:00:00.000Z,85,22,Wendell Carter Jr.,0,0,0,0,0,0
4,1,3,7,5,17,10,1,1,27,0,1,26,3,1,1,1037937,2023-12-17T00:00:00.000Z,227,19,Brandon Ingram,2,29,33,30,7,40.6
4,0,4,0,0,2,1,0,0,18,1,4,2,5,0,1,1037937,2023-12-17T00:00:00.000Z,491,19,Cody Zeller,0,7,11,6,9,13
0,0,0,0,0,0,0,0,0,0,0,0,0,0,0,0,1037937,2023-12-17T00:00:00.000Z,38017726,19,Dereon Seabron,0,0,0,0,0,0
4,0,3,2,1,4,2,0,0,18,1,0,5,4,1,1,1037937,2023-12-17T00:00:00.000Z,38017677,19,Dyson Daniels,1,9,13,9,8,17.8
0,0,0,0,0,0,0,0,0,0,0,0,0,0,0,0,1037937,2023-12-17T00:00:00.000Z,38017663,19,E.J. Liddell,0,0,0,0,0,0
3,0,0,3,0,5,0,2,2,19,1,3,2,1,1,2,1037937,2023-12-17T00:00:00.000Z,17896024,19,Herbert Jones,1,3,6,5,4,8.7
0,0,1,0,0,2,2,0,0,4,0,0,4,1,0,0,1037937,2023-12-17T00:00:00.000Z,17896021,19,Jeremiah Robinson-Earl,0,5,5,4,1,5.2
3,1,12,4,1,13,6,3,2,23,4,3,15,16,1,1,1037937,2023-12-17T00:00:00.000Z,455,19,Jonas Valanciunas,2,31,34,18,19,43.7
0,0,2,4,1,6,3,0,0,12,0,0,7,2,0,0,1037937,2023-12-17T00:00:00.000Z,56677837,19,Jordan Hawkins,0,9,9,7,2,9.4
4,0,3,5,3,7,5,4,3,22,0,0,16,3,1,1,1037937,2023-12-17T00:00:00.000Z,17896097,19,Jose Alvarado,1,19,23,20,7,27.6
0,0,0,0,0,0,0,0,0,0,0,0,0,0,0,0,1037937,2023-12-17T00:00:00.000Z,3547260,19,Kira Lewis Jr.,0,0,0,0,0,0
0,0,0,0,0,0,0,0,0,0,0,0,0,0,0,0,1037937,2023-12-17T00:00:00.000Z,340,19,Larry Nance Jr.,0,0,0,0,0,0
0,0,0,0,0,0,0,0,0,0,0,0,0,0,0,0,1037937,2023-12-17T00:00:00.000Z,17896017,19,Matt Ryan,0,0,0,0,0,0
3,1,3,1,0,12,7,4,1,26,5,2,15,8,2,1,1037937,2023-12-17T00:00:00.000Z,666969,19,Zion Williamson,3,23,26,18,11,37.1
0,0,0,0,0,0,0,0,0,0,0,0,0,0,0,0,1037937,2023-12-17T00:00:00.000Z,38017693,27,Blake Wesley,0,0,0,0,0,0
0,0,3,2,1,7,5,4,3,17,0,2,14,3,0,1,1037937,2023-12-17T00:00:00.000Z,359,27,Cedi Osman,0,17,17,14,3,16.6
0,0,0,0,0,0,0,0,0,0,0,0,0,0,0,0,1037937,2023-12-17T00:00:00.000Z,17895854,27,Charles Bassey,0,0,0,0,0,0
0,0,0,0,0,0,0,0,0,0,0,0,0,0,0,0,1037937,2023-12-17T00:00:00.000Z,56677865,27,Charles Bediako,0,0,0,0,0,0
0,0,0,0,0,0,0,0,0,0,0,0,0,0,0,0,1037937,2023-12-17T00:00:00.000Z,17896049,27,David Duke Jr.,0,0,0,0,0,0
3,0,2,7,3,13,5,1,0,30,0,2,13,2,0,1,1037937,2023-12-17T00:00:00.000Z,3547246,27,Devin Vassell,0,15,18,16,5,18.9
2,0,0,3,2,3,2,2,1,7,0,1,7,0,0,0,1037937,2023-12-17T00:00:00.000Z,180,27,Devonte' Graham,0,7,9,9,2,10
0,0,0,0,0,0,0,0,0,0,0,0,0,0,0,0,1037937,2023-12-17T00:00:00.000Z,38017730,27,Dominick Barlow,0,0,0,0,0,0
1,0,1,5,1,7,2,2,2,15,1,1,7,2,0,0,1037937,2023-12-17T00:00:00.000Z,305,27,Doug McDermott,0,9,10,8,3,10.9
4,0,2,0,0,7,1,4,3,25,1,1,5,3,1,0,1037937,2023-12-17T00:00:00.000Z,38017699,27,Jeremy Sochan,1,8,12,9,7,17.6
1,2,0,6,5,6,5,0,0,14,1,0,15,1,0,0,1037937,2023-12-17T00:00:00.000Z,38017649,27,Julian Champagnie,2,16,17,16,2,23.7
3,0,4,4,0,18,6,2,1,31,4,2,13,8,4,5,1037937,2023-12-17T00:00:00.000Z,666682,27,Keldon Johnson,4,21,24,16,11,34.1
2,0,2,3,1,8,4,2,2,30,0,1,11,2,0,2,1037937,2023-12-17T00:00:00.000Z,38017692,27,Malaki Branham,0,13,15,13,4,14.4
2,0,0,3,0,4,1,0,0,8,0,0,2,0,0,1,1037937,2023-12-17T00:00:00.000Z,17896059,27,Sandro Mamukelashvili,0,2,4,4,2,4
0,0,0,0,0,0,0,0,0,0,0,0,0,0,0,0,1037937,2023-12-17T00:00:00.000Z,56677817,27,Sidy Cissoko,0,0,0,0,0,0
5,0,0,2,0,5,2,0,0,16,0,1,4,0,0,0,1037937,2023-12-17T00:00:00.000Z,3547274,27,Tre Jones,0,4,9,9,5,11.5
4,4,12,6,2,13,6,4,3,31,1,2,17,13,1,3,1037937,2023-12-17T00:00:00.000Z,56677822,27,Victor Wembanyama,5,30,34,21,17,50.6
2,0,4,1,0,3,1,0,0,16,1,2,2,5,0,0,1037937,2023-12-17T00:00:00.000Z,102,27,Zach Collins,0,7,9,4,7,11
2,0,1,1,0,3,0,0,0,12,0,2,0,1,1,2,1037938,2023-12-17T00:00:00.000Z,213,11,Aaron Holiday,1,1,3,2,3,5.2
5,1,6,3,0,15,8,6,4,31,2,4,20,8,1,0,1037938,2023-12-17T00:00:00.000Z,17896062,11,Alperen Sengun,2,28,33,25,13,43.1
0,0,0,0,0,0,0,0,0,0,0,0,0,0,0,0,1037938,2023-12-17T00:00:00.000Z,56677825,11,Amen Thompson,0,0,0,0,0,0
0,0,0,0,0,0,0,0,0,0,0,0,0,0,0,0,1037938,2023-12-17T00:00:00.000Z,296,11,Boban Marjanovic,0,0,0,0,0,0
0,0,0,0,0,0,0,0,0,0,0,0,0,0,0,0,1037938,2023-12-17T00:00:00.000Z,56677831,11,Cam Whitmore,0,0,0,0,0,0
1,0,3,4,2,12,7,2,2,35,1,4,18,4,2,2,1037938,2023-12-17T00:00:00.000Z,66,11,Dillon Brooks,2,22,23,19,5,28.3
6,2,1,8,4,16,8,2,2,39,1,2,22,2,1,1,1037938,2023-12-17T00:00:00.000Z,458,11,Fred VanVleet,3,24,30,28,8,41.4
2,1,5,4,1,13,7,1,1,28,0,5,16,5,0,0,1037938,2023-12-17T00:00:00.000Z,38017684,11,Jabari Smith Jr.,1,21,23,18,7,28
1,0,1,0,0,2,0,0,0,19,2,2,0,3,1,2,1037938,2023-12-17T00:00:00.000Z,3547301,11,Jae'Sean Tate,1,3,4,1,4,6.1
7,0,2,4,2,11,6,2,2,29,0,0,16,2,0,1,1037938,2023-12-17T00:00:00.000Z,17895966,11,Jalen Green,0,18,25,23,9,27.9
0,0,0,0,0,0,0,0,0,0,0,0,0,0,0,0,1037938,2023-12-17T00:00:00.000Z,47738533,11,Jeenathan Williams,0,0,0,0,0,0
1,0,0,1,1,5,4,8,7,17,0,0,16,0,0,1,1037938,2023-12-17T00:00:00.000Z,188,11,Jeff Green,0,16,17,17,1,16.5
0,0,0,0,0,0,0,0,0,0,0,0,0,0,0,0,1037938,2023-12-17T00:00:00.000Z,56677809,11,Jermaine Samuels Jr.,0,0,0,0,0,0
0,0,0,0,0,0,0,0,0,0,0,0,0,0,0,0,1037938,2023-12-17T00:00:00.000Z,19465326,11,Jock Landale,0,0,0,0,0,0
0,0,0,0,0,0,0,0,0,0,0,0,0,0,0,0,1037938,2023-12-17T00:00:00.000Z,3547281,11,Nate Hinton,0,0,0,0,0,0
0,0,0,0,0,0,0,0,0,0,0,0,0,0,0,0,1037938,2023-12-17T00:00:00.000Z,75,11,Reggie Bullock,0,0,0,0,0,0
1,0,6,2,1,8,5,0,0,30,0,2,11,6,2,0,1037938,2023-12-17T00:00:00.000Z,38017695,11,Tari Eason,2,17,18,12,7,25.7
0,0,0,0,0,0,0,0,0,0,0,0,0,0,0,0,1037938,2023-12-17T00:00:00.000Z,357,11,Victor Oladipo,0,0,0,0,0,0
0,0,0,0,0,0,0,0,0,1,0,0,0,0,0,0,1037938,2023-12-17T00:00:00.000Z,38017733,17,A.J. Green,0,0,0,0,0,0
4,0,2,3,1,6,4,0,0,36,4,6,9,6,0,1,1037938,2023-12-17T00:00:00.000Z,56677852,17,Andre Jackson Jr.,0,15,19,13,10,21.2
0,0,2,2,1,7,5,0,0,24,4,3,11,6,0,0,1037938,2023-12-17T00:00:00.000Z,377,17,Bobby Portis,0,17,17,11,6,18.2
1,0,0,4,0,4,0,0,0,11,0,2,0,0,0,0,1037938,2023-12-17T00:00:00.000Z,368,17,Cameron Payne,0,0,1,1,1,1.5
0,0,0,0,0,0,0,0,0,1,0,0,0,0,0,0,1037938,2023-12-17T00:00:00.000Z,56677854,17,Chris Livingston,0,0,0,0,0,0
11,0,5,8,5,19,11,13,12,36,0,2,39,5,3,3,1037938,2023-12-17T00:00:00.000Z,278,17,Damian Lillard,3,44,55,50,16,67.5
0,0,0,0,0,0,0,0,0,0,0,0,0,0,0,0,1037938,2023-12-17T00:00:00.000Z,112,17,Jae Crowder,0,0,0,0,0,0
0,0,0,0,0,0,0,0,0,1,0,0,0,0,0,0,1037938,2023-12-17T00:00:00.000Z,666960,17,Lindell Wigginton,0,0,0,0,0,0
0,0,0,0,0,0,0,0,0,0,0,0,0,0,0,0,1037938,2023-12-17T00:00:00.000Z,38,17,Malik Beasley,0,0,0,0,0,0
0,0,1,0,0,0,0,0,0,12,0,2,0,1,0,0,1037938,2023-12-17T00:00:00.000Z,38017676,17,MarJon Beauchamp,0,1,1,0,1,1.2
0,0,0,0,0,0,0,0,0,1,0,0,0,0,0,0,1037938,2023-12-17T00:00:00.000Z,666453,17,Marques Bolden,0,0,0,0,0,0
4,0,1,3,1,4,2,0,0,17,1,0,5,2,1,1,1037938,2023-12-17T00:00:00.000Z,105,17,Pat Connaughton,1,7,11,9,6,15.4
0,0,0,0,0,0,0,0,0,0,0,0,0,0,0,0,1037938,2023-12-17T00:00:00.000Z,284,17,Robin Lopez,0,0,0,0,0,0
0,0,0,0,0,0,0,0,0,1,0,0,0,0,0,0,1037938,2023-12-17T00:00:00.000Z,2148,17,Thanasis Antetokounmpo,0,0,0,0,0,0
0,0,0,0,0,0,0,0,0,0,0,0,0,0,0,0,1037938,2023-12-17T00:00:00.000Z,38017691,17,TyTy Washington Jr.,0,0,0,0,0,0
8,1,4,11,3,24,10,5,4,42,0,4,27,4,1,5,1037939,2023-12-17T00:00:00.000Z,57,24,Devin Booker,2,31,39,35,12,44.8
3,2,3,6,1,8,2,6,6,33,1,2,11,4,2,1,1037939,2023-12-17T00:00:00.000Z,8,24,Grayson Allen,4,15,18,14,7,31.3
5,1,14,1,0,7,2,4,2,30,3,5,6,17,1,2,1037939,2023-12-17T00:00:00.000Z,349,24,Jusuf Nurkic,2,23,28,11,22,37.9
5,1,2,2,0,24,11,9,6,35,3,1,28,5,1,2,1037939,2023-12-17T00:00:00.000Z,140,24,Kevin Durant,2,33,38,33,10,45.5
1,0,5,2,1,3,2,0,0,23,2,2,5,7,0,1,1037939,2023-12-17T00:00:00.000Z,666729,24,Nassir Little,0,12,13,6,8,13.9
0,0,0,0,0,0,0,0,0,0,0,0,0,0,0,0,1037939,2023-12-17T00:00:00.000Z,38017704,30,Patrick Baldwin Jr.,0,0,0,0,0,0
7,0,3,5,0,20,9,6,6,35,0,3,24,3,1,4,1037940,2023-12-17T00:00:00.000Z,419,25,Anfernee Simons,1,27,34,31,10,37.1
1,1,5,0,0,8,4,0,0,33,3,0,8,8,0,1,1037940,2023-12-17T00:00:00.000Z,22,25,Deandre Ayton,1,16,17,9,9,21.1
0,1,3,0,0,3,1,2,2,15,2,4,4,5,1,1,1037940,2023-12-17T00:00:00.000Z,38017711,25,Jabari Walker,2,9,9,4,5,15
6,0,6,9,3,19,11,5,5,41,1,4,30,7,1,3,1037940,2023-12-17T00:00:00.000Z,182,25,Jerami Grant,1,37,43,36,13,47.4
5,0,1,5,2,8,3,0,0,27,0,1,8,1,0,0,1037940,2023-12-17T00:00:00.000Z,65,25,Malcolm Brogdon,0,9,14,13,6,16.7
1,2,3,4,1,4,1,0,0,18,1,1,3,4,3,0,1037940,2023-12-17T00:00:00.000Z,666923,25,Matisse Thybulle,5,7,8,4,5,24.3
0,0,0,0,0,0,0,0,0,0,0,0,0,0,0,0,1037940,2023-12-17T00:00:00.000Z,666476,25,Moses Brown,0,0,0,0,0,0
2,0,1,4,1,9,4,5,5,22,0,2,14,1,1,1,1037940,2023-12-17T00:00:00.000Z,56677747,25,Scoot Henderson,1,15,17,16,3,20.2
1,0,4,5,3,10,4,1,1,27,1,3,12,5,1,2,1037940,2023-12-17T00:00:00.000Z,38017690,25,Shaedon Sharpe,1,17,18,13,6,20.5
0,0,2,3,3,4,3,4,2,22,1,2,11,3,2,1,1037940,2023-12-17T00:00:00.000Z,56677850,25,Toumani Camara,2,14,14,11,3,19.6
5,0,6,6,1,13,5,2,1,27,1,0,12,7,2,3,1037941,2023-12-18T00:00:00.000Z,277,6,Caris LeVert,2,19,24,17,12,30.9
3,0,0,1,1,2,1,0,0,9,0,0,3,0,1,0,1037941,2023-12-18T00:00:00.000Z,56677872,6,Craig Porter,1,3,6,6,3,10.5
0,0,0,0,0,0,0,0,0,0,0,0,0,0,0,0,1037941,2023-12-18T00:00:00.000Z,248,6,Damian Jones,0,0,0,0,0,0
0,0,0,0,0,0,0,0,0,0,0,0,0,0,0,0,1037941,2023-12-18T00:00:00.000Z,666581,6,Darius Garland,0,0,0,0,0,0
6,2,1,11,4,27,14,5,5,45,0,5,37,1,0,2,1037941,2023-12-18T00:00:00.000Z,322,6,Donovan Mitchell,2,38,44,43,7,51.2
0,0,0,0,0,0,0,0,0,0,0,0,0,0,0,0,1037941,2023-12-18T00:00:00.000Z,56677847,6,Emoni Bates,0,0,0,0,0,0
0,0,0,0,0,0,0,0,0,0,0,0,0,0,0,0,1037941,2023-12-18T00:00:00.000Z,17896076,6,Evan Mobley,0,0,0,0,0,0
0,0,1,6,2,10,4,0,0,25,1,5,10,2,2,3,1037941,2023-12-18T00:00:00.000Z,344,6,Georges Niang,2,12,12,10,2,15.4
0,0,0,0,0,0,0,0,0,0,0,0,0,0,0,0,1037941,2023-12-18T00:00:00.000Z,38017662,6,Isaiah Mobley,0,0,0,0,0,0
2,2,4,0,0,7,3,7,4,29,2,5,10,6,0,1,1037941,2023-12-18T00:00:00.000Z,9,6,Jarrett Allen,2,16,18,12,8,25.2
2,0,3,9,3,13,5,5,4,34,0,3,17,3,0,0,1037941,2023-12-18T00:00:00.000Z,666908,6,Max Strus,0,20,22,19,5,23.6
0,0,0,0,0,0,0,0,0,0,0,0,0,0,0,0,1037941,2023-12-18T00:00:00.000Z,404,6,Ricky Rubio,0,0,0,0,0,0
3,1,3,10,5,11,6,2,2,24,1,1,19,4,1,0,1037941,2023-12-18T00:00:00.000Z,3547299,6,Sam Merrill,2,23,26,22,7,34.3
1,0,2,0,0,1,1,8,2,18,2,2,4,4,0,0,1037941,2023-12-18T00:00:00.000Z,444,6,Tristan Thompson,0,8,9,5,5,10.3
0,0,0,0,0,0,0,0,0,0,0,0,0,0,0,0,1037941,2023-12-18T00:00:00.000Z,666676,6,Ty Jerome,0,0,0,0,0,0
0,0,1,5,2,9,5,2,2,17,1,4,14,2,0,0,1037941,2023-12-18T00:00:00.000Z,213,11,Aaron Holiday,0,16,16,14,2,16.4
2,0,2,7,3,12,6,2,1,38,1,3,16,3,0,0,1037941,2023-12-18T00:00:00.000Z,66,11,Dillon Brooks,0,19,21,18,5,22.6
17,1,8,8,4,19,9,5,5,45,0,4,27,8,2,2,1037941,2023-12-18T00:00:00.000Z,458,11,Fred VanVleet,3,35,52,44,25,69.1
0,0,4,4,1,7,2,0,0,23,3,4,5,7,0,2,1037941,2023-12-18T00:00:00.000Z,38017684,11,Jabari Smith Jr.,0,12,12,5,7,11.4
1,0,1,0,0,4,1,1,1,16,2,2,3,3,0,0,1037941,2023-12-18T00:00:00.000Z,3547301,11,Jae'Sean Tate,0,6,7,4,4,8.1
3,1,1,0,0,6,6,3,3,24,0,3,15,1,0,1,1037941,2023-12-18T00:00:00.000Z,188,11,Jeff Green,1,16,19,18,4,22.7
0,0,0,0,0,0,0,0,0,0,0,0,0,0,0,0,1037941,2023-12-18T00:00:00.000Z,56677809,11,Jermaine Samuels Jr.,0,0,0,0,0,0
0,0,1,0,0,0,0,0,0,4,0,1,0,1,1,0,1037941,2023-12-18T00:00:00.000Z,19465326,11,Jock Landale,1,1,1,0,1,4.2
0,0,0,0,0,0,0,0,0,0,0,0,0,0,0,0,1037941,2023-12-18T00:00:00.000Z,75,11,Reggie Bullock,0,0,0,0,0,0
2,1,4,2,0,13,5,5,4,33,4,4,14,8,4,2,1037941,2023-12-18T00:00:00.000Z,38017695,11,Tari Eason,5,22,24,16,10,39.6
0,0,0,0,0,0,0,0,0,0,0,0,0,0,0,0,1037941,2023-12-18T00:00:00.000Z,357,11,Victor Oladipo,0,0,0,0,0,0
0,0,0,0,0,0,0,0,0,0,0,0,0,0,0,0,1037942,2023-12-18T00:00:00.000Z,38017507,12,Andrew Nembhard,0,0,0,0,0,0
0,0,0,0,0,0,0,0,0,0,0,0,0,0,0,0,1037942,2023-12-18T00:00:00.000Z,56677861,12,Ben Sheppard,0,0,0,0,0,0
0,0,0,0,0,0,0,0,0,0,0,0,0,0,0,0,1037942,2023-12-18T00:00:00.000Z,3547264,12,Jalen Smith,0,0,0,0,0,0
2,0,0,0,0,1,0,0,0,6,1,1,0,1,1,1,1037942,2023-12-18T00:00:00.000Z,242,12,James Johnson,1,1,3,2,3,6.2
0,0,0,0,0,0,0,0,0,0,0,0,0,0,0,0,1037942,2023-12-18T00:00:00.000Z,38017701,12,Kendall Brown,0,0,0,0,0,0
0,0,0,0,0,0,0,0,0,0,0,0,0,0,0,0,1037942,2023-12-18T00:00:00.000Z,452,12,Myles Turner,0,0,0,0,0,0
2,0,3,1,0,1,0,0,0,18,0,2,0,3,0,0,1037942,2023-12-18T00:00:00.000Z,666511,13,Amir Coffey,0,3,5,2,5,6.6
0,0,0,0,0,4,3,0,0,6,0,2,6,0,0,1,1037942,2023-12-18T00:00:00.000Z,17896022,13,Brandon Boston Jr.,0,6,6,6,0,5
0,2,4,0,0,4,1,2,2,22,5,2,4,9,0,2,1037942,2023-12-18T00:00:00.000Z,439,13,Daniel Theis,2,13,13,4,9,18.8
3,3,12,0,0,10,7,5,4,26,4,2,18,16,0,0,1037942,2023-12-18T00:00:00.000Z,493,13,Ivica Zubac,3,34,37,21,19,50.7
9,1,3,11,8,16,12,3,3,28,0,2,35,3,1,1,1037942,2023-12-18T00:00:00.000Z,192,13,James Harden,2,38,47,44,12,57.1
1,0,1,5,2,18,12,2,2,27,1,2,28,2,1,3,1037942,2023-12-18T00:00:00.000Z,274,13,Kawhi Leonard,1,30,31,29,3,31.9
1,0,1,1,0,2,0,0,0,6,0,1,0,1,0,1,1037942,2023-12-18T00:00:00.000Z,56677849,13,Kobe Brown,0,1,2,1,2,1.7
0,0,3,6,4,11,6,3,3,30,0,1,19,3,0,0,1037942,2023-12-18T00:00:00.000Z,380,13,Norman Powell,0,22,22,19,3,22.6
1,1,1,3,0,5,2,0,0,28,1,0,4,2,0,1,1037942,2023-12-18T00:00:00.000Z,666743,13,Terance Mann,1,6,7,5,3,9.9
0,0,0,0,0,0,0,0,0,0,0,0,0,0,0,0,1037943,2023-12-18T00:00:00.000Z,56677860,5,Adama Sanogo,0,0,0,0,0,0
4,2,4,3,0,8,5,1,0,31,0,5,10,4,1,2,1037943,2023-12-18T00:00:00.000Z,89,5,Alex Caruso,3,14,18,14,8,27.8
0,1,5,0,0,3,2,2,1,14,3,0,5,8,1,0,1037943,2023-12-18T00:00:00.000Z,137,5,Andre Drummond,2,13,13,5,8,20.6
9,1,7,6,2,17,9,4,4,40,1,0,24,8,0,2,1037943,2023-12-18T00:00:00.000Z,666956,5,Coby White,1,32,41,33,17,48.1
1,0,2,0,0,1,1,0,0,10,1,2,2,3,0,0,1037943,2023-12-18T00:00:00.000Z,38017719,5,Dalen Terry,0,5,6,3,4,7.1
0,0,0,0,0,0,0,0,0,0,0,0,0,0,0,0,1037943,2023-12-18T00:00:00.000Z,56677857,5,Julian Phillips,0,0,0,0,0,0
0,0,0,0,0,0,0,0,0,0,0,0,0,0,0,0,1037943,2023-12-18T00:00:00.000Z,27,5,Lonzo Ball,0,0,0,0,0,0
0,0,0,0,0,0,0,0,0,0,0,0,0,0,0,0,1037943,2023-12-18T00:00:00.000Z,56677874,5,Onuralp Bitim,0,0,0,0,0,0
0,0,0,0,0,0,0,0,0,0,0,0,0,0,0,0,1037943,2023-12-18T00:00:00.000Z,17896116,5,Terry Taylor,0,0,0,0,0,0
0,0,0,0,0,0,0,0,0,0,0,0,0,0,0,0,1037943,2023-12-18T00:00:00.000Z,110,5,Torrey Craig,0,0,0,0,0,0
0,0,0,0,0,0,0,0,0,0,0,0,0,0,0,0,1037943,2023-12-18T00:00:00.000Z,268,5,Zach LaVine,0,0,0,0,0,0
0,0,0,0,0,0,0,0,0,0,0,0,0,0,0,0,1037944,2023-12-18T00:00:00.000Z,38017689,1,AJ Griffin,0,0,0,0,0,0
0,0,0,0,0,0,0,0,0,0,0,0,0,0,0,0,1037944,2023-12-18T00:00:00.000Z,53,1,Bogdan Bogdanovic,0,0,0,0,0,0
0,0,0,0,0,0,0,0,0,0,0,0,0,0,0,0,1037944,2023-12-18T00:00:00.000Z,666564,1,Bruno Fernando,0,0,0,0,0,0
2,3,8,0,0,11,7,3,3,28,7,3,17,15,1,1,1037944,2023-12-18T00:00:00.000Z,83,1,Clint Capela,4,32,34,19,17,49
2,2,5,6,5,15,7,0,0,29,1,5,19,6,1,4,1037944,2023-12-18T00:00:00.000Z,666656,1,De'Andre Hunter,3,25,27,21,8,34.2
3,1,3,5,3,13,8,2,1,33,0,2,20,3,1,1,1037944,2023-12-18T00:00:00.000Z,334,1,Dejounte Murray,2,23,26,23,6,33.1
0,2,2,5,2,5,2,1,0,23,1,5,6,3,0,2,1037944,2023-12-18T00:00:00.000Z,666754,1,Garrison Mathews,2,9,9,6,3,13.6
0,0,0,0,0,0,0,0,0,0,0,0,0,0,0,0,1037944,2023-12-18T00:00:00.000Z,17896040,1,Jalen Johnson,0,0,0,0,0,0
0,0,0,0,0,0,0,0,0,0,0,0,0,0,0,0,1037944,2023-12-18T00:00:00.000Z,56677838,1,Kobe Bufkin,0,0,0,0,0,0
0,0,0,0,0,0,0,0,0,0,0,0,0,0,0,0,1037944,2023-12-18T00:00:00.000Z,56677875,1,Miles Norris,0,0,0,0,0,0
0,0,0,0,0,0,0,0,0,0,0,0,0,0,0,0,1037944,2023-12-18T00:00:00.000Z,56677806,1,Mouhamed Gueye,0,0,0,0,0,0
1,1,2,0,0,6,5,4,4,23,0,2,14,2,0,2,1037944,2023-12-18T00:00:00.000Z,3547244,1,Onyeka Okongwu,1,16,17,15,3,18.9
0,0,0,0,0,0,0,0,0,0,0,0,0,0,0,0,1037944,2023-12-18T00:00:00.000Z,319,1,Patty Mills,0,0,0,0,0,0
1,0,2,7,2,15,8,5,3,42,2,1,21,4,2,1,1037944,2023-12-18T00:00:00.000Z,3547256,1,Saddiq Bey,2,25,26,22,5,32.3
0,0,1,1,0,1,0,0,0,9,0,2,0,1,0,0,1037944,2023-12-18T00:00:00.000Z,56677855,1,Seth Lundy,0,1,1,0,1,1.2
15,0,4,11,4,17,8,12,11,38,0,3,31,4,0,5,1037944,2023-12-18T00:00:00.000Z,490,1,Trae Young,0,35,50,46,19,53.3
0,0,0,0,0,0,0,0,0,0,0,0,0,0,0,0,1037944,2023-12-18T00:00:00.000Z,3547297,1,Trent Forrest,0,0,0,0,0,0
1,1,2,1,0,2,1,0,0,15,0,1,2,2,1,1,1037944,2023-12-18T00:00:00.000Z,301,1,Wesley Matthews,2,4,5,3,3,10.9
2,0,1,2,0,11,2,2,2,23,1,3,6,2,1,0,1037944,2023-12-18T00:00:00.000Z,77,9,Alec Burks,1,8,10,8,4,14.4
3,0,5,1,0,5,1,0,0,19,3,2,2,8,1,2,1037944,2023-12-18T00:00:00.000Z,56677826,9,Ausar Thompson,1,10,13,5,11,17.1
2,0,1,9,5,17,9,3,2,39,1,3,25,2,0,2,1037944,2023-12-18T00:00:00.000Z,54,9,Bojan Bogdanovic,0,27,29,27,4,28.4
7,1,4,5,3,24,16,9,8,44,1,1,43,5,3,3,1037944,2023-12-18T00:00:00.000Z,17896075,9,Cade Cunningham,4,48,55,50,12,68.5
0,0,0,1,0,3,0,0,0,5,0,0,0,0,0,0,1037944,2023-12-18T00:00:00.000Z,17896071,9,Isaiah Livers,0,0,0,0,0,0
0,0,0,0,0,0,0,0,0,0,0,0,0,0,0,0,1037944,2023-12-18T00:00:00.000Z,3547267,9,Isaiah Stewart,0,0,0,0,0,0
4,0,6,2,0,13,6,5,3,29,2,6,15,8,0,2,1037944,2023-12-18T00:00:00.000Z,38017682,9,Jaden Ivey,0,23,27,19,12,28.6
0,0,0,0,0,0,0,0,0,0,0,0,0,0,0,0,1037944,2023-12-18T00:00:00.000Z,38017694,9,Jalen Duren,0,0,0,0,0,0
2,0,5,0,0,5,5,2,0,25,2,2,10,7,0,2,1037944,2023-12-18T00:00:00.000Z,3547240,9,James Wiseman,0,17,19,12,9,19.4
0,0,0,0,0,0,0,0,0,0,0,0,0,0,0,0,1037944,2023-12-18T00:00:00.000Z,42097199,9,Jared Rhoden,0,0,0,0,0,0
2,1,1,1,0,1,0,2,1,12,1,1,1,2,1,0,1037944,2023-12-18T00:00:00.000Z,197,9,Joe Harris,2,3,5,3,4,12.4
0,0,0,0,0,0,0,0,0,0,0,0,0,0,0,0,1037944,2023-12-18T00:00:00.000Z,259,9,Kevin Knox,0,0,0,0,0,0
0,0,0,0,0,0,0,0,0,0,0,0,0,0,0,0,1037944,2023-12-18T00:00:00.000Z,3547241,9,Killian Hayes,0,0,0,0,0,0
0,0,0,0,0,0,0,0,0,0,0,0,0,0,0,0,1037944,2023-12-18T00:00:00.000Z,56677729,9,Malcolm Cazalon,0,0,0,0,0,0
1,1,1,1,1,3,2,0,0,21,0,6,5,1,1,0,1037944,2023-12-18T00:00:00.000Z,56677792,9,Marcus Sasser,2,6,7,6,2,13.7
0,0,0,0,0,12,7,4,3,23,1,2,17,1,0,2,1037944,2023-12-18T00:00:00.000Z,24,9,Marvin Bagley III,0,18,18,17,1,16.2
0,0,0,0,0,0,0,0,0,0,0,0,0,0,0,0,1037944,2023-12-18T00:00:00.000Z,330,9,Monte Morris,0,0,0,0,0,0
0,0,0,0,0,0,0,0,0,0,0,0,0,0,0,0,1037944,2023-12-18T00:00:00.000Z,44477024,9,Stanley Umude,0,0,0,0,0,0
0,0,0,0,0,0,0,0,0,0,0,0,0,0,0,0,1037945,2023-12-18T00:00:00.000Z,38017736,16,Cole Swider,0,0,0,0,0,0
0,0,0,0,0,0,0,0,0,0,0,0,0,0,0,0,1037945,2023-12-18T00:00:00.000Z,19465585,16,Dru Smith,0,0,0,0,0,0
3,0,5,8,4,9,5,0,0,22,0,2,14,5,1,2,1037945,2023-12-18T00:00:00.000Z,397,16,Duncan Robinson,1,19,22,17,8,25.5
1,1,0,0,0,0,0,0,0,12,0,2,0,0,1,0,1037945,2023-12-18T00:00:00.000Z,3092,16,Haywood Highsmith,2,0,1,1,1,7.5
0,2,2,1,0,8,3,2,2,30,1,4,8,3,2,3,1037945,2023-12-18T00:00:00.000Z,56677785,16,Jaime Jaquez Jr.,4,11,11,8,3,20.6
0,0,0,0,0,0,0,0,0,0,0,0,0,0,0,0,1037945,2023-12-18T00:00:00.000Z,38017734,16,Jamal Cain,0,0,0,0,0,0
5,0,3,3,1,12,5,6,4,34,2,1,15,5,0,1,1037945,2023-12-18T00:00:00.000Z,79,16,Jimmy Butler,0,20,25,20,10,27.5
3,0,4,4,2,6,4,3,3,26,0,2,13,4,0,1,1037945,2023-12-18T00:00:00.000Z,391,16,Josh Richardson,0,17,20,16,7,21.3
0,0,0,0,0,0,0,0,0,0,0,0,0,0,0,0,1037945,2023-12-18T00:00:00.000Z,286,16,Kyle Lowry,0,0,0,0,0,0
0,0,0,0,0,0,0,0,0,0,0,0,0,0,0,0,1037945,2023-12-18T00:00:00.000Z,38017696,16,Nikola Jovic,0,0,0,0,0,0
0,0,0,0,0,0,0,0,0,0,0,0,0,0,0,0,1037945,2023-12-18T00:00:00.000Z,39398582,16,Orlando Robinson,0,0,0,0,0,0
0,0,0,0,0,0,0,0,0,0,0,0,0,0,0,0,1037945,2023-12-18T00:00:00.000Z,3547257,16,R.J. Hampton,0,0,0,0,0,0
0,0,0,0,0,0,0,0,0,0,0,0,0,0,0,0,1037945,2023-12-18T00:00:00.000Z,74,16,Thomas Bryant,0,0,0,0,0,0
5,2,8,9,2,25,13,4,4,40,0,1,32,8,3,1,1037945,2023-12-18T00:00:00.000Z,3547238,18,Anthony Edwards,5,40,45,37,13,63.1
2,3,2,0,0,10,5,0,0,30,3,6,10,5,0,3,1037945,2023-12-18T00:00:00.000Z,3547259,18,Jaden McDaniels,3,15,17,12,7,25
0,0,0,0,0,0,0,0,0,0,0,0,0,0,0,0,1037945,2023-12-18T00:00:00.000Z,666767,18,Jordan McLaughlin,0,0,0,0,0,0
0,0,0,0,0,0,0,0,0,0,0,0,0,0,0,0,1037945,2023-12-18T00:00:00.000Z,38017715,18,Josh Minott,0,0,0,0,0,0
2,0,4,4,1,14,7,3,3,32,4,3,18,8,1,1,1037945,2023-12-18T00:00:00.000Z,447,18,Karl-Anthony Towns,1,26,28,20,10,32.6
5,1,2,0,0,4,2,2,1,22,0,2,5,2,0,1,1037945,2023-12-18T00:00:00.000Z,12,18,Kyle Anderson,1,7,12,10,7,16.9
6,0,1,5,4,5,4,0,0,33,0,1,12,1,1,4,1037945,2023-12-18T00:00:00.000Z,104,18,Mike Conley,1,13,19,18,7,21.2
1,1,3,6,1,13,5,4,4,21,1,2,15,4,1,1,1037945,2023-12-18T00:00:00.000Z,667378,18,Naz Reid,2,19,20,16,5,26.3
3,0,0,4,2,5,2,2,2,22,1,2,8,1,1,0,1037945,2023-12-18T00:00:00.000Z,666400,18,Nickeil Alexander-Walker,1,9,12,11,4,16.7
0,0,0,0,0,0,0,0,0,0,0,0,0,0,0,0,1037945,2023-12-18T00:00:00.000Z,320,18,Shake Milton,0,0,0,0,0,0
1,0,1,1,1,1,1,0,0,5,0,0,3,1,0,1,1037945,2023-12-18T00:00:00.000Z,68,18,Troy Brown Jr.,0,4,5,4,2,4.7
0,0,0,0,0,0,0,0,0,0,0,0,0,0,0,0,1037946,2023-12-18T00:00:00.000Z,56677848,4,Amari Bailey,0,0,0,0,0,0
0,0,0,0,0,0,0,0,0,0,0,0,0,0,0,0,1037946,2023-12-18T00:00:00.000Z,347,4,Frank Ntilikina,0,0,0,0,0,0
1,1,0,0,0,10,4,0,0,23,0,1,8,0,0,1,1037946,2023-12-18T00:00:00.000Z,422,4,Ish Smith,1,8,9,9,1,11.5
0,0,0,0,0,0,0,0,0,0,0,0,0,0,0,0,1037946,2023-12-18T00:00:00.000Z,3547239,4,LaMelo Ball,0,0,0,0,0,0
0,1,1,5,1,9,3,0,0,20,0,2,7,1,0,1,1037946,2023-12-18T00:00:00.000Z,56677846,4,Nick Smith Jr.,1,8,8,7,1,10.2
0,0,0,0,0,0,0,0,0,0,0,0,0,0,0,0,1037946,2023-12-18T00:00:00.000Z,2309958,28,Jontay Porter,0,0,0,0,0,0
0,0,0,0,0,0,0,0,0,0,0,0,0,0,0,0,1037947,2023-12-18T00:00:00.000Z,48,15,Bismack Biyombo,0,0,0,0,0,0
0,0,0,0,0,0,0,0,0,0,0,0,0,0,0,0,1037947,2023-12-18T00:00:00.000Z,666505,15,Brandon Clarke,0,0,0,0,0,0
1,0,4,3,1,5,2,3,3,22,0,1,8,4,1,3,1037947,2023-12-18T00:00:00.000Z,38017729,15,David Roddy,1,12,13,9,5,14.3
0,0,0,0,0,0,0,0,0,0,0,0,0,0,0,0,1037947,2023-12-18T00:00:00.000Z,401,15,Derrick Rose,0,0,0,0,0,0
5,1,1,9,4,14,6,2,1,28,0,1,17,1,0,5,1037947,2023-12-18T00:00:00.000Z,3547287,15,Desmond Bane,1,18,23,22,6,23.7
0,1,0,3,2,6,3,0,0,12,0,2,8,0,0,0,1037947,2023-12-18T00:00:00.000Z,56677830,15,GG Jackson,1,8,8,8,0,11
0,0,0,0,0,0,0,0,0,0,0,0,0,0,0,0,1037947,2023-12-18T00:00:00.000Z,666786,15,Ja Morant,0,0,0,0,0,0
7,0,1,6,4,9,4,0,0,34,0,2,12,1,1,3,1037947,2023-12-18T00:00:00.000Z,48248287,15,Jacob Gilyard,1,13,20,19,8,23.7
0,0,1,4,1,4,1,0,0,12,2,0,3,3,0,0,1037947,2023-12-18T00:00:00.000Z,38017728,15,Jake LaRavia,0,6,6,3,3,6.6
1,0,5,4,1,7,3,5,4,25,0,3,11,5,1,2,1037947,2023-12-18T00:00:00.000Z,231,15,Jaren Jackson Jr.,1,16,17,12,6,19.5
2,0,1,3,1,3,1,2,2,17,1,2,5,2,2,2,1037947,2023-12-18T00:00:00.000Z,666703,15,John Konchar,2,7,9,7,4,14.4
0,0,0,0,0,0,0,0,0,0,0,0,0,0,0,0,1037947,2023-12-18T00:00:00.000Z,38017732,15,Kenneth Lofton Jr.,0,0,0,0,0,0
0,0,0,0,0,0,0,0,0,0,0,0,0,0,0,0,1037947,2023-12-18T00:00:00.000Z,254,15,Luke Kennard,0,0,0,0,0,0
0,0,0,0,0,0,0,0,0,0,0,0,0,0,0,0,1037947,2023-12-18T00:00:00.000Z,420,15,Marcus Smart,0,0,0,0,0,0
0,0,0,0,0,0,0,0,0,0,0,0,0,0,0,0,1037947,2023-12-18T00:00:00.000Z,3,15,Steven Adams,0,0,0,0,0,0
1,0,3,5,1,7,2,0,0,23,2,3,5,5,0,1,1037947,2023-12-18T00:00:00.000Z,38017731,15,Vince Williams Jr.,0,10,11,6,6,11.5
2,1,8,3,0,8,0,0,0,25,0,1,0,8,1,1,1037947,2023-12-18T00:00:00.000Z,3547285,15,Xavier Tillman,2,8,10,2,10,17.6
5,0,7,7,2,12,6,5,5,22,0,3,19,7,0,4,1037947,2023-12-18T00:00:00.000Z,17896027,15,Ziaire Williams,0,26,31,24,12,30.9
2,7,4,4,2,14,7,1,1,25,2,2,17,6,1,2,1037947,2023-12-18T00:00:00.000Z,38017685,21,Chet Holmgren,8,23,25,19,8,49.2
0,0,0,0,0,0,0,0,0,0,0,0,0,0,0,0,1037947,2023-12-18T00:00:00.000Z,44,21,Davis Bertans,0,0,0,0,0,0
3,0,3,3,1,5,2,0,0,20,1,1,5,4,1,0,1037947,2023-12-18T00:00:00.000Z,3547272,21,Isaiah Joe,1,9,12,8,7,17.3
5,1,4,3,1,9,3,4,3,28,0,2,10,4,2,0,1037947,2023-12-18T00:00:00.000Z,38017703,21,Jalen Williams,3,14,19,15,9,31.3
4,0,9,4,0,12,6,4,4,24,3,0,16,12,1,1,1037947,2023-12-18T00:00:00.000Z,17896065,21,Josh Giddey,1,28,32,20,16,38.4
3,0,4,3,2,3,2,0,0,16,0,0,6,4,0,1,1037947,2023-12-18T00:00:00.000Z,480,21,Kenrich Williams,0,10,13,9,7,14.3
0,0,0,0,0,0,0,0,0,0,0,0,0,0,0,0,1037947,2023-12-18T00:00:00.000Z,27924547,21,Lindy Waters III,0,0,0,0,0,0
2,1,2,6,3,7,4,0,0,21,0,2,11,2,0,0,1037947,2023-12-18T00:00:00.000Z,666541,21,Luguentz Dort,1,13,15,13,4,19.4
2,0,1,2,0,5,2,0,0,19,1,1,4,2,0,0,1037947,2023-12-18T00:00:00.000Z,38017716,21,Ousmane Dieng,0,6,8,6,4,9.4
2,0,0,0,0,0,0,0,0,7,0,0,0,0,0,1,1037947,2023-12-18T00:00:00.000Z,17896036,21,Tre Mann,0,0,2,2,2,2
0,0,1,2,1,4,2,2,1,15,1,2,6,2,0,1,1037948,2023-12-18T00:00:00.000Z,17554004,7,AJ Lawson,0,8,8,6,2,7.4
2,0,1,1,1,5,5,0,0,23,0,3,11,1,0,1,1037948,2023-12-18T00:00:00.000Z,151,7,Dante Exum,0,12,14,13,3,14.2
0,0,0,0,0,0,0,0,0,0,0,0,0,0,0,0,1037948,2023-12-18T00:00:00.000Z,56677840,7,Dereck Lively II,0,0,0,0,0,0
0,0,0,0,0,0,0,0,0,0,0,0,0,0,0,0,1037948,2023-12-18T00:00:00.000Z,56677873,7,Dexter Dennis,0,0,0,0,0,0
0,0,1,0,0,3,2,5,1,9,1,1,5,2,0,1,1037948,2023-12-18T00:00:00.000Z,17896028,7,Greg Brown III,0,7,7,5,2,6.4
3,1,1,3,2,9,3,2,1,19,0,1,9,1,0,1,1037948,2023-12-18T00:00:00.000Z,38017679,7,Jaden Hardy,1,10,13,12,4,16.7
0,0,0,0,0,0,0,0,0,0,0,0,0,0,0,0,1037948,2023-12-18T00:00:00.000Z,3547258,7,Josh Green,0,0,0,0,0,0
0,0,0,0,0,0,0,0,0,0,0,0,0,0,0,0,1037948,2023-12-18T00:00:00.000Z,228,7,Kyrie Irving,0,0,0,0,0,0
8,0,8,12,6,24,13,10,6,36,3,1,38,11,0,3,1037948,2023-12-18T00:00:00.000Z,132,7,Luka Doncic,0,49,57,46,19,60.2
0,0,3,2,0,3,1,0,0,13,0,1,2,3,0,0,1037948,2023-12-18T00:00:00.000Z,329,7,Markieff Morris,0,5,5,2,3,5.6
0,0,0,0,0,0,0,0,0,0,0,0,0,0,0,0,1037948,2023-12-18T00:00:00.000Z,257,7,Maxi Kleber,0,0,0,0,0,0
3,0,3,2,0,5,1,0,0,20,1,1,2,4,0,0,1037948,2023-12-18T00:00:00.000Z,56677859,7,Olivier-Maxence Prosper,0,6,9,5,7,11.3
0,0,3,0,0,4,1,0,0,7,1,0,2,4,0,0,1037948,2023-12-18T00:00:00.000Z,217,7,Richaun Holmes,0,6,6,2,4,6.8
0,0,0,0,0,0,0,0,0,7,0,2,0,0,0,0,1037948,2023-12-18T00:00:00.000Z,114,7,Seth Curry,0,0,0,0,0,0
1,0,2,9,2,12,3,0,0,22,0,2,8,2,0,2,1037948,2023-12-18T00:00:00.000Z,191,7,Tim Hardaway Jr.,0,10,11,9,3,9.9
1,0,2,3,2,8,3,0,0,23,2,1,8,4,0,2,1037948,2023-12-18T00:00:00.000Z,375,8,Michael Porter Jr.,0,12,13,9,5,12.3
0,0,0,0,0,0,0,0,0,0,0,0,0,0,0,0,1037949,2023-12-18T00:00:00.000Z,9051997,3,Armoni Brooks,0,0,0,0,0,0
3,1,2,7,5,23,12,3,3,37,2,1,32,4,1,3,1037949,2023-12-18T00:00:00.000Z,17896048,3,Cam Thomas,2,36,39,35,7,44.3
1,0,4,5,1,9,2,2,2,27,1,1,7,5,1,1,1037949,2023-12-18T00:00:00.000Z,666679,3,Cameron Johnson,1,12,13,8,6,16.5
0,1,2,0,0,5,3,1,0,17,3,1,6,5,0,1,1037949,2023-12-18T00:00:00.000Z,17896038,3,Day'Ron Sharpe,1,11,11,6,5,14
0,0,0,0,0,0,0,0,0,0,0,0,0,0,0,0,1037949,2023-12-18T00:00:00.000Z,421,3,Dennis Smith Jr.,0,0,0,0,0,0
3,0,0,5,2,7,2,0,0,21,2,4,6,2,1,0,1037949,2023-12-18T00:00:00.000Z,158,3,Dorian Finney-Smith,1,8,11,9,5,15.9
0,0,0,0,0,0,0,0,0,3,0,0,0,0,0,0,1037949,2023-12-18T00:00:00.000Z,174,3,Harry Giles III,0,0,0,0,0,0
0,0,0,1,1,1,1,2,2,8,0,2,5,0,0,1,1037949,2023-12-18T00:00:00.000Z,56677722,3,Jalen Wilson,0,5,5,5,0,4
5,0,1,8,3,16,4,5,2,35,0,3,13,1,0,2,1037949,2023-12-18T00:00:00.000Z,61,3,Mikal Bridges,0,14,19,18,6,19.7
0,3,5,0,0,5,4,4,3,26,2,3,11,7,0,3,1037949,2023-12-18T00:00:00.000Z,666508,3,Nicolas Claxton,3,18,18,11,7,25.4
0,0,0,0,0,0,0,0,0,0,0,0,0,0,0,0,1037949,2023-12-18T00:00:00.000Z,56677843,3,Noah Clowney,0,0,0,0,0,0
1,0,1,6,2,6,2,0,0,23,0,2,6,1,1,1,1037949,2023-12-18T00:00:00.000Z,351,3,Royce O'Neale,1,7,8,7,2,10.7
11,2,7,6,1,15,7,3,2,36,1,0,17,8,0,1,1037949,2023-12-18T00:00:00.000Z,130,3,Spencer Dinwiddie,2,25,36,28,19,48.1
1,1,3,1,1,3,2,0,0,7,0,0,5,3,0,0,1037949,2023-12-18T00:00:00.000Z,17896058,3,Trendon Watford,1,8,9,6,4,13.1
0,0,0,0,0,0,0,0,0,0,0,0,0,0,0,0,1037949,2023-12-18T00:00:00.000Z,56677842,29,Brice Sensabaugh,0,0,0,0,0,0
6,0,2,7,3,17,6,13,12,35,1,3,27,3,0,2,1037949,2023-12-18T00:00:00.000Z,413,29,Collin Sexton,0,30,36,33,9,37.6
0,1,2,4,3,9,4,0,0,20,1,2,11,3,0,4,1037949,2023-12-18T00:00:00.000Z,101,29,John Collins,1,14,14,11,3,13.6
0,0,0,0,0,0,0,0,0,0,0,0,0,0,0,0,1037949,2023-12-18T00:00:00.000Z,38017630,29,Johnny Juzang,0,0,0,0,0,0
0,0,0,0,0,0,0,0,0,0,0,0,0,0,0,0,1037949,2023-12-18T00:00:00.000Z,100,29,Jordan Clarkson,0,0,0,0,0,0
0,0,0,0,0,0,0,0,0,0,0,0,0,0,0,0,1037949,2023-12-18T00:00:00.000Z,17896023,29,Josh Christopher,0,0,0,0,0,0
3,0,4,1,0,2,1,0,0,20,1,4,2,5,1,0,1037949,2023-12-18T00:00:00.000Z,358,29,Kelly Olynyk,1,7,10,5,8,15.5
0,0,0,0,0,0,0,0,0,0,0,0,0,0,0,0,1037949,2023-12-18T00:00:00.000Z,56677834,29,Keyonte George,0,0,0,0,0,0
5,0,1,0,0,2,2,0,0,16,2,1,4,3,0,0,1037949,2023-12-18T00:00:00.000Z,139,29,Kris Dunn,0,7,12,9,8,15.1
4,1,9,5,1,14,6,7,7,29,1,1,20,10,0,2,1037949,2023-12-18T00:00:00.000Z,297,29,Lauri Markkanen,1,30,34,24,14,39
0,0,1,1,1,2,2,0,0,2,0,1,5,1,0,0,1037949,2023-12-18T00:00:00.000Z,666881,29,Luka Samanic,0,6,6,5,1,6.2
0,0,0,0,0,0,0,0,0,0,0,0,0,0,0,0,1037949,2023-12-18T00:00:00.000Z,19465584,29,Micah Potter,0,0,0,0,0,0
2,1,2,5,1,10,6,0,0,23,1,1,13,3,1,2,1037949,2023-12-18T00:00:00.000Z,38017620,29,Ochai Agbaji,2,16,18,15,5,23.6
0,0,0,0,0,0,0,0,0,0,0,0,0,0,0,0,1037949,2023-12-18T00:00:00.000Z,11891374,29,Omer Yurtseven,0,0,0,0,0,0
3,0,2,3,0,7,1,0,0,25,2,3,2,4,2,1,1037949,2023-12-18T00:00:00.000Z,38017739,29,Simone Fontecchio,2,6,9,5,7,16.3
6,0,3,7,5,19,11,0,0,31,0,2,27,3,2,1,1037949,2023-12-18T00:00:00.000Z,666650,29,Talen Horton-Tucker,2,30,36,33,9,44.6
1,0,2,1,0,1,0,0,0,7,0,1,0,2,0,1,1037949,2023-12-18T00:00:00.000Z,56677824,29,Taylor Hendricks,0,2,3,1,3,2.9
0,5,11,0,0,8,6,4,2,32,3,1,14,14,0,1,1037949,2023-12-18T00:00:00.000Z,38017705,29,Walker Kessler,5,28,28,14,14,44.8
1,0,3,3,2,5,3,0,0,12,4,1,8,7,2,1,1037950,2023-12-18T00:00:00.000Z,4197162,26,Aleksandar Vezenkov,2,15,16,9,8,22.9
0,0,0,0,0,0,0,0,0,0,0,0,0,0,0,0,1037950,2023-12-18T00:00:00.000Z,273,26,Alex Len,0,0,0,0,0,0
0,0,0,1,0,1,0,0,0,4,0,0,0,0,0,0,1037950,2023-12-18T00:00:00.000Z,17896030,26,Chris Duarte,0,0,0,0,0,0
0,0,0,0,0,3,1,0,0,4,1,1,2,1,0,0,1037950,2023-12-18T00:00:00.000Z,56677845,26,Colby Jones,0,3,3,2,1,3.2
1,0,1,0,0,2,1,0,0,4,0,0,2,1,0,0,1037950,2023-12-18T00:00:00.000Z,17553994,26,Davion Mitchell,0,3,4,3,2,4.7
6,1,5,7,2,19,10,12,8,33,0,2,30,5,3,1,1037950,2023-12-18T00:00:00.000Z,161,26,De'Aaron Fox,4,35,41,36,11,56
12,1,10,1,1,16,11,6,5,32,3,1,28,13,0,2,1037950,2023-12-18T00:00:00.000Z,406,26,Domantas Sabonis,1,41,53,40,25,62.6
0,0,0,4,2,11,8,1,1,33,0,1,19,0,1,1,1037950,2023-12-18T00:00:00.000Z,30,26,Harrison Barnes,1,19,19,19,0,21
0,0,0,0,0,0,0,0,0,0,0,0,0,0,0,0,1037950,2023-12-18T00:00:00.000Z,56677862,26,Jalen Slawson,0,0,0,0,0,0
0,0,0,0,0,0,0,0,0,0,0,0,0,0,0,0,1037950,2023-12-18T00:00:00.000Z,306,26,JaVale McGee,0,0,0,0,0,0
0,0,0,0,0,0,0,0,0,0,0,0,0,0,0,0,1037950,2023-12-18T00:00:00.000Z,17895990,26,Jordan Ford,0,0,0,0,0,0
0,0,1,0,0,1,1,0,0,5,0,3,2,1,0,0,1037950,2023-12-18T00:00:00.000Z,666925,26,Juan Toscano-Anderson,0,3,3,2,1,3.2
4,0,4,7,4,17,9,3,3,32,1,4,25,5,1,0,1037950,2023-12-18T00:00:00.000Z,38017688,26,Keegan Murray,1,30,34,29,9,40
2,1,1,5,1,5,1,0,0,15,0,4,3,1,1,0,1037950,2023-12-18T00:00:00.000Z,38017714,26,Keon Ellis,2,4,6,5,3,13.2
1,0,1,2,1,2,1,0,0,4,0,0,3,1,0,1,1037950,2023-12-18T00:00:00.000Z,17896044,26,Kessler Edwards,0,4,5,4,2,4.7
2,1,4,4,1,8,4,2,2,23,0,4,11,4,0,0,1037950,2023-12-18T00:00:00.000Z,221,26,Kevin Huerter,1,15,17,13,6,21.8
6,1,1,6,3,7,3,2,1,21,0,3,10,1,0,1,1037950,2023-12-18T00:00:00.000Z,324,26,Malik Monk,1,11,17,16,7,22.2
0,0,2,3,0,3,0,0,0,18,0,0,0,2,0,0,1037950,2023-12-18T00:00:00.000Z,290,26,Trey Lyles,0,2,2,0,2,2.4
3,0,3,2,0,5,2,0,0,20,1,1,4,4,0,1,1037950,2023-12-18T00:00:00.000Z,3547302,30,Anthony Gill,0,8,11,7,7,12.3
2,1,3,2,0,7,3,7,5,33,1,1,11,4,0,0,1037950,2023-12-18T00:00:00.000Z,56677844,30,Bilal Coulibaly,1,15,17,13,6,21.8
3,0,3,5,2,6,2,2,1,20,0,1,7,3,0,2,1037950,2023-12-18T00:00:00.000Z,17896045,30,Corey Kispert,0,10,13,10,6,13.1
1,3,3,0,0,5,3,2,2,25,2,4,8,5,0,0,1037950,2023-12-18T00:00:00.000Z,666577,30,Daniel Gafford,3,13,14,9,6,24.5
0,0,0,0,0,0,0,0,0,0,0,0,0,0,0,0,1037950,2023-12-18T00:00:00.000Z,167,30,Danilo Gallinari,0,0,0,0,0,0
0,0,0,0,0,0,0,0,0,0,0,0,0,0,0,0,1037950,2023-12-18T00:00:00.000Z,487,30,Delon Wright,0,0,0,0,0,0
3,0,5,3,1,8,3,4,2,23,0,5,9,5,1,2,1037950,2023-12-18T00:00:00.000Z,3547242,30,Deni Avdija,1,14,17,12,8,20.5
0,0,2,1,0,3,1,0,0,5,0,1,2,2,0,0,1037950,2023-12-18T00:00:00.000Z,17896106,30,Eugene Omoruyi,0,4,4,2,2,4.4
0,0,1,1,1,4,3,1,1,5,0,0,8,1,0,0,1037950,2023-12-18T00:00:00.000Z,18677954,30,Jared Butler,0,9,9,8,1,9.2
0,0,0,0,0,0,0,0,0,0,0,0,0,0,0,0,1037950,2023-12-18T00:00:00.000Z,38017687,30,Johnny Davis,0,0,0,0,0,0
2,0,0,13,8,18,10,0,0,29,0,4,28,0,0,1,1037950,2023-12-18T00:00:00.000Z,666848,30,Jordan Poole,0,28,30,30,2,30
1,1,8,7,3,16,8,8,8,29,0,1,27,8,0,3,1037950,2023-12-18T00:00:00.000Z,265,30,Kyle Kuzma,1,35,36,28,9,38.1
0,0,0,0,0,0,0,0,0,0,0,0,0,0,0,0,1037950,2023-12-18T00:00:00.000Z,414,30,Landry Shamet,0,0,0,0,0,0
2,1,5,1,1,3,2,6,6,23,1,3,11,6,1,2,1037950,2023-12-18T00:00:00.000Z,337,30,Mike Muscala,2,17,19,13,8,25.2
0,0,0,0,0,0,0,0,0,0,0,0,0,0,0,0,1037950,2023-12-18T00:00:00.000Z,38017704,30,Patrick Baldwin Jr.,0,0,0,0,0,0
0,0,0,0,0,0,0,0,0,0,0,0,0,0,0,0,1037950,2023-12-18T00:00:00.000Z,38017712,30,Ryan Rollins,0,0,0,0,0,0
9,0,1,2,2,10,7,0,0,28,0,0,16,1,1,0,1037950,2023-12-18T00:00:00.000Z,249,30,Tyus Jones,1,17,26,25,10,33.7
0,0,0,0,0,0,0,0,0,0,0,0,0,0,0,0,1037951,2023-12-18T00:00:00.000Z,56677867,14,Alex Fudge,0,0,0,0,0,0
2,2,12,1,1,22,14,3,3,35,2,2,32,14,1,2,1037951,2023-12-18T00:00:00.000Z,117,14,Anthony Davis,3,46,48,34,16,58.8
7,0,3,7,3,15,6,5,5,33,0,2,20,3,1,4,1037951,2023-12-18T00:00:00.000Z,17553995,14,Austin Reaves,1,23,30,27,10,33.1
1,0,1,4,0,9,2,0,0,27,1,5,4,2,3,0,1037951,2023-12-18T00:00:00.000Z,666860,14,Cameron Reddish,3,6,7,5,3,16.9
0,0,0,0,0,0,0,0,0,0,0,0,0,0,0,0,1037951,2023-12-18T00:00:00.000Z,486,14,Christian Wood,0,0,0,0,0,0
0,0,0,0,0,0,0,0,0,0,0,0,0,0,0,0,1037951,2023-12-18T00:00:00.000Z,56677738,14,Colin Castleton,0,0,0,0,0,0
4,0,3,6,3,10,3,0,0,28,0,1,9,3,1,0,1037951,2023-12-18T00:00:00.000Z,405,14,D'Angelo Russell,1,12,16,13,7,21.6
0,0,0,0,0,0,0,0,0,0,0,0,0,0,0,0,1037951,2023-12-18T00:00:00.000Z,56677868,14,D'Moi Hodge,0,0,0,0,0,0
0,0,0,0,0,0,0,0,0,0,0,0,0,0,0,0,1037951,2023-12-18T00:00:00.000Z,1603383,14,Gabe Vincent,0,0,0,0,0,0
0,0,0,0,0,0,0,0,0,0,0,0,0,0,0,0,1037951,2023-12-18T00:00:00.000Z,56677835,14,Jalen Hood-Schifino,0,0,0,0,0,0
1,0,0,0,0,0,0,0,0,14,2,3,0,2,0,1,1037951,2023-12-18T00:00:00.000Z,457,14,Jarred Vanderbilt,0,2,3,1,3,2.9
0,0,2,0,0,1,1,0,0,8,0,1,2,2,0,0,1037951,2023-12-18T00:00:00.000Z,666626,14,Jaxson Hayes,0,4,4,2,2,4.4
11,0,10,8,2,23,10,4,3,39,1,1,25,11,1,2,1037951,2023-12-18T00:00:00.000Z,237,14,LeBron James,1,36,47,36,22,55.7
0,0,0,0,0,0,0,0,0,0,0,0,0,0,0,0,1037951,2023-12-18T00:00:00.000Z,38017697,14,Max Christie,0,0,0,0,0,0
0,0,0,0,0,0,0,0,0,0,0,0,0,0,0,0,1037951,2023-12-18T00:00:00.000Z,56677836,14,Maxwell Lewis,0,0,0,0,0,0
0,0,0,2,1,6,3,1,1,17,2,1,8,2,2,0,1037951,2023-12-18T00:00:00.000Z,666609,14,Rui Hachimura,2,10,10,8,2,16.4
3,1,1,13,3,13,3,0,0,39,1,1,9,2,0,1,1037951,2023-12-18T00:00:00.000Z,383,14,Taurean Prince,1,11,14,12,5,17.9
0,0,0,0,0,0,0,0,0,0,0,0,0,0,0,0,1037951,2023-12-18T00:00:00.000Z,666474,20,Charles Brown,0,0,0,0,0,0
0,0,0,0,0,0,0,0,0,0,0,0,0,0,0,0,1037951,2023-12-18T00:00:00.000Z,666675,20,DaQuan Jeffries,0,0,0,0,0,0
3,1,1,4,2,5,3,0,0,19,0,1,8,1,0,1,1037951,2023-12-18T00:00:00.000Z,131,20,Donte DiVincenzo,1,9,12,11,4,15.7
0,0,0,0,0,0,0,0,0,0,0,0,0,0,0,0,1037951,2023-12-18T00:00:00.000Z,160,20,Evan Fournier,0,0,0,0,0,0
2,0,3,7,3,15,8,1,1,29,0,2,20,3,1,1,1037951,2023-12-18T00:00:00.000Z,3547269,20,Immanuel Quickley,1,23,25,22,5,28.6
2,2,10,0,0,4,3,6,3,39,7,3,9,17,2,1,1037951,2023-12-18T00:00:00.000Z,201,20,Isaiah Hartenstein,4,26,28,11,19,43.4
0,0,0,0,0,0,0,0,0,0,0,0,0,0,0,0,1037951,2023-12-18T00:00:00.000Z,56677795,20,Jacob Toppin,0,0,0,0,0,0
3,1,3,6,3,21,10,6,6,37,1,0,29,4,1,4,1037951,2023-12-18T00:00:00.000Z,73,20,Jalen Brunson,2,33,36,32,7,40.3
0,0,0,0,0,0,0,0,0,0,0,0,0,0,0,0,1037951,2023-12-18T00:00:00.000Z,59421201,20,Jaylen Martin,0,0,0,0,0,0
0,0,0,0,0,0,0,0,0,4,0,2,0,0,0,0,1037951,2023-12-18T00:00:00.000Z,17896063,20,Jericho Sims,0,0,0,0,0,0
2,1,5,3,0,6,2,2,2,22,0,1,6,5,0,4,1037951,2023-12-18T00:00:00.000Z,202,20,Josh Hart,1,11,13,8,7,14
3,0,13,4,1,22,12,2,2,43,1,3,27,14,0,2,1037951,2023-12-18T00:00:00.000Z,387,20,Julius Randle,0,41,44,30,17,46.3
0,0,0,0,0,0,0,0,0,0,0,0,0,0,0,0,1037951,2023-12-18T00:00:00.000Z,17896033,20,Miles McBride,0,0,0,0,0,0
0,0,0,0,0,0,0,0,0,0,0,0,0,0,0,0,1037951,2023-12-18T00:00:00.000Z,399,20,Mitchell Robinson,0,0,0,0,0,0
2,0,0,4,1,5,1,0,0,11,0,0,3,0,1,0,1037951,2023-12-18T00:00:00.000Z,17895858,20,Quentin Grimes,1,3,5,5,2,9
4,1,4,2,0,10,3,6,6,30,1,2,12,5,0,1,1037951,2023-12-18T00:00:00.000Z,666423,20,RJ Barrett,1,17,21,16,9,26
0,0,0,0,0,0,0,0,0,0,0,0,0,0,0,0,1037951,2023-12-18T00:00:00.000Z,19,20,Ryan Arcidiacono,0,0,0,0,0,0
0,0,2,0,0,0,0,0,0,6,1,2,0,3,0,1,1037951,2023-12-18T00:00:00.000Z,173,20,Taj Gibson,0,3,3,0,3,2.6
0,1,2,0,0,5,4,0,0,22,0,3,8,2,1,1,1037952,2023-12-19T00:00:00.000Z,48,15,Bismack Biyombo,2,10,10,8,2,15.4
0,0,0,0,0,0,0,0,0,0,0,0,0,0,0,0,1037952,2023-12-19T00:00:00.000Z,666505,15,Brandon Clarke,0,0,0,0,0,0
2,0,0,1,0,2,0,0,0,9,1,0,0,1,0,1,1037952,2023-12-19T00:00:00.000Z,38017729,15,David Roddy,0,1,3,2,3,3.2
0,0,0,0,0,0,0,0,0,0,0,0,0,0,0,0,1037952,2023-12-19T00:00:00.000Z,401,15,Derrick Rose,0,0,0,0,0,0
5,0,0,9,3,19,8,2,2,35,1,1,21,1,0,4,1037952,2023-12-19T00:00:00.000Z,3547287,15,Desmond Bane,0,22,27,26,6,25.7
0,0,0,0,0,0,0,0,0,0,0,0,0,0,0,0,1037952,2023-12-19T00:00:00.000Z,56677830,15,GG Jackson,0,0,0,0,0,0
8,1,3,5,0,24,12,12,10,35,3,2,34,6,2,5,1037952,2023-12-19T00:00:00.000Z,666786,15,Ja Morant,3,40,48,42,14,57.2
0,0,0,0,0,0,0,0,0,0,0,0,0,0,0,0,1037952,2023-12-19T00:00:00.000Z,48248287,15,Jacob Gilyard,0,0,0,0,0,0
0,0,0,0,0,0,0,0,0,0,0,0,0,0,0,0,1037952,2023-12-19T00:00:00.000Z,38017728,15,Jake LaRavia,0,0,0,0,0,0
0,3,5,3,1,10,6,15,11,29,1,4,24,6,0,2,1037952,2023-12-19T00:00:00.000Z,231,15,Jaren Jackson Jr.,3,30,30,24,6,38.2
0,0,7,2,0,2,0,0,0,22,1,3,0,8,0,1,1037952,2023-12-19T00:00:00.000Z,666703,15,John Konchar,0,8,8,0,8,8.6
0,0,0,0,0,0,0,0,0,0,0,0,0,0,0,0,1037952,2023-12-19T00:00:00.000Z,38017732,15,Kenneth Lofton Jr.,0,0,0,0,0,0
0,0,0,0,0,0,0,0,0,0,0,0,0,0,0,0,1037952,2023-12-19T00:00:00.000Z,254,15,Luke Kennard,0,0,0,0,0,0
0,0,0,0,0,0,0,0,0,0,0,0,0,0,0,0,1037952,2023-12-19T00:00:00.000Z,420,15,Marcus Smart,0,0,0,0,0,0
0,1,1,2,2,4,3,0,0,16,2,1,8,3,1,0,1037952,2023-12-19T00:00:00.000Z,17896067,15,Santi Aldama,2,11,11,8,3,17.6
0,0,0,0,0,0,0,0,0,0,0,0,0,0,0,0,1037952,2023-12-19T00:00:00.000Z,3,15,Steven Adams,0,0,0,0,0,0
3,1,6,5,3,6,3,0,0,34,1,1,9,7,0,1,1037952,2023-12-19T00:00:00.000Z,38017731,15,Vince Williams Jr.,1,16,19,12,10,23.9
1,0,4,1,1,5,3,0,0,20,2,3,7,6,1,1,1037952,2023-12-19T00:00:00.000Z,3547285,15,Xavier Tillman,1,13,14,8,7,17.7
0,0,1,3,0,5,2,0,0,18,1,1,4,2,0,1,1037952,2023-12-19T00:00:00.000Z,17896027,15,Ziaire Williams,0,6,6,4,2,5.4
6,0,3,1,1,18,11,12,11,37,1,4,34,4,2,2,1037952,2023-12-19T00:00:00.000Z,227,19,Brandon Ingram,2,38,44,40,10,51.8
6,1,3,9,6,11,6,0,0,41,0,2,18,3,1,1,1037952,2023-12-19T00:00:00.000Z,303,19,CJ McCollum,2,21,27,24,9,35.6
1,1,2,0,0,3,1,2,2,13,4,1,4,6,0,1,1037952,2023-12-19T00:00:00.000Z,491,19,Cody Zeller,1,10,11,5,7,14.7
0,0,0,0,0,0,0,0,0,0,0,0,0,0,0,0,1037952,2023-12-19T00:00:00.000Z,38017726,19,Dereon Seabron,0,0,0,0,0,0
2,0,1,2,1,2,1,0,0,14,0,1,3,1,0,0,1037952,2023-12-19T00:00:00.000Z,38017677,19,Dyson Daniels,0,4,6,5,3,7.2
2,0,1,5,1,10,3,0,0,30,0,3,7,1,0,1,1037952,2023-12-19T00:00:00.000Z,17896024,19,Herbert Jones,0,8,10,9,3,10.2
0,0,0,0,0,0,0,0,0,0,0,0,0,0,0,0,1037952,2023-12-19T00:00:00.000Z,17896021,19,Jeremiah Robinson-Earl,0,0,0,0,0,0
1,1,10,1,1,12,9,3,3,33,4,5,22,14,1,2,1037952,2023-12-19T00:00:00.000Z,455,19,Jonas Valanciunas,2,36,37,23,15,44.3
0,0,0,0,0,0,0,0,0,0,0,0,0,0,0,0,1037952,2023-12-19T00:00:00.000Z,56677837,19,Jordan Hawkins,0,0,0,0,0,0
0,0,1,2,0,4,1,0,0,9,1,1,2,2,0,0,1037952,2023-12-19T00:00:00.000Z,17896097,19,Jose Alvarado,0,4,4,2,2,4.4
0,0,0,0,0,0,0,0,0,0,0,0,0,0,0,0,1037952,2023-12-19T00:00:00.000Z,17896017,19,Matt Ryan,0,0,0,0,0,0
1,0,1,4,1,7,1,0,0,17,1,0,3,2,0,1,1037952,2023-12-19T00:00:00.000Z,3547293,19,Naji Marshall,0,5,6,4,3,5.9
0,0,3,1,0,6,2,3,3,21,0,2,7,3,0,1,1037952,2023-12-19T00:00:00.000Z,18677986,19,Trey Murphy III,0,10,10,7,3,9.6
0,0,0,1,0,1,0,0,0,2,0,0,0,0,0,0,1037953,2023-12-19T00:00:00.000Z,38017733,17,A.J. Green,0,0,0,0,0,0
2,0,1,3,2,4,2,2,1,15,2,2,7,3,1,1,1037953,2023-12-19T00:00:00.000Z,56677852,17,Andre Jackson Jr.,1,10,12,9,5,15.6
2,0,9,6,3,16,10,0,0,26,1,3,23,10,2,0,1037953,2023-12-19T00:00:00.000Z,377,17,Bobby Portis,2,33,35,25,12,44
1,6,0,5,0,14,6,2,2,32,5,3,14,5,0,0,1037953,2023-12-19T00:00:00.000Z,283,17,Brook Lopez,6,19,20,15,6,39.5
0,0,0,2,0,6,2,3,3,13,0,1,7,0,0,0,1037953,2023-12-19T00:00:00.000Z,368,17,Cameron Payne,0,7,7,7,0,7
0,0,0,0,0,0,0,0,0,0,0,0,0,0,0,0,1037953,2023-12-19T00:00:00.000Z,56677854,17,Chris Livingston,0,0,0,0,0,0
4,0,3,12,7,22,14,5,5,35,0,0,40,3,3,1,1037953,2023-12-19T00:00:00.000Z,278,17,Damian Lillard,3,43,47,44,7,57.6
16,1,12,2,0,12,4,6,3,34,2,1,11,14,2,3,1037953,2023-12-19T00:00:00.000Z,15,17,Giannis Antetokounmpo,3,25,41,27,30,57.8
0,0,0,0,0,0,0,0,0,0,0,0,0,0,0,0,1037953,2023-12-19T00:00:00.000Z,112,17,Jae Crowder,0,0,0,0,0,0
4,0,3,6,3,15,7,0,0,28,0,2,17,3,1,1,1037953,2023-12-19T00:00:00.000Z,315,17,Khris Middleton,1,20,24,21,7,28.6
0,0,0,0,0,0,0,0,0,0,0,0,0,0,0,0,1037953,2023-12-19T00:00:00.000Z,666960,17,Lindell Wigginton,0,0,0,0,0,0
2,0,3,5,1,7,3,0,0,28,1,1,7,4,1,0,1037953,2023-12-19T00:00:00.000Z,38,17,Malik Beasley,1,11,13,9,6,17.8
0,0,1,0,0,0,0,0,0,6,0,0,0,1,0,0,1037953,2023-12-19T00:00:00.000Z,38017676,17,MarJon Beauchamp,0,1,1,0,1,1.2
0,0,0,0,0,0,0,0,0,0,0,0,0,0,0,0,1037953,2023-12-19T00:00:00.000Z,666453,17,Marques Bolden,0,0,0,0,0,0
2,0,3,6,1,8,1,0,0,18,0,2,3,3,1,0,1037953,2023-12-19T00:00:00.000Z,105,17,Pat Connaughton,1,6,8,5,5,12.6
0,0,1,1,1,1,1,0,0,2,0,0,3,1,0,0,1037953,2023-12-19T00:00:00.000Z,284,17,Robin Lopez,0,4,4,3,1,4.2
1,0,0,0,0,0,0,0,0,1,0,0,0,0,0,0,1037953,2023-12-19T00:00:00.000Z,2148,17,Thanasis Antetokounmpo,0,0,1,1,1,1.5
0,0,0,0,0,0,0,0,0,0,0,0,0,0,0,0,1037953,2023-12-19T00:00:00.000Z,38017691,17,TyTy Washington Jr.,0,0,0,0,0,0
0,0,0,0,0,0,0,0,0,0,0,0,0,0,0,0,1037953,2023-12-19T00:00:00.000Z,38017693,27,Blake Wesley,0,0,0,0,0,0
1,0,2,2,0,6,3,4,4,19,0,1,10,2,0,0,1037953,2023-12-19T00:00:00.000Z,359,27,Cedi Osman,0,12,13,11,3,13.9
0,0,0,0,0,0,0,0,0,0,0,0,0,0,0,0,1037953,2023-12-19T00:00:00.000Z,17895854,27,Charles Bassey,0,0,0,0,0,0
0,0,0,0,0,0,0,0,0,0,0,0,0,0,0,0,1037953,2023-12-19T00:00:00.000Z,56677865,27,Charles Bediako,0,0,0,0,0,0
0,0,0,0,0,0,0,0,0,0,0,0,0,0,0,0,1037953,2023-12-19T00:00:00.000Z,17896049,27,David Duke Jr.,0,0,0,0,0,0
2,0,3,5,2,17,7,1,1,33,0,0,17,3,0,2,1037953,2023-12-19T00:00:00.000Z,3547246,27,Devin Vassell,0,20,22,19,5,21.6
0,0,0,0,0,0,0,0,0,0,0,0,0,0,0,0,1037953,2023-12-19T00:00:00.000Z,180,27,Devonte' Graham,0,0,0,0,0,0
0,0,3,3,0,3,0,2,2,10,0,2,2,3,1,0,1037953,2023-12-19T00:00:00.000Z,38017730,27,Dominick Barlow,1,5,5,2,3,8.6
2,0,2,1,0,2,0,0,0,13,0,3,0,2,0,0,1037953,2023-12-19T00:00:00.000Z,305,27,Doug McDermott,0,2,4,2,4,5.4
8,0,8,2,0,11,4,2,1,33,3,3,9,11,0,0,1037953,2023-12-19T00:00:00.000Z,38017699,27,Jeremy Sochan,0,20,28,17,19,34.2
0,0,0,0,0,1,1,0,0,2,0,0,2,0,0,0,1037953,2023-12-19T00:00:00.000Z,38017649,27,Julian Champagnie,0,2,2,2,0,2
1,0,10,1,0,13,9,12,10,35,2,2,28,12,0,5,1037953,2023-12-19T00:00:00.000Z,666682,27,Keldon Johnson,0,40,41,29,13,38.9
3,0,2,4,2,11,5,0,0,27,0,1,12,2,0,1,1037953,2023-12-19T00:00:00.000Z,38017692,27,Malaki Branham,0,14,17,15,5,17.9
3,2,7,4,1,5,1,0,0,15,1,1,3,8,1,2,1037953,2023-12-19T00:00:00.000Z,17896059,27,Sandro Mamukelashvili,3,11,14,6,11,24.1
0,0,0,0,0,0,0,0,0,0,0,0,0,0,0,0,1037953,2023-12-19T00:00:00.000Z,56677817,27,Sidy Cissoko,0,0,0,0,0,0
5,0,1,1,0,11,7,0,0,24,0,1,14,1,1,2,1037953,2023-12-19T00:00:00.000Z,3547274,27,Tre Jones,1,15,20,19,6,23.7
0,0,0,0,0,0,0,0,0,0,0,0,0,0,0,0,1037953,2023-12-19T00:00:00.000Z,56677822,27,Victor Wembanyama,0,0,0,0,0,0
2,2,6,7,4,16,9,0,0,29,2,3,22,8,1,4,1037953,2023-12-19T00:00:00.000Z,102,27,Zach Collins,3,30,32,24,10,39.6
6,1,10,10,3,14,4,2,2,38,2,1,13,12,0,2,1037954,2023-12-19T00:00:00.000Z,219,2,Al Horford,1,25,31,19,18,37.4
7,1,5,4,1,22,10,8,7,41,3,2,28,8,0,4,1037954,2023-12-19T00:00:00.000Z,70,2,Jaylen Brown,1,36,43,35,15,47.1
7,0,5,9,2,17,5,3,3,41,3,0,15,8,2,0,1037954,2023-12-19T00:00:00.000Z,434,2,Jayson Tatum,2,23,30,22,15,41.1
1,0,4,3,1,4,2,0,0,16,1,2,5,5,1,1,1037954,2023-12-19T00:00:00.000Z,56677858,10,Brandin Podziemski,1,10,11,6,6,14.5
12,0,6,5,1,12,4,0,0,35,1,2,9,7,0,0,1037954,2023-12-19T00:00:00.000Z,367,10,Chris Paul,0,16,28,21,19,35.4
0,0,0,0,0,0,0,0,0,0,0,0,0,0,0,0,1037954,2023-12-19T00:00:00.000Z,185,10,Draymond Green,0,0,0,0,0,0
0,0,0,0,0,0,0,0,0,0,0,0,0,0,0,0,1037954,2023-12-19T00:00:00.000Z,57875092,10,Gui Santos,0,0,0,0,0,0
0,0,0,0,0,0,0,0,0,0,0,0,0,0,0,0,1037954,2023-12-19T00:00:00.000Z,398,10,Jerome Robinson,0,0,0,0,0,0
2,0,3,4,1,13,8,2,0,34,4,0,17,7,2,1,1037954,2023-12-19T00:00:00.000Z,17553979,10,Jonathan Kuminga,2,24,26,19,9,33.4
2,0,5,0,0,2,1,1,1,14,1,0,3,6,0,1,1037954,2023-12-19T00:00:00.000Z,282,10,Kevon Looney,0,9,11,5,8,12.2
4,1,4,15,6,21,9,0,0,40,0,0,24,4,1,1,1037954,2023-12-19T00:00:00.000Z,443,10,Klay Thompson,2,28,32,28,8,39.8
0,0,0,0,0,0,0,0,0,0,0,0,0,0,0,0,1037954,2023-12-19T00:00:00.000Z,45658838,10,Lester Quinones,0,0,0,0,0,0
6,0,3,11,6,21,11,5,5,38,0,5,33,3,0,4,1037954,2023-12-19T00:00:00.000Z,115,10,Stephen Curry,0,36,42,39,9,41.6
0,0,0,0,0,0,0,0,0,0,0,0,0,0,0,0,1037955,2023-12-19T00:00:00.000Z,666451,24,Bol Bol,0,0,0,0,0,0
7,0,3,5,1,25,11,4,3,38,0,3,26,3,0,1,1037955,2023-12-19T00:00:00.000Z,57,24,Devin Booker,0,29,36,33,10,39.1
4,0,2,4,1,7,1,2,2,29,1,1,5,3,2,0,1037955,2023-12-19T00:00:00.000Z,178,24,Eric Gordon,2,8,12,9,7,20.6
0,0,7,5,1,10,5,1,0,33,2,3,11,9,2,0,1037955,2023-12-19T00:00:00.000Z,8,24,Grayson Allen,2,20,20,11,9,27.8
2,1,3,2,0,7,1,0,0,20,3,2,2,6,0,1,1037955,2023-12-19T00:00:00.000Z,18678058,24,Jordan Goodwin,1,8,10,4,8,14.2
0,0,0,0,0,0,0,0,0,0,0,0,0,0,0,0,1037955,2023-12-19T00:00:00.000Z,32,24,Keita Bates-Diop,0,0,0,0,0,0
7,0,3,7,2,23,9,5,3,38,0,2,23,3,1,1,1037955,2023-12-19T00:00:00.000Z,419,25,Anfernee Simons,1,26,33,30,10,39.1
3,0,11,0,0,18,6,4,4,40,4,3,16,15,0,3,1037955,2023-12-19T00:00:00.000Z,22,25,Deandre Ayton,0,31,34,19,18,35.5
4,2,1,4,3,15,8,3,3,36,0,2,22,1,0,2,1037955,2023-12-19T00:00:00.000Z,182,25,Jerami Grant,2,23,27,26,5,33.2
4,0,4,9,4,10,5,0,0,32,0,0,14,4,0,1,1037955,2023-12-19T00:00:00.000Z,65,25,Malcolm Brogdon,0,18,22,18,8,23.8
0,0,0,0,0,0,0,0,0,0,0,0,0,0,0,0,1037955,2023-12-19T00:00:00.000Z,666476,25,Moses Brown,0,0,0,0,0,0
0,0,1,0,0,1,0,0,0,8,0,2,0,1,0,0,1037955,2023-12-19T00:00:00.000Z,38017690,25,Shaedon Sharpe,0,1,1,0,1,1.2
0,1,6,1,1,4,2,0,0,21,3,3,5,9,3,2,1037955,2023-12-19T00:00:00.000Z,56677850,25,Toumani Camara,4,14,14,5,9,25.8
6,3,4,2,0,7,2,2,2,25,3,0,6,7,0,0,1037956,2023-12-20T00:00:00.000Z,56677872,6,Craig Porter,3,13,19,12,13,32.4
0,0,0,0,0,0,0,0,0,0,0,0,0,0,0,0,1037956,2023-12-20T00:00:00.000Z,248,6,Damian Jones,0,0,0,0,0,0
2,0,5,3,1,3,1,0,0,30,2,4,3,7,0,0,1037956,2023-12-20T00:00:00.000Z,666940,6,Dean Wade,0,10,12,5,9,14.4
0,0,0,0,0,0,0,0,0,0,0,0,0,0,0,0,1037956,2023-12-20T00:00:00.000Z,56677847,6,Emoni Bates,0,0,0,0,0,0
3,0,5,0,0,13,8,2,1,29,3,1,17,8,2,2,1037956,2023-12-20T00:00:00.000Z,9,6,Jarrett Allen,2,25,28,20,11,35.1
4,0,3,12,6,15,6,0,0,33,1,3,18,4,0,5,1037956,2023-12-20T00:00:00.000Z,666908,6,Max Strus,0,22,26,22,8,23.8
0,0,0,0,0,0,0,0,0,0,0,0,0,0,0,0,1037956,2023-12-20T00:00:00.000Z,56677842,29,Brice Sensabaugh,0,0,0,0,0,0
2,1,3,6,3,17,7,4,3,34,0,5,20,3,0,2,1037956,2023-12-20T00:00:00.000Z,413,29,Collin Sexton,1,23,25,22,5,27.6
0,1,5,4,2,8,5,4,4,22,0,1,16,5,1,2,1037956,2023-12-20T00:00:00.000Z,101,29,John Collins,2,21,21,16,5,26
0,0,0,0,0,0,0,0,0,0,0,0,0,0,0,0,1037956,2023-12-20T00:00:00.000Z,38017630,29,Johnny Juzang,0,0,0,0,0,0
0,0,0,0,0,0,0,0,0,0,0,0,0,0,0,0,1037956,2023-12-20T00:00:00.000Z,100,29,Jordan Clarkson,0,0,0,0,0,0
0,0,0,0,0,0,0,0,0,0,0,0,0,0,0,0,1037956,2023-12-20T00:00:00.000Z,17896023,29,Josh Christopher,0,0,0,0,0,0
6,2,1,1,0,3,2,2,1,20,1,0,5,2,1,3,1037956,2023-12-20T00:00:00.000Z,358,29,Kelly Olynyk,3,7,13,11,8,22.4
0,0,0,0,0,0,0,0,0,0,0,0,0,0,0,0,1037956,2023-12-20T00:00:00.000Z,56677834,29,Keyonte George,0,0,0,0,0,0
1,0,2,2,2,3,3,0,0,16,0,4,8,2,0,4,1037956,2023-12-20T00:00:00.000Z,139,29,Kris Dunn,0,10,11,9,3,7.9
0,0,0,0,0,0,0,0,0,0,0,0,0,0,0,0,1037956,2023-12-20T00:00:00.000Z,666881,29,Luka Samanic,0,0,0,0,0,0
0,0,0,0,0,0,0,0,0,0,0,0,0,0,0,0,1037956,2023-12-20T00:00:00.000Z,19465584,29,Micah Potter,0,0,0,0,0,0
1,1,2,1,1,1,1,0,0,16,1,1,3,3,0,0,1037956,2023-12-20T00:00:00.000Z,38017620,29,Ochai Agbaji,1,6,7,4,4,11.1
0,0,0,0,0,0,0,0,0,0,0,0,0,0,0,0,1037956,2023-12-20T00:00:00.000Z,11891374,29,Omer Yurtseven,0,0,0,0,0,0
2,0,6,5,2,7,3,2,1,36,1,3,9,7,0,2,1037956,2023-12-20T00:00:00.000Z,38017739,29,Simone Fontecchio,0,16,18,11,9,18.4
0,0,0,0,0,0,0,0,0,0,0,0,0,0,0,0,1037956,2023-12-20T00:00:00.000Z,56677824,29,Taylor Hendricks,0,0,0,0,0,0
0,1,4,1,0,8,5,0,0,30,1,2,10,5,2,2,1037956,2023-12-20T00:00:00.000Z,38017705,29,Walker Kessler,3,15,15,10,5,23
0,0,0,0,0,0,0,0,0,0,0,0,0,0,0,0,1037957,2023-12-20T00:00:00.000Z,56677848,4,Amari Bailey,0,0,0,0,0,0
3,0,4,4,2,17,9,2,1,33,2,4,21,6,1,1,1037957,2023-12-20T00:00:00.000Z,56677823,4,Brandon Miller,1,27,30,24,9,34.7
0,0,0,0,0,0,0,0,0,0,0,0,0,0,0,0,1037957,2023-12-20T00:00:00.000Z,666748,4,Cody Martin,0,0,0,0,0,0
0,0,0,0,0,0,0,0,0,0,0,0,0,0,0,0,1037957,2023-12-20T00:00:00.000Z,347,4,Frank Ntilikina,0,0,0,0,0,0
3,0,1,1,1,5,3,6,4,24,0,0,11,1,0,2,1037957,2023-12-20T00:00:00.000Z,204,4,Gordon Hayward,0,12,15,14,4,14.7
0,0,0,0,0,0,0,2,2,6,1,2,2,1,0,0,1037957,2023-12-20T00:00:00.000Z,18678001,4,JT Thor,0,3,3,2,1,3.2
0,0,0,0,0,0,0,0,0,0,0,0,0,0,0,0,1037957,2023-12-20T00:00:00.000Z,3547239,4,LaMelo Ball,0,0,0,0,0,0
0,0,0,0,0,0,0,0,0,4,0,0,0,0,0,0,1037957,2023-12-20T00:00:00.000Z,56677866,4,Leaky Black,0,0,0,0,0,0
0,0,0,0,0,0,0,0,0,0,0,0,0,0,0,0,1037957,2023-12-20T00:00:00.000Z,38017698,4,Mark Williams,0,0,0,0,0,0
3,0,3,2,0,17,8,4,3,37,1,2,19,4,3,0,1037957,2023-12-20T00:00:00.000Z,62,4,Miles Bridges,3,23,26,22,7,37.3
0,0,2,0,0,4,2,0,0,19,6,3,4,8,0,0,1037957,2023-12-20T00:00:00.000Z,3547282,4,Nick Richards,0,12,12,4,8,13.6
0,0,0,3,0,6,3,0,0,6,0,0,6,0,0,1,1037957,2023-12-20T00:00:00.000Z,56677846,4,Nick Smith Jr.,0,6,6,6,0,5
0,0,1,7,2,10,4,2,2,27,3,1,12,4,0,1,1037957,2023-12-20T00:00:00.000Z,666950,4,P.J. Washington,0,16,16,12,4,15.8
7,0,7,10,2,26,10,3,3,34,2,0,25,9,1,1,1037957,2023-12-20T00:00:00.000Z,403,4,Terry Rozier,1,34,41,32,16,48.3
1,0,2,4,4,6,6,3,3,23,0,1,19,2,1,1,1037957,2023-12-20T00:00:00.000Z,3547250,12,Aaron Nesmith,1,21,22,20,3,24.9
0,0,0,0,0,0,0,0,0,0,0,0,0,0,0,0,1037957,2023-12-20T00:00:00.000Z,38017507,12,Andrew Nembhard,0,0,0,0,0,0
0,0,0,0,0,0,0,0,0,0,0,0,0,0,0,0,1037957,2023-12-20T00:00:00.000Z,56677861,12,Ben Sheppard,0,0,0,0,0,0
1,0,2,6,4,7,5,0,0,29,0,2,14,2,1,2,1037957,2023-12-20T00:00:00.000Z,38017686,12,Bennedict Mathurin,1,16,17,15,3,18.9
6,0,5,1,0,6,3,0,0,28,0,3,6,5,0,0,1037957,2023-12-20T00:00:00.000Z,69,12,Bruce Brown,0,11,17,12,11,21
3,3,2,8,4,13,8,5,5,26,2,2,25,4,1,2,1037957,2023-12-20T00:00:00.000Z,210,12,Buddy Hield,4,29,32,28,7,44.3
1,2,2,1,0,7,4,3,2,15,1,3,10,3,1,1,1037957,2023-12-20T00:00:00.000Z,17896035,12,Isaiah Jackson,3,13,14,11,4,23.1
0,0,0,0,0,0,0,0,0,0,0,0,0,0,0,0,1037957,2023-12-20T00:00:00.000Z,56677794,12,Isaiah Wong,0,0,0,0,0,0
0,0,2,2,2,4,4,0,0,8,2,2,10,4,0,0,1037957,2023-12-20T00:00:00.000Z,3547264,12,Jalen Smith,0,14,14,10,4,14.8
2,0,0,0,0,1,1,0,0,6,0,0,2,0,0,0,1037957,2023-12-20T00:00:00.000Z,242,12,James Johnson,0,2,4,4,2,5
0,0,0,0,0,0,0,0,0,0,0,0,0,0,0,0,1037957,2023-12-20T00:00:00.000Z,56677832,12,Jarace Walker,0,0,0,0,0,0
1,0,0,1,0,5,2,2,2,9,0,3,6,0,0,0,1037957,2023-12-20T00:00:00.000Z,3547207,12,Jordan Nwora,0,6,7,7,1,7.5
0,0,0,0,0,0,0,0,0,0,0,0,0,0,0,0,1037957,2023-12-20T00:00:00.000Z,38017701,12,Kendall Brown,0,0,0,0,0,0
0,2,5,4,1,9,5,7,7,25,1,2,18,6,0,1,1037957,2023-12-20T00:00:00.000Z,452,12,Myles Turner,2,24,24,18,6,30.2
0,0,4,3,0,5,2,2,2,23,0,1,6,4,0,1,1037957,2023-12-20T00:00:00.000Z,3547243,12,Obi Toppin,0,10,10,6,4,9.8
0,0,0,0,0,0,0,0,0,0,0,0,0,0,0,0,1037957,2023-12-20T00:00:00.000Z,56677778,12,Oscar Tshiebwe,0,0,0,0,0,0
9,0,4,0,0,3,3,4,3,20,1,1,9,5,1,1,1037957,2023-12-20T00:00:00.000Z,304,12,T.J. McConnell,1,14,23,18,14,30.5
13,1,2,9,3,14,6,4,4,28,1,0,19,3,1,4,1037957,2023-12-20T00:00:00.000Z,3547245,12,Tyrese Haliburton,2,22,35,32,16,44.1
0,0,0,0,0,0,0,0,0,0,0,0,0,0,0,0,1037958,2023-12-20T00:00:00.000Z,38017736,16,Cole Swider,0,0,0,0,0,0
0,0,0,0,0,0,0,0,0,0,0,0,0,0,0,0,1037958,2023-12-20T00:00:00.000Z,19465585,16,Dru Smith,0,0,0,0,0,0
6,0,3,1,1,5,4,3,3,23,0,3,12,3,0,1,1037958,2023-12-20T00:00:00.000Z,397,16,Duncan Robinson,0,15,21,18,9,23.6
2,0,2,9,4,12,5,2,1,30,4,3,15,6,2,1,1037958,2023-12-20T00:00:00.000Z,3092,16,Haywood Highsmith,2,21,23,17,8,30.2
0,0,0,0,0,0,0,0,0,0,0,0,0,0,0,0,1037958,2023-12-20T00:00:00.000Z,38017734,16,Jamal Cain,0,0,0,0,0,0
0,0,0,0,0,0,0,0,0,0,0,0,0,0,0,0,1037958,2023-12-20T00:00:00.000Z,79,16,Jimmy Butler,0,0,0,0,0,0
4,1,2,8,4,12,4,0,0,34,0,1,12,2,1,0,1037958,2023-12-20T00:00:00.000Z,391,16,Josh Richardson,2,14,18,16,6,26.4
0,0,0,0,0,0,0,0,0,0,0,0,0,0,0,0,1037958,2023-12-20T00:00:00.000Z,285,16,Kevin Love,0,0,0,0,0,0
0,0,0,0,0,0,0,0,0,0,0,0,0,0,0,0,1037958,2023-12-20T00:00:00.000Z,38017696,16,Nikola Jovic,0,0,0,0,0,0
0,0,0,0,0,0,0,0,0,1,0,0,0,0,0,0,1037958,2023-12-20T00:00:00.000Z,39398582,16,Orlando Robinson,0,0,0,0,0,0
0,0,0,0,0,0,0,0,0,0,0,0,0,0,0,0,1037958,2023-12-20T00:00:00.000Z,3547257,16,R.J. Hampton,0,0,0,0,0,0
1,0,2,0,0,7,5,2,2,17,3,1,12,5,0,2,1037958,2023-12-20T00:00:00.000Z,74,16,Thomas Bryant,0,17,18,13,6,17.5
1,0,2,2,1,3,2,0,0,5,0,1,5,2,1,0,1037958,2023-12-20T00:00:00.000Z,666818,22,Chuma Okeke,1,7,8,6,3,11.9
5,1,6,4,0,14,5,6,5,32,0,1,15,6,2,0,1037958,2023-12-20T00:00:00.000Z,17896026,22,Franz Wagner,3,21,26,20,11,38.7
0,0,0,0,0,0,0,0,0,0,0,0,0,0,0,0,1037958,2023-12-20T00:00:00.000Z,56677839,22,Jett Howard,0,0,0,0,0,0
0,0,0,0,0,0,0,0,0,0,0,0,0,0,0,0,1037958,2023-12-20T00:00:00.000Z,226,22,Joe Ingles,0,0,0,0,0,0
1,0,3,2,1,7,4,0,0,12,1,3,9,4,1,1,1037958,2023-12-20T00:00:00.000Z,229,22,Jonathan Isaac,1,13,14,10,5,17.3
0,0,0,0,0,0,0,0,0,0,0,0,0,0,0,0,1037958,2023-12-20T00:00:00.000Z,38017607,22,Kevon Harris,0,0,0,0,0,0
0,0,0,0,0,0,0,0,0,0,0,0,0,0,0,0,1037958,2023-12-20T00:00:00.000Z,165,22,Markelle Fultz,0,0,0,0,0,0
1,0,2,0,0,8,5,1,1,18,5,5,11,7,0,2,1037958,2023-12-20T00:00:00.000Z,462,22,Moritz Wagner,0,18,19,12,8,18.9
0,0,0,0,0,0,0,0,0,0,0,0,0,0,0,0,1037958,2023-12-20T00:00:00.000Z,17553983,22,Trevelin Queen,0,0,0,0,0,0
5,0,6,6,2,20,9,8,7,36,1,2,27,7,0,1,1037959,2023-12-20T00:00:00.000Z,3547238,18,Anthony Edwards,0,34,39,32,12,41.9
0,0,0,0,0,0,0,0,0,0,0,0,0,0,0,0,1037959,2023-12-20T00:00:00.000Z,17895968,18,Daishen Nix,0,0,0,0,0,0
0,0,0,0,0,0,0,0,0,0,0,0,0,0,0,0,1037959,2023-12-20T00:00:00.000Z,56677851,18,Jaylen Clark,0,0,0,0,0,0
1,0,0,0,0,0,0,0,0,2,0,0,0,0,0,0,1037959,2023-12-20T00:00:00.000Z,666767,18,Jordan McLaughlin,0,0,1,1,1,1.5
0,0,0,0,0,0,0,0,0,0,0,0,0,0,0,0,1037959,2023-12-20T00:00:00.000Z,38017715,18,Josh Minott,0,0,0,0,0,0
2,0,10,2,1,14,9,5,4,38,3,4,23,13,0,4,1037959,2023-12-20T00:00:00.000Z,447,18,Karl-Anthony Towns,0,36,38,25,15,37.6
1,0,0,0,0,5,1,0,0,13,0,0,2,0,0,2,1037959,2023-12-20T00:00:00.000Z,12,18,Kyle Anderson,0,2,3,3,1,1.5
0,0,0,0,0,0,0,0,0,0,0,0,0,0,0,0,1037959,2023-12-20T00:00:00.000Z,56677782,18,Leonard Miller,0,0,0,0,0,0
1,0,1,1,0,1,0,0,0,2,0,2,0,1,0,0,1037959,2023-12-20T00:00:00.000Z,17896056,18,Luka Garza,0,1,2,1,2,2.7
4,0,0,4,1,7,3,2,2,26,0,1,9,0,0,2,1037959,2023-12-20T00:00:00.000Z,104,18,Mike Conley,0,9,13,13,4,13
1,1,1,6,2,9,4,0,0,20,1,3,10,2,0,4,1037959,2023-12-20T00:00:00.000Z,667378,18,Naz Reid,1,12,13,11,3,12.9
2,1,2,1,0,3,2,0,0,16,0,1,4,2,0,0,1037959,2023-12-20T00:00:00.000Z,666400,18,Nickeil Alexander-Walker,1,6,8,6,4,12.4
1,0,7,0,0,4,3,2,2,24,2,4,8,9,2,0,1037959,2023-12-20T00:00:00.000Z,176,18,Rudy Gobert,2,17,18,9,10,26.3
3,0,0,0,0,2,0,2,2,13,0,2,2,0,0,1,1037959,2023-12-20T00:00:00.000Z,320,18,Shake Milton,0,2,5,5,3,5.5
1,0,1,2,1,4,2,0,0,10,1,0,5,2,0,3,1037959,2023-12-20T00:00:00.000Z,68,18,Troy Brown Jr.,0,7,8,6,3,5.9
0,0,0,0,0,1,1,0,0,2,0,0,2,0,1,1,1037959,2023-12-20T00:00:00.000Z,38017700,18,Wendell Moore Jr.,1,2,2,2,0,4
0,0,0,0,0,1,0,0,0,2,0,0,0,0,0,0,1037959,2023-12-20T00:00:00.000Z,260,23,Furkan Korkmaz,0,0,0,0,0,0
1,0,0,0,0,0,0,0,0,2,0,0,0,0,0,0,1037959,2023-12-20T00:00:00.000Z,17896025,23,Jaden Springer,0,0,1,1,1,1.5
0,0,0,0,0,1,1,2,1,7,0,1,3,0,0,0,1037959,2023-12-20T00:00:00.000Z,3547294,23,Kenyon Martin Jr.,0,3,3,3,0,3
0,0,1,2,1,4,2,0,0,25,0,2,5,1,1,0,1037959,2023-12-20T00:00:00.000Z,328,23,Marcus Morris,1,6,6,5,1,9.2
0,0,0,0,0,0,0,0,0,2,0,0,0,0,0,0,1037959,2023-12-20T00:00:00.000Z,28,23,Mo Bamba,0,0,0,0,0,0
0,0,0,0,0,0,0,0,0,0,0,0,0,0,0,0,1037959,2023-12-20T00:00:00.000Z,33,23,Nicolas Batum,0,0,0,0,0,0
3,1,4,0,0,5,3,2,2,12,4,3,8,8,3,2,1037959,2023-12-20T00:00:00.000Z,3547270,23,Paul Reed,4,16,19,11,11,32.1
5,0,1,7,4,18,8,1,0,32,1,2,20,2,0,1,1037960,2023-12-20T00:00:00.000Z,17896048,3,Cam Thomas,0,22,27,25,7,28.9
2,0,4,6,4,14,8,1,0,28,0,3,20,4,0,0,1037960,2023-12-20T00:00:00.000Z,666679,3,Cameron Johnson,0,24,26,22,6,27.8
0,0,0,0,0,0,0,0,0,0,0,0,0,0,0,0,1037960,2023-12-20T00:00:00.000Z,56677841,3,Dariq Whitehead,0,0,0,0,0,0
0,0,3,6,2,8,3,2,2,24,0,2,10,3,0,1,1037960,2023-12-20T00:00:00.000Z,158,3,Dorian Finney-Smith,0,13,13,10,3,12.6
0,1,0,0,0,1,0,0,0,4,0,1,0,0,0,1,1037960,2023-12-20T00:00:00.000Z,174,3,Harry Giles III,1,0,0,0,0,2
2,0,3,8,1,21,4,6,6,33,2,0,15,5,2,2,1037960,2023-12-20T00:00:00.000Z,61,3,Mikal Bridges,2,20,22,17,7,28
2,4,4,0,0,5,3,0,0,26,4,5,6,8,0,0,1037960,2023-12-20T00:00:00.000Z,666508,3,Nicolas Claxton,4,14,16,8,10,30.6
6,3,5,10,2,11,2,0,0,28,1,2,6,6,1,2,1037960,2023-12-20T00:00:00.000Z,351,3,Royce O'Neale,4,12,18,12,12,32.2
2,0,2,8,2,11,3,2,2,30,0,0,10,2,1,2,1037960,2023-12-20T00:00:00.000Z,130,3,Spencer Dinwiddie,1,12,14,12,4,16.4
0,0,0,0,0,0,0,0,0,0,0,0,0,0,0,0,1037960,2023-12-20T00:00:00.000Z,666474,20,Charles Brown,0,0,0,0,0,0
0,0,0,0,0,3,2,0,0,3,0,1,4,0,0,0,1037960,2023-12-20T00:00:00.000Z,666675,20,DaQuan Jeffries,0,4,4,4,0,4
1,0,6,10,5,15,9,0,0,23,2,2,23,8,3,2,1037960,2023-12-20T00:00:00.000Z,131,20,Donte DiVincenzo,3,31,32,24,9,41.1
2,1,0,6,4,12,7,4,1,24,0,0,19,0,1,1,1037960,2023-12-20T00:00:00.000Z,3547269,20,Immanuel Quickley,2,19,21,21,2,27
3,2,5,0,0,3,1,0,0,30,5,1,2,10,0,0,1037960,2023-12-20T00:00:00.000Z,201,20,Isaiah Hartenstein,2,12,15,5,13,24.5
0,0,0,0,0,0,0,0,0,0,0,0,0,0,0,0,1037960,2023-12-20T00:00:00.000Z,56677795,20,Jacob Toppin,0,0,0,0,0,0
8,0,6,3,1,15,6,4,3,32,1,0,16,7,1,3,1037960,2023-12-20T00:00:00.000Z,73,20,Jalen Brunson,1,23,31,24,15,36.4
0,0,0,0,0,0,0,0,0,0,0,0,0,0,0,0,1037960,2023-12-20T00:00:00.000Z,59421201,20,Jaylen Martin,0,0,0,0,0,0
0,0,0,0,0,0,0,0,0,0,0,0,0,0,0,0,1037960,2023-12-20T00:00:00.000Z,17896063,20,Jericho Sims,0,0,0,0,0,0
3,0,11,3,2,5,2,4,4,31,2,2,10,13,1,2,1037960,2023-12-20T00:00:00.000Z,202,20,Josh Hart,1,23,26,13,16,31.1
4,0,5,4,0,20,9,9,8,34,2,3,26,7,0,1,1037960,2023-12-20T00:00:00.000Z,387,20,Julius Randle,0,33,37,30,11,39.4
0,0,0,1,0,1,0,0,0,3,0,0,0,0,0,0,1037960,2023-12-20T00:00:00.000Z,17896033,20,Miles McBride,0,0,0,0,0,0
0,0,0,0,0,0,0,0,0,0,0,0,0,0,0,0,1037960,2023-12-20T00:00:00.000Z,399,20,Mitchell Robinson,0,0,0,0,0,0
0,1,1,4,1,7,2,0,0,18,0,1,5,1,1,0,1037960,2023-12-20T00:00:00.000Z,17895858,20,Quentin Grimes,2,6,6,5,1,12.2
2,1,5,1,0,11,5,4,4,27,0,2,14,5,1,2,1037960,2023-12-20T00:00:00.000Z,666423,20,RJ Barrett,2,19,21,16,7,27
0,2,2,0,0,2,1,0,0,13,0,3,2,2,0,0,1037960,2023-12-20T00:00:00.000Z,173,20,Taj Gibson,2,4,4,2,2,10.4
2,0,2,1,0,9,6,0,0,30,3,1,12,5,0,1,1037961,2023-12-20T00:00:00.000Z,177,8,Aaron Gordon,0,17,19,14,7,20
0,0,0,0,0,0,0,0,0,0,0,0,0,0,0,0,1037961,2023-12-20T00:00:00.000Z,38017727,8,Collin Gillespie,0,0,0,0,0,0
0,0,0,0,0,0,0,0,0,0,0,0,0,0,0,0,1037961,2023-12-20T00:00:00.000Z,215,8,Justin Holiday,0,0,0,0,0,0
3,1,2,3,2,5,4,0,0,32,0,2,10,2,3,0,1037961,2023-12-20T00:00:00.000Z,81,8,Kentavious Caldwell-Pope,4,12,15,13,5,28.9
2,0,5,7,2,13,5,0,0,32,1,1,12,6,1,0,1037961,2023-12-20T00:00:00.000Z,375,8,Michael Porter Jr.,1,18,20,14,8,25.2
6,2,10,5,3,23,13,3,2,38,5,2,31,15,0,2,1037961,2023-12-20T00:00:00.000Z,246,8,Nikola Jokic,2,46,52,37,21,62
0,1,5,1,1,3,2,0,0,12,2,1,5,7,0,1,1037961,2023-12-20T00:00:00.000Z,58,28,Chris Boucher,1,12,12,5,7,15.4
0,0,0,0,0,0,0,0,0,0,0,0,0,0,0,0,1037961,2023-12-20T00:00:00.000Z,38017710,28,Christian Koloko,0,0,0,0,0,0
7,0,2,2,1,8,3,0,0,31,0,2,7,2,1,2,1037961,2023-12-20T00:00:00.000Z,409,28,Dennis Schroder,1,9,16,14,9,20.9
0,0,0,0,0,0,0,0,0,0,0,0,0,0,0,0,1037961,2023-12-20T00:00:00.000Z,436,28,Garrett Temple,0,0,0,0,0,0
4,0,3,5,1,9,4,3,3,29,0,0,12,3,0,1,1037961,2023-12-20T00:00:00.000Z,3089,28,Gary Trent Jr.,0,15,19,16,7,20.6
0,0,0,0,0,0,0,0,0,0,0,0,0,0,0,0,1037961,2023-12-20T00:00:00.000Z,56677828,28,Gradey Dick,0,0,0,0,0,0
3,2,3,0,0,5,2,0,0,19,2,2,4,5,0,1,1037961,2023-12-20T00:00:00.000Z,373,28,Jakob Poeltl,2,9,12,7,8,19.5
0,0,0,0,0,0,0,0,0,0,0,0,0,0,0,0,1037961,2023-12-20T00:00:00.000Z,666762,28,Jalen McDaniels,0,0,0,0,0,0
0,0,0,0,0,0,0,0,0,0,0,0,0,0,0,0,1037961,2023-12-20T00:00:00.000Z,56677805,28,Javon Freeman-Liberty,0,0,0,0,0,0
0,0,0,0,0,0,0,0,0,0,0,0,0,0,0,0,1037961,2023-12-20T00:00:00.000Z,2309958,28,Jontay Porter,0,0,0,0,0,0
2,0,3,3,2,8,2,0,0,16,0,1,6,3,1,1,1037961,2023-12-20T00:00:00.000Z,3547275,28,Malachi Flynn,1,9,11,8,5,14.6
0,0,0,0,0,0,0,0,0,0,0,0,0,0,0,0,1037961,2023-12-20T00:00:00.000Z,56677869,28,Markquis Nowell,0,0,0,0,0,0
3,0,1,4,1,9,4,0,0,40,0,2,9,1,0,1,1037961,2023-12-20T00:00:00.000Z,18,28,OG Anunoby,0,10,13,12,4,13.7
0,0,0,0,0,0,0,0,0,0,0,0,0,0,0,0,1037961,2023-12-20T00:00:00.000Z,376,28,Otto Porter Jr.,0,0,0,0,0,0
1,0,4,5,1,16,7,5,3,35,1,2,18,5,0,1,1037961,2023-12-20T00:00:00.000Z,416,28,Pascal Siakam,0,23,24,19,6,24.5
1,1,1,2,1,10,6,1,0,25,4,2,13,5,1,1,1037961,2023-12-20T00:00:00.000Z,3547249,28,Precious Achiuwa,2,18,19,14,6,25.5
5,1,9,5,1,21,13,4,3,33,1,0,30,10,0,3,1037961,2023-12-20T00:00:00.000Z,17896055,28,Scottie Barnes,1,40,45,35,15,49.5
0,0,0,0,0,0,0,0,0,0,0,0,0,0,0,0,1037961,2023-12-20T00:00:00.000Z,489,28,Thaddeus Young,0,0,0,0,0,0
1,0,7,0,0,5,4,4,3,16,0,2,11,7,1,2,1037962,2023-12-20T00:00:00.000Z,137,5,Andre Drummond,1,18,19,12,8,21.9
0,0,0,0,0,0,0,0,0,1,0,0,0,0,0,0,1037962,2023-12-20T00:00:00.000Z,56677857,5,Julian Phillips,0,0,0,0,0,0
0,0,0,0,0,0,0,0,0,0,0,0,0,0,0,0,1037962,2023-12-20T00:00:00.000Z,27,5,Lonzo Ball,0,0,0,0,0,0
0,0,0,0,0,0,0,0,0,0,0,0,0,0,0,0,1037962,2023-12-20T00:00:00.000Z,56677874,5,Onuralp Bitim,0,0,0,0,0,0
0,0,0,0,0,0,0,0,0,1,0,0,0,0,0,0,1037962,2023-12-20T00:00:00.000Z,17896116,5,Terry Taylor,0,0,0,0,0,0
0,0,0,0,0,0,0,0,0,0,0,0,0,0,0,0,1037962,2023-12-20T00:00:00.000Z,110,5,Torrey Craig,0,0,0,0,0,0
0,0,0,0,0,0,0,0,0,0,0,0,0,0,0,0,1037962,2023-12-20T00:00:00.000Z,268,5,Zach LaVine,0,0,0,0,0,0
0,0,0,0,0,0,0,0,0,0,0,0,0,0,0,0,1037962,2023-12-20T00:00:00.000Z,56677867,14,Alex Fudge,0,0,0,0,0,0
0,1,0,0,0,0,0,0,0,1,0,0,0,0,0,1,1037962,2023-12-20T00:00:00.000Z,486,14,Christian Wood,1,0,0,0,0,2
0,0,0,0,0,0,0,0,0,0,0,0,0,0,0,0,1037962,2023-12-20T00:00:00.000Z,56677738,14,Colin Castleton,0,0,0,0,0,0
0,0,0,0,0,0,0,0,0,0,0,0,0,0,0,0,1037962,2023-12-20T00:00:00.000Z,56677868,14,D'Moi Hodge,0,0,0,0,0,0
3,0,1,3,1,4,1,0,0,14,0,2,3,1,0,0,1037962,2023-12-20T00:00:00.000Z,1603383,14,Gabe Vincent,0,4,7,6,4,8.7
0,0,0,0,0,0,0,0,0,0,0,0,0,0,0,0,1037962,2023-12-20T00:00:00.000Z,56677835,14,Jalen Hood-Schifino,0,0,0,0,0,0
0,0,1,0,0,1,1,0,0,1,0,0,2,1,0,0,1037962,2023-12-20T00:00:00.000Z,666626,14,Jaxson Hayes,0,3,3,2,1,3.2
0,0,0,0,0,0,0,0,0,1,0,0,0,0,0,0,1037962,2023-12-20T00:00:00.000Z,38017697,14,Max Christie,0,0,0,0,0,0
0,0,0,0,0,0,0,0,0,1,0,0,0,0,0,0,1037962,2023-12-20T00:00:00.000Z,56677836,14,Maxwell Lewis,0,0,0,0,0,0
1,0,2,2,1,9,2,0,0,16,3,0,5,5,0,0,1037962,2023-12-20T00:00:00.000Z,666609,14,Rui Hachimura,0,10,11,6,6,12.5
0,0,0,0,0,0,0,0,0,0,0,0,0,0,0,0,1037963,2023-12-20T00:00:00.000Z,38017689,1,AJ Griffin,0,0,0,0,0,0
5,1,4,8,4,14,8,2,2,30,0,3,22,4,1,0,1037963,2023-12-20T00:00:00.000Z,53,1,Bogdan Bogdanovic,2,26,31,27,9,40.3
0,0,0,0,0,0,0,0,0,0,0,0,0,0,0,0,1037963,2023-12-20T00:00:00.000Z,666564,1,Bruno Fernando,0,0,0,0,0,0
0,0,1,4,2,4,2,0,0,17,0,1,6,1,0,1,1037963,2023-12-20T00:00:00.000Z,666754,1,Garrison Mathews,0,7,7,6,1,6.2
0,0,0,0,0,0,0,0,0,0,0,0,0,0,0,0,1037963,2023-12-20T00:00:00.000Z,56677838,1,Kobe Bufkin,0,0,0,0,0,0
2,0,10,1,0,11,8,4,3,33,1,1,19,11,0,0,1037963,2023-12-20T00:00:00.000Z,3547244,1,Onyeka Okongwu,0,30,32,21,13,35.2
0,0,0,0,0,0,0,0,0,0,0,0,0,0,0,0,1037963,2023-12-20T00:00:00.000Z,319,1,Patty Mills,0,0,0,0,0,0
14,0,4,8,5,18,10,7,5,36,0,4,30,4,1,4,1037963,2023-12-20T00:00:00.000Z,490,1,Trae Young,1,34,48,44,18,54.8
0,0,0,0,0,0,0,0,0,0,0,0,0,0,0,0,1037963,2023-12-20T00:00:00.000Z,3547297,1,Trent Forrest,0,0,0,0,0,0
0,0,2,1,0,2,0,2,1,8,0,1,1,2,0,0,1037963,2023-12-20T00:00:00.000Z,301,1,Wesley Matthews,0,3,3,1,2,3.4
0,0,0,0,0,0,0,0,0,0,0,0,0,0,0,0,1037963,2023-12-20T00:00:00.000Z,296,11,Boban Marjanovic,0,0,0,0,0,0
0,0,0,0,0,0,0,0,0,0,0,0,0,0,0,0,1037963,2023-12-20T00:00:00.000Z,47738533,11,Jeenathan Williams,0,0,0,0,0,0
0,0,0,0,0,0,0,0,0,0,0,0,0,0,0,0,1037963,2023-12-20T00:00:00.000Z,38017695,11,Tari Eason,0,0,0,0,0,0
0,0,0,0,0,0,0,0,0,0,0,0,0,0,0,0,1037964,2023-12-20T00:00:00.000Z,56677840,7,Dereck Lively II,0,0,0,0,0,0
2,2,0,4,2,11,6,5,5,39,3,2,19,3,1,0,1037964,2023-12-20T00:00:00.000Z,247,7,Derrick Jones Jr.,3,22,24,21,5,34.6
1,0,0,0,0,1,1,2,1,17,1,2,3,1,0,0,1037964,2023-12-20T00:00:00.000Z,379,7,Dwight Powell,0,4,5,4,2,5.7
4,1,4,4,1,7,4,0,0,31,5,6,9,9,0,0,1037964,2023-12-20T00:00:00.000Z,666965,7,Grant Williams,1,18,22,13,13,28.8
1,0,2,9,5,13,5,0,0,23,0,3,15,2,1,0,1037964,2023-12-20T00:00:00.000Z,38017679,7,Jaden Hardy,1,17,18,16,3,21.9
0,0,0,0,0,0,0,0,0,0,0,0,0,0,0,0,1037964,2023-12-20T00:00:00.000Z,217,7,Richaun Holmes,0,0,0,0,0,0
0,0,0,0,0,0,0,0,0,0,0,0,0,0,0,0,1037964,2023-12-20T00:00:00.000Z,114,7,Seth Curry,0,0,0,0,0,0
3,0,5,5,2,6,3,4,4,39,0,5,12,5,1,3,1037964,2023-12-20T00:00:00.000Z,666511,13,Amir Coffey,1,17,20,15,8,22.5
0,0,7,0,0,6,5,2,2,25,2,2,12,9,1,1,1037964,2023-12-20T00:00:00.000Z,493,13,Ivica Zubac,1,21,21,12,9,24.8
11,2,5,8,2,12,4,8,7,39,0,3,17,5,0,4,1037964,2023-12-20T00:00:00.000Z,192,13,James Harden,2,22,33,28,16,41.5
5,1,7,6,1,22,12,5,5,38,3,0,30,10,1,0,1037964,2023-12-20T00:00:00.000Z,274,13,Kawhi Leonard,2,40,45,35,15,55.5
0,0,0,0,0,0,0,0,0,0,0,0,0,0,0,0,1037964,2023-12-20T00:00:00.000Z,450,13,PJ Tucker,0,0,0,0,0,0
1,1,3,2,1,8,3,0,0,29,1,3,7,4,0,1,1037964,2023-12-20T00:00:00.000Z,666743,13,Terance Mann,1,11,12,8,5,15.3
0,0,0,0,0,0,0,0,0,0,0,0,0,0,0,0,1037965,2023-12-20T00:00:00.000Z,219,2,Al Horford,0,0,0,0,0,0
0,0,0,0,0,0,0,0,0,0,0,0,0,0,0,0,1037965,2023-12-20T00:00:00.000Z,17896094,2,Dalano Banton,0,0,0,0,0,0
0,0,0,0,0,0,0,0,0,0,0,0,0,0,0,0,1037965,2023-12-20T00:00:00.000Z,38017707,2,JD Davison,0,0,0,0,0,0
0,0,0,0,0,1,1,0,0,2,0,0,2,0,0,0,1037965,2023-12-20T00:00:00.000Z,3547279,2,Lamar Stevens,0,2,2,2,0,2
0,0,0,0,0,0,0,0,0,0,0,0,0,0,0,0,1037965,2023-12-20T00:00:00.000Z,261,2,Luke Kornet,0,0,0,0,0,0
0,0,4,0,0,8,3,0,0,19,4,5,6,8,1,1,1037965,2023-12-20T00:00:00.000Z,17553967,2,Neemias Queta,1,14,14,6,8,17.6
3,0,2,4,0,6,1,0,0,16,2,1,2,4,1,0,1037965,2023-12-20T00:00:00.000Z,338,2,Svi Mykhailiuk,1,6,9,5,7,14.3
0,0,1,3,1,4,1,0,0,13,2,0,3,3,0,0,1037965,2023-12-20T00:00:00.000Z,4197162,26,Aleksandar Vezenkov,0,6,6,3,3,6.6
0,0,1,1,0,2,0,0,0,5,0,0,0,1,0,0,1037965,2023-12-20T00:00:00.000Z,17896030,26,Chris Duarte,0,1,1,0,1,1.2
3,0,1,8,6,16,9,6,5,27,2,4,29,3,3,3,1037965,2023-12-20T00:00:00.000Z,161,26,De'Aaron Fox,3,32,35,32,6,43.1
8,1,5,1,0,14,6,4,1,26,5,2,13,10,0,1,1037965,2023-12-20T00:00:00.000Z,406,26,Domantas Sabonis,1,23,31,21,18,39
3,0,3,2,2,5,3,4,2,30,1,1,10,4,0,0,1037965,2023-12-20T00:00:00.000Z,30,26,Harrison Barnes,0,14,17,13,7,19.3
0,0,0,7,3,11,5,0,0,26,1,4,13,1,0,1,1037965,2023-12-20T00:00:00.000Z,38017688,26,Keegan Murray,0,14,14,13,1,13.2
4,2,2,7,4,7,4,0,0,19,0,1,12,2,1,0,1037965,2023-12-20T00:00:00.000Z,38017714,26,Keon Ellis,3,14,18,16,6,29.4
0,0,2,2,1,5,3,0,0,6,0,0,7,2,0,0,1037965,2023-12-20T00:00:00.000Z,17896044,26,Kessler Edwards,0,9,9,7,2,9.4
0,0,1,2,1,5,3,1,0,16,0,1,7,1,0,0,1037965,2023-12-20T00:00:00.000Z,221,26,Kevin Huerter,0,8,8,7,1,8.2
5,0,2,4,0,10,3,4,4,25,0,1,10,2,0,1,1037965,2023-12-20T00:00:00.000Z,324,26,Malik Monk,0,12,17,15,7,18.9
3,1,4,6,3,7,4,0,0,27,1,1,11,5,0,0,1037965,2023-12-20T00:00:00.000Z,290,26,Trey Lyles,1,16,19,14,8,24.5
0,1,1,3,0,4,1,3,3,8,0,1,5,1,0,0,1037966,2023-12-21T00:00:00.000Z,77,9,Alec Burks,1,6,6,5,1,9.2
1,2,1,0,0,3,3,2,1,19,1,2,7,2,1,3,1037966,2023-12-21T00:00:00.000Z,56677826,9,Ausar Thompson,3,9,10,8,3,16.9
10,1,6,6,2,22,10,7,6,39,1,2,28,7,2,6,1037966,2023-12-21T00:00:00.000Z,17896075,9,Cade Cunningham,3,35,45,38,17,54.4
7,2,3,5,2,16,9,4,4,35,2,4,24,5,3,5,1037966,2023-12-21T00:00:00.000Z,38017682,9,Jaden Ivey,5,29,36,31,12,50.5
0,0,0,0,0,0,0,0,0,0,0,0,0,0,0,0,1037966,2023-12-21T00:00:00.000Z,38017694,9,Jalen Duren,0,0,0,0,0,0
0,1,3,0,0,2,1,0,0,15,2,1,2,5,0,2,1037966,2023-12-21T00:00:00.000Z,3547240,9,James Wiseman,1,7,7,2,5,9
0,0,0,0,0,0,0,0,0,0,0,0,0,0,0,0,1037966,2023-12-21T00:00:00.000Z,42097199,9,Jared Rhoden,0,0,0,0,0,0
0,0,0,0,0,0,0,0,0,0,0,0,0,0,0,0,1037966,2023-12-21T00:00:00.000Z,197,9,Joe Harris,0,0,0,0,0,0
0,0,0,0,0,0,0,0,0,0,0,0,0,0,0,0,1037966,2023-12-21T00:00:00.000Z,259,9,Kevin Knox,0,0,0,0,0,0
0,0,0,0,0,0,0,0,0,0,0,0,0,0,0,0,1037966,2023-12-21T00:00:00.000Z,3547241,9,Killian Hayes,0,0,0,0,0,0
0,0,2,5,2,8,3,0,0,13,1,0,8,3,0,2,1037966,2023-12-21T00:00:00.000Z,56677792,9,Marcus Sasser,0,11,11,8,3,9.6
0,0,3,1,0,12,10,2,2,31,2,3,22,5,0,0,1037966,2023-12-21T00:00:00.000Z,24,9,Marvin Bagley III,0,27,27,22,5,28
0,0,0,0,0,0,0,0,0,0,0,0,0,0,0,0,1037966,2023-12-21T00:00:00.000Z,330,9,Monte Morris,0,0,0,0,0,0
0,0,0,0,0,0,0,0,0,0,0,0,0,0,0,0,1037966,2023-12-21T00:00:00.000Z,56677842,29,Brice Sensabaugh,0,0,0,0,0,0
8,0,1,3,1,18,6,6,6,32,3,3,19,4,4,3,1037966,2023-12-21T00:00:00.000Z,413,29,Collin Sexton,4,23,31,27,12,44.8
1,1,7,3,0,12,4,5,5,32,2,4,13,9,2,3,1037966,2023-12-21T00:00:00.000Z,101,29,John Collins,3,22,23,14,10,31.3
0,0,0,0,0,0,0,0,0,0,0,0,0,0,0,0,1037966,2023-12-21T00:00:00.000Z,38017630,29,Johnny Juzang,0,0,0,0,0,0
0,0,0,0,0,0,0,0,0,0,0,0,0,0,0,0,1037966,2023-12-21T00:00:00.000Z,100,29,Jordan Clarkson,0,0,0,0,0,0
0,0,0,0,0,0,0,0,0,0,0,0,0,0,0,0,1037966,2023-12-21T00:00:00.000Z,17896023,29,Josh Christopher,0,0,0,0,0,0
0,0,0,0,0,0,0,0,0,0,0,0,0,0,0,0,1037966,2023-12-21T00:00:00.000Z,56677834,29,Keyonte George,0,0,0,0,0,0
10,1,4,2,0,11,5,4,3,33,1,2,13,5,2,1,1037966,2023-12-21T00:00:00.000Z,139,29,Kris Dunn,3,18,28,23,15,42
0,0,0,0,0,0,0,0,0,0,0,0,0,0,0,0,1037966,2023-12-21T00:00:00.000Z,297,29,Lauri Markkanen,0,0,0,0,0,0
0,0,4,1,0,5,0,2,2,10,1,1,2,5,0,0,1037966,2023-12-21T00:00:00.000Z,666881,29,Luka Samanic,0,7,7,2,5,8
0,0,0,0,0,0,0,0,0,0,0,0,0,0,0,0,1037966,2023-12-21T00:00:00.000Z,19465584,29,Micah Potter,0,0,0,0,0,0
0,0,2,6,2,12,7,2,2,33,0,4,18,2,2,0,1037966,2023-12-21T00:00:00.000Z,38017620,29,Ochai Agbaji,2,20,20,18,2,26.4
0,0,0,0,0,0,0,0,0,0,0,0,0,0,0,0,1037966,2023-12-21T00:00:00.000Z,11891374,29,Omer Yurtseven,0,0,0,0,0,0
0,0,0,0,0,0,0,0,0,0,0,0,0,0,0,0,1037966,2023-12-21T00:00:00.000Z,666650,29,Talen Horton-Tucker,0,0,0,0,0,0
0,1,1,2,1,5,3,0,0,16,3,0,7,4,0,0,1037966,2023-12-21T00:00:00.000Z,56677824,29,Taylor Hendricks,1,11,11,7,4,14.8
1,4,5,0,0,3,2,1,0,20,5,1,4,10,0,1,1037966,2023-12-21T00:00:00.000Z,38017705,29,Walker Kessler,4,14,15,5,11,28.5
0,0,1,0,0,1,1,0,0,4,0,0,2,1,0,0,1037967,2023-12-21T00:00:00.000Z,248,6,Damian Jones,0,3,3,2,1,3.2
0,0,0,0,0,0,0,0,0,0,0,0,0,0,0,0,1037967,2023-12-21T00:00:00.000Z,666581,6,Darius Garland,0,0,0,0,0,0
0,0,0,0,0,0,0,0,0,0,0,0,0,0,0,0,1037967,2023-12-21T00:00:00.000Z,322,6,Donovan Mitchell,0,0,0,0,0,0
0,0,0,0,0,0,0,0,0,0,0,0,0,0,0,0,1037967,2023-12-21T00:00:00.000Z,17896076,6,Evan Mobley,0,0,0,0,0,0
1,0,0,1,1,1,1,0,0,4,0,0,3,0,0,0,1037967,2023-12-21T00:00:00.000Z,38017662,6,Isaiah Mobley,0,3,4,4,1,4.5
0,0,0,0,0,0,0,0,0,0,0,0,0,0,0,0,1037967,2023-12-21T00:00:00.000Z,666676,6,Ty Jerome,0,0,0,0,0,0
0,0,0,0,0,0,0,0,0,0,0,0,0,0,0,0,1037967,2023-12-21T00:00:00.000Z,38017726,19,Dereon Seabron,0,0,0,0,0,0
1,0,2,1,1,4,3,0,0,20,0,1,7,2,0,0,1037967,2023-12-21T00:00:00.000Z,38017677,19,Dyson Daniels,0,9,10,8,3,10.9
3,0,1,0,0,1,1,0,0,18,1,2,2,2,0,0,1037967,2023-12-21T00:00:00.000Z,17896097,19,Jose Alvarado,0,4,7,5,5,8.9
0,0,0,0,0,0,0,0,0,0,0,0,0,0,0,0,1037968,2023-12-21T00:00:00.000Z,56677860,5,Adama Sanogo,0,0,0,0,0,0
1,2,4,0,0,10,5,3,2,19,4,0,12,8,5,1,1037968,2023-12-21T00:00:00.000Z,137,5,Andre Drummond,7,20,21,13,9,43.1
0,0,2,4,1,8,5,0,0,26,0,2,11,2,1,0,1037968,2023-12-21T00:00:00.000Z,17895983,5,Ayo Dosunmu,1,13,13,11,2,16.4
5,0,6,6,2,15,10,0,0,36,0,2,22,6,0,3,1037968,2023-12-21T00:00:00.000Z,666956,5,Coby White,0,28,33,27,11,33.7
3,0,3,2,0,2,0,2,1,18,0,1,1,3,0,0,1037968,2023-12-21T00:00:00.000Z,38017719,5,Dalen Terry,0,4,7,4,6,9.1
2,1,1,1,1,3,1,2,2,19,0,1,5,1,0,0,1037968,2023-12-21T00:00:00.000Z,87,5,Jevon Carter,1,6,8,7,3,12.2
0,0,0,1,0,1,0,0,0,4,0,1,0,0,0,0,1037968,2023-12-21T00:00:00.000Z,56677857,5,Julian Phillips,0,0,0,0,0,0
0,0,0,0,0,0,0,0,0,0,0,0,0,0,0,0,1037968,2023-12-21T00:00:00.000Z,27,5,Lonzo Ball,0,0,0,0,0,0
0,0,0,0,0,0,0,0,0,0,0,0,0,0,0,0,1037968,2023-12-21T00:00:00.000Z,56677874,5,Onuralp Bitim,0,0,0,0,0,0
0,0,0,0,0,0,0,0,0,2,0,1,0,0,0,1,1037968,2023-12-21T00:00:00.000Z,17896116,5,Terry Taylor,0,0,0,0,0,-1
0,0,0,0,0,0,0,0,0,0,0,0,0,0,0,0,1037968,2023-12-21T00:00:00.000Z,110,5,Torrey Craig,0,0,0,0,0,0
0,0,0,0,0,0,0,0,0,0,0,0,0,0,0,0,1037968,2023-12-21T00:00:00.000Z,268,5,Zach LaVine,0,0,0,0,0,0
2,0,3,8,3,15,7,4,4,31,1,0,21,4,1,1,1037968,2023-12-21T00:00:00.000Z,3547246,27,Devin Vassell,1,25,27,23,6,30.8
0,0,0,0,0,0,0,0,0,0,0,0,0,0,0,0,1037968,2023-12-21T00:00:00.000Z,180,27,Devonte' Graham,0,0,0,0,0,0
2,0,4,2,1,8,4,0,0,34,3,0,9,7,1,1,1037968,2023-12-21T00:00:00.000Z,38017699,27,Jeremy Sochan,1,16,18,11,9,22.4
2,0,4,2,0,13,5,3,1,32,2,3,11,6,0,3,1037968,2023-12-21T00:00:00.000Z,666682,27,Keldon Johnson,0,17,19,13,8,18.2
2,0,6,4,1,11,6,0,0,29,0,1,13,6,0,3,1037968,2023-12-21T00:00:00.000Z,38017692,27,Malaki Branham,0,19,21,15,8,20.2
0,0,1,0,0,0,0,0,0,3,0,0,0,1,0,0,1037968,2023-12-21T00:00:00.000Z,17896059,27,Sandro Mamukelashvili,0,1,1,0,1,1.2
5,3,5,1,0,8,3,3,1,22,0,0,7,5,2,2,1037968,2023-12-21T00:00:00.000Z,56677822,27,Victor Wembanyama,5,12,17,12,10,33.5
2,3,6,4,2,10,5,2,2,28,3,2,14,9,0,1,1037968,2023-12-21T00:00:00.000Z,102,27,Zach Collins,3,23,25,16,11,35.8
0,3,4,8,4,12,5,0,0,28,1,1,14,5,4,2,1037969,2023-12-21T00:00:00.000Z,3547250,12,Aaron Nesmith,7,19,19,14,5,39
1,0,1,3,2,4,2,0,0,16,0,2,6,1,2,1,1037969,2023-12-21T00:00:00.000Z,38017507,12,Andrew Nembhard,2,7,8,7,2,13.7
3,0,2,4,0,10,3,0,0,18,2,0,6,4,1,1,1037969,2023-12-21T00:00:00.000Z,38017686,12,Bennedict Mathurin,1,10,13,9,7,17.3
2,1,3,1,0,4,1,2,2,28,1,4,4,4,0,0,1037969,2023-12-21T00:00:00.000Z,69,12,Bruce Brown,1,8,10,6,6,14.8
4,0,4,13,5,14,5,0,0,32,2,2,15,6,2,2,1037969,2023-12-21T00:00:00.000Z,210,12,Buddy Hield,2,21,25,19,10,32.2
0,0,0,0,0,0,0,0,0,0,0,0,0,0,0,0,1037969,2023-12-21T00:00:00.000Z,56677794,12,Isaiah Wong,0,0,0,0,0,0
0,0,0,0,0,0,0,0,0,0,0,0,0,0,0,0,1037969,2023-12-21T00:00:00.000Z,56677832,12,Jarace Walker,0,0,0,0,0,0
2,3,3,2,0,10,5,5,5,36,3,5,15,6,1,4,1037969,2023-12-21T00:00:00.000Z,452,12,Myles Turner,4,21,23,17,8,33.2
1,0,3,9,5,14,8,2,1,28,2,3,22,5,2,1,1037969,2023-12-21T00:00:00.000Z,3547243,12,Obi Toppin,2,27,28,23,6,34.5
0,0,0,0,0,0,0,0,0,0,0,0,0,0,0,0,1037969,2023-12-21T00:00:00.000Z,56677778,12,Oscar Tshiebwe,0,0,0,0,0,0
14,0,4,12,2,19,7,2,1,38,0,2,17,4,0,4,1037969,2023-12-21T00:00:00.000Z,3547245,12,Tyrese Haliburton,0,21,35,31,18,38.8
1,1,2,0,0,4,1,1,0,17,1,2,2,3,0,0,1037969,2023-12-21T00:00:00.000Z,48,15,Bismack Biyombo,1,5,6,3,4,10.1
0,0,0,0,0,0,0,0,0,0,0,0,0,0,0,0,1037969,2023-12-21T00:00:00.000Z,666505,15,Brandon Clarke,0,0,0,0,0,0
0,0,0,0,0,0,0,0,0,0,0,0,0,0,0,0,1037969,2023-12-21T00:00:00.000Z,38017729,15,David Roddy,0,0,0,0,0,0
0,0,0,0,0,0,0,0,0,0,0,0,0,0,0,0,1037969,2023-12-21T00:00:00.000Z,401,15,Derrick Rose,0,0,0,0,0,0
7,0,6,12,5,26,11,5,4,36,0,1,31,6,1,2,1037969,2023-12-21T00:00:00.000Z,3547287,15,Desmond Bane,1,37,44,38,13,49.7
0,0,0,0,0,0,0,0,0,0,0,0,0,0,0,0,1037969,2023-12-21T00:00:00.000Z,56677830,15,GG Jackson,0,0,0,0,0,0
8,0,5,3,1,15,7,6,5,34,0,0,20,5,0,2,1037969,2023-12-21T00:00:00.000Z,666786,15,Ja Morant,0,25,33,28,13,36
0,0,0,0,0,0,0,0,0,0,0,0,0,0,0,0,1037969,2023-12-21T00:00:00.000Z,48248287,15,Jacob Gilyard,0,0,0,0,0,0
0,0,0,0,0,0,0,0,0,0,0,0,0,0,0,0,1037969,2023-12-21T00:00:00.000Z,38017728,15,Jake LaRavia,0,0,0,0,0,0
1,0,6,4,2,10,8,3,3,33,1,4,21,7,1,7,1037969,2023-12-21T00:00:00.000Z,231,15,Jaren Jackson Jr.,1,28,29,22,8,26.9
1,2,5,4,2,4,2,0,0,21,1,1,6,6,1,0,1037969,2023-12-21T00:00:00.000Z,666703,15,John Konchar,3,12,13,7,7,23.7
0,0,0,0,0,0,0,0,0,0,0,0,0,0,0,0,1037969,2023-12-21T00:00:00.000Z,254,15,Luke Kennard,0,0,0,0,0,0
0,0,0,0,0,0,0,0,0,0,0,0,0,0,0,0,1037969,2023-12-21T00:00:00.000Z,420,15,Marcus Smart,0,0,0,0,0,0
2,0,3,5,3,7,5,0,0,25,0,0,13,3,1,2,1037969,2023-12-21T00:00:00.000Z,17896067,15,Santi Aldama,1,16,18,15,5,20.6
0,0,0,0,0,0,0,0,0,0,0,0,0,0,0,0,1037969,2023-12-21T00:00:00.000Z,3,15,Steven Adams,0,0,0,0,0,0
3,1,3,3,0,5,1,0,0,35,1,2,2,4,3,2,1037969,2023-12-21T00:00:00.000Z,38017731,15,Vince Williams Jr.,4,6,9,5,7,21.3
2,1,2,0,0,3,2,4,1,21,3,2,5,5,0,1,1037969,2023-12-21T00:00:00.000Z,3547285,15,Xavier Tillman,1,10,12,7,7,16
0,0,0,0,0,0,0,0,0,0,0,0,0,0,0,0,1037970,2023-12-21T00:00:00.000Z,38017733,17,A.J. Green,0,0,0,0,0,0
0,0,0,1,0,1,0,0,0,7,0,0,0,0,0,0,1037970,2023-12-21T00:00:00.000Z,56677852,17,Andre Jackson Jr.,0,0,0,0,0,0
1,1,3,2,0,8,3,0,0,21,5,1,6,8,1,0,1037970,2023-12-21T00:00:00.000Z,377,17,Bobby Portis,2,14,15,7,9,23.1
4,0,1,3,0,4,1,0,0,13,0,2,2,1,0,0,1037970,2023-12-21T00:00:00.000Z,368,17,Cameron Payne,0,3,7,6,5,9.2
0,0,0,0,0,0,0,0,0,0,0,0,0,0,0,0,1037970,2023-12-21T00:00:00.000Z,56677854,17,Chris Livingston,0,0,0,0,0,0
0,0,0,0,0,0,0,0,0,0,0,0,0,0,0,0,1037970,2023-12-21T00:00:00.000Z,112,17,Jae Crowder,0,0,0,0,0,0
0,0,0,0,0,0,0,0,0,0,0,0,0,0,0,0,1037970,2023-12-21T00:00:00.000Z,666453,17,Marques Bolden,0,0,0,0,0,0
0,0,0,0,0,0,0,0,0,0,0,0,0,0,0,0,1037970,2023-12-21T00:00:00.000Z,284,17,Robin Lopez,0,0,0,0,0,0
0,0,0,0,0,0,0,0,0,0,0,0,0,0,0,0,1037970,2023-12-21T00:00:00.000Z,666885,22,Admiral Schofield,0,0,0,0,0,0
1,2,2,0,0,0,0,2,1,19,0,2,1,2,1,1,1037970,2023-12-21T00:00:00.000Z,56677827,22,Anthony Black,3,3,4,2,3,12.9
0,1,1,3,0,3,0,0,0,18,0,2,0,1,0,0,1037970,2023-12-21T00:00:00.000Z,38017724,22,Caleb Houstan,1,1,1,0,1,4.2
0,0,0,0,0,0,0,0,0,0,0,0,0,0,0,0,1037970,2023-12-21T00:00:00.000Z,666818,22,Chuma Okeke,0,0,0,0,0,0
6,0,7,6,1,17,7,3,3,33,4,2,18,11,2,0,1037970,2023-12-21T00:00:00.000Z,3547251,22,Cole Anthony,2,29,35,24,17,46.2
5,0,1,6,2,11,5,3,2,35,1,4,14,2,0,0,1037970,2023-12-21T00:00:00.000Z,196,22,Gary Harris,0,16,21,19,7,23.9
0,0,0,0,0,0,0,0,0,0,0,0,0,0,0,0,1037970,2023-12-21T00:00:00.000Z,666442,22,Goga Bitadze,0,0,0,0,0,0
0,0,0,0,0,0,0,0,0,0,0,0,0,0,0,0,1037970,2023-12-21T00:00:00.000Z,17896073,22,Jalen Suggs,0,0,0,0,0,0
0,0,0,0,0,0,0,0,0,0,0,0,0,0,0,0,1037970,2023-12-21T00:00:00.000Z,56677839,22,Jett Howard,0,0,0,0,0,0
0,0,0,0,0,0,0,0,0,0,0,0,0,0,0,0,1037970,2023-12-21T00:00:00.000Z,226,22,Joe Ingles,0,0,0,0,0,0
0,3,1,0,0,7,2,1,0,14,3,2,4,4,1,1,1037970,2023-12-21T00:00:00.000Z,229,22,Jonathan Isaac,4,8,8,4,4,19.8
0,0,0,0,0,0,0,0,0,0,0,0,0,0,0,0,1037970,2023-12-21T00:00:00.000Z,38017607,22,Kevon Harris,0,0,0,0,0,0
0,0,0,0,0,0,0,0,0,0,0,0,0,0,0,0,1037970,2023-12-21T00:00:00.000Z,165,22,Markelle Fultz,0,0,0,0,0,0
2,1,5,4,1,15,10,0,0,27,3,1,21,8,1,1,1037970,2023-12-21T00:00:00.000Z,462,22,Moritz Wagner,2,29,31,23,10,38.6
0,0,0,0,0,0,0,0,0,0,0,0,0,0,0,0,1037970,2023-12-21T00:00:00.000Z,17553983,22,Trevelin Queen,0,0,0,0,0,0
2,1,3,3,0,6,2,0,0,21,1,2,4,4,0,0,1037970,2023-12-21T00:00:00.000Z,85,22,Wendell Carter Jr.,1,8,10,6,6,14.8
0,0,0,0,0,0,0,0,0,0,0,0,0,0,0,0,1037971,2023-12-21T00:00:00.000Z,56677856,13,Jordan Miller,0,0,0,0,0,0
0,0,0,0,0,0,0,0,0,0,0,0,0,0,0,0,1037971,2023-12-21T00:00:00.000Z,17896051,13,Joshua Primo,0,0,0,0,0,0
0,0,0,0,0,0,0,0,0,0,0,0,0,0,0,0,1037971,2023-12-21T00:00:00.000Z,274,13,Kawhi Leonard,0,0,0,0,0,0
0,0,0,0,0,0,0,0,0,0,0,0,0,0,0,0,1037971,2023-12-21T00:00:00.000Z,371,13,Mason Plumlee,0,0,0,0,0,0
0,0,0,0,0,0,0,0,0,0,0,0,0,0,0,0,1037971,2023-12-21T00:00:00.000Z,24417679,13,Xavier Moon,0,0,0,0,0,0
0,0,0,0,0,0,0,0,0,0,0,0,0,0,0,0,1037971,2023-12-21T00:00:00.000Z,3547271,21,Aleksej Pokusevski,0,0,0,0,0,0
0,0,0,0,0,0,0,0,0,0,0,0,0,0,0,0,1037971,2023-12-21T00:00:00.000Z,44,21,Davis Bertans,0,0,0,0,0,0
1,0,2,0,0,1,1,0,0,6,0,0,2,2,0,0,1037971,2023-12-21T00:00:00.000Z,38017706,21,Jaylin Williams,0,4,5,3,3,5.9
3,0,2,1,1,2,2,0,0,18,0,1,5,2,2,0,1037971,2023-12-21T00:00:00.000Z,480,21,Kenrich Williams,2,7,10,8,5,17.9
0,0,0,0,0,0,0,0,0,0,0,0,0,0,0,0,1037971,2023-12-21T00:00:00.000Z,56677853,21,Keyontae Johnson,0,0,0,0,0,0
0,0,0,0,0,0,0,0,0,0,0,0,0,0,0,0,1037971,2023-12-21T00:00:00.000Z,27924547,21,Lindy Waters III,0,0,0,0,0,0
0,0,0,0,0,0,0,0,0,0,0,0,0,0,0,0,1037971,2023-12-21T00:00:00.000Z,24572055,21,Olivier Sarr,0,0,0,0,0,0
1,0,0,0,0,0,0,0,0,2,0,0,0,0,0,0,1037971,2023-12-21T00:00:00.000Z,17896036,21,Tre Mann,0,0,1,1,1,1.5
0,0,0,0,0,0,0,0,0,0,0,0,0,0,0,0,1037971,2023-12-21T00:00:00.000Z,4197029,21,Vasilije Micic,0,0,0,0,0,0
4,3,7,1,1,20,11,9,8,39,1,2,31,8,0,1,1037972,2023-12-21T00:00:00.000Z,117,14,Anthony Davis,3,39,43,35,12,54.6
5,0,5,4,1,14,7,5,5,27,2,2,20,7,2,4,1037972,2023-12-21T00:00:00.000Z,17553995,14,Austin Reaves,2,27,32,25,12,37.9
2,0,0,2,0,8,3,2,2,37,1,1,8,1,1,1,1037972,2023-12-21T00:00:00.000Z,666860,14,Cameron Reddish,1,9,11,10,3,14.2
0,0,0,0,0,0,0,0,0,3,0,0,0,0,0,1,1037972,2023-12-21T00:00:00.000Z,486,14,Christian Wood,0,0,0,0,0,-1
8,3,4,6,2,19,7,1,1,38,0,1,17,4,2,4,1037972,2023-12-21T00:00:00.000Z,405,14,D'Angelo Russell,5,21,29,25,12,44.8
0,0,0,0,0,0,0,0,0,0,0,0,0,0,0,0,1037972,2023-12-21T00:00:00.000Z,1603383,14,Gabe Vincent,0,0,0,0,0,0
0,0,4,1,0,3,0,0,0,14,1,3,0,5,0,0,1037972,2023-12-21T00:00:00.000Z,457,14,Jarred Vanderbilt,0,5,5,0,5,6
1,0,2,0,0,1,1,1,1,11,1,2,3,3,0,1,1037972,2023-12-21T00:00:00.000Z,666626,14,Jaxson Hayes,0,6,7,4,4,7.1
0,0,4,5,2,12,7,6,2,34,1,3,18,5,1,2,1037972,2023-12-21T00:00:00.000Z,666609,14,Rui Hachimura,1,23,23,18,5,25
1,0,5,4,4,6,5,0,0,37,0,4,14,5,0,3,1037972,2023-12-21T00:00:00.000Z,383,14,Taurean Prince,0,19,20,15,6,18.5
5,1,7,6,2,19,9,8,7,38,0,0,27,7,3,4,1037972,2023-12-21T00:00:00.000Z,3547238,18,Anthony Edwards,4,34,39,32,12,50.9
0,0,0,0,0,0,0,0,0,0,0,0,0,0,0,0,1037972,2023-12-21T00:00:00.000Z,17895968,18,Daishen Nix,0,0,0,0,0,0
3,0,1,4,2,8,5,2,2,36,0,2,14,1,1,2,1037972,2023-12-21T00:00:00.000Z,3547259,18,Jaden McDaniels,1,15,18,17,4,20.7
0,0,0,0,0,0,0,0,0,0,0,0,0,0,0,0,1037972,2023-12-21T00:00:00.000Z,56677851,18,Jaylen Clark,0,0,0,0,0,0
0,0,0,0,0,0,0,0,0,0,0,0,0,0,0,0,1037972,2023-12-21T00:00:00.000Z,666767,18,Jordan McLaughlin,0,0,0,0,0,0
0,0,0,0,0,0,0,0,0,0,0,0,0,0,0,0,1037972,2023-12-21T00:00:00.000Z,38017715,18,Josh Minott,0,0,0,0,0,0
4,0,6,6,2,16,7,6,5,34,0,3,21,6,1,0,1037972,2023-12-21T00:00:00.000Z,447,18,Karl-Anthony Towns,1,27,31,25,10,37.2
4,1,3,2,0,7,4,1,1,23,2,0,9,5,1,1,1037972,2023-12-21T00:00:00.000Z,12,18,Kyle Anderson,2,14,18,13,9,26
0,0,0,0,0,0,0,0,0,0,0,0,0,0,0,0,1037972,2023-12-21T00:00:00.000Z,56677782,18,Leonard Miller,0,0,0,0,0,0
0,0,0,0,0,0,0,0,0,0,0,0,0,0,0,0,1037972,2023-12-21T00:00:00.000Z,17896056,18,Luka Garza,0,0,0,0,0,0
8,1,1,6,4,9,6,0,0,30,0,1,16,1,2,1,1037972,2023-12-21T00:00:00.000Z,104,18,Mike Conley,3,17,25,24,9,37.2
2,1,3,6,3,9,3,0,0,21,2,6,9,5,1,3,1037972,2023-12-21T00:00:00.000Z,667378,18,Naz Reid,2,14,16,11,7,21
3,0,1,5,1,6,2,0,0,15,0,2,5,1,3,1,1037972,2023-12-21T00:00:00.000Z,666400,18,Nickeil Alexander-Walker,3,6,9,8,4,18.7
3,3,8,0,0,12,6,6,3,37,5,3,15,13,1,2,1037972,2023-12-21T00:00:00.000Z,176,18,Rudy Gobert,4,28,31,18,16,45.1
0,0,0,0,0,0,0,0,0,0,0,0,0,0,0,0,1037972,2023-12-21T00:00:00.000Z,320,18,Shake Milton,0,0,0,0,0,0
0,0,1,1,0,1,0,2,2,6,0,2,2,1,0,0,1037972,2023-12-21T00:00:00.000Z,68,18,Troy Brown Jr.,0,3,3,2,1,3.2
0,0,0,0,0,0,0,0,0,0,0,0,0,0,0,0,1037972,2023-12-21T00:00:00.000Z,38017700,18,Wendell Moore Jr.,0,0,0,0,0,0
7,0,3,14,7,28,15,5,4,38,1,2,41,4,0,3,1037973,2023-12-21T00:00:00.000Z,419,25,Anfernee Simons,0,45,52,48,11,53.3
2,1,6,0,0,21,10,4,3,35,10,3,23,16,0,5,1037973,2023-12-21T00:00:00.000Z,22,25,Deandre Ayton,1,39,41,25,18,43.2
0,1,4,1,1,7,4,1,1,10,1,4,10,5,0,1,1037973,2023-12-21T00:00:00.000Z,56783340,25,Duop Reath,1,15,15,10,5,18
0,0,0,0,0,0,0,0,0,0,0,0,0,0,0,0,1037973,2023-12-21T00:00:00.000Z,39613724,25,Ibou Badji,0,0,0,0,0,0
0,0,0,0,0,0,0,0,0,0,0,0,0,0,0,0,1037973,2023-12-21T00:00:00.000Z,17896120,25,Ish Wainright,0,0,0,0,0,0
3,1,7,2,1,6,3,2,1,23,4,3,8,11,1,2,1037973,2023-12-21T00:00:00.000Z,38017711,25,Jabari Walker,2,19,22,11,14,29.7
4,0,1,7,4,14,6,7,4,32,1,4,20,2,1,2,1037973,2023-12-21T00:00:00.000Z,182,25,Jerami Grant,1,22,26,24,6,29.4
0,0,0,0,0,0,0,0,0,0,0,0,0,0,0,0,1037973,2023-12-21T00:00:00.000Z,47957121,25,Justin Minaya,0,0,0,0,0,0
0,0,0,0,0,0,0,0,0,0,0,0,0,0,0,0,1037973,2023-12-21T00:00:00.000Z,56677791,25,Kris Murray,0,0,0,0,0,0
4,0,2,3,1,8,3,0,0,28,0,3,7,2,1,1,1037973,2023-12-21T00:00:00.000Z,65,25,Malcolm Brogdon,1,9,13,11,6,17.4
2,3,2,2,0,3,0,0,0,30,2,2,0,4,3,0,1037973,2023-12-21T00:00:00.000Z,666923,25,Matisse Thybulle,6,4,6,2,6,25.8
0,0,0,0,0,0,0,0,0,0,0,0,0,0,0,0,1037973,2023-12-21T00:00:00.000Z,666476,25,Moses Brown,0,0,0,0,0,0
0,0,0,0,0,0,0,0,0,0,0,0,0,0,0,0,1037973,2023-12-21T00:00:00.000Z,56677829,25,Rayan Rupert,0,0,0,0,0,0
0,0,0,0,0,0,0,0,0,0,0,0,0,0,0,0,1037973,2023-12-21T00:00:00.000Z,476,25,Robert Williams III,0,0,0,0,0,0
2,0,4,0,0,5,0,4,4,26,0,3,4,4,0,1,1037973,2023-12-21T00:00:00.000Z,56677747,25,Scoot Henderson,0,8,10,6,6,10.8
0,0,0,0,0,0,0,0,0,0,0,0,0,0,0,0,1037973,2023-12-21T00:00:00.000Z,38017690,25,Shaedon Sharpe,0,0,0,0,0,0
0,0,0,0,0,0,0,0,0,0,0,0,0,0,0,0,1037973,2023-12-21T00:00:00.000Z,3547289,25,Skylar Mays,0,0,0,0,0,0
0,0,2,1,0,3,2,0,0,18,1,3,4,3,1,0,1037973,2023-12-21T00:00:00.000Z,56677850,25,Toumani Camara,1,7,7,4,3,10.6
0,0,0,0,0,0,0,0,0,1,0,0,0,0,0,0,1037973,2023-12-21T00:00:00.000Z,3547302,30,Anthony Gill,0,0,0,0,0,0
0,6,5,0,0,10,7,3,2,31,3,6,16,8,4,1,1037973,2023-12-21T00:00:00.000Z,666577,30,Daniel Gafford,10,24,24,16,8,54.6
0,0,2,2,1,3,1,2,1,13,0,0,4,2,0,0,1037973,2023-12-21T00:00:00.000Z,167,30,Danilo Gallinari,0,6,6,4,2,6.4
6,0,9,1,0,7,4,7,5,35,2,1,13,11,1,2,1037973,2023-12-21T00:00:00.000Z,3547242,30,Deni Avdija,1,24,30,19,17,36.2
0,0,0,0,0,0,0,0,0,0,0,0,0,0,0,0,1037973,2023-12-21T00:00:00.000Z,17896106,30,Eugene Omoruyi,0,0,0,0,0,0
0,0,0,0,0,0,0,0,0,0,0,0,0,0,0,0,1037973,2023-12-21T00:00:00.000Z,18677954,30,Jared Butler,0,0,0,0,0,0
6,0,6,7,3,22,11,10,7,37,2,0,32,8,1,3,1037973,2023-12-21T00:00:00.000Z,265,30,Kyle Kuzma,1,40,46,38,14,50.6
1,0,1,3,1,5,2,2,0,14,0,2,5,1,1,0,1037973,2023-12-21T00:00:00.000Z,337,30,Mike Muscala,1,6,7,6,2,10.7
0,0,0,0,0,0,0,0,0,0,0,0,0,0,0,0,1037973,2023-12-21T00:00:00.000Z,38017704,30,Patrick Baldwin Jr.,0,0,0,0,0,0
0,0,0,0,0,0,0,0,0,0,0,0,0,0,0,0,1037973,2023-12-21T00:00:00.000Z,38017712,30,Ryan Rollins,0,0,0,0,0,0
1,0,1,0,0,1,1,2,1,23,0,2,3,1,0,2,1037974,2023-12-22T00:00:00.000Z,2175,23,Danuel House Jr.,0,4,5,4,2,3.7
0,0,0,0,0,0,0,0,0,0,0,0,0,0,0,0,1037974,2023-12-22T00:00:00.000Z,313,23,De'Anthony Melton,0,0,0,0,0,0
0,0,1,0,0,1,1,0,0,7,0,0,2,1,0,0,1037974,2023-12-22T00:00:00.000Z,260,23,Furkan Korkmaz,0,3,3,2,1,3.2
0,0,0,0,0,0,0,0,0,1,0,0,0,0,0,0,1037974,2023-12-22T00:00:00.000Z,17896025,23,Jaden Springer,0,0,0,0,0,0
0,0,0,0,0,0,0,0,0,1,0,0,0,0,0,0,1037974,2023-12-22T00:00:00.000Z,17554001,23,Javonte Smart,0,0,0,0,0,0
9,4,9,2,2,21,11,8,7,35,1,1,31,10,2,6,1037974,2023-12-22T00:00:00.000Z,145,23,Joel Embiid,6,41,50,40,19,68.5
0,0,3,6,2,9,3,0,0,26,0,4,8,3,1,0,1037974,2023-12-22T00:00:00.000Z,360,23,Kelly Oubre Jr.,1,11,11,8,3,14.6
0,0,0,0,0,0,0,0,0,1,0,0,0,0,0,0,1037974,2023-12-22T00:00:00.000Z,3547294,23,Kenyon Martin Jr.,0,0,0,0,0,0
5,0,3,2,1,3,2,2,2,30,1,3,7,4,0,0,1037974,2023-12-22T00:00:00.000Z,328,23,Marcus Morris,0,11,16,12,9,19.3
0,0,0,0,0,0,0,0,0,0,0,0,0,0,0,0,1037974,2023-12-22T00:00:00.000Z,45,23,Patrick Beverley,0,0,0,0,0,0
0,1,3,1,0,2,1,2,2,13,1,2,4,4,1,0,1037974,2023-12-22T00:00:00.000Z,3547270,23,Paul Reed,2,8,8,4,4,14.8
2,1,3,1,0,1,0,0,0,24,0,4,0,3,1,0,1037974,2023-12-22T00:00:00.000Z,108,23,Robert Covington,2,3,5,2,5,12.6
7,0,8,9,5,23,12,4,4,38,0,2,33,8,1,2,1037974,2023-12-22T00:00:00.000Z,200,23,Tobias Harris,1,41,48,40,15,54.1
10,0,4,10,4,22,13,3,3,41,0,3,33,4,0,3,1037974,2023-12-22T00:00:00.000Z,3547254,23,Tyrese Maxey,0,37,47,43,14,49.8
0,0,0,0,0,0,0,0,0,0,0,0,0,0,0,0,1037974,2023-12-22T00:00:00.000Z,38017710,28,Christian Koloko,0,0,0,0,0,0
1,0,3,8,5,11,6,0,0,26,1,3,17,4,1,0,1037974,2023-12-22T00:00:00.000Z,3089,28,Gary Trent Jr.,1,21,22,18,5,26.3
0,0,0,0,0,0,0,0,0,0,0,0,0,0,0,0,1037974,2023-12-22T00:00:00.000Z,56677805,28,Javon Freeman-Liberty,0,0,0,0,0,0
0,0,0,0,0,0,0,0,0,0,0,0,0,0,0,0,1037974,2023-12-22T00:00:00.000Z,2309958,28,Jontay Porter,0,0,0,0,0,0
0,0,0,0,0,0,0,0,0,0,0,0,0,0,0,0,1037974,2023-12-22T00:00:00.000Z,56677869,28,Markquis Nowell,0,0,0,0,0,0
0,0,0,0,0,0,0,0,0,0,0,0,0,0,0,0,1037974,2023-12-22T00:00:00.000Z,489,28,Thaddeus Young,0,0,0,0,0,0
0,0,0,0,0,0,0,0,0,0,0,0,0,0,0,0,1037975,2023-12-22T00:00:00.000Z,417,3,Ben Simmons,0,0,0,0,0,0
0,0,0,0,0,0,0,0,0,0,0,0,0,0,0,0,1037975,2023-12-22T00:00:00.000Z,56677841,3,Dariq Whitehead,0,0,0,0,0,0
0,0,0,0,0,0,0,0,0,0,0,0,0,0,0,0,1037975,2023-12-22T00:00:00.000Z,17896041,3,Keon Johnson,0,0,0,0,0,0
0,0,0,0,0,0,0,0,0,0,0,0,0,0,0,0,1037975,2023-12-22T00:00:00.000Z,464,3,Lonnie Walker IV,0,0,0,0,0,0
2,0,3,0,0,6,5,9,8,32,2,1,18,5,1,1,1037975,2023-12-22T00:00:00.000Z,177,8,Aaron Gordon,1,23,25,20,7,29
0,0,0,0,0,0,0,0,0,0,0,0,0,0,0,0,1037975,2023-12-22T00:00:00.000Z,17896007,8,Braxton Key,0,0,0,0,0,0
0,0,0,0,0,0,0,0,0,0,0,0,0,0,0,0,1037975,2023-12-22T00:00:00.000Z,38017727,8,Collin Gillespie,0,0,0,0,0,0
0,0,0,0,0,0,0,0,0,0,0,0,0,0,0,0,1037975,2023-12-22T00:00:00.000Z,56677871,8,Hunter Tyson,0,0,0,0,0,0
0,0,0,0,0,0,0,0,0,0,0,0,0,0,0,0,1037975,2023-12-22T00:00:00.000Z,56677582,8,Jalen Pickett,0,0,0,0,0,0
0,0,0,0,0,0,0,0,0,0,0,0,0,0,0,0,1037975,2023-12-22T00:00:00.000Z,17896103,8,Jay Huff,0,0,0,0,0,0
4,0,4,2,1,6,1,0,0,30,1,3,3,5,2,1,1037975,2023-12-22T00:00:00.000Z,81,8,Kentavious Caldwell-Pope,2,8,12,7,9,20
3,1,4,5,3,10,6,0,0,34,0,1,15,4,0,1,1037975,2023-12-22T00:00:00.000Z,375,8,Michael Porter Jr.,1,19,22,18,7,26.3
7,2,9,2,2,17,12,5,5,34,2,4,31,11,3,0,1037975,2023-12-22T00:00:00.000Z,246,8,Nikola Jokic,5,42,49,38,18,69.7
0,0,0,0,0,0,0,0,0,0,0,0,0,0,0,0,1037975,2023-12-22T00:00:00.000Z,666489,8,Vlatko Cancar,0,0,0,0,0,0
0,0,0,0,0,0,0,0,0,0,0,0,0,0,0,0,1037976,2023-12-22T00:00:00.000Z,38017689,1,AJ Griffin,0,0,0,0,0,0
5,0,1,18,6,24,8,2,1,35,1,3,23,2,1,0,1037976,2023-12-22T00:00:00.000Z,53,1,Bogdan Bogdanovic,1,25,30,28,7,35.9
0,0,0,0,0,0,0,0,0,0,0,0,0,0,0,0,1037976,2023-12-22T00:00:00.000Z,666564,1,Bruno Fernando,0,0,0,0,0,0
0,0,7,0,0,3,3,2,2,28,3,5,8,10,0,2,1037976,2023-12-22T00:00:00.000Z,83,1,Clint Capela,0,18,18,8,10,18
0,0,0,0,0,0,0,0,0,0,0,0,0,0,0,0,1037976,2023-12-22T00:00:00.000Z,666656,1,De'Andre Hunter,0,0,0,0,0,0
6,0,7,9,3,20,10,3,1,34,1,0,24,8,3,2,1037976,2023-12-22T00:00:00.000Z,334,1,Dejounte Murray,3,32,38,30,14,49.6
1,0,1,3,0,3,0,0,0,18,0,4,0,1,0,0,1037976,2023-12-22T00:00:00.000Z,666754,1,Garrison Mathews,0,1,2,1,2,2.7
0,0,0,0,0,0,0,0,0,0,0,0,0,0,0,0,1037976,2023-12-22T00:00:00.000Z,17896040,1,Jalen Johnson,0,0,0,0,0,0
0,0,0,0,0,0,0,0,0,0,0,0,0,0,0,0,1037976,2023-12-22T00:00:00.000Z,56677838,1,Kobe Bufkin,0,0,0,0,0,0
0,0,0,0,0,0,0,0,0,0,0,0,0,0,0,0,1037976,2023-12-22T00:00:00.000Z,56677806,1,Mouhamed Gueye,0,0,0,0,0,0
1,2,3,1,0,7,4,2,1,26,4,3,9,7,1,0,1037976,2023-12-22T00:00:00.000Z,3547244,1,Onyeka Okongwu,3,16,17,10,8,27.9
1,0,0,1,1,2,1,0,0,12,1,4,3,1,0,1,1037976,2023-12-22T00:00:00.000Z,319,1,Patty Mills,0,4,5,4,2,4.7
2,0,8,8,2,14,6,2,2,40,2,2,16,10,2,2,1037976,2023-12-22T00:00:00.000Z,3547256,1,Saddiq Bey,2,26,28,18,12,35
0,0,0,0,0,0,0,0,0,0,0,0,0,0,0,0,1037976,2023-12-22T00:00:00.000Z,56677855,1,Seth Lundy,0,0,0,0,0,0
13,0,3,13,7,22,10,3,3,40,0,1,30,3,2,6,1037976,2023-12-22T00:00:00.000Z,490,1,Trae Young,2,33,46,43,16,53.1
0,0,0,0,0,0,0,0,0,0,0,0,0,0,0,0,1037976,2023-12-22T00:00:00.000Z,3547297,1,Trent Forrest,0,0,0,0,0,0
0,0,0,0,0,0,0,0,0,0,0,0,0,0,0,0,1037976,2023-12-22T00:00:00.000Z,4197387,1,Vit Krejci,0,0,0,0,0,0
0,0,1,1,0,1,0,0,0,7,0,1,0,1,0,0,1037976,2023-12-22T00:00:00.000Z,301,1,Wesley Matthews,0,1,1,0,1,1.2
6,0,9,1,0,14,5,10,8,38,2,2,18,11,2,6,1037976,2023-12-22T00:00:00.000Z,4,16,Bam Adebayo,2,29,35,24,17,40.2
2,1,6,4,2,9,4,1,1,35,2,4,11,8,1,0,1037976,2023-12-22T00:00:00.000Z,666747,16,Caleb Martin,2,19,21,13,10,29.6
0,0,0,0,0,0,0,0,0,0,0,0,0,0,0,0,1037976,2023-12-22T00:00:00.000Z,38017736,16,Cole Swider,0,0,0,0,0,0
0,0,0,0,0,0,0,0,0,0,0,0,0,0,0,0,1037976,2023-12-22T00:00:00.000Z,19465585,16,Dru Smith,0,0,0,0,0,0
3,0,2,7,4,11,8,7,7,25,1,0,27,3,1,2,1037976,2023-12-22T00:00:00.000Z,397,16,Duncan Robinson,1,30,33,30,6,36.1
2,0,2,3,1,6,2,0,0,10,3,2,5,5,0,0,1037976,2023-12-22T00:00:00.000Z,3092,16,Haywood Highsmith,0,10,12,7,7,14
1,1,3,1,1,14,7,5,4,37,4,4,19,7,1,2,1037976,2023-12-22T00:00:00.000Z,56677785,16,Jaime Jaquez Jr.,2,26,27,20,8,32.9
0,0,0,0,0,0,0,0,0,0,0,0,0,0,0,0,1037976,2023-12-22T00:00:00.000Z,38017734,16,Jamal Cain,0,0,0,0,0,0
0,0,0,0,0,0,0,0,0,0,0,0,0,0,0,0,1037976,2023-12-22T00:00:00.000Z,79,16,Jimmy Butler,0,0,0,0,0,0
1,0,3,4,0,5,1,1,1,29,0,0,3,3,1,1,1037976,2023-12-22T00:00:00.000Z,391,16,Josh Richardson,1,6,7,4,4,10.1
1,0,0,4,1,4,1,4,3,10,0,3,6,0,0,0,1037976,2023-12-22T00:00:00.000Z,285,16,Kevin Love,0,6,7,7,1,7.5
3,0,4,2,1,2,1,0,0,22,0,2,3,4,0,2,1037976,2023-12-22T00:00:00.000Z,286,16,Kyle Lowry,0,7,10,6,7,10.3
0,0,0,0,0,0,0,0,0,0,0,0,0,0,0,0,1037976,2023-12-22T00:00:00.000Z,38017696,16,Nikola Jovic,0,0,0,0,0,0
0,0,0,0,0,0,0,0,0,0,0,0,0,0,0,0,1037976,2023-12-22T00:00:00.000Z,39398582,16,Orlando Robinson,0,0,0,0,0,0
0,0,0,0,0,0,0,0,0,0,0,0,0,0,0,0,1037976,2023-12-22T00:00:00.000Z,3547257,16,R.J. Hampton,0,0,0,0,0,0
0,0,0,0,0,0,0,0,0,0,0,0,0,0,0,0,1037976,2023-12-22T00:00:00.000Z,74,16,Thomas Bryant,0,0,0,0,0,0
2,0,7,13,7,21,11,2,1,34,0,1,30,7,1,4,1037976,2023-12-22T00:00:00.000Z,666633,16,Tyler Herro,1,37,39,32,9,40.4
1,0,2,1,0,4,3,2,2,23,0,0,8,2,4,3,1037977,2023-12-22T00:00:00.000Z,17554004,7,AJ Lawson,4,10,11,9,3,20.9
1,0,2,1,0,4,1,2,1,22,2,3,3,4,0,1,1037977,2023-12-22T00:00:00.000Z,247,7,Derrick Jones Jr.,0,7,8,4,5,8.3
4,0,5,3,1,11,8,2,1,17,0,0,18,5,0,0,1037977,2023-12-22T00:00:00.000Z,56677873,7,Dexter Dennis,0,23,27,22,9,30
0,0,4,1,0,1,0,0,0,8,0,1,0,4,0,0,1037977,2023-12-22T00:00:00.000Z,379,7,Dwight Powell,0,4,4,0,4,4.8
2,1,4,3,0,5,0,0,0,26,0,2,0,4,2,0,1037977,2023-12-22T00:00:00.000Z,666965,7,Grant Williams,3,4,6,2,6,16.8
2,0,4,1,0,3,0,4,3,12,1,1,3,5,0,0,1037977,2023-12-22T00:00:00.000Z,17896028,7,Greg Brown III,0,8,10,5,7,12
4,0,2,12,2,17,3,0,0,24,0,5,8,2,0,0,1037977,2023-12-22T00:00:00.000Z,38017679,7,Jaden Hardy,0,10,14,12,6,16.4
0,0,0,0,0,0,0,0,0,0,0,0,0,0,0,0,1037977,2023-12-22T00:00:00.000Z,132,7,Luka Doncic,0,0,0,0,0,0
0,0,2,4,1,4,1,2,1,12,0,0,4,2,0,0,1037977,2023-12-22T00:00:00.000Z,329,7,Markieff Morris,0,6,6,4,2,6.4
2,0,1,4,1,13,6,9,7,30,5,2,20,6,1,3,1037977,2023-12-22T00:00:00.000Z,56677859,7,Olivier-Maxence Prosper,1,26,28,22,8,30.2
1,0,3,0,0,12,7,3,2,22,5,2,16,8,1,1,1037977,2023-12-22T00:00:00.000Z,217,7,Richaun Holmes,1,24,25,17,9,29.1
0,0,2,2,0,7,0,0,0,18,0,1,0,2,2,2,1037977,2023-12-22T00:00:00.000Z,114,7,Seth Curry,2,2,2,0,2,6.4
1,0,2,8,2,20,6,2,2,26,1,0,16,3,0,1,1037977,2023-12-22T00:00:00.000Z,191,7,Tim Hardaway Jr.,0,19,20,17,4,20.1
0,0,3,3,1,3,1,0,0,15,0,0,3,3,0,2,1037977,2023-12-22T00:00:00.000Z,213,11,Aaron Holiday,0,6,6,3,3,4.6
3,0,13,1,1,12,8,5,5,25,2,2,22,15,0,0,1037977,2023-12-22T00:00:00.000Z,17896062,11,Alperen Sengun,0,37,40,25,18,44.5
1,0,3,5,2,9,4,0,0,21,0,2,10,3,0,2,1037977,2023-12-22T00:00:00.000Z,66,11,Dillon Brooks,0,13,14,11,4,13.1
4,0,2,5,1,8,3,3,3,26,0,2,10,2,1,0,1037977,2023-12-22T00:00:00.000Z,458,11,Fred VanVleet,1,12,16,14,6,21.4
1,0,6,3,1,13,8,5,4,31,2,0,21,8,0,1,1037977,2023-12-22T00:00:00.000Z,38017684,11,Jabari Smith Jr.,0,29,30,22,9,31.1
4,0,5,7,3,14,5,4,4,27,1,2,17,6,2,4,1037977,2023-12-22T00:00:00.000Z,17895966,11,Jalen Green,2,23,27,21,10,32.2
0,0,0,0,0,0,0,0,0,0,0,0,0,0,0,0,1037977,2023-12-22T00:00:00.000Z,47738533,11,Jeenathan Williams,0,0,0,0,0,0
0,2,1,0,0,2,1,0,0,8,0,0,2,1,0,0,1037977,2023-12-22T00:00:00.000Z,188,11,Jeff Green,2,3,3,2,1,9.2
1,0,1,2,1,3,1,0,0,10,1,3,3,2,0,1,1037977,2023-12-22T00:00:00.000Z,3547281,11,Nate Hinton,0,5,6,4,3,5.9
0,0,0,0,0,0,0,0,0,0,0,0,0,0,0,0,1037977,2023-12-22T00:00:00.000Z,357,11,Victor Oladipo,0,0,0,0,0,0
0,0,0,0,0,0,0,0,0,0,0,0,0,0,0,0,1037978,2023-12-22T00:00:00.000Z,475,10,Andrew Wiggins,0,0,0,0,0,0
5,0,4,5,2,9,3,2,2,29,3,2,10,7,1,1,1037978,2023-12-22T00:00:00.000Z,56677858,10,Brandin Podziemski,1,17,22,15,12,27.9
10,0,7,3,0,7,2,1,0,25,0,2,4,7,1,1,1037978,2023-12-22T00:00:00.000Z,367,10,Chris Paul,1,11,21,14,17,29.4
0,0,1,1,0,3,0,0,0,14,0,3,0,1,1,1,1037978,2023-12-22T00:00:00.000Z,251,10,Cory Joseph,1,1,1,0,1,3.2
1,0,3,4,1,11,5,2,2,20,0,1,13,3,0,0,1037978,2023-12-22T00:00:00.000Z,407,10,Dario Saric,0,16,17,14,4,18.1
0,0,0,0,0,0,0,0,0,0,0,0,0,0,0,0,1037978,2023-12-22T00:00:00.000Z,185,10,Draymond Green,0,0,0,0,0,0
0,0,0,0,0,0,0,0,0,0,0,0,0,0,0,0,1037978,2023-12-22T00:00:00.000Z,2189,10,Gary Payton II,0,0,0,0,0,0
0,0,1,2,1,3,2,2,2,6,1,1,7,2,0,0,1037978,2023-12-22T00:00:00.000Z,57875092,10,Gui Santos,0,9,9,7,2,9.4
0,0,0,0,0,0,0,0,0,2,0,0,0,0,0,0,1037978,2023-12-22T00:00:00.000Z,398,10,Jerome Robinson,0,0,0,0,0,0
3,0,2,2,1,11,9,3,3,27,2,2,22,4,1,1,1037978,2023-12-22T00:00:00.000Z,17553979,10,Jonathan Kuminga,1,26,29,25,7,33.3
0,0,3,0,0,3,2,1,1,11,2,2,5,5,0,0,1037978,2023-12-22T00:00:00.000Z,282,10,Kevon Looney,0,10,10,5,5,11
2,0,3,10,4,17,8,0,0,27,0,0,20,3,0,2,1037978,2023-12-22T00:00:00.000Z,443,10,Klay Thompson,0,23,25,22,5,24.6
1,0,3,2,1,3,1,0,0,6,0,1,3,3,0,1,1037978,2023-12-22T00:00:00.000Z,45658838,10,Lester Quinones,0,6,7,4,4,7.1
0,0,2,3,0,4,1,4,3,19,1,1,5,3,1,2,1037978,2023-12-22T00:00:00.000Z,17553992,10,Moses Moody,1,8,8,5,3,9.6
7,1,4,13,8,18,9,5,4,27,0,0,30,4,0,2,1037978,2023-12-22T00:00:00.000Z,115,10,Stephen Curry,1,34,41,37,11,46.3
3,1,10,0,0,7,5,0,0,25,5,2,10,15,0,1,1037978,2023-12-22T00:00:00.000Z,56677799,10,Trayce Jackson-Davis,1,25,28,13,18,34.5
1,0,0,0,0,1,0,0,0,2,0,0,0,0,0,0,1037978,2023-12-22T00:00:00.000Z,17896070,10,Usman Garuba,0,0,1,1,1,1.5
0,1,1,1,0,5,4,0,0,11,2,0,8,3,0,0,1037978,2023-12-22T00:00:00.000Z,3547302,30,Anthony Gill,1,11,11,8,3,14.6
2,1,3,2,1,8,3,0,0,32,0,1,7,3,1,2,1037978,2023-12-22T00:00:00.000Z,56677844,30,Bilal Coulibaly,2,10,12,9,5,17.6
0,1,1,7,2,15,7,2,2,25,0,3,18,1,0,1,1037978,2023-12-22T00:00:00.000Z,17896045,30,Corey Kispert,1,19,19,18,1,21.2
1,0,3,0,0,7,5,6,5,23,1,1,15,4,1,1,1037978,2023-12-22T00:00:00.000Z,666577,30,Daniel Gafford,1,19,20,16,5,23.3
0,0,0,0,0,0,0,0,0,0,0,0,0,0,0,0,1037978,2023-12-22T00:00:00.000Z,167,30,Danilo Gallinari,0,0,0,0,0,0
0,0,0,0,0,0,0,0,0,0,0,0,0,0,0,0,1037978,2023-12-22T00:00:00.000Z,487,30,Delon Wright,0,0,0,0,0,0
4,0,2,0,0,5,2,3,3,20,2,1,7,4,1,0,1037978,2023-12-22T00:00:00.000Z,3547242,30,Deni Avdija,1,11,15,11,8,20.8
4,0,1,3,1,5,3,2,1,7,0,0,8,1,1,0,1037978,2023-12-22T00:00:00.000Z,18677954,30,Jared Butler,1,9,13,12,5,18.2
0,0,0,0,0,0,0,0,0,0,0,0,0,0,0,0,1037978,2023-12-22T00:00:00.000Z,38017687,30,Johnny Davis,0,0,0,0,0,0
3,0,2,12,3,21,7,9,8,27,1,3,25,3,2,1,1037978,2023-12-22T00:00:00.000Z,666848,30,Jordan Poole,2,28,31,28,6,38.1
3,0,9,5,1,11,3,1,0,25,0,2,7,9,0,3,1037978,2023-12-22T00:00:00.000Z,265,30,Kyle Kuzma,0,16,19,10,12,19.3
1,0,0,1,0,2,0,0,0,13,0,2,0,0,0,0,1037978,2023-12-22T00:00:00.000Z,414,30,Landry Shamet,0,0,1,1,1,1.5
0,0,4,1,0,5,1,0,0,14,2,2,2,6,0,1,1037978,2023-12-22T00:00:00.000Z,337,30,Mike Muscala,0,8,8,2,6,8.2
1,1,1,1,1,4,3,1,0,11,0,1,7,1,0,0,1037978,2023-12-22T00:00:00.000Z,38017712,30,Ryan Rollins,1,8,9,8,2,12.7
6,0,2,2,2,8,6,0,0,25,1,0,14,3,1,0,1037978,2023-12-22T00:00:00.000Z,249,30,Tyus Jones,1,17,23,20,9,29.6
0,0,0,0,0,2,1,0,0,3,1,0,2,1,0,0,1037979,2023-12-22T00:00:00.000Z,666451,24,Bol Bol,0,3,3,2,1,3.2
0,0,0,0,0,0,0,0,0,0,0,0,0,0,0,0,1037979,2023-12-22T00:00:00.000Z,37,24,Bradley Beal,0,0,0,0,0,0
0,0,3,2,0,6,3,4,4,13,1,1,10,4,0,1,1037979,2023-12-22T00:00:00.000Z,314,24,Chimezie Metu,0,14,14,10,4,13.8
0,0,0,0,0,0,0,0,0,0,0,0,0,0,0,0,1037979,2023-12-22T00:00:00.000Z,272,24,Damion Lee,0,0,0,0,0,0
7,0,2,3,0,20,9,9,6,36,2,1,24,4,0,0,1037979,2023-12-22T00:00:00.000Z,57,24,Devin Booker,0,28,35,31,11,39.3
0,0,1,0,0,3,1,0,0,15,1,2,2,2,1,2,1037979,2023-12-22T00:00:00.000Z,147,24,Drew Eubanks,1,4,4,2,2,5.4
2,1,2,6,3,10,4,0,0,30,2,1,11,4,3,1,1037979,2023-12-22T00:00:00.000Z,8,24,Grayson Allen,4,15,17,13,6,29.8
0,0,1,1,0,6,1,2,1,14,2,2,3,3,1,1,1037979,2023-12-22T00:00:00.000Z,18678058,24,Jordan Goodwin,1,6,6,3,3,8.6
0,0,0,0,0,0,0,0,0,0,0,0,0,0,0,0,1037979,2023-12-22T00:00:00.000Z,356,24,Josh Okogie,0,0,0,0,0,0
0,0,0,0,0,0,0,0,0,0,0,0,0,0,0,0,1037979,2023-12-22T00:00:00.000Z,349,24,Jusuf Nurkic,0,0,0,0,0,0
0,0,0,0,0,0,0,0,0,0,0,0,0,0,0,0,1037979,2023-12-22T00:00:00.000Z,32,24,Keita Bates-Diop,0,0,0,0,0,0
2,0,7,3,2,14,9,9,8,34,0,0,28,7,1,7,1037979,2023-12-22T00:00:00.000Z,140,24,Kevin Durant,1,35,37,30,9,35.4
0,0,0,3,0,8,3,0,0,16,0,3,6,0,1,1,1037979,2023-12-22T00:00:00.000Z,666729,24,Nassir Little,1,6,6,6,0,8
4,1,2,3,0,8,2,2,2,20,1,2,6,3,0,1,1037979,2023-12-22T00:00:00.000Z,3547298,24,Saben Lee,1,9,13,10,7,17.6
0,0,0,0,0,0,0,0,0,0,0,0,0,0,0,0,1037979,2023-12-22T00:00:00.000Z,3547253,24,Theo Maledon,0,0,0,0,0,0
0,1,6,0,0,5,5,2,1,22,5,4,11,11,1,1,1037979,2023-12-22T00:00:00.000Z,3547095,24,Udoka Azubuike,2,22,22,11,11,29.2
0,0,2,3,0,4,1,0,0,12,0,2,2,2,0,0,1037979,2023-12-22T00:00:00.000Z,470,24,Yuta Watanabe,0,4,4,2,2,4.4
0,0,0,1,0,2,0,0,0,2,1,0,0,1,0,0,1037979,2023-12-22T00:00:00.000Z,17896030,26,Chris Duarte,0,1,1,0,1,1.2
7,2,6,6,2,17,9,4,3,32,0,2,23,6,3,2,1037979,2023-12-22T00:00:00.000Z,161,26,De'Aaron Fox,5,29,36,30,13,53.7
11,0,10,2,0,15,12,5,4,35,1,3,28,11,0,3,1037979,2023-12-22T00:00:00.000Z,406,26,Domantas Sabonis,0,39,50,39,22,54.7
0,1,1,8,4,10,5,6,5,37,0,2,19,1,2,0,1037979,2023-12-22T00:00:00.000Z,30,26,Harrison Barnes,3,20,20,19,1,29.2
0,0,1,0,0,2,1,4,3,11,0,3,5,1,0,1,1037979,2023-12-22T00:00:00.000Z,306,26,JaVale McGee,0,6,6,5,1,5.2
2,0,4,7,3,13,8,2,2,33,1,3,21,5,0,1,1037979,2023-12-22T00:00:00.000Z,38017688,26,Keegan Murray,0,26,28,23,7,29
1,1,2,2,0,3,0,2,1,17,1,3,1,3,1,0,1037979,2023-12-22T00:00:00.000Z,38017714,26,Keon Ellis,2,4,5,2,4,12.1
0,0,0,1,0,1,0,0,0,2,0,0,0,0,0,0,1037979,2023-12-22T00:00:00.000Z,17896044,26,Kessler Edwards,0,0,0,0,0,0
5,0,1,6,2,9,5,1,1,27,1,1,13,2,1,1,1037979,2023-12-22T00:00:00.000Z,221,26,Kevin Huerter,1,15,20,18,7,24.9
0,0,3,0,0,1,0,0,0,12,1,1,0,4,0,1,1037979,2023-12-22T00:00:00.000Z,290,26,Trey Lyles,0,4,4,0,4,3.8
0,0,0,0,0,0,0,0,0,1,0,0,0,0,0,0,1037980,2023-12-23T00:00:00.000Z,38017733,17,A.J. Green,0,0,0,0,0,0
2,0,0,0,0,0,0,0,0,11,2,1,0,2,0,1,1037980,2023-12-23T00:00:00.000Z,56677852,17,Andre Jackson Jr.,0,2,4,2,4,4.4
1,0,9,4,3,14,9,2,2,27,2,4,23,11,2,2,1037980,2023-12-23T00:00:00.000Z,377,17,Bobby Portis,2,34,35,24,12,41.7
1,1,2,2,0,7,1,4,3,35,1,3,5,3,0,0,1037980,2023-12-23T00:00:00.000Z,283,17,Brook Lopez,1,8,9,6,4,13.1
1,0,1,1,1,2,2,4,3,14,0,0,8,1,0,0,1037980,2023-12-23T00:00:00.000Z,368,17,Cameron Payne,0,9,10,9,2,10.7
0,0,0,0,0,0,0,0,0,1,0,0,0,0,0,0,1037980,2023-12-23T00:00:00.000Z,56677854,17,Chris Livingston,0,0,0,0,0,0
7,0,6,7,3,16,6,5,4,33,3,3,19,9,1,3,1037980,2023-12-23T00:00:00.000Z,278,17,Damian Lillard,1,28,35,26,16,40.3
7,1,5,0,0,17,11,8,6,32,2,4,28,7,1,5,1037980,2023-12-23T00:00:00.000Z,15,17,Giannis Antetokounmpo,2,35,42,35,14,47.9
0,0,0,0,0,0,0,0,0,0,0,0,0,0,0,0,1037980,2023-12-23T00:00:00.000Z,112,17,Jae Crowder,0,0,0,0,0,0
5,0,4,4,2,16,9,0,0,32,1,4,20,5,0,3,1037980,2023-12-23T00:00:00.000Z,315,17,Khris Middleton,0,25,30,25,10,30.5
0,0,0,0,0,0,0,0,0,0,0,0,0,0,0,0,1037980,2023-12-23T00:00:00.000Z,666960,17,Lindell Wigginton,0,0,0,0,0,0
1,0,5,9,5,13,7,0,0,31,1,3,19,6,0,0,1037980,2023-12-23T00:00:00.000Z,38,17,Malik Beasley,0,25,26,20,7,27.7
0,0,1,0,0,0,0,0,0,1,0,0,0,1,0,0,1037980,2023-12-23T00:00:00.000Z,38017676,17,MarJon Beauchamp,0,1,1,0,1,1.2
0,0,0,0,0,0,0,0,0,0,0,0,0,0,0,0,1037980,2023-12-23T00:00:00.000Z,666453,17,Marques Bolden,0,0,0,0,0,0
0,0,8,5,2,6,3,0,0,22,0,0,8,8,0,0,1037980,2023-12-23T00:00:00.000Z,105,17,Pat Connaughton,0,16,16,8,8,17.6
0,0,0,0,0,0,0,0,0,0,0,0,0,0,0,0,1037980,2023-12-23T00:00:00.000Z,284,17,Robin Lopez,0,0,0,0,0,0
0,0,0,0,0,0,0,0,0,0,0,0,0,0,0,0,1037980,2023-12-23T00:00:00.000Z,2148,17,Thanasis Antetokounmpo,0,0,0,0,0,0
0,0,0,0,0,0,0,0,0,0,0,0,0,0,0,0,1037980,2023-12-23T00:00:00.000Z,38017691,17,TyTy Washington Jr.,0,0,0,0,0,0
0,0,0,1,0,1,0,0,0,1,0,0,0,0,0,0,1037980,2023-12-23T00:00:00.000Z,666474,20,Charles Brown,0,0,0,0,0,0
0,0,0,0,0,0,0,0,0,0,0,0,0,0,0,0,1037980,2023-12-23T00:00:00.000Z,666675,20,DaQuan Jeffries,0,0,0,0,0,0
0,0,0,0,0,0,0,0,0,0,0,0,0,0,0,0,1037980,2023-12-23T00:00:00.000Z,160,20,Evan Fournier,0,0,0,0,0,0
1,0,2,5,1,8,2,2,2,22,0,1,7,2,0,1,1037980,2023-12-23T00:00:00.000Z,3547269,20,Immanuel Quickley,0,9,10,8,3,9.9
0,0,0,0,0,0,0,0,0,1,0,0,0,0,0,0,1037980,2023-12-23T00:00:00.000Z,56677795,20,Jacob Toppin,0,0,0,0,0,0
0,0,0,0,0,0,0,0,0,0,0,0,0,0,0,0,1037980,2023-12-23T00:00:00.000Z,17896063,20,Jericho Sims,0,0,0,0,0,0
3,0,2,3,0,6,1,0,0,26,0,3,2,2,1,1,1037980,2023-12-23T00:00:00.000Z,202,20,Josh Hart,1,4,7,5,5,10.9
0,0,1,0,0,0,0,0,0,1,0,0,0,1,0,0,1037980,2023-12-23T00:00:00.000Z,17896033,20,Miles McBride,0,1,1,0,1,1.2
0,0,0,0,0,0,0,0,0,0,0,0,0,0,0,0,1037980,2023-12-23T00:00:00.000Z,399,20,Mitchell Robinson,0,0,0,0,0,0
0,0,2,1,0,3,1,0,0,16,0,2,2,2,1,0,1037980,2023-12-23T00:00:00.000Z,17895858,20,Quentin Grimes,1,4,4,2,2,7.4
1,1,6,5,2,17,5,2,1,29,1,1,13,7,0,1,1037980,2023-12-23T00:00:00.000Z,666423,20,RJ Barrett,1,20,21,14,8,24.9
0,0,0,0,0,0,0,0,0,1,0,1,0,0,0,0,1037980,2023-12-23T00:00:00.000Z,19,20,Ryan Arcidiacono,0,0,0,0,0,0
5,2,7,5,2,6,2,0,0,27,0,2,6,7,1,0,1037981,2023-12-23T00:00:00.000Z,219,2,Al Horford,3,13,18,11,12,30.9
1,0,0,0,0,1,1,0,0,4,0,0,2,0,0,0,1037981,2023-12-23T00:00:00.000Z,17896094,2,Dalano Banton,0,2,3,3,1,3.5
3,3,3,10,3,12,5,5,5,29,0,2,18,3,0,2,1037981,2023-12-23T00:00:00.000Z,473,2,Derrick White,3,21,24,21,6,33.1
2,0,3,6,3,17,9,4,3,29,3,2,24,6,1,3,1037981,2023-12-23T00:00:00.000Z,70,2,Jaylen Brown,1,30,32,26,8,34.2
2,0,5,10,5,16,9,9,7,30,0,0,30,5,1,2,1037981,2023-12-23T00:00:00.000Z,434,2,Jayson Tatum,1,35,37,32,7,40
0,0,0,0,0,0,0,0,0,0,0,0,0,0,0,0,1037981,2023-12-23T00:00:00.000Z,56677864,2,Jordan Walsh,0,0,0,0,0,0
7,0,3,6,4,12,8,0,0,28,3,1,20,6,1,1,1037981,2023-12-23T00:00:00.000Z,214,2,Jrue Holiday,1,26,33,27,13,39.7
0,0,0,0,0,0,0,0,0,0,0,0,0,0,0,0,1037981,2023-12-23T00:00:00.000Z,378,2,Kristaps Porzingis,0,0,0,0,0,0
1,0,1,0,0,3,2,0,0,5,1,0,4,2,0,0,1037981,2023-12-23T00:00:00.000Z,3547279,2,Lamar Stevens,0,6,7,5,3,7.9
0,0,0,0,0,0,0,0,0,0,0,0,0,0,0,0,1037981,2023-12-23T00:00:00.000Z,261,2,Luke Kornet,0,0,0,0,0,0
3,0,6,0,0,7,4,8,6,23,6,5,14,12,0,1,1037981,2023-12-23T00:00:00.000Z,17553967,2,Neemias Queta,0,26,29,17,15,31.9
1,0,2,4,3,5,4,2,1,18,1,0,12,3,0,0,1037981,2023-12-23T00:00:00.000Z,666468,2,Oshae Brissett,0,15,16,13,4,17.1
3,0,3,5,3,8,3,0,0,23,1,3,9,4,0,0,1037981,2023-12-23T00:00:00.000Z,3547276,2,Payton Pritchard,0,13,16,12,7,18.3
4,0,2,5,1,5,1,0,0,19,0,3,3,2,0,0,1037981,2023-12-23T00:00:00.000Z,17896060,2,Sam Hauser,0,5,9,7,6,11.4
0,0,0,0,0,0,0,0,0,0,0,0,0,0,0,0,1037981,2023-12-23T00:00:00.000Z,338,2,Svi Mykhailiuk,0,0,0,0,0,0
1,0,2,1,0,3,1,0,0,17,0,0,2,2,0,1,1037981,2023-12-23T00:00:00.000Z,666511,13,Amir Coffey,0,4,5,3,3,4.9
0,0,2,4,1,6,3,6,6,13,1,1,13,3,0,0,1037981,2023-12-23T00:00:00.000Z,17896022,13,Brandon Boston Jr.,0,16,16,13,3,16.6
1,0,1,2,2,5,5,3,3,21,0,2,15,1,1,0,1037981,2023-12-23T00:00:00.000Z,439,13,Daniel Theis,1,16,17,16,2,20.7
0,1,5,0,0,9,7,2,2,27,5,3,16,10,0,2,1037981,2023-12-23T00:00:00.000Z,493,13,Ivica Zubac,1,26,26,16,10,29
9,0,4,5,2,13,6,0,0,29,0,4,14,4,1,4,1037981,2023-12-23T00:00:00.000Z,192,13,James Harden,1,18,27,23,13,31.3
0,0,0,0,0,0,0,0,0,0,0,0,0,0,0,0,1037981,2023-12-23T00:00:00.000Z,56677856,13,Jordan Miller,0,0,0,0,0,0
0,0,0,0,0,0,0,0,0,0,0,0,0,0,0,0,1037981,2023-12-23T00:00:00.000Z,17896051,13,Joshua Primo,0,0,0,0,0,0
0,0,0,0,0,0,0,0,0,0,0,0,0,0,0,0,1037981,2023-12-23T00:00:00.000Z,274,13,Kawhi Leonard,0,0,0,0,0,0
4,0,2,2,2,2,2,0,0,25,0,3,6,2,1,0,1037981,2023-12-23T00:00:00.000Z,56677849,13,Kobe Brown,1,8,12,10,6,17.4
0,0,0,0,0,0,0,0,0,0,0,0,0,0,0,0,1037981,2023-12-23T00:00:00.000Z,371,13,Mason Plumlee,0,0,0,0,0,0
0,0,0,0,0,0,0,0,0,0,0,0,0,0,0,0,1037981,2023-12-23T00:00:00.000Z,38017725,13,Moussa Diabate,0,0,0,0,0,0
0,0,0,2,0,4,1,0,0,8,0,0,2,0,0,0,1037981,2023-12-23T00:00:00.000Z,17896031,13,Nah'Shon Hyland,0,2,2,2,0,2
0,0,0,3,1,9,3,0,0,25,0,5,7,0,0,1,1037981,2023-12-23T00:00:00.000Z,380,13,Norman Powell,0,7,7,7,0,6
2,2,2,7,3,17,9,0,0,30,1,1,21,3,1,1,1037981,2023-12-23T00:00:00.000Z,172,13,Paul George,3,24,26,23,5,35.6
0,0,0,0,0,0,0,0,0,0,0,0,0,0,0,0,1037981,2023-12-23T00:00:00.000Z,450,13,PJ Tucker,0,0,0,0,0,0
5,1,4,2,0,11,4,4,4,21,1,3,12,5,0,1,1037981,2023-12-23T00:00:00.000Z,472,13,Russell Westbrook,1,17,22,17,10,27.5
3,0,3,6,0,10,0,0,0,24,1,2,0,4,0,0,1037981,2023-12-23T00:00:00.000Z,666743,13,Terance Mann,0,4,7,3,7,9.3
0,0,0,0,0,0,0,0,0,0,0,0,0,0,0,0,1037981,2023-12-23T00:00:00.000Z,24417679,13,Xavier Moon,0,0,0,0,0,0
0,0,0,0,0,0,0,0,0,0,0,0,0,0,0,0,1037982,2023-12-23T00:00:00.000Z,347,4,Frank Ntilikina,0,0,0,0,0,0
4,2,6,0,0,7,4,0,0,31,0,2,8,6,1,4,1037982,2023-12-23T00:00:00.000Z,204,4,Gordon Hayward,3,14,18,12,10,26.2
0,0,0,0,0,0,0,0,0,0,0,0,0,0,0,0,1037982,2023-12-23T00:00:00.000Z,3547239,4,LaMelo Ball,0,0,0,0,0,0
0,0,0,0,0,0,0,0,0,0,0,0,0,0,0,0,1037982,2023-12-23T00:00:00.000Z,38017698,4,Mark Williams,0,0,0,0,0,0
2,2,7,7,1,20,6,9,7,28,1,1,20,8,4,2,1037982,2023-12-23T00:00:00.000Z,666950,4,P.J. Washington,6,28,30,22,10,48.6
0,0,0,0,0,0,0,0,0,0,0,0,0,0,0,0,1037982,2023-12-23T00:00:00.000Z,17896007,8,Braxton Key,0,0,0,0,0,0
0,0,0,0,0,0,0,0,0,0,0,0,0,0,0,0,1037982,2023-12-23T00:00:00.000Z,38017727,8,Collin Gillespie,0,0,0,0,0,0
0,0,0,0,0,0,0,0,0,0,0,0,0,0,0,0,1037982,2023-12-23T00:00:00.000Z,250,8,DeAndre Jordan,0,0,0,0,0,0
0,0,0,0,0,0,0,0,0,0,0,0,0,0,0,0,1037982,2023-12-23T00:00:00.000Z,56677871,8,Hunter Tyson,0,0,0,0,0,0
0,0,0,0,0,0,0,0,0,0,0,0,0,0,0,0,1037982,2023-12-23T00:00:00.000Z,56677582,8,Jalen Pickett,0,0,0,0,0,0
0,0,0,0,0,0,0,0,0,0,0,0,0,0,0,0,1037982,2023-12-23T00:00:00.000Z,17896103,8,Jay Huff,0,0,0,0,0,0
1,0,0,5,2,10,4,0,0,16,1,0,10,1,1,1,1037982,2023-12-23T00:00:00.000Z,56677776,8,Julian Strawther,1,11,12,11,2,14.7
0,0,0,0,0,0,0,0,0,0,0,0,0,0,0,0,1037982,2023-12-23T00:00:00.000Z,215,8,Justin Holiday,0,0,0,0,0,0
2,4,3,2,1,3,1,0,0,32,0,1,3,3,2,0,1037982,2023-12-23T00:00:00.000Z,81,8,Kentavious Caldwell-Pope,6,6,8,5,5,27.6
9,1,8,2,0,14,8,2,2,35,2,6,18,10,1,3,1037982,2023-12-23T00:00:00.000Z,246,8,Nikola Jokic,2,28,37,27,19,46.5
0,1,3,1,0,2,1,0,0,17,0,2,2,3,1,2,1037982,2023-12-23T00:00:00.000Z,38017721,8,Peyton Watson,2,5,5,2,3,9.6
4,0,3,3,0,9,1,0,0,15,0,3,2,3,1,2,1037982,2023-12-23T00:00:00.000Z,236,8,Reggie Jackson,1,5,9,6,7,12.6
0,0,0,0,0,0,0,0,0,0,0,0,0,0,0,0,1037982,2023-12-23T00:00:00.000Z,666489,8,Vlatko Cancar,0,0,0,0,0,0
1,2,0,0,0,1,0,0,0,12,2,4,0,2,0,1,1037982,2023-12-23T00:00:00.000Z,3547268,8,Zeke Nnaji,2,2,3,1,3,8.9
2,0,2,4,1,5,1,0,0,28,1,6,3,3,2,4,1037983,2023-12-23T00:00:00.000Z,3547250,12,Aaron Nesmith,2,6,8,5,5,11.6
5,0,0,1,1,10,8,0,0,36,1,2,17,1,0,1,1037983,2023-12-23T00:00:00.000Z,38017507,12,Andrew Nembhard,0,18,23,22,6,24.7
0,0,0,0,0,0,0,0,0,0,0,0,0,0,0,0,1037983,2023-12-23T00:00:00.000Z,56677861,12,Ben Sheppard,0,0,0,0,0,0
1,0,2,2,0,5,1,0,0,16,0,1,2,2,0,1,1037983,2023-12-23T00:00:00.000Z,38017686,12,Bennedict Mathurin,0,4,5,3,3,4.9
0,0,0,0,0,0,0,0,0,0,0,0,0,0,0,0,1037983,2023-12-23T00:00:00.000Z,69,12,Bruce Brown,0,0,0,0,0,0
0,0,1,0,0,2,0,0,0,6,2,4,0,3,0,0,1037983,2023-12-23T00:00:00.000Z,17896035,12,Isaiah Jackson,0,3,3,0,3,3.6
0,0,0,0,0,0,0,0,0,0,0,0,0,0,0,0,1037983,2023-12-23T00:00:00.000Z,56677794,12,Isaiah Wong,0,0,0,0,0,0
1,0,1,4,3,5,4,1,0,15,1,5,11,2,0,2,1037983,2023-12-23T00:00:00.000Z,3547264,12,Jalen Smith,0,13,14,12,3,12.9
0,0,0,0,0,0,0,0,0,0,0,0,0,0,0,0,1037983,2023-12-23T00:00:00.000Z,242,12,James Johnson,0,0,0,0,0,0
0,0,0,0,0,0,0,0,0,0,0,0,0,0,0,0,1037983,2023-12-23T00:00:00.000Z,56677832,12,Jarace Walker,0,0,0,0,0,0
0,0,0,0,0,0,0,0,0,0,0,0,0,0,0,0,1037983,2023-12-23T00:00:00.000Z,3547207,12,Jordan Nwora,0,0,0,0,0,0
0,0,0,0,0,0,0,0,0,0,0,0,0,0,0,0,1037983,2023-12-23T00:00:00.000Z,38017701,12,Kendall Brown,0,0,0,0,0,0
0,0,0,0,0,0,0,0,0,0,0,0,0,0,0,0,1037983,2023-12-23T00:00:00.000Z,56677778,12,Oscar Tshiebwe,0,0,0,0,0,0
2,0,0,0,0,1,0,2,1,7,0,0,1,0,0,1,1037983,2023-12-23T00:00:00.000Z,304,12,T.J. McConnell,0,1,3,3,2,3
14,0,2,5,3,22,12,3,2,40,0,2,29,2,3,3,1037983,2023-12-23T00:00:00.000Z,3547245,12,Tyrese Haliburton,3,31,45,43,16,58.4
0,0,5,2,0,14,8,8,8,36,1,4,24,6,1,1,1037983,2023-12-23T00:00:00.000Z,17896026,22,Franz Wagner,1,30,30,24,6,33.2
0,0,0,0,0,0,0,0,0,0,0,0,0,0,0,0,1037983,2023-12-23T00:00:00.000Z,17896073,22,Jalen Suggs,0,0,0,0,0,0
0,0,0,0,0,0,0,0,0,0,0,0,0,0,0,0,1037983,2023-12-23T00:00:00.000Z,226,22,Joe Ingles,0,0,0,0,0,0
4,0,6,0,0,20,11,16,12,36,1,1,34,7,1,3,1037983,2023-12-23T00:00:00.000Z,38017683,22,Paolo Banchero,1,41,45,38,11,48.4
0,0,0,0,0,0,0,0,0,0,0,0,0,0,0,0,1037983,2023-12-23T00:00:00.000Z,17553983,22,Trevelin Queen,0,0,0,0,0,0
1,0,1,2,1,2,1,2,2,15,0,0,5,1,1,1,1037984,2023-12-23T00:00:00.000Z,213,11,Aaron Holiday,1,6,7,6,2,9.7
2,0,2,1,0,3,1,0,0,21,1,1,2,3,0,0,1037984,2023-12-23T00:00:00.000Z,188,11,Jeff Green,0,5,7,4,5,8.6
0,0,0,0,0,0,0,0,0,0,0,0,0,0,0,0,1037984,2023-12-23T00:00:00.000Z,19465326,11,Jock Landale,0,0,0,0,0,0
0,0,0,0,0,0,0,0,0,0,0,0,0,0,0,0,1037984,2023-12-23T00:00:00.000Z,3547281,11,Nate Hinton,0,0,0,0,0,0
0,0,2,2,0,11,4,0,0,20,2,5,8,4,2,0,1037984,2023-12-23T00:00:00.000Z,38017695,11,Tari Eason,2,12,12,8,4,18.8
5,2,2,2,0,12,6,9,7,36,1,2,19,3,0,0,1037984,2023-12-23T00:00:00.000Z,227,19,Brandon Ingram,2,22,27,24,8,36.1
2,1,4,7,2,10,4,4,3,34,1,4,13,5,1,4,1037984,2023-12-23T00:00:00.000Z,303,19,CJ McCollum,2,18,20,15,7,24
0,0,0,0,0,0,0,0,0,0,0,0,0,0,0,0,1037984,2023-12-23T00:00:00.000Z,38017663,19,E.J. Liddell,0,0,0,0,0,0
1,0,0,4,2,8,2,0,0,18,3,1,6,3,0,0,1037984,2023-12-23T00:00:00.000Z,17896024,19,Herbert Jones,0,9,10,7,4,11.1
2,1,3,3,0,5,2,0,0,22,0,2,4,3,2,0,1037984,2023-12-23T00:00:00.000Z,17896021,19,Jeremiah Robinson-Earl,3,7,9,6,5,19.6
5,1,9,2,0,11,5,0,0,26,2,6,10,11,2,6,1037984,2023-12-23T00:00:00.000Z,455,19,Jonas Valanciunas,3,21,26,15,16,33.7
0,1,2,2,0,4,2,0,0,10,0,3,4,2,0,1,1037984,2023-12-23T00:00:00.000Z,17896097,19,Jose Alvarado,1,6,6,4,2,8.4
0,0,0,0,0,0,0,0,0,0,0,0,0,0,0,0,1037984,2023-12-23T00:00:00.000Z,340,19,Larry Nance Jr.,0,0,0,0,0,0
0,0,0,0,0,0,0,0,0,0,0,0,0,0,0,0,1037984,2023-12-23T00:00:00.000Z,17896017,19,Matt Ryan,0,0,0,0,0,0
2,0,1,0,0,2,2,3,2,12,1,1,6,2,0,0,1037984,2023-12-23T00:00:00.000Z,3547293,19,Naji Marshall,0,8,10,8,4,11.4
0,0,5,7,3,11,4,3,3,34,1,2,14,6,2,1,1037984,2023-12-23T00:00:00.000Z,18677986,19,Trey Murphy III,2,20,20,14,6,26.2
4,1,6,2,1,16,11,10,5,34,2,1,28,8,2,3,1037984,2023-12-23T00:00:00.000Z,666969,19,Zion Williamson,3,36,40,32,12,49.6
0,0,0,0,0,0,0,0,0,0,0,0,0,0,0,0,1037985,2023-12-23T00:00:00.000Z,38017689,1,AJ Griffin,0,0,0,0,0,0
3,0,3,8,2,15,6,3,2,34,1,2,16,4,0,0,1037985,2023-12-23T00:00:00.000Z,53,1,Bogdan Bogdanovic,0,20,23,19,7,25.3
0,0,0,0,0,0,0,0,0,0,0,0,0,0,0,0,1037985,2023-12-23T00:00:00.000Z,666564,1,Bruno Fernando,0,0,0,0,0,0
1,2,7,0,0,11,8,4,4,30,5,2,20,12,0,1,1037985,2023-12-23T00:00:00.000Z,83,1,Clint Capela,2,32,33,21,13,40.9
0,0,0,0,0,0,0,0,0,0,0,0,0,0,0,0,1037985,2023-12-23T00:00:00.000Z,666656,1,De'Andre Hunter,0,0,0,0,0,0
4,0,3,6,4,15,10,2,2,36,1,4,26,4,2,3,1037985,2023-12-23T00:00:00.000Z,334,1,Dejounte Murray,2,30,34,30,8,39.8
1,0,1,2,0,3,0,0,0,14,0,3,0,1,1,0,1037985,2023-12-23T00:00:00.000Z,666754,1,Garrison Mathews,1,1,2,1,2,5.7
0,0,0,0,0,0,0,0,0,0,0,0,0,0,0,0,1037985,2023-12-23T00:00:00.000Z,17896040,1,Jalen Johnson,0,0,0,0,0,0
0,0,0,0,0,0,0,0,0,0,0,0,0,0,0,0,1037985,2023-12-23T00:00:00.000Z,56677838,1,Kobe Bufkin,0,0,0,0,0,0
0,0,0,0,0,0,0,0,0,0,0,0,0,0,0,0,1037985,2023-12-23T00:00:00.000Z,56677806,1,Mouhamed Gueye,0,0,0,0,0,0
4,2,3,2,0,10,5,0,0,28,4,4,10,7,2,3,1037985,2023-12-23T00:00:00.000Z,3547244,1,Onyeka Okongwu,4,17,21,14,11,33.4
0,0,0,0,0,0,0,0,0,0,0,0,0,0,0,0,1037985,2023-12-23T00:00:00.000Z,319,1,Patty Mills,0,0,0,0,0,0
2,0,5,9,3,11,4,4,3,38,1,2,14,6,2,1,1037985,2023-12-23T00:00:00.000Z,3547256,1,Saddiq Bey,2,20,22,16,8,29.2
0,0,1,6,1,7,1,0,0,19,1,2,3,2,0,0,1037985,2023-12-23T00:00:00.000Z,56677855,1,Seth Lundy,0,5,5,3,2,5.4
13,1,5,10,3,24,11,7,5,41,0,3,30,5,1,2,1037985,2023-12-23T00:00:00.000Z,490,1,Trae Young,2,35,48,43,18,59.5
0,0,0,0,0,0,0,0,0,0,0,0,0,0,0,0,1037985,2023-12-23T00:00:00.000Z,3547297,1,Trent Forrest,0,0,0,0,0,0
0,0,0,0,0,0,0,0,0,0,0,0,0,0,0,0,1037985,2023-12-23T00:00:00.000Z,4197387,1,Vit Krejci,0,0,0,0,0,0
0,0,0,0,0,0,0,0,0,0,0,0,0,0,0,0,1037985,2023-12-23T00:00:00.000Z,301,1,Wesley Matthews,0,0,0,0,0,0
3,0,4,0,0,6,3,6,2,29,7,2,8,11,1,1,1037985,2023-12-23T00:00:00.000Z,48,15,Bismack Biyombo,1,19,22,11,14,27.7
0,0,0,0,0,0,0,0,0,0,0,0,0,0,0,0,1037985,2023-12-23T00:00:00.000Z,666505,15,Brandon Clarke,0,0,0,0,0,0
0,0,0,0,0,0,0,0,0,0,0,0,0,0,0,0,1037985,2023-12-23T00:00:00.000Z,38017729,15,David Roddy,0,0,0,0,0,0
0,0,0,0,0,0,0,0,0,0,0,0,0,0,0,0,1037985,2023-12-23T00:00:00.000Z,401,15,Derrick Rose,0,0,0,0,0,0
6,0,6,14,5,25,13,6,6,36,0,0,37,6,1,2,1037985,2023-12-23T00:00:00.000Z,3547287,15,Desmond Bane,1,43,49,43,12,54.2
0,0,0,0,0,0,0,0,0,0,0,0,0,0,0,0,1037985,2023-12-23T00:00:00.000Z,56677830,15,GG Jackson,0,0,0,0,0,0
11,2,6,3,1,25,14,1,1,36,0,1,30,6,1,3,1037985,2023-12-23T00:00:00.000Z,666786,15,Ja Morant,3,36,47,41,17,59.7
0,0,0,0,0,0,0,0,0,0,0,0,0,0,0,0,1037985,2023-12-23T00:00:00.000Z,48248287,15,Jacob Gilyard,0,0,0,0,0,0
0,0,0,0,0,0,0,0,0,0,0,0,0,0,0,0,1037985,2023-12-23T00:00:00.000Z,38017728,15,Jake LaRavia,0,0,0,0,0,0
0,0,0,2,1,10,8,4,3,24,2,5,20,2,0,2,1037985,2023-12-23T00:00:00.000Z,231,15,Jaren Jackson Jr.,0,22,22,20,2,20.4
2,2,4,2,1,3,2,0,0,13,1,1,5,5,0,0,1037985,2023-12-23T00:00:00.000Z,666703,15,John Konchar,2,10,12,7,7,20
0,0,0,0,0,0,0,0,0,0,0,0,0,0,0,0,1037985,2023-12-23T00:00:00.000Z,254,15,Luke Kennard,0,0,0,0,0,0
0,0,0,0,0,0,0,0,0,0,0,0,0,0,0,0,1037985,2023-12-23T00:00:00.000Z,420,15,Marcus Smart,0,0,0,0,0,0
3,1,4,4,1,7,2,2,1,27,0,0,6,4,0,1,1037985,2023-12-23T00:00:00.000Z,17896067,15,Santi Aldama,1,10,13,9,7,17.3
0,0,0,0,0,0,0,0,0,0,0,0,0,0,0,0,1037985,2023-12-23T00:00:00.000Z,3,15,Steven Adams,0,0,0,0,0,0
1,0,9,5,1,6,2,0,0,35,2,4,5,11,2,1,1037985,2023-12-23T00:00:00.000Z,38017731,15,Vince Williams Jr.,2,16,17,6,12,24.7
0,2,1,0,0,7,3,0,0,16,2,0,6,3,1,0,1037985,2023-12-23T00:00:00.000Z,3547285,15,Xavier Tillman,3,9,9,6,3,18.6
3,0,2,3,1,8,3,3,1,24,1,3,8,3,0,1,1037985,2023-12-23T00:00:00.000Z,17896027,15,Ziaire Williams,0,11,14,11,6,15.1
0,0,0,0,0,0,0,0,0,0,0,0,0,0,0,0,1037986,2023-12-23T00:00:00.000Z,9051997,3,Armoni Brooks,0,0,0,0,0,0
3,0,2,3,1,16,7,5,5,28,0,3,20,2,1,2,1037986,2023-12-23T00:00:00.000Z,17896048,3,Cam Thomas,1,22,25,23,5,27.9
2,0,2,5,2,10,6,4,4,28,0,3,18,2,2,1,1037986,2023-12-23T00:00:00.000Z,666679,3,Cameron Johnson,2,20,22,20,4,28.4
1,0,2,0,0,6,5,3,1,18,1,4,11,3,0,1,1037986,2023-12-23T00:00:00.000Z,17896038,3,Day'Ron Sharpe,0,14,15,12,4,15.1
3,0,0,2,1,6,2,2,1,19,0,3,6,0,0,1,1037986,2023-12-23T00:00:00.000Z,421,3,Dennis Smith Jr.,0,6,9,9,3,9.5
1,0,6,4,2,6,4,0,0,27,0,1,10,6,2,0,1037986,2023-12-23T00:00:00.000Z,158,3,Dorian Finney-Smith,2,16,17,11,7,24.7
0,0,0,0,0,0,0,0,0,1,0,0,0,0,0,0,1037986,2023-12-23T00:00:00.000Z,174,3,Harry Giles III,0,0,0,0,0,0
1,0,1,0,0,2,1,0,0,6,1,2,2,2,0,0,1037986,2023-12-23T00:00:00.000Z,56677722,3,Jalen Wilson,0,4,5,3,3,5.9
7,1,4,4,1,17,9,10,10,33,2,2,29,6,1,1,1037986,2023-12-23T00:00:00.000Z,61,3,Mikal Bridges,2,35,42,36,13,51.7
2,2,5,0,0,8,4,4,3,30,2,2,11,7,2,2,1037986,2023-12-23T00:00:00.000Z,666508,3,Nicolas Claxton,4,18,20,13,9,32.4
5,0,6,1,1,3,2,0,0,19,0,1,5,6,1,1,1037986,2023-12-23T00:00:00.000Z,351,3,Royce O'Neale,1,11,16,10,11,21.7
7,0,3,5,2,12,5,4,2,30,1,1,14,4,1,1,1037986,2023-12-23T00:00:00.000Z,130,3,Spencer Dinwiddie,1,18,25,21,11,31.3
0,0,0,0,0,0,0,0,0,1,0,0,0,0,0,0,1037986,2023-12-23T00:00:00.000Z,17896058,3,Trendon Watford,0,0,0,0,0,0
6,0,3,5,1,20,9,4,3,33,0,4,22,3,0,2,1037986,2023-12-23T00:00:00.000Z,17896075,9,Cade Cunningham,0,25,31,28,9,32.6
0,0,0,0,0,0,0,0,0,0,0,0,0,0,0,0,1037986,2023-12-23T00:00:00.000Z,17896071,9,Isaiah Livers,0,0,0,0,0,0
5,1,4,5,4,9,8,0,0,33,1,5,20,5,1,0,1037986,2023-12-23T00:00:00.000Z,3547267,9,Isaiah Stewart,2,25,30,25,10,39.5
7,2,6,6,3,11,6,10,8,35,0,4,23,6,0,3,1037986,2023-12-23T00:00:00.000Z,38017682,9,Jaden Ivey,2,29,36,30,13,43.7
0,0,0,0,0,0,0,0,0,0,0,0,0,0,0,0,1037986,2023-12-23T00:00:00.000Z,3547240,9,James Wiseman,0,0,0,0,0,0
0,0,0,0,0,0,0,0,0,0,0,0,0,0,0,0,1037986,2023-12-23T00:00:00.000Z,42097199,9,Jared Rhoden,0,0,0,0,0,0
0,0,1,3,3,6,5,1,1,24,0,2,14,1,0,0,1037986,2023-12-23T00:00:00.000Z,259,9,Kevin Knox,0,15,15,14,1,15.2
0,0,0,0,0,0,0,0,0,0,0,0,0,0,0,0,1037986,2023-12-23T00:00:00.000Z,56677729,9,Malcolm Cazalon,0,0,0,0,0,0
0,0,1,1,0,1,0,0,0,6,0,2,0,1,0,2,1037986,2023-12-23T00:00:00.000Z,56677792,9,Marcus Sasser,0,1,1,0,1,-0.8
0,0,0,0,0,0,0,0,0,0,0,0,0,0,0,0,1037986,2023-12-23T00:00:00.000Z,44477024,9,Stanley Umude,0,0,0,0,0,0
1,0,2,1,1,3,3,3,2,13,0,2,9,2,1,0,1037987,2023-12-23T00:00:00.000Z,58,28,Chris Boucher,1,11,12,10,3,15.9
0,0,0,9,4,12,6,0,0,28,0,0,16,0,1,2,1037987,2023-12-23T00:00:00.000Z,3089,28,Gary Trent Jr.,1,16,16,16,0,17
0,0,0,0,0,0,0,0,0,0,0,0,0,0,0,0,1037987,2023-12-23T00:00:00.000Z,56677828,28,Gradey Dick,0,0,0,0,0,0
0,0,0,0,0,0,0,0,0,0,0,0,0,0,0,0,1037987,2023-12-23T00:00:00.000Z,666762,28,Jalen McDaniels,0,0,0,0,0,0
6,0,2,3,1,3,1,0,0,14,0,1,3,2,0,0,1037987,2023-12-23T00:00:00.000Z,3547275,28,Malachi Flynn,0,5,11,9,8,14.4
0,0,0,0,0,0,0,0,0,0,0,0,0,0,0,0,1037988,2023-12-23T00:00:00.000Z,56677860,5,Adama Sanogo,0,0,0,0,0,0
0,0,4,0,0,0,0,2,1,13,2,4,1,6,1,1,1037988,2023-12-23T00:00:00.000Z,137,5,Andre Drummond,1,7,7,1,6,10.2
1,0,2,3,0,6,2,0,0,20,1,3,4,3,0,1,1037988,2023-12-23T00:00:00.000Z,17895983,5,Ayo Dosunmu,0,7,8,5,4,8.1
0,0,1,1,0,3,2,2,2,17,0,1,6,1,1,0,1037988,2023-12-23T00:00:00.000Z,38017719,5,Dalen Terry,1,7,7,6,1,10.2
0,0,0,0,0,0,0,0,0,0,0,0,0,0,0,0,1037988,2023-12-23T00:00:00.000Z,27,5,Lonzo Ball,0,0,0,0,0,0
0,0,0,0,0,0,0,0,0,0,0,0,0,0,0,0,1037988,2023-12-23T00:00:00.000Z,56677874,5,Onuralp Bitim,0,0,0,0,0,0
0,0,0,0,0,0,0,0,0,0,0,0,0,0,0,0,1037988,2023-12-23T00:00:00.000Z,17896116,5,Terry Taylor,0,0,0,0,0,0
0,0,0,0,0,0,0,0,0,0,0,0,0,0,0,0,1037988,2023-12-23T00:00:00.000Z,110,5,Torrey Craig,0,0,0,0,0,0
0,0,0,0,0,0,0,0,0,0,0,0,0,0,0,0,1037988,2023-12-23T00:00:00.000Z,268,5,Zach LaVine,0,0,0,0,0,0
0,0,0,0,0,0,0,0,0,0,0,0,0,0,0,0,1037988,2023-12-23T00:00:00.000Z,277,6,Caris LeVert,0,0,0,0,0,0
8,1,6,3,1,14,8,5,2,39,1,1,19,7,1,3,1037988,2023-12-23T00:00:00.000Z,56677872,6,Craig Porter,2,26,34,27,15,42.4
1,0,2,2,1,4,2,1,1,12,0,5,6,2,1,1,1037988,2023-12-23T00:00:00.000Z,248,6,Damian Jones,1,8,9,7,3,11.9
1,0,6,10,3,12,4,0,0,36,1,1,11,7,2,1,1037988,2023-12-23T00:00:00.000Z,666940,6,Dean Wade,2,18,19,12,8,25.9
0,1,0,2,1,2,1,0,0,9,0,0,3,0,0,0,1037988,2023-12-23T00:00:00.000Z,56677847,6,Emoni Bates,1,3,3,3,0,6
0,0,4,5,1,12,3,0,0,21,1,4,7,5,0,2,1037988,2023-12-23T00:00:00.000Z,344,6,Georges Niang,0,12,12,7,5,11
3,0,3,5,0,9,3,7,6,34,0,2,12,3,0,1,1037988,2023-12-23T00:00:00.000Z,3547247,6,Isaac Okoro,0,15,18,15,6,19.1
0,0,0,0,0,0,0,0,0,0,0,0,0,0,0,0,1037988,2023-12-23T00:00:00.000Z,38017662,6,Isaiah Mobley,0,0,0,0,0,0
7,1,9,1,0,9,6,10,7,35,8,0,19,17,1,0,1037988,2023-12-23T00:00:00.000Z,9,6,Jarrett Allen,2,36,43,26,24,55.9
7,1,1,17,5,22,9,3,3,41,0,2,26,1,2,3,1037988,2023-12-23T00:00:00.000Z,666908,6,Max Strus,3,27,34,33,8,43.7
0,0,0,0,0,0,0,0,0,0,0,0,0,0,0,0,1037988,2023-12-23T00:00:00.000Z,3547299,6,Sam Merrill,0,0,0,0,0,0
0,0,0,0,0,0,0,0,0,0,0,0,0,0,0,0,1037989,2023-12-23T00:00:00.000Z,56677867,14,Alex Fudge,0,0,0,0,0,0
10,0,3,5,2,8,4,1,1,28,0,3,11,3,0,1,1037989,2023-12-23T00:00:00.000Z,17553995,14,Austin Reaves,0,14,24,21,13,28.6
0,0,0,0,0,0,0,0,0,0,0,0,0,0,0,0,1037989,2023-12-23T00:00:00.000Z,486,14,Christian Wood,0,0,0,0,0,0
0,0,0,0,0,0,0,0,0,0,0,0,0,0,0,0,1037989,2023-12-23T00:00:00.000Z,56677738,14,Colin Castleton,0,0,0,0,0,0
3,0,1,6,3,9,5,3,2,17,0,1,15,1,0,1,1037989,2023-12-23T00:00:00.000Z,405,14,D'Angelo Russell,0,16,19,18,4,19.7
0,0,0,0,0,0,0,0,0,0,0,0,0,0,0,0,1037989,2023-12-23T00:00:00.000Z,56677868,14,D'Moi Hodge,0,0,0,0,0,0
0,0,0,0,0,0,0,0,0,0,0,0,0,0,0,0,1037989,2023-12-23T00:00:00.000Z,1603383,14,Gabe Vincent,0,0,0,0,0,0
7,2,5,5,5,20,13,9,9,37,2,0,40,7,2,3,1037989,2023-12-23T00:00:00.000Z,237,14,LeBron James,4,47,54,47,14,67.9
1,0,0,0,0,1,0,0,0,6,1,0,0,1,0,1,1037989,2023-12-23T00:00:00.000Z,17896078,21,Aaron Wiggins,0,1,2,1,2,1.7
4,0,2,4,1,6,2,0,0,24,1,2,5,3,1,0,1037989,2023-12-23T00:00:00.000Z,56677833,21,Cason Wallace,1,8,12,9,7,17.6
0,3,6,6,1,18,8,5,2,34,4,1,19,10,1,0,1037989,2023-12-23T00:00:00.000Z,38017685,21,Chet Holmgren,4,29,29,19,10,43
1,0,1,2,1,2,1,0,0,11,0,0,3,1,0,0,1037989,2023-12-23T00:00:00.000Z,44,21,Davis Bertans,0,4,5,4,2,5.7
1,2,4,6,1,11,3,0,0,20,1,1,7,5,1,1,1037989,2023-12-23T00:00:00.000Z,3547272,21,Isaiah Joe,3,12,13,8,6,22.5
3,0,6,5,2,17,11,4,4,34,0,3,28,6,0,1,1037989,2023-12-23T00:00:00.000Z,38017703,21,Jalen Williams,0,34,37,31,9,38.7
1,0,2,1,0,1,0,0,0,6,0,1,0,2,0,0,1037989,2023-12-23T00:00:00.000Z,38017706,21,Jaylin Williams,0,2,3,1,3,3.9
0,0,0,0,0,0,0,0,0,0,0,0,0,0,0,0,1037989,2023-12-23T00:00:00.000Z,17896065,21,Josh Giddey,0,0,0,0,0,0
5,1,1,4,3,6,4,0,0,23,1,2,11,2,1,1,1037989,2023-12-23T00:00:00.000Z,480,21,Kenrich Williams,2,13,18,16,7,25.9
0,0,0,0,0,0,0,0,0,0,0,0,0,0,0,0,1037989,2023-12-23T00:00:00.000Z,27924547,21,Lindy Waters III,0,0,0,0,0,0
0,1,4,6,2,9,3,0,0,30,1,2,8,5,0,2,1037989,2023-12-23T00:00:00.000Z,666541,21,Luguentz Dort,1,13,13,8,5,15
1,0,1,0,0,0,0,0,0,3,1,1,0,2,0,0,1037989,2023-12-23T00:00:00.000Z,24572055,21,Olivier Sarr,0,2,3,1,3,3.9
0,0,0,2,1,3,2,0,0,11,0,2,5,0,0,0,1037989,2023-12-23T00:00:00.000Z,38017716,21,Ousmane Dieng,0,5,5,5,0,5
7,0,4,5,1,21,12,10,9,38,1,2,34,5,2,3,1037989,2023-12-23T00:00:00.000Z,175,21,Shai Gilgeous-Alexander,2,39,46,41,12,53.5
0,0,0,0,0,0,0,0,0,0,0,0,0,0,0,0,1037989,2023-12-23T00:00:00.000Z,17896036,21,Tre Mann,0,0,0,0,0,0
0,0,0,0,0,0,0,0,0,0,0,0,0,0,0,0,1037989,2023-12-23T00:00:00.000Z,4197029,21,Vasilije Micic,0,0,0,0,0,0
3,0,4,4,3,10,7,0,0,31,3,2,17,7,2,1,1037990,2023-12-23T00:00:00.000Z,17554004,7,AJ Lawson,2,24,27,20,10,34.9
4,1,5,2,2,10,8,2,2,32,2,1,20,7,0,3,1037990,2023-12-23T00:00:00.000Z,151,7,Dante Exum,1,27,31,24,11,34.4
0,0,0,0,0,0,0,0,0,0,0,0,0,0,0,0,1037990,2023-12-23T00:00:00.000Z,56677840,7,Dereck Lively II,0,0,0,0,0,0
1,0,2,5,3,7,4,0,0,24,2,2,11,4,0,0,1037990,2023-12-23T00:00:00.000Z,247,7,Derrick Jones Jr.,0,15,16,12,5,17.3
0,1,2,2,0,2,0,0,0,5,0,1,0,2,0,3,1037990,2023-12-23T00:00:00.000Z,56677873,7,Dexter Dennis,1,2,2,0,2,2.4
1,1,2,0,0,5,5,4,4,22,2,4,14,4,1,0,1037990,2023-12-23T00:00:00.000Z,379,7,Dwight Powell,2,18,19,15,5,26.3
3,0,2,6,4,8,5,0,0,25,0,3,14,2,0,1,1037990,2023-12-23T00:00:00.000Z,666965,7,Grant Williams,0,16,19,17,5,19.9
0,1,0,0,0,1,0,0,0,5,0,1,0,0,0,2,1037990,2023-12-23T00:00:00.000Z,17896028,7,Greg Brown III,1,0,0,0,0,1
1,0,6,4,1,7,1,4,3,22,0,1,6,6,3,0,1037990,2023-12-23T00:00:00.000Z,38017679,7,Jaden Hardy,3,12,13,7,7,23.7
0,0,0,0,0,0,0,0,0,0,0,0,0,0,0,0,1037990,2023-12-23T00:00:00.000Z,3547258,7,Josh Green,0,0,0,0,0,0
0,0,0,0,0,0,0,0,0,0,0,0,0,0,0,0,1037990,2023-12-23T00:00:00.000Z,228,7,Kyrie Irving,0,0,0,0,0,0
10,1,10,10,5,27,13,11,8,32,2,1,39,12,1,2,1037990,2023-12-23T00:00:00.000Z,132,7,Luka Doncic,2,51,61,49,22,72.4
0,0,0,0,0,0,0,0,0,0,0,0,0,0,0,0,1037990,2023-12-23T00:00:00.000Z,329,7,Markieff Morris,0,0,0,0,0,0
0,0,0,0,0,0,0,0,0,0,0,0,0,0,0,0,1037990,2023-12-23T00:00:00.000Z,257,7,Maxi Kleber,0,0,0,0,0,0
0,0,2,1,0,3,0,0,0,12,0,1,0,2,0,0,1037990,2023-12-23T00:00:00.000Z,56677859,7,Olivier-Maxence Prosper,0,2,2,0,2,2.4
0,0,0,0,0,0,0,0,0,0,0,0,0,0,0,0,1037990,2023-12-23T00:00:00.000Z,217,7,Richaun Holmes,0,0,0,0,0,0
0,0,0,0,0,0,0,0,0,0,0,0,0,0,0,0,1037990,2023-12-23T00:00:00.000Z,114,7,Seth Curry,0,0,0,0,0,0
3,0,1,0,0,3,2,2,1,12,0,1,5,1,3,0,1037990,2023-12-23T00:00:00.000Z,38017693,27,Blake Wesley,3,6,9,8,4,19.7
2,0,0,2,1,3,1,0,0,10,0,1,3,0,0,0,1037990,2023-12-23T00:00:00.000Z,359,27,Cedi Osman,0,3,5,5,2,6
0,0,0,0,0,0,0,0,0,0,0,0,0,0,0,0,1037990,2023-12-23T00:00:00.000Z,17895854,27,Charles Bassey,0,0,0,0,0,0
0,0,0,0,0,0,0,0,0,0,0,0,0,0,0,0,1037990,2023-12-23T00:00:00.000Z,56677865,27,Charles Bediako,0,0,0,0,0,0
0,0,0,0,0,0,0,0,0,0,0,0,0,0,0,0,1037990,2023-12-23T00:00:00.000Z,17896049,27,David Duke Jr.,0,0,0,0,0,0
5,0,0,6,0,13,3,3,3,30,0,1,9,0,0,0,1037990,2023-12-23T00:00:00.000Z,3547246,27,Devin Vassell,0,9,14,14,5,16.5
0,0,5,2,0,3,0,0,0,8,0,0,0,5,0,0,1037990,2023-12-23T00:00:00.000Z,180,27,Devonte' Graham,0,5,5,0,5,6
0,0,0,0,0,0,0,0,0,0,0,0,0,0,0,0,1037990,2023-12-23T00:00:00.000Z,38017730,27,Dominick Barlow,0,0,0,0,0,0
0,0,0,0,0,0,0,2,0,6,0,0,0,0,0,0,1037990,2023-12-23T00:00:00.000Z,305,27,Doug McDermott,0,0,0,0,0,0
4,0,7,6,4,16,9,2,1,30,2,2,23,9,0,3,1037990,2023-12-23T00:00:00.000Z,38017699,27,Jeremy Sochan,0,32,36,27,13,36.8
1,0,5,4,2,6,4,2,2,22,0,0,12,5,1,0,1037990,2023-12-23T00:00:00.000Z,38017649,27,Julian Champagnie,1,17,18,13,6,22.5
2,0,3,8,2,16,6,4,2,23,2,2,16,5,0,2,1037990,2023-12-23T00:00:00.000Z,666682,27,Keldon Johnson,0,21,23,18,7,23
4,0,3,4,1,11,5,1,1,24,0,2,12,3,0,1,1037990,2023-12-23T00:00:00.000Z,38017692,27,Malaki Branham,0,15,19,16,7,20.6
3,1,2,3,1,6,4,6,5,15,3,1,14,5,0,1,1037990,2023-12-23T00:00:00.000Z,17896059,27,Sandro Mamukelashvili,1,19,22,17,8,26.5
0,0,3,2,0,3,0,2,2,14,0,2,2,3,2,0,1037990,2023-12-23T00:00:00.000Z,56677817,27,Sidy Cissoko,2,5,5,2,3,11.6
4,0,1,4,1,8,4,0,0,18,0,1,9,1,1,1,1037990,2023-12-23T00:00:00.000Z,3547274,27,Tre Jones,1,10,14,13,5,18.2
0,0,0,0,0,0,0,0,0,0,0,0,0,0,0,0,1037990,2023-12-23T00:00:00.000Z,56677822,27,Victor Wembanyama,0,0,0,0,0,0
4,2,4,4,2,10,6,0,0,28,1,3,14,5,2,2,1037990,2023-12-23T00:00:00.000Z,102,27,Zach Collins,4,19,23,18,9,36
0,0,0,0,0,0,0,0,0,0,0,0,0,0,0,0,1037991,2023-12-23T00:00:00.000Z,475,10,Andrew Wiggins,0,0,0,0,0,0
7,1,9,5,1,12,7,0,0,32,1,1,15,10,1,2,1037991,2023-12-23T00:00:00.000Z,56677858,10,Brandin Podziemski,2,25,32,22,17,41.5
11,0,3,2,0,4,1,0,0,26,0,1,2,3,3,1,1037991,2023-12-23T00:00:00.000Z,367,10,Chris Paul,3,5,16,13,14,30.1
1,0,0,1,0,1,0,0,0,4,0,0,0,0,0,1,1037991,2023-12-23T00:00:00.000Z,251,10,Cory Joseph,0,0,1,1,1,0.5
1,0,3,2,0,7,3,2,2,19,2,2,8,5,1,1,1037991,2023-12-23T00:00:00.000Z,407,10,Dario Saric,1,13,14,9,6,17.5
0,0,0,0,0,0,0,0,0,0,0,0,0,0,0,0,1037991,2023-12-23T00:00:00.000Z,185,10,Draymond Green,0,0,0,0,0,0
0,0,0,0,0,0,0,0,0,0,0,0,0,0,0,0,1037991,2023-12-23T00:00:00.000Z,2189,10,Gary Payton II,0,0,0,0,0,0
0,0,1,0,0,0,0,2,2,4,1,0,2,2,0,0,1037991,2023-12-23T00:00:00.000Z,57875092,10,Gui Santos,0,4,4,2,2,4.4
0,0,0,2,0,2,0,4,3,4,0,0,3,0,0,0,1037991,2023-12-23T00:00:00.000Z,398,10,Jerome Robinson,0,3,3,3,0,3
5,0,5,2,0,7,3,5,5,30,1,0,11,6,0,0,1037991,2023-12-23T00:00:00.000Z,17553979,10,Jonathan Kuminga,0,17,22,16,11,25.7
7,0,5,0,0,3,2,2,2,22,6,2,6,11,0,3,1037991,2023-12-23T00:00:00.000Z,282,10,Kevon Looney,0,17,24,13,18,26.7
0,0,0,0,0,0,0,0,0,0,0,0,0,0,0,0,1037991,2023-12-23T00:00:00.000Z,45658838,10,Lester Quinones,0,0,0,0,0,0
1,1,1,2,1,6,4,2,2,17,0,3,11,1,1,2,1037991,2023-12-23T00:00:00.000Z,17553992,10,Moses Moody,2,12,13,12,2,17.7
2,0,3,7,2,18,11,3,3,30,0,1,27,3,0,1,1037991,2023-12-23T00:00:00.000Z,115,10,Stephen Curry,0,30,32,29,5,32.6
3,0,4,0,0,7,6,4,1,17,1,2,13,5,1,2,1037991,2023-12-23T00:00:00.000Z,56677799,10,Trayce Jackson-Davis,1,18,21,16,8,24.5
0,0,0,0,0,0,0,0,0,4,0,1,0,0,1,0,1037991,2023-12-23T00:00:00.000Z,17896070,10,Usman Garuba,1,0,0,0,0,3
2,0,2,13,7,17,7,4,4,34,0,0,25,2,1,1,1037991,2023-12-23T00:00:00.000Z,419,25,Anfernee Simons,1,27,29,27,4,32.4
2,0,5,0,0,12,6,3,1,29,1,2,13,6,3,1,1037991,2023-12-23T00:00:00.000Z,22,25,Deandre Ayton,3,19,21,15,8,31.2
0,0,1,2,0,2,0,0,0,9,0,3,0,1,0,0,1037991,2023-12-23T00:00:00.000Z,56783340,25,Duop Reath,0,1,1,0,1,1.2
0,0,0,0,0,0,0,0,0,0,0,0,0,0,0,0,1037991,2023-12-23T00:00:00.000Z,39613724,25,Ibou Badji,0,0,0,0,0,0
0,0,1,1,1,1,1,0,0,4,0,1,3,1,0,0,1037991,2023-12-23T00:00:00.000Z,17896120,25,Ish Wainright,0,4,4,3,1,4.2
0,1,3,2,0,4,2,2,1,18,2,2,5,5,0,1,1037991,2023-12-23T00:00:00.000Z,38017711,25,Jabari Walker,1,10,10,5,5,13
3,0,1,4,1,12,5,8,6,32,1,3,17,2,0,2,1037991,2023-12-23T00:00:00.000Z,182,25,Jerami Grant,0,19,22,20,5,21.9
0,0,0,0,0,0,0,0,0,0,0,0,0,0,0,0,1037991,2023-12-23T00:00:00.000Z,47957121,25,Justin Minaya,0,0,0,0,0,0
0,0,1,0,0,1,1,0,0,5,1,2,2,2,1,0,1037991,2023-12-23T00:00:00.000Z,56677791,25,Kris Murray,1,4,4,2,2,7.4
12,1,4,4,1,14,8,0,0,37,2,2,17,6,3,2,1037991,2023-12-23T00:00:00.000Z,65,25,Malcolm Brogdon,4,23,35,29,18,52.2
2,0,1,5,1,6,2,0,0,16,1,0,5,2,1,0,1037991,2023-12-23T00:00:00.000Z,666923,25,Matisse Thybulle,1,7,9,7,4,13.4
0,0,0,0,0,0,0,0,0,0,0,0,0,0,0,0,1037991,2023-12-23T00:00:00.000Z,666476,25,Moses Brown,0,0,0,0,0,0
2,0,0,0,0,1,0,0,0,4,0,0,0,0,0,0,1037991,2023-12-23T00:00:00.000Z,56677829,25,Rayan Rupert,0,0,2,2,2,3
0,0,0,0,0,0,0,0,0,0,0,0,0,0,0,0,1037991,2023-12-23T00:00:00.000Z,476,25,Robert Williams III,0,0,0,0,0,0
2,0,1,4,2,9,4,4,2,23,0,4,12,1,3,2,1037991,2023-12-23T00:00:00.000Z,56677747,25,Scoot Henderson,3,13,15,14,3,23.2
1,0,0,0,0,2,0,2,1,5,0,0,1,0,0,1,1037991,2023-12-23T00:00:00.000Z,3547289,25,Skylar Mays,0,1,2,2,1,1.5
0,1,2,0,0,3,2,2,2,24,0,1,6,2,1,1,1037991,2023-12-23T00:00:00.000Z,56677850,25,Toumani Camara,2,8,8,6,2,13.4
10,1,5,12,3,27,13,5,5,39,0,1,34,5,1,5,1037992,2023-12-23T00:00:00.000Z,3547238,18,Anthony Edwards,2,39,49,44,15,56
0,0,0,0,0,0,0,0,0,0,0,0,0,0,0,0,1037992,2023-12-23T00:00:00.000Z,17895968,18,Daishen Nix,0,0,0,0,0,0
1,1,5,9,3,16,8,2,1,41,0,4,20,5,4,0,1037992,2023-12-23T00:00:00.000Z,3547259,18,Jaden McDaniels,5,25,26,21,6,42.5
0,0,0,0,0,0,0,0,0,0,0,0,0,0,0,0,1037992,2023-12-23T00:00:00.000Z,56677851,18,Jaylen Clark,0,0,0,0,0,0
2,0,0,0,0,0,0,0,0,1,0,0,0,0,0,0,1037992,2023-12-23T00:00:00.000Z,666767,18,Jordan McLaughlin,0,0,2,2,2,3
0,0,0,0,0,0,0,0,0,0,0,0,0,0,0,0,1037992,2023-12-23T00:00:00.000Z,38017715,18,Josh Minott,0,0,0,0,0,0
5,1,4,0,0,9,4,2,2,29,1,4,10,5,0,2,1037992,2023-12-23T00:00:00.000Z,12,18,Kyle Anderson,1,15,20,15,10,24.5
0,0,0,0,0,0,0,0,0,0,0,0,0,0,0,0,1037992,2023-12-23T00:00:00.000Z,56677782,18,Leonard Miller,0,0,0,0,0,0
0,0,0,0,0,0,0,0,0,0,0,0,0,0,0,0,1037992,2023-12-23T00:00:00.000Z,17896056,18,Luka Garza,0,0,0,0,0,0
9,0,7,7,3,10,4,1,1,32,0,1,12,7,2,2,1037992,2023-12-23T00:00:00.000Z,104,18,Mike Conley,2,19,28,21,16,37.9
2,0,2,1,0,4,2,2,2,19,0,0,6,2,2,1,1037992,2023-12-23T00:00:00.000Z,667378,18,Naz Reid,2,8,10,8,4,16.4
0,0,0,2,0,4,1,0,0,23,0,2,2,0,0,0,1037992,2023-12-23T00:00:00.000Z,666400,18,Nickeil Alexander-Walker,0,2,2,2,0,2
1,2,11,0,0,13,10,2,1,39,6,3,21,17,0,1,1037992,2023-12-23T00:00:00.000Z,176,18,Rudy Gobert,2,38,39,22,18,47.9
1,0,1,2,1,4,2,0,0,14,0,0,5,1,0,1,1037992,2023-12-23T00:00:00.000Z,320,18,Shake Milton,0,6,7,6,2,6.7
0,0,1,0,0,0,0,0,0,3,0,3,0,1,0,0,1037992,2023-12-23T00:00:00.000Z,68,18,Troy Brown Jr.,0,1,1,0,1,1.2
0,0,0,0,0,0,0,0,0,0,0,0,0,0,0,0,1037992,2023-12-23T00:00:00.000Z,38017700,18,Wendell Moore Jr.,0,0,0,0,0,0
0,0,1,1,0,1,0,0,0,8,0,1,0,1,1,0,1037992,2023-12-23T00:00:00.000Z,4197162,26,Aleksandar Vezenkov,1,1,1,0,1,4.2
0,0,0,0,0,0,0,0,0,0,0,0,0,0,0,0,1037992,2023-12-23T00:00:00.000Z,273,26,Alex Len,0,0,0,0,0,0
0,0,3,3,1,3,1,0,0,18,1,1,3,4,2,1,1037992,2023-12-23T00:00:00.000Z,17896030,26,Chris Duarte,2,7,7,3,4,12.8
0,0,1,0,0,0,0,0,0,2,0,0,0,1,0,0,1037992,2023-12-23T00:00:00.000Z,56677845,26,Colby Jones,0,1,1,0,1,1.2
0,0,0,0,0,0,0,0,0,0,0,0,0,0,0,0,1037992,2023-12-23T00:00:00.000Z,17553994,26,Davion Mitchell,0,0,0,0,0,0
6,0,2,11,3,23,10,4,4,39,2,1,27,4,2,3,1037992,2023-12-23T00:00:00.000Z,161,26,De'Aaron Fox,2,31,37,33,10,43.8
10,0,9,1,0,12,7,5,3,39,1,3,17,10,1,3,1037992,2023-12-23T00:00:00.000Z,406,26,Domantas Sabonis,1,27,37,27,20,44
1,0,3,2,0,6,3,6,6,31,0,3,12,3,0,0,1037992,2023-12-23T00:00:00.000Z,30,26,Harrison Barnes,0,15,16,13,4,17.1
0,0,0,0,0,0,0,0,0,0,0,0,0,0,0,0,1037992,2023-12-23T00:00:00.000Z,56677862,26,Jalen Slawson,0,0,0,0,0,0
1,1,2,0,0,6,3,1,1,9,0,2,7,2,1,1,1037992,2023-12-23T00:00:00.000Z,306,26,JaVale McGee,2,9,10,8,3,15.9
0,0,0,0,0,0,0,0,0,0,0,0,0,0,0,0,1037992,2023-12-23T00:00:00.000Z,17895990,26,Jordan Ford,0,0,0,0,0,0
0,0,0,0,0,0,0,0,0,0,0,0,0,0,0,0,1037992,2023-12-23T00:00:00.000Z,666925,26,Juan Toscano-Anderson,0,0,0,0,0,0
0,1,6,7,3,16,8,2,1,40,1,4,20,7,3,1,1037992,2023-12-23T00:00:00.000Z,38017688,26,Keegan Murray,4,27,27,20,7,39.4
0,0,0,0,0,0,0,0,0,1,0,0,0,0,0,0,1037992,2023-12-23T00:00:00.000Z,17896044,26,Kessler Edwards,0,0,0,0,0,0
1,0,1,2,0,7,1,0,0,15,0,3,2,1,0,1,1037992,2023-12-23T00:00:00.000Z,221,26,Kevin Huerter,0,3,4,3,2,3.7
0,0,0,0,0,0,0,0,0,0,0,0,0,0,0,0,1037992,2023-12-23T00:00:00.000Z,324,26,Malik Monk,0,0,0,0,0,0
3,0,4,4,1,8,4,3,1,27,3,1,10,7,0,1,1037992,2023-12-23T00:00:00.000Z,290,26,Trey Lyles,0,17,20,13,10,21.9
0,0,0,0,0,0,0,0,0,0,0,0,0,0,0,0,1037993,2023-12-25T00:00:00.000Z,38017733,17,A.J. Green,0,0,0,0,0,0
0,0,0,0,0,0,0,0,0,0,0,0,0,0,0,0,1037993,2023-12-25T00:00:00.000Z,56677854,17,Chris Livingston,0,0,0,0,0,0
0,0,0,0,0,0,0,0,0,0,0,0,0,0,0,0,1037993,2023-12-25T00:00:00.000Z,112,17,Jae Crowder,0,0,0,0,0,0
0,0,0,0,0,0,0,0,0,0,0,0,0,0,0,0,1037993,2023-12-25T00:00:00.000Z,666960,17,Lindell Wigginton,0,0,0,0,0,0
0,0,0,0,0,0,0,0,0,0,0,0,0,0,0,0,1037993,2023-12-25T00:00:00.000Z,666453,17,Marques Bolden,0,0,0,0,0,0
0,0,0,0,0,0,0,0,0,0,0,0,0,0,0,0,1037993,2023-12-25T00:00:00.000Z,284,17,Robin Lopez,0,0,0,0,0,0
0,0,0,0,0,0,0,0,0,0,0,0,0,0,0,0,1037993,2023-12-25T00:00:00.000Z,38017691,17,TyTy Washington Jr.,0,0,0,0,0,0
0,0,0,0,0,0,0,0,0,0,0,0,0,0,0,0,1037993,2023-12-25T00:00:00.000Z,666474,20,Charles Brown,0,0,0,0,0,0
0,0,0,0,0,0,0,0,0,0,0,0,0,0,0,0,1037993,2023-12-25T00:00:00.000Z,666675,20,DaQuan Jeffries,0,0,0,0,0,0
4,0,1,5,1,6,1,0,0,21,0,4,3,1,1,1,1037993,2023-12-25T00:00:00.000Z,131,20,Donte DiVincenzo,1,4,8,7,5,12.2
0,0,0,0,0,0,0,0,0,0,0,0,0,0,0,0,1037993,2023-12-25T00:00:00.000Z,160,20,Evan Fournier,0,0,0,0,0,0
1,0,0,4,2,10,7,4,4,22,0,1,20,0,1,1,1037993,2023-12-25T00:00:00.000Z,3547269,20,Immanuel Quickley,1,20,21,21,1,23.5
4,1,4,0,0,7,5,2,1,33,4,4,11,8,0,0,1037993,2023-12-25T00:00:00.000Z,201,20,Isaiah Hartenstein,1,19,23,15,12,29.6
6,0,3,3,1,28,15,9,7,37,1,0,38,4,1,0,1037993,2023-12-25T00:00:00.000Z,73,20,Jalen Brunson,1,42,48,44,10,54.8
4,0,9,2,0,7,5,0,0,31,0,1,10,9,2,2,1037993,2023-12-25T00:00:00.000Z,202,20,Josh Hart,2,19,23,14,13,30.8
2,0,8,5,2,17,8,6,6,41,1,3,24,9,1,4,1037993,2023-12-25T00:00:00.000Z,387,20,Julius Randle,1,33,35,26,11,36.8
0,0,0,0,0,0,0,0,0,0,0,0,0,0,0,0,1037993,2023-12-25T00:00:00.000Z,17896033,20,Miles McBride,0,0,0,0,0,0
2,0,1,1,0,2,1,1,0,12,0,0,2,1,0,0,1037993,2023-12-25T00:00:00.000Z,17895858,20,Quentin Grimes,0,3,5,4,3,6.2
1,0,5,5,2,14,8,4,3,28,1,3,21,6,1,3,1037993,2023-12-25T00:00:00.000Z,666423,20,RJ Barrett,1,27,28,22,7,29.7
0,0,0,0,0,0,0,0,0,0,0,0,0,0,0,0,1037993,2023-12-25T00:00:00.000Z,19,20,Ryan Arcidiacono,0,0,0,0,0,0
3,3,3,1,0,1,0,0,0,15,0,2,0,3,0,0,1037993,2023-12-25T00:00:00.000Z,173,20,Taj Gibson,3,3,6,3,6,17.1
0,0,0,0,0,0,0,0,0,0,0,0,0,0,0,0,1037994,2023-12-25T00:00:00.000Z,38017727,8,Collin Gillespie,0,0,0,0,0,0
0,0,0,0,0,0,0,0,0,0,0,0,0,0,0,0,1037994,2023-12-25T00:00:00.000Z,17896103,8,Jay Huff,0,0,0,0,0,0
2,1,2,4,2,11,7,6,6,29,1,5,22,3,0,2,1037994,2023-12-25T00:00:00.000Z,475,10,Andrew Wiggins,1,25,27,24,5,29.6
6,0,5,4,3,7,4,2,2,34,4,1,13,9,5,2,1037994,2023-12-25T00:00:00.000Z,56677858,10,Brandin Podziemski,5,22,28,19,15,45.8
3,0,2,5,3,10,5,0,0,28,1,1,13,3,0,1,1037994,2023-12-25T00:00:00.000Z,367,10,Chris Paul,0,16,19,16,6,20.1
0,0,0,0,0,0,0,0,0,0,0,0,0,0,0,0,1037994,2023-12-25T00:00:00.000Z,251,10,Cory Joseph,0,0,0,0,0,0
2,0,3,3,0,11,5,4,4,20,2,2,14,5,0,0,1037994,2023-12-25T00:00:00.000Z,407,10,Dario Saric,0,19,21,16,7,23
0,0,0,0,0,0,0,0,0,0,0,0,0,0,0,0,1037994,2023-12-25T00:00:00.000Z,185,10,Draymond Green,0,0,0,0,0,0
0,0,0,0,0,0,0,0,0,0,0,0,0,0,0,0,1037994,2023-12-25T00:00:00.000Z,2189,10,Gary Payton II,0,0,0,0,0,0
0,0,0,0,0,0,0,0,0,0,0,0,0,0,0,0,1037994,2023-12-25T00:00:00.000Z,57875092,10,Gui Santos,0,0,0,0,0,0
0,0,0,0,0,0,0,0,0,0,0,0,0,0,0,0,1037994,2023-12-25T00:00:00.000Z,398,10,Jerome Robinson,0,0,0,0,0,0
2,0,5,1,0,8,4,8,5,23,0,1,13,5,0,1,1037994,2023-12-25T00:00:00.000Z,17553979,10,Jonathan Kuminga,0,18,20,15,7,21
2,0,3,0,0,3,2,0,0,22,0,3,4,3,0,1,1037994,2023-12-25T00:00:00.000Z,282,10,Kevon Looney,0,7,9,6,5,9.6
1,1,6,10,3,12,3,0,0,32,0,1,9,6,1,3,1037994,2023-12-25T00:00:00.000Z,443,10,Klay Thompson,2,15,16,10,7,20.7
0,0,0,0,0,0,0,0,0,0,0,0,0,0,0,0,1037994,2023-12-25T00:00:00.000Z,45658838,10,Lester Quinones,0,0,0,0,0,0
0,0,0,0,0,0,0,0,0,3,0,0,0,0,0,0,1037994,2023-12-25T00:00:00.000Z,17553992,10,Moses Moody,0,0,0,0,0,0
4,1,1,13,3,21,7,1,1,34,1,4,18,2,1,3,1037994,2023-12-25T00:00:00.000Z,115,10,Stephen Curry,2,20,24,22,6,29.4
1,0,3,0,0,4,3,2,2,15,0,5,8,3,0,0,1037994,2023-12-25T00:00:00.000Z,56677799,10,Trayce Jackson-Davis,0,11,12,9,4,13.1
0,0,0,0,0,0,0,0,0,0,0,0,0,0,0,0,1037994,2023-12-25T00:00:00.000Z,17896070,10,Usman Garuba,0,0,0,0,0,0
1,1,6,4,2,4,2,0,0,23,0,3,6,6,0,0,1037995,2023-12-25T00:00:00.000Z,219,2,Al Horford,1,12,13,7,7,17.7
0,0,0,0,0,0,0,0,0,0,0,0,0,0,0,0,1037995,2023-12-25T00:00:00.000Z,17896094,2,Dalano Banton,0,0,0,0,0,0
11,2,2,4,2,13,8,0,0,35,0,3,18,2,2,2,1037995,2023-12-25T00:00:00.000Z,473,2,Derrick White,4,20,31,29,13,46.9
7,1,5,5,3,10,7,1,1,38,2,1,18,7,1,2,1037995,2023-12-25T00:00:00.000Z,214,2,Jrue Holiday,2,25,32,25,14,40.9
1,0,1,0,0,0,0,0,0,7,0,3,0,1,1,0,1037995,2023-12-25T00:00:00.000Z,17553967,2,Neemias Queta,1,1,2,1,2,5.7
0,0,0,6,2,8,4,0,0,13,2,1,10,2,0,0,1037995,2023-12-25T00:00:00.000Z,3547276,2,Payton Pritchard,0,12,12,10,2,12.4
0,0,1,4,0,5,1,0,0,15,1,0,2,2,0,0,1037995,2023-12-25T00:00:00.000Z,17896060,2,Sam Hauser,0,4,4,2,2,4.4
0,0,0,1,1,2,1,2,2,18,0,2,5,0,0,2,1037995,2023-12-25T00:00:00.000Z,666860,14,Cameron Reddish,0,5,5,5,0,3
0,0,2,0,0,5,3,0,0,23,4,4,6,6,1,0,1037995,2023-12-25T00:00:00.000Z,457,14,Jarred Vanderbilt,1,12,12,6,6,16.2
5,3,12,0,0,15,9,12,8,36,3,1,26,15,0,4,1037996,2023-12-25T00:00:00.000Z,4,16,Bam Adebayo,3,41,46,31,20,56.5
1,0,4,0,0,0,0,2,1,9,1,1,1,5,0,2,1037996,2023-12-25T00:00:00.000Z,666747,16,Caleb Martin,0,6,7,2,6,6.5
0,0,0,0,0,0,0,0,0,0,0,0,0,0,0,0,1037996,2023-12-25T00:00:00.000Z,38017736,16,Cole Swider,0,0,0,0,0,0
0,0,0,0,0,0,0,0,0,0,0,0,0,0,0,0,1037996,2023-12-25T00:00:00.000Z,19465585,16,Dru Smith,0,0,0,0,0,0
2,0,4,10,5,13,5,1,1,34,0,3,16,4,1,0,1037996,2023-12-25T00:00:00.000Z,397,16,Duncan Robinson,1,20,22,18,6,26.8
0,0,0,0,0,0,0,0,0,0,0,0,0,0,0,0,1037996,2023-12-25T00:00:00.000Z,3092,16,Haywood Highsmith,0,0,0,0,0,0
1,0,5,3,1,15,11,8,8,40,5,3,31,10,2,0,1037996,2023-12-25T00:00:00.000Z,56677785,16,Jaime Jaquez Jr.,2,41,42,32,11,50.5
0,1,4,0,0,2,0,4,3,17,1,4,3,5,0,0,1037996,2023-12-25T00:00:00.000Z,38017734,16,Jamal Cain,1,8,8,3,5,12
0,0,0,0,0,0,0,0,0,0,0,0,0,0,0,0,1037996,2023-12-25T00:00:00.000Z,79,16,Jimmy Butler,0,0,0,0,0,0
0,0,0,0,0,0,0,0,0,0,0,0,0,0,0,0,1037996,2023-12-25T00:00:00.000Z,391,16,Josh Richardson,0,0,0,0,0,0
5,0,9,2,1,3,2,4,3,16,1,0,8,10,0,1,1037996,2023-12-25T00:00:00.000Z,285,16,Kevin Love,0,18,23,13,15,26.5
4,1,1,3,1,7,5,1,1,33,0,4,12,1,1,3,1037996,2023-12-25T00:00:00.000Z,286,16,Kyle Lowry,2,13,17,16,5,22.2
0,0,0,0,0,0,0,0,0,0,0,0,0,0,0,0,1037996,2023-12-25T00:00:00.000Z,38017696,16,Nikola Jovic,0,0,0,0,0,0
0,0,0,0,0,0,0,0,0,0,0,0,0,0,0,0,1037996,2023-12-25T00:00:00.000Z,39398582,16,Orlando Robinson,0,0,0,0,0,0
4,0,0,3,0,4,0,0,0,17,0,0,0,0,0,0,1037996,2023-12-25T00:00:00.000Z,3547257,16,R.J. Hampton,0,0,4,4,4,6
0,0,0,0,0,0,0,0,0,0,0,0,0,0,0,0,1037996,2023-12-25T00:00:00.000Z,74,16,Thomas Bryant,0,0,0,0,0,0
5,1,4,11,4,25,8,3,2,38,2,1,22,6,1,4,1037996,2023-12-25T00:00:00.000Z,666633,16,Tyler Herro,2,28,33,27,11,38.7
0,0,0,2,0,3,0,2,1,6,0,0,1,0,1,1,1037996,2023-12-25T00:00:00.000Z,2175,23,Danuel House Jr.,1,1,1,1,0,3
5,1,5,9,2,17,5,3,3,36,2,2,15,7,4,0,1037996,2023-12-25T00:00:00.000Z,313,23,De'Anthony Melton,5,22,27,20,12,45.9
0,0,0,0,0,0,0,0,0,0,0,0,0,0,0,0,1037996,2023-12-25T00:00:00.000Z,260,23,Furkan Korkmaz,0,0,0,0,0,0
0,0,0,0,0,0,0,0,0,1,0,0,0,0,0,0,1037996,2023-12-25T00:00:00.000Z,17896025,23,Jaden Springer,0,0,0,0,0,0
0,0,0,0,0,0,0,0,0,0,0,0,0,0,0,0,1037996,2023-12-25T00:00:00.000Z,145,23,Joel Embiid,0,0,0,0,0,0
3,1,6,9,6,16,9,3,1,40,1,3,25,7,1,1,1037996,2023-12-25T00:00:00.000Z,360,23,Kelly Oubre Jr.,2,32,35,28,10,42.9
0,0,0,0,0,0,0,0,0,0,0,0,0,0,0,0,1037996,2023-12-25T00:00:00.000Z,38017732,23,Kenneth Lofton Jr.,0,0,0,0,0,0
1,0,0,0,0,1,1,0,0,6,0,0,2,0,1,0,1037996,2023-12-25T00:00:00.000Z,3547294,23,Kenyon Martin Jr.,1,2,3,3,1,6.5
0,0,1,3,0,4,0,0,0,11,0,1,0,1,0,0,1037996,2023-12-25T00:00:00.000Z,328,23,Marcus Morris,0,1,1,0,1,1.2
2,0,5,3,3,8,7,2,1,25,1,2,18,6,2,1,1037996,2023-12-25T00:00:00.000Z,28,23,Mo Bamba,2,24,26,20,8,33.2
0,0,0,0,0,0,0,0,0,0,0,0,0,0,0,0,1037996,2023-12-25T00:00:00.000Z,33,23,Nicolas Batum,0,0,0,0,0,0
0,0,3,3,1,4,2,4,4,13,0,2,9,3,0,2,1037996,2023-12-25T00:00:00.000Z,45,23,Patrick Beverley,0,12,12,9,3,10.6
1,1,2,1,0,3,2,2,0,17,0,5,4,2,0,0,1037996,2023-12-25T00:00:00.000Z,3547270,23,Paul Reed,1,6,7,5,3,10.9
0,0,0,0,0,0,0,0,0,0,0,0,0,0,0,0,1037996,2023-12-25T00:00:00.000Z,56913527,23,Ricky Council IV,0,0,0,0,0,0
0,0,0,0,0,0,0,0,0,0,0,0,0,0,0,0,1037996,2023-12-25T00:00:00.000Z,108,23,Robert Covington,0,0,0,0,0,0
0,0,0,0,0,0,0,0,0,0,0,0,0,0,0,0,1037996,2023-12-25T00:00:00.000Z,56677788,23,Terquavion Smith,0,0,0,0,0,0
6,0,6,7,4,18,10,3,3,42,1,3,27,7,1,2,1037996,2023-12-25T00:00:00.000Z,200,23,Tobias Harris,1,34,40,33,13,45.4
5,1,3,8,1,20,4,6,3,43,0,4,12,3,1,0,1037996,2023-12-25T00:00:00.000Z,3547254,23,Tyrese Maxey,2,15,20,17,8,29.1
0,0,1,2,0,2,0,0,0,5,0,0,0,1,0,0,1037997,2023-12-25T00:00:00.000Z,17554004,7,AJ Lawson,0,1,1,0,1,1.2
5,0,3,4,1,7,3,0,0,33,1,3,7,4,1,3,1037997,2023-12-25T00:00:00.000Z,151,7,Dante Exum,1,11,16,12,9,19.3
1,0,7,0,0,9,8,9,4,32,3,3,20,10,0,1,1037997,2023-12-25T00:00:00.000Z,56677840,7,Dereck Lively II,0,30,31,21,11,32.5
1,0,1,8,3,18,9,4,2,35,2,3,23,3,1,0,1037997,2023-12-25T00:00:00.000Z,247,7,Derrick Jones Jr.,1,26,27,24,4,31.1
0,0,0,0,0,0,0,0,0,0,0,0,0,0,0,0,1037997,2023-12-25T00:00:00.000Z,56677873,7,Dexter Dennis,0,0,0,0,0,0
2,0,1,0,0,2,2,0,0,7,0,1,4,1,0,0,1037997,2023-12-25T00:00:00.000Z,379,7,Dwight Powell,0,5,7,6,3,8.2
1,3,3,2,0,3,1,2,1,27,0,4,3,3,0,2,1037997,2023-12-25T00:00:00.000Z,666965,7,Grant Williams,3,6,7,4,4,15.1
0,0,0,0,0,0,0,0,0,0,0,0,0,0,0,0,1037997,2023-12-25T00:00:00.000Z,17896028,7,Greg Brown III,0,0,0,0,0,0
1,0,2,3,1,4,1,0,0,13,0,0,3,2,0,0,1037997,2023-12-25T00:00:00.000Z,38017679,7,Jaden Hardy,0,5,6,4,3,6.9
0,0,0,0,0,0,0,0,0,0,0,0,0,0,0,0,1037997,2023-12-25T00:00:00.000Z,3547258,7,Josh Green,0,0,0,0,0,0
0,0,0,0,0,0,0,0,0,0,0,0,0,0,0,0,1037997,2023-12-25T00:00:00.000Z,228,7,Kyrie Irving,0,0,0,0,0,0
14,3,5,16,8,25,15,12,12,43,1,2,50,6,4,4,1037997,2023-12-25T00:00:00.000Z,132,7,Luka Doncic,7,56,70,64,20,95.2
0,0,0,0,0,0,0,0,0,0,0,0,0,0,0,0,1037997,2023-12-25T00:00:00.000Z,329,7,Markieff Morris,0,0,0,0,0,0
0,0,0,0,0,0,0,0,0,0,0,0,0,0,0,0,1037997,2023-12-25T00:00:00.000Z,257,7,Maxi Kleber,0,0,0,0,0,0
0,0,0,0,0,0,0,0,0,1,0,0,0,0,0,0,1037997,2023-12-25T00:00:00.000Z,56677859,7,Olivier-Maxence Prosper,0,0,0,0,0,0
0,0,0,0,0,0,0,0,0,0,0,0,0,0,0,0,1037997,2023-12-25T00:00:00.000Z,217,7,Richaun Holmes,0,0,0,0,0,0
0,0,0,0,0,0,0,0,0,6,1,0,0,1,0,0,1037997,2023-12-25T00:00:00.000Z,114,7,Seth Curry,0,1,1,0,1,1.2
2,0,7,9,3,14,6,3,3,38,0,4,18,7,1,1,1037997,2023-12-25T00:00:00.000Z,191,7,Tim Hardaway Jr.,1,25,27,20,9,31.4
2,0,13,6,2,18,9,4,3,34,6,1,23,19,1,3,1037997,2023-12-25T00:00:00.000Z,314,24,Chimezie Metu,1,42,44,25,21,48.8
10,1,3,4,1,14,6,10,7,40,0,5,20,3,1,3,1037997,2023-12-25T00:00:00.000Z,57,24,Devin Booker,2,23,33,30,13,41.6
0,0,5,0,0,3,1,0,0,17,2,3,2,7,1,1,1037997,2023-12-25T00:00:00.000Z,147,24,Drew Eubanks,1,9,9,2,7,12.4
2,0,1,7,2,12,6,0,0,37,0,3,14,1,0,0,1037997,2023-12-25T00:00:00.000Z,178,24,Eric Gordon,0,15,17,16,3,18.2
4,0,3,17,8,22,12,0,0,39,1,4,32,4,1,2,1037997,2023-12-25T00:00:00.000Z,8,24,Grayson Allen,1,36,40,36,8,43.8
1,0,0,1,0,3,0,2,2,11,3,0,2,3,0,0,1037997,2023-12-25T00:00:00.000Z,18678058,24,Jordan Goodwin,0,5,6,3,4,7.1
2,0,1,3,0,5,0,2,1,12,1,2,1,2,1,0,1037997,2023-12-25T00:00:00.000Z,356,24,Josh Okogie,1,3,5,3,4,9.4
0,0,0,0,0,0,0,0,0,0,0,0,0,0,0,0,1037997,2023-12-25T00:00:00.000Z,349,24,Jusuf Nurkic,0,0,0,0,0,0
7,1,7,3,1,11,4,7,7,43,1,2,16,8,0,6,1037997,2023-12-25T00:00:00.000Z,140,24,Kevin Durant,1,24,31,23,15,33.1
0,0,0,0,0,0,0,0,0,3,0,1,0,0,0,0,1037997,2023-12-25T00:00:00.000Z,666729,24,Nassir Little,0,0,0,0,0,0
0,0,0,0,0,0,0,0,0,0,0,0,0,0,0,0,1037997,2023-12-25T00:00:00.000Z,3547253,24,Theo Maledon,0,0,0,0,0,0
0,0,0,0,0,2,2,0,0,4,0,0,4,0,0,0,1037997,2023-12-25T00:00:00.000Z,3547095,24,Udoka Azubuike,0,4,4,4,0,4
0,0,0,0,0,0,0,0,0,0,0,0,0,0,0,0,1037998,2023-12-26T00:00:00.000Z,9051997,3,Armoni Brooks,0,0,0,0,0,0
0,0,0,0,0,0,0,0,0,0,0,0,0,0,0,0,1037998,2023-12-26T00:00:00.000Z,174,3,Harry Giles III,0,0,0,0,0,0
0,0,0,0,0,0,0,0,0,0,0,0,0,0,0,0,1037998,2023-12-26T00:00:00.000Z,56677722,3,Jalen Wilson,0,0,0,0,0,0
0,0,0,0,0,0,0,0,0,0,0,0,0,0,0,0,1037998,2023-12-26T00:00:00.000Z,56677843,3,Noah Clowney,0,0,0,0,0,0
0,0,0,0,0,0,0,0,0,0,0,0,0,0,0,0,1037998,2023-12-26T00:00:00.000Z,17896058,3,Trendon Watford,0,0,0,0,0,0
0,0,4,6,2,11,4,6,5,25,1,1,15,5,0,2,1037998,2023-12-26T00:00:00.000Z,77,9,Alec Burks,0,20,20,15,5,19
2,0,3,9,3,19,9,3,2,39,0,6,23,3,0,4,1037998,2023-12-26T00:00:00.000Z,54,9,Bojan Bogdanovic,0,26,28,25,5,25.6
5,1,8,4,3,21,15,10,8,37,1,4,41,9,1,3,1037998,2023-12-26T00:00:00.000Z,17896075,9,Cade Cunningham,2,50,55,46,14,62.3
4,0,7,2,1,7,2,4,2,36,4,2,7,11,0,0,1037998,2023-12-26T00:00:00.000Z,3547267,9,Isaiah Stewart,0,18,22,11,15,26.2
4,1,1,2,0,12,3,6,3,28,2,5,9,3,3,1,1037998,2023-12-26T00:00:00.000Z,38017682,9,Jaden Ivey,4,12,16,13,7,29.6
4,1,10,0,0,11,6,0,0,33,5,3,12,15,1,1,1037998,2023-12-26T00:00:00.000Z,38017694,9,Jalen Duren,2,27,31,16,19,41
0,0,0,0,0,0,0,0,0,0,0,0,0,0,0,0,1037998,2023-12-26T00:00:00.000Z,197,9,Joe Harris,0,0,0,0,0,0
0,0,0,0,0,0,0,0,0,0,0,0,0,0,0,0,1037998,2023-12-26T00:00:00.000Z,24,9,Marvin Bagley III,0,0,0,0,0,0
1,0,5,6,4,13,9,1,1,33,1,4,23,6,4,5,1037999,2023-12-26T00:00:00.000Z,56677827,22,Anthony Black,4,29,30,24,7,38.7
0,0,1,0,0,0,0,0,0,12,0,0,0,1,0,0,1037999,2023-12-26T00:00:00.000Z,38017724,22,Caleb Houstan,0,1,1,0,1,1.2
0,0,0,0,0,0,0,0,0,0,0,0,0,0,0,0,1037999,2023-12-26T00:00:00.000Z,666818,22,Chuma Okeke,0,0,0,0,0,0
4,0,3,3,1,11,4,2,2,23,0,2,11,3,1,1,1037999,2023-12-26T00:00:00.000Z,3547251,22,Cole Anthony,1,14,18,15,7,22.6
1,0,0,1,1,2,1,0,0,19,0,3,3,0,1,1,1037999,2023-12-26T00:00:00.000Z,196,22,Gary Harris,1,3,4,4,1,6.5
3,1,3,0,0,5,4,2,2,12,4,0,10,7,0,0,1037999,2023-12-26T00:00:00.000Z,666442,22,Goga Bitadze,1,17,20,13,10,25.9
0,0,0,0,0,0,0,0,0,0,0,0,0,0,0,0,1037999,2023-12-26T00:00:00.000Z,38017607,22,Kevon Harris,0,0,0,0,0,0
0,0,0,0,0,0,0,0,0,0,0,0,0,0,0,0,1037999,2023-12-26T00:00:00.000Z,165,22,Markelle Fultz,0,0,0,0,0,0
1,0,5,0,0,9,5,2,1,15,0,1,11,5,0,0,1037999,2023-12-26T00:00:00.000Z,462,22,Moritz Wagner,0,16,17,12,6,18.5
1,0,4,5,3,8,6,2,0,19,0,1,15,4,0,0,1037999,2023-12-26T00:00:00.000Z,17896045,30,Corey Kispert,0,19,20,16,5,21.3
3,3,7,0,0,7,6,2,1,32,6,4,13,13,2,3,1037999,2023-12-26T00:00:00.000Z,666577,30,Daniel Gafford,5,26,29,16,16,45.1
3,1,5,4,0,7,1,0,0,23,0,1,2,5,3,2,1037999,2023-12-26T00:00:00.000Z,3547242,30,Deni Avdija,4,7,10,5,8,22.5
3,0,2,11,6,20,11,2,2,33,0,3,30,2,3,3,1037999,2023-12-26T00:00:00.000Z,666848,30,Jordan Poole,3,32,35,33,5,42.9
6,1,3,8,2,18,6,3,3,36,1,5,17,4,0,6,1037999,2023-12-26T00:00:00.000Z,265,30,Kyle Kuzma,1,21,27,23,10,27.8
6,1,6,6,4,13,8,2,2,34,0,0,22,6,1,2,1037999,2023-12-26T00:00:00.000Z,249,30,Tyus Jones,2,28,34,28,12,42.2
0,0,0,0,0,0,0,0,0,0,0,0,0,0,0,0,1038000,2023-12-26T00:00:00.000Z,38017689,1,AJ Griffin,0,0,0,0,0,0
1,0,2,12,3,21,8,3,3,31,1,2,22,3,0,0,1038000,2023-12-26T00:00:00.000Z,53,1,Bogdan Bogdanovic,0,25,26,23,4,27.1
0,0,0,0,0,0,0,0,0,0,0,0,0,0,0,0,1038000,2023-12-26T00:00:00.000Z,666564,1,Bruno Fernando,0,0,0,0,0,0
1,1,2,0,0,9,5,4,3,27,3,3,13,5,0,1,1038000,2023-12-26T00:00:00.000Z,83,1,Clint Capela,1,18,19,14,6,22.5
4,1,6,9,2,15,6,4,3,34,0,4,17,6,2,3,1038000,2023-12-26T00:00:00.000Z,334,1,Dejounte Murray,3,23,27,21,10,36.2
0,0,1,2,2,2,2,0,0,13,0,3,6,1,0,0,1038000,2023-12-26T00:00:00.000Z,666754,1,Garrison Mathews,0,7,7,6,1,7.2
4,0,6,1,0,8,5,0,0,29,3,1,10,9,1,2,1038000,2023-12-26T00:00:00.000Z,17896040,1,Jalen Johnson,1,19,23,14,13,27.8
0,0,0,0,0,0,0,0,0,0,0,0,0,0,0,0,1038000,2023-12-26T00:00:00.000Z,56677838,1,Kobe Bufkin,0,0,0,0,0,0
0,0,5,2,1,6,4,2,2,21,1,3,11,6,1,1,1038000,2023-12-26T00:00:00.000Z,3547244,1,Onyeka Okongwu,1,17,17,11,6,20.2
0,0,0,0,0,0,0,0,0,0,0,0,0,0,0,0,1038000,2023-12-26T00:00:00.000Z,319,1,Patty Mills,0,0,0,0,0,0
0,0,0,1,0,1,0,0,0,1,0,0,0,0,0,1,1038000,2023-12-26T00:00:00.000Z,56677855,1,Seth Lundy,0,0,0,0,0,-1
13,0,2,13,3,17,6,7,6,40,0,3,21,2,1,6,1038000,2023-12-26T00:00:00.000Z,490,1,Trae Young,1,23,36,34,15,39.9
0,0,0,0,0,0,0,0,0,4,0,0,0,0,0,0,1038000,2023-12-26T00:00:00.000Z,3547297,1,Trent Forrest,0,0,0,0,0,0
1,1,0,0,0,0,0,0,0,6,0,1,0,0,0,1,1038000,2023-12-26T00:00:00.000Z,301,1,Wesley Matthews,1,0,1,1,1,3.5
0,0,0,0,0,0,0,0,0,0,0,0,0,0,0,0,1038000,2023-12-26T00:00:00.000Z,56677860,5,Adama Sanogo,0,0,0,0,0,0
5,0,3,5,1,10,2,6,6,29,2,2,11,5,2,1,1038000,2023-12-26T00:00:00.000Z,89,5,Alex Caruso,2,16,21,16,10,29.5
1,2,15,0,0,13,11,2,2,39,10,4,24,25,3,2,1038000,2023-12-26T00:00:00.000Z,137,5,Andre Drummond,5,49,50,25,26,68.5
4,0,3,4,2,14,6,6,5,35,4,1,19,7,3,0,1038000,2023-12-26T00:00:00.000Z,17895983,5,Ayo Dosunmu,3,26,30,23,11,42.4
5,0,5,7,0,22,7,8,5,37,0,2,19,5,0,1,1038000,2023-12-26T00:00:00.000Z,666956,5,Coby White,0,24,29,24,10,31.5
0,0,0,1,0,1,0,0,0,7,0,1,0,0,0,1,1038000,2023-12-26T00:00:00.000Z,38017719,5,Dalen Terry,0,0,0,0,0,-1
6,0,2,3,2,17,8,7,7,40,0,3,25,2,1,1,1038000,2023-12-26T00:00:00.000Z,125,5,DeMar DeRozan,1,27,33,31,8,38.4
2,0,2,4,2,6,4,0,0,20,0,0,10,2,0,1,1038000,2023-12-26T00:00:00.000Z,87,5,Jevon Carter,0,12,14,12,4,14.4
0,0,0,0,0,0,0,0,0,0,0,0,0,0,0,0,1038000,2023-12-26T00:00:00.000Z,56677857,5,Julian Phillips,0,0,0,0,0,0
0,0,0,0,0,0,0,0,0,0,0,0,0,0,0,0,1038000,2023-12-26T00:00:00.000Z,27,5,Lonzo Ball,0,0,0,0,0,0
0,0,0,0,0,0,0,0,0,0,0,0,0,0,0,0,1038000,2023-12-26T00:00:00.000Z,460,5,Nikola Vucevic,0,0,0,0,0,0
0,0,0,0,0,0,0,0,0,0,0,0,0,0,0,0,1038000,2023-12-26T00:00:00.000Z,56677874,5,Onuralp Bitim,0,0,0,0,0,0
0,0,0,1,0,7,2,2,2,25,1,2,6,1,1,1,1038000,2023-12-26T00:00:00.000Z,3547248,5,Patrick Williams,1,7,7,6,1,9.2
0,0,0,0,0,2,2,0,0,8,1,2,4,1,0,0,1038000,2023-12-26T00:00:00.000Z,17896116,5,Terry Taylor,0,5,5,4,1,5.2
0,0,0,0,0,0,0,0,0,0,0,0,0,0,0,0,1038000,2023-12-26T00:00:00.000Z,110,5,Torrey Craig,0,0,0,0,0,0
0,0,0,0,0,0,0,0,0,0,0,0,0,0,0,0,1038000,2023-12-26T00:00:00.000Z,268,5,Zach LaVine,0,0,0,0,0,0
1,0,3,6,3,10,6,0,0,25,0,1,15,3,1,1,1038001,2023-12-26T00:00:00.000Z,213,11,Aaron Holiday,1,18,19,16,4,22.1
0,0,2,0,0,5,3,1,1,12,2,1,7,4,2,1,1038001,2023-12-26T00:00:00.000Z,56677825,11,Amen Thompson,2,11,11,7,4,16.8
0,0,0,0,0,0,0,0,0,0,0,0,0,0,0,0,1038001,2023-12-26T00:00:00.000Z,296,11,Boban Marjanovic,0,0,0,0,0,0
0,0,0,0,0,0,0,0,0,0,0,0,0,0,0,0,1038001,2023-12-26T00:00:00.000Z,56677831,11,Cam Whitmore,0,0,0,0,0,0
9,1,4,7,1,18,7,3,3,40,0,2,18,4,2,3,1038001,2023-12-26T00:00:00.000Z,458,11,Fred VanVleet,3,22,31,27,13,42.3
0,0,1,0,0,3,2,2,1,14,0,1,5,1,1,0,1038001,2023-12-26T00:00:00.000Z,3547301,11,Jae'Sean Tate,1,6,6,5,1,9.2
2,0,1,3,0,7,2,2,1,19,0,0,5,1,1,0,1038001,2023-12-26T00:00:00.000Z,17895966,11,Jalen Green,1,6,8,7,3,12.2
0,0,0,0,0,1,1,0,0,11,0,2,2,0,0,1,1038001,2023-12-26T00:00:00.000Z,188,11,Jeff Green,0,2,2,2,0,1
0,0,0,0,0,0,0,0,0,0,0,0,0,0,0,0,1038001,2023-12-26T00:00:00.000Z,19465326,11,Jock Landale,0,0,0,0,0,0
0,0,0,0,0,0,0,0,0,0,0,0,0,0,0,0,1038001,2023-12-26T00:00:00.000Z,3547281,11,Nate Hinton,0,0,0,0,0,0
0,0,0,0,0,0,0,0,0,0,0,0,0,0,0,0,1038001,2023-12-26T00:00:00.000Z,75,11,Reggie Bullock,0,0,0,0,0,0
1,0,5,2,1,13,7,2,1,26,3,3,16,8,2,0,1038001,2023-12-26T00:00:00.000Z,38017695,11,Tari Eason,2,24,25,17,9,33.1
0,0,0,0,0,0,0,0,0,0,0,0,0,0,0,0,1038001,2023-12-26T00:00:00.000Z,357,11,Victor Oladipo,0,0,0,0,0,0
0,0,0,0,0,0,0,0,0,0,0,0,0,0,0,0,1038001,2023-12-26T00:00:00.000Z,56677794,12,Isaiah Wong,0,0,0,0,0,0
0,0,0,0,0,0,0,0,0,0,0,0,0,0,0,0,1038001,2023-12-26T00:00:00.000Z,56677778,12,Oscar Tshiebwe,0,0,0,0,0,0
0,0,0,0,0,0,0,0,0,0,0,0,0,0,0,0,1038002,2023-12-26T00:00:00.000Z,666505,15,Brandon Clarke,0,0,0,0,0,0
1,0,3,5,2,7,3,0,0,16,1,0,8,4,0,0,1038002,2023-12-26T00:00:00.000Z,38017729,15,David Roddy,0,12,13,9,5,14.3
7,1,4,14,5,22,9,5,4,40,0,5,27,4,0,1,1038002,2023-12-26T00:00:00.000Z,3547287,15,Desmond Bane,1,31,38,34,11,44.3
0,0,0,0,0,0,0,0,0,0,0,0,0,0,0,0,1038002,2023-12-26T00:00:00.000Z,56677830,15,GG Jackson,0,0,0,0,0,0
7,2,4,7,1,24,12,8,6,40,1,2,31,5,1,6,1038002,2023-12-26T00:00:00.000Z,666786,15,Ja Morant,3,36,43,38,12,50.5
0,0,0,0,0,0,0,0,0,0,0,0,0,0,0,0,1038002,2023-12-26T00:00:00.000Z,48248287,15,Jacob Gilyard,0,0,0,0,0,0
0,0,0,0,0,0,0,0,0,0,0,0,0,0,0,0,1038002,2023-12-26T00:00:00.000Z,666703,15,John Konchar,0,0,0,0,0,0
0,0,0,0,0,0,0,0,0,0,0,0,0,0,0,0,1038002,2023-12-26T00:00:00.000Z,254,15,Luke Kennard,0,0,0,0,0,0
0,1,2,2,0,2,0,0,0,9,0,2,0,2,0,0,1038002,2023-12-26T00:00:00.000Z,17896067,15,Santi Aldama,1,2,2,0,2,5.4
0,0,0,0,0,0,0,0,0,0,0,0,0,0,0,0,1038002,2023-12-26T00:00:00.000Z,3,15,Steven Adams,0,0,0,0,0,0
3,3,6,4,1,4,1,4,3,27,2,0,6,8,1,2,1038002,2023-12-26T00:00:00.000Z,38017731,15,Vince Williams Jr.,4,14,17,9,11,30.1
0,5,5,1,0,3,1,0,0,28,3,1,2,8,1,0,1038002,2023-12-26T00:00:00.000Z,3547285,15,Xavier Tillman,6,10,10,2,8,29.6
1,1,1,2,0,2,0,2,2,12,0,1,2,1,1,2,1038002,2023-12-26T00:00:00.000Z,17896027,15,Ziaire Williams,2,3,4,3,2,8.7
1,0,0,1,1,3,3,6,4,19,0,4,11,0,2,0,1038002,2023-12-26T00:00:00.000Z,38017677,19,Dyson Daniels,2,11,12,12,1,18.5
2,0,2,4,1,8,3,2,1,11,1,0,8,3,1,0,1038002,2023-12-26T00:00:00.000Z,17896097,19,Jose Alvarado,1,11,13,10,5,17.6
1,0,5,6,3,8,3,2,1,36,2,2,10,7,2,2,1038002,2023-12-26T00:00:00.000Z,18677986,19,Trey Murphy III,2,17,18,11,8,23.9
0,0,0,0,0,0,0,0,0,0,0,0,0,0,0,0,1038003,2023-12-26T00:00:00.000Z,17895968,18,Daishen Nix,0,0,0,0,0,0
0,0,0,0,0,0,0,0,0,0,0,0,0,0,0,0,1038003,2023-12-26T00:00:00.000Z,56677851,18,Jaylen Clark,0,0,0,0,0,0
0,0,1,1,1,3,3,0,0,4,0,0,7,1,0,0,1038003,2023-12-26T00:00:00.000Z,56677782,18,Leonard Miller,0,8,8,7,1,8.2
0,0,0,0,0,0,0,0,0,0,0,0,0,0,0,0,1038003,2023-12-26T00:00:00.000Z,17896056,18,Luka Garza,0,0,0,0,0,0
5,1,4,6,3,13,8,2,1,29,0,4,20,4,0,1,1038003,2023-12-26T00:00:00.000Z,38017685,21,Chet Holmgren,1,24,29,25,9,34.3
0,0,0,0,0,0,0,0,0,0,0,0,0,0,0,0,1038003,2023-12-26T00:00:00.000Z,44,21,Davis Bertans,0,0,0,0,0,0
2,0,1,3,2,4,3,0,0,16,1,3,8,2,0,0,1038003,2023-12-26T00:00:00.000Z,3547272,21,Isaiah Joe,0,10,12,10,4,13.4
3,2,1,6,4,11,7,3,3,26,0,3,21,1,0,1,1038003,2023-12-26T00:00:00.000Z,38017703,21,Jalen Williams,2,22,25,24,4,31.7
7,0,2,2,0,7,4,2,2,25,0,3,10,2,0,2,1038003,2023-12-26T00:00:00.000Z,17896065,21,Josh Giddey,0,12,19,17,9,20.9
0,2,4,6,5,9,7,2,1,33,0,4,20,4,1,1,1038003,2023-12-26T00:00:00.000Z,666541,21,Luguentz Dort,3,24,24,20,4,32.8
0,0,0,0,0,0,0,0,0,0,0,0,0,0,0,0,1038003,2023-12-26T00:00:00.000Z,24572055,21,Olivier Sarr,0,0,0,0,0,0
0,0,0,0,0,0,0,0,0,0,0,0,0,0,0,0,1038003,2023-12-26T00:00:00.000Z,38017716,21,Ousmane Dieng,0,0,0,0,0,0
9,1,6,3,0,19,14,7,6,33,0,3,34,6,2,3,1038003,2023-12-26T00:00:00.000Z,175,21,Shai Gilgeous-Alexander,3,40,49,43,15,60.7
0,0,0,0,0,0,0,0,0,2,0,0,0,0,0,0,1038003,2023-12-26T00:00:00.000Z,17896036,21,Tre Mann,0,0,0,0,0,0
4,0,0,4,0,7,1,0,0,16,0,3,2,0,2,1,1038003,2023-12-26T00:00:00.000Z,4197029,21,Vasilije Micic,2,2,6,6,4,13
3,0,2,1,0,2,0,4,1,13,0,0,1,2,0,0,1038004,2023-12-26T00:00:00.000Z,359,27,Cedi Osman,0,3,6,4,5,7.9
0,0,0,0,0,0,0,0,0,0,0,0,0,0,0,0,1038004,2023-12-26T00:00:00.000Z,56677865,27,Charles Bediako,0,0,0,0,0,0
0,0,0,0,0,0,0,0,0,0,0,0,0,0,0,0,1038004,2023-12-26T00:00:00.000Z,17896049,27,David Duke Jr.,0,0,0,0,0,0
3,0,3,10,5,18,8,1,1,34,1,2,22,4,3,1,1038004,2023-12-26T00:00:00.000Z,3547246,27,Devin Vassell,3,26,29,25,7,39.3
0,0,0,2,0,2,0,0,0,11,0,0,0,0,0,0,1038004,2023-12-26T00:00:00.000Z,305,27,Doug McDermott,0,0,0,0,0,0
3,0,3,4,3,10,7,2,2,27,2,2,19,5,0,0,1038004,2023-12-26T00:00:00.000Z,38017699,27,Jeremy Sochan,0,24,27,22,8,29.5
1,1,3,6,4,9,6,0,0,25,1,5,16,4,2,0,1038004,2023-12-26T00:00:00.000Z,38017649,27,Julian Champagnie,3,20,21,17,5,31.3
3,0,2,7,3,20,9,6,5,30,2,0,26,4,0,1,1038004,2023-12-26T00:00:00.000Z,666682,27,Keldon Johnson,0,30,33,29,7,34.3
4,0,4,0,0,3,0,0,0,17,0,1,0,4,0,2,1038004,2023-12-26T00:00:00.000Z,38017692,27,Malaki Branham,0,4,8,4,8,8.8
7,0,1,1,0,7,3,1,0,27,3,1,6,4,2,0,1038004,2023-12-26T00:00:00.000Z,3547274,27,Tre Jones,2,10,17,13,11,27.3
4,5,5,4,1,15,6,3,2,24,2,1,15,7,1,4,1038004,2023-12-26T00:00:00.000Z,56677822,27,Victor Wembanyama,6,22,26,19,11,43.4
4,2,3,0,0,6,3,0,0,18,1,4,6,4,0,1,1038004,2023-12-26T00:00:00.000Z,102,27,Zach Collins,2,10,14,10,8,21.8
0,1,4,4,1,7,2,2,2,18,0,1,7,4,0,3,1038004,2023-12-26T00:00:00.000Z,101,29,John Collins,1,11,11,7,4,11.8
8,0,5,8,2,17,7,8,8,27,1,6,24,6,0,3,1038004,2023-12-26T00:00:00.000Z,100,29,Jordan Clarkson,0,30,38,32,14,40.2
6,1,3,3,1,6,2,2,2,23,2,1,7,5,0,0,1038004,2023-12-26T00:00:00.000Z,358,29,Kelly Olynyk,1,12,18,13,11,25
4,0,0,5,2,11,4,1,0,24,0,3,10,0,1,2,1038004,2023-12-26T00:00:00.000Z,56677834,29,Keyonte George,1,10,14,14,4,17
2,0,9,9,5,17,12,2,2,31,3,3,31,12,1,1,1038004,2023-12-26T00:00:00.000Z,297,29,Lauri Markkanen,1,43,45,33,14,50.4
0,0,0,0,0,0,0,0,0,0,0,0,0,0,0,0,1038004,2023-12-26T00:00:00.000Z,19465584,29,Micah Potter,0,0,0,0,0,0
1,0,3,4,2,6,4,0,0,20,1,0,10,4,0,0,1038004,2023-12-26T00:00:00.000Z,38017620,29,Ochai Agbaji,0,14,15,11,5,16.3
0,0,2,4,2,5,3,0,0,23,1,1,8,3,0,1,1038004,2023-12-26T00:00:00.000Z,38017739,29,Simone Fontecchio,0,11,11,8,3,10.6
0,0,0,0,0,0,0,0,0,0,0,0,0,0,0,0,1038004,2023-12-26T00:00:00.000Z,666650,29,Talen Horton-Tucker,0,0,0,0,0,0
0,0,1,2,0,3,0,0,0,2,0,0,0,1,0,1,1038004,2023-12-26T00:00:00.000Z,56677824,29,Taylor Hendricks,0,1,1,0,1,0.2
1,4,4,1,1,10,5,0,0,18,3,2,11,7,1,1,1038004,2023-12-26T00:00:00.000Z,38017705,29,Walker Kessler,5,18,19,12,8,34.9
0,0,0,0,0,0,0,0,0,0,0,0,0,0,0,0,1038005,2023-12-26T00:00:00.000Z,47957121,25,Justin Minaya,0,0,0,0,0,0
0,0,0,0,0,0,0,0,0,0,0,0,0,0,0,0,1038005,2023-12-26T00:00:00.000Z,56677829,25,Rayan Rupert,0,0,0,0,0,0
0,0,0,0,0,0,0,0,0,0,0,0,0,0,0,0,1038005,2023-12-26T00:00:00.000Z,476,25,Robert Williams III,0,0,0,0,0,0
0,0,0,0,0,0,0,0,0,0,0,0,0,0,0,0,1038005,2023-12-26T00:00:00.000Z,38017690,25,Shaedon Sharpe,0,0,0,0,0,0
1,0,0,3,0,3,0,0,0,9,1,1,0,1,0,0,1038005,2023-12-26T00:00:00.000Z,4197162,26,Aleksandar Vezenkov,0,1,2,1,2,2.7
0,0,0,0,0,0,0,0,0,2,0,0,0,0,0,0,1038005,2023-12-26T00:00:00.000Z,273,26,Alex Len,0,0,0,0,0,0
1,0,3,0,0,2,2,0,0,8,0,0,4,3,1,0,1038005,2023-12-26T00:00:00.000Z,17896030,26,Chris Duarte,1,7,8,5,4,12.1
0,0,0,0,0,0,0,0,0,0,0,0,0,0,0,0,1038005,2023-12-26T00:00:00.000Z,56677845,26,Colby Jones,0,0,0,0,0,0
0,0,1,2,0,3,1,0,0,2,0,0,2,1,0,0,1038005,2023-12-26T00:00:00.000Z,17553994,26,Davion Mitchell,0,3,3,2,1,3.2
4,1,6,15,7,26,16,6,4,38,2,2,43,8,2,5,1038005,2023-12-26T00:00:00.000Z,161,26,De'Aaron Fox,3,51,55,47,12,62.6
5,0,9,0,0,19,14,7,6,36,3,4,34,12,0,2,1038005,2023-12-26T00:00:00.000Z,406,26,Domantas Sabonis,0,46,51,39,17,53.9
1,0,3,3,0,8,3,3,3,36,2,2,9,5,1,2,1038005,2023-12-26T00:00:00.000Z,30,26,Harrison Barnes,1,14,15,10,6,17.5
0,0,0,0,0,0,0,0,0,0,0,0,0,0,0,0,1038005,2023-12-26T00:00:00.000Z,56677862,26,Jalen Slawson,0,0,0,0,0,0
1,0,0,0,0,2,2,0,0,5,1,1,4,1,0,1,1038005,2023-12-26T00:00:00.000Z,306,26,JaVale McGee,0,5,6,5,2,5.7
0,0,0,0,0,0,0,0,0,0,0,0,0,0,0,0,1038005,2023-12-26T00:00:00.000Z,17895990,26,Jordan Ford,0,0,0,0,0,0
0,0,0,0,0,0,0,0,0,2,0,0,0,0,1,0,1038005,2023-12-26T00:00:00.000Z,666925,26,Juan Toscano-Anderson,1,0,0,0,0,3
2,1,3,7,1,11,2,0,0,36,1,1,5,4,0,0,1038005,2023-12-26T00:00:00.000Z,38017688,26,Keegan Murray,1,9,11,7,6,15.8
2,1,0,0,0,0,0,0,0,9,0,1,0,0,0,0,1038005,2023-12-26T00:00:00.000Z,38017714,26,Keon Ellis,1,0,2,2,2,6
0,0,0,0,0,0,0,0,0,2,0,0,0,0,0,0,1038005,2023-12-26T00:00:00.000Z,17896044,26,Kessler Edwards,0,0,0,0,0,0
2,1,1,5,1,8,2,0,0,22,1,1,5,2,0,0,1038005,2023-12-26T00:00:00.000Z,221,26,Kevin Huerter,1,7,9,7,4,13.4
4,1,1,7,1,11,3,0,0,19,0,2,7,1,0,0,1038005,2023-12-26T00:00:00.000Z,324,26,Malik Monk,1,8,12,11,5,17.2
2,2,2,0,0,0,0,0,0,14,0,1,0,2,0,0,1038005,2023-12-26T00:00:00.000Z,290,26,Trey Lyles,2,2,4,2,4,11.4
0,0,0,0,0,0,0,0,0,0,0,0,0,0,0,0,1038006,2023-12-26T00:00:00.000Z,56677848,4,Amari Bailey,0,0,0,0,0,0
0,0,0,0,0,0,0,0,0,0,0,0,0,0,0,0,1038006,2023-12-26T00:00:00.000Z,56677823,4,Brandon Miller,0,0,0,0,0,0
2,0,3,1,0,6,4,3,2,22,0,3,10,3,0,0,1038006,2023-12-26T00:00:00.000Z,38017708,4,Bryce McGowens,0,13,15,12,5,16.6
2,1,2,2,1,8,3,0,0,25,0,2,7,2,4,0,1038006,2023-12-26T00:00:00.000Z,666748,4,Cody Martin,5,9,11,9,4,27.4
0,0,0,0,0,0,0,0,0,0,0,0,0,0,0,0,1038006,2023-12-26T00:00:00.000Z,347,4,Frank Ntilikina,0,0,0,0,0,0
5,0,1,2,0,8,3,2,2,24,1,2,8,2,1,1,1038006,2023-12-26T00:00:00.000Z,204,4,Gordon Hayward,1,10,15,13,7,19.9
4,0,1,0,0,4,2,0,0,16,0,1,4,1,0,1,1038006,2023-12-26T00:00:00.000Z,422,4,Ish Smith,0,5,9,8,5,10.2
0,0,0,0,0,0,0,0,0,0,0,0,0,0,0,0,1038006,2023-12-26T00:00:00.000Z,17896037,4,James Bouknight,0,0,0,0,0,0
0,0,0,0,0,0,0,0,0,0,0,0,0,0,0,0,1038006,2023-12-26T00:00:00.000Z,18678001,4,JT Thor,0,0,0,0,0,0
0,0,0,0,0,0,0,0,0,0,0,0,0,0,0,0,1038006,2023-12-26T00:00:00.000Z,3547239,4,LaMelo Ball,0,0,0,0,0,0
0,0,0,0,0,0,0,0,0,0,0,0,0,0,0,0,1038006,2023-12-26T00:00:00.000Z,56677866,4,Leaky Black,0,0,0,0,0,0
0,0,0,0,0,0,0,0,0,0,0,0,0,0,0,0,1038006,2023-12-26T00:00:00.000Z,38017698,4,Mark Williams,0,0,0,0,0,0
5,2,10,10,3,23,9,0,0,38,1,5,21,11,0,2,1038006,2023-12-26T00:00:00.000Z,62,4,Miles Bridges,2,32,37,26,16,45.7
1,1,8,0,0,6,5,4,3,33,2,2,13,10,0,1,1038006,2023-12-26T00:00:00.000Z,3547282,4,Nick Richards,1,23,24,14,11,28.5
1,0,0,4,1,5,2,0,0,12,0,3,5,0,0,0,1038006,2023-12-26T00:00:00.000Z,56677846,4,Nick Smith Jr.,0,5,6,6,1,6.5
3,0,4,2,0,10,7,4,4,27,4,3,18,8,2,2,1038006,2023-12-26T00:00:00.000Z,666950,4,P.J. Washington,2,26,29,21,11,36.1
7,0,4,8,1,23,8,3,1,39,0,2,18,4,1,4,1038006,2023-12-26T00:00:00.000Z,403,4,Terry Rozier,1,22,29,25,11,32.3
0,0,2,1,0,3,1,2,2,23,0,0,4,2,0,0,1038006,2023-12-26T00:00:00.000Z,666511,13,Amir Coffey,0,6,6,4,2,6.4
0,0,0,0,0,0,0,0,0,0,0,0,0,0,0,0,1038006,2023-12-26T00:00:00.000Z,17896022,13,Brandon Boston Jr.,0,0,0,0,0,0
0,0,2,0,0,7,5,0,0,15,2,0,10,4,0,1,1038006,2023-12-26T00:00:00.000Z,439,13,Daniel Theis,0,14,14,10,4,13.8
4,1,9,0,0,11,7,8,4,31,5,3,18,14,1,2,1038006,2023-12-26T00:00:00.000Z,493,13,Ivica Zubac,2,32,36,22,18,44.8
8,1,6,12,6,16,8,8,7,40,0,2,29,6,2,4,1038006,2023-12-26T00:00:00.000Z,192,13,James Harden,3,35,43,37,14,53.2
0,0,0,0,0,0,0,0,0,0,0,0,0,0,0,0,1038006,2023-12-26T00:00:00.000Z,56677856,13,Jordan Miller,0,0,0,0,0,0
0,0,0,0,0,0,0,0,0,0,0,0,0,0,0,0,1038006,2023-12-26T00:00:00.000Z,17896051,13,Joshua Primo,0,0,0,0,0,0
0,0,0,0,0,0,0,0,0,0,0,0,0,0,0,0,1038006,2023-12-26T00:00:00.000Z,274,13,Kawhi Leonard,0,0,0,0,0,0
2,0,0,2,0,4,1,0,0,17,0,0,2,0,2,0,1038006,2023-12-26T00:00:00.000Z,56677849,13,Kobe Brown,2,2,4,4,2,11
0,0,0,0,0,0,0,0,0,0,0,0,0,0,0,0,1038006,2023-12-26T00:00:00.000Z,371,13,Mason Plumlee,0,0,0,0,0,0
0,0,0,0,0,0,0,0,0,0,0,0,0,0,0,0,1038006,2023-12-26T00:00:00.000Z,38017725,13,Moussa Diabate,0,0,0,0,0,0
0,0,0,0,0,0,0,0,0,0,0,0,0,0,0,0,1038006,2023-12-26T00:00:00.000Z,17896031,13,Nah'Shon Hyland,0,0,0,0,0,0
0,0,3,5,1,7,2,2,2,28,0,1,7,3,0,0,1038006,2023-12-26T00:00:00.000Z,380,13,Norman Powell,0,10,10,7,3,10.6
4,0,2,11,5,25,10,0,0,37,2,4,25,4,0,3,1038006,2023-12-26T00:00:00.000Z,172,13,Paul George,0,29,33,29,8,32.8
0,0,0,0,0,0,0,0,0,0,0,0,0,0,0,0,1038006,2023-12-26T00:00:00.000Z,450,13,PJ Tucker,0,0,0,0,0,0
6,1,10,2,2,8,5,3,2,28,1,2,14,11,2,2,1038006,2023-12-26T00:00:00.000Z,472,13,Russell Westbrook,3,25,31,20,17,43.2
0,0,0,1,0,4,1,2,2,21,1,2,4,1,0,1,1038006,2023-12-26T00:00:00.000Z,666743,13,Terance Mann,0,5,5,4,1,4.2
0,0,0,0,0,0,0,0,0,0,0,0,0,0,0,0,1038006,2023-12-26T00:00:00.000Z,24417679,13,Xavier Moon,0,0,0,0,0,0
0,0,0,0,0,0,0,0,0,1,0,0,0,0,0,0,1038007,2023-12-27T00:00:00.000Z,666885,22,Admiral Schofield,0,0,0,0,0,0
4,1,3,3,1,6,1,0,0,24,1,2,3,4,1,0,1038007,2023-12-27T00:00:00.000Z,56677827,22,Anthony Black,2,7,11,7,8,19.8
2,0,4,4,2,4,2,1,1,26,2,2,7,6,0,2,1038007,2023-12-27T00:00:00.000Z,38017724,22,Caleb Houstan,0,13,15,9,8,15.2
0,1,3,2,1,3,1,0,0,15,1,2,3,4,0,0,1038007,2023-12-27T00:00:00.000Z,666818,22,Chuma Okeke,1,7,7,3,4,10.8
1,0,4,4,1,7,2,1,0,23,2,1,5,6,0,4,1038007,2023-12-27T00:00:00.000Z,3547251,22,Cole Anthony,0,11,12,6,7,9.7
3,0,5,5,1,16,8,8,7,36,0,4,24,5,1,4,1038007,2023-12-27T00:00:00.000Z,17896026,22,Franz Wagner,1,29,32,27,8,33.5
0,0,0,0,0,0,0,0,0,0,0,0,0,0,0,0,1038007,2023-12-27T00:00:00.000Z,196,22,Gary Harris,0,0,0,0,0,0
0,4,1,0,0,1,1,0,0,9,0,0,2,1,0,0,1038007,2023-12-27T00:00:00.000Z,666442,22,Goga Bitadze,4,3,3,2,1,15.2
1,1,1,2,1,12,8,3,3,28,1,5,20,2,1,3,1038007,2023-12-27T00:00:00.000Z,17896073,22,Jalen Suggs,2,22,23,21,3,26.9
0,0,0,1,1,1,1,0,0,1,0,0,3,0,0,0,1038007,2023-12-27T00:00:00.000Z,56677839,22,Jett Howard,0,3,3,3,0,3
0,0,0,0,0,0,0,0,0,0,0,0,0,0,0,0,1038007,2023-12-27T00:00:00.000Z,226,22,Joe Ingles,0,0,0,0,0,0
0,0,0,0,0,0,0,0,0,0,0,0,0,0,0,0,1038007,2023-12-27T00:00:00.000Z,229,22,Jonathan Isaac,0,0,0,0,0,0
0,0,0,0,0,0,0,0,0,0,0,0,0,0,0,0,1038007,2023-12-27T00:00:00.000Z,38017607,22,Kevon Harris,0,0,0,0,0,0
0,0,0,0,0,0,0,0,0,0,0,0,0,0,0,0,1038007,2023-12-27T00:00:00.000Z,165,22,Markelle Fultz,0,0,0,0,0,0
1,0,2,1,0,3,0,2,2,16,0,2,2,2,0,1,1038007,2023-12-27T00:00:00.000Z,462,22,Moritz Wagner,0,4,5,3,3,4.9
4,1,9,8,1,21,6,7,6,38,0,0,19,9,1,1,1038007,2023-12-27T00:00:00.000Z,38017683,22,Paolo Banchero,2,28,32,23,13,40.8
0,0,0,1,0,1,0,0,0,1,0,0,0,0,1,0,1038007,2023-12-27T00:00:00.000Z,17553983,22,Trevelin Queen,1,0,0,0,0,3
1,2,2,2,0,4,1,2,2,22,2,0,4,4,0,1,1038007,2023-12-27T00:00:00.000Z,85,22,Wendell Carter Jr.,2,8,9,5,5,15.3
1,2,3,4,1,7,1,2,1,29,1,1,4,4,2,1,1038007,2023-12-27T00:00:00.000Z,360,23,Kelly Oubre Jr.,4,8,9,5,5,21.3
2,0,6,5,1,23,10,1,1,33,1,0,22,7,1,0,1038007,2023-12-27T00:00:00.000Z,200,23,Tobias Harris,1,29,31,24,9,36.4
0,0,0,0,0,0,0,0,0,0,0,0,0,0,0,0,1038008,2023-12-27T00:00:00.000Z,38017710,28,Christian Koloko,0,0,0,0,0,0
0,0,0,0,0,0,0,0,0,0,0,0,0,0,0,0,1038008,2023-12-27T00:00:00.000Z,436,28,Garrett Temple,0,0,0,0,0,0
4,0,2,8,3,10,4,2,1,26,0,1,12,2,2,1,1038008,2023-12-27T00:00:00.000Z,3089,28,Gary Trent Jr.,2,14,18,16,6,25.4
2,1,5,0,0,6,4,4,2,21,3,4,10,8,2,2,1038008,2023-12-27T00:00:00.000Z,373,28,Jakob Poeltl,3,18,20,12,10,29.6
0,0,0,0,0,0,0,0,0,0,0,0,0,0,0,0,1038008,2023-12-27T00:00:00.000Z,56677805,28,Javon Freeman-Liberty,0,0,0,0,0,0
0,0,0,0,0,0,0,0,0,0,0,0,0,0,0,0,1038008,2023-12-27T00:00:00.000Z,2309958,28,Jontay Porter,0,0,0,0,0,0
0,0,0,0,0,0,0,0,0,0,0,0,0,0,0,0,1038008,2023-12-27T00:00:00.000Z,56677869,28,Markquis Nowell,0,0,0,0,0,0
2,0,4,7,3,16,11,2,1,29,2,1,26,6,0,1,1038008,2023-12-27T00:00:00.000Z,18,28,OG Anunoby,0,32,34,28,8,35.2
11,0,5,2,0,15,9,5,4,32,1,3,22,6,1,4,1038008,2023-12-27T00:00:00.000Z,416,28,Pascal Siakam,1,28,39,33,17,44.7
0,1,0,0,0,2,1,2,1,11,0,0,3,0,1,1,1038008,2023-12-27T00:00:00.000Z,3547249,28,Precious Achiuwa,2,3,3,3,0,8
8,2,7,8,4,16,8,0,0,34,5,0,20,12,3,2,1038008,2023-12-27T00:00:00.000Z,17896055,28,Scottie Barnes,5,32,40,28,20,59.4
0,1,0,0,0,0,0,0,0,5,0,0,0,0,0,0,1038008,2023-12-27T00:00:00.000Z,3547302,30,Anthony Gill,1,0,0,0,0,3
2,0,4,4,1,8,4,2,1,25,0,2,10,4,0,1,1038008,2023-12-27T00:00:00.000Z,56677844,30,Bilal Coulibaly,0,14,16,12,6,16.8
2,0,1,5,2,8,5,1,1,21,1,2,13,2,1,2,1038008,2023-12-27T00:00:00.000Z,17896045,30,Corey Kispert,1,15,17,15,4,19.4
1,1,6,0,0,9,5,2,2,30,2,2,12,8,4,0,1038008,2023-12-27T00:00:00.000Z,666577,30,Daniel Gafford,5,20,21,13,9,38.1
0,0,1,1,0,2,0,0,0,5,0,0,0,1,0,0,1038008,2023-12-27T00:00:00.000Z,167,30,Danilo Gallinari,0,1,1,0,1,1.2
0,0,0,0,0,0,0,0,0,0,0,0,0,0,0,0,1038008,2023-12-27T00:00:00.000Z,487,30,Delon Wright,0,0,0,0,0,0
1,0,2,1,1,8,5,2,1,24,0,1,12,2,2,0,1038008,2023-12-27T00:00:00.000Z,3547242,30,Deni Avdija,2,14,15,13,3,21.9
1,0,1,1,0,4,3,2,1,6,0,2,7,1,2,1,1038008,2023-12-27T00:00:00.000Z,17896106,30,Eugene Omoruyi,2,8,9,8,2,14.7
0,0,0,0,0,0,0,0,0,0,0,0,0,0,0,0,1038008,2023-12-27T00:00:00.000Z,18677954,30,Jared Butler,0,0,0,0,0,0
0,0,0,0,0,1,0,0,0,6,0,1,0,0,0,0,1038008,2023-12-27T00:00:00.000Z,38017687,30,Johnny Davis,0,0,0,0,0,0
4,1,2,7,1,12,5,4,3,27,2,1,14,4,0,2,1038008,2023-12-27T00:00:00.000Z,666848,30,Jordan Poole,1,18,22,18,8,25.8
7,0,2,5,1,13,6,2,1,30,2,3,14,4,0,5,1038008,2023-12-27T00:00:00.000Z,265,30,Kyle Kuzma,0,18,25,21,11,24.3
1,0,0,1,1,5,3,0,0,11,0,0,7,0,0,3,1038008,2023-12-27T00:00:00.000Z,414,30,Landry Shamet,0,7,8,8,1,5.5
0,0,4,0,0,3,0,0,0,7,2,0,0,6,0,1,1038008,2023-12-27T00:00:00.000Z,337,30,Mike Muscala,0,6,6,0,6,6.2
0,0,0,2,0,2,0,0,0,6,0,1,0,0,0,0,1038008,2023-12-27T00:00:00.000Z,38017704,30,Patrick Baldwin Jr.,0,0,0,0,0,0
0,0,0,0,0,3,1,0,0,6,0,0,2,0,0,0,1038008,2023-12-27T00:00:00.000Z,38017712,30,Ryan Rollins,0,2,2,2,0,2
5,0,1,6,1,12,5,0,0,31,1,2,11,2,2,1,1038008,2023-12-27T00:00:00.000Z,249,30,Tyus Jones,2,13,18,16,7,25.9
0,0,0,0,0,0,0,0,0,0,0,0,0,0,0,0,1038009,2023-12-27T00:00:00.000Z,417,3,Ben Simmons,0,0,0,0,0,0
0,0,0,2,0,9,4,0,0,12,0,1,8,0,1,0,1038009,2023-12-27T00:00:00.000Z,17896048,3,Cam Thomas,1,8,8,8,0,11
0,0,0,0,0,0,0,0,0,0,0,0,0,0,0,0,1038009,2023-12-27T00:00:00.000Z,666679,3,Cameron Johnson,0,0,0,0,0,0
3,0,4,3,0,5,1,0,0,21,0,0,2,4,0,0,1038009,2023-12-27T00:00:00.000Z,56677841,3,Dariq Whitehead,0,6,9,5,7,11.3
4,1,2,1,1,6,5,2,1,16,2,3,12,4,0,0,1038009,2023-12-27T00:00:00.000Z,17896038,3,Day'Ron Sharpe,1,16,20,16,8,25.8
8,0,6,4,0,17,7,0,0,30,1,0,14,7,1,2,1038009,2023-12-27T00:00:00.000Z,421,3,Dennis Smith Jr.,1,21,29,22,15,35.4
0,0,0,0,0,0,0,0,0,0,0,0,0,0,0,0,1038009,2023-12-27T00:00:00.000Z,158,3,Dorian Finney-Smith,0,0,0,0,0,0
0,0,2,0,0,3,0,2,1,7,2,2,1,4,0,1,1038009,2023-12-27T00:00:00.000Z,174,3,Harry Giles III,0,5,5,1,4,4.8
2,0,3,3,0,13,5,11,11,30,7,4,21,10,0,1,1038009,2023-12-27T00:00:00.000Z,56677722,3,Jalen Wilson,0,31,33,23,12,35
0,0,0,0,0,0,0,0,0,0,0,0,0,0,0,0,1038009,2023-12-27T00:00:00.000Z,464,3,Lonnie Walker IV,0,0,0,0,0,0
1,0,3,1,0,4,3,0,0,12,0,0,6,3,1,1,1038009,2023-12-27T00:00:00.000Z,61,3,Mikal Bridges,1,9,10,7,4,13.1
0,0,0,0,0,0,0,0,0,0,0,0,0,0,0,0,1038009,2023-12-27T00:00:00.000Z,666508,3,Nicolas Claxton,0,0,0,0,0,0
2,0,1,1,0,9,6,2,2,24,3,3,14,4,0,1,1038009,2023-12-27T00:00:00.000Z,56677843,3,Noah Clowney,0,18,20,16,6,20.8
2,0,1,3,1,4,1,0,0,10,0,1,3,1,0,0,1038009,2023-12-27T00:00:00.000Z,351,3,Royce O'Neale,0,4,6,5,3,7.2
0,0,0,0,0,0,0,0,0,0,0,0,0,0,0,0,1038009,2023-12-27T00:00:00.000Z,130,3,Spencer Dinwiddie,0,0,0,0,0,0
4,0,5,1,0,9,6,6,5,28,0,1,17,5,2,1,1038009,2023-12-27T00:00:00.000Z,17896058,3,Trendon Watford,2,22,26,21,9,34
0,0,1,2,1,2,1,0,0,4,0,2,3,1,0,0,1038009,2023-12-27T00:00:00.000Z,38017733,17,A.J. Green,0,4,4,3,1,4.2
2,2,4,6,0,7,1,0,0,25,2,3,2,6,0,0,1038009,2023-12-27T00:00:00.000Z,283,17,Brook Lopez,2,8,10,4,8,18.2
4,0,3,9,3,10,4,1,1,29,0,0,12,3,0,4,1038009,2023-12-27T00:00:00.000Z,278,17,Damian Lillard,0,15,19,16,7,17.6
1,0,0,8,5,9,6,0,0,22,1,0,17,1,1,0,1038009,2023-12-27T00:00:00.000Z,38,17,Malik Beasley,1,18,19,18,2,22.7
7,1,2,5,1,19,9,5,5,37,2,4,24,4,2,5,1038011,2023-12-27T00:00:00.000Z,73,20,Jalen Brunson,3,28,35,31,11,43.3
0,0,0,0,0,0,0,0,0,0,0,0,0,0,0,0,1038012,2023-12-27T00:00:00.000Z,666581,6,Darius Garland,0,0,0,0,0,0
0,0,0,0,0,0,0,0,0,0,0,0,0,0,0,0,1038012,2023-12-27T00:00:00.000Z,322,6,Donovan Mitchell,0,0,0,0,0,0
0,0,0,0,0,3,1,0,0,13,1,4,2,1,0,2,1038012,2023-12-27T00:00:00.000Z,444,6,Tristan Thompson,0,3,3,2,1,1.2
0,0,0,0,0,0,0,0,0,0,0,0,0,0,0,0,1038012,2023-12-27T00:00:00.000Z,666676,6,Ty Jerome,0,0,0,0,0,0
6,0,4,3,1,8,4,4,4,33,0,4,13,4,3,0,1038012,2023-12-27T00:00:00.000Z,151,7,Dante Exum,3,17,23,19,10,35.8
1,2,2,0,0,2,2,1,0,25,2,4,4,4,0,1,1038012,2023-12-27T00:00:00.000Z,56677840,7,Dereck Lively II,2,8,9,5,5,15.3
1,3,3,4,0,13,5,2,2,36,2,3,12,5,1,2,1038012,2023-12-27T00:00:00.000Z,247,7,Derrick Jones Jr.,4,17,18,13,6,29.5
0,0,4,4,0,7,2,0,0,26,2,5,4,6,2,0,1038012,2023-12-27T00:00:00.000Z,666965,7,Grant Williams,2,10,10,4,6,17.2
5,0,3,2,0,4,1,0,0,21,0,1,2,3,2,1,1038012,2023-12-27T00:00:00.000Z,3547258,7,Josh Green,2,5,10,7,8,18.1
6,2,7,10,3,29,14,10,8,37,0,0,39,7,2,5,1038012,2023-12-27T00:00:00.000Z,132,7,Luka Doncic,4,46,52,45,13,63.4
1,0,4,5,1,13,4,6,5,30,0,2,14,4,0,0,1038012,2023-12-27T00:00:00.000Z,191,7,Tim Hardaway Jr.,0,18,19,15,5,20.3
0,0,0,0,0,0,0,0,0,0,0,0,0,0,0,0,1038013,2023-12-28T00:00:00.000Z,70,2,Jaylen Brown,0,0,0,0,0,0
0,0,0,0,0,0,0,0,0,0,0,0,0,0,0,0,1038013,2023-12-28T00:00:00.000Z,38017707,2,JD Davison,0,0,0,0,0,0
0,0,0,0,0,0,0,0,0,0,0,0,0,0,0,0,1038013,2023-12-28T00:00:00.000Z,56677864,2,Jordan Walsh,0,0,0,0,0,0
0,0,0,0,0,0,0,0,0,0,0,0,0,0,0,0,1038013,2023-12-28T00:00:00.000Z,3547279,2,Lamar Stevens,0,0,0,0,0,0
0,0,0,0,0,0,0,0,0,0,0,0,0,0,0,0,1038013,2023-12-28T00:00:00.000Z,261,2,Luke Kornet,0,0,0,0,0,0
0,0,2,0,0,2,2,2,1,20,0,4,5,2,1,0,1038013,2023-12-28T00:00:00.000Z,17553967,2,Neemias Queta,1,7,7,5,2,10.4
2,0,2,6,1,11,4,0,0,23,2,0,9,4,1,1,1038013,2023-12-28T00:00:00.000Z,3547276,2,Payton Pritchard,1,13,15,11,6,18.8
1,0,2,4,1,6,2,0,0,18,1,0,5,3,0,1,1038013,2023-12-28T00:00:00.000Z,17896060,2,Sam Hauser,0,8,9,6,4,9.1
0,0,0,0,0,0,0,0,0,0,0,0,0,0,0,0,1038013,2023-12-28T00:00:00.000Z,338,2,Svi Mykhailiuk,0,0,0,0,0,0
6,0,10,7,1,21,8,0,0,44,2,3,17,12,0,2,1038013,2023-12-28T00:00:00.000Z,54,9,Bojan Bogdanovic,0,29,35,23,18,38.4
0,0,0,0,0,0,0,0,0,0,0,0,0,0,0,0,1038013,2023-12-28T00:00:00.000Z,3547267,9,Isaiah Stewart,0,0,0,0,0,0
0,0,0,0,0,0,0,0,0,0,0,0,0,0,0,0,1038013,2023-12-28T00:00:00.000Z,42097199,9,Jared Rhoden,0,0,0,0,0,0
0,0,0,0,0,0,0,0,0,0,0,0,0,0,0,0,1038013,2023-12-28T00:00:00.000Z,56677729,9,Malcolm Cazalon,0,0,0,0,0,0
0,0,0,0,0,0,0,0,0,0,0,0,0,0,0,0,1038013,2023-12-28T00:00:00.000Z,56677792,9,Marcus Sasser,0,0,0,0,0,0
0,0,0,0,0,0,0,0,0,0,0,0,0,0,0,0,1038013,2023-12-28T00:00:00.000Z,330,9,Monte Morris,0,0,0,0,0,0
0,0,0,0,0,0,0,0,0,0,0,0,0,0,0,0,1038013,2023-12-28T00:00:00.000Z,44477024,9,Stanley Umude,0,0,0,0,0,0
0,0,0,0,0,0,0,0,0,1,0,0,0,0,0,0,1038014,2023-12-28T00:00:00.000Z,56677860,5,Adama Sanogo,0,0,0,0,0,0
1,3,2,0,0,3,2,2,2,18,1,1,6,3,1,2,1038014,2023-12-28T00:00:00.000Z,38017719,5,Dalen Terry,4,9,10,7,4,21.1
0,0,0,0,0,0,0,0,0,1,0,0,0,0,0,0,1038014,2023-12-28T00:00:00.000Z,56677857,5,Julian Phillips,0,0,0,0,0,0
0,0,0,0,0,0,0,0,0,0,0,0,0,0,0,0,1038014,2023-12-28T00:00:00.000Z,27,5,Lonzo Ball,0,0,0,0,0,0
0,0,0,0,0,0,0,0,0,0,0,0,0,0,0,0,1038014,2023-12-28T00:00:00.000Z,460,5,Nikola Vucevic,0,0,0,0,0,0
0,0,0,0,0,0,0,0,0,0,0,0,0,0,0,0,1038014,2023-12-28T00:00:00.000Z,56677874,5,Onuralp Bitim,0,0,0,0,0,0
1,0,0,1,0,2,1,0,0,14,1,3,2,1,0,0,1038014,2023-12-28T00:00:00.000Z,17896116,5,Terry Taylor,0,3,4,3,2,4.7
0,0,0,0,0,0,0,0,0,0,0,0,0,0,0,0,1038014,2023-12-28T00:00:00.000Z,268,5,Zach LaVine,0,0,0,0,0,0
1,2,5,6,4,9,4,0,0,34,0,4,12,5,1,1,1038014,2023-12-28T00:00:00.000Z,3547250,12,Aaron Nesmith,3,17,18,13,6,27.5
4,0,2,3,0,13,4,0,0,24,1,3,8,3,1,1,1038014,2023-12-28T00:00:00.000Z,38017507,12,Andrew Nembhard,1,11,15,12,7,19.6
0,0,0,0,0,0,0,0,0,0,0,0,0,0,0,0,1038014,2023-12-28T00:00:00.000Z,56677861,12,Ben Sheppard,0,0,0,0,0,0
0,0,0,0,0,0,0,0,0,0,0,0,0,0,0,0,1038014,2023-12-28T00:00:00.000Z,69,12,Bruce Brown,0,0,0,0,0,0
0,0,0,0,0,0,0,0,0,0,0,0,0,0,0,0,1038014,2023-12-28T00:00:00.000Z,56677794,12,Isaiah Wong,0,0,0,0,0,0
1,0,5,2,1,7,6,5,2,24,2,3,15,7,0,0,1038014,2023-12-28T00:00:00.000Z,3547264,12,Jalen Smith,0,22,23,16,8,24.9
0,0,0,0,0,0,0,0,0,0,0,0,0,0,0,0,1038014,2023-12-28T00:00:00.000Z,242,12,James Johnson,0,0,0,0,0,0
0,0,0,0,0,0,0,0,0,0,0,0,0,0,0,0,1038014,2023-12-28T00:00:00.000Z,56677832,12,Jarace Walker,0,0,0,0,0,0
0,0,0,0,0,0,0,0,0,0,0,0,0,0,0,0,1038014,2023-12-28T00:00:00.000Z,3547207,12,Jordan Nwora,0,0,0,0,0,0
0,0,0,0,0,0,0,0,0,0,0,0,0,0,0,0,1038014,2023-12-28T00:00:00.000Z,38017701,12,Kendall Brown,0,0,0,0,0,0
0,3,6,2,1,12,8,7,7,26,0,5,24,6,0,3,1038014,2023-12-28T00:00:00.000Z,452,12,Myles Turner,3,30,30,24,6,37.2
0,0,0,0,0,0,0,0,0,0,0,0,0,0,0,0,1038014,2023-12-28T00:00:00.000Z,56677778,12,Oscar Tshiebwe,0,0,0,0,0,0
0,0,0,0,0,0,0,0,0,0,0,0,0,0,0,0,1038014,2023-12-28T00:00:00.000Z,304,12,T.J. McConnell,0,0,0,0,0,0
20,1,3,13,6,17,7,2,1,37,0,2,21,3,2,0,1038014,2023-12-28T00:00:00.000Z,3547245,12,Tyrese Haliburton,3,24,44,41,23,63.6
0,0,0,0,0,0,0,0,0,0,0,0,0,0,0,0,1038015,2023-12-28T00:00:00.000Z,17554004,7,AJ Lawson,0,0,0,0,0,0
0,0,0,0,0,0,0,0,0,0,0,0,0,0,0,0,1038015,2023-12-28T00:00:00.000Z,24489167,7,Brandon Williams,0,0,0,0,0,0
6,0,2,1,1,11,5,0,0,24,0,4,11,2,0,4,1038015,2023-12-28T00:00:00.000Z,151,7,Dante Exum,0,13,19,17,8,18.4
2,0,1,0,0,4,1,0,0,15,3,5,2,4,0,2,1038015,2023-12-28T00:00:00.000Z,56677840,7,Dereck Lively II,0,6,8,4,6,7.8
0,1,6,3,1,9,3,8,8,30,3,5,15,9,3,1,1038015,2023-12-28T00:00:00.000Z,247,7,Derrick Jones Jr.,4,24,24,15,9,36.8
6,1,7,0,0,8,6,0,0,30,7,3,12,14,2,1,1038015,2023-12-28T00:00:00.000Z,379,7,Dwight Powell,3,26,32,18,20,45.8
3,0,3,5,2,9,3,0,0,30,0,4,8,3,1,2,1038015,2023-12-28T00:00:00.000Z,666965,7,Grant Williams,1,11,14,11,6,17.1
0,0,0,0,0,0,0,0,0,0,0,0,0,0,0,0,1038015,2023-12-28T00:00:00.000Z,17896028,7,Greg Brown III,0,0,0,0,0,0
1,1,2,8,3,18,7,0,0,31,0,2,17,2,1,0,1038015,2023-12-28T00:00:00.000Z,38017679,7,Jaden Hardy,2,19,20,18,3,26.9
5,0,0,1,0,3,1,0,0,15,0,0,2,0,0,1,1038015,2023-12-28T00:00:00.000Z,3547258,7,Josh Green,0,2,7,7,5,8.5
0,0,0,0,0,0,0,0,0,0,0,0,0,0,0,0,1038015,2023-12-28T00:00:00.000Z,228,7,Kyrie Irving,0,0,0,0,0,0
0,0,0,0,0,0,0,0,0,0,0,0,0,0,0,0,1038015,2023-12-28T00:00:00.000Z,132,7,Luka Doncic,0,0,0,0,0,0
0,0,0,0,0,1,0,0,0,3,0,0,0,0,0,1,1038015,2023-12-28T00:00:00.000Z,329,7,Markieff Morris,0,0,0,0,0,-1
0,0,0,0,0,0,0,0,0,0,0,0,0,0,0,0,1038015,2023-12-28T00:00:00.000Z,257,7,Maxi Kleber,0,0,0,0,0,0
0,0,0,0,0,0,0,0,0,0,0,0,0,0,0,0,1038015,2023-12-28T00:00:00.000Z,56677859,7,Olivier-Maxence Prosper,0,0,0,0,0,0
0,0,0,0,0,0,0,0,0,0,0,0,0,0,0,0,1038015,2023-12-28T00:00:00.000Z,217,7,Richaun Holmes,0,0,0,0,0,0
3,0,2,4,2,8,3,4,3,30,0,2,11,2,0,3,1038015,2023-12-28T00:00:00.000Z,114,7,Seth Curry,0,13,16,14,5,14.9
3,0,3,11,5,19,11,7,5,32,0,2,32,3,2,1,1038015,2023-12-28T00:00:00.000Z,191,7,Tim Hardaway Jr.,2,35,38,35,6,45.1
0,0,0,0,0,0,0,0,0,0,0,0,0,0,0,0,1038015,2023-12-28T00:00:00.000Z,17895968,18,Daishen Nix,0,0,0,0,0,0
0,0,0,0,0,0,0,0,0,0,0,0,0,0,0,0,1038015,2023-12-28T00:00:00.000Z,56677851,18,Jaylen Clark,0,0,0,0,0,0
0,0,0,0,0,0,0,0,0,0,0,0,0,0,0,0,1038015,2023-12-28T00:00:00.000Z,38017715,18,Josh Minott,0,0,0,0,0,0
0,0,0,0,0,0,0,0,0,0,0,0,0,0,0,0,1038015,2023-12-28T00:00:00.000Z,56677782,18,Leonard Miller,0,0,0,0,0,0
0,0,0,0,0,0,0,0,0,0,0,0,0,0,0,0,1038015,2023-12-28T00:00:00.000Z,17896056,18,Luka Garza,0,0,0,0,0,0
2,0,4,5,3,5,3,0,0,18,0,4,9,4,0,3,1038015,2023-12-28T00:00:00.000Z,667378,18,Naz Reid,0,13,15,11,6,13.8
0,0,0,0,0,0,0,0,0,0,0,0,0,0,0,0,1038015,2023-12-28T00:00:00.000Z,320,18,Shake Milton,0,0,0,0,0,0
0,0,0,0,0,0,0,0,0,0,0,0,0,0,0,0,1038015,2023-12-28T00:00:00.000Z,38017700,18,Wendell Moore Jr.,0,0,0,0,0,0
6,0,2,10,4,16,8,3,2,32,1,2,22,3,2,2,1038016,2023-12-28T00:00:00.000Z,303,19,CJ McCollum,2,25,31,28,9,38.6
0,0,0,0,0,0,0,0,0,0,0,0,0,0,0,0,1038016,2023-12-28T00:00:00.000Z,491,19,Cody Zeller,0,0,0,0,0,0
0,0,0,0,0,0,0,0,0,0,0,0,0,0,0,0,1038016,2023-12-28T00:00:00.000Z,38017726,19,Dereon Seabron,0,0,0,0,0,0
2,1,2,1,0,1,0,0,0,14,0,2,0,2,2,1,1038016,2023-12-28T00:00:00.000Z,38017677,19,Dyson Daniels,3,2,4,2,4,13.4
0,0,0,0,0,0,0,0,0,0,0,0,0,0,0,0,1038016,2023-12-28T00:00:00.000Z,38017663,19,E.J. Liddell,0,0,0,0,0,0
0,0,0,0,0,0,0,0,0,0,0,0,0,0,0,0,1038016,2023-12-28T00:00:00.000Z,17896021,19,Jeremiah Robinson-Earl,0,0,0,0,0,0
0,0,0,0,0,0,0,0,0,0,0,0,0,0,0,0,1038016,2023-12-28T00:00:00.000Z,56677837,19,Jordan Hawkins,0,0,0,0,0,0
0,0,0,2,1,4,3,0,0,12,0,2,7,0,0,1,1038016,2023-12-28T00:00:00.000Z,17896097,19,Jose Alvarado,0,7,7,7,0,6
0,0,0,0,0,0,0,0,0,0,0,0,0,0,0,0,1038016,2023-12-28T00:00:00.000Z,3547260,19,Kira Lewis Jr.,0,0,0,0,0,0
0,1,6,2,1,6,4,0,0,25,1,0,9,7,5,2,1038016,2023-12-28T00:00:00.000Z,340,19,Larry Nance Jr.,6,16,16,9,7,33.4
0,0,0,0,0,0,0,0,0,0,0,0,0,0,0,0,1038016,2023-12-28T00:00:00.000Z,17896017,19,Matt Ryan,0,0,0,0,0,0
2,0,2,1,1,5,4,0,0,16,0,1,9,2,0,3,1038016,2023-12-28T00:00:00.000Z,3547293,19,Naji Marshall,0,11,13,11,4,11.4
2,0,1,7,2,8,2,0,0,23,0,2,6,1,0,1,1038016,2023-12-28T00:00:00.000Z,18677986,19,Trey Murphy III,0,7,9,8,3,9.2
3,0,4,6,3,17,8,9,7,30,1,4,26,5,0,0,1038016,2023-12-28T00:00:00.000Z,413,29,Collin Sexton,0,31,34,29,8,36.5
0,1,9,3,1,7,3,2,1,26,3,2,8,12,0,1,1038016,2023-12-28T00:00:00.000Z,101,29,John Collins,1,20,20,8,12,24.4
6,0,2,5,1,11,3,3,3,24,0,0,10,2,0,6,1038016,2023-12-28T00:00:00.000Z,100,29,Jordan Clarkson,0,12,18,16,8,15.4
5,0,3,5,1,7,1,2,1,22,0,1,4,3,0,2,1038016,2023-12-28T00:00:00.000Z,56677834,29,Keyonte George,0,7,12,9,8,13.1
3,1,0,3,1,5,3,0,0,19,0,2,7,0,0,0,1038016,2023-12-28T00:00:00.000Z,139,29,Kris Dunn,1,7,10,10,3,14.5
5,0,4,12,3,19,7,7,7,35,6,1,24,10,1,3,1038016,2023-12-28T00:00:00.000Z,297,29,Lauri Markkanen,1,34,39,29,15,43.5
0,1,1,1,1,5,5,0,0,29,3,1,11,4,2,1,1038016,2023-12-28T00:00:00.000Z,38017705,29,Walker Kessler,3,15,15,11,4,23.8
0,0,0,0,0,0,0,0,0,0,0,0,0,0,0,0,1038017,2023-12-28T00:00:00.000Z,56677871,8,Hunter Tyson,0,0,0,0,0,0
1,1,4,0,0,4,1,0,0,22,0,3,2,4,0,2,1038017,2023-12-28T00:00:00.000Z,48,15,Bismack Biyombo,1,6,7,3,5,9.3
0,0,0,0,0,0,0,0,0,0,0,0,0,0,0,0,1038017,2023-12-28T00:00:00.000Z,666505,15,Brandon Clarke,0,0,0,0,0,0
2,0,0,2,1,9,5,8,4,29,0,0,15,0,0,0,1038017,2023-12-28T00:00:00.000Z,38017729,15,David Roddy,0,15,17,17,2,18
0,0,0,0,0,0,0,0,0,0,0,0,0,0,0,0,1038017,2023-12-28T00:00:00.000Z,401,15,Derrick Rose,0,0,0,0,0,0
2,0,1,5,3,13,9,2,2,25,0,3,23,1,1,2,1038017,2023-12-28T00:00:00.000Z,3547287,15,Desmond Bane,1,24,26,25,3,28.2
0,0,0,0,0,0,0,0,0,0,0,0,0,0,0,0,1038017,2023-12-28T00:00:00.000Z,56677830,15,GG Jackson,0,0,0,0,0,0
0,0,0,0,0,0,0,0,0,0,0,0,0,0,0,0,1038017,2023-12-28T00:00:00.000Z,666786,15,Ja Morant,0,0,0,0,0,0
1,1,0,3,2,3,2,0,0,12,0,0,6,0,0,0,1038017,2023-12-28T00:00:00.000Z,48248287,15,Jacob Gilyard,1,6,7,7,1,10.5
0,0,0,0,0,0,0,0,0,0,0,0,0,0,0,0,1038017,2023-12-28T00:00:00.000Z,38017728,15,Jake LaRavia,0,0,0,0,0,0
2,0,3,3,1,14,5,4,3,28,1,1,14,4,2,0,1038017,2023-12-28T00:00:00.000Z,231,15,Jaren Jackson Jr.,2,18,20,16,6,27.8
3,1,4,5,1,8,4,1,1,25,2,1,10,6,2,1,1038017,2023-12-28T00:00:00.000Z,666703,15,John Konchar,3,16,19,13,9,29.7
0,0,0,0,0,0,0,0,0,0,0,0,0,0,0,0,1038017,2023-12-28T00:00:00.000Z,254,15,Luke Kennard,0,0,0,0,0,0
5,0,2,6,2,14,6,4,3,23,1,1,17,3,1,3,1038017,2023-12-28T00:00:00.000Z,420,15,Marcus Smart,1,20,25,22,8,28.1
0,0,0,0,0,0,0,0,0,0,0,0,0,0,0,0,1038017,2023-12-28T00:00:00.000Z,17896067,15,Santi Aldama,0,0,0,0,0,0
0,0,0,0,0,0,0,0,0,0,0,0,0,0,0,0,1038017,2023-12-28T00:00:00.000Z,3,15,Steven Adams,0,0,0,0,0,0
2,0,7,4,1,7,1,2,2,30,4,3,5,11,0,0,1038017,2023-12-28T00:00:00.000Z,38017731,15,Vince Williams Jr.,0,16,18,7,13,21.2
4,1,3,4,1,7,2,2,1,22,0,0,6,3,1,2,1038017,2023-12-28T00:00:00.000Z,3547285,15,Xavier Tillman,2,9,13,10,7,19.6
1,1,1,3,1,8,2,2,2,24,1,1,7,2,1,1,1038017,2023-12-28T00:00:00.000Z,17896027,15,Ziaire Williams,2,9,10,8,3,15.9
5,0,2,5,2,9,4,0,0,28,1,2,10,3,0,1,1038018,2023-12-28T00:00:00.000Z,56677858,10,Brandin Podziemski,0,13,18,15,8,20.1
0,0,0,0,0,0,0,0,0,0,0,0,0,0,0,0,1038018,2023-12-28T00:00:00.000Z,185,10,Draymond Green,0,0,0,0,0,0
1,0,4,3,0,11,5,0,0,24,1,0,10,5,0,6,1038018,2023-12-28T00:00:00.000Z,17553979,10,Jonathan Kuminga,0,15,16,11,6,11.5
0,1,2,0,0,2,2,3,1,14,3,3,5,5,0,0,1038018,2023-12-28T00:00:00.000Z,282,10,Kevon Looney,1,10,10,5,5,14
5,0,0,6,2,11,4,4,3,25,0,2,13,0,2,0,1038018,2023-12-28T00:00:00.000Z,443,10,Klay Thompson,2,13,18,18,5,26.5
6,1,4,8,2,15,3,6,5,32,0,1,13,4,2,1,1038018,2023-12-28T00:00:00.000Z,115,10,Stephen Curry,3,17,23,19,10,34.8
0,0,0,0,0,0,0,0,0,0,0,0,0,0,0,0,1038018,2023-12-28T00:00:00.000Z,666747,16,Caleb Martin,0,0,0,0,0,0
4,0,7,3,1,5,2,3,3,13,0,1,8,7,0,1,1038018,2023-12-28T00:00:00.000Z,285,16,Kevin Love,0,15,19,12,11,21.4
3,0,0,2,0,6,3,2,1,25,2,3,7,2,0,1,1038018,2023-12-28T00:00:00.000Z,3547257,16,R.J. Hampton,0,9,12,10,5,12.9
2,0,7,7,3,18,10,4,3,31,0,0,26,7,1,2,1038018,2023-12-28T00:00:00.000Z,666633,16,Tyler Herro,1,33,35,28,9,38.4
0,0,0,0,0,0,0,0,0,0,0,0,0,0,0,0,1038019,2023-12-28T00:00:00.000Z,22,25,Deandre Ayton,0,0,0,0,0,0
0,0,1,4,0,5,0,0,0,5,0,0,0,1,0,0,1038019,2023-12-28T00:00:00.000Z,17896120,25,Ish Wainright,0,1,1,0,1,1.2
0,1,7,0,0,4,2,2,2,30,2,4,6,9,1,1,1038019,2023-12-28T00:00:00.000Z,38017711,25,Jabari Walker,2,15,15,6,9,21.8
5,0,7,5,1,21,9,13,10,41,3,4,29,10,0,4,1038019,2023-12-28T00:00:00.000Z,182,25,Jerami Grant,0,39,44,34,15,44.5
0,0,0,0,0,0,0,0,0,0,0,0,0,0,0,0,1038019,2023-12-28T00:00:00.000Z,47957121,25,Justin Minaya,0,0,0,0,0,0
0,0,0,0,0,0,0,0,0,0,0,0,0,0,0,0,1038019,2023-12-28T00:00:00.000Z,56677791,25,Kris Murray,0,0,0,0,0,0
6,0,5,8,6,19,10,5,3,37,1,1,29,6,1,1,1038019,2023-12-28T00:00:00.000Z,65,25,Malcolm Brogdon,1,35,41,35,12,47.2
1,0,2,7,1,7,1,2,1,28,0,1,4,2,2,0,1038019,2023-12-28T00:00:00.000Z,666923,25,Matisse Thybulle,2,6,7,5,3,13.9
0,0,2,0,0,6,2,0,0,14,5,3,4,7,0,0,1038019,2023-12-28T00:00:00.000Z,666476,25,Moses Brown,0,11,11,4,7,12.4
0,0,0,0,0,0,0,0,0,0,0,0,0,0,0,0,1038019,2023-12-28T00:00:00.000Z,56677829,25,Rayan Rupert,0,0,0,0,0,0
0,0,0,0,0,0,0,0,0,0,0,0,0,0,0,0,1038019,2023-12-28T00:00:00.000Z,476,25,Robert Williams III,0,0,0,0,0,0
4,0,1,7,3,23,8,6,6,36,2,5,25,3,1,6,1038019,2023-12-28T00:00:00.000Z,56677747,25,Scoot Henderson,1,28,32,29,7,31.6
0,0,0,0,0,0,0,0,0,0,0,0,0,0,0,0,1038019,2023-12-28T00:00:00.000Z,38017690,25,Shaedon Sharpe,0,0,0,0,0,0
0,0,2,4,0,8,0,0,0,14,1,0,0,3,1,0,1038019,2023-12-28T00:00:00.000Z,3547289,25,Skylar Mays,1,3,3,0,3,6.6
0,0,4,1,0,5,0,2,1,21,3,1,1,7,0,1,1038019,2023-12-28T00:00:00.000Z,56677850,25,Toumani Camara,0,8,8,1,7,8.4
7,1,5,9,2,16,7,1,1,35,0,0,17,5,4,1,1038019,2023-12-28T00:00:00.000Z,3547246,27,Devin Vassell,5,22,29,24,12,47.5
3,1,6,2,0,10,6,5,4,31,1,4,16,7,0,2,1038019,2023-12-28T00:00:00.000Z,38017699,27,Jeremy Sochan,1,23,26,19,10,29.9
0,1,1,1,0,1,0,2,2,14,0,0,2,1,2,1,1038019,2023-12-28T00:00:00.000Z,38017649,27,Julian Champagnie,3,3,3,2,1,11.2
2,0,3,6,1,11,4,0,0,31,0,5,9,3,1,2,1038019,2023-12-28T00:00:00.000Z,666682,27,Keldon Johnson,1,12,14,11,5,16.6
4,0,3,6,3,10,4,2,2,28,2,5,13,5,1,2,1038019,2023-12-28T00:00:00.000Z,38017692,27,Malaki Branham,1,18,22,17,9,26
6,0,2,2,0,6,2,4,4,26,3,0,8,5,1,1,1038019,2023-12-28T00:00:00.000Z,3547274,27,Tre Jones,1,13,19,14,11,25
6,7,6,4,2,14,9,10,10,24,0,0,30,6,0,1,1038019,2023-12-28T00:00:00.000Z,56677822,27,Victor Wembanyama,7,36,42,36,12,66.2
2,0,6,2,0,9,4,4,3,17,1,6,11,7,0,1,1038019,2023-12-28T00:00:00.000Z,102,27,Zach Collins,0,18,20,13,9,21.4
0,0,0,0,0,0,0,0,0,0,0,0,0,0,0,0,1038020,2023-12-28T00:00:00.000Z,56677848,4,Amari Bailey,0,0,0,0,0,0
2,1,0,5,3,9,5,4,4,29,1,0,17,1,1,3,1038020,2023-12-28T00:00:00.000Z,56677823,4,Brandon Miller,2,18,20,19,3,24.2
1,0,2,4,3,6,3,2,1,22,0,3,10,2,0,1,1038020,2023-12-28T00:00:00.000Z,38017708,4,Bryce McGowens,0,12,13,11,3,12.9
2,0,2,3,0,7,2,4,1,20,2,1,5,4,1,2,1038020,2023-12-28T00:00:00.000Z,666748,4,Cody Martin,1,9,11,7,6,13.8
0,0,0,0,0,0,0,0,0,0,0,0,0,0,0,0,1038020,2023-12-28T00:00:00.000Z,347,4,Frank Ntilikina,0,0,0,0,0,0
0,0,0,0,0,0,0,0,0,0,0,0,0,0,0,0,1038020,2023-12-28T00:00:00.000Z,204,4,Gordon Hayward,0,0,0,0,0,0
4,0,3,0,0,4,3,0,0,14,0,1,6,3,1,1,1038020,2023-12-28T00:00:00.000Z,422,4,Ish Smith,1,9,13,10,7,17.6
1,0,2,1,1,3,2,0,0,6,0,0,5,2,0,0,1038020,2023-12-28T00:00:00.000Z,17896037,4,James Bouknight,0,7,8,6,3,8.9
1,0,0,1,1,1,1,0,0,6,0,0,3,0,0,0,1038020,2023-12-28T00:00:00.000Z,18678001,4,JT Thor,0,3,4,4,1,4.5
0,0,0,0,0,0,0,0,0,0,0,0,0,0,0,0,1038020,2023-12-28T00:00:00.000Z,3547239,4,LaMelo Ball,0,0,0,0,0,0
0,0,0,0,0,0,0,0,0,0,0,0,0,0,0,0,1038020,2023-12-28T00:00:00.000Z,56677866,4,Leaky Black,0,0,0,0,0,0
0,0,0,0,0,0,0,0,0,0,0,0,0,0,0,0,1038020,2023-12-28T00:00:00.000Z,38017698,4,Mark Williams,0,0,0,0,0,0
5,1,4,10,4,20,7,2,2,33,1,3,20,5,0,3,1038020,2023-12-28T00:00:00.000Z,62,4,Miles Bridges,1,25,30,25,10,33.5
1,2,7,0,0,5,5,3,1,26,3,3,11,10,1,0,1038020,2023-12-28T00:00:00.000Z,3547282,4,Nick Richards,3,21,22,12,11,33.5
4,1,3,2,2,4,2,0,0,18,0,1,6,3,0,2,1038020,2023-12-28T00:00:00.000Z,56677846,4,Nick Smith Jr.,1,9,13,10,7,16.6
0,0,5,4,0,11,4,2,1,25,1,1,9,6,0,3,1038020,2023-12-28T00:00:00.000Z,666950,4,P.J. Washington,0,15,15,9,6,13.2
8,0,6,3,1,14,5,9,7,32,0,0,18,6,1,4,1038020,2023-12-28T00:00:00.000Z,403,4,Terry Rozier,1,24,32,26,14,36.2
0,0,0,0,0,0,0,0,0,0,0,0,0,0,0,0,1038020,2023-12-28T00:00:00.000Z,56677867,14,Alex Fudge,0,0,0,0,0,0
4,0,2,3,2,8,6,2,2,24,0,4,16,2,1,1,1038020,2023-12-28T00:00:00.000Z,17553995,14,Austin Reaves,1,18,22,20,6,26.4
0,0,0,0,0,0,0,0,0,0,0,0,0,0,0,0,1038020,2023-12-28T00:00:00.000Z,666860,14,Cameron Reddish,0,0,0,0,0,0
4,1,5,3,3,4,3,0,0,23,0,2,9,5,0,2,1038020,2023-12-28T00:00:00.000Z,486,14,Christian Wood,1,14,18,13,9,22
0,0,0,0,0,0,0,0,0,0,0,0,0,0,0,0,1038020,2023-12-28T00:00:00.000Z,56677738,14,Colin Castleton,0,0,0,0,0,0
9,0,3,7,4,10,5,2,2,29,0,3,16,3,0,1,1038020,2023-12-28T00:00:00.000Z,405,14,D'Angelo Russell,0,19,28,25,12,32.1
0,0,0,0,0,0,0,0,0,0,0,0,0,0,0,0,1038020,2023-12-28T00:00:00.000Z,56677868,14,D'Moi Hodge,0,0,0,0,0,0
0,0,0,0,0,0,0,0,0,0,0,0,0,0,0,0,1038020,2023-12-28T00:00:00.000Z,1603383,14,Gabe Vincent,0,0,0,0,0,0
1,0,0,1,0,5,1,0,0,7,0,1,2,0,1,1,1038020,2023-12-28T00:00:00.000Z,56677835,14,Jalen Hood-Schifino,1,2,3,3,1,5.5
0,0,1,0,0,7,5,0,0,7,1,0,10,2,0,0,1038020,2023-12-28T00:00:00.000Z,666626,14,Jaxson Hayes,0,12,12,10,2,12.4
0,0,0,0,0,0,0,0,0,0,0,0,0,0,0,0,1038020,2023-12-28T00:00:00.000Z,56677836,14,Maxwell Lewis,0,0,0,0,0,0
3,0,3,4,1,7,1,0,0,23,0,2,3,3,3,1,1038020,2023-12-28T00:00:00.000Z,383,14,Taurean Prince,3,6,9,6,6,19.1
0,0,0,0,0,0,0,0,0,0,0,0,0,0,0,0,1038021,2023-12-29T00:00:00.000Z,666675,20,DaQuan Jeffries,0,0,0,0,0,0
2,1,1,5,0,7,1,0,0,20,0,4,2,1,3,1,1038021,2023-12-29T00:00:00.000Z,131,20,Donte DiVincenzo,4,3,5,4,3,17.2
0,0,0,0,0,0,0,0,0,0,0,0,0,0,0,0,1038021,2023-12-29T00:00:00.000Z,160,20,Evan Fournier,0,0,0,0,0,0
1,0,1,7,3,10,4,1,1,28,0,4,12,1,0,1,1038021,2023-12-29T00:00:00.000Z,3547269,20,Immanuel Quickley,0,13,14,13,2,13.7
3,0,2,0,0,4,2,3,3,25,1,4,7,3,3,2,1038021,2023-12-29T00:00:00.000Z,201,20,Isaiah Hartenstein,3,10,13,10,6,22.1
8,1,7,4,0,15,4,12,12,34,0,2,20,7,0,3,1038021,2023-12-29T00:00:00.000Z,73,20,Jalen Brunson,1,27,35,28,15,40.4
0,0,4,2,1,4,2,0,0,31,0,2,5,4,0,2,1038021,2023-12-29T00:00:00.000Z,202,20,Josh Hart,0,9,9,5,4,7.8
6,1,9,4,0,25,16,8,6,36,3,5,38,12,0,5,1038021,2023-12-29T00:00:00.000Z,387,20,Julius Randle,1,50,56,44,18,59.4
0,0,2,3,1,3,1,0,0,14,0,1,3,2,1,0,1038021,2023-12-29T00:00:00.000Z,17895858,20,Quentin Grimes,1,5,5,3,2,8.4
2,0,4,5,1,17,7,5,4,37,2,4,19,6,1,2,1038021,2023-12-29T00:00:00.000Z,666423,20,RJ Barrett,1,25,27,21,8,30.2
0,0,0,0,0,0,0,0,0,0,0,0,0,0,0,0,1038021,2023-12-29T00:00:00.000Z,19,20,Ryan Arcidiacono,0,0,0,0,0,0
0,1,4,0,0,1,1,0,0,15,0,4,2,4,0,0,1038021,2023-12-29T00:00:00.000Z,173,20,Taj Gibson,1,6,6,2,4,9.8
0,0,0,0,0,0,0,0,0,0,0,0,0,0,0,0,1038021,2023-12-29T00:00:00.000Z,666885,22,Admiral Schofield,0,0,0,0,0,0
5,0,4,0,0,2,2,0,0,29,2,4,4,6,2,1,1038021,2023-12-29T00:00:00.000Z,56677827,22,Anthony Black,2,10,15,9,11,23.7
0,0,0,5,0,5,0,0,0,21,2,1,0,2,0,1,1038021,2023-12-29T00:00:00.000Z,38017724,22,Caleb Houstan,0,2,2,0,2,1.4
1,0,0,4,0,5,1,0,0,12,0,1,2,0,0,0,1038021,2023-12-29T00:00:00.000Z,666818,22,Chuma Okeke,0,2,3,3,1,3.5
5,0,2,3,0,8,3,4,3,23,0,2,9,2,2,1,1038021,2023-12-29T00:00:00.000Z,3547251,22,Cole Anthony,2,11,16,14,7,23.9
2,1,7,5,3,19,11,7,7,39,2,1,32,9,4,4,1038021,2023-12-29T00:00:00.000Z,17896026,22,Franz Wagner,5,41,43,34,11,56.8
0,0,0,0,0,0,0,0,0,0,0,0,0,0,0,0,1038021,2023-12-29T00:00:00.000Z,196,22,Gary Harris,0,0,0,0,0,0
0,2,4,0,0,8,4,8,5,31,3,3,13,7,1,2,1038021,2023-12-29T00:00:00.000Z,666442,22,Goga Bitadze,3,20,20,13,7,28.4
6,1,2,7,2,15,8,6,3,31,0,4,21,2,0,3,1038021,2023-12-29T00:00:00.000Z,17896073,22,Jalen Suggs,1,23,29,27,8,32.4
0,0,0,0,0,0,0,0,0,0,0,0,0,0,0,0,1038021,2023-12-29T00:00:00.000Z,56677839,22,Jett Howard,0,0,0,0,0,0
0,0,0,0,0,0,0,0,0,0,0,0,0,0,0,0,1038021,2023-12-29T00:00:00.000Z,226,22,Joe Ingles,0,0,0,0,0,0
0,0,0,0,0,0,0,0,0,0,0,0,0,0,0,0,1038021,2023-12-29T00:00:00.000Z,229,22,Jonathan Isaac,0,0,0,0,0,0
0,0,0,0,0,0,0,0,0,0,0,0,0,0,0,0,1038021,2023-12-29T00:00:00.000Z,38017607,22,Kevon Harris,0,0,0,0,0,0
0,0,0,0,0,0,0,0,0,0,0,0,0,0,0,0,1038021,2023-12-29T00:00:00.000Z,165,22,Markelle Fultz,0,0,0,0,0,0
1,1,7,3,0,8,2,3,3,18,4,1,7,11,0,1,1038021,2023-12-29T00:00:00.000Z,462,22,Moritz Wagner,1,18,19,8,12,23.7
4,1,9,6,2,19,9,12,9,36,1,3,29,10,1,2,1038021,2023-12-29T00:00:00.000Z,38017683,22,Paolo Banchero,2,39,43,33,14,51
0,0,0,0,0,0,0,0,0,0,0,0,0,0,0,0,1038021,2023-12-29T00:00:00.000Z,17553983,22,Trevelin Queen,0,0,0,0,0,0
0,0,0,0,0,0,0,0,0,0,0,0,0,0,0,0,1038021,2023-12-29T00:00:00.000Z,85,22,Wendell Carter Jr.,0,0,0,0,0,0
0,0,0,0,0,0,0,0,0,0,0,0,0,0,0,0,1038022,2023-12-29T00:00:00.000Z,9051997,3,Armoni Brooks,0,0,0,0,0,0
0,0,0,0,0,0,0,0,0,0,0,0,0,0,0,0,1038022,2023-12-29T00:00:00.000Z,417,3,Ben Simmons,0,0,0,0,0,0
3,0,1,1,0,15,6,6,3,24,0,0,15,1,0,1,1038022,2023-12-29T00:00:00.000Z,17896048,3,Cam Thomas,0,16,19,18,4,19.7
0,0,0,0,0,0,0,0,0,0,0,0,0,0,0,0,1038022,2023-12-29T00:00:00.000Z,56677841,3,Dariq Whitehead,0,0,0,0,0,0
3,0,4,0,0,7,5,0,0,18,5,3,10,9,0,2,1038022,2023-12-29T00:00:00.000Z,17896038,3,Day'Ron Sharpe,0,19,22,13,12,23.3
3,0,2,1,0,6,2,2,1,20,0,3,5,2,2,0,1038022,2023-12-29T00:00:00.000Z,421,3,Dennis Smith Jr.,2,7,10,8,5,17.9
0,0,0,0,0,0,0,0,0,0,0,0,0,0,0,0,1038022,2023-12-29T00:00:00.000Z,17896041,3,Keon Johnson,0,0,0,0,0,0
0,0,0,0,0,0,0,0,0,0,0,0,0,0,0,0,1038022,2023-12-29T00:00:00.000Z,464,3,Lonnie Walker IV,0,0,0,0,0,0
0,0,0,0,0,0,0,0,0,0,0,0,0,0,0,0,1038022,2023-12-29T00:00:00.000Z,56677843,3,Noah Clowney,0,0,0,0,0,0
0,0,0,0,0,0,0,0,0,0,0,0,0,0,0,0,1038022,2023-12-29T00:00:00.000Z,17896058,3,Trendon Watford,0,0,0,0,0,0
2,0,4,0,0,3,2,0,0,19,2,3,4,6,0,1,1038022,2023-12-29T00:00:00.000Z,56677844,30,Bilal Coulibaly,0,10,12,6,8,13.2
0,0,0,7,3,10,6,0,0,17,0,2,15,0,0,0,1038022,2023-12-29T00:00:00.000Z,17896045,30,Corey Kispert,0,15,15,15,0,15
0,0,4,0,0,4,1,2,2,17,1,4,4,5,1,1,1038022,2023-12-29T00:00:00.000Z,666577,30,Daniel Gafford,1,9,9,4,5,12
6,1,11,5,3,18,9,4,0,34,2,2,21,13,1,1,1038022,2023-12-29T00:00:00.000Z,3547242,30,Deni Avdija,2,34,40,27,19,50.6
0,0,0,0,0,0,0,0,0,0,0,0,0,0,0,0,1038022,2023-12-29T00:00:00.000Z,18677954,30,Jared Butler,0,0,0,0,0,0
0,0,0,0,0,0,0,0,0,0,0,0,0,0,0,0,1038022,2023-12-29T00:00:00.000Z,38017687,30,Johnny Davis,0,0,0,0,0,0
5,0,0,4,1,6,2,0,0,25,0,4,5,0,0,1,1038022,2023-12-29T00:00:00.000Z,666848,30,Jordan Poole,0,5,10,10,5,11.5
2,1,7,10,4,22,11,0,0,31,1,1,26,8,0,2,1038022,2023-12-29T00:00:00.000Z,265,30,Kyle Kuzma,1,34,36,28,10,39.6
0,0,0,0,0,0,0,0,0,0,0,0,0,0,0,0,1038022,2023-12-29T00:00:00.000Z,38017704,30,Patrick Baldwin Jr.,0,0,0,0,0,0
6,0,3,0,0,9,6,0,0,31,1,0,12,4,0,0,1038022,2023-12-29T00:00:00.000Z,249,30,Tyus Jones,0,16,22,18,10,25.8
0,0,0,0,0,0,0,0,0,0,0,0,0,0,0,0,1038023,2023-12-29T00:00:00.000Z,38017689,1,AJ Griffin,0,0,0,0,0,0
0,0,0,0,0,0,0,0,0,0,0,0,0,0,0,0,1038023,2023-12-29T00:00:00.000Z,666564,1,Bruno Fernando,0,0,0,0,0,0
0,0,0,0,0,0,0,0,0,0,0,0,0,0,0,0,1038023,2023-12-29T00:00:00.000Z,666656,1,De'Andre Hunter,0,0,0,0,0,0
0,0,0,0,0,0,0,0,0,0,0,0,0,0,0,0,1038023,2023-12-29T00:00:00.000Z,56677838,1,Kobe Bufkin,0,0,0,0,0,0
0,0,0,0,0,0,0,0,0,0,0,0,0,0,0,0,1038023,2023-12-29T00:00:00.000Z,56677806,1,Mouhamed Gueye,0,0,0,0,0,0
0,0,0,0,0,0,0,0,0,0,0,0,0,0,0,0,1038023,2023-12-29T00:00:00.000Z,56677855,1,Seth Lundy,0,0,0,0,0,0
0,0,0,0,0,0,0,0,0,0,0,0,0,0,0,0,1038023,2023-12-29T00:00:00.000Z,3547297,1,Trent Forrest,0,0,0,0,0,0
0,0,0,0,0,0,0,0,0,0,0,0,0,0,0,0,1038023,2023-12-29T00:00:00.000Z,4197387,1,Vit Krejci,0,0,0,0,0,0
0,0,0,0,0,0,0,0,0,0,0,0,0,0,0,0,1038023,2023-12-29T00:00:00.000Z,301,1,Wesley Matthews,0,0,0,0,0,0
0,0,0,0,0,0,0,0,0,0,0,0,0,0,0,0,1038023,2023-12-29T00:00:00.000Z,4197162,26,Aleksandar Vezenkov,0,0,0,0,0,0
0,0,0,0,0,0,0,0,0,0,0,0,0,0,0,0,1038023,2023-12-29T00:00:00.000Z,56677845,26,Colby Jones,0,0,0,0,0,0
7,0,8,0,0,17,12,4,1,35,2,2,25,10,0,1,1038023,2023-12-29T00:00:00.000Z,406,26,Domantas Sabonis,0,35,42,32,17,46.5
0,0,0,2,0,2,0,2,2,12,0,1,2,0,0,0,1038023,2023-12-29T00:00:00.000Z,30,26,Harrison Barnes,0,2,2,2,0,2
0,0,0,0,0,0,0,0,0,0,0,0,0,0,0,0,1038023,2023-12-29T00:00:00.000Z,56677862,26,Jalen Slawson,0,0,0,0,0,0
0,0,0,0,0,0,0,0,0,0,0,0,0,0,0,0,1038023,2023-12-29T00:00:00.000Z,306,26,JaVale McGee,0,0,0,0,0,0
0,0,0,0,0,0,0,0,0,0,0,0,0,0,0,0,1038023,2023-12-29T00:00:00.000Z,17895990,26,Jordan Ford,0,0,0,0,0,0
0,0,0,0,0,0,0,0,0,0,0,0,0,0,0,0,1038023,2023-12-29T00:00:00.000Z,666925,26,Juan Toscano-Anderson,0,0,0,0,0,0
0,2,5,6,1,12,4,0,0,36,0,5,9,5,3,0,1038023,2023-12-29T00:00:00.000Z,38017688,26,Keegan Murray,5,14,14,9,5,30
1,0,3,3,1,6,3,0,0,10,0,0,7,3,0,0,1038023,2023-12-29T00:00:00.000Z,221,26,Kevin Huerter,0,10,11,8,4,12.1
0,0,0,0,0,1,1,0,0,2,0,0,2,0,0,1,1038024,2023-12-29T00:00:00.000Z,17896094,2,Dalano Banton,0,2,2,2,0,1
7,2,4,10,2,19,5,9,9,36,1,2,21,5,3,3,1038024,2023-12-29T00:00:00.000Z,473,2,Derrick White,5,26,33,28,12,49.5
6,0,9,6,5,16,11,5,4,41,1,4,31,10,0,7,1038024,2023-12-29T00:00:00.000Z,70,2,Jaylen Brown,0,41,47,37,16,45
0,0,0,0,0,0,0,0,0,0,0,0,0,0,0,0,1038024,2023-12-29T00:00:00.000Z,56677864,2,Jordan Walsh,0,0,0,0,0,0
3,0,2,5,3,15,5,4,2,32,0,1,15,2,0,1,1038024,2023-12-29T00:00:00.000Z,214,2,Jrue Holiday,0,17,20,18,5,20.9
0,0,0,0,0,0,0,0,0,0,0,0,0,0,0,0,1038024,2023-12-29T00:00:00.000Z,378,2,Kristaps Porzingis,0,0,0,0,0,0
3,3,3,0,0,11,9,2,2,33,5,3,20,8,0,1,1038024,2023-12-29T00:00:00.000Z,261,2,Luke Kornet,3,28,31,23,11,42.1
1,1,9,7,3,7,3,0,0,34,0,2,9,9,0,0,1038024,2023-12-29T00:00:00.000Z,17896060,2,Sam Hauser,1,18,19,10,10,24.3
0,0,3,3,1,3,1,0,0,7,0,1,3,3,0,0,1038024,2023-12-29T00:00:00.000Z,58,28,Chris Boucher,0,6,6,3,3,6.6
0,0,0,0,0,0,0,0,0,0,0,0,0,0,0,0,1038024,2023-12-29T00:00:00.000Z,38017710,28,Christian Koloko,0,0,0,0,0,0
9,1,0,5,2,12,6,2,1,35,2,2,15,2,0,0,1038024,2023-12-29T00:00:00.000Z,409,28,Dennis Schroder,1,17,26,24,11,33.9
0,0,0,0,0,0,0,0,0,0,0,0,0,0,0,0,1038024,2023-12-29T00:00:00.000Z,436,28,Garrett Temple,0,0,0,0,0,0
1,0,4,4,1,10,2,2,1,29,0,0,6,4,2,0,1038024,2023-12-29T00:00:00.000Z,3089,28,Gary Trent Jr.,2,10,11,7,5,18.3
0,0,0,0,0,0,0,0,0,0,0,0,0,0,0,0,1038024,2023-12-29T00:00:00.000Z,56677828,28,Gradey Dick,0,0,0,0,0,0
3,2,6,0,0,8,5,2,2,22,4,3,12,10,0,0,1038024,2023-12-29T00:00:00.000Z,373,28,Jakob Poeltl,2,22,25,15,13,34.5
2,0,0,7,2,10,5,2,1,15,0,4,13,0,1,0,1038024,2023-12-29T00:00:00.000Z,666762,28,Jalen McDaniels,1,13,15,15,2,19
0,0,0,0,0,0,0,0,0,0,0,0,0,0,0,0,1038024,2023-12-29T00:00:00.000Z,56677805,28,Javon Freeman-Liberty,0,0,0,0,0,0
0,0,0,0,0,0,0,0,0,0,0,0,0,0,0,0,1038024,2023-12-29T00:00:00.000Z,2309958,28,Jontay Porter,0,0,0,0,0,0
0,0,0,0,0,0,0,0,0,6,0,1,0,0,2,0,1038024,2023-12-29T00:00:00.000Z,3547275,28,Malachi Flynn,2,0,0,0,0,6
0,0,0,0,0,0,0,0,0,0,0,0,0,0,0,0,1038024,2023-12-29T00:00:00.000Z,56677869,28,Markquis Nowell,0,0,0,0,0,0
2,0,2,4,2,8,5,0,0,37,0,1,12,2,2,1,1038024,2023-12-29T00:00:00.000Z,18,28,OG Anunoby,2,14,16,14,4,22.4
2,0,0,1,0,1,0,0,0,8,0,0,0,0,0,0,1038024,2023-12-29T00:00:00.000Z,376,28,Otto Porter Jr.,0,0,2,2,2,3
5,0,5,5,2,18,10,8,5,41,0,1,27,5,2,1,1038024,2023-12-29T00:00:00.000Z,416,28,Pascal Siakam,2,32,37,32,10,45.5
0,0,2,0,0,1,0,0,0,2,0,0,0,2,0,0,1038024,2023-12-29T00:00:00.000Z,3547249,28,Precious Achiuwa,0,2,2,0,2,2.4
5,3,7,15,7,24,10,4,3,38,3,2,30,10,1,2,1038024,2023-12-29T00:00:00.000Z,17896055,28,Scottie Barnes,4,40,45,35,15,59.5
0,0,0,0,0,0,0,0,0,0,0,0,0,0,0,0,1038024,2023-12-29T00:00:00.000Z,489,28,Thaddeus Young,0,0,0,0,0,0
4,0,1,6,0,14,3,0,0,28,0,2,6,1,1,2,1038025,2023-12-29T00:00:00.000Z,277,6,Caris LeVert,1,7,11,10,5,14.2
1,0,1,3,1,10,6,1,1,15,0,1,14,1,1,0,1038025,2023-12-29T00:00:00.000Z,56677872,6,Craig Porter,1,15,16,15,2,19.7
0,0,0,0,0,0,0,0,0,0,0,0,0,0,0,0,1038025,2023-12-29T00:00:00.000Z,248,6,Damian Jones,0,0,0,0,0,0
0,0,0,0,0,0,0,0,0,0,0,0,0,0,0,0,1038025,2023-12-29T00:00:00.000Z,666581,6,Darius Garland,0,0,0,0,0,0
1,0,5,2,0,3,0,0,0,17,0,1,0,5,1,2,1038025,2023-12-29T00:00:00.000Z,666940,6,Dean Wade,1,5,6,1,6,8.5
9,1,5,10,2,23,14,4,4,36,1,3,34,6,2,2,1038025,2023-12-29T00:00:00.000Z,322,6,Donovan Mitchell,3,40,49,43,15,61.7
0,0,0,0,0,0,0,0,0,0,0,0,0,0,0,0,1038025,2023-12-29T00:00:00.000Z,56677847,6,Emoni Bates,0,0,0,0,0,0
0,1,0,6,0,7,1,0,0,14,0,2,2,0,1,0,1038025,2023-12-29T00:00:00.000Z,344,6,Georges Niang,2,2,2,2,0,8
3,1,2,1,0,5,3,2,2,30,0,3,8,2,1,1,1038025,2023-12-29T00:00:00.000Z,3547247,6,Isaac Okoro,2,10,13,11,5,19.9
6,2,9,0,0,17,15,0,0,40,3,2,30,12,0,0,1038025,2023-12-29T00:00:00.000Z,9,6,Jarrett Allen,2,42,48,36,18,59.4
2,2,3,11,2,18,5,0,0,37,1,3,12,4,4,1,1038025,2023-12-29T00:00:00.000Z,666908,6,Max Strus,6,16,18,14,6,36.8
1,0,0,4,1,4,1,0,0,15,0,1,3,0,0,0,1038025,2023-12-29T00:00:00.000Z,3547299,6,Sam Merrill,0,3,4,4,1,4.5
3,0,1,2,0,6,2,0,0,15,1,2,4,2,2,3,1038026,2023-12-29T00:00:00.000Z,213,11,Aaron Holiday,2,6,9,7,5,13.9
8,1,4,2,1,16,12,4,3,34,3,6,28,7,1,5,1038026,2023-12-29T00:00:00.000Z,17896062,11,Alperen Sengun,2,35,43,36,15,49.4
1,0,2,0,0,1,0,2,1,9,1,1,1,3,0,0,1038026,2023-12-29T00:00:00.000Z,56677825,11,Amen Thompson,0,4,5,2,4,6.1
10,1,3,12,8,16,9,8,7,43,0,3,33,3,1,5,1038026,2023-12-29T00:00:00.000Z,458,11,Fred VanVleet,2,36,46,43,13,52.6
0,0,0,0,0,0,0,0,0,0,0,0,0,0,0,0,1038026,2023-12-29T00:00:00.000Z,38017684,11,Jabari Smith Jr.,0,0,0,0,0,0
2,0,4,1,0,4,2,0,0,35,1,3,4,5,0,0,1038026,2023-12-29T00:00:00.000Z,3547301,11,Jae'Sean Tate,0,9,11,6,7,13
4,0,6,9,5,19,12,4,2,36,0,0,31,6,0,1,1038026,2023-12-29T00:00:00.000Z,17895966,11,Jalen Green,0,37,41,35,10,43.2
0,0,0,0,0,0,0,0,0,0,0,0,0,0,0,0,1038026,2023-12-29T00:00:00.000Z,47738533,11,Jeenathan Williams,0,0,0,0,0,0
0,1,2,2,0,11,5,1,0,33,2,2,10,4,1,0,1038026,2023-12-29T00:00:00.000Z,188,11,Jeff Green,2,14,14,10,4,20.8
0,0,0,0,0,0,0,0,0,0,0,0,0,0,0,0,1038026,2023-12-29T00:00:00.000Z,56677809,11,Jermaine Samuels Jr.,0,0,0,0,0,0
0,1,0,0,0,5,2,2,2,8,1,4,6,1,0,0,1038026,2023-12-29T00:00:00.000Z,19465326,11,Jock Landale,1,7,7,6,1,10.2
0,0,0,0,0,0,0,0,0,0,0,0,0,0,0,0,1038026,2023-12-29T00:00:00.000Z,75,11,Reggie Bullock,0,0,0,0,0,0
2,2,6,2,0,13,5,0,0,27,5,3,10,11,3,2,1038026,2023-12-29T00:00:00.000Z,38017695,11,Tari Eason,5,21,23,12,13,39.2
2,0,3,7,2,12,5,4,3,36,0,1,15,3,1,2,1038026,2023-12-29T00:00:00.000Z,313,23,De'Anthony Melton,1,18,20,17,5,22.6
1,0,1,4,3,7,4,2,2,24,0,1,13,1,0,3,1038026,2023-12-29T00:00:00.000Z,360,23,Kelly Oubre Jr.,0,14,15,14,2,12.7
4,0,0,0,0,5,3,2,1,24,2,3,7,2,1,0,1038026,2023-12-29T00:00:00.000Z,3547270,23,Paul Reed,1,9,13,11,6,18.4
7,3,3,6,2,18,10,0,0,35,1,3,22,4,4,3,1038026,2023-12-29T00:00:00.000Z,200,23,Tobias Harris,7,26,33,29,11,55.3
0,0,0,0,0,0,0,0,0,0,0,0,0,0,0,0,1038027,2023-12-29T00:00:00.000Z,177,8,Aaron Gordon,0,0,0,0,0,0
0,0,0,0,0,2,1,1,1,3,0,0,3,0,0,0,1038027,2023-12-29T00:00:00.000Z,17896007,8,Braxton Key,0,3,3,3,0,3
1,0,3,2,0,3,0,4,4,17,0,1,4,3,0,1,1038027,2023-12-29T00:00:00.000Z,38017709,8,Christian Braun,0,7,8,5,4,8.1
0,0,0,0,0,0,0,0,0,0,0,0,0,0,0,0,1038027,2023-12-29T00:00:00.000Z,38017727,8,Collin Gillespie,0,0,0,0,0,0
1,0,5,0,0,4,3,0,0,13,3,0,6,8,1,1,1038027,2023-12-29T00:00:00.000Z,250,8,DeAndre Jordan,1,14,15,7,9,19.1
0,0,0,0,0,0,0,0,0,0,0,0,0,0,0,0,1038027,2023-12-29T00:00:00.000Z,56677871,8,Hunter Tyson,0,0,0,0,0,0
0,0,0,0,0,1,0,0,0,3,0,1,0,0,0,0,1038027,2023-12-29T00:00:00.000Z,56677582,8,Jalen Pickett,0,0,0,0,0,0
11,1,3,6,1,15,4,1,0,36,0,1,9,3,1,2,1038027,2023-12-29T00:00:00.000Z,335,8,Jamal Murray,2,12,23,20,14,33.1
0,0,0,0,0,0,0,0,0,0,0,0,0,0,0,0,1038027,2023-12-29T00:00:00.000Z,17896103,8,Jay Huff,0,0,0,0,0,0
0,0,1,4,1,7,3,4,3,12,0,3,10,1,0,3,1038027,2023-12-29T00:00:00.000Z,56677776,8,Julian Strawther,0,11,11,10,1,8.2
2,0,1,2,0,3,0,0,0,16,0,1,0,1,0,0,1038027,2023-12-29T00:00:00.000Z,215,8,Justin Holiday,0,1,3,2,3,4.2
2,0,0,3,2,5,3,1,0,27,0,3,8,0,1,1,1038027,2023-12-29T00:00:00.000Z,81,8,Kentavious Caldwell-Pope,1,8,10,10,2,13
1,1,6,8,2,12,4,2,2,31,0,1,12,6,0,0,1038027,2023-12-29T00:00:00.000Z,375,8,Michael Porter Jr.,1,18,19,13,7,23.7
7,1,8,1,1,10,9,0,0,32,2,2,19,10,1,7,1038027,2023-12-29T00:00:00.000Z,246,8,Nikola Jokic,2,29,36,26,17,40.5
2,2,2,6,1,12,6,2,1,32,0,4,14,2,1,1,1038027,2023-12-29T00:00:00.000Z,38017721,8,Peyton Watson,3,16,18,16,4,27.4
3,0,2,5,2,10,3,0,0,15,0,0,8,2,1,0,1038027,2023-12-29T00:00:00.000Z,236,8,Reggie Jackson,1,10,13,11,5,17.9
0,0,0,0,0,0,0,0,0,0,0,0,0,0,0,0,1038027,2023-12-29T00:00:00.000Z,666489,8,Vlatko Cancar,0,0,0,0,0,0
0,0,0,0,0,1,0,0,0,3,0,0,0,0,0,0,1038027,2023-12-29T00:00:00.000Z,3547268,8,Zeke Nnaji,0,0,0,0,0,0
1,1,3,3,0,6,2,0,0,32,1,3,4,4,3,1,1038027,2023-12-29T00:00:00.000Z,666541,21,Luguentz Dort,4,8,9,5,5,21.3
0,0,0,0,0,0,0,0,0,0,0,0,0,0,0,0,1038028,2023-12-29T00:00:00.000Z,56677848,4,Amari Bailey,0,0,0,0,0,0
0,0,0,0,0,0,0,0,0,0,0,0,0,0,0,0,1038028,2023-12-29T00:00:00.000Z,347,4,Frank Ntilikina,0,0,0,0,0,0
0,0,0,0,0,0,0,0,0,0,0,0,0,0,0,0,1038028,2023-12-29T00:00:00.000Z,204,4,Gordon Hayward,0,0,0,0,0,0
0,0,0,0,0,0,0,0,0,0,0,0,0,0,0,0,1038028,2023-12-29T00:00:00.000Z,3547239,4,LaMelo Ball,0,0,0,0,0,0
0,0,0,0,0,0,0,0,0,0,0,0,0,0,0,0,1038028,2023-12-29T00:00:00.000Z,56677866,4,Leaky Black,0,0,0,0,0,0
0,0,0,0,0,0,0,0,0,0,0,0,0,0,0,0,1038028,2023-12-29T00:00:00.000Z,38017698,4,Mark Williams,0,0,0,0,0,0
0,0,0,0,0,0,0,0,0,0,0,0,0,0,0,0,1038029,2023-12-29T00:00:00.000Z,419,25,Anfernee Simons,0,0,0,0,0,0
0,0,0,0,0,0,0,0,0,0,0,0,0,0,0,0,1038029,2023-12-29T00:00:00.000Z,22,25,Deandre Ayton,0,0,0,0,0,0
0,0,0,0,0,0,0,0,0,0,0,0,0,0,0,0,1038029,2023-12-29T00:00:00.000Z,56783340,25,Duop Reath,0,0,0,0,0,0
1,2,1,0,0,0,0,2,2,10,1,3,2,2,0,0,1038029,2023-12-29T00:00:00.000Z,39613724,25,Ibou Badji,2,4,5,3,3,11.9
0,0,0,0,0,0,0,0,0,0,0,0,0,0,0,0,1038029,2023-12-29T00:00:00.000Z,17896120,25,Ish Wainright,0,0,0,0,0,0
1,1,3,2,1,11,7,13,10,30,6,4,25,9,1,1,1038029,2023-12-29T00:00:00.000Z,38017711,25,Jabari Walker,2,34,35,26,10,42.3
0,0,0,0,0,0,0,0,0,0,0,0,0,0,0,0,1038029,2023-12-29T00:00:00.000Z,47957121,25,Justin Minaya,0,0,0,0,0,0
0,0,0,0,0,0,0,0,0,0,0,0,0,0,0,0,1038029,2023-12-29T00:00:00.000Z,56677791,25,Kris Murray,0,0,0,0,0,0
7,0,1,7,5,18,9,4,4,37,0,2,27,1,1,1,1038029,2023-12-29T00:00:00.000Z,65,25,Malcolm Brogdon,1,28,35,34,8,40.7
0,2,1,4,1,6,3,0,0,27,0,1,7,1,1,1,1038029,2023-12-29T00:00:00.000Z,666923,25,Matisse Thybulle,3,8,8,7,1,16.2
0,0,4,0,0,0,0,0,0,4,0,1,0,4,0,0,1038029,2023-12-29T00:00:00.000Z,666476,25,Moses Brown,0,4,4,0,4,4.8
0,0,0,0,0,0,0,0,0,0,0,0,0,0,0,0,1038029,2023-12-29T00:00:00.000Z,56677829,25,Rayan Rupert,0,0,0,0,0,0
0,0,0,0,0,0,0,0,0,0,0,0,0,0,0,0,1038029,2023-12-29T00:00:00.000Z,476,25,Robert Williams III,0,0,0,0,0,0
11,1,3,5,3,21,9,2,1,37,4,5,22,7,1,4,1038029,2023-12-29T00:00:00.000Z,56677747,25,Scoot Henderson,2,29,40,33,18,48.9
0,0,0,0,0,0,0,0,0,0,0,0,0,0,0,0,1038029,2023-12-29T00:00:00.000Z,38017690,25,Shaedon Sharpe,0,0,0,0,0,0
2,0,1,1,1,10,5,0,0,20,1,0,11,2,1,0,1038029,2023-12-29T00:00:00.000Z,3547289,25,Skylar Mays,1,13,15,13,4,19.4
0,0,0,0,0,0,0,0,0,0,0,0,0,0,0,0,1038029,2023-12-29T00:00:00.000Z,38017693,27,Blake Wesley,0,0,0,0,0,0
2,0,4,1,0,4,2,0,0,18,0,1,4,4,0,0,1038029,2023-12-29T00:00:00.000Z,359,27,Cedi Osman,0,8,10,6,6,11.8
0,0,0,0,0,0,0,0,0,0,0,0,0,0,0,0,1038029,2023-12-29T00:00:00.000Z,17895854,27,Charles Bassey,0,0,0,0,0,0
0,0,0,0,0,0,0,0,0,0,0,0,0,0,0,0,1038029,2023-12-29T00:00:00.000Z,17896049,27,David Duke Jr.,0,0,0,0,0,0
5,1,3,6,3,16,8,4,3,31,0,1,22,3,4,0,1038029,2023-12-29T00:00:00.000Z,3547246,27,Devin Vassell,5,25,30,27,8,48.1
0,0,0,0,0,0,0,0,0,0,0,0,0,0,0,0,1038029,2023-12-29T00:00:00.000Z,180,27,Devonte' Graham,0,0,0,0,0,0
0,0,1,1,0,6,1,0,0,14,1,2,2,2,1,0,1038029,2023-12-29T00:00:00.000Z,38017730,27,Dominick Barlow,1,4,4,2,2,7.4
1,0,1,8,6,9,6,0,0,23,0,1,18,1,0,2,1038029,2023-12-29T00:00:00.000Z,305,27,Doug McDermott,0,19,20,19,2,18.7
4,0,3,0,0,3,0,2,2,29,1,2,2,4,1,3,1038029,2023-12-29T00:00:00.000Z,38017699,27,Jeremy Sochan,1,6,10,6,8,12.8
0,1,1,4,1,5,1,5,4,12,2,1,7,3,1,1,1038029,2023-12-29T00:00:00.000Z,38017649,27,Julian Champagnie,2,10,10,7,3,15.6
7,0,5,8,3,18,9,11,8,32,2,4,29,7,1,1,1038029,2023-12-29T00:00:00.000Z,666682,27,Keldon Johnson,1,36,43,36,14,49.9
3,0,3,3,1,12,5,0,0,29,3,1,11,6,1,3,1038029,2023-12-29T00:00:00.000Z,38017692,27,Malaki Branham,1,17,20,14,9,22.7
2,0,1,1,0,2,1,0,0,7,0,1,2,1,0,0,1038029,2023-12-29T00:00:00.000Z,17896059,27,Sandro Mamukelashvili,0,3,5,4,3,6.2
0,0,0,0,0,0,0,0,0,0,0,0,0,0,0,0,1038029,2023-12-29T00:00:00.000Z,56677817,27,Sidy Cissoko,0,0,0,0,0,0
5,0,5,0,0,9,7,0,0,27,3,2,14,8,0,3,1038029,2023-12-29T00:00:00.000Z,3547274,27,Tre Jones,0,22,27,19,13,28.1
0,0,0,0,0,0,0,0,0,0,0,0,0,0,0,0,1038029,2023-12-29T00:00:00.000Z,56677822,27,Victor Wembanyama,0,0,0,0,0,0
2,1,2,1,0,10,8,3,1,18,1,3,17,3,0,1,1038029,2023-12-29T00:00:00.000Z,102,27,Zach Collins,1,20,22,19,5,25.6
2,0,1,4,3,6,5,0,0,31,1,0,13,2,1,0,1038030,2023-12-29T00:00:00.000Z,666511,13,Amir Coffey,1,15,17,15,4,21.4
0,0,0,0,0,0,0,0,0,0,0,0,0,0,0,0,1038030,2023-12-29T00:00:00.000Z,17896022,13,Brandon Boston Jr.,0,0,0,0,0,0
0,2,1,1,0,3,2,2,1,13,1,3,5,2,0,1,1038030,2023-12-29T00:00:00.000Z,439,13,Daniel Theis,2,7,7,5,2,12.4
1,1,14,0,0,8,7,1,1,33,6,3,15,20,0,2,1038030,2023-12-29T00:00:00.000Z,493,13,Ivica Zubac,1,35,36,16,21,41.5
13,3,4,9,2,13,4,8,6,44,0,1,16,4,0,5,1038030,2023-12-29T00:00:00.000Z,192,13,James Harden,3,20,33,29,17,44.3
0,0,0,0,0,0,0,0,0,0,0,0,0,0,0,0,1038030,2023-12-29T00:00:00.000Z,56677856,13,Jordan Miller,0,0,0,0,0,0
0,0,0,0,0,0,0,0,0,0,0,0,0,0,0,0,1038030,2023-12-29T00:00:00.000Z,17896051,13,Joshua Primo,0,0,0,0,0,0
0,0,0,0,0,0,0,0,0,0,0,0,0,0,0,0,1038030,2023-12-29T00:00:00.000Z,274,13,Kawhi Leonard,0,0,0,0,0,0
0,0,4,3,1,5,3,0,0,15,0,2,7,4,0,0,1038030,2023-12-29T00:00:00.000Z,56677849,13,Kobe Brown,0,11,11,7,4,11.8
0,0,0,0,0,0,0,0,0,0,0,0,0,0,0,0,1038030,2023-12-29T00:00:00.000Z,371,13,Mason Plumlee,0,0,0,0,0,0
0,0,0,0,0,0,0,0,0,0,0,0,0,0,0,0,1038030,2023-12-29T00:00:00.000Z,38017725,13,Moussa Diabate,0,0,0,0,0,0
0,0,0,0,0,0,0,0,0,0,0,0,0,0,0,0,1038030,2023-12-29T00:00:00.000Z,17896031,13,Nah'Shon Hyland,0,0,0,0,0,0
1,0,6,4,1,12,5,2,2,25,0,2,13,6,0,1,1038030,2023-12-29T00:00:00.000Z,380,13,Norman Powell,0,19,20,14,7,20.7
3,0,6,8,2,21,8,6,5,36,1,6,23,7,1,4,1038030,2023-12-29T00:00:00.000Z,172,13,Paul George,1,30,33,26,10,34.9
0,0,0,0,0,0,0,0,0,0,0,0,0,0,0,0,1038030,2023-12-29T00:00:00.000Z,450,13,PJ Tucker,0,0,0,0,0,0
6,0,5,4,2,9,6,0,0,20,1,1,14,6,0,4,1038030,2023-12-29T00:00:00.000Z,472,13,Russell Westbrook,0,20,26,20,12,26.2
2,0,2,6,0,10,3,6,5,23,1,1,11,3,1,0,1038030,2023-12-29T00:00:00.000Z,666743,13,Terance Mann,1,14,16,13,5,20.6
0,0,0,0,0,0,0,0,0,0,0,0,0,0,0,0,1038030,2023-12-29T00:00:00.000Z,24417679,13,Xavier Moon,0,0,0,0,0,0
0,0,2,0,0,2,1,0,0,8,0,1,2,2,1,1,1038030,2023-12-29T00:00:00.000Z,48,15,Bismack Biyombo,1,4,4,2,2,6.4
0,0,0,0,0,0,0,0,0,0,0,0,0,0,0,0,1038030,2023-12-29T00:00:00.000Z,666505,15,Brandon Clarke,0,0,0,0,0,0
1,0,2,1,0,3,1,3,2,22,0,1,4,2,0,1,1038030,2023-12-29T00:00:00.000Z,38017729,15,David Roddy,0,6,7,5,3,6.9
0,0,0,0,0,0,0,0,0,0,0,0,0,0,0,0,1038030,2023-12-29T00:00:00.000Z,401,15,Derrick Rose,0,0,0,0,0,0
5,0,7,5,2,11,7,2,2,37,0,3,18,7,2,2,1038030,2023-12-29T00:00:00.000Z,3547287,15,Desmond Bane,2,25,30,23,12,37.9
0,0,0,0,0,0,0,0,0,0,0,0,0,0,0,0,1038030,2023-12-29T00:00:00.000Z,56677830,15,GG Jackson,0,0,0,0,0,0
10,0,6,7,0,19,7,6,5,37,0,4,19,6,0,3,1038030,2023-12-29T00:00:00.000Z,666786,15,Ja Morant,0,25,35,29,16,38.2
0,0,0,0,0,0,0,0,0,0,0,0,0,0,0,0,1038030,2023-12-29T00:00:00.000Z,48248287,15,Jacob Gilyard,0,0,0,0,0,0
0,0,0,0,0,0,0,0,0,0,0,0,0,0,0,0,1038030,2023-12-29T00:00:00.000Z,38017728,15,Jake LaRavia,0,0,0,0,0,0
4,2,2,6,4,17,8,2,2,37,0,5,22,2,2,1,1038030,2023-12-29T00:00:00.000Z,231,15,Jaren Jackson Jr.,4,24,28,26,6,41.4
0,0,0,0,0,0,0,0,0,0,0,0,0,0,0,0,1038030,2023-12-29T00:00:00.000Z,666703,15,John Konchar,0,0,0,0,0,0
0,0,0,0,0,0,0,0,0,0,0,0,0,0,0,0,1038030,2023-12-29T00:00:00.000Z,254,15,Luke Kennard,0,0,0,0,0,0
2,0,2,11,4,14,7,4,4,32,0,0,22,2,3,2,1038030,2023-12-29T00:00:00.000Z,420,15,Marcus Smart,3,24,26,24,4,34.4
1,0,4,3,2,7,5,0,0,22,1,1,12,5,1,0,1038030,2023-12-29T00:00:00.000Z,17896067,15,Santi Aldama,1,17,18,13,6,22.5
0,0,0,0,0,0,0,0,0,0,0,0,0,0,0,0,1038030,2023-12-29T00:00:00.000Z,3,15,Steven Adams,0,0,0,0,0,0
5,1,1,4,1,6,1,3,2,22,0,3,5,1,0,1,1038030,2023-12-29T00:00:00.000Z,38017731,15,Vince Williams Jr.,1,6,11,10,6,15.7
0,1,2,1,0,5,1,0,0,17,2,3,2,4,1,1,1038030,2023-12-29T00:00:00.000Z,3547285,15,Xavier Tillman,2,6,6,2,4,11.8
1,0,2,2,0,3,0,0,0,6,0,1,0,2,0,0,1038030,2023-12-29T00:00:00.000Z,17896027,15,Ziaire Williams,0,2,3,1,3,3.9
3,3,13,0,0,13,7,20,14,36,3,1,28,16,3,4,1038031,2023-12-30T00:00:00.000Z,4,16,Bam Adebayo,6,44,47,31,19,65.7
0,0,0,0,0,0,0,0,0,0,0,0,0,0,0,0,1038031,2023-12-30T00:00:00.000Z,38017736,16,Cole Swider,0,0,0,0,0,0
1,1,6,4,0,5,1,2,2,26,0,2,4,6,2,2,1038031,2023-12-30T00:00:00.000Z,3092,16,Haywood Highsmith,3,10,11,5,7,19.7
1,0,1,4,0,9,2,5,5,35,0,4,9,1,0,2,1038031,2023-12-30T00:00:00.000Z,56677785,16,Jaime Jaquez Jr.,0,10,11,10,2,9.7
1,0,1,0,0,4,3,0,0,11,0,2,6,1,0,1,1038031,2023-12-30T00:00:00.000Z,38017734,16,Jamal Cain,0,7,8,7,2,7.7
1,1,2,0,0,3,2,4,4,23,0,2,8,2,0,2,1038031,2023-12-30T00:00:00.000Z,79,16,Jimmy Butler,1,10,11,9,3,12.9
2,0,4,8,2,11,4,4,2,20,2,1,12,6,0,1,1038031,2023-12-30T00:00:00.000Z,285,16,Kevin Love,0,18,20,14,8,21.2
1,0,1,2,2,2,2,0,0,10,1,5,6,2,0,1,1038031,2023-12-30T00:00:00.000Z,38017696,16,Nikola Jovic,0,8,9,7,3,8.9
0,0,2,1,0,1,0,0,0,8,0,1,0,2,0,1,1038031,2023-12-30T00:00:00.000Z,3547257,16,R.J. Hampton,0,2,2,0,2,1.4
0,0,0,0,0,0,0,0,0,0,0,0,0,0,0,0,1038031,2023-12-30T00:00:00.000Z,74,16,Thomas Bryant,0,0,0,0,0,0
6,1,4,7,2,22,9,5,5,39,2,2,25,6,1,1,1038031,2023-12-30T00:00:00.000Z,666633,16,Tyler Herro,2,31,37,31,12,46.2
0,0,0,0,0,0,0,0,0,0,0,0,0,0,0,0,1038031,2023-12-30T00:00:00.000Z,56677842,29,Brice Sensabaugh,0,0,0,0,0,0
5,0,1,4,1,14,8,6,5,26,1,1,22,2,1,3,1038031,2023-12-30T00:00:00.000Z,413,29,Collin Sexton,1,24,29,27,7,31.9
0,0,6,6,2,11,4,0,0,21,0,3,10,6,0,1,1038031,2023-12-30T00:00:00.000Z,101,29,John Collins,0,16,16,10,6,16.2
0,0,0,0,0,0,0,0,0,0,0,0,0,0,0,0,1038031,2023-12-30T00:00:00.000Z,38017630,29,Johnny Juzang,0,0,0,0,0,0
3,0,2,5,1,10,3,2,2,25,0,0,9,2,0,0,1038031,2023-12-30T00:00:00.000Z,100,29,Jordan Clarkson,0,11,14,12,5,15.9
0,0,0,0,0,0,0,0,0,0,0,0,0,0,0,0,1038031,2023-12-30T00:00:00.000Z,17896023,29,Josh Christopher,0,0,0,0,0,0
10,1,3,1,0,12,8,3,3,27,3,5,19,6,1,3,1038031,2023-12-30T00:00:00.000Z,358,29,Kelly Olynyk,2,25,35,29,16,44.2
2,0,6,8,5,10,6,5,4,28,0,3,21,6,0,2,1038031,2023-12-30T00:00:00.000Z,56677834,29,Keyonte George,0,27,29,23,8,29.2
6,1,1,1,0,5,1,0,0,18,0,3,2,1,2,1,1038031,2023-12-30T00:00:00.000Z,139,29,Kris Dunn,3,3,9,8,7,20.2
1,0,3,8,1,13,4,4,3,26,2,4,12,5,2,0,1038031,2023-12-30T00:00:00.000Z,297,29,Lauri Markkanen,2,17,18,13,6,25.5
0,0,0,0,0,0,0,0,0,0,0,0,0,0,0,0,1038031,2023-12-30T00:00:00.000Z,666881,29,Luka Samanic,0,0,0,0,0,0
0,0,0,0,0,0,0,0,0,0,0,0,0,0,0,0,1038031,2023-12-30T00:00:00.000Z,19465584,29,Micah Potter,0,0,0,0,0,0
0,1,0,3,0,4,0,2,0,15,0,1,0,0,0,0,1038031,2023-12-30T00:00:00.000Z,38017620,29,Ochai Agbaji,1,0,0,0,0,3
0,0,0,0,0,0,0,0,0,0,0,0,0,0,0,0,1038031,2023-12-30T00:00:00.000Z,11891374,29,Omer Yurtseven,0,0,0,0,0,0
2,1,4,5,1,9,4,6,3,31,3,4,12,7,2,0,1038031,2023-12-30T00:00:00.000Z,38017739,29,Simone Fontecchio,3,19,21,14,9,32.4
0,0,0,0,0,0,0,0,0,0,0,0,0,0,0,0,1038031,2023-12-30T00:00:00.000Z,666650,29,Talen Horton-Tucker,0,0,0,0,0,0
0,0,0,0,0,0,0,0,0,0,0,0,0,0,0,0,1038031,2023-12-30T00:00:00.000Z,56677824,29,Taylor Hendricks,0,0,0,0,0,0
0,2,8,0,0,5,5,0,0,23,0,1,10,8,0,0,1038031,2023-12-30T00:00:00.000Z,38017705,29,Walker Kessler,2,18,18,10,8,25.6
0,0,1,2,0,4,2,2,2,12,0,1,6,1,0,0,1038032,2023-12-30T00:00:00.000Z,56677826,9,Ausar Thompson,0,7,7,6,1,7.2
3,0,7,6,2,14,7,5,3,37,0,2,19,7,0,4,1038032,2023-12-30T00:00:00.000Z,54,9,Bojan Bogdanovic,0,26,29,22,10,27.9
12,0,3,4,2,20,9,10,10,38,0,4,30,3,1,0,1038032,2023-12-30T00:00:00.000Z,17896075,9,Cade Cunningham,1,33,45,42,15,54.6
1,0,1,2,1,2,1,0,0,17,0,3,3,1,0,1,1038032,2023-12-30T00:00:00.000Z,17896071,9,Isaiah Livers,0,4,5,4,2,4.7
0,0,0,0,0,0,0,0,0,0,0,0,0,0,0,0,1038032,2023-12-30T00:00:00.000Z,3547267,9,Isaiah Stewart,0,0,0,0,0,0
4,0,1,3,1,5,1,12,9,29,4,2,12,5,1,1,1038032,2023-12-30T00:00:00.000Z,38017682,9,Jaden Ivey,1,17,21,16,9,26
2,0,15,0,0,11,6,6,6,34,2,5,18,17,0,1,1038032,2023-12-30T00:00:00.000Z,38017694,9,Jalen Duren,0,35,37,20,19,40.4
0,3,4,0,0,4,4,0,0,13,0,1,8,4,0,0,1038032,2023-12-30T00:00:00.000Z,3547240,9,James Wiseman,3,12,12,8,4,21.8
0,0,0,0,0,0,0,0,0,0,0,0,0,0,0,0,1038032,2023-12-30T00:00:00.000Z,42097199,9,Jared Rhoden,0,0,0,0,0,0
2,1,2,8,3,14,7,0,0,31,0,2,17,2,1,1,1038032,2023-12-30T00:00:00.000Z,259,9,Kevin Knox,2,19,21,19,4,27.4
4,0,1,0,0,2,0,0,0,10,0,2,0,1,1,3,1038032,2023-12-30T00:00:00.000Z,3547241,9,Killian Hayes,1,1,5,4,5,7.2
0,0,0,0,0,0,0,0,0,0,0,0,0,0,0,0,1038032,2023-12-30T00:00:00.000Z,56677729,9,Malcolm Cazalon,0,0,0,0,0,0
0,0,0,0,0,0,0,0,0,0,0,0,0,0,0,0,1038032,2023-12-30T00:00:00.000Z,56677792,9,Marcus Sasser,0,0,0,0,0,0
0,0,0,0,0,0,0,0,0,0,0,0,0,0,0,0,1038032,2023-12-30T00:00:00.000Z,330,9,Monte Morris,0,0,0,0,0,0
0,0,0,0,0,0,0,0,0,0,0,0,0,0,0,0,1038032,2023-12-30T00:00:00.000Z,44477024,9,Stanley Umude,0,0,0,0,0,0
4,1,1,9,6,16,8,2,2,39,0,3,24,1,4,0,1038032,2023-12-30T00:00:00.000Z,3089,28,Gary Trent Jr.,5,25,29,28,5,46.2
5,3,12,0,0,4,2,0,0,35,2,4,4,14,1,0,1038032,2023-12-30T00:00:00.000Z,373,28,Jakob Poeltl,4,18,23,9,19,40.3
4,0,4,2,2,24,14,8,5,40,1,5,35,5,0,2,1038032,2023-12-30T00:00:00.000Z,416,28,Pascal Siakam,0,40,44,39,9,45
2,1,7,5,1,20,8,5,5,36,2,4,22,9,2,1,1038032,2023-12-30T00:00:00.000Z,17896055,28,Scottie Barnes,3,31,33,24,11,43.8
2,0,1,11,7,13,8,2,2,31,0,2,25,1,1,2,1038033,2023-12-30T00:00:00.000Z,3547250,12,Aaron Nesmith,1,26,28,27,3,30.2
5,0,2,4,2,10,5,2,2,33,3,4,14,5,2,4,1038033,2023-12-30T00:00:00.000Z,38017507,12,Andrew Nembhard,2,19,24,19,10,29.5
0,0,0,5,3,10,7,3,3,26,0,0,20,0,0,2,1038033,2023-12-30T00:00:00.000Z,38017686,12,Bennedict Mathurin,0,20,20,20,0,18
1,0,2,2,1,3,2,1,1,18,0,1,6,2,1,1,1038033,2023-12-30T00:00:00.000Z,210,12,Buddy Hield,1,8,9,7,3,11.9
0,1,1,0,0,1,1,0,0,9,0,2,2,1,0,1,1038033,2023-12-30T00:00:00.000Z,17896035,12,Isaiah Jackson,1,3,3,2,1,5.2
2,2,4,2,1,5,3,4,2,21,0,5,9,4,0,1,1038033,2023-12-30T00:00:00.000Z,3547264,12,Jalen Smith,2,13,15,11,6,21.8
2,0,7,8,6,17,10,3,2,31,1,0,28,8,0,1,1038033,2023-12-30T00:00:00.000Z,452,12,Myles Turner,0,36,38,30,10,39.6
2,3,6,1,1,6,4,1,0,20,2,4,9,8,0,0,1038033,2023-12-30T00:00:00.000Z,3547243,12,Obi Toppin,3,17,19,11,10,30.6
3,0,0,0,0,3,2,1,1,12,0,0,5,0,0,2,1038033,2023-12-30T00:00:00.000Z,304,12,T.J. McConnell,0,5,8,8,3,7.5
23,1,4,9,2,16,8,4,4,36,1,0,22,5,2,2,1038033,2023-12-30T00:00:00.000Z,3547245,12,Tyrese Haliburton,3,27,50,45,28,69.5
0,0,0,0,0,0,0,0,0,0,0,0,0,0,0,0,1038033,2023-12-30T00:00:00.000Z,666675,20,DaQuan Jeffries,0,0,0,0,0,0
2,1,4,11,7,21,15,1,1,36,2,2,38,6,4,1,1038033,2023-12-30T00:00:00.000Z,131,20,Donte DiVincenzo,5,44,46,40,8,62.2
6,0,7,0,0,3,1,0,0,33,2,3,2,9,4,1,1038033,2023-12-30T00:00:00.000Z,201,20,Isaiah Hartenstein,4,11,17,8,15,32.8
1,0,0,0,0,0,0,0,0,1,0,0,0,0,0,0,1038033,2023-12-30T00:00:00.000Z,56677795,20,Jacob Toppin,0,0,1,1,1,1.5
0,0,0,0,0,0,0,0,0,0,0,0,0,0,0,0,1038033,2023-12-30T00:00:00.000Z,17896063,20,Jericho Sims,0,0,0,0,0,0
0,0,0,0,0,0,0,0,0,0,0,0,0,0,0,0,1038033,2023-12-30T00:00:00.000Z,3547275,20,Malachi Flynn,0,0,0,0,0,0
1,0,0,2,1,3,2,0,0,18,0,3,5,0,0,0,1038033,2023-12-30T00:00:00.000Z,17896033,20,Miles McBride,0,5,6,6,1,6.5
0,0,0,0,0,0,0,0,0,0,0,0,0,0,0,0,1038033,2023-12-30T00:00:00.000Z,399,20,Mitchell Robinson,0,0,0,0,0,0
0,0,0,0,0,0,0,0,0,0,0,0,0,0,0,0,1038033,2023-12-30T00:00:00.000Z,18,20,OG Anunoby,0,0,0,0,0,0
0,0,0,0,0,0,0,0,0,0,0,0,0,0,0,0,1038033,2023-12-30T00:00:00.000Z,3547249,20,Precious Achiuwa,0,0,0,0,0,0
0,0,0,0,0,0,0,0,0,0,0,0,0,0,0,0,1038033,2023-12-30T00:00:00.000Z,17895858,20,Quentin Grimes,0,0,0,0,0,0
0,0,0,0,0,0,0,0,0,1,0,0,0,0,0,0,1038033,2023-12-30T00:00:00.000Z,19,20,Ryan Arcidiacono,0,0,0,0,0,0
0,0,0,0,0,0,0,0,0,0,0,0,0,0,0,0,1038034,2023-12-30T00:00:00.000Z,56677860,5,Adama Sanogo,0,0,0,0,0,0
5,1,2,5,3,7,4,5,3,28,0,2,14,2,1,3,1038034,2023-12-30T00:00:00.000Z,89,5,Alex Caruso,2,16,21,19,7,26.9
2,3,20,0,0,8,6,10,3,30,3,4,15,23,2,3,1038034,2023-12-30T00:00:00.000Z,137,5,Andre Drummond,5,38,40,17,25,57.6
2,1,1,4,0,11,3,0,0,29,2,2,6,3,0,0,1038034,2023-12-30T00:00:00.000Z,17895983,5,Ayo Dosunmu,1,9,11,8,5,15.6
2,0,6,5,1,15,7,6,5,40,2,3,20,8,0,5,1038034,2023-12-30T00:00:00.000Z,666956,5,Coby White,0,28,30,22,10,27.6
4,0,6,2,0,17,9,7,6,37,0,0,24,6,0,2,1038034,2023-12-30T00:00:00.000Z,125,5,DeMar DeRozan,0,30,34,28,10,35.2
1,0,2,4,1,5,1,2,1,13,0,3,4,2,1,0,1038034,2023-12-30T00:00:00.000Z,87,5,Jevon Carter,1,6,7,5,3,10.9
0,0,0,0,0,0,0,0,0,1,0,0,0,0,0,0,1038034,2023-12-30T00:00:00.000Z,56677857,5,Julian Phillips,0,0,0,0,0,0
3,0,1,3,1,11,6,0,0,33,2,0,13,3,0,2,1038034,2023-12-30T00:00:00.000Z,3547248,5,Patrick Williams,0,16,19,16,6,19.1
0,0,0,0,0,0,0,0,0,0,0,0,0,0,0,0,1038034,2023-12-30T00:00:00.000Z,110,5,Torrey Craig,0,0,0,0,0,0
0,0,0,0,0,0,0,0,0,0,0,0,0,0,0,0,1038034,2023-12-30T00:00:00.000Z,2175,23,Danuel House Jr.,0,0,0,0,0,0
0,0,0,0,0,1,1,0,0,2,0,0,2,0,0,0,1038034,2023-12-30T00:00:00.000Z,260,23,Furkan Korkmaz,0,2,2,2,0,2
0,0,0,0,0,0,0,0,0,0,0,0,0,0,0,0,1038034,2023-12-30T00:00:00.000Z,17896025,23,Jaden Springer,0,0,0,0,0,0
0,0,0,0,0,0,0,0,0,0,0,0,0,0,0,0,1038034,2023-12-30T00:00:00.000Z,145,23,Joel Embiid,0,0,0,0,0,0
0,0,0,0,0,0,0,0,0,0,0,0,0,0,0,0,1038034,2023-12-30T00:00:00.000Z,38017732,23,Kenneth Lofton Jr.,0,0,0,0,0,0
0,0,1,1,0,2,1,0,0,8,0,0,2,1,0,0,1038034,2023-12-30T00:00:00.000Z,3547294,23,Kenyon Martin Jr.,0,3,3,2,1,3.2
1,0,2,2,0,5,2,0,0,17,0,3,4,2,0,1,1038034,2023-12-30T00:00:00.000Z,328,23,Marcus Morris,0,6,7,5,3,6.9
2,0,3,0,0,3,2,1,1,13,2,0,5,5,0,1,1038034,2023-12-30T00:00:00.000Z,28,23,Mo Bamba,0,10,12,7,7,13
2,0,3,5,3,6,3,0,0,19,0,1,9,3,0,1,1038034,2023-12-30T00:00:00.000Z,33,23,Nicolas Batum,0,12,14,11,5,14.6
3,2,2,2,0,4,1,2,2,24,0,4,4,2,1,1,1038034,2023-12-30T00:00:00.000Z,45,23,Patrick Beverley,3,6,9,7,5,18.9
0,0,0,0,0,0,0,0,0,0,0,0,0,0,0,0,1038034,2023-12-30T00:00:00.000Z,56913527,23,Ricky Council IV,0,0,0,0,0,0
0,0,1,1,0,1,0,0,0,5,0,0,0,1,0,0,1038034,2023-12-30T00:00:00.000Z,108,23,Robert Covington,0,1,1,0,1,1.2
0,0,0,0,0,0,0,0,0,0,0,0,0,0,0,0,1038034,2023-12-30T00:00:00.000Z,56677788,23,Terquavion Smith,0,0,0,0,0,0
0,0,0,0,0,0,0,0,0,0,0,0,0,0,0,0,1038035,2023-12-30T00:00:00.000Z,56677867,14,Alex Fudge,0,0,0,0,0,0
0,0,1,5,0,11,2,6,5,29,1,2,9,2,0,1,1038035,2023-12-30T00:00:00.000Z,17553995,14,Austin Reaves,0,11,11,9,2,10.4
0,1,5,2,2,4,2,2,1,13,0,1,7,5,0,2,1038035,2023-12-30T00:00:00.000Z,486,14,Christian Wood,1,12,12,7,5,14
0,0,0,0,0,0,0,0,0,0,0,0,0,0,0,0,1038035,2023-12-30T00:00:00.000Z,56677738,14,Colin Castleton,0,0,0,0,0,0
3,0,1,1,0,4,1,4,3,20,0,1,5,1,0,1,1038035,2023-12-30T00:00:00.000Z,405,14,D'Angelo Russell,0,6,9,8,4,9.7
0,0,0,0,0,0,0,0,0,0,0,0,0,0,0,0,1038035,2023-12-30T00:00:00.000Z,56677868,14,D'Moi Hodge,0,0,0,0,0,0
0,0,0,0,0,0,0,0,0,0,0,0,0,0,0,0,1038035,2023-12-30T00:00:00.000Z,1603383,14,Gabe Vincent,0,0,0,0,0,0
0,0,0,0,0,0,0,0,0,0,0,0,0,0,0,0,1038035,2023-12-30T00:00:00.000Z,56677835,14,Jalen Hood-Schifino,0,0,0,0,0,0
0,0,0,0,0,0,0,0,0,0,0,0,0,0,0,0,1038035,2023-12-30T00:00:00.000Z,666626,14,Jaxson Hayes,0,0,0,0,0,0
0,0,0,0,0,0,0,0,0,0,0,0,0,0,0,0,1038035,2023-12-30T00:00:00.000Z,56677836,14,Maxwell Lewis,0,0,0,0,0,0
3,3,3,8,2,23,10,11,9,38,0,3,31,3,0,3,1038035,2023-12-30T00:00:00.000Z,3547238,18,Anthony Edwards,3,34,37,34,6,45.1
2,1,3,1,0,6,2,2,2,26,0,6,6,3,1,1,1038035,2023-12-30T00:00:00.000Z,3547259,18,Jaden McDaniels,2,9,11,8,5,17.6
0,0,0,0,0,0,0,0,0,0,0,0,0,0,0,0,1038035,2023-12-30T00:00:00.000Z,666767,18,Jordan McLaughlin,0,0,0,0,0,0
2,0,7,4,1,7,3,2,2,29,2,5,9,9,0,5,1038035,2023-12-30T00:00:00.000Z,447,18,Karl-Anthony Towns,0,18,20,11,11,17.8
7,1,3,1,0,4,2,0,0,25,0,0,4,3,0,1,1038035,2023-12-30T00:00:00.000Z,12,18,Kyle Anderson,1,7,14,11,10,20.1
7,0,3,9,4,11,4,4,3,33,1,2,15,4,1,1,1038035,2023-12-30T00:00:00.000Z,104,18,Mike Conley,1,19,26,22,11,32.3
2,0,2,4,2,4,2,0,0,16,0,4,6,2,1,2,1038035,2023-12-30T00:00:00.000Z,666400,18,Nickeil Alexander-Walker,1,8,10,8,4,12.4
0,1,9,0,0,7,6,1,1,38,4,3,13,13,2,4,1038035,2023-12-30T00:00:00.000Z,176,18,Rudy Gobert,3,26,26,13,13,33.6
0,0,0,0,0,0,0,0,0,0,0,0,0,0,0,0,1038035,2023-12-30T00:00:00.000Z,320,18,Shake Milton,0,0,0,0,0,0
0,0,3,2,1,3,1,0,0,8,0,0,3,3,1,0,1038035,2023-12-30T00:00:00.000Z,68,18,Troy Brown Jr.,1,6,6,3,3,9.6
0,0,0,0,0,0,0,0,0,0,0,0,0,0,0,0,1038036,2023-12-30T00:00:00.000Z,24489167,7,Brandon Williams,0,0,0,0,0,0
4,1,2,3,1,13,5,3,3,28,3,2,14,5,1,0,1038036,2023-12-30T00:00:00.000Z,475,10,Andrew Wiggins,2,19,23,18,9,32
0,0,0,0,0,0,0,0,0,0,0,0,0,0,0,0,1038036,2023-12-30T00:00:00.000Z,251,10,Cory Joseph,0,0,0,0,0,0
0,0,0,0,0,0,0,0,0,0,0,0,0,0,0,0,1038036,2023-12-30T00:00:00.000Z,185,10,Draymond Green,0,0,0,0,0,0
0,0,0,0,0,0,0,0,0,0,0,0,0,0,0,0,1038036,2023-12-30T00:00:00.000Z,45658838,10,Lester Quinones,0,0,0,0,0,0
0,0,0,0,0,0,0,0,0,0,0,0,0,0,0,0,1038036,2023-12-30T00:00:00.000Z,17553992,10,Moses Moody,0,0,0,0,0,0
0,0,0,0,0,0,0,0,0,0,0,0,0,0,0,0,1038037,2023-12-31T00:00:00.000Z,666656,1,De'Andre Hunter,0,0,0,0,0,0
4,0,13,4,2,12,9,5,4,37,0,2,24,13,0,2,1038037,2023-12-31T00:00:00.000Z,17896040,1,Jalen Johnson,0,37,41,28,17,43.6
0,0,0,0,0,0,0,0,0,0,0,0,0,0,0,0,1038037,2023-12-31T00:00:00.000Z,56677838,1,Kobe Bufkin,0,0,0,0,0,0
0,0,0,0,0,0,0,0,0,0,0,0,0,0,0,0,1038037,2023-12-31T00:00:00.000Z,56677806,1,Mouhamed Gueye,0,0,0,0,0,0
0,0,0,0,0,0,0,0,0,0,0,0,0,0,0,0,1038037,2023-12-31T00:00:00.000Z,3547244,1,Onyeka Okongwu,0,0,0,0,0,0
0,0,2,1,0,1,0,0,0,8,0,0,0,2,0,0,1038037,2023-12-31T00:00:00.000Z,319,1,Patty Mills,0,2,2,0,2,2.4
0,0,0,0,0,0,0,0,0,0,0,0,0,0,0,0,1038037,2023-12-31T00:00:00.000Z,56677855,1,Seth Lundy,0,0,0,0,0,0
0,0,0,0,0,0,0,0,0,0,0,0,0,0,0,0,1038037,2023-12-31T00:00:00.000Z,3547297,1,Trent Forrest,0,0,0,0,0,0
0,0,0,0,0,0,0,0,0,0,0,0,0,0,0,0,1038037,2023-12-31T00:00:00.000Z,4197387,1,Vit Krejci,0,0,0,0,0,0
0,0,0,0,0,0,0,0,0,0,0,0,0,0,0,0,1038037,2023-12-31T00:00:00.000Z,301,1,Wesley Matthews,0,0,0,0,0,0
0,0,0,0,0,0,0,0,0,0,0,0,0,0,0,0,1038037,2023-12-31T00:00:00.000Z,3547302,30,Anthony Gill,0,0,0,0,0,0
3,0,3,1,0,3,0,2,2,17,1,2,2,4,0,0,1038037,2023-12-31T00:00:00.000Z,56677844,30,Bilal Coulibaly,0,6,9,5,7,11.3
4,0,0,5,1,10,5,5,4,18,0,0,15,0,0,0,1038037,2023-12-31T00:00:00.000Z,17896045,30,Corey Kispert,0,15,19,19,4,21
0,0,0,0,0,0,0,0,0,0,0,0,0,0,0,0,1038037,2023-12-31T00:00:00.000Z,167,30,Danilo Gallinari,0,0,0,0,0,0
2,0,0,2,1,2,1,0,0,18,0,2,3,0,0,3,1038037,2023-12-31T00:00:00.000Z,487,30,Delon Wright,0,3,5,5,2,3
2,1,11,6,2,9,5,8,5,31,1,5,17,12,1,3,1038037,2023-12-31T00:00:00.000Z,3547242,30,Deni Avdija,2,29,31,19,14,37.4
0,0,0,0,0,0,0,0,0,0,0,0,0,0,0,0,1038037,2023-12-31T00:00:00.000Z,17896106,30,Eugene Omoruyi,0,0,0,0,0,0
0,0,0,0,0,0,0,0,0,0,0,0,0,0,0,0,1038037,2023-12-31T00:00:00.000Z,18677954,30,Jared Butler,0,0,0,0,0,0
0,0,0,0,0,0,0,0,0,0,0,0,0,0,0,0,1038037,2023-12-31T00:00:00.000Z,38017687,30,Johnny Davis,0,0,0,0,0,0
2,2,2,2,0,6,2,0,0,18,0,1,4,2,1,0,1038037,2023-12-31T00:00:00.000Z,414,30,Landry Shamet,3,6,8,6,4,18.4
3,0,4,5,2,8,4,0,0,20,0,1,10,4,0,0,1038037,2023-12-31T00:00:00.000Z,337,30,Mike Muscala,0,14,17,13,7,19.3
0,0,0,0,0,0,0,0,0,0,0,0,0,0,0,0,1038037,2023-12-31T00:00:00.000Z,38017704,30,Patrick Baldwin Jr.,0,0,0,0,0,0
0,0,0,0,0,0,0,0,0,0,0,0,0,0,0,0,1038037,2023-12-31T00:00:00.000Z,38017712,30,Ryan Rollins,0,0,0,0,0,0
7,1,0,7,3,11,5,1,1,27,0,1,14,0,1,1,1038037,2023-12-31T00:00:00.000Z,249,30,Tyus Jones,2,14,21,21,7,29.5
3,5,8,2,0,15,7,8,6,35,2,4,20,10,0,3,1038038,2023-12-31T00:00:00.000Z,117,14,Anthony Davis,5,30,33,23,13,48.5
9,1,1,5,1,12,7,6,5,36,1,3,20,2,1,0,1038038,2023-12-31T00:00:00.000Z,17553995,14,Austin Reaves,2,22,31,29,11,41.9
0,0,0,0,0,0,0,0,0,0,0,0,0,0,0,0,1038038,2023-12-31T00:00:00.000Z,666860,14,Cameron Reddish,0,0,0,0,0,0
1,1,5,4,1,4,1,0,0,25,0,1,3,5,0,0,1038038,2023-12-31T00:00:00.000Z,486,14,Christian Wood,1,8,9,4,6,13.5
0,0,0,0,0,1,1,0,0,5,0,0,2,0,1,0,1038038,2023-12-31T00:00:00.000Z,56677835,14,Jalen Hood-Schifino,1,2,2,2,0,5
0,0,2,1,0,4,2,0,0,21,0,0,4,2,1,1,1038038,2023-12-31T00:00:00.000Z,457,14,Jarred Vanderbilt,1,6,6,4,2,8.4
0,0,2,0,0,1,0,0,0,10,0,2,0,2,0,0,1038038,2023-12-31T00:00:00.000Z,666626,14,Jaxson Hayes,0,2,2,0,2,2.4
8,1,5,7,3,24,12,8,7,37,0,2,34,5,0,4,1038038,2023-12-31T00:00:00.000Z,237,14,LeBron James,1,39,47,42,13,51
0,0,6,6,1,11,3,0,0,29,1,1,7,7,2,2,1038038,2023-12-31T00:00:00.000Z,38017697,14,Max Christie,2,14,14,7,7,19.4
1,0,1,0,0,1,1,2,2,8,0,0,4,1,1,1,1038038,2023-12-31T00:00:00.000Z,666609,14,Rui Hachimura,1,5,6,5,2,8.7
4,2,1,7,4,9,5,1,1,34,0,2,15,1,2,2,1038038,2023-12-31T00:00:00.000Z,383,14,Taurean Prince,4,16,20,19,5,32.2
8,2,4,7,4,18,10,5,2,38,1,3,26,5,3,3,1038038,2023-12-31T00:00:00.000Z,227,19,Brandon Ingram,5,31,39,34,13,56
0,0,0,0,0,0,0,0,0,0,0,0,0,0,0,0,1038038,2023-12-31T00:00:00.000Z,491,19,Cody Zeller,0,0,0,0,0,0
0,0,0,0,0,0,0,0,0,0,0,0,0,0,0,0,1038038,2023-12-31T00:00:00.000Z,38017663,19,E.J. Liddell,0,0,0,0,0,0
0,0,0,0,0,0,0,0,0,0,0,0,0,0,0,0,1038038,2023-12-31T00:00:00.000Z,17896021,19,Jeremiah Robinson-Earl,0,0,0,0,0,0
1,0,2,1,0,1,0,1,1,8,0,1,1,2,0,0,1038038,2023-12-31T00:00:00.000Z,56677837,19,Jordan Hawkins,0,3,4,2,3,4.9
0,0,0,0,0,0,0,0,0,0,0,0,0,0,0,0,1038038,2023-12-31T00:00:00.000Z,3547260,19,Kira Lewis Jr.,0,0,0,0,0,0
3,0,8,1,1,4,3,4,4,23,2,3,11,10,0,1,1038038,2023-12-31T00:00:00.000Z,340,19,Larry Nance Jr.,0,21,24,14,13,26.5
0,0,0,0,0,0,0,0,0,0,0,0,0,0,0,0,1038038,2023-12-31T00:00:00.000Z,17896017,19,Matt Ryan,0,0,0,0,0,0
3,0,3,3,0,8,3,0,0,21,2,2,6,5,0,0,1038038,2023-12-31T00:00:00.000Z,3547293,19,Naji Marshall,0,11,14,9,8,16.5
0,0,0,0,0,0,0,0,0,0,0,0,0,0,0,0,1038038,2023-12-31T00:00:00.000Z,18677986,19,Trey Murphy III,0,0,0,0,0,0
0,0,0,0,0,0,0,0,0,0,0,0,0,0,0,0,1038039,2023-12-31T00:00:00.000Z,9051997,3,Armoni Brooks,0,0,0,0,0,0
0,0,0,0,0,0,0,0,0,0,0,0,0,0,0,0,1038039,2023-12-31T00:00:00.000Z,417,3,Ben Simmons,0,0,0,0,0,0
0,0,0,0,0,0,0,0,0,0,0,0,0,0,0,0,1038039,2023-12-31T00:00:00.000Z,56677841,3,Dariq Whitehead,0,0,0,0,0,0
0,0,0,0,0,0,0,0,0,0,0,0,0,0,0,0,1038039,2023-12-31T00:00:00.000Z,174,3,Harry Giles III,0,0,0,0,0,0
0,0,0,0,0,0,0,0,0,0,0,0,0,0,0,0,1038039,2023-12-31T00:00:00.000Z,56677722,3,Jalen Wilson,0,0,0,0,0,0
0,0,0,0,0,0,0,0,0,0,0,0,0,0,0,0,1038039,2023-12-31T00:00:00.000Z,17896041,3,Keon Johnson,0,0,0,0,0,0
0,0,0,0,0,0,0,0,0,0,0,0,0,0,0,0,1038039,2023-12-31T00:00:00.000Z,464,3,Lonnie Walker IV,0,0,0,0,0,0
0,0,0,0,0,0,0,0,0,0,0,0,0,0,0,0,1038039,2023-12-31T00:00:00.000Z,56677843,3,Noah Clowney,0,0,0,0,0,0
0,0,4,0,0,0,0,0,0,11,1,0,0,5,0,2,1038039,2023-12-31T00:00:00.000Z,17896078,21,Aaron Wiggins,0,5,5,0,5,4
0,0,0,0,0,0,0,0,0,0,0,0,0,0,0,0,1038039,2023-12-31T00:00:00.000Z,3547271,21,Aleksej Pokusevski,0,0,0,0,0,0
1,1,2,4,2,7,3,2,2,22,1,5,10,3,0,0,1038039,2023-12-31T00:00:00.000Z,56677833,21,Cason Wallace,1,13,14,11,4,18.1
3,2,10,5,3,10,7,2,1,32,0,3,18,10,0,3,1038039,2023-12-31T00:00:00.000Z,38017685,21,Chet Holmgren,2,28,31,21,13,37.5
0,0,0,0,0,0,0,0,0,0,0,0,0,0,0,0,1038039,2023-12-31T00:00:00.000Z,44,21,Davis Bertans,0,0,0,0,0,0
0,0,1,2,2,2,2,2,1,16,0,1,7,1,0,2,1038039,2023-12-31T00:00:00.000Z,3547272,21,Isaiah Joe,0,8,8,7,1,6.2
5,1,3,3,1,14,7,4,2,29,0,1,17,3,0,3,1038039,2023-12-31T00:00:00.000Z,38017703,21,Jalen Williams,1,20,25,22,8,28.1
2,1,2,1,0,3,1,1,1,6,1,1,3,3,0,0,1038039,2023-12-31T00:00:00.000Z,38017706,21,Jaylin Williams,1,6,8,5,5,12.6
2,0,4,2,0,4,1,0,0,18,0,0,2,4,0,0,1038039,2023-12-31T00:00:00.000Z,480,21,Kenrich Williams,0,6,8,4,6,9.8
0,0,0,1,1,1,1,0,0,2,0,0,3,0,0,0,1038039,2023-12-31T00:00:00.000Z,27924547,21,Lindy Waters III,0,3,3,3,0,3
3,1,4,5,4,10,7,0,0,30,0,4,18,4,0,0,1038039,2023-12-31T00:00:00.000Z,666541,21,Luguentz Dort,1,22,25,21,7,30.3
0,0,0,0,0,0,0,0,0,0,0,0,0,0,0,0,1038039,2023-12-31T00:00:00.000Z,17896036,21,Tre Mann,0,0,0,0,0,0
4,0,2,0,0,1,1,0,0,12,1,4,2,3,1,0,1038039,2023-12-31T00:00:00.000Z,4197029,21,Vasilije Micic,1,5,9,6,7,14.6
6,0,1,2,0,3,0,2,1,17,0,2,1,1,0,1,1038040,2023-12-31T00:00:00.000Z,38017693,27,Blake Wesley,0,2,8,7,7,10.2
2,0,0,2,1,4,2,0,0,16,0,2,5,0,1,0,1038040,2023-12-31T00:00:00.000Z,359,27,Cedi Osman,1,5,7,7,2,11
0,0,0,0,0,0,0,0,0,0,0,0,0,0,0,0,1038040,2023-12-31T00:00:00.000Z,17895854,27,Charles Bassey,0,0,0,0,0,0
1,0,4,4,2,15,9,2,2,31,1,3,22,5,2,2,1038040,2023-12-31T00:00:00.000Z,3547246,27,Devin Vassell,2,27,28,23,6,33.5
1,0,1,2,2,4,3,1,1,8,1,0,9,2,0,1,1038040,2023-12-31T00:00:00.000Z,180,27,Devonte' Graham,0,11,12,10,3,11.9
1,0,3,1,1,6,3,2,1,12,1,2,8,4,2,0,1038040,2023-12-31T00:00:00.000Z,38017730,27,Dominick Barlow,2,12,13,9,5,20.3
1,0,0,3,0,3,0,0,0,16,0,1,0,0,0,1,1038040,2023-12-31T00:00:00.000Z,305,27,Doug McDermott,0,0,1,1,1,0.5
5,0,3,4,1,11,4,0,0,24,0,1,9,3,0,1,1038040,2023-12-31T00:00:00.000Z,38017699,27,Jeremy Sochan,0,12,17,14,8,19.1
2,0,2,2,0,2,0,0,0,19,0,2,0,2,0,1,1038040,2023-12-31T00:00:00.000Z,38017649,27,Julian Champagnie,0,2,4,2,4,4.4
0,0,1,5,1,9,4,3,2,23,0,0,11,1,0,1,1038040,2023-12-31T00:00:00.000Z,38017692,27,Malaki Branham,0,12,12,11,1,11.2
4,0,5,5,1,9,3,0,0,20,2,1,7,7,0,0,1038040,2023-12-31T00:00:00.000Z,17896059,27,Sandro Mamukelashvili,0,14,18,11,11,21.4
0,0,2,2,0,2,0,0,0,8,1,0,0,3,1,0,1038040,2023-12-31T00:00:00.000Z,56677817,27,Sidy Cissoko,1,3,3,0,3,6.6
2,0,3,5,0,10,4,0,0,22,1,3,8,4,0,1,1038040,2023-12-31T00:00:00.000Z,3547274,27,Tre Jones,0,12,14,10,6,14.8
3,1,5,8,3,16,8,2,2,24,2,0,21,7,0,3,1038040,2023-12-31T00:00:00.000Z,56677822,27,Victor Wembanyama,1,28,31,24,10,33.9
0,0,0,0,0,0,0,0,0,0,0,0,0,0,0,0,1038040,2023-12-31T00:00:00.000Z,102,27,Zach Collins,0,0,0,0,0,0
0,0,0,0,0,0,0,0,0,0,0,0,0,0,0,0,1038041,2023-12-31T00:00:00.000Z,666505,15,Brandon Clarke,0,0,0,0,0,0
0,0,0,0,0,0,0,0,0,0,0,0,0,0,0,0,1038041,2023-12-31T00:00:00.000Z,56677830,15,GG Jackson,0,0,0,0,0,0
0,0,0,0,0,0,0,0,0,0,0,0,0,0,0,0,1038041,2023-12-31T00:00:00.000Z,48248287,15,Jacob Gilyard,0,0,0,0,0,0
0,0,0,0,0,0,0,0,0,5,0,0,0,0,0,0,1038041,2023-12-31T00:00:00.000Z,666703,15,John Konchar,0,0,0,0,0,0
2,0,3,8,5,9,6,0,0,20,0,2,17,3,0,1,1038041,2023-12-31T00:00:00.000Z,254,15,Luke Kennard,0,20,22,19,5,22.6
0,0,0,0,0,0,0,0,0,0,0,0,0,0,0,0,1038041,2023-12-31T00:00:00.000Z,3,15,Steven Adams,0,0,0,0,0,0
0,0,0,0,0,0,0,0,0,0,0,0,0,0,0,0,1038042,2023-12-31T00:00:00.000Z,666885,22,Admiral Schofield,0,0,0,0,0,0
0,0,0,0,0,0,0,0,0,0,0,0,0,0,0,0,1038042,2023-12-31T00:00:00.000Z,56677839,22,Jett Howard,0,0,0,0,0,0
0,0,0,0,0,0,0,0,0,0,0,0,0,0,0,0,1038042,2023-12-31T00:00:00.000Z,226,22,Joe Ingles,0,0,0,0,0,0
0,0,0,0,0,0,0,0,0,0,0,0,0,0,0,0,1038042,2023-12-31T00:00:00.000Z,38017607,22,Kevon Harris,0,0,0,0,0,0
0,0,0,0,0,0,0,0,0,0,0,0,0,0,0,0,1038042,2023-12-31T00:00:00.000Z,165,22,Markelle Fultz,0,0,0,0,0,0
0,0,0,0,0,0,0,0,0,0,0,0,0,0,0,0,1038042,2023-12-31T00:00:00.000Z,17553983,22,Trevelin Queen,0,0,0,0,0,0
0,0,0,0,0,0,0,0,0,0,0,0,0,0,0,0,1038042,2023-12-31T00:00:00.000Z,666451,24,Bol Bol,0,0,0,0,0,0
2,1,1,2,1,13,10,4,4,35,0,1,25,1,1,1,1038042,2023-12-31T00:00:00.000Z,37,24,Bradley Beal,2,26,28,27,3,34.2
0,0,4,2,0,7,3,0,0,17,2,2,6,6,0,1,1038042,2023-12-31T00:00:00.000Z,314,24,Chimezie Metu,0,12,12,6,6,12.2
5,0,4,8,3,17,7,5,4,37,0,3,21,4,3,1,1038042,2023-12-31T00:00:00.000Z,57,24,Devin Booker,3,25,30,26,9,41.3
0,0,0,0,0,0,0,0,0,0,0,0,0,0,0,0,1038042,2023-12-31T00:00:00.000Z,147,24,Drew Eubanks,0,0,0,0,0,0
0,0,1,2,0,3,0,0,0,30,0,3,0,1,2,0,1038042,2023-12-31T00:00:00.000Z,178,24,Eric Gordon,2,1,1,0,1,7.2
0,0,0,0,0,0,0,0,0,0,0,0,0,0,0,0,1038042,2023-12-31T00:00:00.000Z,18678058,24,Jordan Goodwin,0,0,0,0,0,0
2,0,1,1,0,2,0,0,0,7,1,3,0,2,0,0,1038042,2023-12-31T00:00:00.000Z,356,24,Josh Okogie,0,2,4,2,4,5.4
3,0,10,3,0,17,8,5,3,33,3,3,19,13,0,1,1038042,2023-12-31T00:00:00.000Z,349,24,Jusuf Nurkic,0,32,35,22,16,38.1
0,0,0,0,0,0,0,0,0,0,0,0,0,0,0,0,1038042,2023-12-31T00:00:00.000Z,32,24,Keita Bates-Diop,0,0,0,0,0,0
0,0,0,0,0,0,0,0,0,0,0,0,0,0,0,0,1038042,2023-12-31T00:00:00.000Z,3547298,24,Saben Lee,0,0,0,0,0,0
0,1,1,0,0,0,0,0,0,8,0,1,0,1,0,1,1038042,2023-12-31T00:00:00.000Z,3547095,24,Udoka Azubuike,1,1,1,0,1,3.2
0,0,1,1,0,2,0,0,0,6,0,1,0,1,0,0,1038044,2024-01-01T00:00:00.000Z,56677872,6,Craig Porter,0,1,1,0,1,1.2
0,0,0,0,0,0,0,0,0,0,0,0,0,0,0,0,1038044,2024-01-01T00:00:00.000Z,666581,6,Darius Garland,0,0,0,0,0,0
0,0,0,0,0,0,0,0,0,0,0,0,0,0,0,0,1038044,2024-01-01T00:00:00.000Z,17896076,6,Evan Mobley,0,0,0,0,0,0
2,0,4,1,0,5,4,0,0,16,0,5,8,4,0,1,1038044,2024-01-01T00:00:00.000Z,344,6,Georges Niang,0,12,14,10,6,14.8
0,0,0,0,0,0,0,0,0,0,0,0,0,0,0,0,1038044,2024-01-01T00:00:00.000Z,38017662,6,Isaiah Mobley,0,0,0,0,0,0
0,0,0,0,0,0,0,0,0,0,0,0,0,0,0,0,1038044,2024-01-01T00:00:00.000Z,404,6,Ricky Rubio,0,0,0,0,0,0
1,0,3,8,4,11,6,0,0,17,0,2,16,3,0,1,1038044,2024-01-01T00:00:00.000Z,3547299,6,Sam Merrill,0,19,20,17,4,20.1
1,0,1,0,0,0,0,0,0,14,2,3,0,3,0,0,1038044,2024-01-01T00:00:00.000Z,444,6,Tristan Thompson,0,3,4,1,4,5.1
8,0,3,5,1,7,3,7,5,30,0,2,12,3,0,1,1038044,2024-01-01T00:00:00.000Z,409,28,Dennis Schroder,0,15,23,20,11,26.6
2,1,2,6,3,11,6,6,6,23,0,2,21,2,1,2,1038045,2024-01-01T00:00:00.000Z,77,9,Alec Burks,2,23,25,23,4,30.4
2,2,3,0,0,4,2,2,1,24,1,2,5,4,0,2,1038045,2024-01-01T00:00:00.000Z,56677826,9,Ausar Thompson,2,9,11,7,6,16.8
0,0,0,0,0,2,1,0,0,13,0,0,2,0,0,0,1038045,2024-01-01T00:00:00.000Z,17896071,9,Isaiah Livers,0,2,2,2,0,2
0,0,0,0,0,0,0,0,0,0,0,0,0,0,0,0,1038045,2024-01-01T00:00:00.000Z,3547267,9,Isaiah Stewart,0,0,0,0,0,0
0,1,3,0,0,1,1,2,2,17,1,5,4,4,0,1,1038045,2024-01-01T00:00:00.000Z,3547240,9,James Wiseman,1,8,8,4,4,10.8
0,0,0,0,0,0,0,0,0,0,0,0,0,0,0,0,1038045,2024-01-01T00:00:00.000Z,42097199,9,Jared Rhoden,0,0,0,0,0,0
0,0,0,0,0,0,0,0,0,0,0,0,0,0,0,0,1038045,2024-01-01T00:00:00.000Z,197,9,Joe Harris,0,0,0,0,0,0
3,0,1,2,1,8,3,4,1,19,0,2,8,1,1,1,1038045,2024-01-01T00:00:00.000Z,3547241,9,Killian Hayes,1,9,12,11,4,15.7
2,0,0,2,2,3,3,2,1,7,0,0,9,0,1,0,1038045,2024-01-01T00:00:00.000Z,56677792,9,Marcus Sasser,1,9,11,11,2,15
2,0,0,0,0,2,1,0,0,9,0,0,2,0,0,0,1038045,2024-01-01T00:00:00.000Z,24,9,Marvin Bagley III,0,2,4,4,2,5
0,0,0,0,0,0,0,0,0,0,0,0,0,0,0,0,1038045,2024-01-01T00:00:00.000Z,44477024,9,Stanley Umude,0,0,0,0,0,0
4,0,2,1,0,3,0,0,0,11,1,1,0,3,0,0,1038045,2024-01-01T00:00:00.000Z,213,11,Aaron Holiday,0,3,7,4,7,9.6
9,0,3,2,0,13,9,9,8,27,1,3,26,4,3,2,1038045,2024-01-01T00:00:00.000Z,17896062,11,Alperen Sengun,3,30,39,35,13,51.3
6,0,3,1,1,6,5,1,1,28,1,3,12,4,2,2,1038045,2024-01-01T00:00:00.000Z,56677825,11,Amen Thompson,2,16,22,18,10,29.8
1,0,1,1,0,2,0,0,0,6,0,1,0,1,0,0,1038045,2024-01-01T00:00:00.000Z,296,11,Boban Marjanovic,0,1,2,1,2,2.7
0,0,3,1,1,5,4,0,0,8,1,0,9,4,0,0,1038045,2024-01-01T00:00:00.000Z,56677831,11,Cam Whitmore,0,13,13,9,4,13.8
0,0,0,0,0,0,0,0,0,0,0,0,0,0,0,0,1038045,2024-01-01T00:00:00.000Z,66,11,Dillon Brooks,0,0,0,0,0,0
7,0,1,6,3,11,6,0,0,26,0,1,15,1,1,1,1038045,2024-01-01T00:00:00.000Z,458,11,Fred VanVleet,1,16,23,22,8,28.7
1,1,6,5,3,7,3,0,0,27,0,1,9,6,0,1,1038045,2024-01-01T00:00:00.000Z,38017684,11,Jabari Smith Jr.,1,15,16,10,7,19.7
0,0,3,2,0,10,6,6,4,26,0,6,16,3,1,1,1038045,2024-01-01T00:00:00.000Z,3547301,11,Jae'Sean Tate,1,19,19,16,3,21.6
1,0,5,9,5,12,6,6,5,27,0,0,22,5,1,0,1038045,2024-01-01T00:00:00.000Z,17895966,11,Jalen Green,1,27,28,23,6,32.5
0,0,0,0,0,0,0,0,0,0,0,0,0,0,0,0,1038045,2024-01-01T00:00:00.000Z,47738533,11,Jeenathan Williams,0,0,0,0,0,0
2,0,2,1,0,2,1,2,1,9,0,0,3,2,0,1,1038045,2024-01-01T00:00:00.000Z,188,11,Jeff Green,0,5,7,5,4,7.4
0,0,0,0,0,0,0,0,0,0,0,0,0,0,0,0,1038045,2024-01-01T00:00:00.000Z,56677809,11,Jermaine Samuels Jr.,0,0,0,0,0,0
0,0,0,0,0,0,0,0,0,7,0,0,0,0,0,0,1038045,2024-01-01T00:00:00.000Z,19465326,11,Jock Landale,0,0,0,0,0,0
0,0,0,0,0,0,0,0,0,0,0,0,0,0,0,0,1038045,2024-01-01T00:00:00.000Z,3547281,11,Nate Hinton,0,0,0,0,0,0
2,0,2,2,1,5,3,0,0,14,0,0,7,2,0,1,1038045,2024-01-01T00:00:00.000Z,75,11,Reggie Bullock,0,9,11,9,4,11.4
1,0,2,4,1,15,8,0,0,24,2,3,17,4,3,0,1038045,2024-01-01T00:00:00.000Z,38017695,11,Tari Eason,3,21,22,18,5,32.3
0,0,0,0,0,0,0,0,0,0,0,0,0,0,0,0,1038045,2024-01-01T00:00:00.000Z,357,11,Victor Oladipo,0,0,0,0,0,0
0,0,0,0,0,0,0,0,0,0,0,0,0,0,0,0,1038046,2024-01-01T00:00:00.000Z,69,12,Bruce Brown,0,0,0,0,0,0
0,0,0,0,0,0,0,0,0,0,0,0,0,0,0,0,1038046,2024-01-01T00:00:00.000Z,56677794,12,Isaiah Wong,0,0,0,0,0,0
0,0,0,0,0,0,0,0,0,0,0,0,0,0,0,0,1038046,2024-01-01T00:00:00.000Z,56677832,12,Jarace Walker,0,0,0,0,0,0
0,0,0,0,0,0,0,0,0,0,0,0,0,0,0,0,1038046,2024-01-01T00:00:00.000Z,38017701,12,Kendall Brown,0,0,0,0,0,0
0,0,0,0,0,0,0,0,0,0,0,0,0,0,0,0,1038046,2024-01-01T00:00:00.000Z,56677778,12,Oscar Tshiebwe,0,0,0,0,0,0
1,4,4,6,2,17,8,4,3,38,1,3,21,5,0,0,1038046,2024-01-01T00:00:00.000Z,283,17,Brook Lopez,4,26,27,22,6,40.5
5,0,6,9,1,16,3,6,6,38,1,3,13,7,0,1,1038046,2024-01-01T00:00:00.000Z,278,17,Damian Lillard,0,20,25,18,12,27.9
11,2,15,3,0,20,11,11,8,37,3,3,30,18,1,4,1038046,2024-01-01T00:00:00.000Z,15,17,Giannis Antetokounmpo,3,48,59,41,29,73.1
6,0,2,5,2,13,9,2,1,32,1,5,21,3,1,4,1038046,2024-01-01T00:00:00.000Z,315,17,Khris Middleton,1,24,30,27,9,32.6
0,0,4,8,4,8,4,0,0,37,0,5,12,4,0,0,1038046,2024-01-01T00:00:00.000Z,38,17,Malik Beasley,0,16,16,12,4,16.8
2,1,2,3,1,3,1,0,0,23,0,1,3,2,1,0,1038046,2024-01-01T00:00:00.000Z,105,17,Pat Connaughton,2,5,7,5,4,14.4
0,0,0,0,0,0,0,0,0,0,0,0,0,0,0,0,1038047,2024-01-01T00:00:00.000Z,56677848,4,Amari Bailey,0,0,0,0,0,0
1,0,5,9,3,17,5,2,2,32,0,1,15,5,0,2,1038047,2024-01-01T00:00:00.000Z,56677823,4,Brandon Miller,0,20,21,16,6,20.5
3,0,2,3,2,8,4,0,0,23,0,4,10,2,0,0,1038047,2024-01-01T00:00:00.000Z,38017708,4,Bryce McGowens,0,12,15,13,5,16.9
6,2,2,3,0,6,0,4,2,25,1,0,2,3,2,0,1038047,2024-01-01T00:00:00.000Z,666748,4,Cody Martin,4,5,11,8,9,26.6
0,0,0,0,0,0,0,0,0,0,0,0,0,0,0,0,1038047,2024-01-01T00:00:00.000Z,347,4,Frank Ntilikina,0,0,0,0,0,0
4,0,2,0,0,12,5,0,0,29,1,2,10,3,0,4,1038047,2024-01-01T00:00:00.000Z,422,4,Ish Smith,0,13,17,14,7,15.6
2,0,0,0,0,1,0,0,0,4,0,0,0,0,0,0,1038047,2024-01-01T00:00:00.000Z,17896037,4,James Bouknight,0,0,2,2,2,3
0,1,2,0,0,2,1,0,0,4,0,0,2,2,0,0,1038047,2024-01-01T00:00:00.000Z,18678001,4,JT Thor,1,4,4,2,2,7.4
0,0,0,0,0,0,0,0,0,0,0,0,0,0,0,0,1038047,2024-01-01T00:00:00.000Z,3547239,4,LaMelo Ball,0,0,0,0,0,0
5,0,9,5,3,14,10,5,3,36,0,1,26,9,1,2,1038047,2024-01-01T00:00:00.000Z,62,4,Miles Bridges,1,35,40,31,14,45.3
1,1,6,0,0,12,7,2,1,30,2,2,15,8,1,0,1038047,2024-01-01T00:00:00.000Z,3547282,4,Nick Richards,2,23,24,16,9,32.1
2,1,1,3,1,8,2,0,0,19,2,2,5,3,0,2,1038047,2024-01-01T00:00:00.000Z,56677846,4,Nick Smith Jr.,1,8,10,7,5,12.6
0,0,5,3,1,5,2,1,1,26,1,2,6,6,0,2,1038047,2024-01-01T00:00:00.000Z,666950,4,P.J. Washington,0,12,12,6,6,11.2
0,1,1,1,1,5,4,2,1,25,1,0,10,2,1,0,1038047,2024-01-01T00:00:00.000Z,177,8,Aaron Gordon,2,12,12,10,2,18.4
0,0,1,0,0,1,0,0,0,4,0,0,0,1,1,0,1038047,2024-01-01T00:00:00.000Z,17896007,8,Braxton Key,1,1,1,0,1,4.2
2,2,3,3,1,6,3,3,2,24,1,1,9,4,1,1,1038047,2024-01-01T00:00:00.000Z,38017709,8,Christian Braun,3,13,15,11,6,24.8
0,0,0,0,0,0,0,0,0,0,0,0,0,0,0,0,1038047,2024-01-01T00:00:00.000Z,38017727,8,Collin Gillespie,0,0,0,0,0,0
0,0,0,0,0,0,0,0,0,0,0,0,0,0,0,0,1038047,2024-01-01T00:00:00.000Z,250,8,DeAndre Jordan,0,0,0,0,0,0
0,0,0,0,0,0,0,0,0,0,0,0,0,0,0,0,1038047,2024-01-01T00:00:00.000Z,56677871,8,Hunter Tyson,0,0,0,0,0,0
7,1,3,9,5,16,7,7,6,27,0,1,25,3,2,2,1038047,2024-01-01T00:00:00.000Z,335,8,Jamal Murray,3,28,35,32,10,46.1
0,0,0,0,0,0,0,0,0,0,0,0,0,0,0,0,1038047,2024-01-01T00:00:00.000Z,17896103,8,Jay Huff,0,0,0,0,0,0
0,0,0,0,0,0,0,0,0,0,0,0,0,0,0,0,1038047,2024-01-01T00:00:00.000Z,215,8,Justin Holiday,0,0,0,0,0,0
4,0,3,3,0,6,2,1,1,29,0,3,5,3,1,0,1038047,2024-01-01T00:00:00.000Z,81,8,Kentavious Caldwell-Pope,1,8,12,9,7,17.6
1,0,7,11,4,17,8,2,2,31,1,1,22,8,0,1,1038047,2024-01-01T00:00:00.000Z,375,8,Michael Porter Jr.,0,30,31,23,9,32.1
6,1,11,0,0,7,6,1,1,27,0,2,13,11,1,3,1038047,2024-01-01T00:00:00.000Z,246,8,Nikola Jokic,2,24,30,19,17,38.2
1,1,4,4,2,6,3,0,0,19,0,2,8,4,1,0,1038047,2024-01-01T00:00:00.000Z,38017721,8,Peyton Watson,2,12,13,9,5,20.3
4,0,4,3,2,11,6,2,1,17,0,2,15,4,1,0,1038047,2024-01-01T00:00:00.000Z,236,8,Reggie Jackson,1,19,23,19,8,28.8
0,0,0,0,0,0,0,0,0,0,0,0,0,0,0,0,1038047,2024-01-01T00:00:00.000Z,666489,8,Vlatko Cancar,0,0,0,0,0,0
1,3,2,2,0,5,1,0,0,20,1,2,2,3,0,2,1038047,2024-01-01T00:00:00.000Z,3547268,8,Zeke Nnaji,3,5,6,3,4,14.1
1,1,4,3,1,16,8,4,4,34,0,2,21,4,1,4,1038048,2024-01-01T00:00:00.000Z,37,24,Bradley Beal,2,25,26,22,5,29.3
1,0,3,4,2,8,4,4,4,26,2,3,14,5,1,2,1038048,2024-01-01T00:00:00.000Z,314,24,Chimezie Metu,1,19,20,15,6,22.5
6,0,5,4,1,16,4,2,1,31,3,2,10,8,1,2,1038048,2024-01-01T00:00:00.000Z,57,24,Devin Booker,1,18,24,16,14,29.6
4,1,2,5,2,7,4,2,2,28,0,1,12,2,2,1,1038048,2024-01-01T00:00:00.000Z,8,24,Grayson Allen,3,14,18,16,6,28.4
5,2,6,2,1,8,6,6,5,25,1,3,18,7,1,2,1038048,2024-01-01T00:00:00.000Z,349,24,Jusuf Nurkic,3,25,30,23,12,40.9
0,0,0,0,0,0,0,0,0,0,0,0,0,0,0,0,1038048,2024-01-01T00:00:00.000Z,419,25,Anfernee Simons,0,0,0,0,0,0
0,0,0,0,0,0,0,0,0,0,0,0,0,0,0,0,1038048,2024-01-01T00:00:00.000Z,22,25,Deandre Ayton,0,0,0,0,0,0
0,0,0,0,0,0,0,0,0,0,0,0,0,0,0,0,1038048,2024-01-01T00:00:00.000Z,56783340,25,Duop Reath,0,0,0,0,0,0
1,1,5,0,0,2,2,0,0,23,0,6,4,5,0,2,1038048,2024-01-01T00:00:00.000Z,39613724,25,Ibou Badji,1,9,10,5,6,12.5
0,1,1,4,2,5,2,2,2,12,0,2,8,1,0,1,1038048,2024-01-01T00:00:00.000Z,17896120,25,Ish Wainright,1,9,9,8,1,11.2
0,0,7,2,0,7,3,6,4,25,2,2,10,9,1,1,1038048,2024-01-01T00:00:00.000Z,38017711,25,Jabari Walker,1,19,19,10,9,22.8
0,0,0,0,0,0,0,0,0,0,0,0,0,0,0,0,1038048,2024-01-01T00:00:00.000Z,47957121,25,Justin Minaya,0,0,0,0,0,0
1,1,1,2,0,5,3,0,0,19,1,2,6,2,1,0,1038048,2024-01-01T00:00:00.000Z,56677791,25,Kris Murray,2,8,9,7,3,15.9
5,0,2,4,2,8,3,2,2,21,0,0,10,2,0,2,1038048,2024-01-01T00:00:00.000Z,65,25,Malcolm Brogdon,0,12,17,15,7,17.9
0,0,0,0,0,0,0,0,0,0,0,0,0,0,0,0,1038048,2024-01-01T00:00:00.000Z,56677829,25,Rayan Rupert,0,0,0,0,0,0
0,0,0,0,0,0,0,0,0,0,0,0,0,0,0,0,1038048,2024-01-01T00:00:00.000Z,476,25,Robert Williams III,0,0,0,0,0,0
6,2,3,3,1,18,7,4,2,34,0,1,17,3,1,5,1038048,2024-01-01T00:00:00.000Z,56677747,25,Scoot Henderson,3,20,26,23,9,33.6
1,0,0,5,0,8,2,2,2,18,1,0,6,1,0,1,1038048,2024-01-01T00:00:00.000Z,38017690,25,Shaedon Sharpe,0,7,8,7,2,7.7
3,1,1,3,1,8,3,0,0,18,1,1,7,2,0,1,1038048,2024-01-01T00:00:00.000Z,3547289,25,Skylar Mays,1,9,12,10,5,15.9
0,0,0,0,0,0,0,0,0,0,0,0,0,0,0,0,1038048,2024-01-01T00:00:00.000Z,56677850,25,Toumani Camara,0,0,0,0,0,0
0,0,1,0,0,1,1,0,0,7,0,0,2,1,0,0,1038049,2024-01-01T00:00:00.000Z,217,7,Richaun Holmes,0,3,3,2,1,3.2
1,1,2,8,4,12,6,1,1,25,2,0,17,4,1,1,1038049,2024-01-01T00:00:00.000Z,297,29,Lauri Markkanen,2,21,22,18,5,28.3
2,1,6,8,3,16,10,1,1,29,0,0,24,6,2,1,1038049,2024-01-01T00:00:00.000Z,38017739,29,Simone Fontecchio,3,30,32,26,8,42.2
2,0,0,2,1,3,2,0,0,18,1,2,5,1,0,0,1038050,2024-01-01T00:00:00.000Z,666511,13,Amir Coffey,0,6,8,7,3,9.2
0,0,0,0,0,1,0,0,0,3,0,0,0,0,0,0,1038050,2024-01-01T00:00:00.000Z,17896022,13,Brandon Boston Jr.,0,0,0,0,0,0
0,0,1,1,0,3,2,2,2,16,0,3,6,1,0,2,1038050,2024-01-01T00:00:00.000Z,439,13,Daniel Theis,0,7,7,6,1,5.2
1,0,11,0,0,4,3,0,0,29,1,4,6,12,0,1,1038050,2024-01-01T00:00:00.000Z,493,13,Ivica Zubac,0,18,19,7,13,20.9
10,2,4,5,3,8,5,2,2,31,0,1,15,4,1,2,1038050,2024-01-01T00:00:00.000Z,192,13,James Harden,3,19,29,25,14,41.8
5,1,5,5,2,19,10,3,2,34,1,0,24,6,4,2,1038050,2024-01-01T00:00:00.000Z,274,13,Kawhi Leonard,5,30,35,29,11,51.7
0,0,0,0,0,0,0,0,0,3,0,0,0,0,0,1,1038050,2024-01-01T00:00:00.000Z,56677849,13,Kobe Brown,0,0,0,0,0,-1
0,0,0,0,0,0,0,0,0,0,0,0,0,0,0,0,1038050,2024-01-01T00:00:00.000Z,371,13,Mason Plumlee,0,0,0,0,0,0
0,0,1,0,0,0,0,0,0,3,0,0,0,1,0,0,1038050,2024-01-01T00:00:00.000Z,38017725,13,Moussa Diabate,0,1,1,0,1,1.2
0,0,0,0,0,0,0,0,0,0,0,0,0,0,0,0,1038050,2024-01-01T00:00:00.000Z,17896031,13,Nah'Shon Hyland,0,0,0,0,0,0
2,0,2,5,4,11,9,0,0,33,0,4,22,2,2,1,1038050,2024-01-01T00:00:00.000Z,380,13,Norman Powell,2,24,26,24,4,32.4
2,0,3,8,3,14,7,6,6,34,0,4,23,3,1,3,1038050,2024-01-01T00:00:00.000Z,172,13,Paul George,1,26,28,25,5,29.6
0,0,0,0,0,0,0,0,0,0,0,0,0,0,0,0,1038050,2024-01-01T00:00:00.000Z,450,13,PJ Tucker,0,0,0,0,0,0
3,0,2,1,0,10,4,0,0,18,2,0,8,4,2,2,1038050,2024-01-01T00:00:00.000Z,472,13,Russell Westbrook,2,12,15,11,7,21.3
0,0,2,2,1,7,5,1,1,18,1,2,12,3,0,1,1038050,2024-01-01T00:00:00.000Z,666743,13,Terance Mann,0,15,15,12,3,14.6
0,0,0,1,1,1,1,0,0,3,0,0,3,0,0,0,1038050,2024-01-01T00:00:00.000Z,38017736,16,Cole Swider,0,3,3,3,0,3
2,0,1,7,3,8,3,6,6,26,0,1,15,1,0,1,1038050,2024-01-01T00:00:00.000Z,397,16,Duncan Robinson,0,16,18,17,3,18.2
3,2,2,5,1,11,7,2,2,22,2,2,17,4,0,1,1038050,2024-01-01T00:00:00.000Z,285,16,Kevin Love,2,21,24,20,7,31.3
3,0,0,1,0,5,3,2,2,24,1,3,8,1,0,3,1038050,2024-01-01T00:00:00.000Z,286,16,Kyle Lowry,0,9,12,11,4,10.7
1,0,0,2,1,2,1,0,0,3,0,0,3,0,0,0,1038050,2024-01-01T00:00:00.000Z,38017696,16,Nikola Jovic,0,3,4,4,1,4.5
0,0,0,1,0,1,0,0,0,12,0,2,0,0,0,0,1038050,2024-01-01T00:00:00.000Z,3547257,16,R.J. Hampton,0,0,0,0,0,0
1,0,0,0,0,0,0,0,0,3,0,0,0,0,0,0,1038050,2024-01-01T00:00:00.000Z,74,16,Thomas Bryant,0,0,1,1,1,1.5
0,0,4,0,0,3,3,3,2,9,2,0,8,6,0,1,1038051,2024-01-02T00:00:00.000Z,56677860,5,Adama Sanogo,0,14,14,8,6,14.2
0,0,3,4,1,14,7,0,0,32,0,2,15,3,1,3,1038051,2024-01-02T00:00:00.000Z,17895983,5,Ayo Dosunmu,1,18,18,15,3,18.6
7,1,7,3,0,7,2,2,2,21,1,4,6,8,0,3,1038051,2024-01-02T00:00:00.000Z,38017719,5,Dalen Terry,1,14,21,13,15,26.1
1,0,1,8,3,11,3,0,0,23,0,0,9,1,3,0,1038051,2024-01-02T00:00:00.000Z,87,5,Jevon Carter,3,10,11,10,2,20.7
0,3,0,3,1,5,3,0,0,17,0,2,7,0,1,0,1038051,2024-01-02T00:00:00.000Z,56677857,5,Julian Phillips,4,7,7,7,0,19
0,0,0,0,0,0,0,0,0,0,0,0,0,0,0,0,1038051,2024-01-02T00:00:00.000Z,27,5,Lonzo Ball,0,0,0,0,0,0
0,0,0,0,0,0,0,0,0,0,0,0,0,0,0,0,1038051,2024-01-02T00:00:00.000Z,460,5,Nikola Vucevic,0,0,0,0,0,0
0,0,0,0,0,0,0,0,0,0,0,0,0,0,0,0,1038051,2024-01-02T00:00:00.000Z,56677874,5,Onuralp Bitim,0,0,0,0,0,0
1,1,1,2,0,5,0,0,0,20,4,2,0,5,1,4,1038051,2024-01-02T00:00:00.000Z,17896116,5,Terry Taylor,2,5,6,1,6,9.5
0,0,0,0,0,0,0,0,0,0,0,0,0,0,0,0,1038051,2024-01-02T00:00:00.000Z,110,5,Torrey Craig,0,0,0,0,0,0
0,0,0,0,0,0,0,0,0,0,0,0,0,0,0,0,1038051,2024-01-02T00:00:00.000Z,268,5,Zach LaVine,0,0,0,0,0,0
0,0,0,0,0,0,0,0,0,0,0,0,0,0,0,0,1038051,2024-01-02T00:00:00.000Z,313,23,De'Anthony Melton,0,0,0,0,0,0
0,0,0,0,0,0,0,0,0,0,0,0,0,0,0,0,1038051,2024-01-02T00:00:00.000Z,260,23,Furkan Korkmaz,0,0,0,0,0,0
2,1,0,2,0,4,2,0,0,21,2,4,4,2,1,2,1038051,2024-01-02T00:00:00.000Z,17896025,23,Jaden Springer,2,6,8,6,4,13.4
0,0,2,0,0,2,0,0,0,4,0,0,0,2,0,2,1038051,2024-01-02T00:00:00.000Z,38017732,23,Kenneth Lofton Jr.,0,2,2,0,2,0.4
1,0,0,0,0,3,0,0,0,9,0,0,0,0,0,0,1038051,2024-01-02T00:00:00.000Z,3547294,23,Kenyon Martin Jr.,0,0,1,1,1,1.5
0,0,2,0,0,1,0,0,0,7,0,3,0,2,1,2,1038051,2024-01-02T00:00:00.000Z,28,23,Mo Bamba,1,2,2,0,2,3.4
0,0,4,0,0,3,1,0,0,13,0,2,2,4,2,0,1038051,2024-01-02T00:00:00.000Z,3547270,23,Paul Reed,2,6,6,2,4,12.8
0,0,0,1,0,1,0,0,0,6,0,0,0,0,0,0,1038051,2024-01-02T00:00:00.000Z,56913527,23,Ricky Council IV,0,0,0,0,0,0
0,0,0,0,0,0,0,0,0,0,0,0,0,0,0,0,1038051,2024-01-02T00:00:00.000Z,108,23,Robert Covington,0,0,0,0,0,0
0,0,0,0,0,0,0,0,0,0,0,0,0,0,0,0,1038051,2024-01-02T00:00:00.000Z,56677788,23,Terquavion Smith,0,0,0,0,0,0
1,3,6,0,0,4,2,0,0,28,2,4,4,8,1,2,1038052,2024-01-02T00:00:00.000Z,48,15,Bismack Biyombo,4,12,13,5,9,25.1
2,0,0,1,0,4,2,0,0,8,0,0,4,0,0,0,1038052,2024-01-02T00:00:00.000Z,401,15,Derrick Rose,0,4,6,6,2,7
2,0,3,6,2,17,11,0,0,34,0,1,24,3,0,3,1038052,2024-01-02T00:00:00.000Z,3547287,15,Desmond Bane,0,27,29,26,5,27.6
10,0,5,9,3,15,7,12,9,35,0,3,26,5,1,4,1038052,2024-01-02T00:00:00.000Z,666786,15,Ja Morant,1,31,41,36,15,46
1,4,6,4,1,14,3,4,3,32,1,4,10,7,3,1,1038052,2024-01-02T00:00:00.000Z,231,15,Jaren Jackson Jr.,7,17,18,11,8,39.9
3,0,4,7,3,7,3,3,3,20,1,2,12,5,0,0,1038052,2024-01-02T00:00:00.000Z,254,15,Luke Kennard,0,17,20,15,8,22.5
3,0,1,4,0,7,1,4,3,29,1,3,5,2,0,3,1038052,2024-01-02T00:00:00.000Z,420,15,Marcus Smart,0,7,10,8,5,8.9
0,1,9,2,1,6,5,2,2,28,2,1,13,11,0,0,1038052,2024-01-02T00:00:00.000Z,17896067,15,Santi Aldama,1,24,24,13,11,29.2
2,0,4,5,2,6,3,0,0,22,1,5,8,5,0,2,1038052,2024-01-02T00:00:00.000Z,38017731,15,Vince Williams Jr.,0,13,15,10,7,15
0,0,0,0,0,0,0,0,0,1,0,0,0,0,0,0,1038052,2024-01-02T00:00:00.000Z,17896027,15,Ziaire Williams,0,0,0,0,0,0
1,0,1,2,0,8,5,2,0,21,0,4,10,1,2,1,1038052,2024-01-02T00:00:00.000Z,38017693,27,Blake Wesley,2,11,12,11,2,17.7
2,0,6,2,0,3,0,0,0,13,0,2,0,6,0,2,1038052,2024-01-02T00:00:00.000Z,359,27,Cedi Osman,0,6,8,2,8,8.2
0,0,0,0,0,0,0,0,0,0,0,0,0,0,0,0,1038052,2024-01-02T00:00:00.000Z,17895854,27,Charles Bassey,0,0,0,0,0,0
0,0,0,0,0,0,0,0,0,0,0,0,0,0,0,0,1038052,2024-01-02T00:00:00.000Z,17896049,27,David Duke Jr.,0,0,0,0,0,0
3,1,1,2,1,8,3,5,4,34,1,2,11,2,1,2,1038052,2024-01-02T00:00:00.000Z,3547246,27,Devin Vassell,2,13,16,14,5,21.9
0,0,0,0,0,0,0,0,0,0,0,0,0,0,0,0,1038052,2024-01-02T00:00:00.000Z,180,27,Devonte' Graham,0,0,0,0,0,0
2,0,3,0,0,6,2,0,0,14,4,4,4,7,0,2,1038052,2024-01-02T00:00:00.000Z,38017730,27,Dominick Barlow,0,11,13,6,9,13.4
0,0,0,4,1,4,1,0,0,16,0,0,3,0,0,0,1038052,2024-01-02T00:00:00.000Z,305,27,Doug McDermott,0,3,3,3,0,3
1,2,2,2,1,6,4,4,3,28,0,1,12,2,0,1,1038052,2024-01-02T00:00:00.000Z,38017699,27,Jeremy Sochan,2,14,15,13,3,20.9
4,0,5,4,1,16,7,5,4,31,1,4,19,6,1,3,1038052,2024-01-02T00:00:00.000Z,666682,27,Keldon Johnson,1,25,29,23,10,32.2
1,0,1,0,0,5,1,0,0,8,0,1,2,1,0,0,1038052,2024-01-02T00:00:00.000Z,38017692,27,Malaki Branham,0,3,4,3,2,4.7
0,0,0,0,0,0,0,0,0,0,0,0,0,0,0,0,1038052,2024-01-02T00:00:00.000Z,3547163,27,Mamadi Diakite,0,0,0,0,0,0
0,1,0,1,1,1,1,0,0,2,0,0,3,0,0,1,1038052,2024-01-02T00:00:00.000Z,17896059,27,Sandro Mamukelashvili,1,3,3,3,0,5
0,0,0,0,0,0,0,0,0,0,0,0,0,0,0,0,1038052,2024-01-02T00:00:00.000Z,56677817,27,Sidy Cissoko,0,0,0,0,0,0
4,0,4,3,0,6,1,0,0,25,0,2,2,4,1,0,1038052,2024-01-02T00:00:00.000Z,3547274,27,Tre Jones,1,6,10,6,8,15.8
1,4,7,5,2,16,8,4,2,26,0,0,20,7,0,1,1038052,2024-01-02T00:00:00.000Z,56677822,27,Victor Wembanyama,4,27,28,21,8,40.9
0,0,0,0,0,0,0,0,0,0,0,0,0,0,0,0,1038052,2024-01-02T00:00:00.000Z,102,27,Zach Collins,0,0,0,0,0,0
0,0,0,4,1,5,2,0,0,8,1,1,5,1,0,0,1038053,2024-01-02T00:00:00.000Z,9051997,3,Armoni Brooks,0,6,6,5,1,6.2
0,0,1,4,0,11,0,0,0,20,1,0,0,2,1,1,1038053,2024-01-02T00:00:00.000Z,17896048,3,Cam Thomas,1,2,2,0,2,4.4
2,0,4,9,5,12,6,0,0,27,0,2,17,4,1,1,1038053,2024-01-02T00:00:00.000Z,666679,3,Cameron Johnson,1,21,23,19,6,26.8
4,0,1,4,2,7,3,2,1,20,0,1,9,1,1,1,1038053,2024-01-02T00:00:00.000Z,421,3,Dennis Smith Jr.,1,10,14,13,5,18.2
1,0,3,4,1,6,1,0,0,20,1,1,3,4,2,0,1038053,2024-01-02T00:00:00.000Z,158,3,Dorian Finney-Smith,2,7,8,4,5,15.3
1,1,2,2,0,6,3,2,0,8,1,2,6,3,0,0,1038053,2024-01-02T00:00:00.000Z,174,3,Harry Giles III,1,9,10,7,4,14.1
2,0,0,2,0,8,4,0,0,12,4,0,8,4,1,0,1038053,2024-01-02T00:00:00.000Z,56677722,3,Jalen Wilson,1,12,14,10,6,18.8
0,0,0,0,0,0,0,0,0,0,0,0,0,0,0,0,1038053,2024-01-02T00:00:00.000Z,17896041,3,Keon Johnson,0,0,0,0,0,0
2,0,1,5,2,11,4,3,3,29,2,0,13,3,0,4,1038053,2024-01-02T00:00:00.000Z,61,3,Mikal Bridges,0,16,18,15,5,15.6
1,2,3,0,0,7,4,0,0,23,0,1,8,3,0,0,1038053,2024-01-02T00:00:00.000Z,666508,3,Nicolas Claxton,2,11,12,9,4,19.1
0,0,0,0,0,0,0,0,0,0,0,0,0,0,0,0,1038053,2024-01-02T00:00:00.000Z,56677843,3,Noah Clowney,0,0,0,0,0,0
5,0,4,5,0,6,0,0,0,28,4,3,0,8,1,3,1038053,2024-01-02T00:00:00.000Z,351,3,Royce O'Neale,1,8,13,5,13,17.1
5,0,0,4,0,6,0,0,0,21,0,1,0,0,0,1,1038053,2024-01-02T00:00:00.000Z,130,3,Spencer Dinwiddie,0,0,5,5,5,6.5
1,0,0,0,0,4,2,1,0,7,1,1,4,1,0,0,1038053,2024-01-02T00:00:00.000Z,17896058,3,Trendon Watford,0,5,6,5,2,6.7
5,1,4,2,2,9,5,0,0,25,1,2,12,5,0,1,1038053,2024-01-02T00:00:00.000Z,227,19,Brandon Ingram,1,17,22,17,10,27.5
5,0,4,8,4,11,6,0,0,24,2,0,16,6,0,2,1038053,2024-01-02T00:00:00.000Z,303,19,CJ McCollum,0,22,27,21,11,28.7
0,0,1,0,0,3,1,3,2,8,1,2,4,2,0,0,1038053,2024-01-02T00:00:00.000Z,491,19,Cody Zeller,0,6,6,4,2,6.4
0,0,0,0,0,0,0,0,0,0,0,0,0,0,0,0,1038053,2024-01-02T00:00:00.000Z,38017726,19,Dereon Seabron,0,0,0,0,0,0
3,2,1,4,1,5,2,2,2,20,1,0,7,2,2,1,1038053,2024-01-02T00:00:00.000Z,38017677,19,Dyson Daniels,4,9,12,10,5,24.9
1,1,2,4,2,10,5,2,2,24,2,1,14,4,2,3,1038053,2024-01-02T00:00:00.000Z,17896024,19,Herbert Jones,3,18,19,15,5,26.3
0,1,9,1,1,5,5,0,0,20,3,0,11,12,1,1,1038053,2024-01-02T00:00:00.000Z,455,19,Jonas Valanciunas,2,23,23,11,12,30.4
1,2,0,8,2,13,3,4,3,26,0,0,11,0,0,0,1038053,2024-01-02T00:00:00.000Z,56677837,19,Jordan Hawkins,2,11,12,12,1,18.5
2,0,2,6,3,9,4,3,2,22,1,2,13,3,2,1,1038053,2024-01-02T00:00:00.000Z,17896097,19,Jose Alvarado,2,16,18,15,5,24.6
0,0,6,2,1,4,2,2,1,20,2,2,6,8,2,1,1038053,2024-01-02T00:00:00.000Z,340,19,Larry Nance Jr.,2,14,14,6,8,20.6
0,0,0,0,0,0,0,0,0,0,0,0,0,0,0,0,1038053,2024-01-02T00:00:00.000Z,17896017,19,Matt Ryan,0,0,0,0,0,0
1,1,1,2,0,6,2,2,2,16,1,0,6,2,1,0,1038053,2024-01-02T00:00:00.000Z,3547293,19,Naji Marshall,2,8,9,7,3,15.9
5,1,2,0,0,9,5,0,0,26,1,3,10,3,0,4,1038053,2024-01-02T00:00:00.000Z,666969,19,Zion Williamson,1,13,18,15,8,20.1
3,5,2,3,1,5,3,0,0,20,0,0,7,2,1,0,1038054,2024-01-02T00:00:00.000Z,219,2,Al Horford,6,9,12,10,5,31.9
0,0,0,0,0,0,0,0,0,0,0,0,0,0,0,0,1038054,2024-01-02T00:00:00.000Z,17896094,2,Dalano Banton,0,0,0,0,0,0
6,1,5,9,5,12,7,0,0,28,0,4,19,5,1,3,1038054,2024-01-02T00:00:00.000Z,473,2,Derrick White,2,24,30,25,11,37
3,0,4,8,0,18,4,8,7,38,2,5,15,6,0,3,1038054,2024-01-02T00:00:00.000Z,70,2,Jaylen Brown,0,21,24,18,9,23.7
8,0,8,5,2,21,10,10,8,38,5,3,30,13,1,4,1038054,2024-01-02T00:00:00.000Z,434,2,Jayson Tatum,1,43,51,38,21,56.6
0,0,0,0,0,0,0,0,0,0,0,0,0,0,0,0,1038054,2024-01-02T00:00:00.000Z,38017707,2,JD Davison,0,0,0,0,0,0
0,0,0,0,0,0,0,0,0,0,0,0,0,0,0,0,1038054,2024-01-02T00:00:00.000Z,56677864,2,Jordan Walsh,0,0,0,0,0,0
7,0,4,5,2,8,2,2,1,31,1,1,7,5,1,3,1038054,2024-01-02T00:00:00.000Z,214,2,Jrue Holiday,1,12,19,14,12,23.5
2,3,4,3,2,18,12,9,8,35,6,1,34,10,0,1,1038054,2024-01-02T00:00:00.000Z,378,2,Kristaps Porzingis,3,44,46,36,12,57
0,1,0,0,0,2,0,0,0,15,2,0,0,2,1,0,1038054,2024-01-02T00:00:00.000Z,261,2,Luke Kornet,2,2,2,0,2,8.4
0,0,0,0,0,0,0,0,0,0,0,0,0,0,0,0,1038054,2024-01-02T00:00:00.000Z,666468,2,Oshae Brissett,0,0,0,0,0,0
4,0,2,4,1,5,2,0,0,25,1,1,5,3,2,0,1038054,2024-01-02T00:00:00.000Z,3547276,2,Payton Pritchard,2,8,12,9,7,20.6
0,0,1,3,2,3,2,0,0,10,0,0,6,1,0,0,1038054,2024-01-02T00:00:00.000Z,17896060,2,Sam Hauser,0,7,7,6,1,7.2
0,0,0,0,0,0,0,0,0,0,0,0,0,0,0,0,1038054,2024-01-02T00:00:00.000Z,338,2,Svi Mykhailiuk,0,0,0,0,0,0
1,0,1,1,0,3,1,2,2,13,0,1,4,1,1,0,1038054,2024-01-02T00:00:00.000Z,17896078,21,Aaron Wiggins,1,5,6,5,2,9.7
0,0,0,0,0,0,0,0,0,0,0,0,0,0,0,0,1038054,2024-01-02T00:00:00.000Z,3547271,21,Aleksej Pokusevski,0,0,0,0,0,0
3,0,0,2,1,3,2,0,0,17,1,3,5,1,1,0,1038054,2024-01-02T00:00:00.000Z,56677833,21,Cason Wallace,1,6,9,8,4,13.7
7,4,3,5,3,9,5,2,1,33,0,1,14,3,0,1,1038054,2024-01-02T00:00:00.000Z,38017685,21,Chet Holmgren,4,17,24,21,10,39.1
0,0,0,0,0,0,0,0,0,0,0,0,0,0,0,0,1038054,2024-01-02T00:00:00.000Z,44,21,Davis Bertans,0,0,0,0,0,0
0,0,3,3,2,5,4,0,0,13,0,1,10,3,0,1,1038054,2024-01-02T00:00:00.000Z,3547272,21,Isaiah Joe,0,13,13,10,3,12.6
1,2,1,2,2,9,6,2,2,31,0,3,16,1,3,5,1038054,2024-01-02T00:00:00.000Z,38017703,21,Jalen Williams,5,17,18,17,2,28.7
1,1,2,3,1,4,2,0,0,8,0,0,5,2,0,0,1038054,2024-01-02T00:00:00.000Z,38017706,21,Jaylin Williams,1,7,8,6,3,11.9
6,0,7,7,4,14,8,3,3,27,1,0,23,8,0,3,1038054,2024-01-02T00:00:00.000Z,17896065,21,Josh Giddey,0,31,37,29,14,38.6
2,0,1,1,0,3,1,0,0,13,3,4,2,4,0,0,1038054,2024-01-02T00:00:00.000Z,480,21,Kenrich Williams,0,6,8,4,6,9.8
0,0,0,0,0,0,0,0,0,0,0,0,0,0,0,0,1038054,2024-01-02T00:00:00.000Z,56677853,21,Keyontae Johnson,0,0,0,0,0,0
0,0,0,0,0,0,0,0,0,0,0,0,0,0,0,0,1038054,2024-01-02T00:00:00.000Z,27924547,21,Lindy Waters III,0,0,0,0,0,0
1,3,3,7,1,14,4,0,0,37,5,2,9,8,1,0,1038054,2024-01-02T00:00:00.000Z,666541,21,Luguentz Dort,4,17,18,10,9,32.1
0,0,0,0,0,0,0,0,0,0,0,0,0,0,0,0,1038054,2024-01-02T00:00:00.000Z,24572055,21,Olivier Sarr,0,0,0,0,0,0
0,0,0,0,0,0,0,0,0,0,0,0,0,0,0,0,1038054,2024-01-02T00:00:00.000Z,38017716,21,Ousmane Dieng,0,0,0,0,0,0
7,0,6,5,3,22,14,8,5,37,0,5,36,6,1,0,1038054,2024-01-02T00:00:00.000Z,175,21,Shai Gilgeous-Alexander,1,42,49,43,13,56.7
0,0,0,0,0,0,0,0,0,0,0,0,0,0,0,0,1038054,2024-01-02T00:00:00.000Z,17896036,21,Tre Mann,0,0,0,0,0,0
5,0,1,4,1,5,1,0,0,11,0,2,3,1,0,0,1038054,2024-01-02T00:00:00.000Z,4197029,21,Vasilije Micic,0,4,9,8,6,11.7
0,0,3,3,1,7,4,3,1,21,0,1,10,3,2,1,1038055,2024-01-02T00:00:00.000Z,475,10,Andrew Wiggins,2,13,13,10,3,18.6
2,0,3,3,1,7,4,4,1,29,1,2,10,4,1,0,1038055,2024-01-02T00:00:00.000Z,56677858,10,Brandin Podziemski,1,14,16,12,6,20.8
1,0,2,1,0,3,1,0,0,14,1,0,2,3,0,2,1038055,2024-01-02T00:00:00.000Z,407,10,Dario Saric,0,5,6,3,4,5.1
0,0,3,3,0,5,1,0,0,11,1,0,2,4,0,1,1038055,2024-01-02T00:00:00.000Z,2189,10,Gary Payton II,0,6,6,2,4,5.8
0,0,0,0,0,0,0,0,0,0,0,0,0,0,0,0,1038055,2024-01-02T00:00:00.000Z,398,10,Jerome Robinson,0,0,0,0,0,0
0,0,0,0,0,0,0,0,0,0,0,0,0,0,0,0,1038055,2024-01-02T00:00:00.000Z,45658838,10,Lester Quinones,0,0,0,0,0,0
0,0,0,0,0,0,0,0,0,0,0,0,0,0,0,0,1038055,2024-01-02T00:00:00.000Z,17896070,10,Usman Garuba,0,0,0,0,0,0
0,0,0,0,0,0,0,0,0,0,0,0,0,0,0,0,1038055,2024-01-02T00:00:00.000Z,165,22,Markelle Fultz,0,0,0,0,0,0
0,0,0,0,0,0,0,0,0,0,0,0,0,0,0,0,1038056,2024-01-02T00:00:00.000Z,56677848,4,Amari Bailey,0,0,0,0,0,0
0,0,0,0,0,0,0,0,0,0,0,0,0,0,0,0,1038056,2024-01-02T00:00:00.000Z,347,4,Frank Ntilikina,0,0,0,0,0,0
0,0,0,0,0,0,0,0,0,0,0,0,0,0,0,0,1038056,2024-01-02T00:00:00.000Z,204,4,Gordon Hayward,0,0,0,0,0,0
0,0,0,0,0,0,0,0,0,0,0,0,0,0,0,0,1038056,2024-01-02T00:00:00.000Z,3547239,4,LaMelo Ball,0,0,0,0,0,0
0,0,0,0,0,0,0,0,0,0,0,0,0,0,0,0,1038056,2024-01-02T00:00:00.000Z,56677866,4,Leaky Black,0,0,0,0,0,0
0,0,0,0,0,0,0,0,0,0,0,0,0,0,0,0,1038056,2024-01-02T00:00:00.000Z,38017698,4,Mark Williams,0,0,0,0,0,0
4,0,3,6,3,13,7,0,0,29,1,1,17,4,1,1,1038056,2024-01-02T00:00:00.000Z,666950,4,P.J. Washington,1,21,25,21,8,29.8
3,0,4,0,0,1,1,2,1,13,0,2,3,4,0,1,1038056,2024-01-02T00:00:00.000Z,273,26,Alex Len,0,7,10,6,7,11.3
4,0,3,4,2,11,5,0,0,29,4,1,12,7,1,1,1038056,2024-01-02T00:00:00.000Z,17896030,26,Chris Duarte,1,19,23,16,11,28.4
0,0,1,1,1,3,1,2,1,14,0,1,4,1,0,1,1038056,2024-01-02T00:00:00.000Z,17553994,26,Davion Mitchell,0,5,5,4,1,4.2
6,1,5,10,3,25,11,8,5,38,0,2,30,5,1,3,1038056,2024-01-02T00:00:00.000Z,161,26,De'Aaron Fox,2,35,41,36,11,48
4,0,10,1,1,21,11,1,0,35,9,5,23,19,1,11,1038056,2024-01-02T00:00:00.000Z,406,26,Domantas Sabonis,1,42,46,27,23,43.8
1,0,1,2,1,2,1,0,0,24,0,2,3,1,2,1,1038056,2024-01-02T00:00:00.000Z,30,26,Harrison Barnes,2,4,5,4,2,10.7
0,0,0,0,0,0,0,0,0,0,0,0,0,0,0,0,1038056,2024-01-02T00:00:00.000Z,306,26,JaVale McGee,0,0,0,0,0,0
0,0,0,0,0,0,0,0,0,1,0,0,0,0,0,0,1038056,2024-01-02T00:00:00.000Z,666925,26,Juan Toscano-Anderson,0,0,0,0,0,0
2,0,2,6,1,12,4,2,1,37,1,5,10,3,3,1,1038056,2024-01-02T00:00:00.000Z,38017688,26,Keegan Murray,3,13,15,12,5,24.6
0,0,0,0,0,0,0,0,0,0,0,0,0,0,0,0,1038056,2024-01-02T00:00:00.000Z,38017714,26,Keon Ellis,0,0,0,0,0,0
0,0,0,0,0,0,0,0,0,0,0,0,0,0,0,0,1038056,2024-01-02T00:00:00.000Z,17896044,26,Kessler Edwards,0,0,0,0,0,0
0,0,2,2,0,4,1,2,2,12,0,3,4,2,0,0,1038056,2024-01-02T00:00:00.000Z,221,26,Kevin Huerter,0,6,6,4,2,6.4
2,1,2,5,2,7,2,0,0,20,1,2,6,3,0,1,1038056,2024-01-02T00:00:00.000Z,324,26,Malik Monk,1,9,11,8,5,14.6
1,0,3,5,3,6,3,0,0,17,0,0,9,3,0,0,1038056,2024-01-02T00:00:00.000Z,290,26,Trey Lyles,0,12,13,10,4,14.1
0,1,1,1,0,3,2,0,0,6,0,0,4,1,0,0,1038057,2024-01-03T00:00:00.000Z,248,6,Damian Jones,1,5,5,4,1,8.2
0,0,0,0,0,0,0,0,0,0,0,0,0,0,0,0,1038057,2024-01-03T00:00:00.000Z,666581,6,Darius Garland,0,0,0,0,0,0
0,0,0,0,0,0,0,0,0,0,0,0,0,0,0,0,1038057,2024-01-03T00:00:00.000Z,56677847,6,Emoni Bates,0,0,0,0,0,0
0,0,0,0,0,0,0,0,0,0,0,0,0,0,0,0,1038057,2024-01-03T00:00:00.000Z,17896076,6,Evan Mobley,0,0,0,0,0,0
0,0,0,0,0,0,0,0,0,0,0,0,0,0,0,0,1038057,2024-01-03T00:00:00.000Z,38017662,6,Isaiah Mobley,0,0,0,0,0,0
0,0,0,0,0,0,0,0,0,0,0,0,0,0,0,0,1038057,2024-01-03T00:00:00.000Z,404,6,Ricky Rubio,0,0,0,0,0,0
4,1,6,0,0,7,3,3,1,19,3,1,7,9,0,3,1038057,2024-01-03T00:00:00.000Z,444,6,Tristan Thompson,1,16,20,11,13,23.8
0,0,0,0,0,0,0,0,0,0,0,0,0,0,0,0,1038057,2024-01-03T00:00:00.000Z,666676,6,Ty Jerome,0,0,0,0,0,0
0,0,1,0,0,1,1,0,0,5,0,0,2,1,0,0,1038057,2024-01-03T00:00:00.000Z,3547302,30,Anthony Gill,0,3,3,2,1,3.2
1,2,4,4,1,12,2,2,0,32,1,4,5,5,3,2,1038057,2024-01-03T00:00:00.000Z,56677844,30,Bilal Coulibaly,5,10,11,6,6,25.5
0,0,1,5,0,9,4,6,4,20,0,0,12,1,0,0,1038057,2024-01-03T00:00:00.000Z,17896045,30,Corey Kispert,0,13,13,12,1,13.2
1,1,2,0,0,8,6,1,0,20,3,2,12,5,0,0,1038057,2024-01-03T00:00:00.000Z,666577,30,Daniel Gafford,1,17,18,13,6,22.5
0,0,0,0,0,0,0,0,0,0,0,0,0,0,0,0,1038057,2024-01-03T00:00:00.000Z,167,30,Danilo Gallinari,0,0,0,0,0,0
4,0,4,3,1,11,3,0,0,21,2,1,7,6,1,3,1038057,2024-01-03T00:00:00.000Z,3547242,30,Deni Avdija,1,13,17,11,10,20.2
0,0,0,1,0,3,1,0,0,7,1,2,2,1,0,0,1038057,2024-01-03T00:00:00.000Z,17896106,30,Eugene Omoruyi,0,3,3,2,1,3.2
1,0,1,1,1,2,2,0,0,9,0,0,5,1,0,0,1038057,2024-01-03T00:00:00.000Z,18677954,30,Jared Butler,0,6,7,6,2,7.7
0,0,0,0,0,3,1,0,0,5,0,0,2,0,0,0,1038057,2024-01-03T00:00:00.000Z,38017687,30,Johnny Davis,0,2,2,2,0,2
2,0,0,4,2,11,3,0,0,23,3,3,8,3,0,1,1038057,2024-01-03T00:00:00.000Z,666848,30,Jordan Poole,0,11,13,10,5,13.6
3,0,2,6,2,12,7,0,0,23,0,1,16,2,1,1,1038057,2024-01-03T00:00:00.000Z,265,30,Kyle Kuzma,1,18,21,19,5,24.9
2,0,3,3,2,6,3,2,1,15,0,0,9,3,1,0,1038057,2024-01-03T00:00:00.000Z,414,30,Landry Shamet,1,12,14,11,5,18.6
2,0,2,5,2,9,5,0,0,21,2,0,12,4,0,0,1038057,2024-01-03T00:00:00.000Z,337,30,Mike Muscala,0,16,18,14,6,19.8
0,0,0,0,0,0,0,0,0,0,0,0,0,0,0,0,1038057,2024-01-03T00:00:00.000Z,38017704,30,Patrick Baldwin Jr.,0,0,0,0,0,0
0,0,0,0,0,0,0,0,0,0,0,0,0,0,0,0,1038057,2024-01-03T00:00:00.000Z,38017712,30,Ryan Rollins,0,0,0,0,0,0
2,1,2,2,1,11,4,0,0,21,0,0,9,2,1,0,1038057,2024-01-03T00:00:00.000Z,249,30,Tyus Jones,2,11,13,11,4,20.4
2,0,4,1,1,4,4,0,0,22,0,2,9,4,3,0,1038058,2024-01-03T00:00:00.000Z,3547250,12,Aaron Nesmith,3,13,15,11,6,25.8
0,0,0,0,0,0,0,0,0,0,0,0,0,0,0,0,1038058,2024-01-03T00:00:00.000Z,38017507,12,Andrew Nembhard,0,0,0,0,0,0
3,0,1,2,2,9,6,2,2,25,0,4,16,1,0,1,1038058,2024-01-03T00:00:00.000Z,38017686,12,Bennedict Mathurin,0,17,20,19,4,20.7
2,0,5,1,0,7,5,6,5,28,0,6,15,5,0,4,1038058,2024-01-03T00:00:00.000Z,69,12,Bruce Brown,0,20,22,17,7,20
0,0,0,4,2,8,3,3,2,13,0,1,10,0,1,0,1038058,2024-01-03T00:00:00.000Z,210,12,Buddy Hield,1,10,10,10,0,13
3,0,2,0,0,6,4,1,1,18,2,3,9,4,1,1,1038058,2024-01-03T00:00:00.000Z,17896035,12,Isaiah Jackson,1,13,16,12,7,20.3
3,0,5,4,1,8,5,2,2,19,2,2,13,7,0,1,1038058,2024-01-03T00:00:00.000Z,3547264,12,Jalen Smith,0,20,23,16,10,24.9
0,0,0,0,0,0,0,0,0,0,0,0,0,0,0,0,1038058,2024-01-03T00:00:00.000Z,242,12,James Johnson,0,0,0,0,0,0
2,2,7,4,1,9,6,4,2,30,0,4,15,7,0,2,1038058,2024-01-03T00:00:00.000Z,452,12,Myles Turner,2,22,24,17,9,30.4
4,0,5,6,2,12,5,4,3,27,3,3,15,8,1,0,1038058,2024-01-03T00:00:00.000Z,3547243,12,Obi Toppin,1,23,27,19,12,33.6
3,0,6,1,0,6,2,2,2,19,0,1,6,6,0,1,1038058,2024-01-03T00:00:00.000Z,304,12,T.J. McConnell,0,12,15,9,9,16.7
12,3,2,11,5,20,10,6,6,34,0,1,31,2,1,0,1038058,2024-01-03T00:00:00.000Z,3547245,12,Tyrese Haliburton,4,33,45,43,14,63.4
0,0,0,0,0,0,0,0,0,0,0,0,0,0,0,0,1038058,2024-01-03T00:00:00.000Z,38017733,17,A.J. Green,0,0,0,0,0,0
2,0,2,2,1,4,3,0,0,14,0,1,7,2,1,1,1038058,2024-01-03T00:00:00.000Z,56677852,17,Andre Jackson Jr.,1,9,11,9,4,14.4
1,1,3,2,0,10,4,2,1,20,3,1,9,6,0,0,1038058,2024-01-03T00:00:00.000Z,377,17,Bobby Portis,1,15,16,10,7,20.7
2,0,1,2,1,3,2,3,2,10,0,3,7,1,0,0,1038058,2024-01-03T00:00:00.000Z,368,17,Cameron Payne,0,8,10,9,3,11.2
1,0,1,0,0,0,0,0,0,2,0,0,0,1,0,0,1038058,2024-01-03T00:00:00.000Z,56677854,17,Chris Livingston,0,1,2,1,2,2.7
0,0,0,0,0,0,0,0,0,0,0,0,0,0,0,0,1038058,2024-01-03T00:00:00.000Z,112,17,Jae Crowder,0,0,0,0,0,0
0,0,0,0,0,0,0,0,0,0,0,0,0,0,0,0,1038058,2024-01-03T00:00:00.000Z,666960,17,Lindell Wigginton,0,0,0,0,0,0
1,0,2,3,0,9,6,0,0,21,1,1,12,3,0,1,1038058,2024-01-03T00:00:00.000Z,38017676,17,MarJon Beauchamp,0,15,16,13,4,16.1
0,0,0,0,0,0,0,0,0,0,0,0,0,0,0,0,1038058,2024-01-03T00:00:00.000Z,666453,17,Marques Bolden,0,0,0,0,0,0
0,0,1,0,0,0,0,0,0,2,0,0,0,1,0,0,1038058,2024-01-03T00:00:00.000Z,284,17,Robin Lopez,0,1,1,0,1,1.2
0,0,1,0,0,0,0,0,0,2,0,2,0,1,0,0,1038058,2024-01-03T00:00:00.000Z,2148,17,Thanasis Antetokounmpo,0,1,1,0,1,1.2
0,0,0,0,0,0,0,0,0,0,0,0,0,0,0,0,1038058,2024-01-03T00:00:00.000Z,38017691,17,TyTy Washington Jr.,0,0,0,0,0,0
0,0,0,0,0,0,0,0,0,0,0,0,0,0,0,0,1038059,2024-01-03T00:00:00.000Z,666656,1,De'Andre Hunter,0,0,0,0,0,0
3,0,6,4,2,18,11,4,4,29,1,5,28,7,4,1,1038059,2024-01-03T00:00:00.000Z,17896040,1,Jalen Johnson,4,35,38,31,10,51.9
0,0,0,0,0,0,0,0,0,0,0,0,0,0,0,0,1038059,2024-01-03T00:00:00.000Z,56677838,1,Kobe Bufkin,0,0,0,0,0,0
0,0,0,0,0,0,0,0,0,0,0,0,0,0,0,0,1038059,2024-01-03T00:00:00.000Z,56677806,1,Mouhamed Gueye,0,0,0,0,0,0
2,1,6,8,2,12,3,2,2,36,2,2,10,8,0,0,1038059,2024-01-03T00:00:00.000Z,3547256,1,Saddiq Bey,1,18,20,12,10,25.6
0,0,0,0,0,0,0,0,0,0,0,0,0,0,0,0,1038059,2024-01-03T00:00:00.000Z,4197387,1,Vit Krejci,0,0,0,0,0,0
0,0,0,0,0,0,0,0,0,0,0,0,0,0,0,0,1038059,2024-01-03T00:00:00.000Z,3547271,21,Aleksej Pokusevski,0,0,0,0,0,0
2,0,1,7,3,9,5,2,2,20,0,2,15,1,1,0,1038059,2024-01-03T00:00:00.000Z,56677833,21,Cason Wallace,1,16,18,17,3,22.2
1,0,3,5,2,9,5,0,0,25,0,1,12,3,0,4,1038059,2024-01-03T00:00:00.000Z,38017685,21,Chet Holmgren,0,15,16,13,4,13.1
1,0,0,5,1,8,4,0,0,18,1,2,9,1,1,2,1038059,2024-01-03T00:00:00.000Z,3547272,21,Isaiah Joe,1,10,11,10,2,12.7
6,0,2,1,1,12,9,5,2,35,1,4,21,3,4,2,1038059,2024-01-03T00:00:00.000Z,38017703,21,Jalen Williams,4,24,30,27,9,43.6
2,0,3,2,1,2,1,0,0,15,0,4,3,3,2,0,1038059,2024-01-03T00:00:00.000Z,38017706,21,Jaylin Williams,2,6,8,5,5,15.6
4,0,1,3,2,7,3,2,1,22,2,1,9,3,1,2,1038059,2024-01-03T00:00:00.000Z,17896065,21,Josh Giddey,1,12,16,13,7,19.6
0,0,0,0,0,0,0,0,0,0,0,0,0,0,0,0,1038059,2024-01-03T00:00:00.000Z,480,21,Kenrich Williams,0,0,0,0,0,0
0,0,0,0,0,0,0,0,0,0,0,0,0,0,0,0,1038059,2024-01-03T00:00:00.000Z,56677853,21,Keyontae Johnson,0,0,0,0,0,0
1,0,3,6,3,6,3,0,0,20,0,2,9,3,0,1,1038059,2024-01-03T00:00:00.000Z,27924547,21,Lindy Waters III,0,12,13,10,4,13.1
3,0,1,3,2,7,3,6,6,29,3,4,14,4,0,0,1038059,2024-01-03T00:00:00.000Z,666541,21,Luguentz Dort,0,18,21,17,7,23.3
0,0,0,0,0,0,0,0,0,0,0,0,0,0,0,0,1038059,2024-01-03T00:00:00.000Z,24572055,21,Olivier Sarr,0,0,0,0,0,0
0,0,0,0,0,0,0,0,0,0,0,0,0,0,0,0,1038059,2024-01-03T00:00:00.000Z,38017716,21,Ousmane Dieng,0,0,0,0,0,0
8,0,12,3,2,24,11,11,9,35,1,2,33,13,0,2,1038059,2024-01-03T00:00:00.000Z,175,21,Shai Gilgeous-Alexander,0,46,54,41,21,58.6
0,0,0,0,0,0,0,0,0,0,0,0,0,0,0,0,1038059,2024-01-03T00:00:00.000Z,17896036,21,Tre Mann,0,0,0,0,0,0
0,0,0,0,0,0,0,0,0,0,0,0,0,0,0,0,1038059,2024-01-03T00:00:00.000Z,4197029,21,Vasilije Micic,0,0,0,0,0,0
0,0,0,0,0,0,0,0,0,0,0,0,0,0,0,0,1038060,2024-01-03T00:00:00.000Z,160,20,Evan Fournier,0,0,0,0,0,0
1,1,1,0,0,2,2,0,0,12,2,2,4,3,0,0,1038060,2024-01-03T00:00:00.000Z,3547249,20,Precious Achiuwa,1,7,8,5,4,12.1
0,0,1,6,2,9,3,0,0,18,0,0,8,1,1,0,1038060,2024-01-03T00:00:00.000Z,17895858,20,Quentin Grimes,1,9,9,8,1,12.2
0,0,0,0,0,0,0,0,0,1,0,0,0,0,0,0,1038060,2024-01-03T00:00:00.000Z,19,20,Ryan Arcidiacono,0,0,0,0,0,0
0,0,0,0,0,0,0,0,0,0,0,0,0,0,0,0,1038060,2024-01-03T00:00:00.000Z,173,20,Taj Gibson,0,0,0,0,0,0
0,0,1,0,0,0,0,0,0,3,0,0,0,1,0,0,1038061,2024-01-03T00:00:00.000Z,9051997,3,Armoni Brooks,0,1,1,0,1,1.2
0,0,0,0,0,0,0,0,0,0,0,0,0,0,0,0,1038061,2024-01-03T00:00:00.000Z,417,3,Ben Simmons,0,0,0,0,0,0
5,0,0,2,0,7,0,4,4,18,0,1,4,0,1,1,1038061,2024-01-03T00:00:00.000Z,17896048,3,Cam Thomas,1,4,9,9,5,13.5
5,1,6,6,3,13,6,2,0,32,0,0,15,6,0,0,1038061,2024-01-03T00:00:00.000Z,666679,3,Cameron Johnson,1,21,26,20,11,32.7
0,0,0,0,0,0,0,0,0,0,0,0,0,0,0,0,1038061,2024-01-03T00:00:00.000Z,56677841,3,Dariq Whitehead,0,0,0,0,0,0
1,1,8,0,0,7,4,6,3,20,4,5,11,12,1,1,1038061,2024-01-03T00:00:00.000Z,17896038,3,Day'Ron Sharpe,2,23,24,12,13,31.9
0,0,0,0,0,0,0,0,0,0,0,0,0,0,0,0,1038061,2024-01-03T00:00:00.000Z,421,3,Dennis Smith Jr.,0,0,0,0,0,0
2,1,1,11,1,16,4,0,0,20,1,2,9,2,0,2,1038061,2024-01-03T00:00:00.000Z,158,3,Dorian Finney-Smith,1,11,13,11,4,15.4
0,0,0,0,0,0,0,0,0,0,0,0,0,0,0,0,1038061,2024-01-03T00:00:00.000Z,174,3,Harry Giles III,0,0,0,0,0,0
0,0,0,0,0,0,0,0,0,5,0,0,0,0,1,0,1038061,2024-01-03T00:00:00.000Z,56677722,3,Jalen Wilson,1,0,0,0,0,3
0,0,0,0,0,0,0,0,0,0,0,0,0,0,0,0,1038061,2024-01-03T00:00:00.000Z,17896041,3,Keon Johnson,0,0,0,0,0,0
0,0,0,0,0,0,0,0,0,0,0,0,0,0,0,0,1038061,2024-01-03T00:00:00.000Z,464,3,Lonnie Walker IV,0,0,0,0,0,0
3,1,4,12,3,18,5,3,2,36,0,1,15,4,1,1,1038061,2024-01-03T00:00:00.000Z,61,3,Mikal Bridges,2,19,22,18,7,29.3
0,2,8,0,0,8,6,0,0,28,5,5,12,13,1,1,1038061,2024-01-03T00:00:00.000Z,666508,3,Nicolas Claxton,3,25,25,12,13,35.6
0,0,0,0,0,0,0,0,0,0,0,0,0,0,0,0,1038061,2024-01-03T00:00:00.000Z,56677843,3,Noah Clowney,0,0,0,0,0,0
3,0,3,8,2,13,5,2,1,30,1,3,13,4,2,1,1038061,2024-01-03T00:00:00.000Z,351,3,Royce O'Neale,2,17,20,16,7,27.3
5,0,1,3,2,5,3,5,3,28,0,1,11,1,2,1,1038061,2024-01-03T00:00:00.000Z,130,3,Spencer Dinwiddie,2,12,17,16,6,24.7
1,0,4,2,2,6,3,4,3,20,4,1,11,8,1,0,1038061,2024-01-03T00:00:00.000Z,17896058,3,Trendon Watford,1,19,20,12,9,25.1
0,0,0,0,0,0,0,0,0,0,0,0,0,0,0,0,1038061,2024-01-03T00:00:00.000Z,296,11,Boban Marjanovic,0,0,0,0,0,0
0,0,0,0,0,0,0,0,0,0,0,0,0,0,0,0,1038061,2024-01-03T00:00:00.000Z,66,11,Dillon Brooks,0,0,0,0,0,0
0,0,0,0,0,0,0,0,0,0,0,0,0,0,0,0,1038061,2024-01-03T00:00:00.000Z,47738533,11,Jeenathan Williams,0,0,0,0,0,0
0,0,0,0,0,0,0,0,0,0,0,0,0,0,0,0,1038061,2024-01-03T00:00:00.000Z,56677809,11,Jermaine Samuels Jr.,0,0,0,0,0,0
0,0,0,0,0,0,0,0,0,0,0,0,0,0,0,0,1038061,2024-01-03T00:00:00.000Z,19465326,11,Jock Landale,0,0,0,0,0,0
0,0,0,0,0,0,0,0,0,0,0,0,0,0,0,0,1038061,2024-01-03T00:00:00.000Z,3547281,11,Nate Hinton,0,0,0,0,0,0
1,0,1,1,0,2,0,0,0,8,0,0,0,1,0,0,1038061,2024-01-03T00:00:00.000Z,75,11,Reggie Bullock,0,1,2,1,2,2.7
0,0,0,0,0,0,0,0,0,0,0,0,0,0,0,0,1038061,2024-01-03T00:00:00.000Z,38017695,11,Tari Eason,0,0,0,0,0,0
0,0,0,0,0,0,0,0,0,0,0,0,0,0,0,0,1038061,2024-01-03T00:00:00.000Z,357,11,Victor Oladipo,0,0,0,0,0,0
0,0,0,0,0,0,0,0,0,0,0,0,0,0,0,0,1038062,2024-01-03T00:00:00.000Z,48,15,Bismack Biyombo,0,0,0,0,0,0
0,0,0,0,0,0,0,0,0,0,0,0,0,0,0,0,1038062,2024-01-03T00:00:00.000Z,666505,15,Brandon Clarke,0,0,0,0,0,0
0,0,0,2,0,2,0,0,0,7,0,0,0,0,0,0,1038062,2024-01-03T00:00:00.000Z,38017729,15,David Roddy,0,0,0,0,0,0
0,0,0,0,0,0,0,0,0,0,0,0,0,0,0,0,1038062,2024-01-03T00:00:00.000Z,401,15,Derrick Rose,0,0,0,0,0,0
8,0,2,6,2,18,9,2,2,38,2,4,22,4,0,0,1038062,2024-01-03T00:00:00.000Z,3547287,15,Desmond Bane,0,26,34,30,12,38.8
0,0,0,0,0,0,0,0,0,0,0,0,0,0,0,0,1038062,2024-01-03T00:00:00.000Z,56677830,15,GG Jackson,0,0,0,0,0,0
9,0,7,6,3,18,10,6,5,35,1,1,28,8,1,2,1038062,2024-01-03T00:00:00.000Z,666786,15,Ja Morant,1,36,45,37,17,52.1
0,0,0,0,0,0,0,0,0,0,0,0,0,0,0,0,1038062,2024-01-03T00:00:00.000Z,48248287,15,Jacob Gilyard,0,0,0,0,0,0
0,0,0,0,0,0,0,0,0,0,0,0,0,0,0,0,1038062,2024-01-03T00:00:00.000Z,38017728,15,Jake LaRavia,0,0,0,0,0,0
0,4,3,8,4,18,7,6,6,37,1,1,24,4,1,3,1038062,2024-01-03T00:00:00.000Z,231,15,Jaren Jackson Jr.,5,28,28,24,4,40.8
1,1,2,0,0,2,0,0,0,8,0,0,0,2,2,1,1038062,2024-01-03T00:00:00.000Z,666703,15,John Konchar,3,2,3,1,3,11.9
0,0,1,4,0,5,1,0,0,19,0,1,2,1,0,0,1038062,2024-01-03T00:00:00.000Z,254,15,Luke Kennard,0,3,3,2,1,3.2
2,0,5,5,0,10,2,3,2,33,0,4,6,5,1,3,1038062,2024-01-03T00:00:00.000Z,420,15,Marcus Smart,1,11,13,8,7,15
3,0,7,4,2,6,2,2,1,22,1,4,7,8,1,1,1038062,2024-01-03T00:00:00.000Z,17896067,15,Santi Aldama,1,15,18,10,11,23.1
0,0,0,0,0,0,0,0,0,0,0,0,0,0,0,0,1038062,2024-01-03T00:00:00.000Z,3,15,Steven Adams,0,0,0,0,0,0
0,0,0,0,0,0,0,0,0,0,0,0,0,0,0,0,1038062,2024-01-03T00:00:00.000Z,38017731,15,Vince Williams Jr.,0,0,0,0,0,0
2,0,3,0,0,3,2,0,0,23,2,3,4,5,0,0,1038062,2024-01-03T00:00:00.000Z,3547285,15,Xavier Tillman,0,9,11,6,7,13
0,0,4,7,4,12,7,0,0,18,2,1,18,6,1,0,1038062,2024-01-03T00:00:00.000Z,17896027,15,Ziaire Williams,1,24,24,18,6,28.2
2,0,5,0,0,2,2,0,0,13,3,0,4,8,0,1,1038062,2024-01-03T00:00:00.000Z,58,28,Chris Boucher,0,12,14,6,10,15.6
0,0,0,0,0,0,0,0,0,0,0,0,0,0,0,0,1038062,2024-01-03T00:00:00.000Z,38017710,28,Christian Koloko,0,0,0,0,0,0
5,0,7,3,1,11,6,4,3,29,0,0,16,7,0,0,1038062,2024-01-03T00:00:00.000Z,409,28,Dennis Schroder,0,23,28,21,12,31.9
0,0,0,0,0,0,0,0,0,0,0,0,0,0,0,0,1038062,2024-01-03T00:00:00.000Z,436,28,Garrett Temple,0,0,0,0,0,0
0,0,1,1,1,5,2,0,0,22,0,2,5,1,1,2,1038062,2024-01-03T00:00:00.000Z,3089,28,Gary Trent Jr.,1,6,6,5,1,7.2
0,0,0,0,0,0,0,0,0,0,0,0,0,0,0,0,1038062,2024-01-03T00:00:00.000Z,56677828,28,Gradey Dick,0,0,0,0,0,0
5,1,3,8,5,18,8,6,5,33,0,3,26,3,0,1,1038062,2024-01-03T00:00:00.000Z,3547269,28,Immanuel Quickley,1,29,34,31,8,39.1
2,5,5,0,0,7,2,4,3,33,3,3,7,8,1,1,1038062,2024-01-03T00:00:00.000Z,373,28,Jakob Poeltl,6,15,17,9,10,36.6
0,0,0,0,0,0,0,0,0,0,0,0,0,0,0,0,1038062,2024-01-03T00:00:00.000Z,666762,28,Jalen McDaniels,0,0,0,0,0,0
0,0,0,0,0,0,0,0,0,0,0,0,0,0,0,0,1038062,2024-01-03T00:00:00.000Z,56677805,28,Javon Freeman-Liberty,0,0,0,0,0,0
0,0,3,2,0,2,0,0,0,7,0,2,0,3,0,0,1038062,2024-01-03T00:00:00.000Z,2309958,28,Jontay Porter,0,3,3,0,3,3.6
0,0,0,0,0,0,0,0,0,0,0,0,0,0,0,0,1038062,2024-01-03T00:00:00.000Z,56677869,28,Markquis Nowell,0,0,0,0,0,0
0,0,0,0,0,0,0,0,0,0,0,0,0,0,0,0,1038062,2024-01-03T00:00:00.000Z,376,28,Otto Porter Jr.,0,0,0,0,0,0
0,0,6,2,1,14,9,6,5,30,1,5,24,7,1,3,1038062,2024-01-03T00:00:00.000Z,416,28,Pascal Siakam,1,31,31,24,7,32.4
3,0,7,5,2,12,5,3,2,33,0,3,14,7,1,3,1038062,2024-01-03T00:00:00.000Z,666423,28,RJ Barrett,1,21,24,17,10,26.9
8,0,2,5,2,14,7,4,4,40,0,2,20,2,1,1,1038062,2024-01-03T00:00:00.000Z,17896055,28,Scottie Barnes,1,22,30,28,10,36.4
0,0,0,0,0,0,0,0,0,0,0,0,0,0,0,0,1038062,2024-01-03T00:00:00.000Z,489,28,Thaddeus Young,0,0,0,0,0,0
5,1,2,7,4,22,11,10,9,37,2,1,35,4,1,6,1038063,2024-01-03T00:00:00.000Z,3547238,18,Anthony Edwards,2,39,44,40,9,47.3
0,0,0,0,0,0,0,0,0,0,0,0,0,0,0,0,1038063,2024-01-03T00:00:00.000Z,17895968,18,Daishen Nix,0,0,0,0,0,0
2,1,0,3,1,10,5,0,0,33,0,3,11,0,2,1,1038063,2024-01-03T00:00:00.000Z,3547259,18,Jaden McDaniels,3,11,13,13,2,22
0,0,0,0,0,0,0,0,0,0,0,0,0,0,0,0,1038063,2024-01-03T00:00:00.000Z,56677851,18,Jaylen Clark,0,0,0,0,0,0
4,0,1,4,0,6,1,2,1,17,2,0,3,3,1,0,1038063,2024-01-03T00:00:00.000Z,666767,18,Jordan McLaughlin,1,6,10,7,7,15.6
0,1,0,0,0,0,0,2,2,3,0,0,2,0,0,0,1038063,2024-01-03T00:00:00.000Z,38017715,18,Josh Minott,1,2,2,2,0,5
2,0,4,4,0,19,8,7,6,36,2,2,22,6,0,1,1038063,2024-01-03T00:00:00.000Z,447,18,Karl-Anthony Towns,0,28,30,24,8,31.2
0,0,3,0,0,2,0,2,1,14,1,0,1,4,2,0,1038063,2024-01-03T00:00:00.000Z,12,18,Kyle Anderson,2,5,5,1,4,11.8
9,0,0,3,1,5,3,0,0,26,0,1,7,0,1,0,1038063,2024-01-03T00:00:00.000Z,104,18,Mike Conley,1,7,16,16,9,23.5
2,2,6,5,2,8,3,0,0,25,0,2,8,6,0,1,1038063,2024-01-03T00:00:00.000Z,667378,18,Naz Reid,2,14,16,10,8,23.2
1,0,0,2,0,3,1,2,2,19,0,0,4,0,0,1,1038063,2024-01-03T00:00:00.000Z,666400,18,Nickeil Alexander-Walker,0,4,5,5,1,4.5
0,1,4,0,0,3,2,2,1,24,1,4,5,5,0,1,1038063,2024-01-03T00:00:00.000Z,176,18,Rudy Gobert,1,10,10,5,5,13
0,0,0,1,1,2,2,0,0,3,0,0,5,0,0,0,1038063,2024-01-03T00:00:00.000Z,320,18,Shake Milton,0,5,5,5,0,5
1,0,0,2,1,2,1,0,0,3,0,0,3,0,0,0,1038063,2024-01-03T00:00:00.000Z,68,18,Troy Brown Jr.,0,3,4,4,1,4.5
1,0,0,0,0,0,0,0,0,2,1,0,0,1,0,0,1038063,2024-01-03T00:00:00.000Z,491,19,Cody Zeller,0,1,2,1,2,2.7
0,0,0,0,0,0,0,0,0,0,0,0,0,0,0,0,1038063,2024-01-03T00:00:00.000Z,38017726,19,Dereon Seabron,0,0,0,0,0,0
0,0,0,0,0,0,0,0,0,0,0,0,0,0,0,0,1038063,2024-01-03T00:00:00.000Z,38017663,19,E.J. Liddell,0,0,0,0,0,0
0,0,0,0,0,0,0,0,0,0,0,0,0,0,0,0,1038063,2024-01-03T00:00:00.000Z,17896021,19,Jeremiah Robinson-Earl,0,0,0,0,0,0
0,0,0,0,0,0,0,0,0,0,0,0,0,0,0,0,1038063,2024-01-03T00:00:00.000Z,3547260,19,Kira Lewis Jr.,0,0,0,0,0,0
2,1,6,0,0,6,4,0,0,22,3,1,8,9,1,0,1038063,2024-01-03T00:00:00.000Z,340,19,Larry Nance Jr.,2,17,19,10,11,27.8
0,0,0,0,0,0,0,0,0,0,0,0,0,0,0,0,1038063,2024-01-03T00:00:00.000Z,17896017,19,Matt Ryan,0,0,0,0,0,0
0,0,2,2,0,4,1,0,0,14,0,4,2,2,1,0,1038063,2024-01-03T00:00:00.000Z,3547293,19,Naji Marshall,1,4,4,2,2,7.4
0,0,0,0,0,0,0,0,0,0,0,0,0,0,0,0,1038063,2024-01-03T00:00:00.000Z,18677986,19,Trey Murphy III,0,0,0,0,0,0
0,0,0,1,1,4,1,0,0,8,0,1,3,0,1,0,1038064,2024-01-03T00:00:00.000Z,17554004,7,AJ Lawson,1,3,3,3,0,6
0,0,1,0,0,1,0,2,0,6,1,0,0,2,1,0,1038064,2024-01-03T00:00:00.000Z,24489167,7,Brandon Williams,1,2,2,0,2,5.4
0,0,0,0,0,0,0,0,0,0,0,0,0,0,0,0,1038064,2024-01-03T00:00:00.000Z,151,7,Dante Exum,0,0,0,0,0,0
4,3,3,0,0,1,0,0,0,19,1,1,0,4,2,0,1038064,2024-01-03T00:00:00.000Z,56677840,7,Dereck Lively II,5,4,8,4,8,25.8
1,2,0,0,0,3,2,2,1,23,0,2,5,0,2,1,1038064,2024-01-03T00:00:00.000Z,247,7,Derrick Jones Jr.,4,5,6,6,1,17.5
2,0,2,0,0,1,1,6,3,13,1,2,5,3,0,1,1038064,2024-01-03T00:00:00.000Z,379,7,Dwight Powell,0,8,10,7,5,10.6
2,0,1,0,0,2,1,0,0,15,1,2,2,2,0,3,1038064,2024-01-03T00:00:00.000Z,666965,7,Grant Williams,0,4,6,4,4,4.4
0,0,0,0,0,0,0,0,0,0,0,0,0,0,0,0,1038064,2024-01-03T00:00:00.000Z,17896028,7,Greg Brown III,0,0,0,0,0,0
1,1,2,6,1,10,4,3,2,11,0,0,11,2,0,0,1038064,2024-01-03T00:00:00.000Z,38017679,7,Jaden Hardy,1,13,14,12,3,17.9
1,0,4,2,0,5,3,2,2,27,0,4,8,4,2,0,1038064,2024-01-03T00:00:00.000Z,3547258,7,Josh Green,2,12,13,9,5,20.3
5,0,8,8,4,19,10,6,5,29,1,0,29,9,2,1,1038064,2024-01-03T00:00:00.000Z,228,7,Kyrie Irving,2,38,43,34,14,52.3
5,0,6,7,4,21,13,14,11,31,0,1,41,6,1,4,1038064,2024-01-03T00:00:00.000Z,132,7,Luka Doncic,1,47,52,46,11,54.7
1,1,3,1,1,3,1,0,0,12,0,2,3,3,0,1,1038064,2024-01-03T00:00:00.000Z,329,7,Markieff Morris,1,6,7,4,4,10.1
0,0,0,0,0,0,0,0,0,0,0,0,0,0,0,0,1038064,2024-01-03T00:00:00.000Z,257,7,Maxi Kleber,0,0,0,0,0,0
1,1,3,0,0,3,1,4,3,8,2,1,5,5,0,0,1038064,2024-01-03T00:00:00.000Z,56677859,7,Olivier-Maxence Prosper,1,10,11,6,6,15.5
0,0,0,0,0,0,0,0,0,0,0,0,0,0,0,0,1038064,2024-01-03T00:00:00.000Z,217,7,Richaun Holmes,0,0,0,0,0,0
2,0,1,0,0,1,0,0,0,15,0,0,0,1,0,0,1038064,2024-01-03T00:00:00.000Z,114,7,Seth Curry,0,1,3,2,3,4.2
0,0,3,5,2,10,5,2,2,23,0,2,14,3,0,0,1038064,2024-01-03T00:00:00.000Z,191,7,Tim Hardaway Jr.,0,17,17,14,3,17.6
1,0,2,1,0,2,1,0,0,6,0,4,2,2,0,2,1038064,2024-01-03T00:00:00.000Z,56783340,25,Duop Reath,0,4,5,3,3,3.9
0,0,5,5,3,5,3,0,0,17,0,0,9,5,1,0,1038064,2024-01-03T00:00:00.000Z,17896120,25,Ish Wainright,1,14,14,9,5,18
4,0,4,1,0,3,1,2,2,17,1,2,4,5,0,1,1038064,2024-01-03T00:00:00.000Z,38017711,25,Jabari Walker,0,9,13,8,9,15
2,0,1,3,1,9,4,3,1,20,0,3,10,1,0,3,1038064,2024-01-03T00:00:00.000Z,182,25,Jerami Grant,0,11,13,12,3,11.2
2,0,1,1,0,4,1,0,0,15,0,0,2,1,0,0,1038064,2024-01-03T00:00:00.000Z,56677791,25,Kris Murray,0,3,5,4,3,6.2
2,0,2,3,0,6,2,1,1,17,0,1,5,2,0,0,1038064,2024-01-03T00:00:00.000Z,65,25,Malcolm Brogdon,0,7,9,7,4,10.4
1,0,2,6,4,6,4,0,0,23,0,4,12,2,1,0,1038064,2024-01-03T00:00:00.000Z,666923,25,Matisse Thybulle,1,14,15,13,3,18.9
0,0,3,5,1,12,6,3,3,22,1,3,16,4,0,0,1038064,2024-01-03T00:00:00.000Z,38017690,25,Shaedon Sharpe,0,20,20,16,4,20.8
1,0,4,0,0,4,2,2,1,8,1,0,5,5,0,1,1038064,2024-01-03T00:00:00.000Z,3547289,25,Skylar Mays,0,10,11,6,6,11.5
0,1,3,4,2,8,3,3,2,20,2,6,10,5,2,2,1038064,2024-01-03T00:00:00.000Z,56677850,25,Toumani Camara,3,15,15,10,5,23
0,0,0,0,0,0,0,0,0,0,0,0,0,0,0,0,1038065,2024-01-03T00:00:00.000Z,17896022,13,Brandon Boston Jr.,0,0,0,0,0,0
11,1,5,7,4,13,7,4,4,36,0,2,22,5,0,4,1038065,2024-01-03T00:00:00.000Z,192,13,James Harden,1,27,38,33,16,43.5
1,0,1,4,2,8,5,0,0,23,2,1,12,3,2,0,1038065,2024-01-03T00:00:00.000Z,666743,13,Terance Mann,2,15,16,13,4,23.1
2,0,2,4,1,6,3,0,0,15,1,0,7,3,2,1,1038065,2024-01-03T00:00:00.000Z,314,24,Chimezie Metu,2,10,12,9,5,18.6
0,0,0,0,0,0,0,0,0,4,0,1,0,0,0,0,1038065,2024-01-03T00:00:00.000Z,147,24,Drew Eubanks,0,0,0,0,0,0
3,0,3,4,2,9,4,1,0,32,1,2,10,4,3,1,1038065,2024-01-03T00:00:00.000Z,8,24,Grayson Allen,3,14,17,13,7,27.3
0,0,0,0,0,0,0,0,0,0,0,0,0,0,0,0,1038065,2024-01-03T00:00:00.000Z,18678058,24,Jordan Goodwin,0,0,0,0,0,0
1,0,5,1,0,5,3,3,3,25,1,3,9,6,1,1,1038065,2024-01-03T00:00:00.000Z,349,24,Jusuf Nurkic,1,15,16,10,7,19.7
0,0,0,0,0,0,0,0,0,0,0,0,0,0,0,0,1038066,2024-01-03T00:00:00.000Z,56677729,9,Malcolm Cazalon,0,0,0,0,0,0
0,0,0,0,0,0,0,0,0,0,0,0,0,0,0,0,1038066,2024-01-03T00:00:00.000Z,56677792,9,Marcus Sasser,0,0,0,0,0,0
0,0,0,0,0,0,0,0,0,0,0,0,0,0,0,0,1038066,2024-01-03T00:00:00.000Z,330,9,Monte Morris,0,0,0,0,0,0
0,0,0,0,0,0,0,0,0,0,0,0,0,0,0,0,1038066,2024-01-03T00:00:00.000Z,666881,29,Luka Samanic,0,0,0,0,0,0
0,0,0,0,0,0,0,0,0,0,0,0,0,0,0,0,1038067,2024-01-03T00:00:00.000Z,56677867,14,Alex Fudge,0,0,0,0,0,0
6,5,14,1,0,17,10,10,9,43,3,2,29,17,3,5,1038067,2024-01-03T00:00:00.000Z,117,14,Anthony Davis,8,46,52,35,23,77.4
1,0,0,1,0,1,0,0,0,19,0,2,0,0,0,4,1038067,2024-01-03T00:00:00.000Z,666860,14,Cameron Reddish,0,0,1,1,1,-2.5
3,1,4,2,0,10,5,3,3,24,4,1,13,8,0,2,1038067,2024-01-03T00:00:00.000Z,486,14,Christian Wood,1,21,24,16,11,28.1
0,0,0,0,0,0,0,0,0,0,0,0,0,0,0,0,1038067,2024-01-03T00:00:00.000Z,56677738,14,Colin Castleton,0,0,0,0,0,0
0,0,0,0,0,0,0,0,0,0,0,0,0,0,0,0,1038067,2024-01-03T00:00:00.000Z,405,14,D'Angelo Russell,0,0,0,0,0,0
0,0,0,0,0,0,0,0,0,0,0,0,0,0,0,0,1038067,2024-01-03T00:00:00.000Z,56677868,14,D'Moi Hodge,0,0,0,0,0,0
0,0,0,0,0,0,0,0,0,0,0,0,0,0,0,0,1038067,2024-01-03T00:00:00.000Z,1603383,14,Gabe Vincent,0,0,0,0,0,0
0,0,1,0,0,4,0,0,0,6,1,1,0,2,0,0,1038067,2024-01-03T00:00:00.000Z,56677835,14,Jalen Hood-Schifino,0,2,2,0,2,2.4
0,0,2,0,0,3,2,0,0,15,0,0,4,2,0,2,1038067,2024-01-03T00:00:00.000Z,457,14,Jarred Vanderbilt,0,6,6,4,2,4.4
0,0,0,0,0,0,0,0,0,1,0,0,0,0,0,0,1038067,2024-01-03T00:00:00.000Z,666626,14,Jaxson Hayes,0,0,0,0,0,0
9,0,6,6,0,18,6,0,0,38,0,2,12,6,0,2,1038067,2024-01-03T00:00:00.000Z,237,14,LeBron James,0,18,27,21,15,30.7
0,0,4,9,2,12,5,2,2,28,1,2,14,5,0,2,1038067,2024-01-03T00:00:00.000Z,38017697,14,Max Christie,0,19,19,14,5,18
0,0,0,0,0,0,0,0,0,0,0,0,0,0,0,0,1038067,2024-01-03T00:00:00.000Z,56677836,14,Maxwell Lewis,0,0,0,0,0,0
0,0,0,0,0,0,0,0,0,0,0,0,0,0,0,0,1038067,2024-01-03T00:00:00.000Z,666609,14,Rui Hachimura,0,0,0,0,0,0
0,0,0,0,0,0,0,0,0,0,0,0,0,0,0,0,1038067,2024-01-03T00:00:00.000Z,666747,16,Caleb Martin,0,0,0,0,0,0
0,0,0,1,0,1,0,0,0,1,0,0,0,0,0,0,1038067,2024-01-03T00:00:00.000Z,38017736,16,Cole Swider,0,0,0,0,0,0
0,0,0,0,0,0,0,0,0,0,0,0,0,0,0,0,1038067,2024-01-03T00:00:00.000Z,19465585,16,Dru Smith,0,0,0,0,0,0
0,0,0,0,0,0,0,0,0,0,0,0,0,0,0,0,1038067,2024-01-03T00:00:00.000Z,3092,16,Haywood Highsmith,0,0,0,0,0,0
0,0,0,0,0,0,0,0,0,0,0,0,0,0,0,0,1038067,2024-01-03T00:00:00.000Z,79,16,Jimmy Butler,0,0,0,0,0,0
0,0,0,0,0,0,0,0,0,1,0,0,0,0,0,0,1038067,2024-01-03T00:00:00.000Z,39398582,16,Orlando Robinson,0,0,0,0,0,0
0,0,0,0,0,0,0,0,0,0,0,0,0,0,0,0,1038067,2024-01-03T00:00:00.000Z,74,16,Thomas Bryant,0,0,0,0,0,0
1,0,0,0,0,0,0,0,0,6,0,1,0,0,0,0,1038068,2024-01-03T00:00:00.000Z,666885,22,Admiral Schofield,0,0,1,1,1,1.5
4,0,1,1,1,7,4,0,0,25,1,1,9,2,0,1,1038068,2024-01-03T00:00:00.000Z,56677827,22,Anthony Black,0,11,15,13,6,16.4
1,0,2,6,4,6,4,3,3,31,0,2,15,2,4,1,1038068,2024-01-03T00:00:00.000Z,38017724,22,Caleb Houstan,4,17,18,16,3,29.9
3,1,6,4,3,5,4,0,0,27,1,2,11,7,0,0,1038068,2024-01-03T00:00:00.000Z,666818,22,Chuma Okeke,1,18,21,14,10,26.9
0,0,0,0,0,0,0,0,0,0,0,0,0,0,0,0,1038068,2024-01-03T00:00:00.000Z,3547251,22,Cole Anthony,0,0,0,0,0,0
1,0,2,1,1,4,2,1,1,5,0,0,6,2,0,0,1038068,2024-01-03T00:00:00.000Z,17896026,22,Franz Wagner,0,8,9,7,3,9.9
1,0,1,3,1,4,2,1,0,12,0,2,5,1,1,1,1038068,2024-01-03T00:00:00.000Z,196,22,Gary Harris,1,6,7,6,2,9.7
2,3,5,1,0,5,2,2,2,28,1,3,6,6,1,1,1038068,2024-01-03T00:00:00.000Z,666442,22,Goga Bitadze,4,12,14,8,8,27.2
4,2,2,12,6,18,8,2,2,39,1,4,24,3,2,4,1038068,2024-01-03T00:00:00.000Z,17896073,22,Jalen Suggs,4,27,31,28,7,41.6
0,0,0,0,0,0,0,0,0,0,0,0,0,0,0,0,1038068,2024-01-03T00:00:00.000Z,56677839,22,Jett Howard,0,0,0,0,0,0
0,0,0,0,0,0,0,0,0,0,0,0,0,0,0,0,1038068,2024-01-03T00:00:00.000Z,226,22,Joe Ingles,0,0,0,0,0,0
0,0,0,0,0,0,0,0,0,0,0,0,0,0,0,0,1038068,2024-01-03T00:00:00.000Z,229,22,Jonathan Isaac,0,0,0,0,0,0
0,0,0,0,0,0,0,0,0,0,0,0,0,0,0,0,1038068,2024-01-03T00:00:00.000Z,38017607,22,Kevon Harris,0,0,0,0,0,0
0,0,0,0,0,0,0,0,0,0,0,0,0,0,0,0,1038068,2024-01-03T00:00:00.000Z,165,22,Markelle Fultz,0,0,0,0,0,0
2,0,2,1,0,2,0,2,2,13,1,2,2,3,0,3,1038068,2024-01-03T00:00:00.000Z,462,22,Moritz Wagner,0,5,7,4,5,5.6
5,0,3,9,6,25,13,14,11,45,1,4,43,4,0,8,1038068,2024-01-03T00:00:00.000Z,38017683,22,Paolo Banchero,0,47,52,48,9,47.3
6,1,2,3,0,7,2,2,1,38,0,5,5,2,2,0,1038068,2024-01-03T00:00:00.000Z,17553983,22,Trevelin Queen,3,7,13,11,8,25.4
3,0,6,3,3,7,3,0,0,21,1,4,9,7,0,1,1038068,2024-01-03T00:00:00.000Z,85,22,Wendell Carter Jr.,0,16,19,12,10,20.9
0,0,0,0,0,0,0,0,0,0,0,0,0,0,0,0,1038068,2024-01-03T00:00:00.000Z,4197162,26,Aleksandar Vezenkov,0,0,0,0,0,0
1,0,0,1,0,3,0,0,0,10,0,3,0,0,1,2,1038068,2024-01-03T00:00:00.000Z,17896030,26,Chris Duarte,1,0,1,1,1,2.5
0,0,0,0,0,0,0,0,0,0,0,0,0,0,0,0,1038068,2024-01-03T00:00:00.000Z,56677845,26,Colby Jones,0,0,0,0,0,0
7,0,1,5,0,22,6,4,3,44,3,1,15,4,1,3,1038068,2024-01-03T00:00:00.000Z,161,26,De'Aaron Fox,1,19,26,22,11,30.3
12,1,17,0,0,14,8,9,6,45,6,2,22,23,2,6,1038068,2024-01-03T00:00:00.000Z,406,26,Domantas Sabonis,3,45,57,34,35,70.6
0,0,0,0,0,0,0,0,0,0,0,0,0,0,0,0,1038068,2024-01-03T00:00:00.000Z,56677862,26,Jalen Slawson,0,0,0,0,0,0
0,0,0,0,0,0,0,0,0,0,0,0,0,0,0,0,1038068,2024-01-03T00:00:00.000Z,17895990,26,Jordan Ford,0,0,0,0,0,0
0,0,0,0,0,0,0,0,0,1,0,0,0,0,0,0,1038068,2024-01-03T00:00:00.000Z,666925,26,Juan Toscano-Anderson,0,0,0,0,0,0
1,0,8,6,2,21,13,0,0,46,4,0,28,12,1,0,1038068,2024-01-03T00:00:00.000Z,38017688,26,Keegan Murray,1,40,41,29,13,46.9
0,0,0,0,0,0,0,0,0,0,0,0,0,0,0,0,1038068,2024-01-03T00:00:00.000Z,38017714,26,Keon Ellis,0,0,0,0,0,0
0,0,0,0,0,0,0,0,0,0,0,0,0,0,0,0,1038068,2024-01-03T00:00:00.000Z,17896044,26,Kessler Edwards,0,0,0,0,0,0
2,0,6,4,0,5,0,2,2,18,1,1,2,7,0,1,1038068,2024-01-03T00:00:00.000Z,221,26,Kevin Huerter,0,9,11,4,9,12.4
9,1,3,13,7,20,12,8,6,46,0,5,37,3,2,3,1038068,2024-01-03T00:00:00.000Z,324,26,Malik Monk,3,40,49,46,12,60.1
0,0,0,0,0,0,0,0,0,0,0,0,0,0,0,0,1038069,2024-01-04T00:00:00.000Z,180,27,Devonte' Graham,0,0,0,0,0,0
4,2,1,0,0,3,3,0,0,15,0,1,6,1,1,0,1038069,2024-01-04T00:00:00.000Z,38017730,27,Dominick Barlow,3,7,11,10,5,22.2
1,0,8,8,2,17,5,2,2,30,2,1,14,10,0,1,1038069,2024-01-04T00:00:00.000Z,666682,27,Keldon Johnson,0,24,25,15,11,26.5
0,0,0,0,0,0,0,0,0,0,0,0,0,0,0,0,1038069,2024-01-04T00:00:00.000Z,38017692,27,Malaki Branham,0,0,0,0,0,0
0,0,0,0,0,0,0,0,0,0,0,0,0,0,0,0,1038069,2024-01-04T00:00:00.000Z,3547163,27,Mamadi Diakite,0,0,0,0,0,0
2,0,0,0,0,0,0,0,0,2,0,0,0,0,0,0,1038069,2024-01-04T00:00:00.000Z,17896059,27,Sandro Mamukelashvili,0,0,2,2,2,3
2,1,4,4,2,17,11,7,6,35,5,2,30,9,0,0,1038070,2024-01-04T00:00:00.000Z,177,8,Aaron Gordon,1,39,41,32,11,46.8
0,0,0,0,0,0,0,0,0,0,0,0,0,0,0,0,1038070,2024-01-04T00:00:00.000Z,17896007,8,Braxton Key,0,0,0,0,0,0
1,1,0,2,0,4,1,0,0,19,0,3,2,0,1,1,1038070,2024-01-04T00:00:00.000Z,38017709,8,Christian Braun,2,2,3,3,1,8.5
0,0,0,0,0,0,0,0,0,0,0,0,0,0,0,0,1038070,2024-01-04T00:00:00.000Z,38017727,8,Collin Gillespie,0,0,0,0,0,0
0,0,0,0,0,0,0,0,0,0,0,0,0,0,0,0,1038070,2024-01-04T00:00:00.000Z,250,8,DeAndre Jordan,0,0,0,0,0,0
0,0,0,0,0,0,0,0,0,0,0,0,0,0,0,0,1038070,2024-01-04T00:00:00.000Z,56677871,8,Hunter Tyson,0,0,0,0,0,0
0,0,0,0,0,0,0,0,0,0,0,0,0,0,0,0,1038070,2024-01-04T00:00:00.000Z,56677582,8,Jalen Pickett,0,0,0,0,0,0
6,0,2,6,1,16,8,9,8,32,0,4,25,2,2,0,1038070,2024-01-04T00:00:00.000Z,335,8,Jamal Murray,2,27,33,31,8,42.4
0,0,0,0,0,0,0,0,0,0,0,0,0,0,0,0,1038070,2024-01-04T00:00:00.000Z,17896103,8,Jay Huff,0,0,0,0,0,0
1,0,0,1,0,1,0,0,0,9,1,0,0,1,1,0,1038070,2024-01-04T00:00:00.000Z,56677776,8,Julian Strawther,1,1,2,1,2,5.7
0,0,0,0,0,0,0,0,0,0,0,0,0,0,0,0,1038070,2024-01-04T00:00:00.000Z,215,8,Justin Holiday,0,0,0,0,0,0
4,1,2,2,0,8,4,0,0,35,1,0,8,3,1,1,1038070,2024-01-04T00:00:00.000Z,81,8,Kentavious Caldwell-Pope,2,11,15,12,7,22.6
0,0,4,5,2,6,3,0,0,31,0,3,8,4,0,0,1038070,2024-01-04T00:00:00.000Z,375,8,Michael Porter Jr.,0,12,12,8,4,12.8
10,1,7,2,2,16,13,7,6,38,2,2,34,9,2,4,1038070,2024-01-04T00:00:00.000Z,246,8,Nikola Jokic,3,43,53,44,19,64.8
0,0,4,4,2,10,6,6,5,19,1,1,19,5,0,0,1038070,2024-01-04T00:00:00.000Z,38017721,8,Peyton Watson,0,24,24,19,5,25
3,0,0,0,0,6,1,0,0,16,0,0,2,0,0,1,1038070,2024-01-04T00:00:00.000Z,236,8,Reggie Jackson,0,2,5,5,3,5.5
0,0,0,0,0,0,0,0,0,0,0,0,0,0,0,0,1038070,2024-01-04T00:00:00.000Z,666489,8,Vlatko Cancar,0,0,0,0,0,0
1,0,2,0,0,1,1,0,0,6,1,0,2,3,0,0,1038070,2024-01-04T00:00:00.000Z,3547268,8,Zeke Nnaji,0,5,6,3,4,7.1
0,0,0,0,0,0,0,0,0,0,0,0,0,0,0,0,1038070,2024-01-04T00:00:00.000Z,251,10,Cory Joseph,0,0,0,0,0,0
0,0,0,0,0,0,0,0,0,0,0,0,0,0,0,0,1038070,2024-01-04T00:00:00.000Z,2189,10,Gary Payton II,0,0,0,0,0,0
0,0,0,0,0,0,0,0,0,0,0,0,0,0,0,0,1038070,2024-01-04T00:00:00.000Z,57875092,10,Gui Santos,0,0,0,0,0,0
0,0,0,0,0,0,0,0,0,0,0,0,0,0,0,0,1038070,2024-01-04T00:00:00.000Z,398,10,Jerome Robinson,0,0,0,0,0,0
0,0,0,0,0,0,0,0,0,0,0,0,0,0,0,0,1038070,2024-01-04T00:00:00.000Z,45658838,10,Lester Quinones,0,0,0,0,0,0
0,0,0,0,0,0,0,0,0,0,0,0,0,0,0,0,1038070,2024-01-04T00:00:00.000Z,17553992,10,Moses Moody,0,0,0,0,0,0
0,0,0,0,0,0,0,0,0,0,0,0,0,0,0,0,1038070,2024-01-04T00:00:00.000Z,17896070,10,Usman Garuba,0,0,0,0,0,0
0,0,0,0,0,0,0,0,0,0,0,0,0,0,0,0,1038071,2024-01-05T00:00:00.000Z,219,2,Al Horford,0,0,0,0,0,0
1,0,1,1,0,2,1,4,3,6,0,1,5,1,0,0,1038071,2024-01-05T00:00:00.000Z,17896094,2,Dalano Banton,0,6,7,6,2,7.7
0,0,0,0,0,0,0,0,0,0,0,0,0,0,0,0,1038071,2024-01-05T00:00:00.000Z,38017707,2,JD Davison,0,0,0,0,0,0
0,0,0,0,0,0,0,0,0,0,0,0,0,0,0,0,1038071,2024-01-05T00:00:00.000Z,56677864,2,Jordan Walsh,0,0,0,0,0,0
0,1,4,1,0,4,2,0,0,12,1,1,4,5,1,1,1038071,2024-01-05T00:00:00.000Z,3547279,2,Lamar Stevens,2,9,9,4,5,15
0,1,3,0,0,3,1,0,0,11,4,1,2,7,1,1,1038071,2024-01-05T00:00:00.000Z,261,2,Luke Kornet,2,9,9,2,7,15.4
0,0,0,0,0,1,0,0,0,4,0,2,0,0,0,0,1038071,2024-01-05T00:00:00.000Z,17553967,2,Neemias Queta,0,0,0,0,0,0
2,0,2,2,0,5,2,2,2,17,1,3,6,3,2,0,1038071,2024-01-05T00:00:00.000Z,666468,2,Oshae Brissett,2,9,11,8,5,18.6
4,0,1,7,1,10,3,0,0,23,1,3,7,2,1,3,1038071,2024-01-05T00:00:00.000Z,3547276,2,Payton Pritchard,1,9,13,11,6,15.4
1,0,4,7,3,10,5,0,0,23,1,1,13,5,1,0,1038071,2024-01-05T00:00:00.000Z,17896060,2,Sam Hauser,1,18,19,14,6,23.5
0,0,3,6,1,7,1,0,0,15,0,2,3,3,0,0,1038071,2024-01-05T00:00:00.000Z,338,2,Svi Mykhailiuk,0,6,6,3,3,6.6
3,0,1,3,0,11,5,3,3,21,0,1,13,1,3,3,1038071,2024-01-05T00:00:00.000Z,413,29,Collin Sexton,3,14,17,16,4,24.7
2,1,11,1,0,9,5,3,2,22,0,5,12,11,0,2,1038071,2024-01-05T00:00:00.000Z,101,29,John Collins,1,23,25,14,13,29.2
2,0,1,2,0,7,1,0,0,17,1,0,2,2,1,4,1038071,2024-01-05T00:00:00.000Z,100,29,Jordan Clarkson,1,4,6,4,4,6.4
0,0,0,0,0,0,0,0,0,0,0,0,0,0,0,0,1038071,2024-01-05T00:00:00.000Z,17896023,29,Josh Christopher,0,0,0,0,0,0
1,0,1,1,0,2,0,8,6,14,0,3,6,1,1,0,1038071,2024-01-05T00:00:00.000Z,358,29,Kelly Olynyk,1,7,8,7,2,11.7
1,0,3,7,2,10,4,2,2,20,1,0,12,4,0,1,1038071,2024-01-05T00:00:00.000Z,56677834,29,Keyonte George,0,16,17,13,5,17.3
5,1,3,1,0,7,1,0,0,26,2,4,2,5,3,1,1038071,2024-01-05T00:00:00.000Z,139,29,Kris Dunn,4,7,12,7,10,26.5
5,0,1,7,2,16,7,2,1,23,4,1,17,5,0,0,1038071,2024-01-05T00:00:00.000Z,297,29,Lauri Markkanen,0,22,27,22,10,30.5
0,0,3,1,0,3,1,5,4,12,2,0,6,5,0,2,1038071,2024-01-05T00:00:00.000Z,666881,29,Luka Samanic,0,11,11,6,5,10
1,0,3,3,0,5,2,1,1,22,1,4,5,4,0,2,1038071,2024-01-05T00:00:00.000Z,38017620,29,Ochai Agbaji,0,9,10,6,5,9.3
0,0,4,2,0,4,0,2,0,12,3,1,0,7,0,1,1038071,2024-01-05T00:00:00.000Z,11891374,29,Omer Yurtseven,0,7,7,0,7,7.4
3,0,3,5,2,7,2,2,1,25,1,2,7,4,1,2,1038071,2024-01-05T00:00:00.000Z,38017739,29,Simone Fontecchio,1,11,14,10,7,17.3
0,0,1,1,0,10,4,6,3,12,0,1,11,1,2,0,1038071,2024-01-05T00:00:00.000Z,666650,29,Talen Horton-Tucker,2,12,12,11,1,18.2
0,0,6,0,0,3,2,0,0,14,1,2,4,7,0,0,1038071,2024-01-05T00:00:00.000Z,38017705,29,Walker Kessler,0,11,11,4,7,12.4
0,0,0,3,1,3,1,0,0,7,0,0,3,0,0,2,1038072,2024-01-05T00:00:00.000Z,38017689,1,AJ Griffin,0,3,3,3,0,1
0,1,2,0,0,2,2,2,2,7,0,1,6,2,0,0,1038072,2024-01-05T00:00:00.000Z,666564,1,Bruno Fernando,1,8,8,6,2,11.4
0,1,2,0,0,9,4,2,1,20,5,2,9,7,0,1,1038072,2024-01-05T00:00:00.000Z,83,1,Clint Capela,1,16,16,9,7,19.4
0,0,0,0,0,0,0,0,0,0,0,0,0,0,0,0,1038072,2024-01-05T00:00:00.000Z,666656,1,De'Andre Hunter,0,0,0,0,0,0
2,0,1,3,2,19,13,2,2,34,0,0,30,1,0,1,1038072,2024-01-05T00:00:00.000Z,334,1,Dejounte Murray,0,31,33,32,3,33.2
2,0,2,3,2,3,2,0,0,20,1,1,6,3,0,1,1038072,2024-01-05T00:00:00.000Z,666754,1,Garrison Mathews,0,9,11,8,5,11.6
0,0,0,0,0,0,0,0,0,0,0,0,0,0,0,0,1038072,2024-01-05T00:00:00.000Z,56677838,1,Kobe Bufkin,0,0,0,0,0,0
0,0,0,0,0,0,0,0,0,0,0,0,0,0,0,0,1038072,2024-01-05T00:00:00.000Z,56677806,1,Mouhamed Gueye,0,0,0,0,0,0
1,1,2,0,0,1,1,2,1,21,4,1,3,6,0,0,1038072,2024-01-05T00:00:00.000Z,3547244,1,Onyeka Okongwu,1,9,10,4,7,14.7
0,0,0,0,0,0,0,0,0,0,0,0,0,0,0,0,1038072,2024-01-05T00:00:00.000Z,319,1,Patty Mills,0,0,0,0,0,0
0,0,0,2,1,2,1,0,0,7,0,0,3,0,0,0,1038072,2024-01-05T00:00:00.000Z,56677855,1,Seth Lundy,0,3,3,3,0,3
6,0,2,11,1,18,4,5,4,28,0,2,13,2,2,3,1038072,2024-01-05T00:00:00.000Z,490,1,Trae Young,2,15,21,19,8,27.4
2,0,2,1,0,4,2,2,2,14,0,0,6,2,1,2,1038072,2024-01-05T00:00:00.000Z,3547297,1,Trent Forrest,1,8,10,8,4,12.4
0,0,0,0,0,0,0,0,0,0,0,0,0,0,0,0,1038072,2024-01-05T00:00:00.000Z,4197387,1,Vit Krejci,0,0,0,0,0,0
0,0,0,0,0,0,0,0,0,0,0,0,0,0,0,0,1038072,2024-01-05T00:00:00.000Z,301,1,Wesley Matthews,0,0,0,0,0,0
3,1,2,2,1,11,7,0,0,22,0,3,15,2,1,2,1038072,2024-01-05T00:00:00.000Z,3547250,12,Aaron Nesmith,2,17,20,18,5,25.9
2,0,2,3,1,7,5,0,0,23,0,2,11,2,0,0,1038072,2024-01-05T00:00:00.000Z,3547264,12,Jalen Smith,0,13,15,13,4,16.4
3,1,3,3,2,14,10,5,5,22,2,0,27,5,1,1,1038072,2024-01-05T00:00:00.000Z,452,12,Myles Turner,2,32,35,30,8,42.5
0,0,0,0,0,0,0,0,0,0,0,0,0,0,0,0,1038073,2024-01-05T00:00:00.000Z,9051997,3,Armoni Brooks,0,0,0,0,0,0
0,0,0,0,0,0,0,0,0,0,0,0,0,0,0,0,1038073,2024-01-05T00:00:00.000Z,417,3,Ben Simmons,0,0,0,0,0,0
0,0,0,0,0,0,0,0,0,0,0,0,0,0,0,0,1038073,2024-01-05T00:00:00.000Z,56677841,3,Dariq Whitehead,0,0,0,0,0,0
0,0,0,0,0,0,0,0,0,0,0,0,0,0,0,0,1038073,2024-01-05T00:00:00.000Z,174,3,Harry Giles III,0,0,0,0,0,0
0,0,0,0,0,0,0,0,0,0,0,0,0,0,0,0,1038073,2024-01-05T00:00:00.000Z,56677722,3,Jalen Wilson,0,0,0,0,0,0
0,0,0,0,0,0,0,0,0,0,0,0,0,0,0,0,1038073,2024-01-05T00:00:00.000Z,17896041,3,Keon Johnson,0,0,0,0,0,0
0,0,0,0,0,0,0,0,0,0,0,0,0,0,0,0,1038073,2024-01-05T00:00:00.000Z,56677843,3,Noah Clowney,0,0,0,0,0,0
0,0,0,0,0,0,0,0,0,0,0,0,0,0,0,0,1038073,2024-01-05T00:00:00.000Z,17896058,3,Trendon Watford,0,0,0,0,0,0
0,0,0,0,0,0,0,0,0,0,0,0,0,0,0,0,1038073,2024-01-05T00:00:00.000Z,3547271,21,Aleksej Pokusevski,0,0,0,0,0,0
3,1,3,4,0,15,8,2,1,35,3,3,17,6,1,1,1038073,2024-01-05T00:00:00.000Z,38017685,21,Chet Holmgren,2,23,26,20,9,33.7
0,0,0,1,0,1,0,0,0,1,0,0,0,0,0,0,1038073,2024-01-05T00:00:00.000Z,44,21,Davis Bertans,0,0,0,0,0,0
1,1,1,3,1,5,1,0,0,20,0,1,3,1,0,1,1038073,2024-01-05T00:00:00.000Z,3547272,21,Isaiah Joe,1,4,5,4,2,7.7
5,1,5,4,2,11,8,3,2,36,0,3,20,5,0,3,1038073,2024-01-05T00:00:00.000Z,38017703,21,Jalen Williams,1,25,30,25,10,33.5
5,1,8,1,0,9,5,4,3,24,0,3,13,8,1,2,1038073,2024-01-05T00:00:00.000Z,17896065,21,Josh Giddey,2,21,26,18,13,34.1
0,0,0,0,0,0,0,0,0,0,0,0,0,0,0,0,1038073,2024-01-05T00:00:00.000Z,56677853,21,Keyontae Johnson,0,0,0,0,0,0
3,0,2,5,2,8,5,0,0,28,2,4,12,4,3,1,1038073,2024-01-05T00:00:00.000Z,666541,21,Luguentz Dort,3,16,19,15,7,29.3
0,0,0,0,0,0,0,0,0,0,0,0,0,0,0,0,1038073,2024-01-05T00:00:00.000Z,24572055,21,Olivier Sarr,0,0,0,0,0,0
0,0,0,0,0,0,0,0,0,0,0,0,0,0,0,0,1038073,2024-01-05T00:00:00.000Z,38017716,21,Ousmane Dieng,0,0,0,0,0,0
6,0,8,5,2,19,11,15,10,36,1,5,34,9,0,2,1038073,2024-01-05T00:00:00.000Z,175,21,Shai Gilgeous-Alexander,0,43,49,40,15,51.8
0,0,0,0,0,0,0,0,0,0,0,0,0,0,0,0,1038073,2024-01-05T00:00:00.000Z,17896036,21,Tre Mann,0,0,0,0,0,0
3,1,0,1,0,4,3,0,0,12,0,0,6,0,1,0,1038073,2024-01-05T00:00:00.000Z,4197029,21,Vasilije Micic,2,6,9,9,3,16.5
11,0,4,2,1,7,3,4,4,27,0,0,11,4,2,2,1038074,2024-01-05T00:00:00.000Z,277,6,Caris LeVert,2,15,26,22,15,36.3
4,0,3,0,0,6,3,1,1,12,1,2,7,4,1,5,1038074,2024-01-05T00:00:00.000Z,56677872,6,Craig Porter,1,11,15,11,8,15.8
0,0,0,0,0,0,0,0,0,0,0,0,0,0,0,0,1038074,2024-01-05T00:00:00.000Z,666581,6,Darius Garland,0,0,0,0,0,0
1,0,5,3,2,4,2,0,0,22,0,0,6,5,1,0,1038074,2024-01-05T00:00:00.000Z,666940,6,Dean Wade,1,11,12,7,6,16.5
0,0,0,0,0,0,0,0,0,0,0,0,0,0,0,0,1038074,2024-01-05T00:00:00.000Z,56677847,6,Emoni Bates,0,0,0,0,0,0
0,0,0,0,0,0,0,0,0,0,0,0,0,0,0,0,1038074,2024-01-05T00:00:00.000Z,17896076,6,Evan Mobley,0,0,0,0,0,0
1,0,9,8,4,9,5,0,0,25,0,2,14,9,0,1,1038074,2024-01-05T00:00:00.000Z,344,6,Georges Niang,0,23,24,15,10,25.3
0,0,0,0,0,0,0,0,0,0,0,0,0,0,0,0,1038074,2024-01-05T00:00:00.000Z,38017662,6,Isaiah Mobley,0,0,0,0,0,0
0,0,0,0,0,0,0,0,0,0,0,0,0,0,0,0,1038074,2024-01-05T00:00:00.000Z,404,6,Ricky Rubio,0,0,0,0,0,0
2,0,2,9,3,12,4,0,0,26,0,2,11,2,1,0,1038074,2024-01-05T00:00:00.000Z,3547299,6,Sam Merrill,1,13,15,13,4,19.4
2,0,2,0,0,5,4,2,0,17,2,6,8,4,0,2,1038074,2024-01-05T00:00:00.000Z,444,6,Tristan Thompson,0,12,14,10,6,13.8
1,3,5,4,2,13,6,3,1,36,2,0,15,7,1,1,1038074,2024-01-05T00:00:00.000Z,56677844,30,Bilal Coulibaly,4,22,23,16,8,35.9
1,1,1,6,1,12,6,0,0,20,0,2,13,1,0,2,1038074,2024-01-05T00:00:00.000Z,17896045,30,Corey Kispert,1,14,15,14,2,16.7
2,0,2,3,1,6,3,0,0,17,0,0,7,2,5,1,1038074,2024-01-05T00:00:00.000Z,487,30,Delon Wright,5,9,11,9,4,26.4
4,1,5,1,0,8,5,4,3,26,0,4,13,5,2,3,1038074,2024-01-05T00:00:00.000Z,3547242,30,Deni Avdija,3,18,22,17,9,31
1,1,0,2,0,4,0,2,2,23,0,4,2,0,0,0,1038074,2024-01-05T00:00:00.000Z,666848,30,Jordan Poole,1,2,3,3,1,6.5
0,0,5,2,0,3,0,0,0,18,1,2,0,6,0,1,1038074,2024-01-05T00:00:00.000Z,337,30,Mike Muscala,0,6,6,0,6,6.2
5,0,1,6,4,10,6,0,0,26,0,0,16,1,2,1,1038074,2024-01-05T00:00:00.000Z,249,30,Tyus Jones,2,17,22,21,6,29.7
0,0,0,0,0,0,0,0,0,0,0,0,0,0,0,0,1038075,2024-01-05T00:00:00.000Z,666474,20,Charles Brown,0,0,0,0,0,0
3,0,1,6,4,6,4,2,2,17,1,4,14,2,1,2,1038075,2024-01-05T00:00:00.000Z,131,20,Donte DiVincenzo,1,16,19,17,5,21.9
0,0,0,0,0,0,0,0,0,0,0,0,0,0,0,0,1038075,2024-01-05T00:00:00.000Z,17896089,20,Duane Washington Jr.,0,0,0,0,0,0
0,0,0,0,0,0,0,0,0,0,0,0,0,0,0,0,1038075,2024-01-05T00:00:00.000Z,160,20,Evan Fournier,0,0,0,0,0,0
5,2,5,0,0,9,8,2,1,35,1,4,17,6,2,1,1038075,2024-01-05T00:00:00.000Z,201,20,Isaiah Hartenstein,4,23,28,22,11,42.7
0,0,0,0,0,0,0,0,0,0,0,0,0,0,0,0,1038075,2024-01-05T00:00:00.000Z,56677795,20,Jacob Toppin,0,0,0,0,0,0
2,1,3,9,4,20,11,3,3,32,0,1,29,3,1,0,1038075,2024-01-05T00:00:00.000Z,73,20,Jalen Brunson,2,32,34,31,5,41.6
0,0,0,0,0,0,0,0,0,2,0,0,0,0,0,0,1038075,2024-01-05T00:00:00.000Z,17896063,20,Jericho Sims,0,0,0,0,0,0
5,1,7,3,0,11,1,6,6,30,0,3,8,7,1,4,1038075,2024-01-05T00:00:00.000Z,387,20,Julius Randle,2,15,20,13,12,25.9
0,0,1,0,0,0,0,0,0,1,0,0,0,1,0,0,1038075,2024-01-05T00:00:00.000Z,3547275,20,Malachi Flynn,0,1,1,0,1,1.2
0,0,0,0,0,0,0,0,0,0,0,0,0,0,0,0,1038075,2024-01-05T00:00:00.000Z,399,20,Mitchell Robinson,0,0,0,0,0,0
0,0,1,3,1,11,3,4,4,37,1,3,11,2,1,0,1038075,2024-01-05T00:00:00.000Z,18,20,OG Anunoby,1,13,13,11,2,16.4
0,0,0,0,0,0,0,0,0,0,0,0,0,0,0,0,1038075,2024-01-05T00:00:00.000Z,173,20,Taj Gibson,0,0,0,0,0,0
0,0,0,0,0,0,0,0,0,0,0,0,0,0,0,0,1038075,2024-01-05T00:00:00.000Z,313,23,De'Anthony Melton,0,0,0,0,0,0
0,0,0,0,0,0,0,0,0,0,0,0,0,0,0,0,1038075,2024-01-05T00:00:00.000Z,260,23,Furkan Korkmaz,0,0,0,0,0,0
1,1,0,3,0,7,1,2,1,15,1,1,3,1,1,0,1038075,2024-01-05T00:00:00.000Z,17896025,23,Jaden Springer,2,4,5,4,2,11.7
3,3,7,1,1,23,10,12,9,36,3,3,30,10,1,6,1038075,2024-01-05T00:00:00.000Z,145,23,Joel Embiid,4,40,43,33,13,52.5
1,3,5,6,3,12,6,0,0,31,2,2,15,7,0,3,1038075,2024-01-05T00:00:00.000Z,360,23,Kelly Oubre Jr.,3,22,23,16,8,30.9
0,0,0,0,0,0,0,0,0,0,0,0,0,0,0,0,1038075,2024-01-05T00:00:00.000Z,38017732,23,Kenneth Lofton Jr.,0,0,0,0,0,0
0,0,0,0,0,0,0,0,0,7,0,2,0,0,0,0,1038075,2024-01-05T00:00:00.000Z,3547294,23,Kenyon Martin Jr.,0,0,0,0,0,0
1,0,2,0,0,1,1,0,0,5,0,0,2,2,2,0,1038075,2024-01-05T00:00:00.000Z,28,23,Mo Bamba,2,4,5,3,3,11.9
1,1,3,1,0,2,0,0,0,21,1,2,0,4,0,2,1038075,2024-01-05T00:00:00.000Z,33,23,Nicolas Batum,1,4,5,1,5,7.3
0,0,1,0,0,5,3,0,0,12,0,2,6,1,0,0,1038075,2024-01-05T00:00:00.000Z,3547270,23,Paul Reed,0,7,7,6,1,7.2
0,0,0,0,0,0,0,0,0,0,0,0,0,0,0,0,1038075,2024-01-05T00:00:00.000Z,56913527,23,Ricky Council IV,0,0,0,0,0,0
0,0,0,0,0,0,0,0,0,0,0,0,0,0,0,0,1038075,2024-01-05T00:00:00.000Z,108,23,Robert Covington,0,0,0,0,0,0
0,0,0,0,0,0,0,0,0,0,0,0,0,0,0,0,1038075,2024-01-05T00:00:00.000Z,56677788,23,Terquavion Smith,0,0,0,0,0,0
4,0,3,2,1,6,2,1,0,24,0,2,5,3,0,0,1038075,2024-01-05T00:00:00.000Z,200,23,Tobias Harris,0,8,12,9,7,14.6
9,1,3,7,1,20,9,10,8,37,1,1,27,4,2,1,1038075,2024-01-05T00:00:00.000Z,3547254,23,Tyrese Maxey,3,31,40,36,13,53.3
0,0,0,0,0,0,0,0,0,0,0,0,0,0,0,0,1038076,2024-01-05T00:00:00.000Z,56677848,4,Amari Bailey,0,0,0,0,0,0
1,0,3,7,1,13,3,2,2,23,0,3,9,3,1,0,1038076,2024-01-05T00:00:00.000Z,56677823,4,Brandon Miller,1,12,13,10,4,17.1
0,0,0,1,0,4,0,0,0,5,2,0,0,2,0,1,1038076,2024-01-05T00:00:00.000Z,38017708,4,Bryce McGowens,0,2,2,0,2,1.4
2,0,3,7,3,11,5,0,0,36,2,4,13,5,2,1,1038076,2024-01-05T00:00:00.000Z,666748,4,Cody Martin,2,18,20,15,7,27
0,0,0,0,0,0,0,0,0,0,0,0,0,0,0,0,1038076,2024-01-05T00:00:00.000Z,347,4,Frank Ntilikina,0,0,0,0,0,0
0,0,0,0,0,0,0,0,0,0,0,0,0,0,0,0,1038076,2024-01-05T00:00:00.000Z,204,4,Gordon Hayward,0,0,0,0,0,0
4,0,1,2,0,9,3,0,0,16,1,1,6,2,1,0,1038076,2024-01-05T00:00:00.000Z,422,4,Ish Smith,1,8,12,10,6,17.4
0,0,0,0,0,0,0,0,0,0,0,0,0,0,0,0,1038076,2024-01-05T00:00:00.000Z,17896037,4,James Bouknight,0,0,0,0,0,0
1,0,2,0,0,2,1,0,0,16,0,1,2,2,0,0,1038076,2024-01-05T00:00:00.000Z,18678001,4,JT Thor,0,4,5,3,3,5.9
0,0,0,0,0,0,0,0,0,0,0,0,0,0,0,0,1038076,2024-01-05T00:00:00.000Z,3547239,4,LaMelo Ball,0,0,0,0,0,0
0,0,0,0,0,0,0,0,0,0,0,0,0,0,0,0,1038076,2024-01-05T00:00:00.000Z,56677866,4,Leaky Black,0,0,0,0,0,0
0,0,0,0,0,0,0,0,0,0,0,0,0,0,0,0,1038076,2024-01-05T00:00:00.000Z,38017698,4,Mark Williams,0,0,0,0,0,0
2,0,5,7,3,18,12,2,1,42,0,1,28,5,0,2,1038076,2024-01-05T00:00:00.000Z,62,4,Miles Bridges,0,33,35,30,7,35
1,0,7,0,0,6,2,2,0,27,5,4,4,12,0,2,1038076,2024-01-05T00:00:00.000Z,3547282,4,Nick Richards,0,16,17,5,13,17.9
0,0,2,2,2,6,4,0,0,16,0,0,10,2,1,1,1038076,2024-01-05T00:00:00.000Z,56677846,4,Nick Smith Jr.,1,12,12,10,2,14.4
2,0,2,1,0,2,0,0,0,6,1,0,0,3,0,0,1038076,2024-01-05T00:00:00.000Z,666950,4,P.J. Washington,0,3,5,2,5,6.6
7,0,3,7,1,17,5,4,4,36,1,2,15,4,1,3,1038076,2024-01-05T00:00:00.000Z,403,4,Terry Rozier,1,19,26,22,11,30.3
0,0,0,0,0,0,0,0,0,0,0,0,0,0,0,0,1038076,2024-01-05T00:00:00.000Z,56677860,5,Adama Sanogo,0,0,0,0,0,0
0,0,0,0,0,0,0,0,0,0,0,0,0,0,0,0,1038076,2024-01-05T00:00:00.000Z,89,5,Alex Caruso,0,0,0,0,0,0
2,0,2,2,1,5,3,0,0,14,0,1,7,2,0,0,1038076,2024-01-05T00:00:00.000Z,87,5,Jevon Carter,0,9,11,9,4,12.4
0,0,0,0,0,0,0,0,0,0,0,0,0,0,0,0,1038076,2024-01-05T00:00:00.000Z,56677857,5,Julian Phillips,0,0,0,0,0,0
0,0,0,0,0,0,0,0,0,0,0,0,0,0,0,0,1038076,2024-01-05T00:00:00.000Z,3547248,5,Patrick Williams,0,0,0,0,0,0
0,1,0,1,0,3,2,1,1,9,0,2,5,0,0,1,1038076,2024-01-05T00:00:00.000Z,17896116,5,Terry Taylor,1,5,5,5,0,7
0,0,0,0,0,0,0,0,0,0,0,0,0,0,0,0,1038076,2024-01-05T00:00:00.000Z,110,5,Torrey Craig,0,0,0,0,0,0
2,0,2,1,1,3,2,0,0,19,0,0,5,2,0,0,1038077,2024-01-05T00:00:00.000Z,213,11,Aaron Holiday,0,7,9,7,4,10.4
1,0,4,1,0,17,8,3,3,33,1,3,19,5,0,2,1038077,2024-01-05T00:00:00.000Z,17896062,11,Alperen Sengun,0,24,25,20,6,24.5
1,0,5,2,0,9,2,3,2,20,1,3,6,6,3,2,1038077,2024-01-05T00:00:00.000Z,56677825,11,Amen Thompson,3,12,13,7,7,21.7
0,0,1,0,0,3,1,0,0,4,2,0,2,3,0,0,1038077,2024-01-05T00:00:00.000Z,296,11,Boban Marjanovic,0,5,5,2,3,5.6
0,0,2,4,1,10,4,2,2,15,0,1,11,2,2,4,1038077,2024-01-05T00:00:00.000Z,56677831,11,Cam Whitmore,2,13,13,11,2,15.4
0,0,0,0,0,0,0,0,0,0,0,0,0,0,0,0,1038077,2024-01-05T00:00:00.000Z,66,11,Dillon Brooks,0,0,0,0,0,0
8,1,1,5,2,9,2,1,1,31,0,0,7,1,1,1,1038077,2024-01-05T00:00:00.000Z,458,11,Fred VanVleet,2,8,16,15,9,25.2
2,0,8,5,3,13,6,2,1,32,1,3,16,9,0,4,1038077,2024-01-05T00:00:00.000Z,38017684,11,Jabari Smith Jr.,0,25,27,18,11,25.8
2,0,3,1,0,1,0,0,0,21,0,1,0,3,1,0,1038077,2024-01-05T00:00:00.000Z,3547301,11,Jae'Sean Tate,1,3,5,2,5,9.6
2,0,4,8,4,16,7,4,2,31,1,1,20,5,0,2,1038077,2024-01-05T00:00:00.000Z,17895966,11,Jalen Green,0,25,27,22,7,27
0,0,0,2,0,4,2,0,0,21,1,2,4,1,0,0,1038077,2024-01-05T00:00:00.000Z,188,11,Jeff Green,0,5,5,4,1,5.2
0,1,0,1,0,1,0,0,0,5,0,0,0,0,0,0,1038077,2024-01-05T00:00:00.000Z,19465326,11,Jock Landale,1,0,0,0,0,3
0,0,1,2,1,4,2,0,0,8,0,1,5,1,0,0,1038077,2024-01-05T00:00:00.000Z,75,11,Reggie Bullock,0,6,6,5,1,6.2
0,0,0,0,0,0,0,0,0,0,0,0,0,0,0,0,1038077,2024-01-05T00:00:00.000Z,17895968,18,Daishen Nix,0,0,0,0,0,0
0,0,0,0,0,0,0,0,0,0,0,0,0,0,0,0,1038077,2024-01-05T00:00:00.000Z,56677851,18,Jaylen Clark,0,0,0,0,0,0
0,0,0,0,0,0,0,2,2,3,0,0,2,0,0,0,1038077,2024-01-05T00:00:00.000Z,38017715,18,Josh Minott,0,2,2,2,0,2
0,0,0,0,0,0,0,0,0,0,0,0,0,0,0,0,1038077,2024-01-05T00:00:00.000Z,56677782,18,Leonard Miller,0,0,0,0,0,0
0,0,0,2,0,4,1,0,0,3,1,1,2,1,0,1,1038077,2024-01-05T00:00:00.000Z,17896056,18,Luka Garza,0,3,3,2,1,2.2
1,0,1,2,1,2,1,0,0,3,0,0,3,1,0,0,1038077,2024-01-05T00:00:00.000Z,68,18,Troy Brown Jr.,0,4,5,4,2,5.7
0,1,2,0,0,0,0,0,0,3,0,0,0,2,0,0,1038077,2024-01-05T00:00:00.000Z,38017700,18,Wendell Moore Jr.,1,2,2,0,2,5.4
0,0,2,2,0,4,2,0,0,21,1,1,4,3,1,2,1038078,2024-01-05T00:00:00.000Z,666511,13,Amir Coffey,1,7,7,4,3,8.6
1,1,1,0,0,3,1,0,0,7,1,1,2,2,0,1,1038078,2024-01-05T00:00:00.000Z,17896022,13,Brandon Boston Jr.,1,4,5,3,3,7.9
0,0,3,1,0,3,1,0,0,17,2,1,2,5,0,1,1038078,2024-01-05T00:00:00.000Z,439,13,Daniel Theis,0,7,7,2,5,7
2,2,8,0,0,7,6,4,3,23,0,3,15,8,0,1,1038078,2024-01-05T00:00:00.000Z,493,13,Ivica Zubac,2,23,25,17,10,32.6
13,0,3,6,1,7,2,3,3,29,0,2,8,3,0,1,1038078,2024-01-05T00:00:00.000Z,192,13,James Harden,0,11,24,21,16,30.1
0,0,0,0,0,0,0,0,0,0,0,0,0,0,0,0,1038078,2024-01-05T00:00:00.000Z,56677856,13,Jordan Miller,0,0,0,0,0,0
0,0,0,0,0,0,0,0,0,0,0,0,0,0,0,0,1038078,2024-01-05T00:00:00.000Z,17896051,13,Joshua Primo,0,0,0,0,0,0
2,1,7,4,2,15,7,4,3,30,2,1,19,9,1,2,1038078,2024-01-05T00:00:00.000Z,274,13,Kawhi Leonard,2,28,30,21,11,36.8
0,0,0,1,0,1,0,0,0,6,0,0,0,0,0,0,1038078,2024-01-05T00:00:00.000Z,56677849,13,Kobe Brown,0,0,0,0,0,0
0,0,1,0,0,2,2,5,4,7,1,1,8,2,0,0,1038078,2024-01-05T00:00:00.000Z,371,13,Mason Plumlee,0,10,10,8,2,10.4
0,0,0,0,0,0,0,0,0,0,0,0,0,0,0,0,1038078,2024-01-05T00:00:00.000Z,38017725,13,Moussa Diabate,0,0,0,0,0,0
1,0,0,0,0,3,0,0,0,6,0,1,0,0,0,0,1038078,2024-01-05T00:00:00.000Z,17896031,13,Nah'Shon Hyland,0,0,1,1,1,1.5
2,0,3,6,3,13,5,0,0,25,0,1,13,3,1,0,1038078,2024-01-05T00:00:00.000Z,380,13,Norman Powell,1,16,18,15,5,22.6
1,1,7,10,6,15,9,0,0,30,0,2,24,7,0,2,1038078,2024-01-05T00:00:00.000Z,172,13,Paul George,1,31,32,25,8,34.9
0,0,0,0,0,0,0,0,0,0,0,0,0,0,0,0,1038078,2024-01-05T00:00:00.000Z,450,13,PJ Tucker,0,0,0,0,0,0
5,2,3,3,1,6,3,2,1,22,2,2,8,5,2,4,1038078,2024-01-05T00:00:00.000Z,472,13,Russell Westbrook,4,13,18,13,10,29.5
1,0,2,3,2,3,2,2,2,17,1,2,8,3,1,0,1038078,2024-01-05T00:00:00.000Z,666743,13,Terance Mann,1,11,12,9,4,16.1
0,0,0,0,0,0,0,0,0,0,0,0,0,0,0,0,1038078,2024-01-05T00:00:00.000Z,24417679,13,Xavier Moon,0,0,0,0,0,0
2,0,2,1,0,1,0,2,1,7,1,3,1,3,0,0,1038078,2024-01-05T00:00:00.000Z,491,19,Cody Zeller,0,4,6,3,5,7.6
0,0,0,0,0,0,0,0,0,0,0,0,0,0,0,0,1038078,2024-01-05T00:00:00.000Z,38017726,19,Dereon Seabron,0,0,0,0,0,0
0,0,0,0,0,0,0,0,0,0,0,0,0,0,0,0,1038078,2024-01-05T00:00:00.000Z,38017663,19,E.J. Liddell,0,0,0,0,0,0
0,0,0,0,0,0,0,0,0,0,0,0,0,0,0,0,1038078,2024-01-05T00:00:00.000Z,17896021,19,Jeremiah Robinson-Earl,0,0,0,0,0,0
0,0,1,3,3,7,4,2,2,7,0,0,13,1,0,0,1038078,2024-01-05T00:00:00.000Z,56677837,19,Jordan Hawkins,0,14,14,13,1,14.2
0,0,0,0,0,0,0,0,0,0,0,0,0,0,0,0,1038078,2024-01-05T00:00:00.000Z,3547260,19,Kira Lewis Jr.,0,0,0,0,0,0
2,0,3,2,1,6,3,0,0,19,3,0,7,6,1,0,1038078,2024-01-05T00:00:00.000Z,340,19,Larry Nance Jr.,1,13,15,9,8,20.2
0,0,0,0,0,0,0,0,0,0,0,0,0,0,0,0,1038078,2024-01-05T00:00:00.000Z,17896017,19,Matt Ryan,0,0,0,0,0,0
1,0,0,1,1,9,4,0,0,17,3,2,9,3,1,2,1038078,2024-01-05T00:00:00.000Z,3547293,19,Naji Marshall,1,12,13,10,4,15.1
1,1,2,6,1,9,1,0,0,17,0,0,3,2,0,0,1038078,2024-01-05T00:00:00.000Z,18677986,19,Trey Murphy III,1,5,6,4,3,9.9
2,0,4,4,1,8,4,6,5,25,1,5,14,5,2,2,1038079,2024-01-05T00:00:00.000Z,17554004,7,AJ Lawson,2,19,21,16,7,27
2,1,0,1,1,3,2,3,2,10,0,0,7,0,0,1,1038079,2024-01-05T00:00:00.000Z,24489167,7,Brandon Williams,1,7,9,9,2,12
0,0,0,0,0,0,0,0,0,0,0,0,0,0,0,0,1038079,2024-01-05T00:00:00.000Z,151,7,Dante Exum,0,0,0,0,0,0
0,0,0,0,0,0,0,0,0,0,0,0,0,0,0,0,1038079,2024-01-05T00:00:00.000Z,56677840,7,Dereck Lively II,0,0,0,0,0,0
0,0,0,0,0,0,0,0,0,0,0,0,0,0,0,0,1038079,2024-01-05T00:00:00.000Z,666965,7,Grant Williams,0,0,0,0,0,0
1,3,1,2,1,5,3,0,0,12,1,2,7,2,0,2,1038079,2024-01-05T00:00:00.000Z,17896028,7,Greg Brown III,3,9,10,8,3,17.9
5,2,9,7,3,18,10,1,1,29,0,0,24,9,2,1,1038079,2024-01-05T00:00:00.000Z,228,7,Kyrie Irving,4,33,38,29,14,53.3
0,0,0,0,0,0,0,0,0,0,0,0,0,0,0,0,1038079,2024-01-05T00:00:00.000Z,132,7,Luka Doncic,0,0,0,0,0,0
0,0,0,0,0,0,0,0,0,0,0,0,0,0,0,0,1038079,2024-01-05T00:00:00.000Z,329,7,Markieff Morris,0,0,0,0,0,0
0,0,0,0,0,0,0,0,0,0,0,0,0,0,0,0,1038079,2024-01-05T00:00:00.000Z,257,7,Maxi Kleber,0,0,0,0,0,0
3,0,5,3,2,7,3,0,0,14,1,3,8,6,0,0,1038079,2024-01-05T00:00:00.000Z,56677859,7,Olivier-Maxence Prosper,0,14,17,11,9,19.7
0,0,0,0,0,0,0,0,0,0,0,0,0,0,0,0,1038079,2024-01-05T00:00:00.000Z,217,7,Richaun Holmes,0,0,0,0,0,0
1,0,1,4,1,9,4,0,0,20,1,2,9,2,0,0,1038079,2024-01-05T00:00:00.000Z,114,7,Seth Curry,0,11,12,10,3,12.9
4,1,2,7,3,14,8,1,0,27,0,3,19,2,1,1,1038079,2024-01-05T00:00:00.000Z,191,7,Tim Hardaway Jr.,2,21,25,23,6,32.4
4,0,5,4,1,8,1,3,3,23,0,1,6,5,0,2,1038079,2024-01-05T00:00:00.000Z,419,25,Anfernee Simons,0,11,15,10,9,16
0,0,0,0,0,0,0,0,0,0,0,0,0,0,0,0,1038079,2024-01-05T00:00:00.000Z,22,25,Deandre Ayton,0,0,0,0,0,0
2,0,3,3,1,12,7,2,1,27,4,3,16,7,0,3,1038079,2024-01-05T00:00:00.000Z,56783340,25,Duop Reath,0,23,25,18,9,24.4
1,0,2,0,0,1,0,0,0,18,0,3,0,2,0,1,1038079,2024-01-05T00:00:00.000Z,39613724,25,Ibou Badji,0,2,3,1,3,2.9
0,0,0,0,0,0,0,0,0,0,0,0,0,0,0,0,1038079,2024-01-05T00:00:00.000Z,17896120,25,Ish Wainright,0,0,0,0,0,0
0,0,0,0,0,0,0,0,0,0,0,0,0,0,0,0,1038079,2024-01-05T00:00:00.000Z,38017711,25,Jabari Walker,0,0,0,0,0,0
3,1,1,3,2,11,6,5,4,22,0,1,18,1,3,1,1038079,2024-01-05T00:00:00.000Z,182,25,Jerami Grant,4,19,22,21,4,34.7
0,0,0,0,0,0,0,0,0,0,0,0,0,0,0,0,1038079,2024-01-05T00:00:00.000Z,47957121,25,Justin Minaya,0,0,0,0,0,0
1,0,2,3,2,8,4,0,0,20,2,0,10,4,1,1,1038079,2024-01-05T00:00:00.000Z,56677791,25,Kris Murray,1,14,15,11,5,18.3
3,0,3,4,0,8,2,2,0,16,0,0,4,3,1,3,1038079,2024-01-05T00:00:00.000Z,65,25,Malcolm Brogdon,1,7,10,7,6,12.1
0,1,2,1,0,2,0,0,0,14,0,0,0,2,1,0,1038079,2024-01-05T00:00:00.000Z,666923,25,Matisse Thybulle,2,2,2,0,2,8.4
0,0,0,0,0,0,0,0,0,0,0,0,0,0,0,0,1038079,2024-01-05T00:00:00.000Z,666476,25,Moses Brown,0,0,0,0,0,0
0,0,2,2,1,5,3,0,0,19,1,3,7,3,0,2,1038079,2024-01-05T00:00:00.000Z,56677829,25,Rayan Rupert,0,10,10,7,3,8.6
0,0,0,0,0,0,0,0,0,0,0,0,0,0,0,0,1038079,2024-01-05T00:00:00.000Z,476,25,Robert Williams III,0,0,0,0,0,0
10,0,2,7,3,15,7,0,0,33,1,0,17,3,1,1,1038079,2024-01-05T00:00:00.000Z,56677747,25,Scoot Henderson,1,20,30,27,13,37.6
2,1,4,6,1,15,5,4,4,24,1,2,15,5,1,2,1038079,2024-01-05T00:00:00.000Z,38017690,25,Shaedon Sharpe,2,20,22,17,7,28
0,0,0,0,0,0,0,0,0,0,0,0,0,0,0,0,1038079,2024-01-05T00:00:00.000Z,3547289,25,Skylar Mays,0,0,0,0,0,0
1,0,6,7,2,10,4,1,0,24,1,2,10,7,1,2,1038079,2024-01-05T00:00:00.000Z,56677850,25,Toumani Camara,1,17,18,11,8,20.9
3,0,5,4,2,8,5,5,4,36,3,4,16,8,0,1,1038080,2024-01-05T00:00:00.000Z,177,8,Aaron Gordon,0,24,27,19,11,29.1
1,0,2,2,1,3,1,0,0,6,0,1,3,2,0,0,1038080,2024-01-05T00:00:00.000Z,17896007,8,Braxton Key,0,5,6,4,3,6.9
0,0,3,3,1,4,2,2,1,16,1,0,6,4,0,1,1038080,2024-01-05T00:00:00.000Z,38017709,8,Christian Braun,0,10,10,6,4,9.8
0,0,0,0,0,0,0,0,0,0,0,0,0,0,0,0,1038080,2024-01-05T00:00:00.000Z,38017727,8,Collin Gillespie,0,0,0,0,0,0
0,0,0,0,0,0,0,0,0,0,0,0,0,0,0,0,1038080,2024-01-05T00:00:00.000Z,250,8,DeAndre Jordan,0,0,0,0,0,0
0,0,0,0,0,0,0,0,0,0,0,0,0,0,0,0,1038080,2024-01-05T00:00:00.000Z,56677871,8,Hunter Tyson,0,0,0,0,0,0
0,0,0,0,0,0,0,0,0,0,0,0,0,0,0,0,1038080,2024-01-05T00:00:00.000Z,56677582,8,Jalen Pickett,0,0,0,0,0,0
9,0,6,6,0,23,9,2,2,34,1,3,20,7,1,3,1038080,2024-01-05T00:00:00.000Z,335,8,Jamal Murray,1,27,36,29,16,41.9
0,0,0,0,0,0,0,0,0,0,0,0,0,0,0,0,1038080,2024-01-05T00:00:00.000Z,17896103,8,Jay Huff,0,0,0,0,0,0
0,0,0,0,0,0,0,0,0,0,0,0,0,0,0,0,1038080,2024-01-05T00:00:00.000Z,56677776,8,Julian Strawther,0,0,0,0,0,0
1,0,1,1,0,1,0,0,0,10,0,1,0,1,0,0,1038080,2024-01-05T00:00:00.000Z,215,8,Justin Holiday,0,1,2,1,2,2.7
2,1,2,3,0,4,1,4,4,29,1,1,6,3,1,3,1038080,2024-01-05T00:00:00.000Z,81,8,Kentavious Caldwell-Pope,2,9,11,8,5,15.6
1,0,3,6,4,14,9,0,0,31,0,2,22,3,2,0,1038080,2024-01-05T00:00:00.000Z,375,8,Michael Porter Jr.,2,25,26,23,4,33.1
8,0,4,1,0,19,13,4,3,37,0,3,29,4,3,2,1038080,2024-01-05T00:00:00.000Z,246,8,Nikola Jokic,3,33,41,37,12,52.8
0,0,0,2,0,6,2,0,0,13,1,4,4,1,0,0,1038080,2024-01-05T00:00:00.000Z,38017721,8,Peyton Watson,0,5,5,4,1,5.2
3,0,2,5,1,12,5,0,0,17,1,0,11,3,0,1,1038080,2024-01-05T00:00:00.000Z,236,8,Reggie Jackson,0,14,17,14,6,18.1
0,0,0,0,0,0,0,0,0,0,0,0,0,0,0,0,1038080,2024-01-05T00:00:00.000Z,666489,8,Vlatko Cancar,0,0,0,0,0,0
0,0,1,0,0,1,1,2,1,11,1,4,3,2,1,2,1038080,2024-01-05T00:00:00.000Z,3547268,8,Zeke Nnaji,1,5,5,3,2,6.4
1,0,0,2,1,3,2,0,0,8,1,0,5,1,0,0,1038080,2024-01-05T00:00:00.000Z,666885,22,Admiral Schofield,0,6,7,6,2,7.7
1,0,0,0,0,1,0,0,0,5,0,1,0,0,0,0,1038080,2024-01-05T00:00:00.000Z,56677827,22,Anthony Black,0,0,1,1,1,1.5
1,0,0,5,2,6,3,2,0,24,0,3,8,0,0,0,1038080,2024-01-05T00:00:00.000Z,38017724,22,Caleb Houstan,0,8,9,9,1,9.5
1,1,4,3,1,3,1,2,0,28,3,1,3,7,1,4,1038080,2024-01-05T00:00:00.000Z,666818,22,Chuma Okeke,2,10,11,4,8,14.9
0,0,0,0,0,0,0,0,0,0,0,0,0,0,0,0,1038080,2024-01-05T00:00:00.000Z,17896026,22,Franz Wagner,0,0,0,0,0,0
0,0,0,0,0,0,0,0,0,0,0,0,0,0,0,0,1038080,2024-01-05T00:00:00.000Z,196,22,Gary Harris,0,0,0,0,0,0
0,0,0,0,0,0,0,0,0,0,0,0,0,0,0,0,1038080,2024-01-05T00:00:00.000Z,666442,22,Goga Bitadze,0,0,0,0,0,0
1,1,2,9,7,15,9,4,2,34,2,3,27,4,0,2,1038080,2024-01-05T00:00:00.000Z,17896073,22,Jalen Suggs,1,31,32,28,5,34.3
0,0,0,0,0,0,0,0,0,0,0,0,0,0,0,0,1038080,2024-01-05T00:00:00.000Z,56677839,22,Jett Howard,0,0,0,0,0,0
0,0,0,0,0,0,0,0,0,0,0,0,0,0,0,0,1038080,2024-01-05T00:00:00.000Z,226,22,Joe Ingles,0,0,0,0,0,0
0,0,0,0,0,0,0,0,0,0,0,0,0,0,0,0,1038080,2024-01-05T00:00:00.000Z,229,22,Jonathan Isaac,0,0,0,0,0,0
0,0,0,0,0,0,0,0,0,0,0,0,0,0,0,0,1038080,2024-01-05T00:00:00.000Z,38017607,22,Kevon Harris,0,0,0,0,0,0
0,0,0,0,0,0,0,0,0,0,0,0,0,0,0,0,1038080,2024-01-05T00:00:00.000Z,165,22,Markelle Fultz,0,0,0,0,0,0
3,0,8,4,2,14,8,2,1,38,3,4,19,11,2,0,1038080,2024-01-05T00:00:00.000Z,462,22,Moritz Wagner,2,30,33,22,14,42.7
11,0,9,4,1,21,8,19,15,41,1,2,32,10,3,5,1038080,2024-01-05T00:00:00.000Z,38017683,22,Paolo Banchero,3,42,53,43,21,64.5
2,1,4,1,0,4,2,1,1,31,1,4,5,5,2,0,1038080,2024-01-05T00:00:00.000Z,17553983,22,Trevelin Queen,3,10,12,7,7,23
0,0,0,0,0,0,0,0,0,0,0,0,0,0,0,0,1038080,2024-01-05T00:00:00.000Z,85,22,Wendell Carter Jr.,0,0,0,0,0,0
1,1,9,0,0,19,11,7,6,36,2,2,28,11,0,1,1038081,2024-01-05T00:00:00.000Z,4,16,Bam Adebayo,1,39,40,29,12,44.7
0,0,0,0,0,0,0,0,0,0,0,0,0,0,0,0,1038081,2024-01-05T00:00:00.000Z,666747,16,Caleb Martin,0,0,0,0,0,0
0,0,0,0,0,0,0,0,0,2,0,0,0,0,0,1,1038081,2024-01-05T00:00:00.000Z,38017736,16,Cole Swider,0,0,0,0,0,-1
0,0,0,0,0,0,0,0,0,0,0,0,0,0,0,0,1038081,2024-01-05T00:00:00.000Z,19465585,16,Dru Smith,0,0,0,0,0,0
3,1,1,6,1,7,1,2,1,27,0,3,4,1,1,3,1038081,2024-01-05T00:00:00.000Z,397,16,Duncan Robinson,2,5,8,7,4,12.7
0,0,0,0,0,0,0,0,0,0,0,0,0,0,0,0,1038081,2024-01-05T00:00:00.000Z,3092,16,Haywood Highsmith,0,0,0,0,0,0
0,0,0,1,1,5,2,2,2,5,2,0,7,2,0,0,1038081,2024-01-05T00:00:00.000Z,38017734,16,Jamal Cain,0,9,9,7,2,9.4
0,0,0,0,0,0,0,0,0,0,0,0,0,0,0,0,1038081,2024-01-05T00:00:00.000Z,79,16,Jimmy Butler,0,0,0,0,0,0
7,0,7,6,1,9,2,5,5,29,1,3,10,8,2,0,1038081,2024-01-05T00:00:00.000Z,391,16,Josh Richardson,2,18,25,17,15,36.1
2,0,4,6,3,9,6,6,5,20,3,4,20,7,0,2,1038081,2024-01-05T00:00:00.000Z,285,16,Kevin Love,0,27,29,22,9,29.4
4,0,2,6,2,7,2,0,0,23,1,2,6,3,0,4,1038081,2024-01-05T00:00:00.000Z,286,16,Kyle Lowry,0,9,13,10,7,11.6
1,0,3,3,1,3,1,0,0,24,1,0,3,4,0,0,1038081,2024-01-05T00:00:00.000Z,38017696,16,Nikola Jovic,0,7,8,4,5,9.3
0,0,0,0,0,0,0,0,0,0,0,0,0,0,0,0,1038081,2024-01-05T00:00:00.000Z,39398582,16,Orlando Robinson,0,0,0,0,0,0
1,0,0,0,0,0,0,0,0,2,0,1,0,0,0,0,1038081,2024-01-05T00:00:00.000Z,3547257,16,R.J. Hampton,0,0,1,1,1,1.5
0,0,2,0,0,0,0,0,0,2,0,0,0,2,0,0,1038081,2024-01-05T00:00:00.000Z,74,16,Thomas Bryant,0,2,2,0,2,2.4
6,0,4,7,1,17,4,0,0,35,0,2,9,4,0,1,1038081,2024-01-05T00:00:00.000Z,666633,16,Tyler Herro,0,13,19,15,10,21.8
1,1,2,0,0,2,2,1,0,10,1,1,4,3,0,0,1038081,2024-01-05T00:00:00.000Z,666451,24,Bol Bol,1,7,8,5,4,12.1
9,0,7,6,2,18,11,1,1,37,1,2,25,8,0,2,1038081,2024-01-05T00:00:00.000Z,37,24,Bradley Beal,0,33,42,34,17,46.1
0,0,2,0,0,3,3,1,1,17,0,0,7,2,2,2,1038081,2024-01-05T00:00:00.000Z,314,24,Chimezie Metu,2,9,9,7,2,13.4
0,0,0,0,0,0,0,0,0,0,0,0,0,0,0,0,1038081,2024-01-05T00:00:00.000Z,272,24,Damion Lee,0,0,0,0,0,0
10,0,5,7,2,19,9,0,0,35,0,2,20,5,2,3,1038081,2024-01-05T00:00:00.000Z,57,24,Devin Booker,2,25,35,30,15,44
0,0,4,1,1,8,4,4,2,22,2,1,11,6,1,0,1038081,2024-01-05T00:00:00.000Z,147,24,Drew Eubanks,1,17,17,11,6,21.2
0,0,0,0,0,0,0,0,0,0,0,0,0,0,0,0,1038081,2024-01-05T00:00:00.000Z,178,24,Eric Gordon,0,0,0,0,0,0
4,2,3,14,9,19,11,0,0,37,1,4,31,4,0,2,1038081,2024-01-05T00:00:00.000Z,8,24,Grayson Allen,2,35,39,35,8,45.8
0,0,0,1,0,1,0,0,0,2,0,0,0,0,0,0,1038081,2024-01-05T00:00:00.000Z,18678058,24,Jordan Goodwin,0,0,0,0,0,0
4,2,1,1,0,2,0,8,7,24,1,5,7,2,3,0,1038081,2024-01-05T00:00:00.000Z,356,24,Josh Okogie,5,9,13,11,6,30.4
2,0,8,1,0,6,3,0,0,26,1,2,6,9,1,0,1038081,2024-01-05T00:00:00.000Z,349,24,Jusuf Nurkic,1,15,17,8,11,22.8
0,0,3,3,0,6,0,0,0,19,1,1,0,4,3,0,1038081,2024-01-05T00:00:00.000Z,32,24,Keita Bates-Diop,3,4,4,0,4,13.8
0,0,0,0,0,0,0,0,0,0,0,0,0,0,0,0,1038081,2024-01-05T00:00:00.000Z,140,24,Kevin Durant,0,0,0,0,0,0
0,0,0,0,0,0,0,2,0,2,0,0,0,0,1,0,1038081,2024-01-05T00:00:00.000Z,3547298,24,Saben Lee,1,0,0,0,0,3
0,0,0,0,0,0,0,0,0,0,0,0,0,0,0,0,1038081,2024-01-05T00:00:00.000Z,3547095,24,Udoka Azubuike,0,0,0,0,0,0
0,0,0,1,0,3,1,0,0,9,1,0,2,1,0,0,1038081,2024-01-05T00:00:00.000Z,470,24,Yuta Watanabe,0,3,3,2,1,3.2
3,0,3,8,2,19,5,0,0,36,2,0,12,5,2,1,1038082,2024-01-05T00:00:00.000Z,54,9,Bojan Bogdanovic,2,17,20,15,8,27.5
1,0,1,2,1,3,2,0,0,22,0,2,5,1,1,0,1038082,2024-01-05T00:00:00.000Z,17896071,9,Isaiah Livers,1,6,7,6,2,10.7
0,0,0,0,0,0,0,0,0,0,0,0,0,0,0,0,1038082,2024-01-05T00:00:00.000Z,3547267,9,Isaiah Stewart,0,0,0,0,0,0
3,1,2,5,2,10,5,0,0,24,2,6,12,4,0,4,1038082,2024-01-05T00:00:00.000Z,38017682,9,Jaden Ivey,1,16,19,15,7,20.3
2,2,8,0,0,6,6,2,1,33,4,2,13,12,0,1,1038082,2024-01-05T00:00:00.000Z,38017694,9,Jalen Duren,2,25,27,15,14,35.4
0,0,0,0,0,0,0,0,0,0,0,0,0,0,0,0,1038082,2024-01-05T00:00:00.000Z,42097199,9,Jared Rhoden,0,0,0,0,0,0
0,0,0,0,0,0,0,0,0,0,0,0,0,0,0,0,1038082,2024-01-05T00:00:00.000Z,330,9,Monte Morris,0,0,0,0,0,0
0,0,0,0,0,0,0,0,0,0,0,0,0,0,0,0,1038082,2024-01-05T00:00:00.000Z,44477024,9,Stanley Umude,0,0,0,0,0,0
0,0,0,0,0,0,0,0,0,0,0,0,0,0,0,0,1038082,2024-01-05T00:00:00.000Z,57875092,10,Gui Santos,0,0,0,0,0,0
0,0,0,0,0,0,0,0,0,0,0,0,0,0,0,0,1038082,2024-01-05T00:00:00.000Z,45658838,10,Lester Quinones,0,0,0,0,0,0
0,0,0,0,0,0,0,0,0,0,0,0,0,0,0,0,1038083,2024-01-05T00:00:00.000Z,56677867,14,Alex Fudge,0,0,0,0,0,0
4,2,3,3,0,22,13,7,5,41,3,4,31,6,0,4,1038083,2024-01-05T00:00:00.000Z,117,14,Anthony Davis,2,37,41,35,10,46.2
12,0,7,3,0,14,8,4,3,40,0,4,19,7,2,1,1038083,2024-01-05T00:00:00.000Z,17553995,14,Austin Reaves,2,26,38,31,19,50.4
0,0,1,3,2,8,3,0,0,32,1,0,8,2,1,0,1038083,2024-01-05T00:00:00.000Z,666860,14,Cameron Reddish,1,10,10,8,2,13.4
0,0,5,2,1,5,3,4,4,16,0,0,11,5,1,1,1038083,2024-01-05T00:00:00.000Z,486,14,Christian Wood,1,16,16,11,5,19
0,0,0,0,0,0,0,0,0,0,0,0,0,0,0,0,1038083,2024-01-05T00:00:00.000Z,56677738,14,Colin Castleton,0,0,0,0,0,0
0,0,0,0,0,0,0,0,0,0,0,0,0,0,0,0,1038083,2024-01-05T00:00:00.000Z,405,14,D'Angelo Russell,0,0,0,0,0,0
0,0,0,0,0,0,0,0,0,0,0,0,0,0,0,0,1038083,2024-01-05T00:00:00.000Z,56677868,14,D'Moi Hodge,0,0,0,0,0,0
0,0,0,0,0,0,0,0,0,0,0,0,0,0,0,0,1038083,2024-01-05T00:00:00.000Z,1603383,14,Gabe Vincent,0,0,0,0,0,0
0,0,0,0,0,0,0,0,0,0,0,0,0,0,0,0,1038083,2024-01-05T00:00:00.000Z,56677835,14,Jalen Hood-Schifino,0,0,0,0,0,0
1,0,4,0,0,0,0,0,0,17,1,1,0,5,1,0,1038083,2024-01-05T00:00:00.000Z,457,14,Jarred Vanderbilt,1,5,6,1,6,10.5
0,0,0,0,0,0,0,0,0,0,0,0,0,0,0,0,1038083,2024-01-05T00:00:00.000Z,666626,14,Jaxson Hayes,0,0,0,0,0,0
7,0,3,9,4,24,11,10,6,39,2,0,32,5,5,4,1038083,2024-01-05T00:00:00.000Z,237,14,LeBron James,5,37,44,39,12,59.5
0,0,3,1,0,3,1,0,0,20,0,2,2,3,1,2,1038083,2024-01-05T00:00:00.000Z,38017697,14,Max Christie,1,5,5,2,3,6.6
0,0,0,0,0,0,0,0,0,0,0,0,0,0,0,0,1038083,2024-01-05T00:00:00.000Z,56677836,14,Maxwell Lewis,0,0,0,0,0,0
0,0,0,0,0,0,0,0,0,0,0,0,0,0,0,0,1038083,2024-01-05T00:00:00.000Z,666609,14,Rui Hachimura,0,0,0,0,0,0
2,1,1,7,3,9,3,2,1,35,1,3,10,2,2,1,1038083,2024-01-05T00:00:00.000Z,383,14,Taurean Prince,3,12,14,12,4,23.4
1,0,9,0,0,3,3,0,0,31,1,2,6,10,0,2,1038083,2024-01-05T00:00:00.000Z,48,15,Bismack Biyombo,0,16,17,7,11,17.5
0,0,0,0,0,0,0,0,0,0,0,0,0,0,0,0,1038083,2024-01-05T00:00:00.000Z,666505,15,Brandon Clarke,0,0,0,0,0,0
13,0,5,8,5,14,8,4,3,37,0,2,24,5,1,3,1038083,2024-01-05T00:00:00.000Z,3547287,15,Desmond Bane,1,29,42,37,18,49.5
0,0,0,0,0,0,0,0,0,0,0,0,0,0,0,0,1038083,2024-01-05T00:00:00.000Z,56677830,15,GG Jackson,0,0,0,0,0,0
7,1,5,7,3,17,7,5,4,35,2,3,21,7,1,2,1038083,2024-01-05T00:00:00.000Z,666786,15,Ja Morant,2,28,35,28,14,43.9
0,0,0,0,0,0,0,0,0,0,0,0,0,0,0,0,1038083,2024-01-05T00:00:00.000Z,48248287,15,Jacob Gilyard,0,0,0,0,0,0
0,0,0,0,0,0,0,0,0,0,0,0,0,0,0,0,1038083,2024-01-05T00:00:00.000Z,38017728,15,Jake LaRavia,0,0,0,0,0,0
1,3,9,6,5,14,11,4,4,30,0,5,31,9,0,3,1038083,2024-01-05T00:00:00.000Z,231,15,Jaren Jackson Jr.,3,40,41,32,10,49.3
4,0,2,3,0,4,0,0,0,20,1,0,0,3,1,0,1038083,2024-01-05T00:00:00.000Z,254,15,Luke Kennard,1,3,7,4,7,12.6
5,0,1,14,8,16,9,4,3,39,1,2,29,2,1,3,1038083,2024-01-05T00:00:00.000Z,420,15,Marcus Smart,1,31,36,34,7,38.9
0,0,0,0,0,0,0,0,0,9,0,0,0,0,1,1,1038083,2024-01-05T00:00:00.000Z,17896067,15,Santi Aldama,1,0,0,0,0,2
0,0,0,0,0,0,0,0,0,0,0,0,0,0,0,0,1038083,2024-01-05T00:00:00.000Z,3,15,Steven Adams,0,0,0,0,0,0
0,0,0,0,0,0,0,0,0,0,0,0,0,0,0,0,1038083,2024-01-05T00:00:00.000Z,38017731,15,Vince Williams Jr.,0,0,0,0,0,0
0,0,0,0,0,0,0,0,0,0,0,0,0,0,0,0,1038084,2024-01-05T00:00:00.000Z,4197162,26,Aleksandar Vezenkov,0,0,0,0,0,0
0,0,0,0,0,0,0,0,0,0,0,0,0,0,0,0,1038084,2024-01-05T00:00:00.000Z,273,26,Alex Len,0,0,0,0,0,0
1,0,0,3,2,6,4,0,0,16,0,2,10,0,0,1,1038084,2024-01-05T00:00:00.000Z,17896030,26,Chris Duarte,0,10,11,11,1,10.5
0,0,0,0,0,0,0,0,0,0,0,0,0,0,0,0,1038084,2024-01-05T00:00:00.000Z,56677845,26,Colby Jones,0,0,0,0,0,0
2,0,1,4,1,8,3,0,0,11,0,0,7,1,0,0,1038084,2024-01-05T00:00:00.000Z,17553994,26,Davion Mitchell,0,8,10,9,3,11.2
4,1,1,3,1,20,10,3,3,37,1,4,24,2,2,2,1038084,2024-01-05T00:00:00.000Z,161,26,De'Aaron Fox,3,26,30,28,6,39.4
11,0,11,0,0,16,11,3,2,39,4,6,24,15,0,6,1038084,2024-01-05T00:00:00.000Z,406,26,Domantas Sabonis,0,39,50,35,26,52.5
2,0,1,8,5,12,5,2,1,34,3,3,16,4,0,1,1038084,2024-01-05T00:00:00.000Z,30,26,Harrison Barnes,0,20,22,18,6,22.8
0,0,0,0,0,0,0,0,0,0,0,0,0,0,0,0,1038084,2024-01-05T00:00:00.000Z,56677862,26,Jalen Slawson,0,0,0,0,0,0
0,0,0,0,0,0,0,0,0,0,0,0,0,0,0,0,1038084,2024-01-05T00:00:00.000Z,17895990,26,Jordan Ford,0,0,0,0,0,0
0,0,0,0,0,0,0,0,0,0,0,0,0,0,0,0,1038084,2024-01-05T00:00:00.000Z,666925,26,Juan Toscano-Anderson,0,0,0,0,0,0
1,0,9,4,4,11,6,4,2,35,3,1,18,12,1,3,1038084,2024-01-05T00:00:00.000Z,38017688,26,Keegan Murray,1,30,31,19,13,33.9
0,0,0,0,0,0,0,0,0,0,0,0,0,0,0,0,1038084,2024-01-05T00:00:00.000Z,38017714,26,Keon Ellis,0,0,0,0,0,0
0,0,0,0,0,0,0,0,0,0,0,0,0,0,0,0,1038084,2024-01-05T00:00:00.000Z,17896044,26,Kessler Edwards,0,0,0,0,0,0
9,0,1,9,3,16,6,1,0,32,0,4,15,1,1,1,1038084,2024-01-05T00:00:00.000Z,324,26,Malik Monk,1,16,25,24,10,31.7
0,0,0,0,0,0,0,0,0,0,0,0,0,0,0,0,1038084,2024-01-05T00:00:00.000Z,38017710,28,Christian Koloko,0,0,0,0,0,0
0,0,0,0,0,0,0,0,0,0,0,0,0,0,0,0,1038084,2024-01-05T00:00:00.000Z,436,28,Garrett Temple,0,0,0,0,0,0
0,0,0,0,0,0,0,0,0,0,0,0,0,0,0,0,1038084,2024-01-05T00:00:00.000Z,3089,28,Gary Trent Jr.,0,0,0,0,0,0
0,0,0,0,0,0,0,0,0,0,0,0,0,0,0,0,1038084,2024-01-05T00:00:00.000Z,56677828,28,Gradey Dick,0,0,0,0,0,0
2,3,5,0,0,10,7,0,0,23,1,6,14,6,0,3,1038084,2024-01-05T00:00:00.000Z,373,28,Jakob Poeltl,3,20,22,16,8,30.2
0,0,0,0,0,0,0,0,0,0,0,0,0,0,0,0,1038084,2024-01-05T00:00:00.000Z,56677805,28,Javon Freeman-Liberty,0,0,0,0,0,0
0,0,0,0,0,0,0,0,0,0,0,0,0,0,0,0,1038084,2024-01-05T00:00:00.000Z,56677869,28,Markquis Nowell,0,0,0,0,0,0
0,0,0,0,0,0,0,0,0,0,0,0,0,0,0,0,1038084,2024-01-05T00:00:00.000Z,376,28,Otto Porter Jr.,0,0,0,0,0,0
9,1,3,0,0,11,6,7,6,37,1,3,18,4,2,2,1038084,2024-01-05T00:00:00.000Z,416,28,Pascal Siakam,3,22,31,27,13,43.3
2,1,3,4,2,8,4,4,4,27,1,2,14,4,0,0,1038084,2024-01-05T00:00:00.000Z,666423,28,RJ Barrett,1,18,20,16,6,24.8
0,0,0,0,0,0,0,0,0,0,0,0,0,0,0,0,1038084,2024-01-05T00:00:00.000Z,489,28,Thaddeus Young,0,0,0,0,0,0
8,3,6,5,2,8,4,2,0,30,1,1,10,7,1,2,1038085,2024-01-06T00:00:00.000Z,219,2,Al Horford,4,17,25,18,15,40.4
0,0,0,0,0,0,0,0,0,0,0,0,0,0,0,0,1038085,2024-01-06T00:00:00.000Z,38017707,2,JD Davison,0,0,0,0,0,0
0,0,0,0,0,0,0,0,0,0,0,0,0,0,0,0,1038085,2024-01-06T00:00:00.000Z,3547279,2,Lamar Stevens,0,0,0,0,0,0
3,0,1,0,0,2,1,2,2,16,3,1,4,4,1,1,1038085,2024-01-06T00:00:00.000Z,261,2,Luke Kornet,1,8,11,7,7,15.3
0,0,0,0,0,0,0,0,0,0,0,0,0,0,0,0,1038085,2024-01-06T00:00:00.000Z,17553967,2,Neemias Queta,0,0,0,0,0,0
0,0,2,3,1,5,2,0,0,15,0,0,5,2,1,0,1038085,2024-01-06T00:00:00.000Z,3547276,2,Payton Pritchard,1,7,7,5,2,10.4
0,0,0,0,0,0,0,0,0,1,0,0,0,0,0,0,1038085,2024-01-06T00:00:00.000Z,338,2,Svi Mykhailiuk,0,0,0,0,0,0
0,1,3,7,0,13,3,2,2,32,1,2,8,4,3,0,1038085,2024-01-06T00:00:00.000Z,3547250,12,Aaron Nesmith,4,12,12,8,4,24.8
0,0,0,0,0,0,0,0,0,0,0,0,0,0,0,0,1038085,2024-01-06T00:00:00.000Z,38017507,12,Andrew Nembhard,0,0,0,0,0,0
0,0,1,0,0,0,0,0,0,3,0,0,0,1,0,0,1038085,2024-01-06T00:00:00.000Z,56677861,12,Ben Sheppard,0,1,1,0,1,1.2
0,0,0,0,0,0,0,0,0,0,0,0,0,0,0,0,1038085,2024-01-06T00:00:00.000Z,69,12,Bruce Brown,0,0,0,0,0,0
3,0,2,10,3,16,6,0,0,31,0,3,15,2,0,0,1038085,2024-01-06T00:00:00.000Z,210,12,Buddy Hield,0,17,20,18,5,21.9
0,0,2,0,0,3,2,0,0,9,1,4,4,3,0,0,1038085,2024-01-06T00:00:00.000Z,17896035,12,Isaiah Jackson,0,7,7,4,3,7.6
0,0,0,0,0,0,0,0,0,0,0,0,0,0,0,0,1038085,2024-01-06T00:00:00.000Z,56677794,12,Isaiah Wong,0,0,0,0,0,0
2,0,6,4,1,6,2,2,2,26,1,2,7,7,0,0,1038085,2024-01-06T00:00:00.000Z,3547264,12,Jalen Smith,0,14,16,9,9,18.4
1,0,0,0,0,0,0,0,0,1,0,0,0,0,0,0,1038085,2024-01-06T00:00:00.000Z,56677832,12,Jarace Walker,0,0,1,1,1,1.5
0,0,0,0,0,0,0,0,0,1,0,0,0,0,0,0,1038085,2024-01-06T00:00:00.000Z,3547207,12,Jordan Nwora,0,0,0,0,0,0
0,0,0,0,0,0,0,0,0,1,0,0,0,0,0,0,1038085,2024-01-06T00:00:00.000Z,38017701,12,Kendall Brown,0,0,0,0,0,0
2,0,4,5,0,11,5,4,2,30,3,3,12,7,0,0,1038085,2024-01-06T00:00:00.000Z,452,12,Myles Turner,0,19,21,14,9,23.4
1,0,2,4,2,8,4,0,0,23,1,1,10,3,0,0,1038085,2024-01-06T00:00:00.000Z,3547243,12,Obi Toppin,0,13,14,11,4,15.1
0,0,0,0,0,1,1,0,0,1,0,0,2,0,0,0,1038085,2024-01-06T00:00:00.000Z,56677778,12,Oscar Tshiebwe,0,2,2,2,0,2
7,0,5,9,2,17,5,5,5,35,1,1,17,6,5,4,1038085,2024-01-06T00:00:00.000Z,3547245,12,Tyrese Haliburton,5,23,30,24,13,45.7
3,0,4,7,2,10,4,0,0,26,1,1,10,5,1,1,1038086,2024-01-06T00:00:00.000Z,131,20,Donte DiVincenzo,1,15,18,13,8,22.5
2,2,17,0,0,8,4,0,0,39,2,3,8,19,4,5,1038086,2024-01-06T00:00:00.000Z,201,20,Isaiah Hartenstein,6,27,29,10,21,46.8
5,0,4,8,3,23,13,13,10,38,3,2,39,7,1,2,1038086,2024-01-06T00:00:00.000Z,387,20,Julius Randle,1,46,51,44,12,55.9
2,0,3,3,1,7,4,0,0,31,2,3,9,5,1,1,1038086,2024-01-06T00:00:00.000Z,18,20,OG Anunoby,1,14,16,11,7,20
6,0,7,4,2,13,9,5,3,33,3,5,23,10,2,4,1038086,2024-01-06T00:00:00.000Z,3547242,30,Deni Avdija,2,33,39,29,16,46
2,1,2,10,4,21,10,4,3,32,0,3,27,2,0,3,1038086,2024-01-06T00:00:00.000Z,265,30,Kyle Kuzma,1,29,31,29,4,32.4
0,0,0,0,0,0,0,0,0,0,0,0,0,0,0,0,1038086,2024-01-06T00:00:00.000Z,414,30,Landry Shamet,0,0,0,0,0,0
0,0,0,0,0,0,0,0,0,0,0,0,0,0,0,0,1038086,2024-01-06T00:00:00.000Z,38017712,30,Ryan Rollins,0,0,0,0,0,0
0,0,0,0,0,0,0,0,0,0,0,0,0,0,0,0,1038087,2024-01-06T00:00:00.000Z,2175,23,Danuel House Jr.,0,0,0,0,0,0
0,0,0,0,0,0,0,0,0,0,0,0,0,0,0,0,1038087,2024-01-06T00:00:00.000Z,313,23,De'Anthony Melton,0,0,0,0,0,0
0,0,0,0,0,0,0,0,0,0,0,0,0,0,0,0,1038087,2024-01-06T00:00:00.000Z,260,23,Furkan Korkmaz,0,0,0,0,0,0
2,0,1,3,0,3,0,0,0,13,1,1,0,2,0,0,1038087,2024-01-06T00:00:00.000Z,17896025,23,Jaden Springer,0,2,4,2,4,5.4
0,0,0,0,0,0,0,0,0,0,0,0,0,0,0,0,1038087,2024-01-06T00:00:00.000Z,145,23,Joel Embiid,0,0,0,0,0,0
0,0,0,0,0,0,0,0,0,0,0,0,0,0,0,0,1038087,2024-01-06T00:00:00.000Z,38017732,23,Kenneth Lofton Jr.,0,0,0,0,0,0
1,0,1,1,0,7,4,2,1,17,1,4,9,2,1,0,1038087,2024-01-06T00:00:00.000Z,3547294,23,Kenyon Martin Jr.,1,11,12,10,3,15.9
0,0,0,0,0,0,0,0,0,0,0,0,0,0,0,0,1038087,2024-01-06T00:00:00.000Z,56913527,23,Ricky Council IV,0,0,0,0,0,0
0,0,0,0,0,0,0,0,0,0,0,0,0,0,0,0,1038087,2024-01-06T00:00:00.000Z,108,23,Robert Covington,0,0,0,0,0,0
0,0,0,0,0,0,0,0,0,0,0,0,0,0,0,0,1038087,2024-01-06T00:00:00.000Z,56677788,23,Terquavion Smith,0,0,0,0,0,0
0,0,0,0,0,0,0,0,0,0,0,0,0,0,0,0,1038087,2024-01-06T00:00:00.000Z,200,23,Tobias Harris,0,0,0,0,0,0
0,0,0,0,0,0,0,0,0,0,0,0,0,0,0,0,1038087,2024-01-06T00:00:00.000Z,56677842,29,Brice Sensabaugh,0,0,0,0,0,0
10,0,2,3,1,14,9,4,3,27,1,3,22,3,0,5,1038087,2024-01-06T00:00:00.000Z,413,29,Collin Sexton,0,25,35,32,13,35.6
2,1,4,0,0,10,9,2,1,28,1,1,19,5,0,1,1038087,2024-01-06T00:00:00.000Z,101,29,John Collins,1,24,26,21,7,30
0,0,0,0,0,0,0,0,0,0,0,0,0,0,0,0,1038087,2024-01-06T00:00:00.000Z,38017630,29,Johnny Juzang,0,0,0,0,0,0
6,0,5,6,0,14,5,9,8,31,0,0,18,5,1,5,1038087,2024-01-06T00:00:00.000Z,100,29,Jordan Clarkson,1,23,29,24,11,31
0,0,0,0,0,0,0,0,0,0,0,0,0,0,0,0,1038087,2024-01-06T00:00:00.000Z,17896023,29,Josh Christopher,0,0,0,0,0,0
4,0,1,1,1,3,2,0,0,15,0,3,5,1,0,3,1038087,2024-01-06T00:00:00.000Z,358,29,Kelly Olynyk,0,6,10,9,5,9.2
3,0,2,2,0,4,2,2,2,16,0,2,6,2,0,2,1038087,2024-01-06T00:00:00.000Z,56677834,29,Keyonte George,0,8,11,9,5,10.9
1,2,5,1,0,1,0,0,0,23,0,3,0,5,1,1,1038087,2024-01-06T00:00:00.000Z,139,29,Kris Dunn,3,5,6,1,6,15.5
1,1,9,9,5,19,12,5,4,35,4,2,33,13,0,1,1038087,2024-01-06T00:00:00.000Z,297,29,Lauri Markkanen,1,46,47,34,14,52.1
0,0,0,0,0,0,0,0,0,0,0,0,0,0,0,0,1038087,2024-01-06T00:00:00.000Z,666881,29,Luka Samanic,0,0,0,0,0,0
0,0,0,0,0,0,0,0,0,0,0,0,0,0,0,0,1038087,2024-01-06T00:00:00.000Z,19465584,29,Micah Potter,0,0,0,0,0,0
1,0,2,2,0,2,0,0,0,13,1,1,0,3,0,1,1038087,2024-01-06T00:00:00.000Z,38017620,29,Ochai Agbaji,0,3,4,1,4,4.1
0,0,0,0,0,0,0,0,0,0,0,0,0,0,0,0,1038087,2024-01-06T00:00:00.000Z,11891374,29,Omer Yurtseven,0,0,0,0,0,0
2,0,6,6,1,9,3,0,0,33,1,1,7,7,1,4,1038087,2024-01-06T00:00:00.000Z,38017739,29,Simone Fontecchio,1,14,16,9,9,17.4
0,0,0,0,0,0,0,0,0,0,0,0,0,0,0,0,1038087,2024-01-06T00:00:00.000Z,666650,29,Talen Horton-Tucker,0,0,0,0,0,0
0,0,0,0,0,0,0,0,0,0,0,0,0,0,0,0,1038087,2024-01-06T00:00:00.000Z,56677824,29,Taylor Hendricks,0,0,0,0,0,0
0,0,3,0,0,4,4,2,2,19,1,2,10,4,1,0,1038087,2024-01-06T00:00:00.000Z,38017705,29,Walker Kessler,1,14,14,10,4,17.8
0,0,1,5,3,7,4,0,0,21,0,1,11,1,0,2,1038088,2024-01-06T00:00:00.000Z,213,11,Aaron Holiday,0,12,12,11,1,10.2
4,0,10,1,0,21,7,10,7,31,1,5,21,11,0,3,1038088,2024-01-06T00:00:00.000Z,17896062,11,Alperen Sengun,0,32,36,25,15,37.2
0,0,0,0,0,0,0,0,0,0,0,0,0,0,0,0,1038088,2024-01-06T00:00:00.000Z,296,11,Boban Marjanovic,0,0,0,0,0,0
0,0,3,1,1,6,4,3,3,13,0,0,12,3,1,0,1038088,2024-01-06T00:00:00.000Z,56677831,11,Cam Whitmore,1,15,15,12,3,18.6
0,0,0,0,0,0,0,0,0,0,0,0,0,0,0,0,1038088,2024-01-06T00:00:00.000Z,66,11,Dillon Brooks,0,0,0,0,0,0
7,0,1,10,3,13,4,3,3,37,1,3,14,2,2,1,1038088,2024-01-06T00:00:00.000Z,458,11,Fred VanVleet,2,16,23,21,9,31.9
2,1,11,5,3,7,3,6,5,40,1,4,14,12,2,1,1038088,2024-01-06T00:00:00.000Z,38017684,11,Jabari Smith Jr.,3,26,28,16,14,39.4
0,0,5,0,0,3,2,0,0,20,3,4,4,8,1,0,1038088,2024-01-06T00:00:00.000Z,3547301,11,Jae'Sean Tate,1,12,12,4,8,16.6
2,0,4,6,1,12,5,5,5,28,0,1,16,4,1,1,1038088,2024-01-06T00:00:00.000Z,17895966,11,Jalen Green,1,20,22,18,6,25.8
0,0,0,0,0,0,0,0,0,0,0,0,0,0,0,0,1038088,2024-01-06T00:00:00.000Z,47738533,11,Jeenathan Williams,0,0,0,0,0,0
2,1,2,5,2,11,5,5,4,34,0,4,16,2,0,1,1038088,2024-01-06T00:00:00.000Z,188,11,Jeff Green,1,18,20,18,4,23.4
0,0,0,0,0,0,0,0,0,0,0,0,0,0,0,0,1038088,2024-01-06T00:00:00.000Z,56677809,11,Jermaine Samuels Jr.,0,0,0,0,0,0
0,0,0,0,0,0,0,0,0,0,0,0,0,0,0,0,1038088,2024-01-06T00:00:00.000Z,19465326,11,Jock Landale,0,0,0,0,0,0
0,0,0,0,0,0,0,0,0,0,0,0,0,0,0,0,1038088,2024-01-06T00:00:00.000Z,3547281,11,Nate Hinton,0,0,0,0,0,0
0,0,0,0,0,0,0,0,0,0,0,0,0,0,0,0,1038088,2024-01-06T00:00:00.000Z,75,11,Reggie Bullock,0,0,0,0,0,0
0,0,0,0,0,0,0,0,0,0,0,0,0,0,0,0,1038088,2024-01-06T00:00:00.000Z,38017695,11,Tari Eason,0,0,0,0,0,0
0,0,0,0,0,0,0,0,0,0,0,0,0,0,0,0,1038088,2024-01-06T00:00:00.000Z,357,11,Victor Oladipo,0,0,0,0,0,0
0,0,0,0,0,0,0,0,0,3,0,1,0,0,0,0,1038088,2024-01-06T00:00:00.000Z,38017733,17,A.J. Green,0,0,0,0,0,0
0,0,2,1,0,1,0,1,1,12,0,3,1,2,2,0,1038088,2024-01-06T00:00:00.000Z,56677852,17,Andre Jackson Jr.,2,3,3,1,2,9.4
0,1,6,2,1,5,2,2,1,17,0,5,6,6,1,2,1038088,2024-01-06T00:00:00.000Z,377,17,Bobby Portis,2,12,12,6,6,17.2
0,1,5,6,1,9,3,0,0,31,0,2,7,5,1,0,1038088,2024-01-06T00:00:00.000Z,283,17,Brook Lopez,2,12,12,7,5,19
1,0,0,1,0,1,0,2,1,8,0,0,1,0,0,0,1038088,2024-01-06T00:00:00.000Z,368,17,Cameron Payne,0,1,2,2,1,2.5
0,0,0,0,0,0,0,0,0,0,0,0,0,0,0,0,1038088,2024-01-06T00:00:00.000Z,56677854,17,Chris Livingston,0,0,0,0,0,0
9,0,2,8,1,16,5,10,7,39,0,1,18,2,2,1,1038088,2024-01-06T00:00:00.000Z,278,17,Damian Lillard,2,20,29,27,11,38.9
2,1,14,2,1,25,16,21,15,39,3,4,48,17,0,2,1038088,2024-01-06T00:00:00.000Z,15,17,Giannis Antetokounmpo,1,65,67,50,19,72.4
0,0,0,0,0,0,0,0,0,0,0,0,0,0,0,0,1038088,2024-01-06T00:00:00.000Z,112,17,Jae Crowder,0,0,0,0,0,0
5,0,3,5,0,9,3,6,4,33,0,5,10,3,1,3,1038088,2024-01-06T00:00:00.000Z,315,17,Khris Middleton,1,13,18,15,8,21.1
0,0,0,0,0,0,0,0,0,0,0,0,0,0,0,0,1038088,2024-01-06T00:00:00.000Z,666960,17,Lindell Wigginton,0,0,0,0,0,0
0,0,1,1,1,1,1,0,0,16,0,2,3,1,0,2,1038088,2024-01-06T00:00:00.000Z,38,17,Malik Beasley,0,4,4,3,1,2.2
3,1,3,3,1,4,2,0,0,23,1,1,5,4,0,1,1038088,2024-01-06T00:00:00.000Z,38017676,17,MarJon Beauchamp,1,9,12,8,7,16.3
0,0,0,0,0,0,0,0,0,0,0,0,0,0,0,0,1038088,2024-01-06T00:00:00.000Z,666453,17,Marques Bolden,0,0,0,0,0,0
1,0,1,5,3,5,3,0,0,19,0,0,9,1,0,0,1038088,2024-01-06T00:00:00.000Z,105,17,Pat Connaughton,0,10,11,10,2,11.7
0,0,0,0,0,0,0,0,0,0,0,0,0,0,0,0,1038088,2024-01-06T00:00:00.000Z,2148,17,Thanasis Antetokounmpo,0,0,0,0,0,0
0,0,0,0,0,0,0,0,0,0,0,0,0,0,0,0,1038088,2024-01-06T00:00:00.000Z,38017691,17,TyTy Washington Jr.,0,0,0,0,0,0
3,0,2,5,4,13,9,3,1,26,0,2,23,2,2,4,1038089,2024-01-07T00:00:00.000Z,277,6,Caris LeVert,2,25,28,26,5,31.9
1,1,1,0,0,0,0,0,0,4,0,0,0,1,0,0,1038089,2024-01-07T00:00:00.000Z,56677872,6,Craig Porter,1,1,2,1,2,5.7
0,0,0,0,0,0,0,0,0,0,0,0,0,0,0,0,1038089,2024-01-07T00:00:00.000Z,248,6,Damian Jones,0,0,0,0,0,0
0,0,0,0,0,0,0,0,0,0,0,0,0,0,0,0,1038089,2024-01-07T00:00:00.000Z,666581,6,Darius Garland,0,0,0,0,0,0
1,0,2,2,0,3,0,0,0,11,0,2,0,2,0,1,1038089,2024-01-07T00:00:00.000Z,666940,6,Dean Wade,0,2,3,1,3,2.9
9,0,2,10,1,18,7,4,2,37,0,1,17,2,1,4,1038089,2024-01-07T00:00:00.000Z,322,6,Donovan Mitchell,1,19,28,26,11,31.9
0,0,0,0,0,0,0,0,0,0,0,0,0,0,0,0,1038089,2024-01-07T00:00:00.000Z,56677847,6,Emoni Bates,0,0,0,0,0,0
0,0,0,0,0,0,0,0,0,0,0,0,0,0,0,0,1038089,2024-01-07T00:00:00.000Z,17896076,6,Evan Mobley,0,0,0,0,0,0
1,1,4,6,3,7,4,0,0,27,0,2,11,4,0,1,1038089,2024-01-07T00:00:00.000Z,344,6,Georges Niang,1,15,16,12,5,19.3
1,0,1,2,1,2,1,0,0,27,4,0,3,5,0,2,1038089,2024-01-07T00:00:00.000Z,3547247,6,Isaac Okoro,0,8,9,4,6,8.5
0,0,0,0,0,0,0,0,0,0,0,0,0,0,0,0,1038089,2024-01-07T00:00:00.000Z,38017662,6,Isaiah Mobley,0,0,0,0,0,0
2,1,11,0,0,19,11,7,7,31,5,3,29,16,1,1,1038089,2024-01-07T00:00:00.000Z,9,6,Jarrett Allen,2,45,47,31,18,56.2
4,0,4,9,2,11,3,0,0,37,1,2,8,5,2,2,1038089,2024-01-07T00:00:00.000Z,666908,6,Max Strus,2,13,17,12,9,24
3,0,3,9,5,11,5,3,3,23,0,0,18,3,0,0,1038089,2024-01-07T00:00:00.000Z,3547299,6,Sam Merrill,0,21,24,21,6,26.1
2,0,2,0,0,4,3,4,2,17,2,4,8,4,0,1,1038089,2024-01-07T00:00:00.000Z,444,6,Tristan Thompson,0,12,14,10,6,14.8
0,0,0,0,0,0,0,0,0,0,0,0,0,0,0,0,1038089,2024-01-07T00:00:00.000Z,666676,6,Ty Jerome,0,0,0,0,0,0
0,0,2,1,0,2,1,2,1,11,0,1,3,2,0,2,1038089,2024-01-07T00:00:00.000Z,38017693,27,Blake Wesley,0,5,5,3,2,3.4
1,0,4,4,1,7,4,0,0,21,2,1,9,6,1,0,1038089,2024-01-07T00:00:00.000Z,359,27,Cedi Osman,1,15,16,10,7,20.7
0,0,0,0,0,0,0,0,0,0,0,0,0,0,0,0,1038089,2024-01-07T00:00:00.000Z,17895854,27,Charles Bassey,0,0,0,0,0,0
0,0,0,0,0,0,0,0,0,0,0,0,0,0,0,0,1038089,2024-01-07T00:00:00.000Z,17896049,27,David Duke Jr.,0,0,0,0,0,0
2,0,3,9,4,19,9,0,0,35,0,2,22,3,3,0,1038089,2024-01-07T00:00:00.000Z,3547246,27,Devin Vassell,3,25,27,24,5,37.6
0,0,0,0,0,0,0,0,0,0,0,0,0,0,0,0,1038089,2024-01-07T00:00:00.000Z,180,27,Devonte' Graham,0,0,0,0,0,0
2,1,4,0,0,5,3,0,0,22,2,3,6,6,1,1,1038089,2024-01-07T00:00:00.000Z,38017730,27,Dominick Barlow,2,12,14,8,8,21.2
0,0,0,0,0,0,0,0,0,0,0,0,0,0,0,0,1038089,2024-01-07T00:00:00.000Z,305,27,Doug McDermott,0,0,0,0,0,0
4,0,4,5,2,9,4,1,1,28,1,2,11,5,0,1,1038089,2024-01-07T00:00:00.000Z,38017699,27,Jeremy Sochan,0,16,20,15,9,22
1,0,2,2,0,2,0,2,2,16,0,0,2,2,1,1,1038089,2024-01-07T00:00:00.000Z,38017649,27,Julian Champagnie,1,4,5,3,3,7.9
2,0,1,6,3,16,6,4,3,33,3,3,18,4,1,0,1038089,2024-01-07T00:00:00.000Z,666682,27,Keldon Johnson,1,22,24,20,6,28.8
2,0,1,3,0,5,1,0,0,15,0,2,2,1,0,1,1038089,2024-01-07T00:00:00.000Z,38017692,27,Malaki Branham,0,3,5,4,3,5.2
0,0,0,0,0,0,0,0,0,0,0,0,0,0,0,0,1038089,2024-01-07T00:00:00.000Z,3547163,27,Mamadi Diakite,0,0,0,0,0,0
0,0,0,0,0,0,0,0,0,0,0,0,0,0,0,0,1038089,2024-01-07T00:00:00.000Z,17896059,27,Sandro Mamukelashvili,0,0,0,0,0,0
0,0,0,0,0,0,0,0,0,0,0,0,0,0,0,0,1038089,2024-01-07T00:00:00.000Z,56677817,27,Sidy Cissoko,0,0,0,0,0,0
5,0,2,2,2,8,7,2,2,34,0,1,18,2,2,2,1038089,2024-01-07T00:00:00.000Z,3547274,27,Tre Jones,2,20,25,23,7,31.9
3,5,9,5,2,13,6,11,10,25,0,3,24,9,1,3,1038089,2024-01-07T00:00:00.000Z,56677822,27,Victor Wembanyama,6,33,36,27,12,54.3
0,0,0,0,0,0,0,0,0,0,0,0,0,0,0,0,1038089,2024-01-07T00:00:00.000Z,102,27,Zach Collins,0,0,0,0,0,0
0,0,0,0,0,0,0,0,0,0,0,0,0,0,0,0,1038090,2024-01-07T00:00:00.000Z,417,3,Ben Simmons,0,0,0,0,0,0
0,0,0,0,0,0,0,0,0,0,0,0,0,0,0,0,1038090,2024-01-07T00:00:00.000Z,56677841,3,Dariq Whitehead,0,0,0,0,0,0
2,1,3,0,0,7,4,4,3,17,3,3,11,6,0,0,1038090,2024-01-07T00:00:00.000Z,17896038,3,Day'Ron Sharpe,1,17,19,13,8,24.2
10,1,2,1,0,8,3,4,4,29,0,6,10,2,2,1,1038090,2024-01-07T00:00:00.000Z,421,3,Dennis Smith Jr.,3,12,22,20,12,35.4
0,0,0,0,0,0,0,0,0,0,0,0,0,0,0,0,1038090,2024-01-07T00:00:00.000Z,174,3,Harry Giles III,0,0,0,0,0,0
0,0,0,0,0,0,0,0,0,0,0,0,0,0,0,0,1038090,2024-01-07T00:00:00.000Z,56677722,3,Jalen Wilson,0,0,0,0,0,0
0,0,0,0,0,0,0,0,0,0,0,0,0,0,0,0,1038090,2024-01-07T00:00:00.000Z,17896041,3,Keon Johnson,0,0,0,0,0,0
0,0,1,2,0,3,0,0,0,6,0,2,0,1,0,0,1038090,2024-01-07T00:00:00.000Z,464,3,Lonnie Walker IV,0,1,1,0,1,1.2
3,0,4,8,4,26,15,8,8,44,0,0,42,4,0,3,1038090,2024-01-07T00:00:00.000Z,61,3,Mikal Bridges,0,46,49,45,7,48.3
0,0,0,0,0,0,0,0,0,0,0,0,0,0,0,0,1038090,2024-01-07T00:00:00.000Z,56677843,3,Noah Clowney,0,0,0,0,0,0
0,0,0,0,0,0,0,0,0,1,0,0,0,0,0,1,1038090,2024-01-07T00:00:00.000Z,17896058,3,Trendon Watford,0,0,0,0,0,-1
11,0,4,10,5,25,13,8,7,45,0,2,38,4,0,2,1038090,2024-01-07T00:00:00.000Z,419,25,Anfernee Simons,0,42,53,49,15,57.3
0,0,0,0,0,0,0,0,0,0,0,0,0,0,0,0,1038090,2024-01-07T00:00:00.000Z,22,25,Deandre Ayton,0,0,0,0,0,0
1,3,10,4,3,10,5,3,2,41,3,4,15,13,1,1,1038090,2024-01-07T00:00:00.000Z,56783340,25,Duop Reath,4,28,29,16,14,43.1
0,0,1,0,0,0,0,0,0,9,2,3,0,3,0,0,1038090,2024-01-07T00:00:00.000Z,39613724,25,Ibou Badji,0,3,3,0,3,3.6
0,0,0,0,0,0,0,0,0,0,0,0,0,0,0,0,1038090,2024-01-07T00:00:00.000Z,38017711,25,Jabari Walker,0,0,0,0,0,0
1,1,2,7,3,24,11,2,2,42,0,2,27,2,1,0,1038090,2024-01-07T00:00:00.000Z,182,25,Jerami Grant,2,29,30,28,3,36.9
0,0,0,0,0,0,0,0,0,0,0,0,0,0,0,0,1038090,2024-01-07T00:00:00.000Z,47957121,25,Justin Minaya,0,0,0,0,0,0
0,0,2,0,0,2,0,0,0,7,1,1,0,3,0,2,1038090,2024-01-07T00:00:00.000Z,56677791,25,Kris Murray,0,3,3,0,3,1.6
2,0,2,6,4,8,5,4,4,22,1,0,18,3,0,0,1038090,2024-01-07T00:00:00.000Z,65,25,Malcolm Brogdon,0,21,23,20,5,24.6
0,0,0,0,0,0,0,0,0,0,0,0,0,0,0,0,1038090,2024-01-07T00:00:00.000Z,666923,25,Matisse Thybulle,0,0,0,0,0,0
0,0,0,0,0,0,0,0,0,0,0,0,0,0,0,0,1038090,2024-01-07T00:00:00.000Z,666476,25,Moses Brown,0,0,0,0,0,0
0,0,0,0,0,0,0,0,0,0,0,0,0,0,0,0,1038090,2024-01-07T00:00:00.000Z,56677829,25,Rayan Rupert,0,0,0,0,0,0
0,0,0,0,0,0,0,0,0,0,0,0,0,0,0,0,1038090,2024-01-07T00:00:00.000Z,476,25,Robert Williams III,0,0,0,0,0,0
4,0,2,3,2,8,3,2,2,30,1,2,10,3,0,2,1038090,2024-01-07T00:00:00.000Z,56677747,25,Scoot Henderson,0,13,17,14,7,17.6
1,1,1,6,3,14,7,7,4,40,0,2,21,1,2,0,1038090,2024-01-07T00:00:00.000Z,38017690,25,Shaedon Sharpe,3,22,23,22,2,32.7
1,0,5,2,0,4,1,4,3,29,1,4,5,6,1,2,1038090,2024-01-07T00:00:00.000Z,56677850,25,Toumani Camara,1,11,12,6,7,14.7
1,0,2,9,4,17,7,0,0,26,1,5,18,3,4,0,1038091,2024-01-07T00:00:00.000Z,53,1,Bogdan Bogdanovic,4,21,22,19,4,35.1
0,0,0,0,0,0,0,0,0,0,0,0,0,0,0,0,1038091,2024-01-07T00:00:00.000Z,666564,1,Bruno Fernando,0,0,0,0,0,0
0,2,8,0,0,6,2,2,0,36,4,3,4,12,3,1,1038091,2024-01-07T00:00:00.000Z,83,1,Clint Capela,5,16,16,4,12,32.4
0,0,0,0,0,0,0,0,0,0,0,0,0,0,0,0,1038091,2024-01-07T00:00:00.000Z,666656,1,De'Andre Hunter,0,0,0,0,0,0
2,0,6,2,0,20,9,10,6,40,0,2,24,6,0,3,1038091,2024-01-07T00:00:00.000Z,334,1,Dejounte Murray,0,30,32,26,8,31.2
0,0,0,0,0,0,0,0,0,2,0,0,0,0,0,0,1038091,2024-01-07T00:00:00.000Z,666754,1,Garrison Mathews,0,0,0,0,0,0
4,1,10,4,0,12,6,0,0,40,1,6,12,11,0,3,1038091,2024-01-07T00:00:00.000Z,17896040,1,Jalen Johnson,1,23,27,16,15,31.2
0,0,0,0,0,0,0,0,0,0,0,0,0,0,0,0,1038091,2024-01-07T00:00:00.000Z,56677838,1,Kobe Bufkin,0,0,0,0,0,0
0,0,0,0,0,0,0,0,0,0,0,0,0,0,0,0,1038091,2024-01-07T00:00:00.000Z,56677806,1,Mouhamed Gueye,0,0,0,0,0,0
3,5,5,2,1,3,2,2,0,32,1,3,5,6,0,0,1038091,2024-01-07T00:00:00.000Z,3547244,1,Onyeka Okongwu,5,11,14,8,9,31.7
2,0,6,4,2,10,5,5,4,38,1,1,16,7,1,0,1038091,2024-01-07T00:00:00.000Z,3547256,1,Saddiq Bey,1,23,25,18,9,30.4
9,1,4,9,2,23,11,10,7,42,0,2,31,4,1,5,1038091,2024-01-07T00:00:00.000Z,490,1,Trae Young,2,35,44,40,13,50.3
0,0,0,0,0,0,0,0,0,0,0,0,0,0,0,0,1038091,2024-01-07T00:00:00.000Z,4197387,1,Vit Krejci,0,0,0,0,0,0
0,1,1,0,0,0,0,0,0,9,0,1,0,1,0,0,1038091,2024-01-07T00:00:00.000Z,301,1,Wesley Matthews,1,1,1,0,1,4.2
4,0,1,14,7,15,8,3,2,36,1,2,25,2,1,0,1038091,2024-01-07T00:00:00.000Z,38017724,22,Caleb Houstan,1,27,31,29,6,36.4
0,0,0,0,0,0,0,0,0,0,0,0,0,0,0,0,1038091,2024-01-07T00:00:00.000Z,17896026,22,Franz Wagner,0,0,0,0,0,0
0,0,0,0,0,0,0,0,0,0,0,0,0,0,0,0,1038091,2024-01-07T00:00:00.000Z,196,22,Gary Harris,0,0,0,0,0,0
0,0,0,0,0,0,0,0,0,0,0,0,0,0,0,0,1038091,2024-01-07T00:00:00.000Z,56677839,22,Jett Howard,0,0,0,0,0,0
0,0,0,0,0,0,0,0,0,0,0,0,0,0,0,0,1038091,2024-01-07T00:00:00.000Z,229,22,Jonathan Isaac,0,0,0,0,0,0
0,0,0,0,0,0,0,0,0,0,0,0,0,0,0,0,1038091,2024-01-07T00:00:00.000Z,38017607,22,Kevon Harris,0,0,0,0,0,0
4,1,9,7,4,29,13,7,5,45,1,2,35,10,3,2,1038091,2024-01-07T00:00:00.000Z,38017683,22,Paolo Banchero,4,45,49,39,14,63
0,0,0,0,0,0,0,0,0,0,0,0,0,0,0,0,1038091,2024-01-07T00:00:00.000Z,85,22,Wendell Carter Jr.,0,0,0,0,0,0
8,1,4,3,1,12,6,2,2,30,1,0,15,5,1,1,1038092,2024-01-07T00:00:00.000Z,227,19,Brandon Ingram,2,20,28,23,13,38
1,0,1,1,1,3,2,2,2,7,1,0,7,2,0,2,1038092,2024-01-07T00:00:00.000Z,491,19,Cody Zeller,0,9,10,8,3,8.9
0,0,0,0,0,0,0,0,0,0,0,0,0,0,0,0,1038092,2024-01-07T00:00:00.000Z,38017726,19,Dereon Seabron,0,0,0,0,0,0
0,1,0,0,0,0,0,0,0,4,0,1,0,0,0,1,1038092,2024-01-07T00:00:00.000Z,38017663,19,E.J. Liddell,1,0,0,0,0,2
2,1,2,3,1,7,3,2,2,26,1,1,9,3,0,1,1038092,2024-01-07T00:00:00.000Z,17896024,19,Herbert Jones,1,12,14,11,5,17.6
0,1,0,2,1,4,3,0,0,10,0,1,7,0,0,1,1038092,2024-01-07T00:00:00.000Z,17896021,19,Jeremiah Robinson-Earl,1,7,7,7,0,9
1,1,11,2,1,10,6,2,2,22,1,2,15,12,0,1,1038092,2024-01-07T00:00:00.000Z,455,19,Jonas Valanciunas,1,27,28,16,13,32.9
2,1,3,5,1,9,5,2,1,24,0,2,12,3,0,2,1038092,2024-01-07T00:00:00.000Z,56677837,19,Jordan Hawkins,1,15,17,14,5,19.6
0,0,0,0,0,0,0,0,0,0,0,0,0,0,0,0,1038092,2024-01-07T00:00:00.000Z,17896097,19,Jose Alvarado,0,0,0,0,0,0
0,0,0,0,0,0,0,0,0,0,0,0,0,0,0,0,1038092,2024-01-07T00:00:00.000Z,3547260,19,Kira Lewis Jr.,0,0,0,0,0,0
4,1,5,0,0,4,1,0,0,14,2,1,2,7,0,2,1038092,2024-01-07T00:00:00.000Z,340,19,Larry Nance Jr.,1,9,13,6,11,17.4
0,0,0,0,0,0,0,0,0,0,0,0,0,0,0,0,1038092,2024-01-07T00:00:00.000Z,17896017,19,Matt Ryan,0,0,0,0,0,0
2,0,4,1,1,4,3,4,4,22,1,2,11,5,0,1,1038092,2024-01-07T00:00:00.000Z,3547293,19,Naji Marshall,0,16,18,13,7,19
5,0,2,6,3,7,4,0,0,25,0,1,11,2,1,1,1038092,2024-01-07T00:00:00.000Z,18677986,19,Trey Murphy III,1,13,18,16,7,22.9
0,0,1,5,1,9,5,0,0,21,1,0,11,2,0,0,1038092,2024-01-07T00:00:00.000Z,4197162,26,Aleksandar Vezenkov,0,13,13,11,2,13.4
3,0,0,0,0,2,0,0,0,10,1,1,0,1,1,0,1038092,2024-01-07T00:00:00.000Z,273,26,Alex Len,1,1,4,3,4,8.7
1,0,0,2,0,3,0,2,1,15,0,0,1,0,0,0,1038092,2024-01-07T00:00:00.000Z,17896030,26,Chris Duarte,0,1,2,2,1,2.5
4,0,1,2,0,5,2,0,0,10,0,1,4,1,1,0,1038092,2024-01-07T00:00:00.000Z,56677845,26,Colby Jones,1,5,9,8,5,14.2
0,0,0,2,0,2,0,0,0,10,0,1,0,0,1,0,1038092,2024-01-07T00:00:00.000Z,17553994,26,Davion Mitchell,1,0,0,0,0,3
4,0,2,4,1,10,1,0,0,26,0,3,3,2,0,4,1038092,2024-01-07T00:00:00.000Z,161,26,De'Aaron Fox,0,5,9,7,6,7.4
6,0,10,2,1,12,8,1,0,29,0,2,17,10,1,3,1038092,2024-01-07T00:00:00.000Z,406,26,Domantas Sabonis,1,27,33,23,16,38
0,0,0,5,2,9,4,0,0,22,1,1,10,1,0,0,1038092,2024-01-07T00:00:00.000Z,30,26,Harrison Barnes,0,11,11,10,1,11.2
1,0,1,0,0,1,0,0,0,6,0,0,0,1,0,1,1038092,2024-01-07T00:00:00.000Z,306,26,JaVale McGee,0,1,2,1,2,1.7
0,0,0,0,0,0,0,0,0,0,0,0,0,0,0,0,1038092,2024-01-07T00:00:00.000Z,17895990,26,Jordan Ford,0,0,0,0,0,0
0,0,0,6,1,9,2,3,3,26,1,1,8,1,2,0,1038092,2024-01-07T00:00:00.000Z,38017688,26,Keegan Murray,2,9,9,8,1,15.2
1,0,0,3,3,6,5,0,0,12,2,1,13,2,1,0,1038092,2024-01-07T00:00:00.000Z,38017714,26,Keon Ellis,1,15,16,14,3,19.9
0,0,1,2,2,4,3,2,2,8,1,0,10,2,0,0,1038092,2024-01-07T00:00:00.000Z,17896044,26,Kessler Edwards,0,12,12,10,2,12.4
3,1,0,6,2,10,6,4,3,24,1,0,17,1,1,0,1038092,2024-01-07T00:00:00.000Z,221,26,Kevin Huerter,2,18,21,20,4,28.7
5,1,1,6,2,9,2,0,0,21,0,1,6,1,1,1,1038092,2024-01-07T00:00:00.000Z,324,26,Malik Monk,2,7,12,11,6,19.7
0,0,0,0,0,0,0,0,0,0,0,0,0,0,0,0,1038093,2024-01-07T00:00:00.000Z,24489167,7,Brandon Williams,0,0,0,0,0,0
0,0,0,0,0,0,0,0,0,0,0,0,0,0,0,0,1038093,2024-01-07T00:00:00.000Z,151,7,Dante Exum,0,0,0,0,0,0
0,0,0,0,0,0,0,0,0,0,0,0,0,0,0,0,1038093,2024-01-07T00:00:00.000Z,56677840,7,Dereck Lively II,0,0,0,0,0,0
0,0,0,0,0,0,0,0,0,0,0,0,0,0,0,0,1038093,2024-01-07T00:00:00.000Z,329,7,Markieff Morris,0,0,0,0,0,0
0,0,0,0,0,0,0,0,0,0,0,0,0,0,0,0,1038093,2024-01-07T00:00:00.000Z,257,7,Maxi Kleber,0,0,0,0,0,0
0,0,0,0,0,0,0,0,0,0,0,0,0,0,0,0,1038093,2024-01-07T00:00:00.000Z,56677859,7,Olivier-Maxence Prosper,0,0,0,0,0,0
3,1,5,6,3,27,14,7,5,37,5,3,36,10,3,2,1038093,2024-01-07T00:00:00.000Z,3547238,18,Anthony Edwards,4,46,49,39,13,62.5
0,0,0,0,0,0,0,0,0,0,0,0,0,0,0,0,1038093,2024-01-07T00:00:00.000Z,17895968,18,Daishen Nix,0,0,0,0,0,0
4,0,2,5,0,10,1,0,0,37,1,4,2,3,0,0,1038093,2024-01-07T00:00:00.000Z,3547259,18,Jaden McDaniels,0,5,9,6,7,11.6
0,0,0,0,0,0,0,0,0,0,0,0,0,0,0,0,1038093,2024-01-07T00:00:00.000Z,56677851,18,Jaylen Clark,0,0,0,0,0,0
0,0,0,0,0,0,0,0,0,0,0,0,0,0,0,0,1038093,2024-01-07T00:00:00.000Z,38017715,18,Josh Minott,0,0,0,0,0,0
0,0,0,0,0,0,0,0,0,0,0,0,0,0,0,0,1038093,2024-01-07T00:00:00.000Z,17896056,18,Luka Garza,0,0,0,0,0,0
0,0,0,0,0,0,0,0,0,0,0,0,0,0,0,0,1038093,2024-01-07T00:00:00.000Z,320,18,Shake Milton,0,0,0,0,0,0
0,0,1,0,0,0,0,2,2,3,0,0,2,1,0,0,1038094,2024-01-07T00:00:00.000Z,17896007,8,Braxton Key,0,3,3,2,1,3.2
0,0,0,0,0,0,0,0,0,3,0,1,0,0,0,1,1038094,2024-01-07T00:00:00.000Z,38017727,8,Collin Gillespie,0,0,0,0,0,-1
1,1,7,0,0,3,3,5,3,21,0,5,9,7,0,3,1038094,2024-01-07T00:00:00.000Z,250,8,DeAndre Jordan,1,16,17,10,8,18.9
0,0,0,1,0,1,0,0,0,2,0,1,0,0,0,0,1038094,2024-01-07T00:00:00.000Z,17896103,8,Jay Huff,0,0,0,0,0,0
0,0,0,0,0,0,0,0,0,4,0,0,0,0,0,0,1038094,2024-01-07T00:00:00.000Z,215,8,Justin Holiday,0,0,0,0,0,0
1,1,5,4,2,10,4,5,5,23,1,0,15,6,1,0,1038094,2024-01-07T00:00:00.000Z,38017721,8,Peyton Watson,2,21,22,16,7,29.7
0,0,0,1,0,1,0,0,0,3,0,0,0,0,0,0,1038094,2024-01-07T00:00:00.000Z,3547268,8,Zeke Nnaji,0,0,0,0,0,0
1,0,3,3,3,9,6,3,3,20,1,1,18,4,0,1,1038094,2024-01-07T00:00:00.000Z,77,9,Alec Burks,0,22,23,19,5,23.3
3,0,3,2,1,6,1,0,0,11,0,2,3,3,0,0,1038094,2024-01-07T00:00:00.000Z,17896075,9,Cade Cunningham,0,6,9,6,6,11.1
1,0,3,2,1,8,4,2,2,31,2,5,11,5,1,0,1038094,2024-01-07T00:00:00.000Z,17896071,9,Isaiah Livers,1,16,17,12,6,21.5
0,0,0,0,0,0,0,0,0,0,0,0,0,0,0,0,1038094,2024-01-07T00:00:00.000Z,3547267,9,Isaiah Stewart,0,0,0,0,0,0
6,0,3,6,0,11,4,8,5,27,1,2,13,4,1,4,1038094,2024-01-07T00:00:00.000Z,38017682,9,Jaden Ivey,1,17,23,19,10,25.8
4,0,3,0,0,12,8,6,4,30,2,1,20,5,0,1,1038094,2024-01-07T00:00:00.000Z,38017694,9,Jalen Duren,0,25,29,24,9,31
0,0,0,0,0,0,0,0,0,0,0,0,0,0,0,0,1038094,2024-01-07T00:00:00.000Z,42097199,9,Jared Rhoden,0,0,0,0,0,0
6,0,2,1,0,5,1,0,0,25,0,4,2,2,1,1,1038094,2024-01-07T00:00:00.000Z,3547241,9,Killian Hayes,1,4,10,8,8,15.4
0,0,0,0,0,0,0,0,0,0,0,0,0,0,0,0,1038094,2024-01-07T00:00:00.000Z,56677729,9,Malcolm Cazalon,0,0,0,0,0,0
0,0,0,0,0,0,0,0,0,0,0,0,0,0,0,0,1038094,2024-01-07T00:00:00.000Z,330,9,Monte Morris,0,0,0,0,0,0
0,0,0,0,0,0,0,0,0,0,0,0,0,0,0,0,1038094,2024-01-07T00:00:00.000Z,44477024,9,Stanley Umude,0,0,0,0,0,0
2,3,5,0,0,2,0,2,1,26,1,3,1,6,0,2,1038095,2024-01-07T00:00:00.000Z,48,15,Bismack Biyombo,3,7,9,3,8,18.2
0,0,0,0,0,0,0,0,0,0,0,0,0,0,0,0,1038095,2024-01-07T00:00:00.000Z,666505,15,Brandon Clarke,0,0,0,0,0,0
0,0,0,0,0,0,0,0,0,0,0,0,0,0,0,0,1038095,2024-01-07T00:00:00.000Z,38017729,15,David Roddy,0,0,0,0,0,0
0,0,0,0,0,0,0,0,0,0,0,0,0,0,0,0,1038095,2024-01-07T00:00:00.000Z,401,15,Derrick Rose,0,0,0,0,0,0
5,1,3,7,2,14,8,5,5,36,2,3,23,5,1,3,1038095,2024-01-07T00:00:00.000Z,3547287,15,Desmond Bane,2,28,33,28,10,39.5
0,0,0,0,0,0,0,0,0,0,0,0,0,0,0,0,1038095,2024-01-07T00:00:00.000Z,56677830,15,GG Jackson,0,0,0,0,0,0
0,0,0,0,0,0,0,0,0,0,0,0,0,0,0,0,1038095,2024-01-07T00:00:00.000Z,666786,15,Ja Morant,0,0,0,0,0,0
0,0,0,0,0,0,0,0,0,0,0,0,0,0,0,0,1038095,2024-01-07T00:00:00.000Z,48248287,15,Jacob Gilyard,0,0,0,0,0,0
0,0,0,0,0,0,0,0,0,0,0,0,0,0,0,0,1038095,2024-01-07T00:00:00.000Z,38017728,15,Jake LaRavia,0,0,0,0,0,0
6,1,9,8,3,20,11,4,3,32,1,5,28,10,0,2,1038095,2024-01-07T00:00:00.000Z,231,15,Jaren Jackson Jr.,1,38,44,34,16,50
0,0,1,1,0,1,0,0,0,3,0,0,0,1,0,0,1038095,2024-01-07T00:00:00.000Z,666703,15,John Konchar,0,1,1,0,1,1.2
8,0,6,13,4,20,9,5,3,38,0,2,25,6,3,5,1038095,2024-01-07T00:00:00.000Z,420,15,Marcus Smart,3,31,39,33,14,48.2
1,1,5,7,1,11,2,3,2,16,2,2,7,7,1,4,1038095,2024-01-07T00:00:00.000Z,17896067,15,Santi Aldama,2,14,15,8,8,18.9
0,0,0,0,0,0,0,0,0,0,0,0,0,0,0,0,1038095,2024-01-07T00:00:00.000Z,3,15,Steven Adams,0,0,0,0,0,0
1,2,5,4,3,11,6,4,4,37,4,2,19,9,0,0,1038095,2024-01-07T00:00:00.000Z,38017731,15,Vince Williams Jr.,2,28,29,20,10,37.3
0,0,0,1,0,3,0,0,0,3,3,1,0,3,0,0,1038095,2024-01-07T00:00:00.000Z,3547285,15,Xavier Tillman,0,3,3,0,3,3.6
3,0,2,5,1,10,4,1,0,27,2,4,9,4,2,1,1038095,2024-01-07T00:00:00.000Z,17896027,15,Ziaire Williams,2,13,16,12,7,23.3
0,0,0,0,0,0,0,0,0,0,0,0,0,0,0,0,1038095,2024-01-07T00:00:00.000Z,666451,24,Bol Bol,0,0,0,0,0,0
0,0,0,0,0,0,0,0,0,0,0,0,0,0,0,0,1038095,2024-01-07T00:00:00.000Z,272,24,Damion Lee,0,0,0,0,0,0
0,0,0,0,0,0,0,0,0,0,0,0,0,0,0,0,1038095,2024-01-07T00:00:00.000Z,178,24,Eric Gordon,0,0,0,0,0,0
0,0,0,0,0,0,0,0,0,0,0,0,0,0,0,0,1038095,2024-01-07T00:00:00.000Z,18678058,24,Jordan Goodwin,0,0,0,0,0,0
0,0,0,0,0,0,0,0,0,0,0,0,0,0,0,0,1038095,2024-01-07T00:00:00.000Z,666729,24,Nassir Little,0,0,0,0,0,0
0,0,0,0,0,0,0,0,0,0,0,0,0,0,0,0,1038095,2024-01-07T00:00:00.000Z,3547095,24,Udoka Azubuike,0,0,0,0,0,0
0,0,0,0,0,0,0,0,0,0,0,0,0,0,0,0,1038095,2024-01-07T00:00:00.000Z,470,24,Yuta Watanabe,0,0,0,0,0,0
1,0,2,2,0,6,1,2,1,17,0,0,3,2,0,1,1038096,2024-01-07T00:00:00.000Z,475,10,Andrew Wiggins,0,5,6,4,3,5.9
4,0,6,8,1,11,2,0,0,29,2,1,5,8,0,0,1038096,2024-01-07T00:00:00.000Z,56677858,10,Brandin Podziemski,0,13,17,9,12,20.6
0,0,0,0,0,0,0,0,0,0,0,0,0,0,0,0,1038096,2024-01-07T00:00:00.000Z,367,10,Chris Paul,0,0,0,0,0,0
2,0,0,1,0,2,0,0,0,14,0,1,0,0,0,1,1038096,2024-01-07T00:00:00.000Z,251,10,Cory Joseph,0,0,2,2,2,2
0,0,0,0,0,0,0,0,0,0,0,0,0,0,0,0,1038096,2024-01-07T00:00:00.000Z,185,10,Draymond Green,0,0,0,0,0,0
0,0,0,0,0,0,0,0,0,0,0,0,0,0,0,0,1038096,2024-01-07T00:00:00.000Z,2189,10,Gary Payton II,0,0,0,0,0,0
0,0,0,0,0,0,0,0,0,0,0,0,0,0,0,0,1038096,2024-01-07T00:00:00.000Z,57875092,10,Gui Santos,0,0,0,0,0,0
1,0,1,1,0,2,0,0,0,7,0,1,0,1,0,0,1038096,2024-01-07T00:00:00.000Z,398,10,Jerome Robinson,0,1,2,1,2,2.7
4,1,3,5,1,12,5,2,2,25,1,0,13,4,1,1,1038096,2024-01-07T00:00:00.000Z,17553979,10,Jonathan Kuminga,2,17,21,17,8,28.8
2,0,0,0,0,6,4,2,2,17,7,2,10,7,0,1,1038096,2024-01-07T00:00:00.000Z,282,10,Kevon Looney,0,17,19,12,9,20.4
3,0,0,7,5,15,10,0,0,28,0,0,25,0,0,2,1038096,2024-01-07T00:00:00.000Z,443,10,Klay Thompson,0,25,28,28,3,27.5
0,0,1,2,1,3,2,0,0,6,0,1,5,1,1,1,1038096,2024-01-07T00:00:00.000Z,45658838,10,Lester Quinones,1,6,6,5,1,8.2
1,0,3,6,4,9,7,3,3,22,0,1,21,3,1,1,1038096,2024-01-07T00:00:00.000Z,17553992,10,Moses Moody,1,24,25,22,4,28.1
6,0,1,9,0,14,2,5,5,30,0,3,9,1,0,2,1038096,2024-01-07T00:00:00.000Z,115,10,Stephen Curry,0,10,16,15,7,17.2
2,3,8,0,0,9,8,0,0,27,3,0,16,11,0,0,1038096,2024-01-07T00:00:00.000Z,56677799,10,Trayce Jackson-Davis,3,27,29,18,13,41.2
0,0,0,0,0,0,0,0,0,0,0,0,0,0,0,0,1038096,2024-01-07T00:00:00.000Z,17896070,10,Usman Garuba,0,0,0,0,0,0
1,1,7,3,3,7,7,0,0,16,2,0,17,9,1,0,1038096,2024-01-07T00:00:00.000Z,58,28,Chris Boucher,2,26,27,18,10,35.3
0,0,0,0,0,0,0,0,0,0,0,0,0,0,0,0,1038096,2024-01-07T00:00:00.000Z,38017710,28,Christian Koloko,0,0,0,0,0,0
4,0,3,3,1,10,6,1,0,28,0,5,13,3,0,0,1038096,2024-01-07T00:00:00.000Z,409,28,Dennis Schroder,0,16,20,17,7,22.6
0,0,0,0,0,1,1,0,0,4,0,0,2,0,1,1,1038096,2024-01-07T00:00:00.000Z,436,28,Garrett Temple,1,2,2,2,0,4
1,0,1,5,2,11,6,0,0,26,0,1,14,1,2,0,1038096,2024-01-07T00:00:00.000Z,3089,28,Gary Trent Jr.,2,15,16,15,2,22.7
0,0,0,0,0,0,0,0,0,0,0,0,0,0,0,0,1038096,2024-01-07T00:00:00.000Z,56677828,28,Gradey Dick,0,0,0,0,0,0
10,0,4,4,1,10,4,0,0,26,1,0,9,5,1,0,1038096,2024-01-07T00:00:00.000Z,3547269,28,Immanuel Quickley,1,14,24,19,15,33
5,0,8,0,0,8,6,5,2,31,3,3,14,11,0,2,1038096,2024-01-07T00:00:00.000Z,373,28,Jakob Poeltl,0,25,30,19,16,32.7
1,0,0,0,0,0,0,0,0,4,0,0,0,0,0,0,1038096,2024-01-07T00:00:00.000Z,666762,28,Jalen McDaniels,0,0,1,1,1,1.5
0,0,0,0,0,0,0,0,0,0,0,0,0,0,0,0,1038096,2024-01-07T00:00:00.000Z,56677805,28,Javon Freeman-Liberty,0,0,0,0,0,0
1,1,1,2,0,3,1,0,0,11,1,1,2,2,0,0,1038096,2024-01-07T00:00:00.000Z,2309958,28,Jontay Porter,1,4,5,3,3,8.9
0,0,0,0,0,0,0,0,0,0,0,0,0,0,0,0,1038096,2024-01-07T00:00:00.000Z,56677869,28,Markquis Nowell,0,0,0,0,0,0
6,2,5,3,2,11,7,0,0,30,1,0,16,6,0,1,1038096,2024-01-07T00:00:00.000Z,416,28,Pascal Siakam,2,22,28,22,12,37.2
6,0,6,8,5,20,13,8,6,36,0,3,37,6,1,0,1038096,2024-01-07T00:00:00.000Z,666423,28,RJ Barrett,1,43,49,43,12,56.2
3,1,1,4,0,11,3,0,0,24,1,1,6,2,1,2,1038096,2024-01-07T00:00:00.000Z,17896055,28,Scottie Barnes,2,8,11,9,5,16.9
0,0,0,1,1,2,1,0,0,4,0,0,3,0,0,1,1038096,2024-01-07T00:00:00.000Z,489,28,Thaddeus Young,0,3,3,3,0,2
0,0,0,0,0,0,0,0,0,0,0,0,0,0,0,0,1038097,2024-01-07T00:00:00.000Z,17896051,13,Joshua Primo,0,0,0,0,0,0
0,0,0,0,0,0,0,0,0,0,0,0,0,0,0,0,1038097,2024-01-07T00:00:00.000Z,371,13,Mason Plumlee,0,0,0,0,0,0
0,0,0,0,0,0,0,0,0,0,0,0,0,0,0,0,1038097,2024-01-07T00:00:00.000Z,38017725,13,Moussa Diabate,0,0,0,0,0,0
0,0,0,0,0,0,0,0,0,0,0,0,0,0,0,0,1038097,2024-01-07T00:00:00.000Z,450,13,PJ Tucker,0,0,0,0,0,0
3,0,1,4,1,9,3,0,0,19,0,1,7,1,1,0,1038097,2024-01-07T00:00:00.000Z,472,13,Russell Westbrook,1,8,11,10,4,15.7
0,0,0,0,0,0,0,0,0,0,0,0,0,0,0,0,1038097,2024-01-07T00:00:00.000Z,24417679,13,Xavier Moon,0,0,0,0,0,0
1,1,9,1,0,15,10,4,2,39,1,1,22,10,3,3,1038097,2024-01-07T00:00:00.000Z,117,14,Anthony Davis,4,32,33,23,11,44.5
2,0,0,3,0,5,2,5,4,32,0,0,8,0,0,2,1038097,2024-01-07T00:00:00.000Z,17553995,14,Austin Reaves,0,8,10,10,2,9
1,0,3,3,2,6,2,2,1,20,1,1,7,4,2,5,1038097,2024-01-07T00:00:00.000Z,666860,14,Cameron Reddish,2,11,12,8,5,14.3
0,0,0,0,0,0,0,0,0,0,0,0,0,0,0,0,1038097,2024-01-07T00:00:00.000Z,56677835,14,Jalen Hood-Schifino,0,0,0,0,0,0
0,0,0,0,0,0,0,0,0,0,0,0,0,0,0,0,1038097,2024-01-07T00:00:00.000Z,666626,14,Jaxson Hayes,0,0,0,0,0,0
7,0,7,3,1,19,11,3,2,38,1,2,25,8,1,4,1038097,2024-01-07T00:00:00.000Z,237,14,LeBron James,1,33,40,32,15,44.1
0,2,1,1,1,6,3,0,0,13,2,0,7,3,0,0,1038097,2024-01-07T00:00:00.000Z,38017697,14,Max Christie,2,10,10,7,3,16.6
2,0,1,6,3,8,4,2,2,30,0,3,13,1,1,0,1038097,2024-01-07T00:00:00.000Z,383,14,Taurean Prince,1,14,16,15,3,20.2
0,0,0,0,0,0,0,0,0,0,0,0,0,0,0,0,1038098,2024-01-08T00:00:00.000Z,56677848,4,Amari Bailey,0,0,0,0,0,0
4,0,6,7,0,11,2,0,0,31,0,4,4,6,1,3,1038098,2024-01-08T00:00:00.000Z,56677823,4,Brandon Miller,1,10,14,8,10,17.2
2,0,1,5,1,7,1,0,0,24,0,1,3,1,0,0,1038098,2024-01-08T00:00:00.000Z,38017708,4,Bryce McGowens,0,4,6,5,3,7.2
0,0,0,0,0,0,0,0,0,0,0,0,0,0,0,0,1038098,2024-01-08T00:00:00.000Z,666748,4,Cody Martin,0,0,0,0,0,0
0,0,0,0,0,0,0,0,0,0,0,0,0,0,0,0,1038098,2024-01-08T00:00:00.000Z,347,4,Frank Ntilikina,0,0,0,0,0,0
0,0,0,0,0,0,0,0,0,0,0,0,0,0,0,0,1038098,2024-01-08T00:00:00.000Z,204,4,Gordon Hayward,0,0,0,0,0,0
1,0,0,0,0,4,1,0,0,15,0,1,2,0,0,0,1038098,2024-01-08T00:00:00.000Z,422,4,Ish Smith,0,2,3,3,1,3.5
2,0,2,1,1,1,1,0,0,4,0,1,3,2,0,0,1038098,2024-01-08T00:00:00.000Z,17896037,4,James Bouknight,0,5,7,5,4,8.4
0,2,2,2,1,12,4,0,0,21,6,1,9,8,0,0,1038098,2024-01-08T00:00:00.000Z,18678001,4,JT Thor,2,17,17,9,8,24.6
0,0,0,0,0,0,0,0,0,0,0,0,0,0,0,0,1038098,2024-01-08T00:00:00.000Z,3547239,4,LaMelo Ball,0,0,0,0,0,0
0,0,0,0,0,0,0,0,0,0,0,0,0,0,0,0,1038098,2024-01-08T00:00:00.000Z,56677866,4,Leaky Black,0,0,0,0,0,0
0,0,0,0,0,0,0,0,0,0,0,0,0,0,0,0,1038098,2024-01-08T00:00:00.000Z,38017698,4,Mark Williams,0,0,0,0,0,0
5,2,6,8,4,18,9,3,2,40,2,3,24,8,1,5,1038098,2024-01-08T00:00:00.000Z,62,4,Miles Bridges,3,32,37,29,13,45.1
1,3,7,0,0,6,5,0,0,39,1,4,10,8,0,0,1038098,2024-01-08T00:00:00.000Z,3547282,4,Nick Richards,3,18,19,11,9,30.1
3,0,2,6,3,15,6,0,0,32,2,2,15,4,1,3,1038098,2024-01-08T00:00:00.000Z,56677846,4,Nick Smith Jr.,1,19,22,18,7,24.3
0,0,0,0,0,0,0,0,0,0,0,0,0,0,0,0,1038098,2024-01-08T00:00:00.000Z,666950,4,P.J. Washington,0,0,0,0,0,0
8,0,3,13,7,18,10,12,12,44,0,2,39,3,0,0,1038098,2024-01-08T00:00:00.000Z,403,4,Terry Rozier,0,42,50,47,11,54.6
3,1,2,3,1,7,2,0,0,34,0,4,5,2,2,0,1038098,2024-01-08T00:00:00.000Z,89,5,Alex Caruso,3,7,10,8,5,20.9
0,0,10,0,0,12,9,3,3,22,5,1,21,15,0,2,1038098,2024-01-08T00:00:00.000Z,137,5,Andre Drummond,0,36,36,21,15,37
2,1,0,0,0,3,2,2,2,18,1,3,6,1,0,1,1038098,2024-01-08T00:00:00.000Z,17895983,5,Ayo Dosunmu,1,7,9,8,3,12.2
5,0,6,7,3,19,10,5,4,42,0,3,27,6,0,1,1038098,2024-01-08T00:00:00.000Z,666956,5,Coby White,0,33,38,32,11,40.7
1,0,1,1,0,1,0,2,2,12,1,1,2,2,0,1,1038098,2024-01-08T00:00:00.000Z,38017719,5,Dalen Terry,0,4,5,3,3,4.9
7,1,7,3,1,16,7,4,3,44,0,0,18,7,3,2,1038098,2024-01-08T00:00:00.000Z,125,5,DeMar DeRozan,4,25,32,25,14,46.9
0,0,0,1,0,2,1,0,0,4,0,0,2,0,0,0,1038098,2024-01-08T00:00:00.000Z,87,5,Jevon Carter,0,2,2,2,0,2
0,0,0,0,0,0,0,0,0,0,0,0,0,0,0,0,1038098,2024-01-08T00:00:00.000Z,56677857,5,Julian Phillips,0,0,0,0,0,0
0,1,4,2,1,6,2,4,3,23,1,1,8,5,1,2,1038098,2024-01-08T00:00:00.000Z,3547248,5,Patrick Williams,2,13,13,8,5,18
0,0,0,0,0,0,0,0,0,0,0,0,0,0,0,0,1038098,2024-01-08T00:00:00.000Z,17896116,5,Terry Taylor,0,0,0,0,0,0
5,2,2,6,2,9,2,4,3,36,1,1,9,3,0,2,1038098,2024-01-08T00:00:00.000Z,268,5,Zach LaVine,2,12,17,14,8,24.1
0,1,6,4,3,5,4,0,0,32,0,1,11,6,0,1,1038099,2024-01-08T00:00:00.000Z,219,2,Al Horford,1,17,17,11,6,20.2
0,0,0,0,0,0,0,0,0,4,0,3,0,0,0,1,1038099,2024-01-08T00:00:00.000Z,17896094,2,Dalano Banton,0,0,0,0,0,-1
6,2,4,8,2,16,4,3,3,36,0,3,13,4,0,1,1038099,2024-01-08T00:00:00.000Z,473,2,Derrick White,2,17,23,19,10,31.8
2,0,4,4,3,26,17,5,3,38,1,2,40,5,0,5,1038099,2024-01-08T00:00:00.000Z,70,2,Jaylen Brown,0,45,47,42,7,44
0,0,0,0,0,0,0,0,0,0,0,0,0,0,0,0,1038099,2024-01-08T00:00:00.000Z,434,2,Jayson Tatum,0,0,0,0,0,0
0,0,0,0,0,0,0,0,0,0,0,0,0,0,0,0,1038099,2024-01-08T00:00:00.000Z,38017707,2,JD Davison,0,0,0,0,0,0
0,0,0,0,0,0,0,0,0,0,0,0,0,0,0,0,1038099,2024-01-08T00:00:00.000Z,56677864,2,Jordan Walsh,0,0,0,0,0,0
6,0,5,6,3,16,9,0,0,38,1,2,21,6,1,3,1038099,2024-01-08T00:00:00.000Z,214,2,Jrue Holiday,1,27,33,27,12,37.2
7,3,3,4,1,13,6,7,6,38,2,2,19,5,0,1,1038099,2024-01-08T00:00:00.000Z,378,2,Kristaps Porzingis,3,24,31,26,12,43.5
0,0,0,0,0,0,0,0,0,0,0,0,0,0,0,0,1038099,2024-01-08T00:00:00.000Z,3547279,2,Lamar Stevens,0,0,0,0,0,0
2,2,0,0,0,4,1,4,3,10,2,2,5,2,0,1,1038099,2024-01-08T00:00:00.000Z,261,2,Luke Kornet,2,7,9,7,4,15.4
0,0,0,0,0,0,0,0,0,0,0,0,0,0,0,0,1038099,2024-01-08T00:00:00.000Z,17553967,2,Neemias Queta,0,0,0,0,0,0
0,0,4,4,1,4,1,6,3,16,2,3,6,6,2,0,1038099,2024-01-08T00:00:00.000Z,666468,2,Oshae Brissett,2,12,12,6,6,19.2
3,0,3,5,4,6,5,0,0,23,4,2,14,7,0,1,1038099,2024-01-08T00:00:00.000Z,3547276,2,Payton Pritchard,0,21,24,17,10,25.9
0,0,0,0,0,0,0,0,0,0,0,0,0,0,0,0,1038099,2024-01-08T00:00:00.000Z,17896060,2,Sam Hauser,0,0,0,0,0,0
0,0,0,0,0,0,0,4,2,5,1,0,2,1,0,1,1038099,2024-01-08T00:00:00.000Z,338,2,Svi Mykhailiuk,0,3,3,2,1,2.2
2,1,2,5,3,10,6,3,2,26,2,2,17,4,0,0,1038099,2024-01-08T00:00:00.000Z,3547250,12,Aaron Nesmith,1,21,23,19,6,27.8
3,0,0,2,1,6,4,0,0,12,0,5,9,0,0,2,1038099,2024-01-08T00:00:00.000Z,38017507,12,Andrew Nembhard,0,9,12,12,3,11.5
0,0,0,0,0,0,0,0,0,0,0,0,0,0,0,0,1038099,2024-01-08T00:00:00.000Z,56677861,12,Ben Sheppard,0,0,0,0,0,0
3,0,4,9,5,15,8,7,5,29,0,4,26,4,2,2,1038099,2024-01-08T00:00:00.000Z,38017686,12,Bennedict Mathurin,2,30,33,29,7,39.3
2,0,2,1,1,6,1,4,4,21,0,1,7,2,1,0,1038099,2024-01-08T00:00:00.000Z,69,12,Bruce Brown,1,9,11,9,4,15.4
3,2,3,7,3,11,6,0,0,25,1,3,15,4,1,1,1038099,2024-01-08T00:00:00.000Z,210,12,Buddy Hield,3,19,22,18,7,32.3
0,2,1,0,0,0,0,0,0,7,1,1,0,2,0,0,1038099,2024-01-08T00:00:00.000Z,17896035,12,Isaiah Jackson,2,2,2,0,2,8.4
0,0,0,0,0,0,0,0,0,0,0,0,0,0,0,0,1038099,2024-01-08T00:00:00.000Z,56677794,12,Isaiah Wong,0,0,0,0,0,0
1,3,7,4,1,8,3,4,4,27,2,1,11,9,0,2,1038099,2024-01-08T00:00:00.000Z,3547264,12,Jalen Smith,3,20,21,12,10,30.3
0,0,0,0,0,0,0,0,0,0,0,0,0,0,0,0,1038099,2024-01-08T00:00:00.000Z,242,12,James Johnson,0,0,0,0,0,0
0,0,0,0,0,0,0,0,0,0,0,0,0,0,0,0,1038099,2024-01-08T00:00:00.000Z,56677832,12,Jarace Walker,0,0,0,0,0,0
0,0,0,0,0,0,0,0,0,0,0,0,0,0,0,0,1038099,2024-01-08T00:00:00.000Z,3547207,12,Jordan Nwora,0,0,0,0,0,0
0,0,0,0,0,0,0,0,0,0,0,0,0,0,0,0,1038099,2024-01-08T00:00:00.000Z,38017701,12,Kendall Brown,0,0,0,0,0,0
1,0,6,3,1,13,7,2,1,35,2,2,16,8,0,2,1038099,2024-01-08T00:00:00.000Z,452,12,Myles Turner,0,24,25,17,9,25.1
1,0,0,4,3,5,4,2,2,20,0,2,13,0,0,0,1038099,2024-01-08T00:00:00.000Z,3547243,12,Obi Toppin,0,13,14,14,1,14.5
0,0,0,0,0,0,0,0,0,0,0,0,0,0,0,0,1038099,2024-01-08T00:00:00.000Z,56677778,12,Oscar Tshiebwe,0,0,0,0,0,0
7,0,3,2,0,12,6,0,0,25,1,1,12,4,2,2,1038099,2024-01-08T00:00:00.000Z,304,12,T.J. McConnell,2,16,23,19,11,31.3
6,0,2,3,1,5,3,0,0,13,0,1,7,2,0,2,1038099,2024-01-08T00:00:00.000Z,3547245,12,Tyrese Haliburton,0,9,15,13,8,16.4
0,0,3,1,1,8,6,0,0,23,2,1,13,5,1,1,1038100,2024-01-08T00:00:00.000Z,17896078,21,Aaron Wiggins,1,18,18,13,5,21
0,0,0,0,0,0,0,0,0,0,0,0,0,0,0,0,1038100,2024-01-08T00:00:00.000Z,3547271,21,Aleksej Pokusevski,0,0,0,0,0,0
2,3,1,4,1,7,2,0,0,24,1,1,5,2,2,1,1038100,2024-01-08T00:00:00.000Z,56677833,21,Cason Wallace,5,7,9,7,4,24.4
5,2,3,5,4,14,11,8,5,32,1,3,31,4,0,1,1038100,2024-01-08T00:00:00.000Z,38017685,21,Chet Holmgren,2,35,40,36,9,48.3
3,0,3,7,4,10,6,0,0,21,1,0,16,4,0,1,1038100,2024-01-08T00:00:00.000Z,3547272,21,Isaiah Joe,0,20,23,19,7,24.3
10,0,6,1,1,13,9,2,2,34,1,3,21,7,2,3,1038100,2024-01-08T00:00:00.000Z,38017703,21,Jalen Williams,2,28,38,31,17,47.4
0,0,0,0,0,0,0,0,0,0,0,0,0,0,0,0,1038100,2024-01-08T00:00:00.000Z,38017706,21,Jaylin Williams,0,0,0,0,0,0
9,0,5,3,1,11,4,0,0,26,1,2,9,6,2,1,1038100,2024-01-08T00:00:00.000Z,17896065,21,Josh Giddey,2,15,24,18,15,34.7
0,0,0,0,0,0,0,0,0,0,0,0,0,0,0,0,1038100,2024-01-08T00:00:00.000Z,27924547,21,Lindy Waters III,0,0,0,0,0,0
1,1,3,3,0,5,2,4,3,27,0,4,7,3,0,2,1038100,2024-01-08T00:00:00.000Z,666541,21,Luguentz Dort,1,10,11,8,4,13.1
5,1,5,3,2,17,11,10,8,36,1,5,32,6,3,3,1038100,2024-01-08T00:00:00.000Z,175,21,Shai Gilgeous-Alexander,4,38,43,37,11,55.7
0,0,0,0,0,0,0,0,0,0,0,0,0,0,0,0,1038100,2024-01-08T00:00:00.000Z,17896036,21,Tre Mann,0,0,0,0,0,0
0,0,0,0,0,0,0,0,0,0,0,0,0,0,0,0,1038100,2024-01-08T00:00:00.000Z,4197029,21,Vasilije Micic,0,0,0,0,0,0
3,2,4,2,1,4,1,2,2,25,1,2,5,5,0,0,1038100,2024-01-08T00:00:00.000Z,56677844,30,Bilal Coulibaly,2,10,13,8,8,21.5
1,1,5,0,0,7,3,3,3,26,4,2,9,9,0,0,1038100,2024-01-08T00:00:00.000Z,666577,30,Daniel Gafford,1,18,19,10,10,24.3
4,0,4,3,2,8,5,6,5,33,0,4,17,4,1,4,1038100,2024-01-08T00:00:00.000Z,3547242,30,Deni Avdija,1,21,25,21,8,26.8
5,0,0,8,4,17,8,5,4,29,0,5,24,0,0,1,1038100,2024-01-08T00:00:00.000Z,666848,30,Jordan Poole,0,24,29,29,5,30.5
5,0,11,5,0,24,10,2,2,37,4,1,22,15,0,2,1038100,2024-01-08T00:00:00.000Z,265,30,Kyle Kuzma,0,37,42,27,20,45.5
0,0,0,0,0,0,0,0,0,0,0,0,0,0,0,0,1038100,2024-01-08T00:00:00.000Z,38017712,30,Ryan Rollins,0,0,0,0,0,0
9,0,0,5,3,10,7,2,1,31,0,1,18,0,3,2,1038100,2024-01-08T00:00:00.000Z,249,30,Tyus Jones,3,18,27,27,9,38.5
1,0,4,5,1,6,2,3,3,23,0,2,8,4,1,0,1038101,2024-01-08T00:00:00.000Z,213,11,Aaron Holiday,1,12,13,9,5,17.3
2,0,7,2,1,15,9,4,3,33,4,6,22,11,3,3,1038101,2024-01-08T00:00:00.000Z,17896062,11,Alperen Sengun,3,33,35,24,13,44.2
1,1,2,0,0,2,1,3,3,11,0,3,5,2,1,2,1038101,2024-01-08T00:00:00.000Z,56677825,11,Amen Thompson,2,7,8,6,3,12.9
0,0,0,0,0,0,0,0,0,0,0,0,0,0,0,0,1038101,2024-01-08T00:00:00.000Z,296,11,Boban Marjanovic,0,0,0,0,0,0
0,0,5,2,1,8,5,0,0,17,1,4,11,6,1,1,1038101,2024-01-08T00:00:00.000Z,56677831,11,Cam Whitmore,1,17,17,11,6,20.2
0,0,0,0,0,0,0,0,0,0,0,0,0,0,0,0,1038101,2024-01-08T00:00:00.000Z,66,11,Dillon Brooks,0,0,0,0,0,0
0,0,3,5,1,13,3,3,3,32,3,3,10,6,0,1,1038101,2024-01-08T00:00:00.000Z,38017684,11,Jabari Smith Jr.,0,16,16,10,6,16.2
1,0,1,4,1,8,3,2,2,34,3,5,9,4,1,0,1038101,2024-01-08T00:00:00.000Z,3547301,11,Jae'Sean Tate,1,13,14,10,5,18.3
2,1,0,1,0,4,2,2,1,20,0,3,5,0,0,1,1038101,2024-01-08T00:00:00.000Z,188,11,Jeff Green,1,5,7,7,2,10
0,0,0,0,0,0,0,0,0,0,0,0,0,0,0,0,1038101,2024-01-08T00:00:00.000Z,19465326,11,Jock Landale,0,0,0,0,0,0
0,0,0,0,0,0,0,0,0,0,0,0,0,0,0,0,1038101,2024-01-08T00:00:00.000Z,3547281,11,Nate Hinton,0,0,0,0,0,0
0,0,0,0,0,0,0,0,0,0,0,0,0,0,0,0,1038101,2024-01-08T00:00:00.000Z,75,11,Reggie Bullock,0,0,0,0,0,0
0,0,0,0,0,0,0,0,0,0,0,0,0,0,0,0,1038101,2024-01-08T00:00:00.000Z,38017695,11,Tari Eason,0,0,0,0,0,0
0,0,0,0,0,0,0,0,0,0,0,0,0,0,0,0,1038101,2024-01-08T00:00:00.000Z,357,11,Victor Oladipo,0,0,0,0,0,0
3,0,11,0,0,12,9,7,4,32,1,4,22,12,1,3,1038101,2024-01-08T00:00:00.000Z,4,16,Bam Adebayo,1,34,37,25,15,40.9
0,0,0,0,0,0,0,0,0,0,0,0,0,0,0,0,1038101,2024-01-08T00:00:00.000Z,666747,16,Caleb Martin,0,0,0,0,0,0
0,0,0,0,0,0,0,0,0,0,0,0,0,0,0,0,1038101,2024-01-08T00:00:00.000Z,38017736,16,Cole Swider,0,0,0,0,0,0
0,0,0,0,0,0,0,0,0,0,0,0,0,0,0,0,1038101,2024-01-08T00:00:00.000Z,19465585,16,Dru Smith,0,0,0,0,0,0
7,0,3,10,3,12,4,3,3,30,0,6,14,3,1,1,1038101,2024-01-08T00:00:00.000Z,397,16,Duncan Robinson,1,17,24,21,10,30.1
0,0,3,2,1,2,1,0,0,16,0,0,3,3,0,0,1038101,2024-01-08T00:00:00.000Z,3092,16,Haywood Highsmith,0,6,6,3,3,6.6
4,0,4,2,1,11,5,4,3,39,0,1,14,4,1,2,1038101,2024-01-08T00:00:00.000Z,56677785,16,Jaime Jaquez Jr.,1,18,22,18,8,25.8
0,0,0,0,0,0,0,0,0,0,0,0,0,0,0,0,1038101,2024-01-08T00:00:00.000Z,38017734,16,Jamal Cain,0,0,0,0,0,0
0,0,0,0,0,0,0,0,0,0,0,0,0,0,0,0,1038101,2024-01-08T00:00:00.000Z,79,16,Jimmy Butler,0,0,0,0,0,0
2,1,2,3,2,6,4,2,2,29,0,2,12,2,0,0,1038101,2024-01-08T00:00:00.000Z,391,16,Josh Richardson,1,14,16,14,4,20.4
4,0,4,3,1,7,4,7,6,23,3,2,15,7,1,1,1038101,2024-01-08T00:00:00.000Z,285,16,Kevin Love,1,22,26,19,11,31.4
1,2,1,1,1,3,2,2,1,16,1,1,6,2,0,0,1038101,2024-01-08T00:00:00.000Z,286,16,Kyle Lowry,2,8,9,7,3,15.9
6,2,5,5,1,9,2,4,1,21,3,3,6,8,2,2,1038101,2024-01-08T00:00:00.000Z,38017696,16,Nikola Jovic,4,14,20,12,14,34.6
0,0,0,0,0,0,0,0,0,0,0,0,0,0,0,0,1038101,2024-01-08T00:00:00.000Z,39398582,16,Orlando Robinson,0,0,0,0,0,0
0,0,0,0,0,0,0,0,0,0,0,0,0,0,0,0,1038101,2024-01-08T00:00:00.000Z,3547257,16,R.J. Hampton,0,0,0,0,0,0
0,0,0,0,0,0,0,0,0,0,0,0,0,0,0,0,1038101,2024-01-08T00:00:00.000Z,74,16,Thomas Bryant,0,0,0,0,0,0
3,0,1,10,5,20,10,3,3,34,2,2,28,3,0,1,1038101,2024-01-08T00:00:00.000Z,666633,16,Tyler Herro,0,31,34,31,6,35.1
0,0,0,0,0,0,0,0,0,0,0,0,0,0,0,0,1038102,2024-01-08T00:00:00.000Z,368,17,Cameron Payne,0,0,0,0,0,0
0,0,0,0,0,0,0,0,0,0,0,0,0,0,0,0,1038102,2024-01-08T00:00:00.000Z,278,17,Damian Lillard,0,0,0,0,0,0
0,0,0,0,0,0,0,0,0,0,0,0,0,0,0,0,1038102,2024-01-08T00:00:00.000Z,112,17,Jae Crowder,0,0,0,0,0,0
0,0,0,0,0,0,0,0,0,1,0,0,0,0,0,0,1038102,2024-01-08T00:00:00.000Z,2148,17,Thanasis Antetokounmpo,0,0,0,0,0,0
0,0,0,0,0,0,0,0,0,0,0,0,0,0,0,0,1038102,2024-01-08T00:00:00.000Z,38017691,17,TyTy Washington Jr.,0,0,0,0,0,0
0,0,0,0,0,0,0,0,0,0,0,0,0,0,0,0,1038102,2024-01-08T00:00:00.000Z,56677842,29,Brice Sensabaugh,0,0,0,0,0,0
0,0,0,0,0,0,0,0,0,0,0,0,0,0,0,0,1038102,2024-01-08T00:00:00.000Z,38017630,29,Johnny Juzang,0,0,0,0,0,0
6,1,3,3,2,14,7,5,5,31,1,0,21,4,0,1,1038102,2024-01-08T00:00:00.000Z,100,29,Jordan Clarkson,1,25,31,27,10,36.8
0,0,0,0,0,0,0,0,0,0,0,0,0,0,0,0,1038102,2024-01-08T00:00:00.000Z,17896023,29,Josh Christopher,0,0,0,0,0,0
3,0,4,2,2,6,4,4,3,17,2,4,13,6,0,2,1038102,2024-01-08T00:00:00.000Z,358,29,Kelly Olynyk,0,19,22,16,9,22.7
4,0,6,9,4,13,7,1,1,23,0,0,19,6,0,2,1038102,2024-01-08T00:00:00.000Z,56677834,29,Keyonte George,0,25,29,23,10,30.2
0,0,0,0,0,0,0,0,0,0,0,0,0,0,0,0,1038102,2024-01-08T00:00:00.000Z,666881,29,Luka Samanic,0,0,0,0,0,0
0,0,0,0,0,0,0,0,0,0,0,0,0,0,0,0,1038102,2024-01-08T00:00:00.000Z,19465584,29,Micah Potter,0,0,0,0,0,0
0,0,1,1,0,2,1,0,0,15,0,1,2,1,0,0,1038102,2024-01-08T00:00:00.000Z,38017620,29,Ochai Agbaji,0,3,3,2,1,3.2
0,0,0,0,0,0,0,0,0,0,0,0,0,0,0,0,1038102,2024-01-08T00:00:00.000Z,11891374,29,Omer Yurtseven,0,0,0,0,0,0
0,0,0,0,0,0,0,0,0,0,0,0,0,0,0,0,1038102,2024-01-08T00:00:00.000Z,666650,29,Talen Horton-Tucker,0,0,0,0,0,0
0,0,0,0,0,0,0,0,0,0,0,0,0,0,0,0,1038102,2024-01-08T00:00:00.000Z,56677824,29,Taylor Hendricks,0,0,0,0,0,0
0,2,4,0,0,4,3,4,2,21,2,1,8,6,1,0,1038102,2024-01-08T00:00:00.000Z,38017705,29,Walker Kessler,3,14,14,8,6,24.2
0,0,2,1,1,5,4,0,0,23,0,3,9,2,0,0,1038103,2024-01-08T00:00:00.000Z,666511,13,Amir Coffey,0,11,11,9,2,11.4
0,0,0,1,1,2,2,0,0,5,0,2,5,0,0,1,1038103,2024-01-08T00:00:00.000Z,17896022,13,Brandon Boston Jr.,0,5,5,5,0,4
3,1,1,1,0,6,3,0,0,14,2,3,6,3,1,1,1038103,2024-01-08T00:00:00.000Z,439,13,Daniel Theis,2,9,12,9,6,19.1
3,1,6,0,0,9,8,6,3,28,2,3,19,8,1,0,1038103,2024-01-08T00:00:00.000Z,493,13,Ivica Zubac,2,27,30,22,11,39.1
10,0,7,4,3,8,6,4,4,30,0,1,19,7,0,3,1038103,2024-01-08T00:00:00.000Z,192,13,James Harden,0,26,36,29,17,39.4
0,0,0,0,0,0,0,0,0,0,0,0,0,0,0,0,1038103,2024-01-08T00:00:00.000Z,56677856,13,Jordan Miller,0,0,0,0,0,0
0,0,0,0,0,0,0,0,0,0,0,0,0,0,0,0,1038103,2024-01-08T00:00:00.000Z,17896051,13,Joshua Primo,0,0,0,0,0,0
2,1,3,3,1,15,8,0,0,32,0,1,17,3,5,3,1038103,2024-01-08T00:00:00.000Z,274,13,Kawhi Leonard,6,20,22,19,5,38.6
0,0,0,0,0,0,0,0,0,5,0,1,0,0,1,0,1038103,2024-01-08T00:00:00.000Z,56677849,13,Kobe Brown,1,0,0,0,0,3
3,0,2,0,0,0,0,2,1,5,0,0,1,2,0,0,1038103,2024-01-08T00:00:00.000Z,371,13,Mason Plumlee,0,3,6,4,5,7.9
0,0,0,0,0,0,0,0,0,0,0,0,0,0,0,0,1038103,2024-01-08T00:00:00.000Z,38017725,13,Moussa Diabate,0,0,0,0,0,0
0,0,0,0,0,0,0,0,0,0,0,0,0,0,0,0,1038103,2024-01-08T00:00:00.000Z,17896031,13,Nah'Shon Hyland,0,0,0,0,0,0
1,0,4,3,2,6,4,4,4,24,1,1,14,5,0,1,1038103,2024-01-08T00:00:00.000Z,380,13,Norman Powell,0,19,20,15,6,20.5
0,0,6,9,4,19,10,2,1,31,1,2,25,7,1,1,1038103,2024-01-08T00:00:00.000Z,172,13,Paul George,1,32,32,25,7,35.4
0,0,0,0,0,0,0,0,0,0,0,0,0,0,0,0,1038103,2024-01-08T00:00:00.000Z,450,13,PJ Tucker,0,0,0,0,0,0
7,0,0,1,0,6,3,3,3,15,2,2,9,2,2,1,1038103,2024-01-08T00:00:00.000Z,472,13,Russell Westbrook,2,11,18,16,9,26.9
3,0,2,6,3,9,5,2,1,28,3,2,14,5,0,1,1038103,2024-01-08T00:00:00.000Z,666743,13,Terance Mann,0,19,22,17,8,23.5
0,0,0,0,0,0,0,0,0,0,0,0,0,0,0,0,1038103,2024-01-08T00:00:00.000Z,24417679,13,Xavier Moon,0,0,0,0,0,0
2,0,3,2,0,15,7,2,1,35,0,4,15,3,2,2,1038103,2024-01-08T00:00:00.000Z,37,24,Bradley Beal,2,18,20,17,5,25.6
0,1,2,0,0,1,1,2,2,8,0,1,4,2,0,0,1038103,2024-01-08T00:00:00.000Z,314,24,Chimezie Metu,1,6,6,4,2,9.4
0,0,0,0,0,0,0,0,0,0,0,0,0,0,0,0,1038103,2024-01-08T00:00:00.000Z,272,24,Damion Lee,0,0,0,0,0,0
5,0,0,6,2,14,8,2,2,34,0,4,20,0,0,6,1038103,2024-01-08T00:00:00.000Z,57,24,Devin Booker,0,20,25,25,5,21.5
0,2,2,0,0,1,0,0,0,16,2,2,0,4,0,0,1038103,2024-01-08T00:00:00.000Z,147,24,Drew Eubanks,2,4,4,0,4,10.8
2,0,1,7,2,8,3,4,4,25,0,1,12,1,0,1,1038103,2024-01-08T00:00:00.000Z,178,24,Eric Gordon,0,13,15,14,3,15.2
2,0,3,3,1,3,1,5,5,31,0,1,8,3,0,1,1038103,2024-01-08T00:00:00.000Z,8,24,Grayson Allen,0,11,13,10,5,13.6
0,0,0,0,0,3,2,0,0,5,0,0,4,0,0,0,1038103,2024-01-08T00:00:00.000Z,18678058,24,Jordan Goodwin,0,4,4,4,0,4
2,0,2,2,1,8,3,2,1,21,1,1,8,3,1,0,1038103,2024-01-08T00:00:00.000Z,349,24,Jusuf Nurkic,1,11,13,10,5,17.6
2,1,7,6,3,17,10,8,7,35,0,2,30,7,0,3,1038103,2024-01-08T00:00:00.000Z,140,24,Kevin Durant,1,37,39,32,9,41.4
0,0,0,0,0,0,0,0,0,0,0,0,0,0,0,0,1038103,2024-01-08T00:00:00.000Z,666729,24,Nassir Little,0,0,0,0,0,0
0,0,0,0,0,0,0,0,0,0,0,0,0,0,0,0,1038103,2024-01-08T00:00:00.000Z,3547253,24,Theo Maledon,0,0,0,0,0,0
0,0,0,2,0,2,0,2,1,5,0,1,1,0,0,0,1038103,2024-01-08T00:00:00.000Z,470,24,Yuta Watanabe,0,1,1,1,0,1
1,0,3,7,3,11,5,5,3,20,0,0,16,3,1,2,1038104,2024-01-09T00:00:00.000Z,77,9,Alec Burks,1,19,20,17,4,22.1
0,0,2,0,0,2,0,0,0,13,0,3,0,2,3,0,1038104,2024-01-09T00:00:00.000Z,56677826,9,Ausar Thompson,3,2,2,0,2,11.4
2,0,4,7,4,14,10,3,2,33,1,1,26,5,3,3,1038104,2024-01-09T00:00:00.000Z,54,9,Bojan Bogdanovic,3,31,33,28,7,41
0,0,0,0,0,0,0,0,0,0,0,0,0,0,0,0,1038104,2024-01-09T00:00:00.000Z,17896075,9,Cade Cunningham,0,0,0,0,0,0
2,0,0,2,1,3,1,0,0,15,1,0,3,1,0,0,1038104,2024-01-09T00:00:00.000Z,17896071,9,Isaiah Livers,0,4,6,5,3,7.2
0,0,0,0,0,0,0,0,0,0,0,0,0,0,0,0,1038104,2024-01-09T00:00:00.000Z,3547267,9,Isaiah Stewart,0,0,0,0,0,0
6,0,0,9,2,17,7,8,6,33,5,4,22,5,2,4,1038104,2024-01-09T00:00:00.000Z,38017682,9,Jaden Ivey,2,27,33,28,11,39
3,0,7,0,0,14,8,0,0,24,3,4,16,10,0,3,1038104,2024-01-09T00:00:00.000Z,38017694,9,Jalen Duren,0,26,29,19,13,29.5
1,1,4,0,0,3,2,0,0,24,1,2,4,5,0,1,1038104,2024-01-09T00:00:00.000Z,3547240,9,James Wiseman,1,9,10,5,6,13.5
0,0,0,0,0,0,0,0,0,0,0,0,0,0,0,0,1038104,2024-01-09T00:00:00.000Z,42097199,9,Jared Rhoden,0,0,0,0,0,0
0,0,1,5,3,5,3,0,0,9,0,2,9,1,0,0,1038104,2024-01-09T00:00:00.000Z,197,9,Joe Harris,0,10,10,9,1,10.2
1,0,1,4,1,8,3,1,1,20,1,1,8,2,1,2,1038104,2024-01-09T00:00:00.000Z,259,9,Kevin Knox,1,10,11,9,3,12.9
7,0,3,1,0,4,1,2,2,31,1,2,4,4,1,6,1038104,2024-01-09T00:00:00.000Z,3547241,9,Killian Hayes,1,8,15,11,11,16.3
0,0,0,0,0,0,0,0,0,0,0,0,0,0,0,0,1038104,2024-01-09T00:00:00.000Z,56677729,9,Malcolm Cazalon,0,0,0,0,0,0
4,1,2,2,0,4,0,2,2,18,0,0,2,2,1,0,1038104,2024-01-09T00:00:00.000Z,56677792,9,Marcus Sasser,2,4,8,6,6,16.4
0,0,0,0,0,0,0,0,0,0,0,0,0,0,0,0,1038104,2024-01-09T00:00:00.000Z,330,9,Monte Morris,0,0,0,0,0,0
0,0,0,0,0,0,0,0,0,0,0,0,0,0,0,0,1038104,2024-01-09T00:00:00.000Z,44477024,9,Stanley Umude,0,0,0,0,0,0
0,0,0,0,0,0,0,0,0,0,0,0,0,0,0,0,1038104,2024-01-09T00:00:00.000Z,4197162,26,Aleksandar Vezenkov,0,0,0,0,0,0
0,0,0,0,0,0,0,0,0,0,0,0,0,0,0,0,1038104,2024-01-09T00:00:00.000Z,17896030,26,Chris Duarte,0,0,0,0,0,0
0,0,0,0,0,0,0,0,0,0,0,0,0,0,0,0,1038104,2024-01-09T00:00:00.000Z,56677845,26,Colby Jones,0,0,0,0,0,0
4,0,3,7,4,19,10,2,2,33,0,2,26,3,2,5,1038104,2024-01-09T00:00:00.000Z,161,26,De'Aaron Fox,2,29,33,30,7,36.6
13,0,5,1,1,21,16,4,4,38,5,3,37,10,3,5,1038104,2024-01-09T00:00:00.000Z,406,26,Domantas Sabonis,3,47,60,50,23,72.5
1,0,1,0,0,1,0,2,0,14,0,0,0,1,0,0,1038104,2024-01-09T00:00:00.000Z,30,26,Harrison Barnes,0,1,2,1,2,2.7
0,0,0,0,0,0,0,0,0,0,0,0,0,0,0,0,1038104,2024-01-09T00:00:00.000Z,56677862,26,Jalen Slawson,0,0,0,0,0,0
0,0,0,0,0,0,0,0,0,0,0,0,0,0,0,0,1038104,2024-01-09T00:00:00.000Z,306,26,JaVale McGee,0,0,0,0,0,0
0,0,0,0,0,0,0,0,0,0,0,0,0,0,0,0,1038104,2024-01-09T00:00:00.000Z,17895990,26,Jordan Ford,0,0,0,0,0,0
1,0,4,1,0,3,0,0,0,14,2,4,0,6,0,1,1038104,2024-01-09T00:00:00.000Z,666925,26,Juan Toscano-Anderson,0,6,7,1,7,7.7
2,2,5,9,5,17,13,1,1,35,0,2,32,5,1,1,1038104,2024-01-09T00:00:00.000Z,38017688,26,Keegan Murray,3,37,39,34,7,49
0,0,0,0,0,0,0,0,0,5,0,1,0,0,0,0,1038104,2024-01-09T00:00:00.000Z,38017714,26,Keon Ellis,0,0,0,0,0,0
5,1,5,6,0,11,2,0,0,29,0,1,4,5,1,0,1038104,2024-01-09T00:00:00.000Z,221,26,Kevin Huerter,2,9,14,9,10,23.5
9,2,2,6,2,15,9,0,0,28,0,5,20,2,1,3,1038104,2024-01-09T00:00:00.000Z,324,26,Malik Monk,3,22,31,29,11,41.9
3,0,7,3,1,4,1,4,3,32,1,2,6,8,0,1,1038104,2024-01-09T00:00:00.000Z,290,26,Trey Lyles,0,14,17,9,11,19.1
0,0,0,0,0,0,0,0,0,0,0,0,0,0,0,0,1038105,2024-01-09T00:00:00.000Z,17895968,18,Daishen Nix,0,0,0,0,0,0
0,0,0,0,0,0,0,0,0,0,0,0,0,0,0,0,1038105,2024-01-09T00:00:00.000Z,56677851,18,Jaylen Clark,0,0,0,0,0,0
5,0,0,1,0,3,2,0,0,16,0,1,4,0,1,1,1038105,2024-01-09T00:00:00.000Z,666767,18,Jordan McLaughlin,1,4,9,9,5,13.5
0,0,0,0,0,0,0,0,0,0,0,0,0,0,0,0,1038105,2024-01-09T00:00:00.000Z,38017715,18,Josh Minott,0,0,0,0,0,0
0,0,0,0,0,0,0,0,0,0,0,0,0,0,0,0,1038105,2024-01-09T00:00:00.000Z,56677782,18,Leonard Miller,0,0,0,0,0,0
0,0,0,0,0,0,0,0,0,0,0,0,0,0,0,0,1038105,2024-01-09T00:00:00.000Z,17896056,18,Luka Garza,0,0,0,0,0,0
3,1,2,4,0,5,0,0,0,18,0,1,0,2,0,2,1038105,2024-01-09T00:00:00.000Z,666400,18,Nickeil Alexander-Walker,1,2,5,3,5,7.9
0,0,0,0,0,2,2,0,0,2,0,0,4,0,0,0,1038105,2024-01-09T00:00:00.000Z,320,18,Shake Milton,0,4,4,4,0,4
1,0,1,2,0,2,0,0,0,2,0,0,0,1,0,0,1038105,2024-01-09T00:00:00.000Z,68,18,Troy Brown Jr.,0,1,2,1,2,2.7
0,0,0,0,0,0,0,0,0,0,0,0,0,0,0,0,1038105,2024-01-09T00:00:00.000Z,38017700,18,Wendell Moore Jr.,0,0,0,0,0,0
0,0,0,0,0,0,0,0,0,0,0,0,0,0,0,0,1038105,2024-01-09T00:00:00.000Z,666885,22,Admiral Schofield,0,0,0,0,0,0
4,1,1,3,1,4,1,0,0,21,0,2,3,1,3,2,1038105,2024-01-09T00:00:00.000Z,56677827,22,Anthony Black,4,4,8,7,5,20.2
2,0,4,10,2,12,3,0,0,34,3,2,8,7,0,0,1038105,2024-01-09T00:00:00.000Z,38017724,22,Caleb Houstan,0,15,17,10,9,19.4
1,1,8,8,1,10,1,0,0,27,2,2,3,10,0,0,1038105,2024-01-09T00:00:00.000Z,666818,22,Chuma Okeke,1,13,14,4,11,19.5
0,0,0,1,0,4,1,0,0,7,1,2,2,1,0,0,1038105,2024-01-09T00:00:00.000Z,3547251,22,Cole Anthony,0,3,3,2,1,3.2
0,0,0,0,0,0,0,0,0,0,0,0,0,0,0,0,1038105,2024-01-09T00:00:00.000Z,196,22,Gary Harris,0,0,0,0,0,0
1,2,2,0,0,3,1,0,0,17,4,4,2,6,1,1,1038105,2024-01-09T00:00:00.000Z,666442,22,Goga Bitadze,3,8,9,3,7,18.7
2,0,4,8,4,14,8,1,0,27,1,2,20,5,3,2,1038105,2024-01-09T00:00:00.000Z,17896073,22,Jalen Suggs,3,25,27,22,7,36
0,0,0,0,0,0,0,0,0,0,0,0,0,0,0,0,1038105,2024-01-09T00:00:00.000Z,56677839,22,Jett Howard,0,0,0,0,0,0
0,0,0,0,0,0,0,0,0,0,0,0,0,0,0,0,1038105,2024-01-09T00:00:00.000Z,226,22,Joe Ingles,0,0,0,0,0,0
0,0,0,0,0,0,0,0,0,0,0,0,0,0,0,0,1038105,2024-01-09T00:00:00.000Z,229,22,Jonathan Isaac,0,0,0,0,0,0
0,0,0,0,0,0,0,0,0,0,0,0,0,0,0,0,1038105,2024-01-09T00:00:00.000Z,38017607,22,Kevon Harris,0,0,0,0,0,0
2,0,2,0,0,7,2,0,0,13,1,0,4,3,0,0,1038105,2024-01-09T00:00:00.000Z,165,22,Markelle Fultz,0,7,9,6,5,10.6
2,0,5,4,1,9,6,11,8,31,3,3,21,8,2,1,1038105,2024-01-09T00:00:00.000Z,462,22,Moritz Wagner,2,29,31,23,10,38.6
3,1,2,4,1,22,8,4,1,35,0,4,18,2,3,4,1038105,2024-01-09T00:00:00.000Z,38017683,22,Paolo Banchero,4,20,23,21,5,32.9
3,0,2,4,3,9,3,2,2,28,1,1,11,3,1,2,1038105,2024-01-09T00:00:00.000Z,17553983,22,Trevelin Queen,1,14,17,14,6,20.1
0,0,0,0,0,0,0,0,0,0,0,0,0,0,0,0,1038105,2024-01-09T00:00:00.000Z,85,22,Wendell Carter Jr.,0,0,0,0,0,0
0,0,0,0,0,0,0,0,0,0,0,0,0,0,0,0,1038106,2024-01-09T00:00:00.000Z,666474,20,Charles Brown,0,0,0,0,0,0
0,0,0,0,0,0,0,0,0,0,0,0,0,0,0,0,1038106,2024-01-09T00:00:00.000Z,17896089,20,Duane Washington Jr.,0,0,0,0,0,0
0,0,0,0,0,0,0,0,0,0,0,0,0,0,0,0,1038106,2024-01-09T00:00:00.000Z,160,20,Evan Fournier,0,0,0,0,0,0
3,1,9,0,0,1,1,4,3,28,5,3,5,14,3,2,1038106,2024-01-09T00:00:00.000Z,201,20,Isaiah Hartenstein,4,19,22,8,17,36.3
0,0,0,0,0,0,0,0,0,0,0,0,0,0,0,0,1038106,2024-01-09T00:00:00.000Z,56677795,20,Jacob Toppin,0,0,0,0,0,0
7,0,2,7,1,11,3,6,5,26,1,0,12,3,0,0,1038106,2024-01-09T00:00:00.000Z,73,20,Jalen Brunson,0,15,22,19,10,26.1
0,0,1,0,0,0,0,0,0,7,0,0,0,1,1,1,1038106,2024-01-09T00:00:00.000Z,17896063,20,Jericho Sims,1,1,1,0,1,3.2
8,1,7,4,2,17,7,4,4,32,0,1,20,7,0,2,1038106,2024-01-09T00:00:00.000Z,387,20,Julius Randle,1,27,35,28,15,41.4
0,0,0,1,0,1,0,2,2,4,0,0,2,0,0,0,1038106,2024-01-09T00:00:00.000Z,3547275,20,Malachi Flynn,0,2,2,2,0,2
0,0,0,0,0,0,0,0,0,0,0,0,0,0,0,0,1038106,2024-01-09T00:00:00.000Z,399,20,Mitchell Robinson,0,0,0,0,0,0
0,1,2,6,4,12,9,2,1,29,2,3,23,4,1,1,1038106,2024-01-09T00:00:00.000Z,18,20,OG Anunoby,2,27,27,23,4,32.8
1,0,4,9,4,11,5,3,3,21,0,1,17,4,3,2,1038106,2024-01-09T00:00:00.000Z,17895858,20,Quentin Grimes,3,21,22,18,5,30.3
0,0,0,1,0,1,0,0,0,6,0,2,0,0,0,0,1038106,2024-01-09T00:00:00.000Z,19,20,Ryan Arcidiacono,0,0,0,0,0,0
0,0,0,0,0,0,0,0,0,0,0,0,0,0,0,0,1038106,2024-01-09T00:00:00.000Z,22,25,Deandre Ayton,0,0,0,0,0,0
0,0,0,0,0,0,0,0,0,0,0,0,0,0,0,0,1038106,2024-01-09T00:00:00.000Z,38017711,25,Jabari Walker,0,0,0,0,0,0
0,1,1,1,0,1,0,0,0,12,0,0,0,1,1,0,1038106,2024-01-09T00:00:00.000Z,666923,25,Matisse Thybulle,2,1,1,0,1,7.2
0,0,0,0,0,0,0,0,0,0,0,0,0,0,0,0,1038106,2024-01-09T00:00:00.000Z,666476,25,Moses Brown,0,0,0,0,0,0
0,0,0,0,0,0,0,0,0,0,0,0,0,0,0,0,1038106,2024-01-09T00:00:00.000Z,476,25,Robert Williams III,0,0,0,0,0,0
2,2,3,3,1,4,2,0,0,25,3,3,5,6,1,2,1038106,2024-01-09T00:00:00.000Z,56677850,25,Toumani Camara,3,11,13,7,8,22.2
2,1,4,1,0,9,5,1,1,36,0,1,11,4,0,0,1038107,2024-01-09T00:00:00.000Z,247,7,Derrick Jones Jr.,1,15,17,13,6,21.8
3,1,3,0,0,3,2,0,0,22,1,3,4,4,2,2,1038107,2024-01-09T00:00:00.000Z,379,7,Dwight Powell,3,8,11,7,7,20.3
1,0,1,4,2,7,4,0,0,19,0,2,10,1,0,1,1038107,2024-01-09T00:00:00.000Z,38017679,7,Jaden Hardy,0,11,12,11,2,11.7
0,1,2,1,0,3,0,0,0,23,1,1,0,3,0,0,1038107,2024-01-09T00:00:00.000Z,3547258,7,Josh Green,1,3,3,0,3,6.6
4,1,4,7,2,25,11,10,9,40,4,3,33,8,4,3,1038107,2024-01-09T00:00:00.000Z,228,7,Kyrie Irving,5,41,45,37,12,60.6
6,0,6,8,2,21,9,15,11,36,0,1,31,6,3,3,1038107,2024-01-09T00:00:00.000Z,132,7,Luka Doncic,3,37,43,37,12,53.2
0,0,0,0,0,0,0,0,0,0,0,0,0,0,0,0,1038107,2024-01-09T00:00:00.000Z,257,7,Maxi Kleber,0,0,0,0,0,0
1,0,0,0,0,0,0,0,0,3,1,0,0,1,0,0,1038107,2024-01-09T00:00:00.000Z,217,7,Richaun Holmes,0,1,2,1,2,2.7
0,0,0,1,0,2,1,0,0,10,0,1,2,0,0,1,1038107,2024-01-09T00:00:00.000Z,114,7,Seth Curry,0,2,2,2,0,1
2,0,3,3,2,6,3,1,1,30,0,3,9,3,0,1,1038107,2024-01-09T00:00:00.000Z,191,7,Tim Hardaway Jr.,0,12,14,11,5,14.6
0,0,0,0,0,0,0,0,0,0,0,0,0,0,0,0,1038107,2024-01-09T00:00:00.000Z,666505,15,Brandon Clarke,0,0,0,0,0,0
0,0,0,0,0,0,0,0,0,0,0,0,0,0,0,0,1038107,2024-01-09T00:00:00.000Z,401,15,Derrick Rose,0,0,0,0,0,0
0,0,0,1,0,2,0,0,0,2,0,0,0,0,0,0,1038107,2024-01-09T00:00:00.000Z,56677830,15,GG Jackson,0,0,0,0,0,0
0,0,0,0,0,0,0,0,0,0,0,0,0,0,0,0,1038107,2024-01-09T00:00:00.000Z,666786,15,Ja Morant,0,0,0,0,0,0
0,0,0,0,0,0,0,0,0,0,0,0,0,0,0,0,1038107,2024-01-09T00:00:00.000Z,48248287,15,Jacob Gilyard,0,0,0,0,0,0
0,0,1,0,0,1,0,0,0,2,0,0,0,1,0,0,1038107,2024-01-09T00:00:00.000Z,38017728,15,Jake LaRavia,0,1,1,0,1,1.2
0,0,0,0,0,0,0,0,0,0,0,0,0,0,0,0,1038107,2024-01-09T00:00:00.000Z,231,15,Jaren Jackson Jr.,0,0,0,0,0,0
4,0,4,4,3,7,5,1,1,23,1,2,14,5,1,2,1038107,2024-01-09T00:00:00.000Z,254,15,Luke Kennard,1,19,23,18,9,27
0,0,0,0,0,0,0,0,0,0,0,0,0,0,0,0,1038107,2024-01-09T00:00:00.000Z,17896067,15,Santi Aldama,0,0,0,0,0,0
0,0,0,0,0,0,0,0,0,0,0,0,0,0,0,0,1038107,2024-01-09T00:00:00.000Z,3,15,Steven Adams,0,0,0,0,0,0
6,0,4,5,2,8,2,0,0,30,2,5,6,6,3,3,1038107,2024-01-09T00:00:00.000Z,38017731,15,Vince Williams Jr.,3,12,18,12,12,28.2
0,0,0,0,0,0,0,0,0,0,0,0,0,0,0,0,1038108,2024-01-09T00:00:00.000Z,56677738,14,Colin Castleton,0,0,0,0,0,0
0,0,0,0,0,0,0,0,0,0,0,0,0,0,0,0,1038108,2024-01-09T00:00:00.000Z,666971,14,Dylan Windler,0,0,0,0,0,0
0,0,0,0,0,0,0,0,0,0,0,0,0,0,0,0,1038108,2024-01-09T00:00:00.000Z,56677835,14,Jalen Hood-Schifino,0,0,0,0,0,0
0,0,0,0,0,0,0,0,0,0,0,0,0,0,0,0,1038108,2024-01-09T00:00:00.000Z,666626,14,Jaxson Hayes,0,0,0,0,0,0
2,0,3,1,1,2,2,2,1,18,1,0,6,4,0,0,1038108,2024-01-09T00:00:00.000Z,38017697,14,Max Christie,0,10,12,8,6,13.8
0,0,0,0,0,0,0,0,0,0,0,0,0,0,0,0,1038108,2024-01-09T00:00:00.000Z,56677836,14,Maxwell Lewis,0,0,0,0,0,0
0,0,0,0,0,0,0,0,0,0,0,0,0,0,0,0,1038108,2024-01-09T00:00:00.000Z,3547289,14,Skylar Mays,0,0,0,0,0,0
1,0,7,2,0,3,1,0,0,14,0,1,2,7,2,3,1038108,2024-01-09T00:00:00.000Z,58,28,Chris Boucher,2,9,10,3,8,14.9
6,0,1,3,2,6,3,2,2,30,1,2,10,2,0,2,1038108,2024-01-09T00:00:00.000Z,409,28,Dennis Schroder,0,12,18,16,8,19.4
0,0,0,0,0,0,0,0,0,0,0,0,0,0,0,0,1038108,2024-01-09T00:00:00.000Z,436,28,Garrett Temple,0,0,0,0,0,0
1,0,1,6,4,10,5,0,0,24,0,1,14,1,0,0,1038108,2024-01-09T00:00:00.000Z,3089,28,Gary Trent Jr.,0,15,16,15,2,16.7
5,0,4,6,4,14,8,3,1,26,1,6,21,5,0,1,1038108,2024-01-09T00:00:00.000Z,3547269,28,Immanuel Quickley,0,26,31,26,10,33.5
0,0,0,0,0,0,0,0,0,0,0,0,0,0,0,0,1038108,2024-01-09T00:00:00.000Z,666762,28,Jalen McDaniels,0,0,0,0,0,0
3,0,0,2,0,2,0,0,0,10,0,0,0,0,1,0,1038108,2024-01-09T00:00:00.000Z,2309958,28,Jontay Porter,1,0,3,3,3,7.5
0,0,0,0,0,0,0,0,0,0,0,0,0,0,0,0,1038108,2024-01-09T00:00:00.000Z,376,28,Otto Porter Jr.,0,0,0,0,0,0
3,1,4,5,3,17,10,3,2,32,0,2,25,4,0,1,1038108,2024-01-09T00:00:00.000Z,416,28,Pascal Siakam,1,29,32,28,7,36.3
5,0,9,3,1,13,10,3,2,35,1,4,23,10,2,3,1038108,2024-01-09T00:00:00.000Z,666423,28,RJ Barrett,2,33,38,28,15,45.5
6,2,2,7,3,20,11,2,1,40,1,6,26,3,0,2,1038108,2024-01-09T00:00:00.000Z,17896055,28,Scottie Barnes,2,29,35,32,9,42.6
4,1,4,1,0,9,5,0,0,29,1,4,10,5,3,0,1038108,2024-01-09T00:00:00.000Z,489,28,Thaddeus Young,4,15,19,14,9,34
5,0,7,6,3,8,3,0,0,38,1,3,9,8,0,1,1038109,2024-01-10T00:00:00.000Z,219,2,Al Horford,0,17,22,14,13,25.1
6,0,4,5,1,11,3,2,2,44,2,5,9,6,0,2,1038109,2024-01-10T00:00:00.000Z,473,2,Derrick White,0,15,21,15,12,23.2
3,1,10,7,4,16,9,13,13,43,1,1,35,11,2,2,1038109,2024-01-10T00:00:00.000Z,70,2,Jaylen Brown,3,46,49,38,14,59.7
2,0,4,11,6,26,13,14,13,42,0,3,45,4,1,1,1038109,2024-01-10T00:00:00.000Z,434,2,Jayson Tatum,1,49,51,47,6,54.8
4,1,4,10,2,15,5,0,0,40,1,3,12,5,2,2,1038109,2024-01-10T00:00:00.000Z,214,2,Jrue Holiday,3,17,21,16,9,31
0,1,4,5,2,6,2,0,0,18,0,2,6,4,0,0,1038109,2024-01-10T00:00:00.000Z,17896060,2,Sam Hauser,1,10,10,6,4,13.8
0,0,0,0,0,0,0,0,0,0,0,0,0,0,0,0,1038109,2024-01-10T00:00:00.000Z,176,18,Rudy Gobert,0,0,0,0,0,0
0,0,0,0,0,0,0,0,0,0,0,0,0,0,0,0,1038110,2024-01-10T00:00:00.000Z,56677848,4,Amari Bailey,0,0,0,0,0,0
0,0,0,0,0,0,0,0,0,0,0,0,0,0,0,0,1038110,2024-01-10T00:00:00.000Z,347,4,Frank Ntilikina,0,0,0,0,0,0
0,0,1,0,0,3,1,0,0,16,0,1,2,1,0,0,1038110,2024-01-10T00:00:00.000Z,422,4,Ish Smith,0,3,3,2,1,3.2
1,0,0,6,2,8,3,0,0,20,0,0,8,0,0,0,1038110,2024-01-10T00:00:00.000Z,17896037,4,James Bouknight,0,8,9,9,1,9.5
0,0,3,2,0,7,1,0,0,21,2,2,2,5,0,0,1038110,2024-01-10T00:00:00.000Z,18678001,4,JT Thor,0,7,7,2,5,8
1,0,3,8,2,15,4,2,1,25,0,3,11,3,0,2,1038110,2024-01-10T00:00:00.000Z,56677846,4,Nick Smith Jr.,0,14,15,12,4,14.1
0,0,0,0,0,0,0,0,0,0,0,0,0,0,0,0,1038110,2024-01-10T00:00:00.000Z,4197162,26,Aleksandar Vezenkov,0,0,0,0,0,0
0,0,0,0,0,0,0,0,0,0,0,0,0,0,0,0,1038110,2024-01-10T00:00:00.000Z,56677862,26,Jalen Slawson,0,0,0,0,0,0
0,0,0,0,0,0,0,0,0,0,0,0,0,0,0,0,1038110,2024-01-10T00:00:00.000Z,17895990,26,Jordan Ford,0,0,0,0,0,0
0,1,2,1,0,4,1,0,0,17,1,2,2,3,0,0,1038110,2024-01-10T00:00:00.000Z,666925,26,Juan Toscano-Anderson,1,5,5,2,3,8.6
0,0,0,0,0,0,0,0,0,0,0,0,0,0,0,0,1038110,2024-01-10T00:00:00.000Z,17896044,26,Kessler Edwards,0,0,0,0,0,0
2,0,2,5,1,13,5,4,4,20,0,1,15,2,0,1,1038111,2024-01-10T00:00:00.000Z,77,9,Alec Burks,0,17,19,17,4,19.4
1,1,6,3,0,6,1,1,1,15,0,4,3,6,0,1,1038111,2024-01-10T00:00:00.000Z,56677826,9,Ausar Thompson,1,9,10,4,7,13.7
2,0,2,5,3,13,8,0,0,33,0,1,19,2,1,4,1038111,2024-01-10T00:00:00.000Z,54,9,Bojan Bogdanovic,1,21,23,21,4,23.4
0,0,0,0,0,0,0,0,0,0,0,0,0,0,0,0,1038111,2024-01-10T00:00:00.000Z,17896075,9,Cade Cunningham,0,0,0,0,0,0
0,0,2,3,2,3,2,0,0,17,2,1,6,4,1,0,1038111,2024-01-10T00:00:00.000Z,17896071,9,Isaiah Livers,1,10,10,6,4,13.8
0,0,0,0,0,0,0,0,0,0,0,0,0,0,0,0,1038111,2024-01-10T00:00:00.000Z,3547267,9,Isaiah Stewart,0,0,0,0,0,0
5,2,3,10,2,18,7,5,3,30,0,0,19,3,2,1,1038111,2024-01-10T00:00:00.000Z,38017682,9,Jaden Ivey,4,22,27,24,8,41.1
2,0,10,0,0,16,10,1,1,30,2,4,21,12,0,1,1038111,2024-01-10T00:00:00.000Z,38017694,9,Jalen Duren,0,33,35,23,14,37.4
3,0,3,0,0,1,1,2,1,17,0,2,3,3,0,0,1038111,2024-01-10T00:00:00.000Z,3547240,9,James Wiseman,0,6,9,6,6,11.1
0,0,1,0,0,0,0,0,0,6,0,1,0,1,0,0,1038111,2024-01-10T00:00:00.000Z,197,9,Joe Harris,0,1,1,0,1,1.2
0,0,1,5,2,11,5,0,0,24,3,2,12,4,0,0,1038111,2024-01-10T00:00:00.000Z,259,9,Kevin Knox,0,16,16,12,4,16.8
12,0,3,0,0,8,2,0,0,32,1,1,4,4,0,1,1038111,2024-01-10T00:00:00.000Z,3547241,9,Killian Hayes,0,8,20,16,16,25.8
0,0,0,0,0,0,0,0,0,0,0,0,0,0,0,0,1038111,2024-01-10T00:00:00.000Z,56677729,9,Malcolm Cazalon,0,0,0,0,0,0
5,0,1,1,0,7,3,0,0,16,1,2,6,2,0,1,1038111,2024-01-10T00:00:00.000Z,56677792,9,Marcus Sasser,0,8,13,11,7,14.9
0,0,0,0,0,0,0,0,0,0,0,0,0,0,0,0,1038111,2024-01-10T00:00:00.000Z,24,9,Marvin Bagley III,0,0,0,0,0,0
0,0,0,0,0,0,0,0,0,0,0,0,0,0,0,0,1038111,2024-01-10T00:00:00.000Z,330,9,Monte Morris,0,0,0,0,0,0
0,0,0,0,0,0,0,0,0,0,0,0,0,0,0,0,1038112,2024-01-10T00:00:00.000Z,3547264,12,Jalen Smith,0,0,0,0,0,0
0,0,0,0,0,0,0,0,0,0,0,0,0,0,0,0,1038112,2024-01-10T00:00:00.000Z,56677778,12,Oscar Tshiebwe,0,0,0,0,0,0
0,0,0,0,0,0,0,0,0,0,0,0,0,0,0,0,1038112,2024-01-10T00:00:00.000Z,3547302,30,Anthony Gill,0,0,0,0,0,0
0,0,0,0,0,0,0,0,0,0,0,0,0,0,0,0,1038112,2024-01-10T00:00:00.000Z,167,30,Danilo Gallinari,0,0,0,0,0,0
0,0,0,0,0,0,0,0,0,0,0,0,0,0,0,0,1038112,2024-01-10T00:00:00.000Z,17896106,30,Eugene Omoruyi,0,0,0,0,0,0
0,0,0,0,0,0,0,0,0,0,0,0,0,0,0,0,1038112,2024-01-10T00:00:00.000Z,18677954,30,Jared Butler,0,0,0,0,0,0
0,0,0,0,0,0,0,0,0,0,0,0,0,0,0,0,1038112,2024-01-10T00:00:00.000Z,414,30,Landry Shamet,0,0,0,0,0,0
0,0,0,0,0,0,0,0,0,0,0,0,0,0,0,0,1038113,2024-01-10T00:00:00.000Z,4197387,1,Vit Krejci,0,0,0,0,0,0
0,0,0,0,0,0,0,0,0,0,0,0,0,0,0,0,1038113,2024-01-10T00:00:00.000Z,145,23,Joel Embiid,0,0,0,0,0,0
0,0,0,0,0,0,0,0,0,0,0,0,0,0,0,0,1038113,2024-01-10T00:00:00.000Z,38017732,23,Kenneth Lofton Jr.,0,0,0,0,0,0
0,0,0,0,0,0,0,0,0,0,0,0,0,0,0,0,1038113,2024-01-10T00:00:00.000Z,56677788,23,Terquavion Smith,0,0,0,0,0,0
0,0,0,0,0,4,1,0,0,8,0,1,2,0,0,0,1038114,2024-01-10T00:00:00.000Z,17896078,21,Aaron Wiggins,0,2,2,2,0,2
0,0,0,0,0,0,0,0,0,0,0,0,0,0,0,0,1038114,2024-01-10T00:00:00.000Z,3547271,21,Aleksej Pokusevski,0,0,0,0,0,0
1,0,1,4,2,5,3,0,0,18,1,2,8,2,0,1,1038114,2024-01-10T00:00:00.000Z,56677833,21,Cason Wallace,0,10,11,9,3,10.9
0,0,0,0,0,0,0,0,0,0,0,0,0,0,0,0,1038114,2024-01-10T00:00:00.000Z,44,21,Davis Bertans,0,0,0,0,0,0
4,0,2,2,1,2,1,0,0,12,0,2,3,2,0,0,1038114,2024-01-10T00:00:00.000Z,38017706,21,Jaylin Williams,0,5,9,7,6,11.4
2,0,7,2,1,6,3,2,2,20,0,0,9,7,1,2,1038114,2024-01-10T00:00:00.000Z,17896065,21,Josh Giddey,1,16,18,11,9,21.4
2,0,5,2,1,4,3,0,0,17,1,0,7,6,0,2,1038114,2024-01-10T00:00:00.000Z,480,21,Kenrich Williams,0,13,15,9,8,15.2
0,0,0,0,0,0,0,0,0,0,0,0,0,0,0,0,1038114,2024-01-10T00:00:00.000Z,27924547,21,Lindy Waters III,0,0,0,0,0,0
0,0,0,0,0,0,0,0,0,0,0,0,0,0,0,0,1038114,2024-01-10T00:00:00.000Z,38017716,21,Ousmane Dieng,0,0,0,0,0,0
8,1,2,5,2,17,11,5,4,34,0,3,28,2,1,3,1038114,2024-01-10T00:00:00.000Z,175,21,Shai Gilgeous-Alexander,2,30,38,36,10,45.4
3,1,4,9,2,10,3,6,4,32,2,3,12,6,1,0,1038115,2024-01-10T00:00:00.000Z,89,5,Alex Caruso,2,18,21,15,9,29.7
0,0,0,0,0,2,2,0,0,13,0,1,4,0,2,3,1038115,2024-01-10T00:00:00.000Z,137,5,Andre Drummond,2,4,4,4,0,7
3,0,2,4,2,8,3,0,0,18,2,0,8,4,0,0,1038115,2024-01-10T00:00:00.000Z,17895983,5,Ayo Dosunmu,0,12,15,11,7,17.3
8,1,4,11,6,17,9,7,6,43,0,1,30,4,0,4,1038115,2024-01-10T00:00:00.000Z,666956,5,Coby White,1,34,42,38,12,45.8
1,0,0,1,1,1,1,0,0,6,0,1,3,0,0,0,1038115,2024-01-10T00:00:00.000Z,38017719,5,Dalen Terry,0,3,4,4,1,4.5
4,0,4,6,3,19,5,6,6,43,0,2,19,4,0,1,1038115,2024-01-10T00:00:00.000Z,125,5,DeMar DeRozan,0,23,27,23,8,28.8
0,0,0,0,0,0,0,0,0,0,0,0,0,0,0,0,1038115,2024-01-10T00:00:00.000Z,87,5,Jevon Carter,0,0,0,0,0,0
3,1,12,5,0,17,9,0,0,40,3,4,18,15,0,0,1038115,2024-01-10T00:00:00.000Z,460,5,Nikola Vucevic,1,33,36,21,18,43.5
1,0,0,3,1,6,2,0,0,29,0,2,5,0,3,2,1038115,2024-01-10T00:00:00.000Z,3547248,5,Patrick Williams,3,5,6,6,1,13.5
0,0,0,0,0,0,0,0,0,0,0,0,0,0,0,0,1038115,2024-01-10T00:00:00.000Z,17896116,5,Terry Taylor,0,0,0,0,0,0
0,0,0,0,0,0,0,0,0,0,0,0,0,0,0,0,1038115,2024-01-10T00:00:00.000Z,110,5,Torrey Craig,0,0,0,0,0,0
7,1,12,8,4,15,8,6,5,41,1,5,25,13,3,4,1038115,2024-01-10T00:00:00.000Z,268,5,Zach LaVine,4,38,45,32,20,59.1
3,0,2,3,0,7,3,0,0,14,0,2,6,2,1,2,1038115,2024-01-10T00:00:00.000Z,56677825,11,Amen Thompson,1,8,11,9,5,13.9
1,0,4,5,2,12,6,2,2,33,1,1,16,5,2,1,1038115,2024-01-10T00:00:00.000Z,56677831,11,Cam Whitmore,2,21,22,17,6,28.5
0,0,0,0,0,0,0,0,0,0,0,0,0,0,0,0,1038115,2024-01-10T00:00:00.000Z,66,11,Dillon Brooks,0,0,0,0,0,0
0,0,0,0,0,0,0,0,0,0,0,0,0,0,0,0,1038115,2024-01-10T00:00:00.000Z,47738533,11,Jeenathan Williams,0,0,0,0,0,0
0,0,0,0,0,0,0,0,0,0,0,0,0,0,0,0,1038115,2024-01-10T00:00:00.000Z,56677809,11,Jermaine Samuels Jr.,0,0,0,0,0,0
0,0,0,0,0,0,0,0,0,0,0,0,0,0,0,0,1038115,2024-01-10T00:00:00.000Z,3547281,11,Nate Hinton,0,0,0,0,0,0
0,0,0,0,0,0,0,0,0,0,0,0,0,0,0,0,1038115,2024-01-10T00:00:00.000Z,38017695,11,Tari Eason,0,0,0,0,0,0
0,0,0,0,0,0,0,0,0,0,0,0,0,0,0,0,1038115,2024-01-10T00:00:00.000Z,357,11,Victor Oladipo,0,0,0,0,0,0
4,0,3,2,2,6,5,0,0,29,2,4,12,5,1,2,1038116,2024-01-10T00:00:00.000Z,177,8,Aaron Gordon,1,17,21,16,9,25
1,0,0,0,0,1,1,0,0,6,2,0,2,2,0,0,1038116,2024-01-10T00:00:00.000Z,17896007,8,Braxton Key,0,4,5,3,3,5.9
1,0,3,2,1,4,2,0,0,17,0,1,5,3,1,1,1038116,2024-01-10T00:00:00.000Z,38017709,8,Christian Braun,1,8,9,6,4,12.1
1,0,1,1,1,3,2,4,3,6,0,0,8,1,0,0,1038116,2024-01-10T00:00:00.000Z,38017727,8,Collin Gillespie,0,9,10,9,2,10.7
0,1,3,0,0,3,1,4,3,8,2,0,5,5,0,0,1038116,2024-01-10T00:00:00.000Z,250,8,DeAndre Jordan,1,10,10,5,5,14
0,0,0,0,0,0,0,0,0,0,0,0,0,0,0,0,1038116,2024-01-10T00:00:00.000Z,56677871,8,Hunter Tyson,0,0,0,0,0,0
0,0,0,0,0,0,0,0,0,0,0,0,0,0,0,0,1038116,2024-01-10T00:00:00.000Z,56677582,8,Jalen Pickett,0,0,0,0,0,0
6,2,1,5,1,15,6,4,4,31,0,3,17,1,1,4,1038116,2024-01-10T00:00:00.000Z,335,8,Jamal Murray,3,18,24,23,7,32.2
1,0,0,1,0,2,1,0,0,6,0,1,2,0,0,1,1038116,2024-01-10T00:00:00.000Z,17896103,8,Jay Huff,0,2,3,3,1,2.5
0,0,0,0,0,0,0,0,0,0,0,0,0,0,0,0,1038116,2024-01-10T00:00:00.000Z,56677776,8,Julian Strawther,0,0,0,0,0,0
1,0,0,3,1,3,1,0,0,12,0,2,3,0,2,0,1038116,2024-01-10T00:00:00.000Z,215,8,Justin Holiday,2,3,4,4,1,10.5
1,1,1,5,2,9,4,2,2,28,0,2,12,1,4,1,1038116,2024-01-10T00:00:00.000Z,81,8,Kentavious Caldwell-Pope,5,13,14,13,2,28.7
1,0,3,3,1,9,2,0,0,24,1,2,5,4,0,1,1038116,2024-01-10T00:00:00.000Z,375,8,Michael Porter Jr.,0,9,10,6,5,10.3
6,0,10,1,1,9,8,12,10,30,1,3,27,11,1,6,1038116,2024-01-10T00:00:00.000Z,246,8,Nikola Jokic,1,38,44,33,17,46.2
0,0,1,5,1,8,1,0,0,17,1,1,3,2,0,0,1038116,2024-01-10T00:00:00.000Z,38017721,8,Peyton Watson,0,5,5,3,2,5.4
2,0,0,4,1,7,2,0,0,20,0,2,5,0,0,0,1038116,2024-01-10T00:00:00.000Z,236,8,Reggie Jackson,0,5,7,7,2,8
0,0,0,0,0,0,0,0,0,0,0,0,0,0,0,0,1038116,2024-01-10T00:00:00.000Z,666489,8,Vlatko Cancar,0,0,0,0,0,0
1,0,0,1,1,2,1,2,2,6,0,2,5,0,1,0,1038116,2024-01-10T00:00:00.000Z,3547268,8,Zeke Nnaji,1,5,6,6,1,9.5
0,0,0,0,0,0,0,0,0,3,0,0,0,0,0,0,1038116,2024-01-10T00:00:00.000Z,56677842,29,Brice Sensabaugh,0,0,0,0,0,0
0,0,0,0,0,0,0,0,0,0,0,0,0,0,0,0,1038116,2024-01-10T00:00:00.000Z,17896042,29,Jason Preston,0,0,0,0,0,0
0,0,0,0,0,0,0,0,0,0,0,0,0,0,0,0,1038116,2024-01-10T00:00:00.000Z,38017630,29,Johnny Juzang,0,0,0,0,0,0
5,1,3,1,1,5,4,0,0,19,0,2,9,3,2,1,1038116,2024-01-10T00:00:00.000Z,358,29,Kelly Olynyk,3,12,17,14,8,28.1
1,0,0,0,0,0,0,2,1,3,0,0,1,0,0,0,1038116,2024-01-10T00:00:00.000Z,666881,29,Luka Samanic,0,1,2,2,1,2.5
0,0,0,0,0,0,0,0,0,0,0,0,0,0,0,0,1038116,2024-01-10T00:00:00.000Z,19465584,29,Micah Potter,0,0,0,0,0,0
0,0,2,0,0,1,1,0,0,3,0,0,2,2,0,2,1038116,2024-01-10T00:00:00.000Z,11891374,29,Omer Yurtseven,0,4,4,2,2,2.4
1,1,2,0,0,4,4,0,0,15,2,4,8,4,2,1,1038116,2024-01-10T00:00:00.000Z,38017705,29,Walker Kessler,3,12,13,9,5,22.3
2,0,2,3,1,8,2,0,0,23,0,2,5,2,0,1,1038117,2024-01-10T00:00:00.000Z,475,10,Andrew Wiggins,0,7,9,7,4,9.4
2,0,1,2,0,3,1,0,0,17,2,2,2,3,0,2,1038117,2024-01-10T00:00:00.000Z,251,10,Cory Joseph,0,5,7,4,5,6.6
3,0,2,2,0,3,1,2,2,14,1,2,4,3,1,2,1038117,2024-01-10T00:00:00.000Z,407,10,Dario Saric,1,7,10,7,6,13.1
0,0,0,0,0,0,0,0,0,0,0,0,0,0,0,0,1038117,2024-01-10T00:00:00.000Z,185,10,Draymond Green,0,0,0,0,0,0
1,0,0,3,1,4,1,0,0,8,1,0,3,1,0,0,1038117,2024-01-10T00:00:00.000Z,45658838,10,Lester Quinones,0,4,5,4,2,5.7
0,0,1,8,4,18,8,1,1,25,1,3,21,2,1,0,1038117,2024-01-10T00:00:00.000Z,17553992,10,Moses Moody,1,23,23,21,2,26.4
1,1,2,0,0,11,9,1,1,22,3,1,19,5,1,1,1038117,2024-01-10T00:00:00.000Z,56677799,10,Trayce Jackson-Davis,2,24,25,20,6,31.5
8,1,3,7,2,13,5,2,2,26,0,0,14,3,2,0,1038117,2024-01-10T00:00:00.000Z,303,19,CJ McCollum,3,17,25,22,11,38.6
1,0,1,0,0,3,3,0,0,8,2,2,6,3,0,1,1038117,2024-01-10T00:00:00.000Z,491,19,Cody Zeller,0,9,10,7,4,10.1
3,0,3,2,1,4,3,2,1,23,0,2,8,3,1,1,1038117,2024-01-10T00:00:00.000Z,38017677,19,Dyson Daniels,1,11,14,11,6,18.1
0,0,0,1,0,1,0,0,0,3,0,0,0,0,0,0,1038117,2024-01-10T00:00:00.000Z,38017663,19,E.J. Liddell,0,0,0,0,0,0
4,2,4,7,4,7,4,0,0,23,1,1,12,5,1,1,1038117,2024-01-10T00:00:00.000Z,17896024,19,Herbert Jones,3,17,21,16,9,32
0,1,1,0,0,0,0,0,0,6,0,0,0,1,0,0,1038117,2024-01-10T00:00:00.000Z,17896021,19,Jeremiah Robinson-Earl,1,1,1,0,1,4.2
2,0,1,5,4,9,5,0,0,21,0,1,14,1,0,0,1038117,2024-01-10T00:00:00.000Z,56677837,19,Jordan Hawkins,0,15,17,16,3,18.2
0,0,0,0,0,0,0,0,0,0,0,0,0,0,0,0,1038117,2024-01-10T00:00:00.000Z,17896097,19,Jose Alvarado,0,0,0,0,0,0
1,1,4,1,1,1,1,4,3,19,1,0,6,5,2,1,1038117,2024-01-10T00:00:00.000Z,340,19,Larry Nance Jr.,3,11,12,7,6,21.5
2,0,3,0,0,6,5,2,2,13,0,1,12,3,1,1,1038117,2024-01-10T00:00:00.000Z,3547293,19,Naji Marshall,1,15,17,14,5,20.6
6,1,1,11,4,13,6,0,0,24,3,2,16,4,0,0,1038117,2024-01-10T00:00:00.000Z,18677986,19,Trey Murphy III,1,20,26,22,10,32.8
1,0,1,2,0,5,3,0,0,18,0,1,6,1,1,0,1038118,2024-01-10T00:00:00.000Z,666511,13,Amir Coffey,1,7,8,7,2,11.7
0,0,0,0,0,0,0,0,0,0,0,0,0,0,0,0,1038118,2024-01-10T00:00:00.000Z,17896022,13,Brandon Boston Jr.,0,0,0,0,0,0
3,1,6,0,0,8,6,0,0,31,5,2,12,11,0,2,1038118,2024-01-10T00:00:00.000Z,493,13,Ivica Zubac,1,23,26,15,14,30.7
11,0,5,7,2,13,5,2,2,34,0,4,14,5,1,3,1038118,2024-01-10T00:00:00.000Z,192,13,James Harden,1,19,30,25,16,36.5
7,2,1,4,2,18,10,7,7,38,2,3,29,3,1,0,1038118,2024-01-10T00:00:00.000Z,274,13,Kawhi Leonard,3,32,39,36,10,52.1
0,0,0,0,0,0,0,0,0,0,0,0,0,0,0,0,1038118,2024-01-10T00:00:00.000Z,56677849,13,Kobe Brown,0,0,0,0,0,0
0,0,0,0,0,0,0,0,0,0,0,0,0,0,0,0,1038118,2024-01-10T00:00:00.000Z,371,13,Mason Plumlee,0,0,0,0,0,0
0,0,0,0,0,0,0,0,0,0,0,0,0,0,0,0,1038118,2024-01-10T00:00:00.000Z,17896031,13,Nah'Shon Hyland,0,0,0,0,0,0
1,0,3,8,3,11,4,2,2,27,0,1,13,3,0,0,1038118,2024-01-10T00:00:00.000Z,380,13,Norman Powell,0,16,17,14,4,18.1
6,1,7,9,5,22,12,0,0,38,0,4,29,7,2,0,1038118,2024-01-10T00:00:00.000Z,172,13,Paul George,3,36,42,35,13,55.4
3,0,0,1,0,9,3,0,0,14,0,0,6,0,0,0,1038118,2024-01-10T00:00:00.000Z,472,13,Russell Westbrook,0,6,9,9,3,10.5
1,0,0,3,3,5,5,0,0,24,2,1,13,2,0,1,1038118,2024-01-10T00:00:00.000Z,666743,13,Terance Mann,0,15,16,14,3,15.9
0,0,1,1,0,3,1,1,1,11,0,0,3,1,0,0,1038118,2024-01-10T00:00:00.000Z,58,28,Chris Boucher,0,4,4,3,1,4.2
0,0,0,0,0,0,0,0,0,0,0,0,0,0,0,0,1038118,2024-01-10T00:00:00.000Z,38017710,28,Christian Koloko,0,0,0,0,0,0
4,0,1,5,1,13,8,5,5,34,0,1,22,1,0,2,1038118,2024-01-10T00:00:00.000Z,409,28,Dennis Schroder,0,23,27,26,5,27.2
1,0,2,1,1,2,1,0,0,9,0,2,3,2,0,0,1038118,2024-01-10T00:00:00.000Z,436,28,Garrett Temple,0,5,6,4,3,6.9
2,0,2,4,2,9,5,0,0,24,1,1,12,3,0,0,1038118,2024-01-10T00:00:00.000Z,3089,28,Gary Trent Jr.,0,15,17,14,5,18.6
0,0,0,0,0,0,0,0,0,0,0,0,0,0,0,0,1038118,2024-01-10T00:00:00.000Z,56677828,28,Gradey Dick,0,0,0,0,0,0
6,0,4,4,2,16,7,9,9,36,0,1,25,4,1,1,1038118,2024-01-10T00:00:00.000Z,3547269,28,Immanuel Quickley,1,29,35,31,10,40.8
0,0,0,0,0,0,0,0,0,0,0,0,0,0,0,0,1038118,2024-01-10T00:00:00.000Z,373,28,Jakob Poeltl,0,0,0,0,0,0
1,0,3,0,0,2,1,0,0,13,0,2,2,3,1,0,1038118,2024-01-10T00:00:00.000Z,666762,28,Jalen McDaniels,1,5,6,3,4,10.1
0,0,0,0,0,0,0,0,0,0,0,0,0,0,0,0,1038118,2024-01-10T00:00:00.000Z,56677805,28,Javon Freeman-Liberty,0,0,0,0,0,0
4,0,4,3,1,8,4,0,0,18,3,4,9,7,0,3,1038118,2024-01-10T00:00:00.000Z,2309958,28,Jontay Porter,0,16,20,13,11,20.4
0,0,0,0,0,0,0,0,0,0,0,0,0,0,0,0,1038118,2024-01-10T00:00:00.000Z,56677869,28,Markquis Nowell,0,0,0,0,0,0
0,0,0,0,0,0,0,0,0,0,0,0,0,0,0,0,1038118,2024-01-10T00:00:00.000Z,376,28,Otto Porter Jr.,0,0,0,0,0,0
0,0,0,0,0,0,0,0,0,0,0,0,0,0,0,0,1038118,2024-01-10T00:00:00.000Z,416,28,Pascal Siakam,0,0,0,0,0,0
3,0,2,1,0,5,4,0,0,23,2,1,8,4,2,2,1038118,2024-01-10T00:00:00.000Z,489,28,Thaddeus Young,2,12,15,11,7,21.3
1,0,1,5,1,7,1,2,0,23,1,3,3,2,1,3,1038119,2024-01-11T00:00:00.000Z,666679,3,Cameron Johnson,1,5,6,4,3,6.9
0,1,0,1,0,1,0,0,0,14,0,3,0,0,0,1,1038119,2024-01-11T00:00:00.000Z,158,3,Dorian Finney-Smith,1,0,0,0,0,2
1,0,6,6,2,18,6,13,12,32,0,3,26,6,1,4,1038119,2024-01-11T00:00:00.000Z,61,3,Mikal Bridges,1,32,33,27,7,33.7
1,0,8,0,0,9,6,2,1,33,3,3,13,11,1,3,1038119,2024-01-11T00:00:00.000Z,666508,3,Nicolas Claxton,1,24,25,14,12,27.7
1,0,2,2,0,2,0,0,0,17,0,2,0,2,0,1,1038119,2024-01-11T00:00:00.000Z,351,3,Royce O'Neale,0,2,3,1,3,2.9
3,0,2,2,0,3,1,0,0,16,0,2,2,2,0,0,1038119,2024-01-11T00:00:00.000Z,130,3,Spencer Dinwiddie,0,4,7,5,5,8.9
1,1,3,9,3,14,5,12,8,35,0,2,21,3,1,1,1038119,2024-01-11T00:00:00.000Z,277,6,Caris LeVert,2,24,25,22,4,31.1
0,0,0,0,0,0,0,0,0,0,0,0,0,0,0,0,1038119,2024-01-11T00:00:00.000Z,248,6,Damian Jones,0,0,0,0,0,0
2,0,1,1,0,1,0,4,4,27,0,5,4,1,2,0,1038119,2024-01-11T00:00:00.000Z,666940,6,Dean Wade,2,5,7,6,3,14.2
6,0,10,12,4,30,15,13,11,40,2,1,45,12,4,7,1038119,2024-01-11T00:00:00.000Z,322,6,Donovan Mitchell,4,57,63,51,18,73.4
0,0,0,0,0,0,0,0,0,0,0,0,0,0,0,0,1038119,2024-01-11T00:00:00.000Z,56677847,6,Emoni Bates,0,0,0,0,0,0
2,0,3,4,2,6,3,2,2,16,1,3,10,4,0,0,1038119,2024-01-11T00:00:00.000Z,344,6,Georges Niang,0,14,16,12,6,17.8
0,1,1,5,2,12,4,2,2,35,3,4,12,4,0,1,1038119,2024-01-11T00:00:00.000Z,3547247,6,Isaac Okoro,1,16,16,12,4,18.8
0,0,0,0,0,0,0,0,0,0,0,0,0,0,0,0,1038119,2024-01-11T00:00:00.000Z,38017662,6,Isaiah Mobley,0,0,0,0,0,0
4,4,9,0,0,5,3,6,6,38,3,5,12,12,2,1,1038119,2024-01-11T00:00:00.000Z,9,6,Jarrett Allen,6,24,28,16,16,49.4
0,0,0,2,0,2,0,0,0,7,0,0,0,0,0,0,1038119,2024-01-11T00:00:00.000Z,666908,6,Max Strus,0,0,0,0,0,0
1,0,7,11,2,12,2,0,0,32,2,1,6,9,1,0,1038119,2024-01-11T00:00:00.000Z,3547299,6,Sam Merrill,1,15,16,7,10,21.3
0,0,1,0,0,0,0,4,1,10,1,3,1,2,1,1,1038119,2024-01-11T00:00:00.000Z,444,6,Tristan Thompson,1,3,3,1,2,5.4
0,0,0,0,0,0,0,0,0,0,0,0,0,0,0,0,1038121,2024-01-11T00:00:00.000Z,3547271,21,Aleksej Pokusevski,0,0,0,0,0,0
0,0,0,0,0,0,0,0,0,0,0,0,0,0,0,0,1038121,2024-01-11T00:00:00.000Z,24572055,21,Olivier Sarr,0,0,0,0,0,0
2,0,2,8,4,13,4,4,2,20,1,2,14,3,0,3,1038121,2024-01-11T00:00:00.000Z,419,25,Anfernee Simons,0,17,19,16,5,17.6
2,1,5,4,1,9,3,2,1,24,2,2,8,7,0,0,1038121,2024-01-11T00:00:00.000Z,56783340,25,Duop Reath,1,15,17,10,9,22.4
2,1,2,3,1,10,4,0,0,25,0,2,9,2,1,0,1038121,2024-01-11T00:00:00.000Z,182,25,Jerami Grant,2,11,13,11,4,20.4
2,0,4,9,1,21,4,6,4,31,2,3,13,6,1,3,1038121,2024-01-11T00:00:00.000Z,56677747,25,Scoot Henderson,1,19,21,15,8,23.2
1,2,3,6,1,8,2,2,1,32,1,3,6,4,2,2,1038121,2024-01-11T00:00:00.000Z,56677850,25,Toumani Camara,4,10,11,7,5,22.3
0,0,0,0,0,0,0,0,0,0,0,0,0,0,0,0,1038122,2024-01-11T00:00:00.000Z,17554004,7,AJ Lawson,0,0,0,0,0,0
0,0,0,0,0,0,0,0,0,0,0,0,0,0,0,0,1038122,2024-01-11T00:00:00.000Z,24489167,7,Brandon Williams,0,0,0,0,0,0
0,0,0,0,0,0,0,0,0,0,0,0,0,0,0,0,1038122,2024-01-11T00:00:00.000Z,151,7,Dante Exum,0,0,0,0,0,0
0,0,0,0,0,0,0,0,0,0,0,0,0,0,0,0,1038122,2024-01-11T00:00:00.000Z,56677840,7,Dereck Lively II,0,0,0,0,0,0
0,0,0,0,0,0,0,0,0,0,0,0,0,0,0,0,1038122,2024-01-11T00:00:00.000Z,17896028,7,Greg Brown III,0,0,0,0,0,0
0,0,0,0,0,0,0,0,0,0,0,0,0,0,0,0,1038122,2024-01-11T00:00:00.000Z,132,7,Luka Doncic,0,0,0,0,0,0
0,0,0,0,0,0,0,0,0,0,0,0,0,0,0,0,1038122,2024-01-11T00:00:00.000Z,257,7,Maxi Kleber,0,0,0,0,0,0
0,0,0,0,0,0,0,0,0,0,0,0,0,0,0,0,1038122,2024-01-11T00:00:00.000Z,56677859,7,Olivier-Maxence Prosper,0,0,0,0,0,0
0,0,0,0,0,0,0,0,0,0,0,0,0,0,0,0,1038122,2024-01-11T00:00:00.000Z,217,7,Richaun Holmes,0,0,0,0,0,0
0,0,1,1,0,1,0,0,0,10,0,0,0,1,0,1,1038122,2024-01-11T00:00:00.000Z,114,7,Seth Curry,0,1,1,0,1,0.2
2,2,5,6,1,10,4,1,1,39,1,1,10,6,0,1,1038122,2024-01-11T00:00:00.000Z,18,20,OG Anunoby,2,16,18,12,8,25.2
0,0,0,0,0,0,0,0,0,0,0,0,0,0,0,0,1038123,2024-01-11T00:00:00.000Z,486,14,Christian Wood,0,0,0,0,0,0
0,0,0,0,0,0,0,0,0,0,0,0,0,0,0,0,1038123,2024-01-11T00:00:00.000Z,56677738,14,Colin Castleton,0,0,0,0,0,0
1,0,0,1,1,1,1,0,0,5,0,1,3,0,0,0,1038123,2024-01-11T00:00:00.000Z,666971,14,Dylan Windler,0,3,4,4,1,4.5
0,0,0,0,0,0,0,0,0,0,0,0,0,0,0,0,1038123,2024-01-11T00:00:00.000Z,1603383,14,Gabe Vincent,0,0,0,0,0,0
0,0,0,0,0,3,1,0,0,5,0,0,2,0,0,0,1038123,2024-01-11T00:00:00.000Z,56677835,14,Jalen Hood-Schifino,0,2,2,2,0,2
0,0,0,0,0,0,0,0,0,0,0,0,0,0,0,0,1038123,2024-01-11T00:00:00.000Z,56677836,14,Maxwell Lewis,0,0,0,0,0,0
0,0,0,0,0,0,0,0,0,0,0,0,0,0,0,0,1038123,2024-01-11T00:00:00.000Z,666609,14,Rui Hachimura,0,0,0,0,0,0
1,0,0,2,2,6,5,0,0,12,1,0,12,1,1,0,1038123,2024-01-11T00:00:00.000Z,3547289,14,Skylar Mays,1,13,14,13,2,17.7
2,2,4,0,0,3,2,2,2,17,2,1,6,6,2,0,1038123,2024-01-11T00:00:00.000Z,666451,24,Bol Bol,4,12,14,8,8,28.2
4,0,4,10,8,21,14,1,1,32,2,3,37,6,1,3,1038123,2024-01-11T00:00:00.000Z,37,24,Bradley Beal,1,43,47,41,10,50.2
1,0,1,0,0,0,0,4,4,8,1,0,4,2,0,0,1038123,2024-01-11T00:00:00.000Z,314,24,Chimezie Metu,0,6,7,5,3,7.9
0,0,0,0,0,0,0,0,0,0,0,0,0,0,0,0,1038123,2024-01-11T00:00:00.000Z,272,24,Damion Lee,0,0,0,0,0,0
5,0,5,6,2,22,11,7,7,34,0,2,31,5,3,3,1038123,2024-01-11T00:00:00.000Z,57,24,Devin Booker,3,36,41,36,10,50.5
0,0,0,0,0,0,0,0,0,0,0,0,0,0,0,0,1038123,2024-01-11T00:00:00.000Z,147,24,Drew Eubanks,0,0,0,0,0,0
0,0,1,9,1,11,2,0,0,23,2,0,5,3,0,0,1038123,2024-01-11T00:00:00.000Z,178,24,Eric Gordon,0,8,8,5,3,8.6
3,0,4,6,1,8,2,0,0,30,1,3,5,5,0,0,1038123,2024-01-11T00:00:00.000Z,8,24,Grayson Allen,0,10,13,8,8,15.5
1,0,0,0,0,1,0,0,0,5,0,1,0,0,1,1,1038123,2024-01-11T00:00:00.000Z,18678058,24,Jordan Goodwin,1,0,1,1,1,3.5
0,0,0,2,0,4,2,2,1,12,0,1,5,0,1,0,1038123,2024-01-11T00:00:00.000Z,356,24,Josh Okogie,1,5,5,5,0,8
2,0,8,0,0,6,3,4,3,28,4,2,9,12,1,2,1038123,2024-01-11T00:00:00.000Z,349,24,Jusuf Nurkic,1,21,23,11,14,27.4
0,0,0,1,0,3,1,0,0,5,0,0,2,0,0,0,1038123,2024-01-11T00:00:00.000Z,32,24,Keita Bates-Diop,0,2,2,2,0,2
5,1,5,5,2,12,7,2,2,32,0,0,18,5,3,1,1038123,2024-01-11T00:00:00.000Z,140,24,Kevin Durant,4,23,28,23,10,42.5
0,0,0,0,0,1,1,1,1,4,0,0,3,0,0,1,1038123,2024-01-11T00:00:00.000Z,666729,24,Nassir Little,0,3,3,3,0,2
0,0,0,0,0,0,0,0,0,0,0,0,0,0,0,0,1038123,2024-01-11T00:00:00.000Z,3547298,24,Saben Lee,0,0,0,0,0,0
0,0,0,0,0,0,0,0,0,0,0,0,0,0,0,0,1038123,2024-01-11T00:00:00.000Z,3547253,24,Theo Maledon,0,0,0,0,0,0
0,0,0,0,0,1,1,0,0,5,1,2,2,1,0,0,1038123,2024-01-11T00:00:00.000Z,3547095,24,Udoka Azubuike,0,3,3,2,1,3.2
0,1,1,0,0,0,0,0,0,5,0,1,0,1,0,1,1038123,2024-01-11T00:00:00.000Z,470,24,Yuta Watanabe,1,1,1,0,1,3.2
1,0,2,1,0,2,1,2,2,14,0,3,4,2,0,0,1038124,2024-01-12T00:00:00.000Z,2175,23,Danuel House Jr.,0,6,7,5,3,7.9
1,0,0,2,1,3,1,0,0,3,0,0,3,0,1,0,1038124,2024-01-12T00:00:00.000Z,260,23,Furkan Korkmaz,1,3,4,4,1,7.5
0,0,1,0,0,3,1,0,0,3,0,1,2,1,0,0,1038124,2024-01-12T00:00:00.000Z,17896025,23,Jaden Springer,0,3,3,2,1,3.2
0,0,0,0,0,0,0,0,0,0,0,0,0,0,0,0,1038124,2024-01-12T00:00:00.000Z,145,23,Joel Embiid,0,0,0,0,0,0
0,0,0,0,0,0,0,0,0,0,0,0,0,0,0,0,1038124,2024-01-12T00:00:00.000Z,360,23,Kelly Oubre Jr.,0,0,0,0,0,0
0,0,0,0,0,0,0,0,0,0,0,0,0,0,0,0,1038124,2024-01-12T00:00:00.000Z,38017732,23,Kenneth Lofton Jr.,0,0,0,0,0,0
0,0,0,0,0,1,1,0,0,3,0,0,2,0,0,0,1038124,2024-01-12T00:00:00.000Z,3547294,23,Kenyon Martin Jr.,0,2,2,2,0,2
0,0,4,0,0,5,0,0,0,17,0,0,0,4,0,1,1038124,2024-01-12T00:00:00.000Z,328,23,Marcus Morris,0,4,4,0,4,3.8
0,4,1,2,2,6,4,2,1,20,2,1,11,3,1,2,1038124,2024-01-12T00:00:00.000Z,28,23,Mo Bamba,5,14,14,11,3,27.6
7,0,9,4,0,8,2,0,0,27,0,2,4,9,0,3,1038124,2024-01-12T00:00:00.000Z,45,23,Patrick Beverley,0,13,20,11,16,22.3
0,0,0,0,0,0,0,0,0,0,0,0,0,0,0,0,1038124,2024-01-12T00:00:00.000Z,56913527,23,Ricky Council IV,0,0,0,0,0,0
0,0,0,0,0,0,0,0,0,0,0,0,0,0,0,0,1038124,2024-01-12T00:00:00.000Z,108,23,Robert Covington,0,0,0,0,0,0
0,0,0,0,0,0,0,0,0,0,0,0,0,0,0,0,1038124,2024-01-12T00:00:00.000Z,56677788,23,Terquavion Smith,0,0,0,0,0,0
1,0,2,0,0,1,1,0,0,8,2,1,2,4,0,0,1038124,2024-01-12T00:00:00.000Z,273,26,Alex Len,0,6,7,3,5,8.3
0,0,2,1,0,2,0,2,1,10,1,1,1,3,0,1,1038124,2024-01-12T00:00:00.000Z,17896030,26,Chris Duarte,0,4,4,1,3,3.6
3,0,2,1,0,4,0,0,0,9,1,3,0,3,1,1,1038124,2024-01-12T00:00:00.000Z,56677845,26,Colby Jones,1,3,6,3,6,10.1
4,0,4,7,2,15,5,11,9,38,1,2,21,5,1,2,1038124,2024-01-12T00:00:00.000Z,161,26,De'Aaron Fox,1,26,30,25,9,34
5,0,7,0,0,10,6,2,2,33,5,3,14,12,0,4,1038124,2024-01-12T00:00:00.000Z,406,26,Domantas Sabonis,0,26,31,19,17,31.9
3,2,6,7,3,14,6,1,0,35,2,2,15,8,1,2,1038124,2024-01-12T00:00:00.000Z,38017688,26,Keegan Murray,3,23,26,18,11,36.1
0,0,2,2,1,3,1,0,0,10,0,1,3,2,0,2,1038124,2024-01-12T00:00:00.000Z,38017714,26,Keon Ellis,0,5,5,3,2,3.4
0,0,0,1,0,3,1,0,0,6,1,1,2,1,0,0,1038124,2024-01-12T00:00:00.000Z,17896044,26,Kessler Edwards,0,3,3,2,1,3.2
0,0,0,1,0,2,1,0,0,4,0,0,2,0,0,0,1038125,2024-01-12T00:00:00.000Z,38017689,1,AJ Griffin,0,2,2,2,0,2
0,0,1,1,0,1,0,0,0,4,0,0,0,1,0,0,1038125,2024-01-12T00:00:00.000Z,666564,1,Bruno Fernando,0,1,1,0,1,1.2
1,1,2,0,0,5,3,4,1,22,3,1,7,5,1,0,1038125,2024-01-12T00:00:00.000Z,83,1,Clint Capela,2,12,13,8,6,20.5
0,0,0,0,0,0,0,0,0,0,0,0,0,0,0,0,1038125,2024-01-12T00:00:00.000Z,666656,1,De'Andre Hunter,0,0,0,0,0,0
0,0,0,0,0,0,0,0,0,0,0,0,0,0,0,0,1038125,2024-01-12T00:00:00.000Z,666754,1,Garrison Mathews,0,0,0,0,0,0
3,0,4,2,1,11,7,3,1,32,0,3,16,4,2,3,1038125,2024-01-12T00:00:00.000Z,17896040,1,Jalen Johnson,2,20,23,19,7,28.3
0,0,0,0,0,0,0,0,0,0,0,0,0,0,0,0,1038125,2024-01-12T00:00:00.000Z,56677838,1,Kobe Bufkin,0,0,0,0,0,0
0,0,0,0,0,0,0,0,0,0,0,0,0,0,0,0,1038125,2024-01-12T00:00:00.000Z,56677806,1,Mouhamed Gueye,0,0,0,0,0,0
0,0,0,1,0,3,1,0,0,14,1,1,2,1,1,0,1038125,2024-01-12T00:00:00.000Z,319,1,Patty Mills,1,3,3,2,1,6.2
2,0,3,7,3,10,3,9,8,31,1,1,17,4,1,0,1038125,2024-01-12T00:00:00.000Z,3547256,1,Saddiq Bey,1,21,23,19,6,27.8
0,0,0,1,0,1,0,2,2,4,0,0,2,0,0,0,1038125,2024-01-12T00:00:00.000Z,56677855,1,Seth Lundy,0,2,2,2,0,2
0,0,0,0,0,0,0,0,0,0,0,0,0,0,0,0,1038125,2024-01-12T00:00:00.000Z,4197387,1,Vit Krejci,0,0,0,0,0,0
0,0,0,0,0,0,0,0,0,0,0,0,0,0,0,0,1038125,2024-01-12T00:00:00.000Z,301,1,Wesley Matthews,0,0,0,0,0,0
0,0,3,3,3,6,5,0,0,21,1,3,13,4,1,1,1038125,2024-01-12T00:00:00.000Z,3547250,12,Aaron Nesmith,1,17,17,13,4,19.8
6,0,4,2,2,6,4,0,0,23,0,2,10,4,2,4,1038125,2024-01-12T00:00:00.000Z,38017507,12,Andrew Nembhard,2,14,20,16,10,25.8
0,0,0,0,0,0,0,0,0,4,0,0,0,0,0,0,1038125,2024-01-12T00:00:00.000Z,56677861,12,Ben Sheppard,0,0,0,0,0,0
4,0,1,3,2,9,5,0,0,21,0,0,12,1,0,2,1038125,2024-01-12T00:00:00.000Z,69,12,Bruce Brown,0,13,17,16,5,17.2
2,3,3,6,4,11,7,0,0,23,0,3,18,3,0,2,1038125,2024-01-12T00:00:00.000Z,210,12,Buddy Hield,3,21,23,20,5,31.6
2,4,4,0,0,7,6,0,0,18,1,3,12,5,4,2,1038125,2024-01-12T00:00:00.000Z,17896035,12,Isaiah Jackson,8,17,19,14,7,43
0,0,0,0,0,0,0,0,0,0,0,0,0,0,0,0,1038125,2024-01-12T00:00:00.000Z,56677794,12,Isaiah Wong,0,0,0,0,0,0
0,0,4,0,0,7,3,0,0,19,3,1,6,7,0,0,1038125,2024-01-12T00:00:00.000Z,3547264,12,Jalen Smith,0,13,13,6,7,14.4
0,0,0,0,0,0,0,0,0,0,0,0,0,0,0,0,1038125,2024-01-12T00:00:00.000Z,242,12,James Johnson,0,0,0,0,0,0
0,0,0,0,0,0,0,0,0,0,0,0,0,0,0,0,1038125,2024-01-12T00:00:00.000Z,56677832,12,Jarace Walker,0,0,0,0,0,0
2,0,1,0,0,1,0,0,0,4,0,0,0,1,0,0,1038125,2024-01-12T00:00:00.000Z,3547207,12,Jordan Nwora,0,1,3,2,3,4.2
0,0,0,0,0,0,0,0,0,4,0,1,0,0,0,0,1038125,2024-01-12T00:00:00.000Z,38017701,12,Kendall Brown,0,0,0,0,0,0
4,2,5,3,0,9,5,3,2,26,2,2,12,7,2,3,1038125,2024-01-12T00:00:00.000Z,452,12,Myles Turner,4,19,23,16,11,35.4
4,0,4,0,0,7,7,4,4,21,2,4,18,6,0,1,1038125,2024-01-12T00:00:00.000Z,3547243,12,Obi Toppin,0,24,28,22,10,30.2
14,1,4,0,0,5,3,0,0,25,0,0,6,4,3,5,1038125,2024-01-12T00:00:00.000Z,304,12,T.J. McConnell,4,10,24,20,18,38.8
1,2,0,9,5,14,7,0,0,30,0,3,19,0,0,2,1038126,2024-01-12T00:00:00.000Z,77,9,Alec Burks,2,19,20,20,1,24.5
0,0,6,1,0,3,2,0,0,18,2,2,4,8,0,1,1038126,2024-01-12T00:00:00.000Z,56677826,9,Ausar Thompson,0,12,12,4,8,12.6
0,0,0,0,0,0,0,0,0,0,0,0,0,0,0,0,1038126,2024-01-12T00:00:00.000Z,54,9,Bojan Bogdanovic,0,0,0,0,0,0
0,0,0,0,0,0,0,0,0,0,0,0,0,0,0,0,1038126,2024-01-12T00:00:00.000Z,17896075,9,Cade Cunningham,0,0,0,0,0,0
1,2,0,4,1,4,1,0,0,16,0,3,3,0,0,0,1038126,2024-01-12T00:00:00.000Z,17896071,9,Isaiah Livers,2,3,4,4,1,10.5
1,0,7,8,3,13,6,2,1,29,0,1,16,7,0,3,1038126,2024-01-12T00:00:00.000Z,3547267,9,Isaiah Stewart,0,23,24,17,8,22.9
8,1,2,6,1,19,8,4,1,28,4,3,18,6,0,2,1038126,2024-01-12T00:00:00.000Z,38017682,9,Jaden Ivey,1,24,32,26,14,38.2
3,1,6,0,0,12,7,2,1,32,2,3,15,8,2,2,1038126,2024-01-12T00:00:00.000Z,38017694,9,Jalen Duren,3,23,26,18,11,36.1
0,0,0,0,0,0,0,0,0,0,0,0,0,0,0,0,1038126,2024-01-12T00:00:00.000Z,3547240,9,James Wiseman,0,0,0,0,0,0
0,0,0,0,0,0,0,0,0,0,0,0,0,0,0,0,1038126,2024-01-12T00:00:00.000Z,42097199,9,Jared Rhoden,0,0,0,0,0,0
0,0,0,0,0,0,0,0,0,0,0,0,0,0,0,0,1038126,2024-01-12T00:00:00.000Z,197,9,Joe Harris,0,0,0,0,0,0
2,2,7,4,2,9,7,3,3,35,0,1,19,7,1,1,1038126,2024-01-12T00:00:00.000Z,259,9,Kevin Knox,3,26,28,21,9,38.4
8,1,4,2,0,6,2,1,1,29,0,1,5,4,1,1,1038126,2024-01-12T00:00:00.000Z,3547241,9,Killian Hayes,2,9,17,13,12,26.8
0,0,0,0,0,0,0,0,0,0,0,0,0,0,0,0,1038126,2024-01-12T00:00:00.000Z,56677729,9,Malcolm Cazalon,0,0,0,0,0,0
7,0,0,1,0,2,0,0,0,11,1,2,0,1,1,1,1038126,2024-01-12T00:00:00.000Z,56677792,9,Marcus Sasser,1,1,8,7,8,13.7
1,0,3,0,0,6,4,4,3,12,1,2,11,4,1,0,1038126,2024-01-12T00:00:00.000Z,24,9,Marvin Bagley III,1,15,16,12,5,20.3
0,0,0,0,0,0,0,0,0,0,0,0,0,0,0,0,1038126,2024-01-12T00:00:00.000Z,330,9,Monte Morris,0,0,0,0,0,0
0,0,0,0,0,0,0,0,0,0,0,0,0,0,0,0,1038126,2024-01-12T00:00:00.000Z,44477024,9,Stanley Umude,0,0,0,0,0,0
0,0,1,0,0,0,0,0,0,3,0,0,0,1,0,0,1038126,2024-01-12T00:00:00.000Z,213,11,Aaron Holiday,0,1,1,0,1,1.2
1,0,6,1,0,19,12,7,5,37,0,3,29,6,1,4,1038126,2024-01-12T00:00:00.000Z,17896062,11,Alperen Sengun,1,35,36,30,7,36.7
2,0,1,0,0,2,1,0,0,8,0,0,2,1,1,0,1038126,2024-01-12T00:00:00.000Z,56677825,11,Amen Thompson,1,3,5,4,3,9.2
0,0,0,0,0,0,0,0,0,0,0,0,0,0,0,0,1038126,2024-01-12T00:00:00.000Z,296,11,Boban Marjanovic,0,0,0,0,0,0
0,0,1,5,1,7,1,0,0,15,0,2,3,1,0,0,1038126,2024-01-12T00:00:00.000Z,56677831,11,Cam Whitmore,0,4,4,3,1,4.2
0,0,0,0,0,0,0,0,0,0,0,0,0,0,0,0,1038126,2024-01-12T00:00:00.000Z,66,11,Dillon Brooks,0,0,0,0,0,0
12,2,3,9,3,15,7,3,3,43,1,5,20,4,2,0,1038126,2024-01-12T00:00:00.000Z,458,11,Fred VanVleet,4,24,36,32,16,54.8
1,2,6,3,1,15,7,4,4,41,5,0,19,11,1,1,1038126,2024-01-12T00:00:00.000Z,38017684,11,Jabari Smith Jr.,3,30,31,20,12,41.7
1,0,5,0,0,2,1,0,0,20,2,1,2,7,0,1,1038126,2024-01-12T00:00:00.000Z,3547301,11,Jae'Sean Tate,0,9,10,3,8,10.9
3,1,3,9,2,25,9,9,8,39,2,3,28,5,1,1,1038126,2024-01-12T00:00:00.000Z,17895966,11,Jalen Green,2,33,36,31,8,43.5
0,0,0,0,0,0,0,0,0,0,0,0,0,0,0,0,1038126,2024-01-12T00:00:00.000Z,47738533,11,Jeenathan Williams,0,0,0,0,0,0
0,0,2,0,0,2,2,2,2,13,0,2,6,2,0,1,1038126,2024-01-12T00:00:00.000Z,188,11,Jeff Green,0,8,8,6,2,7.4
0,0,0,0,0,0,0,0,0,0,0,0,0,0,0,0,1038126,2024-01-12T00:00:00.000Z,56677809,11,Jermaine Samuels Jr.,0,0,0,0,0,0
0,0,0,0,0,0,0,0,0,0,0,0,0,0,0,0,1038126,2024-01-12T00:00:00.000Z,19465326,11,Jock Landale,0,0,0,0,0,0
0,0,0,0,0,0,0,0,0,0,0,0,0,0,0,0,1038126,2024-01-12T00:00:00.000Z,3547281,11,Nate Hinton,0,0,0,0,0,0
1,0,4,3,1,3,1,0,0,21,0,0,3,4,1,1,1038126,2024-01-12T00:00:00.000Z,75,11,Reggie Bullock,1,7,8,4,5,11.3
0,0,0,0,0,0,0,0,0,0,0,0,0,0,0,0,1038126,2024-01-12T00:00:00.000Z,38017695,11,Tari Eason,0,0,0,0,0,0
0,0,0,0,0,0,0,0,0,0,0,0,0,0,0,0,1038126,2024-01-12T00:00:00.000Z,357,11,Victor Oladipo,0,0,0,0,0,0
2,0,4,2,1,6,3,4,4,24,0,1,11,4,1,0,1038127,2024-01-12T00:00:00.000Z,666747,16,Caleb Martin,1,15,17,13,6,21.8
0,0,0,0,0,0,0,0,0,0,0,0,0,0,0,0,1038127,2024-01-12T00:00:00.000Z,38017736,16,Cole Swider,0,0,0,0,0,0
0,0,0,0,0,0,0,0,0,0,0,0,0,0,0,0,1038127,2024-01-12T00:00:00.000Z,19465585,16,Dru Smith,0,0,0,0,0,0
0,0,0,0,0,0,0,0,0,0,0,0,0,0,0,0,1038127,2024-01-12T00:00:00.000Z,79,16,Jimmy Butler,0,0,0,0,0,0
2,0,1,1,0,6,4,1,1,25,0,2,9,1,1,2,1038127,2024-01-12T00:00:00.000Z,391,16,Josh Richardson,1,10,12,11,3,14.2
1,0,2,4,1,6,2,1,0,16,1,3,5,3,1,1,1038127,2024-01-12T00:00:00.000Z,285,16,Kevin Love,1,8,9,6,4,12.1
0,0,0,0,0,0,0,0,0,0,0,0,0,0,0,0,1038127,2024-01-12T00:00:00.000Z,286,16,Kyle Lowry,0,0,0,0,0,0
0,0,0,0,0,0,0,0,0,0,0,0,0,0,0,0,1038127,2024-01-12T00:00:00.000Z,39398582,16,Orlando Robinson,0,0,0,0,0,0
0,0,0,0,0,0,0,0,0,0,0,0,0,0,0,0,1038127,2024-01-12T00:00:00.000Z,666633,16,Tyler Herro,0,0,0,0,0,0
1,0,3,0,0,1,0,2,1,9,0,0,1,3,1,0,1038127,2024-01-12T00:00:00.000Z,56677827,22,Anthony Black,1,4,5,2,4,9.1
3,0,1,9,3,9,3,0,0,32,1,4,9,2,0,0,1038127,2024-01-12T00:00:00.000Z,38017724,22,Caleb Houstan,0,11,14,12,5,15.9
0,1,2,2,0,8,2,2,1,27,1,1,5,3,2,0,1038127,2024-01-12T00:00:00.000Z,3547251,22,Cole Anthony,3,8,8,5,3,17.6
0,0,0,0,0,0,0,0,0,0,0,0,0,0,0,0,1038127,2024-01-12T00:00:00.000Z,17896026,22,Franz Wagner,0,0,0,0,0,0
0,0,0,0,0,0,0,0,0,0,0,0,0,0,0,0,1038127,2024-01-12T00:00:00.000Z,196,22,Gary Harris,0,0,0,0,0,0
1,1,9,0,0,1,1,2,0,20,0,1,2,9,1,0,1038127,2024-01-12T00:00:00.000Z,666442,22,Goga Bitadze,2,11,12,3,10,20.3
0,3,0,4,0,5,1,0,0,14,0,3,2,0,0,0,1038127,2024-01-12T00:00:00.000Z,17896073,22,Jalen Suggs,3,2,2,2,0,11
0,0,0,0,0,0,0,0,0,0,0,0,0,0,0,0,1038127,2024-01-12T00:00:00.000Z,56677839,22,Jett Howard,0,0,0,0,0,0
6,0,0,8,4,10,5,1,0,20,0,2,14,0,3,2,1038127,2024-01-12T00:00:00.000Z,226,22,Joe Ingles,3,14,20,20,6,30
0,0,0,0,0,0,0,0,0,0,0,0,0,0,0,0,1038127,2024-01-12T00:00:00.000Z,229,22,Jonathan Isaac,0,0,0,0,0,0
0,0,0,0,0,0,0,0,0,0,0,0,0,0,0,0,1038127,2024-01-12T00:00:00.000Z,38017607,22,Kevon Harris,0,0,0,0,0,0
3,1,1,0,0,2,1,2,1,17,2,2,3,3,2,2,1038127,2024-01-12T00:00:00.000Z,165,22,Markelle Fultz,3,6,9,6,6,18.1
6,0,5,7,1,26,10,6,4,36,3,2,25,8,0,4,1038127,2024-01-12T00:00:00.000Z,38017683,22,Paolo Banchero,0,33,39,31,14,39.6
0,0,0,0,0,0,0,0,0,0,0,0,0,0,0,0,1038127,2024-01-12T00:00:00.000Z,85,22,Wendell Carter Jr.,0,0,0,0,0,0
2,1,1,6,2,6,2,0,0,29,1,0,6,2,0,0,1038128,2024-01-12T00:00:00.000Z,89,5,Alex Caruso,1,8,10,8,4,14.4
1,1,5,0,0,2,2,2,1,12,0,0,5,5,0,0,1038128,2024-01-12T00:00:00.000Z,137,5,Andre Drummond,1,10,11,6,6,15.5
0,0,0,3,2,4,2,0,0,17,0,4,6,0,0,3,1038128,2024-01-12T00:00:00.000Z,17895983,5,Ayo Dosunmu,0,6,6,6,0,3
7,0,4,7,5,13,9,3,2,37,0,4,25,4,0,1,1038128,2024-01-12T00:00:00.000Z,666956,5,Coby White,0,29,36,32,11,39.3
5,0,5,5,2,21,15,8,7,41,1,5,39,6,0,1,1038128,2024-01-12T00:00:00.000Z,125,5,DeMar DeRozan,0,45,50,44,11,52.7
0,0,0,0,0,0,0,0,0,0,0,0,0,0,0,0,1038128,2024-01-12T00:00:00.000Z,87,5,Jevon Carter,0,0,0,0,0,0
2,0,5,5,2,12,6,0,0,33,2,1,14,7,0,3,1038128,2024-01-12T00:00:00.000Z,460,5,Nikola Vucevic,0,21,23,16,9,22.4
0,0,0,0,0,0,0,0,0,0,0,0,0,0,0,0,1038128,2024-01-12T00:00:00.000Z,110,5,Torrey Craig,0,0,0,0,0,0
7,1,8,8,4,15,9,3,3,35,0,3,25,8,0,1,1038128,2024-01-12T00:00:00.000Z,268,5,Zach LaVine,1,33,40,32,15,47.1
1,0,2,1,1,6,6,1,0,26,0,0,13,2,2,1,1038129,2024-01-12T00:00:00.000Z,666511,13,Amir Coffey,2,15,16,14,3,21.9
0,0,0,1,0,3,0,0,0,4,0,2,0,0,0,0,1038129,2024-01-12T00:00:00.000Z,17896022,13,Brandon Boston Jr.,0,0,0,0,0,0
4,3,3,1,1,4,2,4,2,22,2,2,7,5,2,0,1038129,2024-01-12T00:00:00.000Z,439,13,Daniel Theis,5,12,16,11,9,34
0,2,7,0,0,5,2,2,2,22,4,3,6,11,0,0,1038129,2024-01-12T00:00:00.000Z,493,13,Ivica Zubac,2,17,17,6,11,25.2
9,0,1,4,2,7,3,3,3,28,0,0,11,1,1,3,1038129,2024-01-12T00:00:00.000Z,192,13,James Harden,1,12,21,20,10,25.7
0,0,5,2,0,8,5,1,1,24,0,2,11,5,0,1,1038129,2024-01-12T00:00:00.000Z,380,13,Norman Powell,0,16,16,11,5,16
1,0,3,10,7,18,12,6,6,35,0,3,37,3,2,4,1038129,2024-01-12T00:00:00.000Z,172,13,Paul George,2,40,41,38,4,44.1
2,0,1,3,1,11,5,3,1,16,1,1,12,2,0,1,1038129,2024-01-12T00:00:00.000Z,472,13,Russell Westbrook,0,14,16,14,4,16.4
0,0,3,4,1,8,3,0,0,26,2,0,7,5,0,1,1038129,2024-01-12T00:00:00.000Z,666743,13,Terance Mann,0,12,12,7,5,12
4,0,5,5,3,11,7,0,0,27,1,3,17,6,1,2,1038129,2024-01-12T00:00:00.000Z,38017729,15,David Roddy,1,23,27,21,10,31.2
1,0,2,1,0,5,1,3,2,9,3,1,4,5,0,0,1038129,2024-01-12T00:00:00.000Z,56677830,15,GG Jackson,0,9,10,5,6,11.5
8,0,1,2,0,2,0,0,0,20,0,1,0,1,0,1,1038129,2024-01-12T00:00:00.000Z,48248287,15,Jacob Gilyard,0,1,9,8,9,12.2
1,1,2,4,2,10,5,0,0,20,2,4,12,4,0,0,1038129,2024-01-12T00:00:00.000Z,38017728,15,Jake LaRavia,1,16,17,13,5,21.3
1,0,1,1,0,1,0,0,0,6,0,1,0,1,0,0,1038129,2024-01-12T00:00:00.000Z,666703,15,John Konchar,0,1,2,1,2,2.7
0,0,0,0,0,0,0,0,0,0,0,0,0,0,0,0,1038129,2024-01-12T00:00:00.000Z,17896067,15,Santi Aldama,0,0,0,0,0,0
0,0,0,0,0,0,0,0,0,0,0,0,0,0,0,0,1038129,2024-01-12T00:00:00.000Z,3,15,Steven Adams,0,0,0,0,0,0
2,0,1,5,3,12,5,0,0,19,2,2,13,3,0,1,1038129,2024-01-12T00:00:00.000Z,17896027,15,Ziaire Williams,0,16,18,15,5,18.6
6,1,3,3,0,9,4,2,1,27,0,2,9,3,1,0,1038130,2024-01-12T00:00:00.000Z,3547238,18,Anthony Edwards,2,12,18,15,9,27.6
0,0,0,0,0,0,0,0,0,0,0,0,0,0,0,0,1038130,2024-01-12T00:00:00.000Z,17895968,18,Daishen Nix,0,0,0,0,0,0
3,0,2,3,1,8,4,0,0,24,0,1,9,2,2,4,1038130,2024-01-12T00:00:00.000Z,3547259,18,Jaden McDaniels,2,11,14,12,5,17.9
5,0,0,2,0,3,1,0,0,13,0,2,2,0,1,2,1038130,2024-01-12T00:00:00.000Z,666767,18,Jordan McLaughlin,1,2,7,7,5,10.5
0,1,0,0,0,3,0,2,2,9,0,2,2,0,1,0,1038130,2024-01-12T00:00:00.000Z,38017715,18,Josh Minott,2,2,2,2,0,8
1,0,7,3,3,8,7,7,6,28,1,2,23,8,2,0,1038130,2024-01-12T00:00:00.000Z,447,18,Karl-Anthony Towns,2,31,32,24,9,40.1
1,0,2,0,0,2,1,0,0,15,0,2,2,2,0,2,1038130,2024-01-12T00:00:00.000Z,12,18,Kyle Anderson,0,4,5,3,3,3.9
0,1,2,2,0,4,2,0,0,8,0,2,4,2,1,1,1038130,2024-01-12T00:00:00.000Z,56677782,18,Leonard Miller,2,6,6,4,2,11.4
0,0,0,0,0,0,0,0,0,0,0,0,0,0,0,0,1038130,2024-01-12T00:00:00.000Z,17896056,18,Luka Garza,0,0,0,0,0,0
10,0,4,5,3,7,3,0,0,20,0,1,9,4,0,0,1038130,2024-01-12T00:00:00.000Z,104,18,Mike Conley,0,13,23,19,14,28.8
3,0,2,2,0,3,1,0,0,19,0,1,2,2,2,2,1038130,2024-01-12T00:00:00.000Z,666400,18,Nickeil Alexander-Walker,2,4,7,5,5,12.9
0,2,12,0,0,11,9,8,6,29,5,2,24,17,0,1,1038130,2024-01-12T00:00:00.000Z,176,18,Rudy Gobert,2,41,41,24,17,49.4
2,0,0,0,0,5,3,0,0,10,0,1,6,0,0,0,1038130,2024-01-12T00:00:00.000Z,320,18,Shake Milton,0,6,8,8,2,9
3,0,1,5,2,5,2,0,0,9,1,1,6,2,0,3,1038130,2024-01-12T00:00:00.000Z,68,18,Troy Brown Jr.,0,8,11,9,5,9.9
0,0,0,0,0,2,2,0,0,8,0,2,4,0,2,0,1038130,2024-01-12T00:00:00.000Z,38017700,18,Wendell Moore Jr.,2,4,4,4,0,10
3,1,2,2,0,10,0,5,5,29,0,0,5,2,0,3,1038130,2024-01-12T00:00:00.000Z,419,25,Anfernee Simons,1,7,10,8,5,11.9
0,0,0,0,0,0,0,0,0,0,0,0,0,0,0,0,1038130,2024-01-12T00:00:00.000Z,22,25,Deandre Ayton,0,0,0,0,0,0
0,1,3,6,2,14,6,3,0,24,3,4,14,6,1,1,1038130,2024-01-12T00:00:00.000Z,56783340,25,Duop Reath,2,20,20,14,6,26.2
0,1,3,0,0,1,1,0,0,9,3,3,2,6,0,1,1038130,2024-01-12T00:00:00.000Z,39613724,25,Ibou Badji,1,8,8,2,6,11.2
3,0,11,2,1,11,6,4,4,32,2,4,17,13,1,4,1038130,2024-01-12T00:00:00.000Z,38017711,25,Jabari Walker,1,30,33,20,16,36.1
1,0,0,7,2,15,4,3,3,31,0,3,13,0,2,0,1038130,2024-01-12T00:00:00.000Z,182,25,Jerami Grant,2,13,14,14,1,20.5
2,1,0,1,1,1,1,0,0,9,0,0,3,0,1,0,1038130,2024-01-12T00:00:00.000Z,47957121,25,Justin Minaya,2,3,5,5,2,12
1,0,0,0,0,1,0,2,2,9,0,0,2,0,1,0,1038130,2024-01-12T00:00:00.000Z,56677791,25,Kris Murray,1,2,3,3,1,6.5
3,0,2,5,2,7,2,4,3,26,0,1,9,2,0,1,1038130,2024-01-12T00:00:00.000Z,65,25,Malcolm Brogdon,0,11,14,12,5,14.9
0,0,1,2,1,3,1,0,0,14,0,1,3,1,2,0,1038130,2024-01-12T00:00:00.000Z,666923,25,Matisse Thybulle,2,4,4,3,1,10.2
0,0,0,0,0,0,0,0,0,0,0,0,0,0,0,0,1038130,2024-01-12T00:00:00.000Z,666476,25,Moses Brown,0,0,0,0,0,0
1,0,1,0,0,2,1,2,1,7,0,0,3,1,0,0,1038130,2024-01-12T00:00:00.000Z,56677829,25,Rayan Rupert,0,4,5,4,2,5.7
0,0,0,0,0,0,0,0,0,0,0,0,0,0,0,0,1038130,2024-01-12T00:00:00.000Z,476,25,Robert Williams III,0,0,0,0,0,0
4,0,2,0,0,4,3,7,2,25,0,2,8,2,0,6,1038130,2024-01-12T00:00:00.000Z,56677747,25,Scoot Henderson,0,10,14,12,6,10.4
0,0,0,0,0,0,0,0,0,0,0,0,0,0,0,0,1038130,2024-01-12T00:00:00.000Z,38017690,25,Shaedon Sharpe,0,0,0,0,0,0
0,1,3,3,1,8,5,4,3,25,2,1,14,5,0,3,1038130,2024-01-12T00:00:00.000Z,56677850,25,Toumani Camara,1,19,19,14,5,20
2,0,2,2,0,12,7,3,1,31,3,2,15,5,0,2,1038131,2024-01-12T00:00:00.000Z,177,8,Aaron Gordon,0,20,22,17,7,22
0,0,0,0,0,0,0,0,0,1,0,0,0,0,0,1,1038131,2024-01-12T00:00:00.000Z,17896007,8,Braxton Key,0,0,0,0,0,-1
0,0,5,4,1,4,1,2,1,17,1,2,4,6,0,3,1038131,2024-01-12T00:00:00.000Z,38017709,8,Christian Braun,0,10,10,4,6,8.2
0,0,0,0,0,1,1,0,0,2,0,1,2,0,0,0,1038131,2024-01-12T00:00:00.000Z,38017727,8,Collin Gillespie,0,2,2,2,0,2
1,1,6,0,0,2,2,2,2,14,1,1,6,7,0,0,1038131,2024-01-12T00:00:00.000Z,250,8,DeAndre Jordan,1,13,14,7,8,18.9
0,0,0,0,0,0,0,0,0,0,0,0,0,0,0,0,1038131,2024-01-12T00:00:00.000Z,56677871,8,Hunter Tyson,0,0,0,0,0,0
0,0,0,0,0,0,0,0,0,0,0,0,0,0,0,0,1038131,2024-01-12T00:00:00.000Z,56677582,8,Jalen Pickett,0,0,0,0,0,0
9,0,2,5,3,15,8,1,1,34,0,3,20,2,0,2,1038131,2024-01-12T00:00:00.000Z,335,8,Jamal Murray,0,22,31,29,11,33.9
0,0,1,0,0,0,0,0,0,2,0,1,0,1,0,0,1038131,2024-01-12T00:00:00.000Z,17896103,8,Jay Huff,0,1,1,0,1,1.2
0,0,0,0,0,0,0,0,0,0,0,0,0,0,0,0,1038131,2024-01-12T00:00:00.000Z,56677776,8,Julian Strawther,0,0,0,0,0,0
0,0,0,0,0,0,0,0,0,2,0,0,0,0,0,1,1038131,2024-01-12T00:00:00.000Z,215,8,Justin Holiday,0,0,0,0,0,-1
3,0,2,6,3,9,4,0,0,31,0,0,11,2,2,0,1038131,2024-01-12T00:00:00.000Z,81,8,Kentavious Caldwell-Pope,2,13,16,14,5,23.9
1,1,9,5,2,12,8,3,2,33,1,2,20,10,1,1,1038131,2024-01-12T00:00:00.000Z,375,8,Michael Porter Jr.,2,30,31,21,11,38.5
14,1,7,2,1,17,11,4,4,32,3,4,27,10,0,2,1038131,2024-01-12T00:00:00.000Z,246,8,Nikola Jokic,1,37,51,41,24,61
0,1,2,4,2,7,3,0,0,15,1,1,8,3,1,0,1038131,2024-01-12T00:00:00.000Z,38017721,8,Peyton Watson,2,11,11,8,3,17.6
0,0,2,5,2,10,5,0,0,24,0,1,12,2,1,3,1038131,2024-01-12T00:00:00.000Z,236,8,Reggie Jackson,1,14,14,12,2,14.4
0,0,0,0,0,0,0,0,0,0,0,0,0,0,0,0,1038131,2024-01-12T00:00:00.000Z,666489,8,Vlatko Cancar,0,0,0,0,0,0
0,0,0,0,0,1,0,0,0,2,0,0,0,0,0,0,1038131,2024-01-12T00:00:00.000Z,3547268,8,Zeke Nnaji,0,0,0,0,0,0
6,0,4,1,0,11,4,2,1,34,0,2,9,4,0,2,1038131,2024-01-12T00:00:00.000Z,227,19,Brandon Ingram,0,13,19,15,10,20.8
7,0,5,8,3,10,4,2,1,30,0,2,12,5,1,2,1038131,2024-01-12T00:00:00.000Z,303,19,CJ McCollum,1,17,24,19,12,29.5
0,0,0,0,0,0,0,0,0,0,0,0,0,0,0,0,1038131,2024-01-12T00:00:00.000Z,491,19,Cody Zeller,0,0,0,0,0,0
3,0,2,2,0,4,1,2,0,15,2,0,2,4,3,0,1038131,2024-01-12T00:00:00.000Z,38017677,19,Dyson Daniels,3,6,9,5,7,20.3
1,0,1,0,0,0,0,0,0,2,0,0,0,1,0,0,1038131,2024-01-12T00:00:00.000Z,38017663,19,E.J. Liddell,0,1,2,1,2,2.7
1,1,1,2,2,4,3,0,0,19,0,1,8,1,0,1,1038131,2024-01-12T00:00:00.000Z,17896024,19,Herbert Jones,1,9,10,9,2,12.7
1,0,4,3,1,11,5,6,6,26,2,3,17,6,0,0,1038131,2024-01-12T00:00:00.000Z,455,19,Jonas Valanciunas,0,23,24,18,7,25.7
0,0,0,0,0,0,0,0,0,2,0,0,0,0,0,0,1038131,2024-01-12T00:00:00.000Z,56677837,19,Jordan Hawkins,0,0,0,0,0,0
1,0,0,3,2,7,3,2,2,17,1,0,10,1,1,1,1038131,2024-01-12T00:00:00.000Z,17896097,19,Jose Alvarado,1,11,12,11,2,14.7
0,0,0,0,0,0,0,0,0,0,0,0,0,0,0,0,1038131,2024-01-12T00:00:00.000Z,3547260,19,Kira Lewis Jr.,0,0,0,0,0,0
1,1,2,4,3,6,5,0,0,20,0,1,13,2,2,1,1038131,2024-01-12T00:00:00.000Z,340,19,Larry Nance Jr.,3,15,16,14,3,24.9
0,0,1,2,0,5,2,2,2,12,1,0,6,2,0,0,1038131,2024-01-12T00:00:00.000Z,3547293,19,Naji Marshall,0,8,8,6,2,8.4
4,0,3,8,2,9,2,0,0,28,0,0,6,3,2,0,1038131,2024-01-12T00:00:00.000Z,18677986,19,Trey Murphy III,2,9,13,10,7,21.6
5,1,4,0,0,22,13,6,4,35,2,1,30,6,0,1,1038131,2024-01-12T00:00:00.000Z,666969,19,Zion Williamson,1,36,41,35,11,46.7
0,0,0,3,1,4,2,2,2,12,0,1,7,0,0,1,1038132,2024-01-12T00:00:00.000Z,58,28,Chris Boucher,0,7,7,7,0,6
0,0,0,0,0,0,0,0,0,0,0,0,0,0,0,0,1038132,2024-01-12T00:00:00.000Z,38017710,28,Christian Koloko,0,0,0,0,0,0
4,0,0,7,4,9,4,0,0,23,0,2,12,0,1,1,1038132,2024-01-12T00:00:00.000Z,409,28,Dennis Schroder,1,12,16,16,4,20
2,0,0,1,0,1,0,0,0,7,1,1,0,1,0,1,1038132,2024-01-12T00:00:00.000Z,436,28,Garrett Temple,0,1,3,2,3,3.2
2,0,0,2,1,6,2,0,0,22,1,1,5,1,0,1,1038132,2024-01-12T00:00:00.000Z,3089,28,Gary Trent Jr.,0,6,8,7,3,8.2
2,0,1,2,0,3,0,0,0,12,0,1,0,1,0,0,1038132,2024-01-12T00:00:00.000Z,56677828,28,Gradey Dick,0,1,3,2,3,4.2
0,0,2,3,3,8,4,4,4,25,1,1,15,3,0,1,1038132,2024-01-12T00:00:00.000Z,3547269,28,Immanuel Quickley,0,18,18,15,3,17.6
0,0,1,0,0,5,4,10,7,8,2,0,15,3,1,1,1038132,2024-01-12T00:00:00.000Z,666762,28,Jalen McDaniels,1,18,18,15,3,20.6
0,0,0,0,0,0,0,0,0,0,0,0,0,0,0,0,1038132,2024-01-12T00:00:00.000Z,56677805,28,Javon Freeman-Liberty,0,0,0,0,0,0
6,2,4,4,1,8,3,2,2,31,2,1,9,6,2,0,1038132,2024-01-12T00:00:00.000Z,2309958,28,Jontay Porter,4,15,21,15,12,37.2
2,0,4,6,5,14,8,8,6,30,0,1,27,4,0,2,1038132,2024-01-12T00:00:00.000Z,416,28,Pascal Siakam,0,31,33,29,6,32.8
2,3,7,2,0,9,2,0,0,30,0,4,4,7,1,2,1038132,2024-01-12T00:00:00.000Z,666423,28,RJ Barrett,4,11,13,6,9,25.4
3,3,2,4,2,13,6,11,5,28,1,3,19,3,0,3,1038132,2024-01-12T00:00:00.000Z,17896055,28,Scottie Barnes,3,22,25,22,6,33.1
2,0,2,0,0,1,0,0,0,12,0,5,0,2,0,0,1038132,2024-01-12T00:00:00.000Z,489,28,Thaddeus Young,0,2,4,2,4,5.4
2,0,0,2,1,4,2,0,0,4,0,1,5,0,0,0,1038132,2024-01-12T00:00:00.000Z,56677842,29,Brice Sensabaugh,0,5,7,7,2,8
5,0,2,3,3,10,5,8,7,20,0,0,20,2,2,2,1038132,2024-01-12T00:00:00.000Z,413,29,Collin Sexton,2,22,27,25,7,33.9
0,0,0,0,0,0,0,0,0,0,0,0,0,0,0,0,1038132,2024-01-12T00:00:00.000Z,17896042,29,Jason Preston,0,0,0,0,0,0
1,0,6,1,0,3,2,0,0,14,1,4,4,7,0,1,1038132,2024-01-12T00:00:00.000Z,101,29,John Collins,0,11,12,5,8,12.9
0,0,0,0,0,0,0,0,0,0,0,0,0,0,0,0,1038132,2024-01-12T00:00:00.000Z,38017630,29,Johnny Juzang,0,0,0,0,0,0
5,0,1,9,5,16,8,0,0,31,0,1,21,1,0,0,1038132,2024-01-12T00:00:00.000Z,100,29,Jordan Clarkson,0,22,27,26,6,29.7
5,0,8,2,1,7,4,4,2,21,2,3,11,10,1,1,1038132,2024-01-12T00:00:00.000Z,358,29,Kelly Olynyk,1,21,26,16,15,32.5
6,0,3,5,0,10,3,3,3,24,0,0,9,3,0,3,1038132,2024-01-12T00:00:00.000Z,56677834,29,Keyonte George,0,12,18,15,9,18.6
5,2,3,1,0,4,3,0,0,17,2,3,6,5,1,2,1038132,2024-01-12T00:00:00.000Z,139,29,Kris Dunn,3,11,16,11,10,26.5
2,0,6,6,4,11,7,5,4,29,3,2,22,9,1,3,1038132,2024-01-12T00:00:00.000Z,297,29,Lauri Markkanen,1,31,33,24,11,35.8
0,0,1,0,0,2,1,2,2,6,0,2,4,1,0,1,1038132,2024-01-12T00:00:00.000Z,666881,29,Luka Samanic,0,5,5,4,1,4.2
0,0,0,0,0,0,0,0,0,0,0,0,0,0,0,0,1038132,2024-01-12T00:00:00.000Z,19465584,29,Micah Potter,0,0,0,0,0,0
1,2,4,7,2,8,3,0,0,22,1,1,8,5,0,0,1038132,2024-01-12T00:00:00.000Z,38017620,29,Ochai Agbaji,2,13,14,9,6,21.5
0,0,2,0,0,2,2,0,0,5,2,1,4,4,0,0,1038132,2024-01-12T00:00:00.000Z,11891374,29,Omer Yurtseven,0,8,8,4,4,8.8
0,1,1,5,3,9,5,0,0,23,1,0,13,2,0,0,1038132,2024-01-12T00:00:00.000Z,38017739,29,Simone Fontecchio,1,15,15,13,2,18.4
0,0,0,0,0,0,0,0,0,0,0,0,0,0,0,0,1038132,2024-01-12T00:00:00.000Z,666650,29,Talen Horton-Tucker,0,0,0,0,0,0
1,0,1,2,2,2,2,0,0,4,0,1,6,1,1,0,1038132,2024-01-12T00:00:00.000Z,56677824,29,Taylor Hendricks,1,7,8,7,2,11.7
1,3,4,0,0,5,5,4,2,20,2,4,12,6,1,0,1038132,2024-01-12T00:00:00.000Z,38017705,29,Walker Kessler,4,18,19,13,7,32.7
0,0,0,0,0,0,0,0,0,0,0,0,0,0,0,0,1038133,2024-01-12T00:00:00.000Z,347,4,Frank Ntilikina,0,0,0,0,0,0
0,0,0,0,0,0,0,0,0,0,0,0,0,0,0,0,1038133,2024-01-12T00:00:00.000Z,204,4,Gordon Hayward,0,0,0,0,0,0
0,0,0,1,0,2,1,0,0,7,0,1,2,0,0,0,1038133,2024-01-12T00:00:00.000Z,56677866,4,Leaky Black,0,2,2,2,0,2
0,0,0,0,0,0,0,0,0,0,0,0,0,0,0,0,1038133,2024-01-12T00:00:00.000Z,38017698,4,Mark Williams,0,0,0,0,0,0
0,0,0,0,0,0,0,0,0,0,0,0,0,0,0,0,1038133,2024-01-12T00:00:00.000Z,666950,4,P.J. Washington,0,0,0,0,0,0
3,0,2,0,0,3,2,0,0,16,0,3,4,2,1,0,1038133,2024-01-12T00:00:00.000Z,38017693,27,Blake Wesley,1,6,9,7,5,13.9
0,0,0,0,0,0,0,0,0,0,0,0,0,0,0,0,1038133,2024-01-12T00:00:00.000Z,17895854,27,Charles Bassey,0,0,0,0,0,0
0,0,0,0,0,0,0,0,0,0,0,0,0,0,0,0,1038133,2024-01-12T00:00:00.000Z,17896049,27,David Duke Jr.,0,0,0,0,0,0
0,0,0,0,0,0,0,0,0,0,0,0,0,0,0,0,1038133,2024-01-12T00:00:00.000Z,56677817,27,Sidy Cissoko,0,0,0,0,0,0
0,0,0,0,0,0,0,0,0,0,0,0,0,0,0,0,1038133,2024-01-12T00:00:00.000Z,102,27,Zach Collins,0,0,0,0,0,0