"ast","blk","dreb","fg3a","fg3m","fga","fgm","fta","ftm","min","oreb","pf","pts","reb","stl","turnover","game.id","game.date","game.home_team_id","game.postseason","game.visitor_team_id","player.id","player.position","player.team_id","team.id","team.full_name","player_name","blk_stl","pts_rebs","pts_rebs_ast","pts_ast","rebs_ast","fantasy"
2,0,10,9,2,13,5,0,0,"30",2,1,12,12,2,0,1037593,"2023-10-24T00:00:00.000Z",8,FALSE,14,375,"F",8,8,"Denver Nuggets","Michael Porter Jr.",2,24,26,14,14,35.4
5,1,5,2,1,11,7,0,0,"35",2,0,15,7,2,0,1037593,"2023-10-24T00:00:00.000Z",8,FALSE,14,177,"F",8,8,"Denver Nuggets","Aaron Gordon",3,22,27,20,12,39.9
11,1,10,5,3,22,12,4,2,"36",3,2,29,13,1,2,1037593,"2023-10-24T00:00:00.000Z",8,FALSE,14,246,"C",8,8,"Denver Nuggets","Nikola Jokic",2,42,53,40,24,65.1
1,1,1,3,2,12,8,2,2,"36",1,5,20,2,3,3,1037593,"2023-10-24T00:00:00.000Z",8,FALSE,14,81,"G",8,8,"Denver Nuggets","Kentavious Caldwell-Pope",4,22,23,21,3,32.9
6,1,2,5,3,13,8,2,2,"34",0,3,21,2,0,1,1037593,"2023-10-24T00:00:00.000Z",8,FALSE,14,335,"G",8,8,"Denver Nuggets","Jamal Murray",1,23,29,27,8,34.4
2,1,2,1,0,5,2,2,1,"19",1,1,5,3,0,1,1037593,"2023-10-24T00:00:00.000Z",8,FALSE,14,38017709,"G",8,8,"Denver Nuggets","Christian Braun",1,8,10,7,5,13.6
0,0,0,0,0,0,0,0,0,"01",0,0,0,0,0,0,1037593,"2023-10-24T00:00:00.000Z",8,FALSE,14,38017727,"G",8,8,"Denver Nuggets","Collin Gillespie",0,0,0,0,0,0
0,0,0,0,0,0,0,0,0,"00",0,0,0,0,0,0,1037593,"2023-10-24T00:00:00.000Z",8,FALSE,14,215,"F-G",8,8,"Denver Nuggets","Justin Holiday",0,0,0,0,0,0
1,0,3,5,2,8,3,0,0,"24",0,0,8,3,1,2,1037593,"2023-10-24T00:00:00.000Z",8,FALSE,14,236,"G",8,8,"Denver Nuggets","Reggie Jackson",1,11,12,9,4,14.1
0,0,0,0,0,0,0,0,0,"00",0,0,0,0,0,0,1037593,"2023-10-24T00:00:00.000Z",8,FALSE,14,250,"C",8,8,"Denver Nuggets","DeAndre Jordan",0,0,0,0,0,0
0,0,1,3,0,10,3,0,0,"15",2,2,6,3,0,0,1037593,"2023-10-24T00:00:00.000Z",8,FALSE,14,666609,"F",14,14,"Los Angeles Lakers","Rui Hachimura",0,9,9,6,3,9.6
0,0,1,0,0,0,0,0,0,"07",0,1,0,1,0,0,1037593,"2023-10-24T00:00:00.000Z",8,FALSE,14,666626,"C",14,14,"Los Angeles Lakers","Jaxson Hayes",0,1,1,0,1,1.2
0,0,0,0,0,0,0,0,0,"01",0,0,0,0,0,0,1037593,"2023-10-24T00:00:00.000Z",8,FALSE,14,56677836,"F",14,14,"Los Angeles Lakers","Maxwell Lewis",0,0,0,0,0,0
0,1,2,2,1,4,2,2,2,"18",2,2,7,4,0,0,1037593,"2023-10-24T00:00:00.000Z",8,FALSE,14,666860,"F-G",14,14,"Los Angeles Lakers","Cameron Reddish",1,11,11,7,4,14.8
0,0,0,0,0,0,0,0,0,"01",0,0,0,0,0,0,1037593,"2023-10-24T00:00:00.000Z",8,FALSE,14,17896007,"G",8,8,"Denver Nuggets","Braxton Key",0,0,0,0,0,0
1,0,0,1,0,3,1,2,2,"12",0,2,4,0,0,1,1037593,"2023-10-24T00:00:00.000Z",8,FALSE,14,3547268,"F-C",8,8,"Denver Nuggets","Zeke Nnaji",0,4,5,5,1,4.5
0,0,0,0,0,1,1,0,0,"01",0,0,2,0,0,0,1037593,"2023-10-24T00:00:00.000Z",8,FALSE,14,56677582,"G",8,8,"Denver Nuggets","Jalen Pickett",0,2,2,2,0,2
0,0,0,0,0,0,0,0,0,"00",0,0,0,0,0,0,1037593,"2023-10-24T00:00:00.000Z",8,FALSE,14,56677776,"G",8,8,"Denver Nuggets","Julian Strawther",0,0,0,0,0,0
0,1,0,3,1,3,1,0,0,"11",0,1,3,0,0,1,1037593,"2023-10-24T00:00:00.000Z",8,FALSE,14,38017721,"G",8,8,"Denver Nuggets","Peyton Watson",1,3,3,3,0,5
0,0,0,0,0,0,0,0,0,"00",0,0,0,0,0,0,1037593,"2023-10-24T00:00:00.000Z",8,FALSE,14,666489,"F",8,8,"Denver Nuggets","Vlatko Cancar",0,0,0,0,0,0
0,0,0,0,0,0,0,0,0,"00",0,0,0,0,0,0,1037593,"2023-10-24T00:00:00.000Z",8,FALSE,14,17896103,"F-C",8,8,"Denver Nuggets","Jay Huff",0,0,0,0,0,0
0,0,0,0,0,0,0,0,0,"00",0,0,0,0,0,0,1037593,"2023-10-24T00:00:00.000Z",8,FALSE,14,56677871,"F",8,8,"Denver Nuggets","Hunter Tyson",0,0,0,0,0,0
1,1,2,6,4,8,6,2,2,"30",1,0,18,3,0,1,1037593,"2023-10-24T00:00:00.000Z",8,FALSE,14,383,"F",14,14,"Los Angeles Lakers","Taurean Prince",1,21,22,19,4,25.1
5,0,7,4,1,16,10,1,0,"29",1,1,21,8,1,0,1037593,"2023-10-24T00:00:00.000Z",8,FALSE,14,237,"F",14,14,"Los Angeles Lakers","LeBron James",1,29,34,26,13,41.1
4,2,7,2,1,17,6,4,4,"34",1,3,17,8,0,2,1037593,"2023-10-24T00:00:00.000Z",8,FALSE,14,117,"F-C",14,14,"Los Angeles Lakers","Anthony Davis",2,25,29,21,12,36.6
0,0,0,0,0,0,0,0,0,"01",0,0,0,0,0,0,1037593,"2023-10-24T00:00:00.000Z",8,FALSE,14,38017697,"G",14,14,"Los Angeles Lakers","Max Christie",0,0,0,0,0,0
2,0,0,4,0,8,3,0,0,"22",1,3,6,1,1,2,1037593,"2023-10-24T00:00:00.000Z",8,FALSE,14,1603383,"G",14,14,"Los Angeles Lakers","Gabe Vincent",1,7,9,8,3,11.2
0,0,3,1,0,4,3,2,1,"16",1,1,7,4,0,1,1037593,"2023-10-24T00:00:00.000Z",8,FALSE,14,486,"F",14,14,"Los Angeles Lakers","Christian Wood",0,11,11,7,4,10.8
0,0,0,0,0,0,0,0,0,"00",0,0,0,0,0,0,1037593,"2023-10-24T00:00:00.000Z",8,FALSE,14,56677738,"C",14,14,"Los Angeles Lakers","Colin Castleton",0,0,0,0,0,0
0,0,0,0,0,0,0,0,0,"00",0,0,0,0,0,0,1037593,"2023-10-24T00:00:00.000Z",8,FALSE,14,56677867,"F",14,14,"Los Angeles Lakers","Alex Fudge",0,0,0,0,0,0
0,0,0,0,0,0,0,0,0,"00",0,0,0,0,0,0,1037593,"2023-10-24T00:00:00.000Z",8,FALSE,14,56677868,"G",14,14,"Los Angeles Lakers","D'Moi Hodge",0,0,0,0,0,0
0,0,0,0,0,0,0,0,0,"00",0,0,0,0,0,0,1037593,"2023-10-24T00:00:00.000Z",8,FALSE,14,56677835,"G",14,14,"Los Angeles Lakers","Jalen Hood-Schifino",0,0,0,0,0,0
0,0,0,0,0,0,0,0,0,"00",0,0,0,0,0,0,1037593,"2023-10-24T00:00:00.000Z",8,FALSE,14,457,"F",14,14,"Los Angeles Lakers","Jarred Vanderbilt",0,0,0,0,0,0
4,0,4,2,1,11,4,7,5,"31",4,2,14,8,2,2,1037593,"2023-10-24T00:00:00.000Z",8,FALSE,14,17553995,"G",14,14,"Los Angeles Lakers","Austin Reaves",2,22,26,18,12,33.6
7,0,4,5,2,12,4,2,1,"36",0,3,11,4,1,3,1037593,"2023-10-24T00:00:00.000Z",8,FALSE,14,405,"G",14,14,"Los Angeles Lakers","D'Angelo Russell",1,15,22,18,11,26.3
3,1,6,11,3,18,6,0,0,"36",1,3,15,7,0,3,1037594,"2023-10-24T00:00:00.000Z",10,FALSE,24,443,"G",10,10,"Golden State Warriors","Klay Thompson",1,22,25,18,10,27.9
0,1,0,3,0,12,4,3,2,"27",1,3,10,1,0,0,1037594,"2023-10-24T00:00:00.000Z",10,FALSE,24,475,"F-G",10,10,"Golden State Warriors","Andrew Wiggins",1,11,11,10,1,14.2
1,0,6,0,0,6,3,1,1,"28",5,2,7,11,0,2,1037594,"2023-10-24T00:00:00.000Z",10,FALSE,24,282,"F",10,10,"Golden State Warriors","Kevon Looney",0,18,19,8,12,19.7
9,0,5,6,0,15,4,7,6,"34",1,0,14,6,2,1,1037594,"2023-10-24T00:00:00.000Z",10,FALSE,24,367,"G",10,10,"Golden State Warriors","Chris Paul",2,20,29,23,15,39.7
1,0,4,14,4,20,8,7,7,"31",1,5,27,5,1,2,1037594,"2023-10-24T00:00:00.000Z",10,FALSE,24,115,"G",10,10,"Golden State Warriors","Stephen Curry",1,32,33,28,6,35.5
0,0,0,0,0,0,0,0,0,"00",0,0,0,0,0,0,1037594,"2023-10-24T00:00:00.000Z",10,FALSE,24,56677799,"F",10,10,"Golden State Warriors","Trayce Jackson-Davis",0,0,0,0,0,0
1,0,0,0,0,0,0,0,0,"04",1,0,0,1,0,0,1037594,"2023-10-24T00:00:00.000Z",10,FALSE,24,251,"G",10,10,"Golden State Warriors","Cory Joseph",0,1,2,1,2,2.7
1,2,3,3,1,11,3,0,0,"20",4,3,7,7,0,0,1037594,"2023-10-24T00:00:00.000Z",10,FALSE,24,407,"F",10,10,"Golden State Warriors","Dario Saric",2,14,15,8,8,22.9
0,0,0,0,0,0,0,0,0,"00",0,0,0,0,0,0,1037594,"2023-10-24T00:00:00.000Z",10,FALSE,24,17896070,"F",10,10,"Golden State Warriors","Usman Garuba",0,0,0,0,0,0
0,0,0,0,0,0,0,0,0,"00",0,0,0,0,0,0,1037594,"2023-10-24T00:00:00.000Z",10,FALSE,24,185,"F",10,10,"Golden State Warriors","Draymond Green",0,0,0,0,0,0
0,0,0,0,0,0,0,0,0,"00",0,0,0,0,0,0,1037594,"2023-10-24T00:00:00.000Z",10,FALSE,24,45658838,"G",10,10,"Golden State Warriors","Lester Quinones",0,0,0,0,0,0
0,0,0,0,0,0,0,0,0,"00",0,0,0,0,0,0,1037594,"2023-10-24T00:00:00.000Z",10,FALSE,24,398,"G",10,10,"Golden State Warriors","Jerome Robinson",0,0,0,0,0,0
1,0,1,1,1,9,7,2,2,"31",4,2,17,5,1,2,1037594,"2023-10-24T00:00:00.000Z",10,FALSE,24,356,"G",24,24,"Phoenix Suns","Josh Okogie",1,22,23,18,6,25.5
3,1,8,2,1,22,7,5,3,"37",2,1,18,10,0,2,1037594,"2023-10-24T00:00:00.000Z",10,FALSE,24,140,"F",24,24,"Phoenix Suns","Kevin Durant",1,28,31,21,13,35.5
3,1,11,2,1,8,5,3,3,"28",3,5,14,14,0,1,1037594,"2023-10-24T00:00:00.000Z",10,FALSE,24,349,"C",24,24,"Phoenix Suns","Jusuf Nurkic",1,28,31,17,17,37.3
2,0,1,5,0,6,0,0,0,"21",3,2,0,4,0,1,1037594,"2023-10-24T00:00:00.000Z",10,FALSE,24,8,"G",24,24,"Phoenix Suns","Grayson Allen",0,4,6,2,6,6.8
8,0,5,8,3,21,13,3,3,"37",1,4,32,6,1,6,1037594,"2023-10-24T00:00:00.000Z",10,FALSE,24,57,"G",24,24,"Phoenix Suns","Devin Booker",1,38,46,40,14,48.2
0,0,0,0,0,0,0,0,0,"00",0,0,0,0,0,0,1037594,"2023-10-24T00:00:00.000Z",10,FALSE,24,3547095,"C-F",24,24,"Phoenix Suns","Udoka Azubuike",0,0,0,0,0,0
0,0,0,0,0,0,0,0,0,"00",0,0,0,0,0,0,1037594,"2023-10-24T00:00:00.000Z",10,FALSE,24,32,"F",24,24,"Phoenix Suns","Keita Bates-Diop",0,0,0,0,0,0
0,0,0,0,0,0,0,0,0,"00",0,0,0,0,0,0,1037594,"2023-10-24T00:00:00.000Z",10,FALSE,24,666451,"C",24,24,"Phoenix Suns","Bol Bol",0,0,0,0,0,0
2,3,6,0,0,3,1,4,2,"19",2,3,4,8,0,3,1037594,"2023-10-24T00:00:00.000Z",10,FALSE,24,147,"F",24,24,"Phoenix Suns","Drew Eubanks",3,12,14,6,10,22.6
3,0,3,1,0,4,1,0,0,"14",1,0,2,4,1,2,1037594,"2023-10-24T00:00:00.000Z",10,FALSE,24,18678058,"",24,24,"Phoenix Suns","Jordan Goodwin",1,6,9,5,7,12.3
1,1,3,9,2,16,4,0,0,"32",1,2,10,4,1,1,1037594,"2023-10-24T00:00:00.000Z",10,FALSE,24,178,"G",24,24,"Phoenix Suns","Eric Gordon",2,14,15,11,5,21.3
0,0,0,0,0,0,0,0,0,"00",0,0,0,0,0,0,1037594,"2023-10-24T00:00:00.000Z",10,FALSE,24,3547298,"G",24,24,"Phoenix Suns","Saben Lee",0,0,0,0,0,0
1,1,3,0,0,8,4,6,4,"20",3,5,12,6,2,2,1037594,"2023-10-24T00:00:00.000Z",10,FALSE,24,17553979,"F",10,10,"Golden State Warriors","Jonathan Kuminga",3,18,19,13,7,27.7
0,1,2,4,2,6,4,2,1,"18",1,1,11,3,3,1,1037594,"2023-10-24T00:00:00.000Z",10,FALSE,24,17553992,"G",10,10,"Golden State Warriors","Moses Moody",4,14,14,11,3,25.6
2,0,2,2,0,5,0,2,1,"22",0,1,1,2,3,0,1037594,"2023-10-24T00:00:00.000Z",10,FALSE,24,2189,"",10,10,"Golden State Warriors","Gary Payton II",3,3,5,3,4,15.4
0,0,0,0,0,0,0,0,0,"00",0,0,0,0,0,0,1037594,"2023-10-24T00:00:00.000Z",10,FALSE,24,56677858,"G",10,10,"Golden State Warriors","Brandin Podziemski",0,0,0,0,0,0
0,0,1,1,1,1,1,0,0,"03",0,1,3,1,1,0,1037594,"2023-10-24T00:00:00.000Z",10,FALSE,24,666729,"F",24,24,"Phoenix Suns","Nassir Little",1,4,4,3,1,7.2
0,0,0,0,0,0,0,0,0,"00",0,0,0,0,0,0,1037594,"2023-10-24T00:00:00.000Z",10,FALSE,24,314,"F",24,24,"Phoenix Suns","Chimezie Metu",0,0,0,0,0,0
0,1,4,4,2,5,3,0,0,"18",0,2,8,4,0,1,1037594,"2023-10-24T00:00:00.000Z",10,FALSE,24,470,"G",24,24,"Phoenix Suns","Yuta Watanabe",1,12,12,8,4,14.8
0,0,0,0,0,0,0,0,0,"00",0,0,0,0,0,0,1037594,"2023-10-24T00:00:00.000Z",10,FALSE,24,37,"G",24,24,"Phoenix Suns","Bradley Beal",0,0,0,0,0,0
0,0,0,0,0,0,0,0,0,"00",0,0,0,0,0,0,1037594,"2023-10-24T00:00:00.000Z",10,FALSE,24,272,"G",24,24,"Phoenix Suns","Damion Lee",0,0,0,0,0,0
7,1,5,1,0,8,4,3,2,"33",3,1,10,8,1,6,1037595,"2023-10-25T00:00:00.000Z",4,FALSE,1,204,"F",4,4,"Charlotte Hornets","Gordon Hayward",2,18,25,17,15,30.1
2,0,4,6,1,18,12,0,0,"32",1,4,25,5,0,1,1037595,"2023-10-25T00:00:00.000Z",4,FALSE,1,666950,"F",4,4,"Charlotte Hornets","P.J. Washington",0,30,32,27,7,33
1,1,11,0,0,6,5,3,3,"30",4,2,13,15,3,2,1037595,"2023-10-25T00:00:00.000Z",4,FALSE,1,38017698,"C",4,4,"Charlotte Hornets","Mark Williams",4,28,29,14,16,42.5
6,0,4,7,2,16,7,12,8,"34",1,2,24,5,0,3,1037595,"2023-10-25T00:00:00.000Z",4,FALSE,1,403,"G",4,4,"Charlotte Hornets","Terry Rozier",0,29,35,30,11,36
10,0,5,11,4,15,4,4,3,"31",1,3,15,6,1,3,1037595,"2023-10-25T00:00:00.000Z",4,FALSE,1,3547239,"G",4,4,"Charlotte Hornets","LaMelo Ball",1,21,31,25,16,37.2
2,0,3,7,3,9,5,0,0,"25",0,3,13,3,0,1,1037595,"2023-10-25T00:00:00.000Z",4,FALSE,1,56677823,"F",4,4,"Charlotte Hornets","Brandon Miller",0,16,18,15,5,18.6
4,0,4,5,1,9,3,0,0,"24",0,1,7,4,3,0,1037595,"2023-10-25T00:00:00.000Z",4,FALSE,1,53,"G",1,1,"Atlanta Hawks","Bogdan Bogdanovic",3,11,15,11,8,26.8
0,0,0,0,0,0,0,0,0,"00",0,0,0,0,0,0,1037595,"2023-10-25T00:00:00.000Z",4,FALSE,1,56677838,"G",1,1,"Atlanta Hawks","Kobe Bufkin",0,0,0,0,0,0
0,0,0,0,0,0,0,0,0,"00",0,0,0,0,0,0,1037595,"2023-10-25T00:00:00.000Z",4,FALSE,1,666564,"F",1,1,"Atlanta Hawks","Bruno Fernando",0,0,0,0,0,0
0,0,0,0,0,0,0,0,0,"00",0,0,0,0,0,0,1037595,"2023-10-25T00:00:00.000Z",4,FALSE,1,3547297,"G",1,1,"Atlanta Hawks","Trent Forrest",0,0,0,0,0,0
0,0,2,1,0,2,1,0,0,"10",0,1,2,2,0,1,1037595,"2023-10-25T00:00:00.000Z",4,FALSE,1,38017689,"F",1,1,"Atlanta Hawks","AJ Griffin",0,4,4,2,2,3.4
0,0,0,0,0,0,0,0,0,"00",0,0,0,0,0,0,1037595,"2023-10-25T00:00:00.000Z",4,FALSE,1,56677806,"F",1,1,"Atlanta Hawks","Mouhamed Gueye",0,0,0,0,0,0
2,1,7,3,1,13,9,4,2,"29",0,1,21,7,2,0,1037595,"2023-10-25T00:00:00.000Z",4,FALSE,1,17896040,"F",1,1,"Atlanta Hawks","Jalen Johnson",3,28,30,23,9,41.4
0,0,0,0,0,0,0,0,0,"00",0,0,0,0,0,0,1037595,"2023-10-25T00:00:00.000Z",4,FALSE,1,666754,"G",1,1,"Atlanta Hawks","Garrison Mathews",0,0,0,0,0,0
0,0,0,0,0,0,0,0,0,"00",0,0,0,0,0,0,1037595,"2023-10-25T00:00:00.000Z",4,FALSE,1,319,"G",1,1,"Atlanta Hawks","Patty Mills",0,0,0,0,0,0
2,0,3,0,0,5,3,1,1,"19",1,5,7,4,0,1,1037595,"2023-10-25T00:00:00.000Z",4,FALSE,1,3547244,"F-C",1,1,"Atlanta Hawks","Onyeka Okongwu",0,11,13,9,6,13.8
9,0,1,9,1,19,4,15,14,"36",0,3,23,1,1,5,1037595,"2023-10-25T00:00:00.000Z",4,FALSE,1,490,"G",1,1,"Atlanta Hawks","Trae Young",1,24,33,32,10,35.7
0,0,0,0,0,0,0,0,0,"00",0,0,0,0,0,0,1037595,"2023-10-25T00:00:00.000Z",4,FALSE,1,56677855,"G",1,1,"Atlanta Hawks","Seth Lundy",0,0,0,0,0,0
0,0,0,0,0,0,0,0,0,"00",0,0,0,0,0,0,1037595,"2023-10-25T00:00:00.000Z",4,FALSE,1,301,"G-F",1,1,"Atlanta Hawks","Wesley Matthews",0,0,0,0,0,0
0,0,0,0,0,0,0,0,0,"00",0,0,0,0,0,0,1037595,"2023-10-25T00:00:00.000Z",4,FALSE,1,56677875,"F",1,1,"Atlanta Hawks","Miles Norris",0,0,0,0,0,0
0,0,0,0,0,0,0,0,0,"00",0,0,0,0,0,0,1037595,"2023-10-25T00:00:00.000Z",4,FALSE,1,62,"F",4,4,"Charlotte Hornets","Miles Bridges",0,0,0,0,0,0
0,0,0,0,0,0,0,0,0,"00",0,0,0,0,0,0,1037595,"2023-10-25T00:00:00.000Z",4,FALSE,1,666748,"F",4,4,"Charlotte Hornets","Cody Martin",0,0,0,0,0,0
0,0,0,0,0,0,0,0,0,"00",0,0,0,0,0,0,1037595,"2023-10-25T00:00:00.000Z",4,FALSE,1,38017708,"G",4,4,"Charlotte Hornets","Bryce McGowens",0,0,0,0,0,0
0,0,0,0,0,0,0,0,0,"00",0,0,0,0,0,0,1037595,"2023-10-25T00:00:00.000Z",4,FALSE,1,347,"G",4,4,"Charlotte Hornets","Frank Ntilikina",0,0,0,0,0,0
0,0,0,0,0,0,0,0,0,"00",0,0,0,0,0,0,1037595,"2023-10-25T00:00:00.000Z",4,FALSE,1,422,"G",4,4,"Charlotte Hornets","Ish Smith",0,0,0,0,0,0
1,0,2,4,1,9,4,1,0,"31",2,6,9,4,0,0,1037595,"2023-10-25T00:00:00.000Z",4,FALSE,1,666656,"F",1,1,"Atlanta Hawks","De'Andre Hunter",0,13,14,10,5,15.3
0,0,2,4,1,12,6,2,2,"29",3,1,15,5,5,2,1037595,"2023-10-25T00:00:00.000Z",4,FALSE,1,3547256,"F",1,1,"Atlanta Hawks","Saddiq Bey",5,20,20,15,5,34
0,0,7,0,0,10,6,4,3,"29",6,1,15,13,1,2,1037595,"2023-10-25T00:00:00.000Z",4,FALSE,1,83,"C",1,1,"Atlanta Hawks","Clint Capela",1,28,28,15,13,31.6
6,0,2,3,0,14,3,6,5,"33",0,0,11,2,0,1,1037595,"2023-10-25T00:00:00.000Z",4,FALSE,1,334,"G",1,1,"Atlanta Hawks","Dejounte Murray",0,13,19,17,8,21.4
1,0,1,3,1,7,2,0,0,"20",1,0,5,2,0,0,1037595,"2023-10-25T00:00:00.000Z",4,FALSE,1,18678001,"F",4,4,"Charlotte Hornets","JT Thor",0,7,8,6,3,8.9
1,1,3,0,0,2,2,4,3,"18",1,3,7,4,0,2,1037595,"2023-10-25T00:00:00.000Z",4,FALSE,1,3547282,"C",4,4,"Charlotte Hornets","Nick Richards",1,11,12,8,5,14.3
4,0,3,2,0,5,2,0,0,"16",0,3,4,3,0,1,1037595,"2023-10-25T00:00:00.000Z",4,FALSE,1,3547253,"G",4,4,"Charlotte Hornets","Theo Maledon",0,7,11,8,7,12.6
0,0,0,0,0,0,0,0,0,"01",0,0,0,0,0,0,1037595,"2023-10-25T00:00:00.000Z",4,FALSE,1,56677846,"G",4,4,"Charlotte Hornets","Nick Smith Jr.",0,0,0,0,0,0
0,0,0,0,0,0,0,0,0,"00",0,0,0,0,0,0,1037595,"2023-10-25T00:00:00.000Z",4,FALSE,1,56677848,"G",4,4,"Charlotte Hornets","Amari Bailey",0,0,0,0,0,0
0,0,0,0,0,0,0,0,0,"00",0,0,0,0,0,0,1037595,"2023-10-25T00:00:00.000Z",4,FALSE,1,56677866,"F",4,4,"Charlotte Hornets","Leaky Black",0,0,0,0,0,0
0,0,0,0,0,0,0,0,0,"00",0,0,0,0,0,0,1037595,"2023-10-25T00:00:00.000Z",4,FALSE,1,17896037,"G",4,4,"Charlotte Hornets","James Bouknight",0,0,0,0,0,0
1,0,2,8,6,11,8,2,2,"27",1,3,24,3,1,1,1037596,"2023-10-25T00:00:00.000Z",12,FALSE,30,69,"G",12,12,"Indiana Pacers","Bruce Brown",1,27,28,25,4,31.1
1,0,3,5,2,9,4,1,1,"19",1,0,11,4,1,0,1037596,"2023-10-25T00:00:00.000Z",12,FALSE,30,3547243,"F",12,12,"Indiana Pacers","Obi Toppin",1,15,16,12,5,20.3
1,3,8,2,0,8,5,2,1,"23",0,4,11,8,0,2,1037596,"2023-10-25T00:00:00.000Z",12,FALSE,30,452,"C-F",12,12,"Indiana Pacers","Myles Turner",3,19,20,12,9,29.1
5,0,4,6,2,15,6,4,4,"26",0,1,18,4,2,2,1037596,"2023-10-25T00:00:00.000Z",12,FALSE,30,38017686,"G-F",12,12,"Indiana Pacers","Bennedict Mathurin",2,22,27,23,9,34.3
11,2,3,6,2,16,9,0,0,"27",0,1,20,3,1,3,1037596,"2023-10-25T00:00:00.000Z",12,FALSE,30,3547245,"G",12,12,"Indiana Pacers","Tyrese Haliburton",3,23,34,31,14,46.1
5,1,2,7,4,9,5,0,0,"25",0,0,14,2,1,1,1037596,"2023-10-25T00:00:00.000Z",12,FALSE,30,210,"G",12,12,"Indiana Pacers","Buddy Hield",2,16,21,19,7,28.9
0,0,3,0,0,4,2,0,0,"11",1,2,4,4,0,0,1037596,"2023-10-25T00:00:00.000Z",12,FALSE,30,17896035,"F",12,12,"Indiana Pacers","Isaiah Jackson",0,8,8,4,4,8.8
2,0,1,0,0,2,2,0,0,"06",0,0,4,1,2,0,1037596,"2023-10-25T00:00:00.000Z",12,FALSE,30,304,"G",12,12,"Indiana Pacers","T.J. McConnell",2,5,7,6,3,14.2
10,0,3,1,0,9,6,0,0,"22",1,4,12,4,0,2,1037596,"2023-10-25T00:00:00.000Z",12,FALSE,30,38017507,"G-F",12,12,"Indiana Pacers","Andrew Nembhard",0,16,26,22,14,29.8
1,1,4,3,1,5,2,2,2,"23",1,3,7,5,0,1,1037596,"2023-10-25T00:00:00.000Z",12,FALSE,30,3547250,"G-F",12,12,"Indiana Pacers","Aaron Nesmith",1,12,13,8,6,16.5
0,0,0,0,0,0,0,0,0,"00",0,0,0,0,0,0,1037596,"2023-10-25T00:00:00.000Z",12,FALSE,30,439,"F",13,12,"Indiana Pacers","Daniel Theis",0,0,0,0,0,0
0,0,3,1,0,5,0,0,0,"06",1,1,0,4,1,0,1037596,"2023-10-25T00:00:00.000Z",12,FALSE,30,56677832,"F",12,12,"Indiana Pacers","Jarace Walker",1,4,4,0,4,7.8
0,0,0,0,0,0,0,0,0,"00",0,0,0,0,0,0,1037596,"2023-10-25T00:00:00.000Z",12,FALSE,30,38017701,"G",12,12,"Indiana Pacers","Kendall Brown",0,0,0,0,0,0
1,1,0,2,1,7,2,0,0,"06",1,0,5,1,0,0,1037596,"2023-10-25T00:00:00.000Z",12,FALSE,30,3547207,"F",12,12,"Indiana Pacers","Jordan Nwora",1,6,7,6,2,10.7
0,0,0,0,0,1,0,0,0,"06",0,0,0,0,0,0,1037596,"2023-10-25T00:00:00.000Z",12,FALSE,30,56677861,"G",12,12,"Indiana Pacers","Ben Sheppard",0,0,0,0,0,0
0,0,5,2,2,6,5,1,1,"13",3,4,13,8,1,0,1037596,"2023-10-25T00:00:00.000Z",12,FALSE,30,3547264,"F-C",12,12,"Indiana Pacers","Jalen Smith",1,21,21,13,8,25.6
0,0,0,0,0,0,0,0,0,"00",0,0,0,0,0,0,1037596,"2023-10-25T00:00:00.000Z",12,FALSE,30,56677778,"F-C",12,12,"Indiana Pacers","Oscar Tshiebwe",0,0,0,0,0,0
0,0,0,0,0,0,0,0,0,"00",0,0,0,0,0,0,1037596,"2023-10-25T00:00:00.000Z",12,FALSE,30,56677794,"G",12,12,"Indiana Pacers","Isaiah Wong",0,0,0,0,0,0
0,2,1,4,1,18,9,6,6,"25",1,0,25,2,0,0,1037596,"2023-10-25T00:00:00.000Z",12,FALSE,30,265,"F",30,30,"Washington Wizards","Kyle Kuzma",2,27,27,25,2,33.4
5,0,5,0,0,8,4,2,1,"21",2,0,9,7,1,2,1037596,"2023-10-25T00:00:00.000Z",12,FALSE,30,3547242,"F",30,30,"Washington Wizards","Deni Avdija",1,16,21,14,12,25.9
0,2,4,0,0,2,2,4,2,"21",1,5,6,5,0,0,1037596,"2023-10-25T00:00:00.000Z",12,FALSE,30,666577,"F",30,30,"Washington Wizards","Daniel Gafford",2,11,11,6,5,18
5,1,2,6,0,18,7,5,4,"26",0,1,18,2,1,4,1037596,"2023-10-25T00:00:00.000Z",12,FALSE,30,666848,"G",30,30,"Washington Wizards","Jordan Poole",2,20,25,23,7,29.9
6,1,2,4,2,12,7,1,0,"28",1,1,16,3,1,2,1037596,"2023-10-25T00:00:00.000Z",12,FALSE,30,249,"G",30,30,"Washington Wizards","Tyus Jones",2,19,25,22,9,32.6
0,0,0,0,0,1,0,0,0,"03",0,0,0,0,0,0,1037596,"2023-10-25T00:00:00.000Z",12,FALSE,30,38017704,"F",30,30,"Washington Wizards","Patrick Baldwin Jr.",0,0,0,0,0,0
0,0,0,0,0,0,0,0,0,"00",0,0,0,0,0,0,1037596,"2023-10-25T00:00:00.000Z",12,FALSE,30,38124126,"F",30,30,"Washington Wizards","John Butler Jr.",0,0,0,0,0,0
3,3,4,1,1,3,1,0,0,"23",0,1,3,4,0,3,1037596,"2023-10-25T00:00:00.000Z",12,FALSE,30,56677844,"G",30,30,"Washington Wizards","Bilal Coulibaly",3,7,10,6,7,18.3
0,0,1,2,2,7,4,6,6,"17",2,1,16,3,0,0,1037596,"2023-10-25T00:00:00.000Z",12,FALSE,30,167,"F",30,30,"Washington Wizards","Danilo Gallinari",0,19,19,16,3,19.6
1,0,3,5,1,11,4,2,2,"25",2,1,11,5,0,1,1037596,"2023-10-25T00:00:00.000Z",12,FALSE,30,17896045,"F",30,30,"Washington Wizards","Corey Kispert",0,16,17,12,6,17.5
0,0,3,0,0,0,0,0,0,"08",0,0,0,3,0,0,1037596,"2023-10-25T00:00:00.000Z",12,FALSE,30,337,"F-C",30,30,"Washington Wizards","Mike Muscala",0,3,3,0,3,3.6
1,0,1,0,0,3,2,0,0,"08",1,0,4,2,0,1,1037596,"2023-10-25T00:00:00.000Z",12,FALSE,30,17896106,"F",30,30,"Washington Wizards","Eugene Omoruyi",0,6,7,5,3,6.9
1,0,3,0,0,3,0,2,1,"06",0,0,1,3,0,1,1037596,"2023-10-25T00:00:00.000Z",12,FALSE,30,38017712,"G",30,30,"Washington Wizards","Ryan Rollins",0,4,5,2,4,5.1
6,0,5,1,1,8,3,1,1,"25",1,1,8,6,3,0,1037596,"2023-10-25T00:00:00.000Z",12,FALSE,30,487,"G",30,30,"Washington Wizards","Delon Wright",3,14,20,14,12,33.2
0,0,0,0,0,0,0,0,0,"00",0,0,0,0,0,0,1037596,"2023-10-25T00:00:00.000Z",12,FALSE,30,38017687,"G",30,30,"Washington Wizards","Johnny Davis",0,0,0,0,0,0
0,0,0,0,0,0,0,0,0,"00",0,0,0,0,0,0,1037596,"2023-10-25T00:00:00.000Z",12,FALSE,30,3547302,"F",30,30,"Washington Wizards","Anthony Gill",0,0,0,0,0,0
0,0,0,0,0,0,0,0,0,"00",0,0,0,0,0,0,1037596,"2023-10-25T00:00:00.000Z",12,FALSE,30,414,"G",30,30,"Washington Wizards","Landry Shamet",0,0,0,0,0,0
0,0,0,1,1,2,1,0,0,"04",0,0,3,0,0,0,1037596,"2023-10-25T00:00:00.000Z",12,FALSE,30,18677954,"G",30,30,"Washington Wizards","Jared Butler",0,3,3,3,0,3
2,0,2,5,2,20,8,7,6,"36",1,0,24,3,1,2,1037597,"2023-10-25T00:00:00.000Z",20,FALSE,2,666423,"F-G",20,20,"New York Knicks","RJ Barrett",1,27,29,26,5,31.6
7,0,7,8,3,22,5,5,1,"34",4,3,14,11,2,0,1037597,"2023-10-25T00:00:00.000Z",20,FALSE,2,387,"F",20,20,"New York Knicks","Julius Randle",2,25,32,21,18,43.7
1,0,3,0,0,4,1,2,0,"22",3,4,2,6,2,1,1037597,"2023-10-25T00:00:00.000Z",20,FALSE,2,399,"C",20,20,"New York Knicks","Mitchell Robinson",2,8,9,3,7,15.7
6,0,2,8,3,21,6,1,0,"33",1,3,15,3,3,2,1037597,"2023-10-25T00:00:00.000Z",20,FALSE,2,73,"G",20,20,"New York Knicks","Jalen Brunson",3,18,24,21,9,34.6
0,0,1,6,3,7,4,1,0,"23",0,2,11,1,0,0,1037597,"2023-10-25T00:00:00.000Z",20,FALSE,2,17895858,"G",20,20,"New York Knicks","Quentin Grimes",0,12,12,11,1,12.2
0,0,0,0,0,0,0,0,0,"00",0,0,0,0,0,0,1037597,"2023-10-25T00:00:00.000Z",20,FALSE,2,19,"G",20,20,"New York Knicks","Ryan Arcidiacono",0,0,0,0,0,0
2,0,3,3,0,4,0,0,0,"15",0,1,0,3,0,0,1037597,"2023-10-25T00:00:00.000Z",20,FALSE,2,131,"G",20,20,"New York Knicks","Donte DiVincenzo",0,3,5,2,5,6.6
0,0,0,0,0,0,0,0,0,"00",0,0,0,0,0,0,1037597,"2023-10-25T00:00:00.000Z",20,FALSE,2,160,"G-F",20,20,"New York Knicks","Evan Fournier",0,0,0,0,0,0
0,0,5,4,2,4,2,2,1,"23",1,1,7,6,0,1,1037597,"2023-10-25T00:00:00.000Z",20,FALSE,2,202,"G",20,20,"New York Knicks","Josh Hart",0,13,13,7,6,13.2
2,0,3,0,0,4,3,2,1,"26",5,5,7,8,0,1,1037597,"2023-10-25T00:00:00.000Z",20,FALSE,2,201,"F-C",20,20,"New York Knicks","Isaiah Hartenstein",0,15,17,9,10,18.6
0,0,0,0,0,0,0,0,0,"00",0,0,0,0,0,0,1037597,"2023-10-25T00:00:00.000Z",20,FALSE,2,666675,"F",20,20,"New York Knicks","DaQuan Jeffries",0,0,0,0,0,0
0,0,0,0,0,0,0,0,0,"00",0,0,0,0,0,0,1037597,"2023-10-25T00:00:00.000Z",20,FALSE,2,17896033,"G",20,20,"New York Knicks","Miles McBride",0,0,0,0,0,0
4,0,4,7,5,11,7,6,5,"28",2,3,24,6,1,2,1037597,"2023-10-25T00:00:00.000Z",20,FALSE,2,3547269,"G",20,20,"New York Knicks","Immanuel Quickley",1,30,34,28,10,38.2
0,0,0,0,0,0,0,0,0,"00",0,0,0,0,0,0,1037597,"2023-10-25T00:00:00.000Z",20,FALSE,2,17896063,"F",20,20,"New York Knicks","Jericho Sims",0,0,0,0,0,0
0,0,0,0,0,0,0,0,0,"00",0,0,0,0,0,0,1037597,"2023-10-25T00:00:00.000Z",20,FALSE,2,666971,"G-F",20,20,"New York Knicks","Dylan Windler",0,0,0,0,0,0
0,0,0,0,0,0,0,0,0,"00",0,0,0,0,0,0,1037597,"2023-10-25T00:00:00.000Z",20,FALSE,2,666474,"G",20,20,"New York Knicks","Charles Brown",0,0,0,0,0,0
0,0,0,0,0,0,0,0,0,"00",0,0,0,0,0,0,1037597,"2023-10-25T00:00:00.000Z",20,FALSE,2,56677795,"F",20,20,"New York Knicks","Jacob Toppin",0,0,0,0,0,0
0,0,0,0,0,0,0,0,0,"00",0,0,0,0,0,0,1037597,"2023-10-25T00:00:00.000Z",20,FALSE,2,17896089,"G",20,20,"New York Knicks","Duane Washington Jr.",0,0,0,0,0,0
5,0,6,4,0,11,4,4,3,"38",0,5,11,6,1,2,1037597,"2023-10-25T00:00:00.000Z",20,FALSE,2,70,"G",2,2,"Boston Celtics","Jaylen Brown",1,17,22,16,11,26.7
4,1,11,8,3,22,13,6,5,"38",0,3,34,11,2,4,1037597,"2023-10-25T00:00:00.000Z",20,FALSE,2,434,"F",2,2,"Boston Celtics","Jayson Tatum",3,45,49,38,15,58.2
0,4,7,9,5,15,8,10,9,"38",1,4,30,8,0,1,1037597,"2023-10-25T00:00:00.000Z",20,FALSE,2,378,"F-C",2,2,"Boston Celtics","Kristaps Porzingis",4,38,38,30,8,50.6
2,3,2,5,1,10,4,0,0,"35",2,3,9,4,0,2,1037597,"2023-10-25T00:00:00.000Z",20,FALSE,2,214,"G",2,2,"Boston Celtics","Jrue Holiday",3,13,15,11,6,23.8
2,1,6,3,1,6,4,4,3,"32",0,3,12,6,2,1,1037597,"2023-10-25T00:00:00.000Z",20,FALSE,2,473,"G",2,2,"Boston Celtics","Derrick White",3,18,20,14,8,30.2
0,0,0,0,0,0,0,0,0,"00",0,0,0,0,0,0,1037597,"2023-10-25T00:00:00.000Z",20,FALSE,2,17896094,"G",2,2,"Boston Celtics","Dalano Banton",0,0,0,0,0,0
0,0,0,0,0,0,0,0,0,"00",0,0,0,0,0,0,1037597,"2023-10-25T00:00:00.000Z",20,FALSE,2,666468,"F",2,2,"Boston Celtics","Oshae Brissett",0,0,0,0,0,0
0,1,2,4,0,4,0,0,0,"14",0,1,0,2,1,0,1037597,"2023-10-25T00:00:00.000Z",20,FALSE,2,17896060,"F",2,2,"Boston Celtics","Sam Hauser",2,2,2,0,2,8.4
2,0,4,3,2,4,3,0,0,"26",3,2,8,7,0,3,1037597,"2023-10-25T00:00:00.000Z",20,FALSE,2,219,"C-F",2,2,"Boston Celtics","Al Horford",0,15,17,10,9,16.4
2,1,0,0,0,1,0,0,0,"08",1,0,0,1,0,0,1037597,"2023-10-25T00:00:00.000Z",20,FALSE,2,261,"F-C",2,2,"Boston Celtics","Luke Kornet",1,1,3,2,3,7.2
0,0,0,0,0,0,0,0,0,"00",0,0,0,0,0,0,1037597,"2023-10-25T00:00:00.000Z",20,FALSE,2,338,"G",2,2,"Boston Celtics","Svi Mykhailiuk",0,0,0,0,0,0
0,0,0,0,0,0,0,0,0,"00",0,0,0,0,0,0,1037597,"2023-10-25T00:00:00.000Z",20,FALSE,2,17553967,"C",2,2,"Boston Celtics","Neemias Queta",0,0,0,0,0,0
0,0,0,0,0,0,0,0,0,"00",0,0,0,0,0,0,1037597,"2023-10-25T00:00:00.000Z",20,FALSE,2,3547279,"F",2,2,"Boston Celtics","Lamar Stevens",0,0,0,0,0,0
0,0,0,0,0,0,0,0,0,"00",0,0,0,0,0,0,1037597,"2023-10-25T00:00:00.000Z",20,FALSE,2,56677864,"G",2,2,"Boston Celtics","Jordan Walsh",0,0,0,0,0,0
0,0,0,0,0,0,0,0,0,"00",0,0,0,0,0,0,1037597,"2023-10-25T00:00:00.000Z",20,FALSE,2,38017707,"G",2,2,"Boston Celtics","JD Davison",0,0,0,0,0,0
0,0,0,0,0,0,0,0,0,"00",0,0,0,0,0,0,1037597,"2023-10-25T00:00:00.000Z",20,FALSE,2,3547295,"F-C",2,2,"Boston Celtics","Nathan Knight",0,0,0,0,0,0
1,0,1,3,0,4,1,2,2,"11",0,1,4,1,0,0,1037597,"2023-10-25T00:00:00.000Z",20,FALSE,2,3547276,"G",2,2,"Boston Celtics","Payton Pritchard",0,5,6,5,2,6.7
2,0,1,7,3,11,5,4,4,"27",2,1,17,3,1,3,1037598,"2023-10-25T00:00:00.000Z",22,FALSE,11,17896026,"F",22,22,"Orlando Magic","Franz Wagner",1,20,22,19,5,23.6
5,0,5,1,0,6,3,7,6,"28",0,2,12,5,1,1,1037598,"2023-10-25T00:00:00.000Z",22,FALSE,11,38017683,"F",22,22,"Orlando Magic","Paolo Banchero",1,17,22,17,10,27.5
1,0,4,2,0,10,4,0,0,"27",4,3,8,8,2,2,1037598,"2023-10-25T00:00:00.000Z",22,FALSE,11,85,"F",22,22,"Orlando Magic","Wendell Carter Jr.",2,16,17,9,9,23.1
0,0,3,7,2,12,3,0,0,"21",1,2,8,4,0,0,1037598,"2023-10-25T00:00:00.000Z",22,FALSE,11,17896073,"G",22,22,"Orlando Magic","Jalen Suggs",0,12,12,8,4,12.8
2,0,1,0,0,9,5,0,0,"24",3,0,10,4,3,1,1037598,"2023-10-25T00:00:00.000Z",22,FALSE,11,165,"G",22,22,"Orlando Magic","Markelle Fultz",3,14,16,12,6,25.8
2,0,7,2,1,12,8,3,3,"24",1,2,20,8,0,0,1037598,"2023-10-25T00:00:00.000Z",22,FALSE,11,3547251,"G",22,22,"Orlando Magic","Cole Anthony",0,28,30,22,10,32.6
0,0,2,0,0,2,2,4,3,"05",1,1,7,3,0,1,1037598,"2023-10-25T00:00:00.000Z",22,FALSE,11,666442,"C",22,22,"Orlando Magic","Goga Bitadze",0,10,10,7,3,9.6
1,2,0,0,0,2,2,1,1,"05",0,0,5,0,0,0,1037598,"2023-10-25T00:00:00.000Z",22,FALSE,11,56677827,"G",22,22,"Orlando Magic","Anthony Black",2,5,6,6,1,12.5
0,1,3,4,1,8,5,0,0,"17",3,0,11,6,0,0,1037598,"2023-10-25T00:00:00.000Z",22,FALSE,11,196,"G",22,22,"Orlando Magic","Gary Harris",1,17,17,11,6,21.2
0,0,1,2,1,2,1,0,0,"05",0,0,3,1,0,0,1037598,"2023-10-25T00:00:00.000Z",22,FALSE,11,38017724,"G",22,22,"Orlando Magic","Caleb Houstan",0,4,4,3,1,4.2
1,0,0,1,0,1,0,0,0,"05",0,0,0,0,1,0,1037598,"2023-10-25T00:00:00.000Z",22,FALSE,11,56677839,"G",22,22,"Orlando Magic","Jett Howard",1,0,1,1,1,4.5
5,0,4,3,0,3,0,0,0,"18",0,3,0,4,0,1,1037598,"2023-10-25T00:00:00.000Z",22,FALSE,11,226,"F",22,22,"Orlando Magic","Joe Ingles",0,4,9,5,9,11.3
0,1,3,3,1,6,4,3,2,"14",1,2,11,4,0,2,1037598,"2023-10-25T00:00:00.000Z",22,FALSE,11,229,"F",22,22,"Orlando Magic","Jonathan Isaac",1,15,15,11,4,16.8
0,0,3,1,0,1,0,0,0,"05",0,0,0,3,0,0,1037598,"2023-10-25T00:00:00.000Z",22,FALSE,11,666818,"F",22,22,"Orlando Magic","Chuma Okeke",0,3,3,0,3,3.6
0,1,3,1,0,1,0,4,4,"15",0,4,4,3,0,3,1037598,"2023-10-25T00:00:00.000Z",22,FALSE,11,462,"C",22,22,"Orlando Magic","Moritz Wagner",1,7,7,4,3,7.6
0,0,0,0,0,0,0,0,0,"00",0,0,0,0,0,0,1037598,"2023-10-25T00:00:00.000Z",22,FALSE,11,38017607,"G",22,22,"Orlando Magic","Kevon Harris",0,0,0,0,0,0
0,0,0,0,0,0,0,0,0,"00",0,0,0,0,0,0,1037598,"2023-10-25T00:00:00.000Z",22,FALSE,11,17553983,"G",22,22,"Orlando Magic","Trevelin Queen",0,0,0,0,0,0
0,0,0,0,0,0,0,0,0,"00",0,0,0,0,0,0,1037598,"2023-10-25T00:00:00.000Z",22,FALSE,11,666885,"F",22,22,"Orlando Magic","Admiral Schofield",0,0,0,0,0,0
2,0,4,6,4,7,5,0,0,"26",0,4,14,4,1,2,1037598,"2023-10-25T00:00:00.000Z",22,FALSE,11,66,"G-F",11,11,"Houston Rockets","Dillon Brooks",1,18,20,16,6,22.8
6,0,6,1,0,11,6,4,2,"28",2,4,14,8,0,1,1037598,"2023-10-25T00:00:00.000Z",22,FALSE,11,17896062,"F-C",11,11,"Houston Rockets","Alperen Sengun",0,22,28,20,14,31.6
0,1,1,1,0,10,2,7,6,"30",0,2,10,1,1,4,1037598,"2023-10-25T00:00:00.000Z",22,FALSE,11,17895966,"G",11,11,"Houston Rockets","Jalen Green",2,11,11,10,1,13.2
5,0,1,6,4,13,5,0,0,"34",0,0,14,1,1,3,1037598,"2023-10-25T00:00:00.000Z",22,FALSE,11,458,"G",11,11,"Houston Rockets","Fred VanVleet",1,15,20,19,6,22.7
2,0,0,2,1,2,1,0,0,"09",0,1,3,0,0,1,1037598,"2023-10-25T00:00:00.000Z",22,FALSE,11,19465326,"C",11,11,"Houston Rockets","Jock Landale",0,3,5,5,2,5
0,1,2,1,1,2,2,0,0,"15",0,1,5,2,1,0,1037598,"2023-10-25T00:00:00.000Z",22,FALSE,11,3547301,"F",11,11,"Houston Rockets","Jae'Sean Tate",2,7,7,5,2,13.4
2,0,4,7,1,10,3,2,1,"21",1,2,8,5,0,4,1037598,"2023-10-25T00:00:00.000Z",22,FALSE,11,56677825,"G-F",11,11,"Houston Rockets","Amen Thompson",0,13,15,10,7,13
1,0,4,4,0,9,3,2,1,"26",1,6,7,5,1,1,1037598,"2023-10-25T00:00:00.000Z",22,FALSE,11,38017684,"F",11,11,"Houston Rockets","Jabari Smith Jr.",1,12,13,8,6,16.5
0,0,0,0,0,0,0,0,0,"00",0,0,0,0,0,0,1037598,"2023-10-25T00:00:00.000Z",22,FALSE,11,3547281,"G-F",11,11,"Houston Rockets","Nate Hinton",0,0,0,0,0,0
0,0,0,0,0,0,0,0,0,"00",0,0,0,0,0,0,1037598,"2023-10-25T00:00:00.000Z",22,FALSE,11,357,"G",11,11,"Houston Rockets","Victor Oladipo",0,0,0,0,0,0
1,0,0,1,0,4,2,1,0,"14",3,2,4,3,0,1,1037598,"2023-10-25T00:00:00.000Z",22,FALSE,11,188,"F",11,11,"Houston Rockets","Jeff Green",0,7,8,5,4,8.1
0,1,1,1,1,1,1,0,0,"11",0,1,3,1,1,0,1037598,"2023-10-25T00:00:00.000Z",22,FALSE,11,75,"G-F",11,11,"Houston Rockets","Reggie Bullock",2,4,4,3,1,10.2
0,0,0,1,0,3,0,0,0,"05",0,0,0,0,0,0,1037598,"2023-10-25T00:00:00.000Z",22,FALSE,11,213,"G",11,11,"Houston Rockets","Aaron Holiday",0,0,0,0,0,0
0,0,0,0,0,0,0,0,0,"00",0,0,0,0,0,0,1037598,"2023-10-25T00:00:00.000Z",22,FALSE,11,296,"C",11,11,"Houston Rockets","Boban Marjanovic",0,0,0,0,0,0
0,0,0,0,0,0,0,0,0,"06",0,1,0,0,0,0,1037598,"2023-10-25T00:00:00.000Z",22,FALSE,11,56677809,"F",11,11,"Houston Rockets","Jermaine Samuels Jr.",0,0,0,0,0,0
0,0,1,2,0,4,0,0,0,"10",0,0,0,1,0,1,1037598,"2023-10-25T00:00:00.000Z",22,FALSE,11,56677831,"F",11,11,"Houston Rockets","Cam Whitmore",0,1,1,0,1,0.2
0,0,0,1,0,3,2,0,0,"05",0,0,4,0,0,0,1037598,"2023-10-25T00:00:00.000Z",22,FALSE,11,47738533,"G",11,11,"Houston Rockets","Jeenathan Williams",0,4,4,4,0,4
0,0,0,0,0,0,0,0,0,"00",0,0,0,0,0,0,1037598,"2023-10-25T00:00:00.000Z",22,FALSE,11,38017695,"F",11,11,"Houston Rockets","Tari Eason",0,0,0,0,0,0
4,0,4,2,0,12,6,9,8,"35",2,4,20,6,3,3,1037599,"2023-10-25T00:00:00.000Z",3,FALSE,6,61,"F",3,3,"Brooklyn Nets","Mikal Bridges",3,26,30,24,10,39.2
3,0,3,4,1,10,5,2,1,"26",2,1,12,5,2,2,1037599,"2023-10-25T00:00:00.000Z",3,FALSE,6,666679,"F",3,3,"Brooklyn Nets","Cameron Johnson",2,17,20,15,8,26.5
4,3,3,0,0,10,3,1,1,"28",4,1,7,7,0,0,1037599,"2023-10-25T00:00:00.000Z",3,FALSE,6,666508,"F-C",3,3,"Brooklyn Nets","Nicolas Claxton",3,14,18,11,11,30.4
3,0,1,3,1,3,1,2,2,"24",0,2,5,1,0,1,1037599,"2023-10-25T00:00:00.000Z",3,FALSE,6,130,"G",3,3,"Brooklyn Nets","Spencer Dinwiddie",0,6,9,8,4,9.7
9,1,9,0,0,6,2,0,0,"23",1,2,4,10,0,2,1037599,"2023-10-25T00:00:00.000Z",3,FALSE,6,417,"G-F",3,3,"Brooklyn Nets","Ben Simmons",1,14,23,13,19,30.5
0,2,1,0,0,3,2,0,0,"12",1,2,4,2,0,3,1037599,"2023-10-25T00:00:00.000Z",3,FALSE,6,17896038,"C",3,3,"Brooklyn Nets","Day'Ron Sharpe",2,6,6,4,2,9.4
2,0,3,5,2,21,13,11,8,"25",0,0,36,3,1,1,1037599,"2023-10-25T00:00:00.000Z",3,FALSE,6,17896048,"G",3,3,"Brooklyn Nets","Cam Thomas",1,39,41,38,5,44.6
0,0,0,0,0,0,0,0,0,"00",0,0,0,0,0,0,1037599,"2023-10-25T00:00:00.000Z",3,FALSE,6,464,"G",3,3,"Brooklyn Nets","Lonnie Walker IV",0,0,0,0,0,0
0,0,0,0,0,0,0,0,0,"00",0,0,0,0,0,0,1037599,"2023-10-25T00:00:00.000Z",3,FALSE,6,17896058,"F",3,3,"Brooklyn Nets","Trendon Watford",0,0,0,0,0,0
0,0,0,0,0,0,0,0,0,"00",0,0,0,0,0,0,1037599,"2023-10-25T00:00:00.000Z",3,FALSE,6,9051997,"G",3,3,"Brooklyn Nets","Armoni Brooks",0,0,0,0,0,0
0,0,0,0,0,0,0,0,0,"00",0,0,0,0,0,0,1037599,"2023-10-25T00:00:00.000Z",3,FALSE,6,56677841,"F",3,3,"Brooklyn Nets","Dariq Whitehead",0,0,0,0,0,0
0,0,0,0,0,0,0,0,0,"00",0,0,0,0,0,0,1037599,"2023-10-25T00:00:00.000Z",3,FALSE,6,56677722,"F",3,3,"Brooklyn Nets","Jalen Wilson",0,0,0,0,0,0
2,1,12,13,7,17,9,2,2,"39",0,4,27,12,1,0,1037599,"2023-10-25T00:00:00.000Z",3,FALSE,6,666908,"G",6,6,"Cleveland Cavaliers","Max Strus",2,39,41,29,14,50.4
4,1,3,4,2,10,6,5,4,"32",3,5,18,6,2,2,1037599,"2023-10-25T00:00:00.000Z",3,FALSE,6,3547247,"F-G",6,6,"Cleveland Cavaliers","Isaac Okoro",3,24,28,22,10,38.2
1,2,5,0,0,11,5,0,0,"34",1,3,10,6,0,0,1037599,"2023-10-25T00:00:00.000Z",3,FALSE,6,17896076,"F-C",6,6,"Cleveland Cavaliers","Evan Mobley",2,16,17,11,7,24.7
6,1,3,10,4,21,11,1,1,"36",2,1,27,5,4,0,1037599,"2023-10-25T00:00:00.000Z",3,FALSE,6,322,"G",6,6,"Cleveland Cavaliers","Donovan Mitchell",5,32,38,33,11,57
5,0,1,5,1,12,6,2,2,"32",1,2,15,2,2,6,1037599,"2023-10-25T00:00:00.000Z",3,FALSE,6,666581,"G",6,6,"Cleveland Cavaliers","Darius Garland",2,17,22,20,7,24.9
0,0,0,0,0,0,0,0,0,"00",0,0,0,0,0,0,1037599,"2023-10-25T00:00:00.000Z",3,FALSE,6,56677847,"F",6,6,"Cleveland Cavaliers","Emoni Bates",0,0,0,0,0,0
0,0,0,0,0,1,1,0,0,"05",0,1,2,0,0,0,1037599,"2023-10-25T00:00:00.000Z",3,FALSE,6,666676,"G",6,6,"Cleveland Cavaliers","Ty Jerome",0,2,2,2,0,2
2,0,0,0,0,2,2,0,0,"11",0,3,4,0,0,2,1037599,"2023-10-25T00:00:00.000Z",3,FALSE,6,248,"C",6,6,"Cleveland Cavaliers","Damian Jones",0,4,6,6,2,5
5,1,3,8,3,17,4,0,0,"31",0,1,11,3,1,0,1037599,"2023-10-25T00:00:00.000Z",3,FALSE,6,277,"G",6,6,"Cleveland Cavaliers","Caris LeVert",2,14,19,16,8,28.1
0,0,2,3,0,3,0,0,0,"20",2,3,0,4,0,0,1037599,"2023-10-25T00:00:00.000Z",3,FALSE,6,344,"F",6,6,"Cleveland Cavaliers","Georges Niang",0,4,4,0,4,4.8
0,0,0,0,0,0,0,0,0,"00",0,0,0,0,0,0,1037599,"2023-10-25T00:00:00.000Z",3,FALSE,6,38017662,"F",6,6,"Cleveland Cavaliers","Isaiah Mobley",0,0,0,0,0,0
0,0,0,0,0,0,0,0,0,"00",0,0,0,0,0,0,1037599,"2023-10-25T00:00:00.000Z",3,FALSE,6,444,"C-F",6,6,"Cleveland Cavaliers","Tristan Thompson",0,0,0,0,0,0
0,0,0,0,0,0,0,0,0,"00",0,0,0,0,0,0,1037599,"2023-10-25T00:00:00.000Z",3,FALSE,6,9,"C",6,6,"Cleveland Cavaliers","Jarrett Allen",0,0,0,0,0,0
0,0,0,0,0,0,0,0,0,"00",0,0,0,0,0,0,1037599,"2023-10-25T00:00:00.000Z",3,FALSE,6,56677872,"G",6,6,"Cleveland Cavaliers","Craig Porter",0,0,0,0,0,0
0,0,0,0,0,0,0,0,0,"00",0,0,0,0,0,0,1037599,"2023-10-25T00:00:00.000Z",3,FALSE,6,404,"G",6,6,"Cleveland Cavaliers","Ricky Rubio",0,0,0,0,0,0
0,0,0,0,0,0,0,0,0,"00",0,0,0,0,0,0,1037599,"2023-10-25T00:00:00.000Z",3,FALSE,6,666940,"F",6,6,"Cleveland Cavaliers","Dean Wade",0,0,0,0,0,0
0,0,0,0,0,0,0,0,0,"00",0,0,0,0,0,0,1037599,"2023-10-25T00:00:00.000Z",3,FALSE,6,3547299,"G",6,6,"Cleveland Cavaliers","Sam Merrill",0,0,0,0,0,0
2,0,4,6,2,8,4,1,0,"28",1,1,10,5,0,3,1037599,"2023-10-25T00:00:00.000Z",3,FALSE,6,158,"F",3,3,"Brooklyn Nets","Dorian Finney-Smith",0,15,17,12,7,16
2,0,7,4,1,6,2,0,0,"23",0,2,5,7,0,1,1037599,"2023-10-25T00:00:00.000Z",3,FALSE,6,351,"F",3,3,"Brooklyn Nets","Royce O'Neale",0,12,14,7,9,15.4
1,0,2,3,2,5,4,0,0,"16",2,1,10,4,0,1,1037599,"2023-10-25T00:00:00.000Z",3,FALSE,6,421,"G",3,3,"Brooklyn Nets","Dennis Smith Jr.",0,14,15,11,5,15.3
0,0,0,0,0,0,0,0,0,"00",0,0,0,0,0,0,1037599,"2023-10-25T00:00:00.000Z",3,FALSE,6,56677843,"F",3,3,"Brooklyn Nets","Noah Clowney",0,0,0,0,0,0
0,0,0,0,0,0,0,0,0,"00",0,0,0,0,0,0,1037599,"2023-10-25T00:00:00.000Z",3,FALSE,6,174,"F-C",3,3,"Brooklyn Nets","Harry Giles III",0,0,0,0,0,0
4,0,5,0,0,18,6,9,7,"34",8,0,19,13,2,0,1037600,"2023-10-25T00:00:00.000Z",16,FALSE,9,79,"G-F",16,16,"Miami Heat","Jimmy Butler",2,32,36,23,17,46.6
2,0,8,6,3,9,4,2,2,"28",2,5,13,10,0,1,1037600,"2023-10-25T00:00:00.000Z",16,FALSE,9,285,"F-C",16,16,"Miami Heat","Kevin Love",0,23,25,15,12,27
3,2,6,0,0,13,7,10,8,"32",2,3,22,8,0,2,1037600,"2023-10-25T00:00:00.000Z",16,FALSE,9,4,"C-F",16,16,"Miami Heat","Bam Adebayo",2,30,33,25,11,40.1
3,0,2,7,2,24,7,0,0,"34",0,1,16,2,3,2,1037600,"2023-10-25T00:00:00.000Z",16,FALSE,9,666633,"G",16,16,"Miami Heat","Tyler Herro",3,18,21,19,5,29.9
2,1,2,0,0,1,0,0,0,"32",0,4,0,2,2,0,1037600,"2023-10-25T00:00:00.000Z",16,FALSE,9,286,"G",16,16,"Miami Heat","Kyle Lowry",3,2,4,2,4,14.4
3,0,4,0,0,5,2,5,4,"16",2,0,8,6,1,1,1037600,"2023-10-25T00:00:00.000Z",16,FALSE,9,74,"C",16,16,"Miami Heat","Thomas Bryant",1,14,17,11,9,21.7
0,0,0,0,0,0,0,0,0,"00",0,0,0,0,0,0,1037600,"2023-10-25T00:00:00.000Z",16,FALSE,9,38017734,"F",16,16,"Miami Heat","Jamal Cain",0,0,0,0,0,0
0,0,0,0,0,0,0,0,0,"00",0,0,0,0,0,0,1037600,"2023-10-25T00:00:00.000Z",16,FALSE,9,3547257,"G",16,16,"Miami Heat","R.J. Hampton",0,0,0,0,0,0
2,0,2,0,0,3,3,0,0,"13",0,2,6,2,2,1,1037600,"2023-10-25T00:00:00.000Z",16,FALSE,9,56677785,"G",16,16,"Miami Heat","Jaime Jaquez Jr.",2,8,10,8,4,16.4
0,0,0,0,0,0,0,0,0,"00",0,0,0,0,0,0,1037600,"2023-10-25T00:00:00.000Z",16,FALSE,9,38017696,"F",16,16,"Miami Heat","Nikola Jovic",0,0,0,0,0,0
1,0,2,3,0,7,1,0,0,"20",1,1,2,3,1,0,1037600,"2023-10-25T00:00:00.000Z",16,FALSE,9,666747,"F",16,16,"Miami Heat","Caleb Martin",1,5,6,3,4,10.1
1,0,1,5,3,10,6,0,0,"22",1,1,15,2,0,0,1037600,"2023-10-25T00:00:00.000Z",16,FALSE,9,397,"F",16,16,"Miami Heat","Duncan Robinson",0,17,18,16,3,18.9
0,0,0,0,0,0,0,0,0,"00",0,0,0,0,0,0,1037600,"2023-10-25T00:00:00.000Z",16,FALSE,9,39398582,"C",16,16,"Miami Heat","Orlando Robinson",0,0,0,0,0,0
1,0,0,1,0,2,1,0,0,"09",0,1,2,0,0,0,1037600,"2023-10-25T00:00:00.000Z",16,FALSE,9,19465585,"G",16,16,"Miami Heat","Dru Smith",0,2,3,3,1,3.5
0,0,0,0,0,0,0,0,0,"00",0,0,0,0,0,0,1037600,"2023-10-25T00:00:00.000Z",16,FALSE,9,3092,"",16,16,"Miami Heat","Haywood Highsmith",0,0,0,0,0,0
0,0,0,0,0,0,0,0,0,"00",0,0,0,0,0,0,1037600,"2023-10-25T00:00:00.000Z",16,FALSE,9,391,"G-F",16,16,"Miami Heat","Josh Richardson",0,0,0,0,0,0
0,0,0,0,0,0,0,0,0,"00",0,0,0,0,0,0,1037600,"2023-10-25T00:00:00.000Z",16,FALSE,9,38017736,"F",16,16,"Miami Heat","Cole Swider",0,0,0,0,0,0
3,5,4,2,1,7,1,2,1,"27",3,2,4,7,0,2,1037600,"2023-10-25T00:00:00.000Z",16,FALSE,9,56677826,"G-F",9,9,"Detroit Pistons","Ausar Thompson",5,11,14,7,10,29.9
2,0,8,3,2,11,6,0,0,"35",6,3,14,14,0,1,1037600,"2023-10-25T00:00:00.000Z",16,FALSE,9,3547267,"F-C",9,9,"Detroit Pistons","Isaiah Stewart",0,28,30,16,16,32.8
4,4,8,0,0,11,8,3,1,"32",6,4,17,14,0,4,1037600,"2023-10-25T00:00:00.000Z",16,FALSE,9,38017694,"C",9,9,"Detroit Pistons","Jalen Duren",4,31,35,21,18,47.8
3,1,1,6,0,12,4,3,2,"30",0,2,10,1,2,1,1037600,"2023-10-25T00:00:00.000Z",16,FALSE,9,3547241,"G",9,9,"Detroit Pistons","Killian Hayes",3,11,14,13,4,23.7
9,1,3,9,4,27,13,0,0,"36",0,5,30,3,1,3,1037600,"2023-10-25T00:00:00.000Z",16,FALSE,9,17896075,"G-F",9,9,"Detroit Pistons","Cade Cunningham",2,33,42,39,12,50.1
3,1,6,0,0,3,3,2,2,"16",2,1,8,8,0,1,1037600,"2023-10-25T00:00:00.000Z",16,FALSE,9,24,"F",9,9,"Detroit Pistons","Marvin Bagley III",1,16,19,11,11,24.1
0,1,5,5,2,8,2,2,1,"25",0,1,7,5,0,0,1037600,"2023-10-25T00:00:00.000Z",16,FALSE,9,77,"G",9,9,"Detroit Pistons","Alec Burks",1,12,12,7,5,16
0,0,0,0,0,0,0,0,0,"00",0,0,0,0,0,0,1037600,"2023-10-25T00:00:00.000Z",16,FALSE,9,56677729,"G",9,9,"Detroit Pistons","Malcolm Cazalon",0,0,0,0,0,0
0,0,0,2,0,2,0,0,0,"12",0,2,0,0,0,0,1037600,"2023-10-25T00:00:00.000Z",16,FALSE,9,197,"F-G",9,9,"Detroit Pistons","Joe Harris",0,0,0,0,0,0
3,0,2,2,0,7,1,3,2,"17",0,3,4,2,0,3,1037600,"2023-10-25T00:00:00.000Z",16,FALSE,9,38017682,"G",9,9,"Detroit Pistons","Jaden Ivey",0,6,9,7,5,7.9
0,0,0,0,0,0,0,0,0,"00",0,0,0,0,0,0,1037600,"2023-10-25T00:00:00.000Z",16,FALSE,9,42097199,"G",9,9,"Detroit Pistons","Jared Rhoden",0,0,0,0,0,0
1,0,2,3,2,4,3,0,0,"10",0,0,8,2,0,1,1037600,"2023-10-25T00:00:00.000Z",16,FALSE,9,56677792,"G",9,9,"Detroit Pistons","Marcus Sasser",0,10,11,9,3,10.9
0,0,0,0,0,0,0,0,0,"00",0,0,0,0,0,0,1037600,"2023-10-25T00:00:00.000Z",16,FALSE,9,44477024,"G",9,9,"Detroit Pistons","Stanley Umude",0,0,0,0,0,0
0,0,0,0,0,0,0,0,0,"00",0,0,0,0,0,0,1037600,"2023-10-25T00:00:00.000Z",16,FALSE,9,3547240,"C",9,9,"Detroit Pistons","James Wiseman",0,0,0,0,0,0
0,0,0,0,0,0,0,0,0,"00",0,0,0,0,0,0,1037600,"2023-10-25T00:00:00.000Z",16,FALSE,9,54,"F",9,9,"Detroit Pistons","Bojan Bogdanovic",0,0,0,0,0,0
0,0,0,0,0,0,0,0,0,"00",0,0,0,0,0,0,1037600,"2023-10-25T00:00:00.000Z",16,FALSE,9,17896071,"F",9,9,"Detroit Pistons","Isaiah Livers",0,0,0,0,0,0
0,0,0,0,0,0,0,0,0,"00",0,0,0,0,0,0,1037600,"2023-10-25T00:00:00.000Z",16,FALSE,9,330,"G",9,9,"Detroit Pistons","Monte Morris",0,0,0,0,0,0
1,3,6,9,4,13,7,2,2,"34",0,2,20,6,2,2,1037601,"2023-10-25T00:00:00.000Z",28,FALSE,18,18,"F",28,28,"Toronto Raptors","OG Anunoby",5,26,27,21,7,41.7
6,0,7,5,3,17,5,2,2,"34",0,2,15,7,1,2,1037601,"2023-10-25T00:00:00.000Z",28,FALSE,18,416,"F",28,28,"Toronto Raptors","Pascal Siakam",1,22,28,21,13,33.4
1,1,8,0,0,3,3,4,1,"24",3,1,7,11,1,0,1037601,"2023-10-25T00:00:00.000Z",28,FALSE,18,373,"C",28,28,"Toronto Raptors","Jakob Poeltl",2,18,19,8,12,27.7
5,5,7,4,1,16,6,6,4,"37",1,1,17,8,2,4,1037601,"2023-10-25T00:00:00.000Z",28,FALSE,18,17896055,"G-F",28,28,"Toronto Raptors","Scottie Barnes",7,25,30,22,13,51.1
7,0,2,8,4,17,8,2,2,"32",1,1,22,3,0,2,1037601,"2023-10-25T00:00:00.000Z",28,FALSE,18,409,"G",28,28,"Toronto Raptors","Dennis Schroder",0,25,32,29,10,34.1
0,0,6,1,0,9,4,0,0,"24",3,1,8,9,0,2,1037601,"2023-10-25T00:00:00.000Z",28,FALSE,18,3547249,"F",28,28,"Toronto Raptors","Precious Achiuwa",0,17,17,8,9,16.8
0,0,0,0,0,0,0,0,0,"00",0,0,0,0,0,0,1037601,"2023-10-25T00:00:00.000Z",28,FALSE,18,58,"F",28,28,"Toronto Raptors","Chris Boucher",0,0,0,0,0,0
1,0,0,0,0,1,0,0,0,"02",0,1,0,0,0,0,1037601,"2023-10-25T00:00:00.000Z",28,FALSE,18,56677828,"G",28,28,"Toronto Raptors","Gradey Dick",0,0,1,1,1,1.5
2,0,0,1,1,3,1,0,0,"10",0,4,3,0,1,2,1037601,"2023-10-25T00:00:00.000Z",28,FALSE,18,3547275,"G",28,28,"Toronto Raptors","Malachi Flynn",1,3,5,5,2,7
2,1,2,3,0,3,0,0,0,"16",0,2,0,2,1,0,1037601,"2023-10-25T00:00:00.000Z",28,FALSE,18,666762,"F",28,28,"Toronto Raptors","Jalen McDaniels",2,2,4,2,4,11.4
0,0,0,0,0,0,0,0,0,"00",0,0,0,0,0,0,1037601,"2023-10-25T00:00:00.000Z",28,FALSE,18,376,"F",28,28,"Toronto Raptors","Otto Porter Jr.",0,0,0,0,0,0
0,0,0,0,0,0,0,0,0,"00",0,0,0,0,0,0,1037601,"2023-10-25T00:00:00.000Z",28,FALSE,18,436,"G-F",28,28,"Toronto Raptors","Garrett Temple",0,0,0,0,0,0
2,1,1,4,1,8,2,0,0,"27",0,3,5,1,1,0,1037601,"2023-10-25T00:00:00.000Z",28,FALSE,18,3089,"",28,28,"Toronto Raptors","Gary Trent Jr.",2,6,8,7,3,15.2
0,0,0,0,0,0,0,0,0,"00",0,0,0,0,0,0,1037601,"2023-10-25T00:00:00.000Z",28,FALSE,18,489,"F",28,28,"Toronto Raptors","Thaddeus Young",0,0,0,0,0,0
0,0,0,0,0,0,0,0,0,"00",0,0,0,0,0,0,1037601,"2023-10-25T00:00:00.000Z",28,FALSE,18,56677805,"G",28,28,"Toronto Raptors","Javon Freeman-Liberty",0,0,0,0,0,0
0,0,0,0,0,0,0,0,0,"00",0,0,0,0,0,0,1037601,"2023-10-25T00:00:00.000Z",28,FALSE,18,38017717,"F",28,28,"Toronto Raptors","Ron Harper Jr.",0,0,0,0,0,0
0,0,0,0,0,0,0,0,0,"00",0,0,0,0,0,0,1037601,"2023-10-25T00:00:00.000Z",28,FALSE,18,38017710,"C",28,28,"Toronto Raptors","Christian Koloko",0,0,0,0,0,0
0,0,0,0,0,0,0,0,0,"00",0,0,0,0,0,0,1037601,"2023-10-25T00:00:00.000Z",28,FALSE,18,56677869,"G",28,28,"Toronto Raptors","Markquis Nowell",0,0,0,0,0,0
0,0,0,0,0,0,0,0,0,"00",0,0,0,0,0,0,1037601,"2023-10-25T00:00:00.000Z",28,FALSE,18,17895968,"F",18,18,"Minnesota Timberwolves","Daishen Nix",0,0,0,0,0,0
1,0,3,2,0,8,3,4,4,"24",1,0,10,4,0,1,1037601,"2023-10-25T00:00:00.000Z",28,FALSE,18,667378,"F-C",18,18,"Minnesota Timberwolves","Naz Reid",0,14,15,11,5,15.3
0,0,0,0,0,0,0,0,0,"00",0,0,0,0,0,0,1037601,"2023-10-25T00:00:00.000Z",28,FALSE,18,56677851,"G",18,18,"Minnesota Timberwolves","Jaylen Clark",0,0,0,0,0,0
0,0,0,0,0,0,0,0,0,"00",0,0,0,0,0,0,1037601,"2023-10-25T00:00:00.000Z",28,FALSE,18,3547259,"F",18,18,"Minnesota Timberwolves","Jaden McDaniels",0,0,0,0,0,0
5,0,7,1,0,9,3,2,1,"30",2,0,7,9,1,1,1037601,"2023-10-25T00:00:00.000Z",28,FALSE,18,12,"F",18,18,"Minnesota Timberwolves","Kyle Anderson",1,16,21,12,14,27.3
4,0,3,4,1,5,1,2,1,"21",0,4,4,3,3,2,1037601,"2023-10-25T00:00:00.000Z",28,FALSE,18,320,"G",18,18,"Minnesota Timberwolves","Shake Milton",3,7,11,8,7,20.6
0,0,1,0,0,0,0,0,0,"05",0,0,0,1,0,0,1037601,"2023-10-25T00:00:00.000Z",28,FALSE,18,68,"F",18,18,"Minnesota Timberwolves","Troy Brown Jr.",0,1,1,0,1,1.2
0,0,0,0,0,0,0,0,0,"00",0,0,0,0,0,0,1037601,"2023-10-25T00:00:00.000Z",28,FALSE,18,17896056,"C",18,18,"Minnesota Timberwolves","Luka Garza",0,0,0,0,0,0
0,0,0,0,0,0,0,0,0,"00",0,0,0,0,0,0,1037601,"2023-10-25T00:00:00.000Z",28,FALSE,18,666767,"G",18,18,"Minnesota Timberwolves","Jordan McLaughlin",0,0,0,0,0,0
0,0,0,0,0,0,0,0,0,"00",0,0,0,0,0,0,1037601,"2023-10-25T00:00:00.000Z",28,FALSE,18,56677782,"F",18,18,"Minnesota Timberwolves","Leonard Miller",0,0,0,0,0,0
0,0,0,0,0,0,0,0,0,"00",0,0,0,0,0,0,1037601,"2023-10-25T00:00:00.000Z",28,FALSE,18,38017715,"F",18,18,"Minnesota Timberwolves","Josh Minott",0,0,0,0,0,0
0,0,0,0,0,0,0,0,0,"00",0,0,0,0,0,0,1037601,"2023-10-25T00:00:00.000Z",28,FALSE,18,38017700,"G",18,18,"Minnesota Timberwolves","Wendell Moore Jr.",0,0,0,0,0,0
2,0,4,3,0,5,1,0,0,"23",0,3,2,4,1,1,1037601,"2023-10-25T00:00:00.000Z",28,FALSE,18,666400,"G",18,18,"Minnesota Timberwolves","Nickeil Alexander-Walker",1,6,8,4,6,11.8
3,4,8,10,2,25,8,1,1,"36",2,2,19,10,0,4,1037601,"2023-10-25T00:00:00.000Z",28,FALSE,18,447,"C",18,18,"Minnesota Timberwolves","Karl-Anthony Towns",4,29,32,22,13,43.5
1,4,8,0,0,12,6,5,3,"32",5,3,15,13,2,2,1037601,"2023-10-25T00:00:00.000Z",28,FALSE,18,176,"C",18,18,"Minnesota Timberwolves","Rudy Gobert",6,28,29,16,14,48.1
1,0,9,7,4,27,8,6,6,"38",5,1,26,14,0,2,1037601,"2023-10-25T00:00:00.000Z",28,FALSE,18,3547238,"G",18,18,"Minnesota Timberwolves","Anthony Edwards",0,40,41,27,15,42.3
3,1,3,4,1,9,4,2,2,"31",1,1,11,4,1,1,1037601,"2023-10-25T00:00:00.000Z",28,FALSE,18,104,"G",18,18,"Minnesota Timberwolves","Mike Conley",2,15,18,14,7,25.3
2,1,3,3,1,20,9,3,1,"33",2,1,20,5,1,0,1037602,"2023-10-25T00:00:00.000Z",5,FALSE,21,125,"G",5,5,"Chicago Bulls","DeMar DeRozan",2,25,27,22,7,35
4,0,1,4,0,10,4,0,0,"30",2,3,8,3,2,0,1037602,"2023-10-25T00:00:00.000Z",5,FALSE,21,3547248,"F",5,5,"Chicago Bulls","Patrick Williams",2,11,15,12,7,23.6
4,2,8,2,0,8,5,1,1,"32",1,2,11,9,3,4,1037602,"2023-10-25T00:00:00.000Z",5,FALSE,21,460,"C",5,5,"Chicago Bulls","Nikola Vucevic",5,20,24,15,13,38.8
3,0,4,9,2,16,4,6,6,"25",0,3,16,4,0,4,1037602,"2023-10-25T00:00:00.000Z",5,FALSE,21,268,"G",5,5,"Chicago Bulls","Zach LaVine",0,20,23,19,7,21.3
4,0,3,7,2,14,4,6,5,"30",1,3,15,4,0,0,1037602,"2023-10-25T00:00:00.000Z",5,FALSE,21,666956,"G",5,5,"Chicago Bulls","Coby White",0,19,23,19,8,25.8
2,0,1,4,1,4,1,0,0,"16",0,0,3,1,0,0,1037602,"2023-10-25T00:00:00.000Z",5,FALSE,21,87,"G",5,5,"Chicago Bulls","Jevon Carter",0,4,6,5,3,7.2
3,0,2,4,1,5,2,2,1,"19",0,1,6,2,2,1,1037602,"2023-10-25T00:00:00.000Z",5,FALSE,21,89,"G",5,5,"Chicago Bulls","Alex Caruso",2,8,11,9,5,17.9
1,0,3,4,3,6,4,0,0,"22",4,2,11,7,0,1,1037602,"2023-10-25T00:00:00.000Z",5,FALSE,21,110,"F",5,5,"Chicago Bulls","Torrey Craig",0,18,19,12,8,19.9
1,0,2,0,0,4,3,0,0,"16",3,1,6,5,1,1,1037602,"2023-10-25T00:00:00.000Z",5,FALSE,21,137,"C",5,5,"Chicago Bulls","Andre Drummond",1,11,12,7,6,15.5
1,0,2,1,0,2,0,0,0,"04",0,0,0,2,0,0,1037602,"2023-10-25T00:00:00.000Z",5,FALSE,21,38017719,"F",5,5,"Chicago Bulls","Dalen Terry",0,2,3,1,3,3.9
0,0,0,0,0,0,0,0,0,"00",0,0,0,0,0,0,1037602,"2023-10-25T00:00:00.000Z",5,FALSE,21,27,"G",5,5,"Chicago Bulls","Lonzo Ball",0,0,0,0,0,0
0,0,0,0,0,0,0,0,0,"00",0,0,0,0,0,0,1037602,"2023-10-25T00:00:00.000Z",5,FALSE,21,56677874,"F",5,5,"Chicago Bulls","Onuralp Bitim",0,0,0,0,0,0
0,0,0,0,0,0,0,0,0,"00",0,0,0,0,0,0,1037602,"2023-10-25T00:00:00.000Z",5,FALSE,21,45969255,"F",5,5,"Chicago Bulls","Justin Lewis",0,0,0,0,0,0
0,0,0,0,0,0,0,0,0,"00",0,0,0,0,0,0,1037602,"2023-10-25T00:00:00.000Z",5,FALSE,21,56677860,"F",5,5,"Chicago Bulls","Adama Sanogo",0,0,0,0,0,0
2,1,7,5,2,8,3,0,0,"32",0,1,8,7,2,2,1037602,"2023-10-25T00:00:00.000Z",5,FALSE,21,666541,"G",21,21,"Oklahoma City Thunder","Luguentz Dort",3,15,17,10,9,26.4
5,0,3,6,2,11,5,4,4,"32",0,3,16,3,1,2,1037602,"2023-10-25T00:00:00.000Z",5,FALSE,21,38017703,"G-F",21,21,"Oklahoma City Thunder","Jalen Williams",1,19,24,21,8,28.1
3,0,4,3,2,7,4,3,1,"25",0,3,11,4,1,1,1037602,"2023-10-25T00:00:00.000Z",5,FALSE,21,38017685,"C-F",21,21,"Oklahoma City Thunder","Chet Holmgren",1,15,18,14,7,22.3
6,0,5,3,2,14,7,0,0,"32",1,1,16,6,0,3,1037602,"2023-10-25T00:00:00.000Z",5,FALSE,21,17896065,"G",21,21,"Oklahoma City Thunder","Josh Giddey",0,22,28,22,12,29.2
10,2,5,5,2,18,12,5,5,"36",0,0,31,5,1,1,1037602,"2023-10-25T00:00:00.000Z",5,FALSE,21,175,"G",21,21,"Oklahoma City Thunder","Shai Gilgeous-Alexander",3,36,46,41,15,60
0,0,1,5,3,5,3,0,0,"14",1,1,9,2,0,1,1037602,"2023-10-25T00:00:00.000Z",5,FALSE,21,38017716,"F",21,21,"Oklahoma City Thunder","Ousmane Dieng",0,11,11,9,2,10.4
0,0,2,1,0,3,1,0,0,"11",1,2,2,3,0,1,1037602,"2023-10-25T00:00:00.000Z",5,FALSE,21,17896078,"G",21,21,"Oklahoma City Thunder","Aaron Wiggins",0,5,5,2,3,4.6
2,0,4,6,3,8,4,4,3,"22",1,2,14,5,1,2,1037602,"2023-10-25T00:00:00.000Z",5,FALSE,21,3547272,"G",21,21,"Oklahoma City Thunder","Isaiah Joe",1,19,21,16,7,24
0,0,3,0,0,1,1,2,2,"10",1,3,4,4,0,1,1037602,"2023-10-25T00:00:00.000Z",5,FALSE,21,24572055,"C",21,21,"Oklahoma City Thunder","Olivier Sarr",0,8,8,4,4,7.8
1,1,2,3,3,5,5,0,0,"19",0,3,13,2,0,1,1037602,"2023-10-25T00:00:00.000Z",5,FALSE,21,56677833,"G",21,21,"Oklahoma City Thunder","Cason Wallace",1,15,16,14,3,18.9
1,0,0,4,2,5,3,0,0,"09",0,0,8,0,1,1,1037602,"2023-10-25T00:00:00.000Z",5,FALSE,21,17895983,"G",5,5,"Chicago Bulls","Ayo Dosunmu",1,8,9,9,1,11.5
0,0,0,0,0,0,0,0,0,"04",0,0,0,0,0,0,1037602,"2023-10-25T00:00:00.000Z",5,FALSE,21,56677857,"F",5,5,"Chicago Bulls","Julian Phillips",0,0,0,0,0,0
0,0,0,0,0,0,0,0,0,"00",0,0,0,0,0,0,1037602,"2023-10-25T00:00:00.000Z",5,FALSE,21,17896116,"G",5,5,"Chicago Bulls","Terry Taylor",0,0,0,0,0,0
0,0,0,1,0,1,0,0,0,"03",0,0,0,0,0,0,1037602,"2023-10-25T00:00:00.000Z",5,FALSE,21,27924547,"F",21,21,"Oklahoma City Thunder","Lindy Waters III",0,0,0,0,0,0
0,0,0,0,0,0,0,0,0,"00",0,0,0,0,0,0,1037602,"2023-10-25T00:00:00.000Z",5,FALSE,21,44,"F",21,21,"Oklahoma City Thunder","Davis Bertans",0,0,0,0,0,0
1,0,0,0,0,0,0,0,0,"02",0,0,0,0,0,0,1037602,"2023-10-25T00:00:00.000Z",5,FALSE,21,17896036,"G",21,21,"Oklahoma City Thunder","Tre Mann",0,0,1,1,1,1.5
0,0,0,0,0,0,0,0,0,"00",0,0,0,0,0,0,1037602,"2023-10-25T00:00:00.000Z",5,FALSE,21,4197029,"G",21,21,"Oklahoma City Thunder","Vasilije Micic",0,0,0,0,0,0
0,0,2,1,0,1,0,0,0,"02",0,0,0,2,0,0,1037602,"2023-10-25T00:00:00.000Z",5,FALSE,21,3547271,"C",21,21,"Oklahoma City Thunder","Aleksej Pokusevski",0,2,2,0,2,2.4
0,0,0,0,0,0,0,0,0,"00",0,0,0,0,0,0,1037602,"2023-10-25T00:00:00.000Z",5,FALSE,21,56677853,"F",21,21,"Oklahoma City Thunder","Keyontae Johnson",0,0,0,0,0,0
0,0,0,0,0,0,0,0,0,"00",0,0,0,0,0,0,1037602,"2023-10-25T00:00:00.000Z",5,FALSE,21,38017706,"F",21,21,"Oklahoma City Thunder","Jaylin Williams",0,0,0,0,0,0
0,0,0,0,0,0,0,0,0,"00",0,0,0,0,0,0,1037602,"2023-10-25T00:00:00.000Z",5,FALSE,21,480,"G-F",21,21,"Oklahoma City Thunder","Kenrich Williams",0,0,0,0,0,0
0,0,4,3,1,7,4,0,0,"29",0,2,9,4,0,1,1037603,"2023-10-25T00:00:00.000Z",15,FALSE,19,17896027,"G-F",15,15,"Memphis Grizzlies","Ziaire Williams",0,13,13,9,4,12.8
3,5,4,5,0,9,2,4,4,"36",1,5,8,5,0,3,1037603,"2023-10-25T00:00:00.000Z",15,FALSE,19,231,"F-C",15,15,"Memphis Grizzlies","Jaren Jackson Jr.",5,13,16,11,8,30.5
4,1,8,5,1,16,7,2,2,"34",4,2,17,12,3,0,1037603,"2023-10-25T00:00:00.000Z",15,FALSE,19,3547285,"F",15,15,"Memphis Grizzlies","Xavier Tillman",4,29,33,21,16,49.4
5,1,5,10,5,22,11,5,4,"36",0,1,31,5,2,2,1037603,"2023-10-25T00:00:00.000Z",15,FALSE,19,3547287,"G",15,15,"Memphis Grizzlies","Desmond Bane",3,36,41,36,10,51.5
3,0,0,6,2,11,6,6,3,"32",0,3,17,0,2,5,1037603,"2023-10-25T00:00:00.000Z",15,FALSE,19,420,"G",15,15,"Memphis Grizzlies","Marcus Smart",2,17,20,20,3,22.5
0,0,0,0,0,0,0,0,0,"00",0,0,0,0,0,0,1037603,"2023-10-25T00:00:00.000Z",15,FALSE,19,48248287,"G",15,15,"Memphis Grizzlies","Jacob Gilyard",0,0,0,0,0,0
0,0,0,0,0,0,0,0,0,"00",0,0,0,0,0,0,1037603,"2023-10-25T00:00:00.000Z",15,FALSE,19,56677830,"F",15,15,"Memphis Grizzlies","GG Jackson",0,0,0,0,0,0
2,0,1,5,0,5,0,3,3,"15",1,0,3,2,0,1,1037603,"2023-10-25T00:00:00.000Z",15,FALSE,19,254,"G",15,15,"Memphis Grizzlies","Luke Kennard",0,5,7,5,4,7.4
0,0,0,0,0,0,0,0,0,"00",0,0,0,0,0,0,1037603,"2023-10-25T00:00:00.000Z",15,FALSE,19,666703,"G-F",15,15,"Memphis Grizzlies","John Konchar",0,0,0,0,0,0
2,0,4,3,1,7,4,0,0,"28",1,2,9,5,0,1,1037603,"2023-10-25T00:00:00.000Z",15,FALSE,19,38017729,"F",15,15,"Memphis Grizzlies","David Roddy",0,14,16,11,7,17
0,0,0,0,0,0,0,0,0,"00",0,0,0,0,0,0,1037603,"2023-10-25T00:00:00.000Z",15,FALSE,19,666505,"F",15,15,"Memphis Grizzlies","Brandon Clarke",0,0,0,0,0,0
6,0,7,3,0,18,7,6,5,"36",0,3,19,7,2,5,1037603,"2023-10-25T00:00:00.000Z",15,FALSE,19,227,"F",19,19,"New Orleans Pelicans","Brandon Ingram",2,26,32,25,13,37.4
3,0,3,0,0,17,9,7,5,"32",4,1,23,7,0,3,1037603,"2023-10-25T00:00:00.000Z",15,FALSE,19,666969,"F",19,19,"New Orleans Pelicans","Zion Williamson",0,30,33,26,10,32.9
1,1,12,4,2,7,4,2,2,"29",0,1,12,12,0,3,1037603,"2023-10-25T00:00:00.000Z",15,FALSE,19,455,"C",19,19,"New Orleans Pelicans","Jonas Valanciunas",1,24,25,13,13,27.9
3,1,5,3,2,8,4,5,3,"38",3,3,13,8,1,3,1037603,"2023-10-25T00:00:00.000Z",15,FALSE,19,17896024,"F",19,19,"New Orleans Pelicans","Herbert Jones",2,21,24,16,11,30.1
6,1,3,11,6,16,8,2,2,"37",1,3,24,4,2,2,1037603,"2023-10-25T00:00:00.000Z",15,FALSE,19,303,"G",19,19,"New Orleans Pelicans","CJ McCollum",3,28,34,30,10,44.8
0,1,3,1,0,6,3,0,0,"19",2,4,6,5,2,2,1037603,"2023-10-25T00:00:00.000Z",15,FALSE,19,38017677,"G",19,19,"New Orleans Pelicans","Dyson Daniels",3,11,11,6,5,19
0,0,0,0,0,0,0,0,0,"00",0,0,0,0,0,0,1037603,"2023-10-25T00:00:00.000Z",15,FALSE,19,666584,"F",19,19,"New Orleans Pelicans","Kaiser Gates",0,0,0,0,0,0
2,0,0,2,1,2,1,0,0,"09",0,2,3,0,0,0,1037603,"2023-10-25T00:00:00.000Z",15,FALSE,19,56677837,"G",19,19,"New Orleans Pelicans","Jordan Hawkins",0,3,5,5,2,6
0,1,0,2,0,3,0,0,0,"11",0,1,0,0,0,1,1037603,"2023-10-25T00:00:00.000Z",15,FALSE,19,3547260,"G",19,19,"New Orleans Pelicans","Kira Lewis Jr.",1,0,0,0,0,2
0,0,0,0,0,0,0,0,0,"00",0,0,0,0,0,0,1037603,"2023-10-25T00:00:00.000Z",15,FALSE,19,38017663,"F",19,19,"New Orleans Pelicans","E.J. Liddell",0,0,0,0,0,0
0,0,7,0,0,2,1,0,0,"15",1,1,2,8,1,2,1037603,"2023-10-25T00:00:00.000Z",15,FALSE,19,340,"F",19,19,"New Orleans Pelicans","Larry Nance Jr.",1,10,10,2,8,12.6
1,0,1,6,3,6,3,0,0,"14",0,2,9,1,0,0,1037603,"2023-10-25T00:00:00.000Z",15,FALSE,19,17896017,"F",19,19,"New Orleans Pelicans","Matt Ryan",0,10,11,10,2,11.7
0,0,0,0,0,0,0,0,0,"00",0,0,0,0,0,0,1037603,"2023-10-25T00:00:00.000Z",15,FALSE,19,491,"C",19,19,"New Orleans Pelicans","Cody Zeller",0,0,0,0,0,0
1,0,2,2,0,3,1,0,0,"14",0,4,2,2,1,0,1037603,"2023-10-25T00:00:00.000Z",15,FALSE,19,38017728,"F",15,15,"Memphis Grizzlies","Jake LaRavia",1,4,5,3,3,8.9
0,0,0,0,0,0,0,0,0,"00",0,0,0,0,0,0,1037603,"2023-10-25T00:00:00.000Z",15,FALSE,19,38017732,"F",15,15,"Memphis Grizzlies","Kenneth Lofton Jr.",0,0,0,0,0,0
0,0,0,0,0,0,0,0,0,"00",0,0,0,0,0,0,1037603,"2023-10-25T00:00:00.000Z",15,FALSE,19,666786,"G",15,15,"Memphis Grizzlies","Ja Morant",0,0,0,0,0,0
3,0,1,4,2,11,3,0,0,"16",1,0,8,2,0,0,1037603,"2023-10-25T00:00:00.000Z",15,FALSE,19,401,"G",15,15,"Memphis Grizzlies","Derrick Rose",0,10,13,11,5,14.9
0,0,0,0,0,0,0,0,0,"00",0,0,0,0,0,0,1037603,"2023-10-25T00:00:00.000Z",15,FALSE,19,38017731,"G",15,15,"Memphis Grizzlies","Vince Williams Jr.",0,0,0,0,0,0
0,0,0,0,0,0,0,0,0,"00",0,0,0,0,0,0,1037603,"2023-10-25T00:00:00.000Z",15,FALSE,19,3,"C",15,15,"Memphis Grizzlies","Steven Adams",0,0,0,0,0,0
0,0,0,0,0,0,0,0,0,"00",0,0,0,0,0,0,1037603,"2023-10-25T00:00:00.000Z",15,FALSE,19,17896067,"F",15,15,"Memphis Grizzlies","Santi Aldama",0,0,0,0,0,0
0,0,0,0,0,0,0,0,0,"00",0,0,0,0,0,0,1037603,"2023-10-25T00:00:00.000Z",15,FALSE,19,18677986,"F",19,19,"New Orleans Pelicans","Trey Murphy III",0,0,0,0,0,0
0,0,0,0,0,0,0,0,0,"00",0,0,0,0,0,0,1037603,"2023-10-25T00:00:00.000Z",15,FALSE,19,38017726,"G",19,19,"New Orleans Pelicans","Dereon Seabron",0,0,0,0,0,0
0,0,0,0,0,0,0,0,0,"00",0,0,0,0,0,0,1037603,"2023-10-25T00:00:00.000Z",15,FALSE,19,17896097,"G",19,19,"New Orleans Pelicans","Jose Alvarado",0,0,0,0,0,0
0,0,0,0,0,0,0,0,0,"00",0,0,0,0,0,0,1037603,"2023-10-25T00:00:00.000Z",15,FALSE,19,3547293,"F",19,19,"New Orleans Pelicans","Naji Marshall",0,0,0,0,0,0
1,0,8,6,2,15,6,6,5,"32",2,1,19,10,2,1,1037604,"2023-10-25T00:00:00.000Z",29,FALSE,26,297,"F",29,29,"Utah Jazz","Lauri Markkanen",2,29,30,20,11,37.5
2,0,8,3,1,11,6,2,2,"31",3,3,15,11,1,0,1037604,"2023-10-25T00:00:00.000Z",29,FALSE,26,101,"F-C",29,29,"Utah Jazz","John Collins",1,26,28,17,13,34.2
0,1,4,0,0,5,4,0,0,"22",4,3,8,8,0,1,1037604,"2023-10-25T00:00:00.000Z",29,FALSE,26,38017705,"C",29,29,"Utah Jazz","Walker Kessler",1,16,16,8,8,19.6
6,0,2,5,2,16,8,8,6,"31",2,4,24,4,0,2,1037604,"2023-10-25T00:00:00.000Z",29,FALSE,26,100,"G",29,29,"Utah Jazz","Jordan Clarkson",0,28,34,30,10,35.8
4,1,1,4,2,9,3,0,0,"22",0,1,8,1,0,1,1037604,"2023-10-25T00:00:00.000Z",29,FALSE,26,666650,"G",29,29,"Utah Jazz","Talen Horton-Tucker",1,9,13,12,5,17.2
0,0,3,2,1,6,2,0,0,"20",0,2,5,3,0,0,1037604,"2023-10-25T00:00:00.000Z",29,FALSE,26,38017620,"G",29,29,"Utah Jazz","Ochai Agbaji",0,8,8,5,3,8.6
2,0,1,1,0,6,3,4,2,"16",0,0,8,1,2,4,1037604,"2023-10-25T00:00:00.000Z",29,FALSE,26,139,"G",29,29,"Utah Jazz","Kris Dunn",2,9,11,10,3,14.2
1,0,0,1,0,2,1,0,0,"02",1,0,2,1,0,0,1037604,"2023-10-25T00:00:00.000Z",29,FALSE,26,38017739,"F",29,29,"Utah Jazz","Simone Fontecchio",0,3,4,3,2,4.7
4,0,3,0,0,3,2,1,1,"17",3,3,5,6,1,1,1037604,"2023-10-25T00:00:00.000Z",29,FALSE,26,358,"F",29,29,"Utah Jazz","Kelly Olynyk",1,11,15,9,10,20.2
5,2,6,2,1,14,8,7,5,"32",6,3,22,12,1,3,1037604,"2023-10-25T00:00:00.000Z",29,FALSE,26,406,"F",26,26,"Sacramento Kings","Domantas Sabonis",3,34,39,27,17,49.9
2,0,3,5,1,9,3,0,0,"24",2,3,7,5,0,1,1037604,"2023-10-25T00:00:00.000Z",29,FALSE,26,221,"G",26,26,"Sacramento Kings","Kevin Huerter",0,12,14,9,7,15
6,1,3,7,1,18,6,6,5,"33",2,4,18,5,1,3,1037604,"2023-10-25T00:00:00.000Z",29,FALSE,26,161,"G",26,26,"Sacramento Kings","De'Aaron Fox",2,23,29,24,11,36
1,0,1,4,3,5,3,0,0,"15",1,3,9,2,0,0,1037604,"2023-10-25T00:00:00.000Z",29,FALSE,26,17896030,"G",26,26,"Sacramento Kings","Chris Duarte",0,11,12,10,3,12.9
4,0,3,2,0,3,0,0,0,"14",0,3,0,3,0,1,1037604,"2023-10-25T00:00:00.000Z",29,FALSE,26,17553994,"G",26,26,"Sacramento Kings","Davion Mitchell",0,3,7,4,7,8.6
7,2,1,9,2,12,4,0,0,"23",1,2,10,2,0,2,1037604,"2023-10-25T00:00:00.000Z",29,FALSE,26,324,"G",26,26,"Sacramento Kings","Malik Monk",2,12,19,17,9,26.9
0,0,1,5,2,6,3,0,0,"16",1,1,8,2,2,0,1037604,"2023-10-25T00:00:00.000Z",29,FALSE,26,4197162,"F",26,26,"Sacramento Kings","Aleksandar Vezenkov",2,10,10,8,2,16.4
2,0,2,3,1,5,3,1,1,"19",0,0,8,2,0,1,1037604,"2023-10-25T00:00:00.000Z",29,FALSE,26,56677834,"G",29,29,"Utah Jazz","Keyonte George",0,10,12,10,4,12.4
0,0,1,0,0,0,0,2,1,"02",0,0,1,1,0,0,1037604,"2023-10-25T00:00:00.000Z",29,FALSE,26,56677824,"F",29,29,"Utah Jazz","Taylor Hendricks",0,2,2,1,1,2.2
0,0,1,1,0,2,1,0,0,"02",0,0,2,1,0,0,1037604,"2023-10-25T00:00:00.000Z",29,FALSE,26,666881,"F",29,29,"Utah Jazz","Luka Samanic",0,3,3,2,1,3.2
0,0,0,0,0,2,0,0,0,"02",1,0,0,1,0,0,1037604,"2023-10-25T00:00:00.000Z",29,FALSE,26,56677842,"F",29,29,"Utah Jazz","Brice Sensabaugh",0,1,1,0,1,1.2
0,0,3,2,0,9,2,7,5,"20",0,3,9,3,0,3,1037604,"2023-10-25T00:00:00.000Z",29,FALSE,26,413,"G",29,29,"Utah Jazz","Collin Sexton",0,12,12,9,3,9.6
0,0,1,0,0,0,0,0,0,"02",0,0,0,1,0,0,1037604,"2023-10-25T00:00:00.000Z",29,FALSE,26,11891374,"C",29,29,"Utah Jazz","Omer Yurtseven",0,1,1,0,1,1.2
0,0,0,0,0,0,0,0,0,"00",0,0,0,0,0,0,1037604,"2023-10-25T00:00:00.000Z",29,FALSE,26,17896023,"G",29,29,"Utah Jazz","Josh Christopher",0,0,0,0,0,0
0,0,0,0,0,0,0,0,0,"00",0,0,0,0,0,0,1037604,"2023-10-25T00:00:00.000Z",29,FALSE,26,38017630,"G",29,29,"Utah Jazz","Johnny Juzang",0,0,0,0,0,0
0,0,0,0,0,0,0,0,0,"00",0,0,0,0,0,0,1037604,"2023-10-25T00:00:00.000Z",29,FALSE,26,19465584,"F",29,29,"Utah Jazz","Micah Potter",0,0,0,0,0,0
2,0,4,7,5,16,11,6,6,"33",0,2,33,4,1,1,1037604,"2023-10-25T00:00:00.000Z",29,FALSE,26,30,"F",26,26,"Sacramento Kings","Harrison Barnes",1,37,39,35,6,42.8
0,0,0,1,0,1,0,0,0,"01",0,0,0,0,0,0,1037604,"2023-10-25T00:00:00.000Z",29,FALSE,26,17896044,"F",26,26,"Sacramento Kings","Kessler Edwards",0,0,0,0,0,0
0,0,0,0,0,0,0,0,0,"01",0,0,0,0,0,0,1037604,"2023-10-25T00:00:00.000Z",29,FALSE,26,38017714,"G",26,26,"Sacramento Kings","Keon Ellis",0,0,0,0,0,0
0,0,0,0,0,1,0,0,0,"01",0,0,0,0,0,0,1037604,"2023-10-25T00:00:00.000Z",29,FALSE,26,17895990,"G",26,26,"Sacramento Kings","Jordan Ford",0,0,0,0,0,0
0,0,1,0,0,0,0,0,0,"01",0,0,0,1,0,0,1037604,"2023-10-25T00:00:00.000Z",29,FALSE,26,56677845,"G",26,26,"Sacramento Kings","Colby Jones",0,1,1,0,1,1.2
1,1,1,0,0,4,4,0,0,"14",0,0,8,1,0,0,1037604,"2023-10-25T00:00:00.000Z",29,FALSE,26,306,"C",26,26,"Sacramento Kings","JaVale McGee",1,9,10,9,2,13.7
1,2,6,9,4,13,5,1,1,"30",2,4,15,8,1,0,1037604,"2023-10-25T00:00:00.000Z",29,FALSE,26,38017688,"F",26,26,"Sacramento Kings","Keegan Murray",3,23,24,16,9,35.1
0,0,0,0,0,0,0,0,0,"02",0,0,0,0,0,0,1037604,"2023-10-25T00:00:00.000Z",29,FALSE,26,273,"C",26,26,"Sacramento Kings","Alex Len",0,0,0,0,0,0
0,0,0,0,0,0,0,0,0,"00",0,0,0,0,0,0,1037604,"2023-10-25T00:00:00.000Z",29,FALSE,26,290,"F",26,26,"Sacramento Kings","Trey Lyles",0,0,0,0,0,0
0,0,0,0,0,0,0,0,0,"00",0,0,0,0,0,0,1037604,"2023-10-25T00:00:00.000Z",29,FALSE,26,56677862,"F",26,26,"Sacramento Kings","Jalen Slawson",0,0,0,0,0,0
0,1,5,8,4,11,6,1,1,"35",1,4,17,6,0,3,1037605,"2023-10-25T00:00:00.000Z",27,FALSE,7,666965,"F",7,7,"Dallas Mavericks","Grant Williams",1,23,23,17,6,24.2
2,1,5,5,2,7,2,0,0,"23",2,3,6,7,0,0,1037605,"2023-10-25T00:00:00.000Z",27,FALSE,7,257,"F",7,7,"Dallas Mavericks","Maxi Kleber",1,13,15,8,9,20.4
7,0,7,3,1,15,7,3,2,"32",2,4,17,9,0,3,1037605,"2023-10-25T00:00:00.000Z",27,FALSE,7,666682,"F",27,27,"San Antonio Spurs","Keldon Johnson",0,26,33,24,16,35.3
2,1,5,5,3,9,6,1,0,"23",0,5,15,5,2,5,1037605,"2023-10-25T00:00:00.000Z",27,FALSE,7,56677822,"F-C",27,27,"San Antonio Spurs","Victor Wembanyama",3,20,22,17,7,28
3,2,4,4,0,10,6,2,2,"32",1,4,14,5,1,3,1037605,"2023-10-25T00:00:00.000Z",27,FALSE,7,102,"F-C",27,27,"San Antonio Spurs","Zach Collins",3,19,22,17,8,30.5
3,0,4,6,1,17,9,5,4,"35",1,2,23,5,2,2,1037605,"2023-10-25T00:00:00.000Z",27,FALSE,7,3547246,"G-F",27,27,"San Antonio Spurs","Devin Vassell",2,28,31,26,8,37.5
5,0,5,4,2,12,4,6,3,"29",2,4,13,7,1,2,1037605,"2023-10-25T00:00:00.000Z",27,FALSE,7,38017699,"F",27,27,"San Antonio Spurs","Jeremy Sochan",1,20,25,18,12,29.9
2,0,4,0,0,1,1,0,0,"13",1,0,2,5,1,1,1037605,"2023-10-25T00:00:00.000Z",27,FALSE,7,17895854,"G",27,27,"San Antonio Spurs","Charles Bassey",1,7,9,4,7,13
2,1,0,6,2,10,5,0,0,"22",0,2,12,0,0,0,1037605,"2023-10-25T00:00:00.000Z",27,FALSE,7,359,"F",27,27,"San Antonio Spurs","Cedi Osman",1,12,14,14,2,18
4,0,4,10,3,14,5,4,4,"28",2,0,17,6,1,1,1037605,"2023-10-25T00:00:00.000Z",27,FALSE,7,191,"G",7,7,"Dallas Mavericks","Tim Hardaway Jr.",1,23,27,21,10,32.2
1,1,5,0,0,8,7,3,2,"31",5,4,16,10,1,1,1037605,"2023-10-25T00:00:00.000Z",27,FALSE,7,56677840,"C",7,7,"Dallas Mavericks","Dereck Lively II",2,26,27,17,11,34.5
10,0,13,11,3,25,13,7,4,"34",1,1,33,14,1,4,1037605,"2023-10-25T00:00:00.000Z",27,FALSE,7,132,"F-G",7,7,"Dallas Mavericks","Luka Doncic",1,47,57,43,24,63.8
6,0,2,8,1,24,10,1,1,"36",0,3,22,2,1,2,1037605,"2023-10-25T00:00:00.000Z",27,FALSE,7,228,"G",7,7,"Dallas Mavericks","Kyrie Irving",1,24,30,28,8,34.4
0,0,0,0,0,0,0,0,0,"04",0,0,0,0,0,0,1037605,"2023-10-25T00:00:00.000Z",27,FALSE,7,114,"G",7,7,"Dallas Mavericks","Seth Curry",0,0,0,0,0,0
0,0,1,1,0,2,1,1,1,"08",0,1,3,1,0,0,1037605,"2023-10-25T00:00:00.000Z",27,FALSE,7,151,"G",7,7,"Dallas Mavericks","Dante Exum",0,4,4,3,1,4.2
1,0,0,2,2,5,3,4,3,"30",2,4,11,2,1,0,1037605,"2023-10-25T00:00:00.000Z",27,FALSE,7,3547258,"G",7,7,"Dallas Mavericks","Josh Green",1,13,14,12,3,17.9
0,0,1,2,0,3,0,2,1,"11",0,0,1,1,0,1,1037605,"2023-10-25T00:00:00.000Z",27,FALSE,7,247,"F-G",7,7,"Dallas Mavericks","Derrick Jones Jr.",0,2,2,1,1,1.2
0,0,0,0,0,0,0,0,0,"00",0,0,0,0,0,0,1037605,"2023-10-25T00:00:00.000Z",27,FALSE,7,38017649,"F",27,27,"San Antonio Spurs","Julian Champagnie",0,0,0,0,0,0
0,0,0,0,0,0,0,0,0,"00",0,0,0,0,0,0,1037605,"2023-10-25T00:00:00.000Z",27,FALSE,7,180,"G",27,27,"San Antonio Spurs","Devonte' Graham",0,0,0,0,0,0
0,0,0,0,0,0,0,0,0,"00",0,0,0,0,0,0,1037605,"2023-10-25T00:00:00.000Z",27,FALSE,7,17896059,"F",27,27,"San Antonio Spurs","Sandro Mamukelashvili",0,0,0,0,0,0
0,0,0,0,0,0,0,0,0,"00",0,0,0,0,0,0,1037605,"2023-10-25T00:00:00.000Z",27,FALSE,7,38017693,"G",27,27,"San Antonio Spurs","Blake Wesley",0,0,0,0,0,0
0,0,0,0,0,0,0,0,0,"00",0,0,0,0,0,0,1037605,"2023-10-25T00:00:00.000Z",27,FALSE,7,56677865,"C",27,27,"San Antonio Spurs","Charles Bediako",0,0,0,0,0,0
0,0,0,0,0,0,0,0,0,"00",0,0,0,0,0,0,1037605,"2023-10-25T00:00:00.000Z",27,FALSE,7,56677817,"G",27,27,"San Antonio Spurs","Sidy Cissoko",0,0,0,0,0,0
0,0,0,0,0,0,0,0,0,"00",0,0,0,0,0,0,1037605,"2023-10-25T00:00:00.000Z",27,FALSE,7,56677870,"G",27,27,"San Antonio Spurs","Sir'Jabari Rice",0,0,0,0,0,0
0,0,0,0,0,0,0,0,0,"00",0,0,0,0,0,0,1037605,"2023-10-25T00:00:00.000Z",27,FALSE,7,38017679,"G",7,7,"Dallas Mavericks","Jaden Hardy",0,0,0,0,0,0
0,0,0,0,0,0,0,0,0,"00",0,0,0,0,0,0,1037605,"2023-10-25T00:00:00.000Z",27,FALSE,7,217,"F-C",7,7,"Dallas Mavericks","Richaun Holmes",0,0,0,0,0,0
0,0,0,0,0,0,0,0,0,"00",0,0,0,0,0,0,1037605,"2023-10-25T00:00:00.000Z",27,FALSE,7,329,"F",7,7,"Dallas Mavericks","Markieff Morris",0,0,0,0,0,0
0,0,0,0,0,0,0,0,0,"00",0,0,0,0,0,0,1037605,"2023-10-25T00:00:00.000Z",27,FALSE,7,379,"F-C",7,7,"Dallas Mavericks","Dwight Powell",0,0,0,0,0,0
0,0,0,0,0,0,0,0,0,"00",0,0,0,0,0,0,1037605,"2023-10-25T00:00:00.000Z",27,FALSE,7,56677859,"F",7,7,"Dallas Mavericks","Olivier-Maxence Prosper",0,0,0,0,0,0
0,0,0,0,0,0,0,0,0,"00",0,0,0,0,0,0,1037605,"2023-10-25T00:00:00.000Z",27,FALSE,7,17896028,"F",7,7,"Dallas Mavericks","Greg Brown III",0,0,0,0,0,0
0,0,0,0,0,0,0,0,0,"00",0,0,0,0,0,0,1037605,"2023-10-25T00:00:00.000Z",27,FALSE,7,56677873,"G",7,7,"Dallas Mavericks","Dexter Dennis",0,0,0,0,0,0
0,0,0,0,0,0,0,0,0,"00",0,0,0,0,0,0,1037605,"2023-10-25T00:00:00.000Z",27,FALSE,7,17554004,"G",7,7,"Dallas Mavericks","AJ Lawson",0,0,0,0,0,0
6,0,4,3,2,7,5,4,4,"25",1,0,16,5,0,1,1037605,"2023-10-25T00:00:00.000Z",27,FALSE,7,3547274,"G",27,27,"San Antonio Spurs","Tre Jones",0,21,27,22,11,30
2,0,2,3,0,7,3,1,1,"18",0,1,7,2,1,1,1037605,"2023-10-25T00:00:00.000Z",27,FALSE,7,38017692,"F",27,27,"San Antonio Spurs","Malaki Branham",1,9,11,9,4,14.4
1,1,1,1,0,1,0,0,0,"11",0,1,0,1,0,0,1037605,"2023-10-25T00:00:00.000Z",27,FALSE,7,305,"F",27,27,"San Antonio Spurs","Doug McDermott",1,1,2,1,2,5.7
0,0,0,0,0,0,0,0,0,"00",0,0,0,0,0,0,1037605,"2023-10-25T00:00:00.000Z",27,FALSE,7,38017730,"F",27,27,"San Antonio Spurs","Dominick Barlow",0,0,0,0,0,0
2,0,5,0,0,4,2,4,2,"17",3,0,6,8,0,0,1037606,"2023-10-25T00:00:00.000Z",13,FALSE,25,371,"F-C",13,13,"LA Clippers","Mason Plumlee",0,14,16,8,10,18.6
1,0,3,5,2,6,2,2,2,"23",0,0,8,3,0,2,1037606,"2023-10-25T00:00:00.000Z",13,FALSE,25,380,"F-G",13,13,"LA Clippers","Norman Powell",0,11,12,9,4,11.1
0,0,0,0,0,0,0,0,0,"00",0,0,0,0,0,0,1037606,"2023-10-25T00:00:00.000Z",13,FALSE,25,17896022,"G",13,13,"LA Clippers","Brandon Boston Jr.",0,0,0,0,0,0
0,0,0,0,0,0,0,0,0,"00",0,0,0,0,0,0,1037606,"2023-10-25T00:00:00.000Z",13,FALSE,25,666743,"G",13,13,"LA Clippers","Terance Mann",0,0,0,0,0,0
0,0,0,0,0,0,0,0,0,"00",0,0,0,0,0,0,1037606,"2023-10-25T00:00:00.000Z",13,FALSE,25,328,"F",23,13,"LA Clippers","Marcus Morris",0,0,0,0,0,0
0,0,0,0,0,0,0,0,0,"00",0,0,0,0,0,0,1037606,"2023-10-25T00:00:00.000Z",13,FALSE,25,17896051,"G",13,13,"LA Clippers","Joshua Primo",0,0,0,0,0,0
1,0,0,6,2,7,3,0,0,"20",1,0,8,1,1,2,1037606,"2023-10-25T00:00:00.000Z",13,FALSE,25,666923,"G-F",25,25,"Portland Trail Blazers","Matisse Thybulle",1,9,10,9,2,11.7
1,1,1,4,0,12,5,4,3,"30",2,1,13,3,0,3,1037606,"2023-10-25T00:00:00.000Z",13,FALSE,25,182,"F",25,25,"Portland Trail Blazers","Jerami Grant",1,16,17,14,4,18.1
2,1,3,4,1,5,2,0,0,"23",1,2,5,4,3,0,1037606,"2023-10-25T00:00:00.000Z",13,FALSE,25,108,"F",23,13,"LA Clippers","Robert Covington",4,9,11,7,6,24.8
6,1,4,5,5,17,9,0,0,"29",1,2,23,5,1,4,1037606,"2023-10-25T00:00:00.000Z",13,FALSE,25,274,"F",13,13,"LA Clippers","Kawhi Leonard",2,28,34,29,11,40
0,4,7,0,0,10,8,5,4,"26",5,3,20,12,0,2,1037606,"2023-10-25T00:00:00.000Z",13,FALSE,25,493,"C",13,13,"LA Clippers","Ivica Zubac",4,32,32,20,12,44.4
6,0,3,7,4,17,11,1,1,"32",0,2,27,3,3,4,1037606,"2023-10-25T00:00:00.000Z",13,FALSE,25,172,"F",13,13,"LA Clippers","Paul George",3,30,36,33,9,44.6
13,0,3,2,1,8,5,0,0,"29",2,3,11,5,0,3,1037606,"2023-10-25T00:00:00.000Z",13,FALSE,25,472,"G",13,13,"LA Clippers","Russell Westbrook",0,16,29,24,18,33.5
1,1,3,0,0,0,0,0,0,"09",0,0,0,3,1,0,1037606,"2023-10-25T00:00:00.000Z",13,FALSE,25,33,"F-G",23,13,"LA Clippers","Nicolas Batum",2,3,4,1,4,11.1
0,0,0,1,0,2,0,0,0,"05",0,1,0,0,0,0,1037606,"2023-10-25T00:00:00.000Z",13,FALSE,25,56677849,"F",13,13,"LA Clippers","Kobe Brown",0,0,0,0,0,0
1,0,0,0,0,1,0,2,2,"04",0,0,2,0,0,0,1037606,"2023-10-25T00:00:00.000Z",13,FALSE,25,666511,"G",13,13,"LA Clippers","Amir Coffey",0,2,3,3,1,3.5
1,1,9,0,0,4,2,0,0,"23",3,5,4,12,3,3,1037606,"2023-10-25T00:00:00.000Z",13,FALSE,25,22,"C",25,25,"Portland Trail Blazers","Deandre Ayton",4,16,17,5,13,28.9
4,0,1,6,2,14,6,4,4,"27",1,2,18,2,2,0,1037606,"2023-10-25T00:00:00.000Z",13,FALSE,25,419,"G",25,25,"Portland Trail Blazers","Anfernee Simons",2,20,24,22,6,32.4
4,0,2,3,0,11,5,1,1,"36",1,2,11,3,0,4,1037606,"2023-10-25T00:00:00.000Z",13,FALSE,25,56677747,"G",25,25,"Portland Trail Blazers","Scoot Henderson",0,14,18,15,7,16.6
5,0,2,5,3,16,8,1,1,"23",0,0,20,2,0,1,1037606,"2023-10-25T00:00:00.000Z",13,FALSE,25,65,"G",25,25,"Portland Trail Blazers","Malcolm Brogdon",0,22,27,25,7,28.9
0,0,0,0,0,0,0,0,0,"00",0,0,0,0,0,0,1037606,"2023-10-25T00:00:00.000Z",13,FALSE,25,666476,"C",25,25,"Portland Trail Blazers","Moses Brown",0,0,0,0,0,0
1,1,2,2,2,5,2,2,1,"16",0,2,7,2,0,0,1037606,"2023-10-25T00:00:00.000Z",13,FALSE,25,56677850,"F",25,25,"Portland Trail Blazers","Toumani Camara",1,9,10,8,3,13.9
3,0,2,6,1,14,6,1,1,"29",4,4,14,6,1,0,1037606,"2023-10-25T00:00:00.000Z",13,FALSE,25,38017690,"G",25,25,"Portland Trail Blazers","Shaedon Sharpe",1,20,23,17,9,28.7
0,1,5,0,0,7,5,1,0,"23",2,4,10,7,3,2,1037606,"2023-10-25T00:00:00.000Z",13,FALSE,25,476,"C-F",25,25,"Portland Trail Blazers","Robert Williams III",4,17,17,10,7,28.4
0,0,0,0,0,3,1,0,0,"04",1,0,2,1,2,0,1037606,"2023-10-25T00:00:00.000Z",13,FALSE,25,38017725,"F",13,13,"LA Clippers","Moussa Diabate",2,3,3,2,1,9.2
3,0,0,8,3,11,6,2,2,"22",0,4,17,0,0,2,1037606,"2023-10-25T00:00:00.000Z",13,FALSE,25,17896031,"G",13,13,"LA Clippers","Nah'Shon Hyland",0,17,20,20,3,19.5
1,0,0,2,0,4,0,0,0,"13",1,2,0,1,1,0,1037606,"2023-10-25T00:00:00.000Z",13,FALSE,25,3547294,"F",23,13,"LA Clippers","Kenyon Martin Jr.",1,1,2,1,2,5.7
0,0,0,0,0,2,1,0,0,"04",0,1,2,0,0,0,1037606,"2023-10-25T00:00:00.000Z",13,FALSE,25,56677856,"G",13,13,"LA Clippers","Jordan Miller",0,2,2,2,0,2
0,0,1,0,0,0,0,0,0,"05",0,0,0,1,0,0,1037606,"2023-10-25T00:00:00.000Z",13,FALSE,25,56677791,"F",25,25,"Portland Trail Blazers","Kris Murray",0,1,1,0,1,1.2
0,0,0,0,0,0,0,0,0,"02",0,0,0,0,0,0,1037606,"2023-10-25T00:00:00.000Z",13,FALSE,25,56677829,"G-F",25,25,"Portland Trail Blazers","Rayan Rupert",0,0,0,0,0,0
0,0,0,0,0,3,2,3,2,"06",1,0,6,1,0,2,1037606,"2023-10-25T00:00:00.000Z",13,FALSE,25,38017711,"F",25,25,"Portland Trail Blazers","Jabari Walker",0,7,7,6,1,5.2
0,0,0,0,0,0,0,0,0,"00",0,0,0,0,0,0,1037606,"2023-10-25T00:00:00.000Z",13,FALSE,25,3547289,"G",25,25,"Portland Trail Blazers","Skylar Mays",0,0,0,0,0,0
0,0,0,0,0,0,0,0,0,"00",0,0,0,0,0,0,1037606,"2023-10-25T00:00:00.000Z",13,FALSE,25,47957121,"F",25,25,"Portland Trail Blazers","Justin Minaya",0,0,0,0,0,0
0,0,0,0,0,0,0,0,0,"00",0,0,0,0,0,0,1037606,"2023-10-25T00:00:00.000Z",13,FALSE,25,56783340,"C",25,25,"Portland Trail Blazers","Duop Reath",0,0,0,0,0,0
0,0,0,0,0,0,0,0,0,"00",0,0,0,0,0,0,1037606,"2023-10-25T00:00:00.000Z",13,FALSE,25,17896120,"F",25,25,"Portland Trail Blazers","Ish Wainright",0,0,0,0,0,0
4,0,3,3,1,5,2,2,1,"16",0,0,6,3,2,2,1037607,"2023-10-26T00:00:00.000Z",17,FALSE,23,315,"F",17,17,"Milwaukee Bucks","Khris Middleton",2,9,13,10,7,19.6
3,2,8,3,0,22,10,9,3,"35",5,4,23,13,2,7,1037607,"2023-10-26T00:00:00.000Z",17,FALSE,23,15,"F",17,17,"Milwaukee Bucks","Giannis Antetokounmpo",4,36,39,26,16,48.1
0,0,1,4,3,7,5,0,0,"29",1,4,13,2,0,2,1037607,"2023-10-26T00:00:00.000Z",17,FALSE,23,283,"C",17,17,"Milwaukee Bucks","Brook Lopez",0,15,15,13,2,13.4
3,0,4,1,1,4,2,0,0,"31",0,1,5,4,2,2,1037607,"2023-10-26T00:00:00.000Z",17,FALSE,23,38,"G",17,17,"Milwaukee Bucks","Malik Beasley",2,9,12,8,7,18.3
4,0,8,12,4,20,9,17,17,"37",0,2,39,8,0,0,1037607,"2023-10-26T00:00:00.000Z",17,FALSE,23,278,"G",17,17,"Milwaukee Bucks","Damian Lillard",0,47,51,43,12,54.6
0,0,0,0,0,0,0,0,0,"00",0,0,0,0,0,0,1037607,"2023-10-26T00:00:00.000Z",17,FALSE,23,2148,"",17,17,"Milwaukee Bucks","Thanasis Antetokounmpo",0,0,0,0,0,0
0,0,1,1,0,3,2,0,0,"17",1,3,4,2,0,0,1037607,"2023-10-26T00:00:00.000Z",17,FALSE,23,38017676,"F",17,17,"Milwaukee Bucks","MarJon Beauchamp",0,6,6,4,2,6.4
2,1,2,4,1,6,2,2,2,"20",0,0,7,2,0,0,1037607,"2023-10-26T00:00:00.000Z",17,FALSE,23,105,"G",17,17,"Milwaukee Bucks","Pat Connaughton",1,9,11,9,4,15.4
2,0,4,1,1,4,3,2,2,"27",0,3,9,4,2,1,1037607,"2023-10-26T00:00:00.000Z",17,FALSE,23,112,"F",17,17,"Milwaukee Bucks","Jae Crowder",2,13,15,11,6,21.8
0,0,0,0,0,0,0,0,0,"00",0,0,0,0,0,0,1037607,"2023-10-26T00:00:00.000Z",17,FALSE,23,38017733,"G",17,17,"Milwaukee Bucks","A.J. Green",0,0,0,0,0,0
0,0,0,0,0,0,0,0,0,"00",0,0,0,0,0,0,1037607,"2023-10-26T00:00:00.000Z",17,FALSE,23,56677852,"G",17,17,"Milwaukee Bucks","Andre Jackson Jr.",0,0,0,0,0,0
0,0,0,0,0,0,0,0,0,"00",0,0,0,0,0,0,1037607,"2023-10-26T00:00:00.000Z",17,FALSE,23,56677854,"F",17,17,"Milwaukee Bucks","Chris Livingston",0,0,0,0,0,0
0,0,0,0,0,0,0,0,0,"00",0,0,0,0,0,0,1037607,"2023-10-26T00:00:00.000Z",17,FALSE,23,284,"C",17,17,"Milwaukee Bucks","Robin Lopez",0,0,0,0,0,0
0,0,0,1,0,3,1,0,0,"09",0,3,2,0,1,0,1037607,"2023-10-26T00:00:00.000Z",17,FALSE,23,368,"G",17,17,"Milwaukee Bucks","Cameron Payne",1,2,2,2,0,5
2,1,4,0,0,8,5,4,0,"19",2,3,10,6,0,0,1037607,"2023-10-26T00:00:00.000Z",17,FALSE,23,377,"F",17,17,"Milwaukee Bucks","Bobby Portis",1,16,18,12,8,23.2
0,0,0,0,0,0,0,0,0,"00",0,0,0,0,0,0,1037607,"2023-10-26T00:00:00.000Z",17,FALSE,23,666453,"C",17,17,"Milwaukee Bucks","Marques Bolden",0,0,0,0,0,0
0,0,0,0,0,0,0,0,0,"00",0,0,0,0,0,0,1037607,"2023-10-26T00:00:00.000Z",17,FALSE,23,38017691,"G",17,17,"Milwaukee Bucks","TyTy Washington Jr.",0,0,0,0,0,0
0,0,0,0,0,0,0,0,0,"00",0,0,0,0,0,0,1037607,"2023-10-26T00:00:00.000Z",17,FALSE,23,666960,"G",17,17,"Milwaukee Bucks","Lindell Wigginton",0,0,0,0,0,0
2,0,7,3,3,9,8,2,1,"37",0,2,20,7,0,2,1037607,"2023-10-26T00:00:00.000Z",17,FALSE,23,200,"F",23,23,"Philadelphia 76ers","Tobias Harris",0,27,29,22,9,29.4
0,0,6,2,0,2,0,0,0,"26",1,5,0,7,2,0,1037607,"2023-10-26T00:00:00.000Z",17,FALSE,23,450,"F",13,23,"Philadelphia 76ers","PJ Tucker",2,7,7,0,7,14.4
6,1,7,7,3,21,9,8,3,"36",0,5,24,7,0,7,1037607,"2023-10-26T00:00:00.000Z",17,FALSE,23,145,"F-C",23,23,"Philadelphia 76ers","Joel Embiid",1,31,37,30,13,37.4
4,0,1,6,2,10,3,2,2,"25",1,2,10,2,2,1,1037607,"2023-10-26T00:00:00.000Z",17,FALSE,23,313,"G",23,23,"Philadelphia 76ers","De'Anthony Melton",2,12,16,14,6,23.4
8,0,4,8,3,22,10,10,8,"40",0,3,31,4,2,0,1037607,"2023-10-26T00:00:00.000Z",17,FALSE,23,3547254,"G",23,23,"Philadelphia 76ers","Tyrese Maxey",2,35,43,39,12,53.8
0,0,0,0,0,0,0,0,0,"00",0,0,0,0,0,0,1037607,"2023-10-26T00:00:00.000Z",17,FALSE,23,28,"C",23,23,"Philadelphia 76ers","Mo Bamba",0,0,0,0,0,0
2,0,2,0,0,1,1,0,0,"13",0,2,2,2,0,0,1037607,"2023-10-26T00:00:00.000Z",17,FALSE,23,45,"G",23,23,"Philadelphia 76ers","Patrick Beverley",0,4,6,4,4,7.4
1,0,2,1,0,1,0,0,0,"14",0,0,0,2,1,0,1037607,"2023-10-26T00:00:00.000Z",17,FALSE,23,184,"G-F",23,23,"Philadelphia 76ers","Danny Green",1,2,3,1,3,6.9
0,0,0,0,0,0,0,0,0,"00",0,0,0,0,0,0,1037607,"2023-10-26T00:00:00.000Z",17,FALSE,23,2175,"",23,23,"Philadelphia 76ers","Danuel House Jr.",0,0,0,0,0,0
0,0,0,0,0,0,0,0,0,"00",0,0,0,0,0,0,1037607,"2023-10-26T00:00:00.000Z",17,FALSE,23,260,"G-F",23,23,"Philadelphia 76ers","Furkan Korkmaz",0,0,0,0,0,0
0,0,3,6,5,11,9,4,4,"32",1,4,27,4,1,3,1037607,"2023-10-26T00:00:00.000Z",17,FALSE,23,360,"F",23,23,"Philadelphia 76ers","Kelly Oubre Jr.",1,31,31,27,4,31.8
0,0,0,0,0,0,0,0,0,"00",0,0,0,0,0,0,1037607,"2023-10-26T00:00:00.000Z",17,FALSE,23,17895941,"C",26,23,"Philadelphia 76ers","Filip Petrusev",0,0,0,0,0,0
2,1,3,1,0,2,1,2,1,"12",1,4,3,4,0,2,1037607,"2023-10-26T00:00:00.000Z",17,FALSE,23,3547270,"F",23,23,"Philadelphia 76ers","Paul Reed",1,7,9,5,6,11.8
0,2,0,1,0,1,0,0,0,"05",0,1,0,0,0,0,1037607,"2023-10-26T00:00:00.000Z",17,FALSE,23,17896025,"G",23,23,"Philadelphia 76ers","Jaden Springer",2,0,0,0,0,6
0,0,0,0,0,0,0,0,0,"00",0,0,0,0,0,0,1037607,"2023-10-26T00:00:00.000Z",17,FALSE,23,56913527,"G",23,23,"Philadelphia 76ers","Ricky Council IV",0,0,0,0,0,0
0,0,0,0,0,0,0,0,0,"00",0,0,0,0,0,0,1037607,"2023-10-26T00:00:00.000Z",17,FALSE,23,192,"G",13,23,"Philadelphia 76ers","James Harden",0,0,0,0,0,0
0,0,0,0,0,0,0,0,0,"00",0,0,0,0,0,0,1037607,"2023-10-26T00:00:00.000Z",17,FALSE,23,17554001,"G",23,23,"Philadelphia 76ers","Javonte Smart",0,0,0,0,0,0
0,0,0,0,0,0,0,0,0,"00",0,0,0,0,0,0,1037607,"2023-10-26T00:00:00.000Z",17,FALSE,23,56677788,"G",23,23,"Philadelphia 76ers","Terquavion Smith",0,0,0,0,0,0
0,0,0,1,0,5,0,0,0,"18",0,3,0,0,1,0,1037608,"2023-10-26T00:00:00.000Z",14,FALSE,24,383,"F",14,14,"Los Angeles Lakers","Taurean Prince",1,0,0,0,0,3
9,2,7,5,1,14,7,8,6,"35",1,1,21,8,2,5,1037608,"2023-10-26T00:00:00.000Z",14,FALSE,24,237,"F",14,14,"Los Angeles Lakers","LeBron James",4,29,38,30,17,51.1
2,3,9,2,1,17,10,10,9,"39",3,2,30,12,3,2,1037608,"2023-10-26T00:00:00.000Z",14,FALSE,24,117,"F-C",14,14,"Los Angeles Lakers","Anthony Davis",6,42,44,32,14,63.4
1,0,1,2,1,7,4,2,1,"28",1,5,10,2,1,1,1037608,"2023-10-26T00:00:00.000Z",14,FALSE,24,17553995,"G",14,14,"Los Angeles Lakers","Austin Reaves",1,12,13,11,3,15.9
5,1,4,7,1,16,6,1,1,"33",0,2,14,4,2,3,1037608,"2023-10-26T00:00:00.000Z",14,FALSE,24,405,"G",14,14,"Los Angeles Lakers","D'Angelo Russell",3,18,23,19,9,32.3
0,0,0,0,0,0,0,0,0,"00",0,0,0,0,0,0,1037608,"2023-10-26T00:00:00.000Z",14,FALSE,24,56677738,"C",14,14,"Los Angeles Lakers","Colin Castleton",0,0,0,0,0,0
0,0,0,0,0,0,0,0,0,"00",0,0,0,0,0,0,1037608,"2023-10-26T00:00:00.000Z",14,FALSE,24,38017697,"G",14,14,"Los Angeles Lakers","Max Christie",0,0,0,0,0,0
0,1,0,2,1,3,2,2,2,"13",0,2,7,0,1,1,1037608,"2023-10-26T00:00:00.000Z",14,FALSE,24,666609,"F",14,14,"Los Angeles Lakers","Rui Hachimura",2,7,7,7,0,12
0,0,2,0,0,0,0,0,0,"06",0,3,0,2,1,2,1037608,"2023-10-26T00:00:00.000Z",14,FALSE,24,666626,"C",14,14,"Los Angeles Lakers","Jaxson Hayes",1,2,2,0,2,3.4
0,0,0,0,0,0,0,0,0,"00",0,0,0,0,0,0,1037608,"2023-10-26T00:00:00.000Z",14,FALSE,24,56677868,"G",14,14,"Los Angeles Lakers","D'Moi Hodge",0,0,0,0,0,0
0,0,0,0,0,0,0,0,0,"00",0,0,0,0,0,0,1037608,"2023-10-26T00:00:00.000Z",14,FALSE,24,56677836,"F",14,14,"Los Angeles Lakers","Maxwell Lewis",0,0,0,0,0,0
0,0,1,3,0,5,2,0,0,"12",0,2,4,1,0,1,1037608,"2023-10-26T00:00:00.000Z",14,FALSE,24,666860,"F-G",14,14,"Los Angeles Lakers","Cameron Reddish",0,5,5,4,1,4.2
6,0,2,5,0,10,3,2,1,"35",1,1,7,3,3,0,1037608,"2023-10-26T00:00:00.000Z",14,FALSE,24,1603383,"G",14,14,"Los Angeles Lakers","Gabe Vincent",3,10,16,13,9,28.6
1,0,8,2,0,7,2,4,3,"21",2,2,7,10,0,1,1037608,"2023-10-26T00:00:00.000Z",14,FALSE,24,486,"F",14,14,"Los Angeles Lakers","Christian Wood",0,17,18,8,11,19.5
0,0,0,0,0,0,0,0,0,"00",0,0,0,0,0,0,1037608,"2023-10-26T00:00:00.000Z",14,FALSE,24,56677867,"F",14,14,"Los Angeles Lakers","Alex Fudge",0,0,0,0,0,0
0,0,0,0,0,0,0,0,0,"00",0,0,0,0,0,0,1037608,"2023-10-26T00:00:00.000Z",14,FALSE,24,56677835,"G",14,14,"Los Angeles Lakers","Jalen Hood-Schifino",0,0,0,0,0,0
0,0,0,0,0,0,0,0,0,"00",0,0,0,0,0,0,1037608,"2023-10-26T00:00:00.000Z",14,FALSE,24,457,"F",14,14,"Los Angeles Lakers","Jarred Vanderbilt",0,0,0,0,0,0
3,1,4,4,2,5,3,2,2,"33",4,2,10,8,0,1,1037608,"2023-10-26T00:00:00.000Z",14,FALSE,24,356,"G",24,24,"Phoenix Suns","Josh Okogie",1,18,21,13,11,26.1
2,1,11,5,1,28,14,13,10,"39",0,2,39,11,1,8,1037608,"2023-10-26T00:00:00.000Z",14,FALSE,24,140,"F",24,24,"Phoenix Suns","Kevin Durant",2,50,52,41,13,53.2
3,0,6,2,0,5,1,2,2,"28",3,5,4,9,3,4,1037608,"2023-10-26T00:00:00.000Z",14,FALSE,24,349,"C",24,24,"Phoenix Suns","Jusuf Nurkic",3,13,16,7,12,24.3
4,0,5,4,2,6,2,0,0,"35",1,3,6,6,0,0,1037608,"2023-10-26T00:00:00.000Z",14,FALSE,24,8,"G",24,24,"Phoenix Suns","Grayson Allen",0,12,16,10,10,19.2
0,0,1,8,2,16,6,1,1,"30",1,2,15,2,0,2,1037608,"2023-10-26T00:00:00.000Z",14,FALSE,24,178,"G",24,24,"Phoenix Suns","Eric Gordon",0,17,17,15,2,15.4
0,0,0,0,0,0,0,0,0,"00",0,0,0,0,0,0,1037608,"2023-10-26T00:00:00.000Z",14,FALSE,24,3547095,"C-F",24,24,"Phoenix Suns","Udoka Azubuike",0,0,0,0,0,0
0,0,0,0,0,0,0,0,0,"00",0,0,0,0,0,0,1037608,"2023-10-26T00:00:00.000Z",14,FALSE,24,32,"F",24,24,"Phoenix Suns","Keita Bates-Diop",0,0,0,0,0,0
0,0,0,0,0,0,0,0,0,"00",0,0,0,0,0,0,1037608,"2023-10-26T00:00:00.000Z",14,FALSE,24,666451,"C",24,24,"Phoenix Suns","Bol Bol",0,0,0,0,0,0
2,0,3,0,0,2,1,0,0,"17",1,3,2,4,0,2,1037608,"2023-10-26T00:00:00.000Z",14,FALSE,24,147,"F",24,24,"Phoenix Suns","Drew Eubanks",0,6,8,4,6,7.8
2,0,6,5,1,15,6,3,1,"30",0,2,14,6,2,1,1037608,"2023-10-26T00:00:00.000Z",14,FALSE,24,18678058,"",24,24,"Phoenix Suns","Jordan Goodwin",2,20,22,16,8,29.2
0,0,0,0,0,0,0,0,0,"00",0,0,0,0,0,0,1037608,"2023-10-26T00:00:00.000Z",14,FALSE,24,3547298,"G",24,24,"Phoenix Suns","Saben Lee",0,0,0,0,0,0
0,1,2,2,0,2,0,2,2,"13",0,0,2,2,1,1,1037608,"2023-10-26T00:00:00.000Z",14,FALSE,24,666729,"F",24,24,"Phoenix Suns","Nassir Little",2,4,4,2,2,9.4
0,0,0,0,0,0,0,0,0,"00",0,0,0,0,0,0,1037608,"2023-10-26T00:00:00.000Z",14,FALSE,24,314,"F",24,24,"Phoenix Suns","Chimezie Metu",0,0,0,0,0,0
0,0,1,1,1,2,1,0,0,"15",0,2,3,1,0,1,1037608,"2023-10-26T00:00:00.000Z",14,FALSE,24,470,"G",24,24,"Phoenix Suns","Yuta Watanabe",0,4,4,3,1,3.2
0,0,0,0,0,0,0,0,0,"00",0,0,0,0,0,0,1037608,"2023-10-26T00:00:00.000Z",14,FALSE,24,37,"G",24,24,"Phoenix Suns","Bradley Beal",0,0,0,0,0,0
0,0,0,0,0,0,0,0,0,"00",0,0,0,0,0,0,1037608,"2023-10-26T00:00:00.000Z",14,FALSE,24,57,"G",24,24,"Phoenix Suns","Devin Booker",0,0,0,0,0,0
0,0,0,0,0,0,0,0,0,"00",0,0,0,0,0,0,1037608,"2023-10-26T00:00:00.000Z",14,FALSE,24,272,"G",24,24,"Phoenix Suns","Damion Lee",0,0,0,0,0,0
4,0,8,4,2,15,6,6,5,"34",1,2,19,9,3,3,1037609,"2023-10-27T00:00:00.000Z",4,FALSE,9,204,"F",4,4,"Charlotte Hornets","Gordon Hayward",3,28,32,23,13,41.8
3,1,3,5,1,13,6,1,0,"29",0,6,13,3,2,2,1037609,"2023-10-27T00:00:00.000Z",4,FALSE,9,666950,"F",4,4,"Charlotte Hornets","P.J. Washington",3,16,19,16,6,28.1
1,1,1,0,0,4,1,0,0,"21",2,5,2,3,0,1,1037609,"2023-10-27T00:00:00.000Z",4,FALSE,9,38017698,"C",4,4,"Charlotte Hornets","Mark Williams",1,5,6,3,4,9.1
1,0,2,7,0,20,8,4,4,"35",1,0,20,3,1,2,1037609,"2023-10-27T00:00:00.000Z",4,FALSE,9,403,"G",4,4,"Charlotte Hornets","Terry Rozier",1,23,24,21,4,26.1
9,1,6,7,2,17,4,12,10,"33",3,1,20,9,2,4,1037609,"2023-10-27T00:00:00.000Z",4,FALSE,9,3547239,"G",4,4,"Charlotte Hornets","LaMelo Ball",3,29,38,29,18,49.3
0,0,0,0,0,0,0,0,0,"00",0,0,0,0,0,0,1037609,"2023-10-27T00:00:00.000Z",4,FALSE,9,56677848,"G",4,4,"Charlotte Hornets","Amari Bailey",0,0,0,0,0,0
0,0,0,0,0,0,0,0,0,"00",0,0,0,0,0,0,1037609,"2023-10-27T00:00:00.000Z",4,FALSE,9,56677866,"F",4,4,"Charlotte Hornets","Leaky Black",0,0,0,0,0,0
0,0,0,0,0,0,0,0,0,"00",0,0,0,0,0,0,1037609,"2023-10-27T00:00:00.000Z",4,FALSE,9,62,"F",4,4,"Charlotte Hornets","Miles Bridges",0,0,0,0,0,0
0,0,2,0,0,2,1,5,4,"14",0,0,6,2,2,1,1037609,"2023-10-27T00:00:00.000Z",4,FALSE,9,3547253,"G",4,4,"Charlotte Hornets","Theo Maledon",2,8,8,6,2,13.4
0,0,0,0,0,0,0,0,0,"00",0,0,0,0,0,0,1037609,"2023-10-27T00:00:00.000Z",4,FALSE,9,38017708,"G",4,4,"Charlotte Hornets","Bryce McGowens",0,0,0,0,0,0
2,1,4,4,2,13,6,4,3,"33",2,4,17,6,1,3,1037609,"2023-10-27T00:00:00.000Z",4,FALSE,9,56677823,"F",4,4,"Charlotte Hornets","Brandon Miller",2,23,25,19,8,30.2
0,0,0,0,0,0,0,0,0,"00",0,0,0,0,0,0,1037609,"2023-10-27T00:00:00.000Z",4,FALSE,9,347,"G",4,4,"Charlotte Hornets","Frank Ntilikina",0,0,0,0,0,0
0,2,1,0,0,1,0,2,0,"16",1,4,0,2,1,2,1037609,"2023-10-27T00:00:00.000Z",4,FALSE,9,3547282,"C",4,4,"Charlotte Hornets","Nick Richards",3,2,2,0,2,9.4
0,0,0,0,0,0,0,0,0,"00",0,0,0,0,0,0,1037609,"2023-10-27T00:00:00.000Z",4,FALSE,9,56677846,"G",4,4,"Charlotte Hornets","Nick Smith Jr.",0,0,0,0,0,0
0,1,3,1,0,3,1,0,0,"25",1,1,2,4,1,0,1037609,"2023-10-27T00:00:00.000Z",4,FALSE,9,18678001,"F",4,4,"Charlotte Hornets","JT Thor",2,6,6,2,4,12.8
0,0,0,0,0,0,0,0,0,"00",0,0,0,0,0,0,1037609,"2023-10-27T00:00:00.000Z",4,FALSE,9,17896037,"G",4,4,"Charlotte Hornets","James Bouknight",0,0,0,0,0,0
0,0,0,0,0,0,0,0,0,"00",0,0,0,0,0,0,1037609,"2023-10-27T00:00:00.000Z",4,FALSE,9,666748,"F",4,4,"Charlotte Hornets","Cody Martin",0,0,0,0,0,0
0,0,0,0,0,0,0,0,0,"00",0,0,0,0,0,0,1037609,"2023-10-27T00:00:00.000Z",4,FALSE,9,422,"G",4,4,"Charlotte Hornets","Ish Smith",0,0,0,0,0,0
1,1,6,4,2,10,6,2,1,"36",1,3,15,7,0,4,1037609,"2023-10-27T00:00:00.000Z",4,FALSE,9,3547267,"F-C",9,9,"Detroit Pistons","Isaiah Stewart",1,22,23,16,8,23.9
6,1,9,1,0,9,2,2,2,"30",3,5,6,12,0,3,1037609,"2023-10-27T00:00:00.000Z",4,FALSE,9,56677826,"G-F",9,9,"Detroit Pistons","Ausar Thompson",1,18,24,12,18,29.4
3,2,11,0,0,8,7,0,0,"35",6,3,14,17,2,5,1037609,"2023-10-27T00:00:00.000Z",4,FALSE,9,38017694,"C",9,9,"Detroit Pistons","Jalen Duren",4,31,34,17,20,45.9
1,0,4,1,0,9,5,5,4,"13",0,0,14,4,0,0,1037609,"2023-10-27T00:00:00.000Z",4,FALSE,9,24,"F",9,9,"Detroit Pistons","Marvin Bagley III",0,18,19,15,5,20.3
2,1,4,7,3,10,5,12,11,"31",0,1,24,4,1,0,1037609,"2023-10-27T00:00:00.000Z",4,FALSE,9,77,"G",9,9,"Detroit Pistons","Alec Burks",2,28,30,26,6,37.8
0,0,0,0,0,0,0,0,0,"00",0,0,0,0,0,0,1037609,"2023-10-27T00:00:00.000Z",4,FALSE,9,56677729,"G",9,9,"Detroit Pistons","Malcolm Cazalon",0,0,0,0,0,0
1,0,0,1,0,3,1,0,0,"11",0,2,2,0,1,0,1037609,"2023-10-27T00:00:00.000Z",4,FALSE,9,197,"F-G",9,9,"Detroit Pistons","Joe Harris",1,2,3,3,1,6.5
4,0,2,6,2,14,8,0,0,"23",0,4,18,2,1,2,1037609,"2023-10-27T00:00:00.000Z",4,FALSE,9,38017682,"G",9,9,"Detroit Pistons","Jaden Ivey",1,20,24,22,6,27.4
0,0,0,0,0,0,0,0,0,"00",0,0,0,0,0,0,1037609,"2023-10-27T00:00:00.000Z",4,FALSE,9,42097199,"G",9,9,"Detroit Pistons","Jared Rhoden",0,0,0,0,0,0
1,0,1,1,0,1,0,0,0,"08",0,1,0,1,0,1,1037609,"2023-10-27T00:00:00.000Z",4,FALSE,9,56677792,"G",9,9,"Detroit Pistons","Marcus Sasser",0,1,2,1,2,1.7
0,0,0,0,0,0,0,0,0,"00",0,0,0,0,0,0,1037609,"2023-10-27T00:00:00.000Z",4,FALSE,9,44477024,"G",9,9,"Detroit Pistons","Stanley Umude",0,0,0,0,0,0
0,0,0,0,0,0,0,0,0,"00",0,0,0,0,0,0,1037609,"2023-10-27T00:00:00.000Z",4,FALSE,9,3547240,"C",9,9,"Detroit Pistons","James Wiseman",0,0,0,0,0,0
0,0,0,0,0,0,0,0,0,"00",0,0,0,0,0,0,1037609,"2023-10-27T00:00:00.000Z",4,FALSE,9,54,"F",9,9,"Detroit Pistons","Bojan Bogdanovic",0,0,0,0,0,0
0,0,0,0,0,0,0,0,0,"00",0,0,0,0,0,0,1037609,"2023-10-27T00:00:00.000Z",4,FALSE,9,17896071,"F",9,9,"Detroit Pistons","Isaiah Livers",0,0,0,0,0,0
0,0,0,0,0,0,0,0,0,"00",0,0,0,0,0,0,1037609,"2023-10-27T00:00:00.000Z",4,FALSE,9,330,"G",9,9,"Detroit Pistons","Monte Morris",0,0,0,0,0,0
6,0,1,5,2,13,4,2,2,"24",1,6,12,2,1,5,1037609,"2023-10-27T00:00:00.000Z",4,FALSE,9,17896075,"G-F",9,9,"Detroit Pistons","Cade Cunningham",1,14,20,18,8,21.4
3,1,3,3,1,10,2,2,1,"29",0,4,6,3,1,3,1037609,"2023-10-27T00:00:00.000Z",4,FALSE,9,3547241,"G",9,9,"Detroit Pistons","Killian Hayes",2,9,12,9,6,17.1
3,0,7,3,0,10,3,5,5,"31",2,0,11,9,0,4,1037610,"2023-10-27T00:00:00.000Z",15,FALSE,8,17896027,"G-F",15,15,"Memphis Grizzlies","Ziaire Williams",0,20,23,14,12,22.3
2,3,7,2,2,12,9,2,1,"29",2,5,21,9,0,1,1037610,"2023-10-27T00:00:00.000Z",15,FALSE,8,231,"F-C",15,15,"Memphis Grizzlies","Jaren Jackson Jr.",3,30,32,23,11,42.8
2,2,6,3,1,9,5,4,2,"34",2,5,13,8,3,5,1037610,"2023-10-27T00:00:00.000Z",15,FALSE,8,3547285,"F",15,15,"Memphis Grizzlies","Xavier Tillman",5,21,23,15,10,35.6
3,0,2,10,1,17,4,6,6,"32",1,3,15,3,2,2,1037610,"2023-10-27T00:00:00.000Z",15,FALSE,8,3547287,"G",15,15,"Memphis Grizzlies","Desmond Bane",2,18,21,18,6,27.1
5,0,1,7,3,13,7,3,3,"31",1,3,20,2,5,2,1037610,"2023-10-27T00:00:00.000Z",15,FALSE,8,420,"G",15,15,"Memphis Grizzlies","Marcus Smart",5,22,27,25,7,42.9
0,0,0,0,0,0,0,0,0,"00",0,0,0,0,0,0,1037610,"2023-10-27T00:00:00.000Z",15,FALSE,8,48248287,"G",15,15,"Memphis Grizzlies","Jacob Gilyard",0,0,0,0,0,0
0,0,0,0,0,0,0,0,0,"00",0,0,0,0,0,0,1037610,"2023-10-27T00:00:00.000Z",15,FALSE,8,56677830,"F",15,15,"Memphis Grizzlies","GG Jackson",0,0,0,0,0,0
2,2,6,1,0,2,1,0,0,"30",0,1,2,6,1,0,1037610,"2023-10-27T00:00:00.000Z",15,FALSE,8,666703,"G-F",15,15,"Memphis Grizzlies","John Konchar",3,8,10,4,8,21.2
0,0,2,2,1,3,2,2,1,"16",3,1,6,5,0,2,1037610,"2023-10-27T00:00:00.000Z",15,FALSE,8,38017728,"F",15,15,"Memphis Grizzlies","Jake LaRavia",0,11,11,6,5,10
0,0,0,0,0,0,0,0,0,"00",0,0,0,0,0,0,1037610,"2023-10-27T00:00:00.000Z",15,FALSE,8,38017732,"F",15,15,"Memphis Grizzlies","Kenneth Lofton Jr.",0,0,0,0,0,0
0,0,0,0,0,0,0,0,0,"00",0,0,0,0,0,0,1037610,"2023-10-27T00:00:00.000Z",15,FALSE,8,666786,"G",15,15,"Memphis Grizzlies","Ja Morant",0,0,0,0,0,0
2,0,2,2,0,4,0,0,0,"15",0,3,0,2,1,2,1037610,"2023-10-27T00:00:00.000Z",15,FALSE,8,38017729,"F",15,15,"Memphis Grizzlies","David Roddy",1,2,4,2,4,6.4
3,0,2,3,2,14,6,2,2,"22",2,2,16,4,1,3,1037610,"2023-10-27T00:00:00.000Z",15,FALSE,8,401,"G",15,15,"Memphis Grizzlies","Derrick Rose",1,20,23,19,7,25.3
0,0,0,0,0,0,0,0,0,"00",0,0,0,0,0,0,1037610,"2023-10-27T00:00:00.000Z",15,FALSE,8,38017731,"G",15,15,"Memphis Grizzlies","Vince Williams Jr.",0,0,0,0,0,0
0,0,0,0,0,0,0,0,0,"00",0,0,0,0,0,0,1037610,"2023-10-27T00:00:00.000Z",15,FALSE,8,3,"C",15,15,"Memphis Grizzlies","Steven Adams",0,0,0,0,0,0
0,0,0,0,0,0,0,0,0,"00",0,0,0,0,0,0,1037610,"2023-10-27T00:00:00.000Z",15,FALSE,8,17896067,"F",15,15,"Memphis Grizzlies","Santi Aldama",0,0,0,0,0,0
0,0,0,0,0,0,0,0,0,"00",0,0,0,0,0,0,1037610,"2023-10-27T00:00:00.000Z",15,FALSE,8,666505,"F",15,15,"Memphis Grizzlies","Brandon Clarke",0,0,0,0,0,0
0,0,0,0,0,0,0,0,0,"00",0,0,0,0,0,0,1037610,"2023-10-27T00:00:00.000Z",15,FALSE,8,254,"G",15,15,"Memphis Grizzlies","Luke Kennard",0,0,0,0,0,0
2,0,12,5,2,7,3,1,1,"29",1,4,9,13,0,1,1037610,"2023-10-27T00:00:00.000Z",15,FALSE,8,375,"F",8,8,"Denver Nuggets","Michael Porter Jr.",0,22,24,11,15,26.6
3,1,1,1,0,11,5,1,0,"30",1,3,10,2,3,1,1037610,"2023-10-27T00:00:00.000Z",15,FALSE,8,177,"F",8,8,"Denver Nuggets","Aaron Gordon",4,12,15,13,5,27.9
7,1,9,4,1,14,8,6,5,"35",3,1,22,12,1,9,1037610,"2023-10-27T00:00:00.000Z",15,FALSE,8,246,"C",8,8,"Denver Nuggets","Nikola Jokic",2,34,41,29,19,43.9
2,1,2,6,2,10,3,0,0,"35",0,1,8,2,5,0,1037610,"2023-10-27T00:00:00.000Z",15,FALSE,8,81,"G",8,8,"Denver Nuggets","Kentavious Caldwell-Pope",6,10,12,10,4,31.4
5,1,1,9,4,17,7,4,4,"34",0,2,22,1,0,3,1037610,"2023-10-27T00:00:00.000Z",15,FALSE,8,335,"G",8,8,"Denver Nuggets","Jamal Murray",1,23,28,27,6,30.7
2,0,3,4,1,6,2,2,0,"19",1,1,5,4,1,1,1037610,"2023-10-27T00:00:00.000Z",15,FALSE,8,38017709,"G",8,8,"Denver Nuggets","Christian Braun",1,9,11,7,6,14.8
6,0,2,5,2,13,7,0,0,"22",0,0,16,2,0,0,1037610,"2023-10-27T00:00:00.000Z",15,FALSE,8,236,"G",8,8,"Denver Nuggets","Reggie Jackson",0,18,24,22,8,27.4
0,2,0,0,0,4,3,2,1,"13",0,1,7,0,1,1,1037610,"2023-10-27T00:00:00.000Z",15,FALSE,8,3547268,"F-C",8,8,"Denver Nuggets","Zeke Nnaji",3,7,7,7,0,15
0,0,0,0,0,2,0,0,0,"05",0,2,0,0,0,0,1037610,"2023-10-27T00:00:00.000Z",15,FALSE,8,56677776,"G",8,8,"Denver Nuggets","Julian Strawther",0,0,0,0,0,0
0,0,0,0,0,0,0,0,0,"00",0,0,0,0,0,0,1037610,"2023-10-27T00:00:00.000Z",15,FALSE,8,215,"F-G",8,8,"Denver Nuggets","Justin Holiday",0,0,0,0,0,0
0,0,0,0,0,0,0,0,0,"00",0,0,0,0,0,0,1037610,"2023-10-27T00:00:00.000Z",15,FALSE,8,250,"C",8,8,"Denver Nuggets","DeAndre Jordan",0,0,0,0,0,0
0,0,0,0,0,0,0,0,0,"00",0,0,0,0,0,0,1037610,"2023-10-27T00:00:00.000Z",15,FALSE,8,17896007,"G",8,8,"Denver Nuggets","Braxton Key",0,0,0,0,0,0
0,0,0,0,0,0,0,0,0,"00",0,0,0,0,0,0,1037610,"2023-10-27T00:00:00.000Z",15,FALSE,8,56677582,"G",8,8,"Denver Nuggets","Jalen Pickett",0,0,0,0,0,0
0,0,0,0,0,0,0,0,0,"00",0,0,0,0,0,0,1037610,"2023-10-27T00:00:00.000Z",15,FALSE,8,56677871,"F",8,8,"Denver Nuggets","Hunter Tyson",0,0,0,0,0,0
0,0,0,0,0,0,0,0,0,"00",0,0,0,0,0,0,1037610,"2023-10-27T00:00:00.000Z",15,FALSE,8,666489,"F",8,8,"Denver Nuggets","Vlatko Cancar",0,0,0,0,0,0
0,0,0,0,0,0,0,0,0,"00",0,0,0,0,0,0,1037610,"2023-10-27T00:00:00.000Z",15,FALSE,8,38017727,"G",8,8,"Denver Nuggets","Collin Gillespie",0,0,0,0,0,0
0,0,0,0,0,0,0,0,0,"00",0,0,0,0,0,0,1037610,"2023-10-27T00:00:00.000Z",15,FALSE,8,17896103,"F-C",8,8,"Denver Nuggets","Jay Huff",0,0,0,0,0,0
0,3,3,3,2,4,3,2,1,"18",0,3,9,3,1,1,1037610,"2023-10-27T00:00:00.000Z",15,FALSE,8,38017721,"G",8,8,"Denver Nuggets","Peyton Watson",4,12,12,9,3,23.6
1,1,6,7,3,13,8,8,8,"32",0,3,27,6,0,0,1037611,"2023-10-27T00:00:00.000Z",1,FALSE,20,666656,"F",1,1,"Atlanta Hawks","De'Andre Hunter",1,33,34,28,7,38.7
1,1,1,2,1,4,2,0,0,"26",0,2,5,1,0,1,1037611,"2023-10-27T00:00:00.000Z",1,FALSE,20,3547256,"F",1,1,"Atlanta Hawks","Saddiq Bey",1,6,7,6,2,9.7
2,1,7,0,0,12,6,2,1,"28",6,3,13,13,0,1,1037611,"2023-10-27T00:00:00.000Z",1,FALSE,20,83,"C",1,1,"Atlanta Hawks","Clint Capela",1,26,28,15,15,33.6
6,1,5,3,0,17,8,3,2,"35",2,1,18,7,1,1,1037611,"2023-10-27T00:00:00.000Z",1,FALSE,20,334,"G",1,1,"Atlanta Hawks","Dejounte Murray",2,25,31,24,13,40.4
12,0,2,5,2,16,4,10,8,"35",1,2,18,3,3,6,1037611,"2023-10-27T00:00:00.000Z",1,FALSE,20,490,"G",1,1,"Atlanta Hawks","Trae Young",3,21,33,30,15,42.6
3,0,1,9,4,11,6,0,0,"26",0,3,16,1,1,2,1037611,"2023-10-27T00:00:00.000Z",1,FALSE,20,53,"G",1,1,"Atlanta Hawks","Bogdan Bogdanovic",1,17,20,19,4,22.7
0,0,0,0,0,0,0,0,0,"00",0,0,0,0,0,0,1037611,"2023-10-27T00:00:00.000Z",1,FALSE,20,56677838,"G",1,1,"Atlanta Hawks","Kobe Bufkin",0,0,0,0,0,0
0,0,0,0,0,0,0,0,0,"00",0,0,0,0,0,0,1037611,"2023-10-27T00:00:00.000Z",1,FALSE,20,666564,"F",1,1,"Atlanta Hawks","Bruno Fernando",0,0,0,0,0,0
0,0,0,0,0,0,0,0,0,"00",0,0,0,0,0,0,1037611,"2023-10-27T00:00:00.000Z",1,FALSE,20,3547297,"G",1,1,"Atlanta Hawks","Trent Forrest",0,0,0,0,0,0
0,0,2,4,2,4,2,0,0,"08",0,0,6,2,0,0,1037611,"2023-10-27T00:00:00.000Z",1,FALSE,20,38017689,"F",1,1,"Atlanta Hawks","AJ Griffin",0,8,8,6,2,8.4
0,0,0,0,0,0,0,0,0,"00",0,0,0,0,0,0,1037611,"2023-10-27T00:00:00.000Z",1,FALSE,20,56677806,"F",1,1,"Atlanta Hawks","Mouhamed Gueye",0,0,0,0,0,0
2,1,9,2,0,8,5,3,1,"30",0,2,11,9,1,3,1037611,"2023-10-27T00:00:00.000Z",1,FALSE,20,17896040,"F",1,1,"Atlanta Hawks","Jalen Johnson",2,20,22,13,11,27.8
0,0,0,0,0,0,0,0,0,"00",0,0,0,0,0,0,1037611,"2023-10-27T00:00:00.000Z",1,FALSE,20,666754,"G",1,1,"Atlanta Hawks","Garrison Mathews",0,0,0,0,0,0
0,0,0,0,0,0,0,0,0,"00",0,0,0,0,0,0,1037611,"2023-10-27T00:00:00.000Z",1,FALSE,20,319,"G",1,1,"Atlanta Hawks","Patty Mills",0,0,0,0,0,0
1,1,2,0,0,2,1,4,4,"20",0,4,6,2,2,0,1037611,"2023-10-27T00:00:00.000Z",1,FALSE,20,3547244,"F-C",1,1,"Atlanta Hawks","Onyeka Okongwu",3,8,9,7,3,18.9
0,0,0,0,0,0,0,0,0,"00",0,0,0,0,0,0,1037611,"2023-10-27T00:00:00.000Z",1,FALSE,20,56677855,"G",1,1,"Atlanta Hawks","Seth Lundy",0,0,0,0,0,0
0,0,0,0,0,0,0,0,0,"00",0,0,0,0,0,0,1037611,"2023-10-27T00:00:00.000Z",1,FALSE,20,301,"G-F",1,1,"Atlanta Hawks","Wesley Matthews",0,0,0,0,0,0
0,0,0,0,0,0,0,0,0,"00",0,0,0,0,0,0,1037611,"2023-10-27T00:00:00.000Z",1,FALSE,20,56677875,"F",1,1,"Atlanta Hawks","Miles Norris",0,0,0,0,0,0
6,0,2,5,3,15,9,6,5,"34",1,2,26,3,1,3,1037611,"2023-10-27T00:00:00.000Z",1,FALSE,20,666423,"F-G",20,20,"New York Knicks","RJ Barrett",1,29,35,32,9,38.6
9,0,10,7,3,10,4,8,6,"34",2,3,17,12,0,3,1037611,"2023-10-27T00:00:00.000Z",1,FALSE,20,387,"F",20,20,"New York Knicks","Julius Randle",0,29,38,26,21,41.9
1,4,7,0,0,6,2,4,3,"38",6,1,7,13,4,1,1037611,"2023-10-27T00:00:00.000Z",1,FALSE,20,399,"C",20,20,"New York Knicks","Mitchell Robinson",8,20,21,8,14,47.1
1,0,0,5,2,6,2,0,0,"25",1,3,6,1,0,1,1037611,"2023-10-27T00:00:00.000Z",1,FALSE,20,17895858,"G",20,20,"New York Knicks","Quentin Grimes",0,7,8,7,2,7.7
5,0,3,12,8,21,11,2,1,"33",0,1,31,3,0,1,1037611,"2023-10-27T00:00:00.000Z",1,FALSE,20,73,"G",20,20,"New York Knicks","Jalen Brunson",0,34,39,36,8,41.1
0,0,0,0,0,0,0,0,0,"00",0,0,0,0,0,0,1037611,"2023-10-27T00:00:00.000Z",1,FALSE,20,19,"G",20,20,"New York Knicks","Ryan Arcidiacono",0,0,0,0,0,0
1,1,1,5,3,10,6,2,1,"20",1,2,16,2,1,2,1037611,"2023-10-27T00:00:00.000Z",1,FALSE,20,131,"G",20,20,"New York Knicks","Donte DiVincenzo",2,18,19,17,3,23.9
0,0,0,0,0,0,0,0,0,"00",0,0,0,0,0,0,1037611,"2023-10-27T00:00:00.000Z",1,FALSE,20,160,"G-F",20,20,"New York Knicks","Evan Fournier",0,0,0,0,0,0
0,0,3,1,0,4,2,0,0,"22",0,3,4,3,1,0,1037611,"2023-10-27T00:00:00.000Z",1,FALSE,20,202,"G",20,20,"New York Knicks","Josh Hart",1,7,7,4,3,10.6
1,1,1,0,0,4,3,4,2,"10",1,4,8,2,1,1,1037611,"2023-10-27T00:00:00.000Z",1,FALSE,20,201,"F-C",20,20,"New York Knicks","Isaiah Hartenstein",2,10,11,9,3,16.9
0,0,0,0,0,0,0,0,0,"00",0,0,0,0,0,0,1037611,"2023-10-27T00:00:00.000Z",1,FALSE,20,666675,"F",20,20,"New York Knicks","DaQuan Jeffries",0,0,0,0,0,0
0,0,0,0,0,0,0,0,0,"00",0,0,0,0,0,0,1037611,"2023-10-27T00:00:00.000Z",1,FALSE,20,17896033,"G",20,20,"New York Knicks","Miles McBride",0,0,0,0,0,0
6,0,6,9,1,14,4,2,2,"24",0,2,11,6,1,4,1037611,"2023-10-27T00:00:00.000Z",1,FALSE,20,3547269,"G",20,20,"New York Knicks","Immanuel Quickley",1,17,23,17,12,26.2
0,0,0,0,0,0,0,0,0,"00",0,0,0,0,0,0,1037611,"2023-10-27T00:00:00.000Z",1,FALSE,20,17896063,"F",20,20,"New York Knicks","Jericho Sims",0,0,0,0,0,0
0,0,0,0,0,0,0,0,0,"00",0,0,0,0,0,0,1037611,"2023-10-27T00:00:00.000Z",1,FALSE,20,666971,"G-F",20,20,"New York Knicks","Dylan Windler",0,0,0,0,0,0
0,0,0,0,0,0,0,0,0,"00",0,0,0,0,0,0,1037611,"2023-10-27T00:00:00.000Z",1,FALSE,20,666474,"G",20,20,"New York Knicks","Charles Brown",0,0,0,0,0,0
0,0,0,0,0,0,0,0,0,"00",0,0,0,0,0,0,1037611,"2023-10-27T00:00:00.000Z",1,FALSE,20,56677795,"F",20,20,"New York Knicks","Jacob Toppin",0,0,0,0,0,0
0,0,0,0,0,0,0,0,0,"00",0,0,0,0,0,0,1037611,"2023-10-27T00:00:00.000Z",1,FALSE,20,17896089,"G",20,20,"New York Knicks","Duane Washington Jr.",0,0,0,0,0,0
1,0,4,7,3,22,11,4,2,"34",2,1,27,6,2,4,1037612,"2023-10-27T00:00:00.000Z",2,FALSE,16,70,"G",2,2,"Boston Celtics","Jaylen Brown",2,33,34,28,7,37.7
5,0,8,10,3,22,9,3,1,"41",0,4,22,8,1,2,1037612,"2023-10-27T00:00:00.000Z",2,FALSE,16,434,"F",2,2,"Boston Celtics","Jayson Tatum",1,30,35,27,13,40.1
1,1,6,6,2,12,6,4,3,"30",3,6,17,9,3,1,1037612,"2023-10-27T00:00:00.000Z",2,FALSE,16,378,"F-C",2,2,"Boston Celtics","Kristaps Porzingis",4,26,27,18,10,40.3
3,3,3,7,5,15,9,6,5,"36",3,1,28,6,1,2,1037612,"2023-10-27T00:00:00.000Z",2,FALSE,16,473,"G",2,2,"Boston Celtics","Derrick White",4,34,37,31,9,49.7
7,1,8,4,1,13,7,2,2,"37",2,2,17,10,0,1,1037612,"2023-10-27T00:00:00.000Z",2,FALSE,16,214,"G",2,2,"Boston Celtics","Jrue Holiday",1,27,34,24,17,41.5
0,0,0,0,0,0,0,0,0,"00",0,0,0,0,0,0,1037612,"2023-10-27T00:00:00.000Z",2,FALSE,16,17896094,"G",2,2,"Boston Celtics","Dalano Banton",0,0,0,0,0,0
0,0,2,0,0,2,1,0,0,"14",3,1,2,5,0,2,1037612,"2023-10-27T00:00:00.000Z",2,FALSE,16,666468,"F",2,2,"Boston Celtics","Oshae Brissett",0,7,7,2,5,6
0,0,0,0,0,0,0,0,0,"00",0,0,0,0,0,0,1037612,"2023-10-27T00:00:00.000Z",2,FALSE,16,38017707,"G",2,2,"Boston Celtics","JD Davison",0,0,0,0,0,0
0,0,1,2,1,2,1,0,0,"10",0,1,3,1,0,0,1037612,"2023-10-27T00:00:00.000Z",2,FALSE,16,17896060,"F",2,2,"Boston Celtics","Sam Hauser",0,4,4,3,1,4.2
2,1,7,2,0,6,0,0,0,"25",3,1,0,10,0,3,1037612,"2023-10-27T00:00:00.000Z",2,FALSE,16,219,"C-F",2,2,"Boston Celtics","Al Horford",1,10,12,2,12,15
0,0,0,0,0,0,0,0,0,"00",0,0,0,0,0,0,1037612,"2023-10-27T00:00:00.000Z",2,FALSE,16,261,"F-C",2,2,"Boston Celtics","Luke Kornet",0,0,0,0,0,0
0,0,0,0,0,0,0,0,0,"00",0,0,0,0,0,0,1037612,"2023-10-27T00:00:00.000Z",2,FALSE,16,338,"G",2,2,"Boston Celtics","Svi Mykhailiuk",0,0,0,0,0,0
1,0,0,1,1,1,1,0,0,"13",0,2,3,0,0,0,1037612,"2023-10-27T00:00:00.000Z",2,FALSE,16,3547276,"G",2,2,"Boston Celtics","Payton Pritchard",0,3,4,4,1,4.5
0,0,0,0,0,0,0,0,0,"00",0,0,0,0,0,0,1037612,"2023-10-27T00:00:00.000Z",2,FALSE,16,3547279,"F",2,2,"Boston Celtics","Lamar Stevens",0,0,0,0,0,0
0,0,0,0,0,0,0,0,0,"00",0,0,0,0,0,0,1037612,"2023-10-27T00:00:00.000Z",2,FALSE,16,56677864,"G",2,2,"Boston Celtics","Jordan Walsh",0,0,0,0,0,0
0,0,0,0,0,0,0,0,0,"00",0,0,0,0,0,0,1037612,"2023-10-27T00:00:00.000Z",2,FALSE,16,3547295,"F-C",2,2,"Boston Celtics","Nathan Knight",0,0,0,0,0,0
0,0,0,0,0,0,0,0,0,"00",0,0,0,0,0,0,1037612,"2023-10-27T00:00:00.000Z",2,FALSE,16,17553967,"C",2,2,"Boston Celtics","Neemias Queta",0,0,0,0,0,0
3,1,3,0,0,11,3,9,8,"34",2,1,14,5,1,1,1037612,"2023-10-27T00:00:00.000Z",2,FALSE,16,79,"G-F",16,16,"Miami Heat","Jimmy Butler",2,19,22,17,8,29.5
2,0,7,4,2,7,3,2,1,"21",2,1,9,9,1,0,1037612,"2023-10-27T00:00:00.000Z",2,FALSE,16,285,"F-C",16,16,"Miami Heat","Kevin Love",1,18,20,11,11,25.8
2,2,4,0,0,24,10,9,7,"35",3,1,27,7,1,3,1037612,"2023-10-27T00:00:00.000Z",2,FALSE,16,4,"C-F",16,16,"Miami Heat","Bam Adebayo",3,34,36,29,9,44.4
6,0,5,12,5,19,10,3,3,"40",1,2,28,6,1,3,1037612,"2023-10-27T00:00:00.000Z",2,FALSE,16,666633,"G",16,16,"Miami Heat","Tyler Herro",1,34,40,34,12,44.2
5,1,7,4,3,7,5,0,0,"32",1,3,13,8,0,1,1037612,"2023-10-27T00:00:00.000Z",2,FALSE,16,286,"G",16,16,"Miami Heat","Kyle Lowry",1,21,26,18,13,32.1
1,1,3,1,0,5,1,0,0,"13",1,1,2,4,0,1,1037612,"2023-10-27T00:00:00.000Z",2,FALSE,16,74,"C",16,16,"Miami Heat","Thomas Bryant",1,6,7,3,5,10.3
0,0,1,1,0,1,0,0,0,"04",0,1,0,1,1,1,1037612,"2023-10-27T00:00:00.000Z",2,FALSE,16,38017734,"F",16,16,"Miami Heat","Jamal Cain",1,1,1,0,1,3.2
0,0,0,0,0,0,0,0,0,"00",0,0,0,0,0,0,1037612,"2023-10-27T00:00:00.000Z",2,FALSE,16,3547257,"G",16,16,"Miami Heat","R.J. Hampton",0,0,0,0,0,0
2,0,2,1,0,2,0,0,0,"14",0,2,0,2,0,1,1037612,"2023-10-27T00:00:00.000Z",2,FALSE,16,56677785,"G",16,16,"Miami Heat","Jaime Jaquez Jr.",0,2,4,2,4,4.4
0,0,0,0,0,0,0,0,0,"00",0,0,0,0,0,0,1037612,"2023-10-27T00:00:00.000Z",2,FALSE,16,38017696,"F",16,16,"Miami Heat","Nikola Jovic",0,0,0,0,0,0
0,0,0,0,0,0,0,0,0,"00",0,0,0,0,0,0,1037612,"2023-10-27T00:00:00.000Z",2,FALSE,16,666747,"F",16,16,"Miami Heat","Caleb Martin",0,0,0,0,0,0
0,0,1,6,3,7,3,0,0,"24",0,2,9,1,0,0,1037612,"2023-10-27T00:00:00.000Z",2,FALSE,16,397,"F",16,16,"Miami Heat","Duncan Robinson",0,10,10,9,1,10.2
0,0,0,0,0,0,0,0,0,"00",0,0,0,0,0,0,1037612,"2023-10-27T00:00:00.000Z",2,FALSE,16,39398582,"C",16,16,"Miami Heat","Orlando Robinson",0,0,0,0,0,0
3,1,1,4,3,6,3,0,0,"23",1,2,9,2,3,1,1037612,"2023-10-27T00:00:00.000Z",2,FALSE,16,19465585,"G",16,16,"Miami Heat","Dru Smith",4,11,14,12,5,26.9
0,0,0,0,0,0,0,0,0,"00",0,0,0,0,0,0,1037612,"2023-10-27T00:00:00.000Z",2,FALSE,16,3092,"",16,16,"Miami Heat","Haywood Highsmith",0,0,0,0,0,0
0,0,0,0,0,0,0,0,0,"00",0,0,0,0,0,0,1037612,"2023-10-27T00:00:00.000Z",2,FALSE,16,391,"G-F",16,16,"Miami Heat","Josh Richardson",0,0,0,0,0,0
0,0,0,0,0,0,0,0,0,"00",0,0,0,0,0,0,1037612,"2023-10-27T00:00:00.000Z",2,FALSE,16,38017736,"F",16,16,"Miami Heat","Cole Swider",0,0,0,0,0,0
2,1,3,3,1,8,3,4,3,"28",4,3,10,7,2,1,1037613,"2023-10-27T00:00:00.000Z",6,FALSE,21,3547247,"F-G",6,6,"Cleveland Cavaliers","Isaac Okoro",3,17,19,12,9,29.4
0,0,5,5,2,6,3,0,0,"27",0,3,8,5,2,1,1037613,"2023-10-27T00:00:00.000Z",6,FALSE,21,666940,"F",6,6,"Cleveland Cavaliers","Dean Wade",2,13,13,8,5,19
3,2,13,0,0,12,5,6,4,"34",2,4,14,15,0,2,1037613,"2023-10-27T00:00:00.000Z",6,FALSE,21,17896076,"F-C",6,6,"Cleveland Cavaliers","Evan Mobley",2,29,32,17,18,40.5
4,1,5,11,2,14,3,0,0,"38",0,1,8,5,2,2,1037613,"2023-10-27T00:00:00.000Z",6,FALSE,21,666908,"G",6,6,"Cleveland Cavaliers","Max Strus",3,13,17,12,9,27
5,2,7,11,4,27,15,11,9,"42",1,1,43,8,3,5,1037613,"2023-10-27T00:00:00.000Z",6,FALSE,21,322,"G",6,6,"Cleveland Cavaliers","Donovan Mitchell",5,51,56,48,13,70.1
0,0,0,0,0,0,0,0,0,"00",0,0,0,0,0,0,1037613,"2023-10-27T00:00:00.000Z",6,FALSE,21,56677847,"F",6,6,"Cleveland Cavaliers","Emoni Bates",0,0,0,0,0,0
3,0,0,1,0,3,1,0,0,"09",1,1,2,1,0,1,1037613,"2023-10-27T00:00:00.000Z",6,FALSE,21,666676,"G",6,6,"Cleveland Cavaliers","Ty Jerome",0,3,6,5,4,6.7
0,1,3,0,0,0,0,2,1,"10",0,0,1,3,0,0,1037613,"2023-10-27T00:00:00.000Z",6,FALSE,21,248,"C",6,6,"Cleveland Cavaliers","Damian Jones",1,4,4,1,3,7.6
2,1,2,9,3,16,7,0,0,"31",0,1,17,2,1,1,1037613,"2023-10-27T00:00:00.000Z",6,FALSE,21,277,"G",6,6,"Cleveland Cavaliers","Caris LeVert",2,19,21,19,4,27.4
0,0,0,0,0,0,0,0,0,"00",0,0,0,0,0,0,1037613,"2023-10-27T00:00:00.000Z",6,FALSE,21,3547299,"G",6,6,"Cleveland Cavaliers","Sam Merrill",0,0,0,0,0,0
0,0,0,0,0,0,0,0,0,"00",0,0,0,0,0,0,1037613,"2023-10-27T00:00:00.000Z",6,FALSE,21,38017662,"F",6,6,"Cleveland Cavaliers","Isaiah Mobley",0,0,0,0,0,0
1,0,2,5,0,6,1,0,0,"21",0,2,2,2,0,0,1037613,"2023-10-27T00:00:00.000Z",6,FALSE,21,344,"F",6,6,"Cleveland Cavaliers","Georges Niang",0,4,5,3,3,5.9
0,0,0,0,0,0,0,0,0,"00",0,0,0,0,0,0,1037613,"2023-10-27T00:00:00.000Z",6,FALSE,21,56677872,"G",6,6,"Cleveland Cavaliers","Craig Porter",0,0,0,0,0,0
0,0,0,0,0,0,0,0,0,"00",0,0,0,0,0,0,1037613,"2023-10-27T00:00:00.000Z",6,FALSE,21,444,"C-F",6,6,"Cleveland Cavaliers","Tristan Thompson",0,0,0,0,0,0
0,0,0,0,0,0,0,0,0,"00",0,0,0,0,0,0,1037613,"2023-10-27T00:00:00.000Z",6,FALSE,21,9,"C",6,6,"Cleveland Cavaliers","Jarrett Allen",0,0,0,0,0,0
0,0,0,0,0,0,0,0,0,"00",0,0,0,0,0,0,1037613,"2023-10-27T00:00:00.000Z",6,FALSE,21,666581,"G",6,6,"Cleveland Cavaliers","Darius Garland",0,0,0,0,0,0
0,0,0,0,0,0,0,0,0,"00",0,0,0,0,0,0,1037613,"2023-10-27T00:00:00.000Z",6,FALSE,21,404,"G",6,6,"Cleveland Cavaliers","Ricky Rubio",0,0,0,0,0,0
2,0,5,4,2,14,4,4,4,"35",0,2,14,5,1,4,1037613,"2023-10-27T00:00:00.000Z",6,FALSE,21,38017703,"G-F",21,21,"Oklahoma City Thunder","Jalen Williams",1,19,21,16,7,22
2,1,3,4,3,13,9,6,4,"39",3,5,25,6,1,1,1037613,"2023-10-27T00:00:00.000Z",6,FALSE,21,666541,"G",21,21,"Oklahoma City Thunder","Luguentz Dort",2,31,33,27,8,40.2
2,7,12,4,3,9,5,4,3,"31",1,3,16,13,1,1,1037613,"2023-10-27T00:00:00.000Z",6,FALSE,21,38017685,"C-F",21,21,"Oklahoma City Thunder","Chet Holmgren",8,29,31,18,15,57.6
6,0,6,1,0,8,1,0,0,"28",0,1,2,6,0,3,1037613,"2023-10-27T00:00:00.000Z",6,FALSE,21,17896065,"G",21,21,"Oklahoma City Thunder","Josh Giddey",0,8,14,8,12,15.2
0,0,0,0,0,0,0,0,0,"00",0,0,0,0,0,0,1037613,"2023-10-27T00:00:00.000Z",6,FALSE,21,44,"F",21,21,"Oklahoma City Thunder","Davis Bertans",0,0,0,0,0,0
2,0,3,7,1,10,2,1,0,"22",0,1,5,3,0,1,1037613,"2023-10-27T00:00:00.000Z",6,FALSE,21,3547272,"G",21,21,"Oklahoma City Thunder","Isaiah Joe",0,8,10,7,5,10.6
0,0,0,0,0,0,0,0,0,"00",0,0,0,0,0,0,1037613,"2023-10-27T00:00:00.000Z",6,FALSE,21,17896036,"G",21,21,"Oklahoma City Thunder","Tre Mann",0,0,0,0,0,0
1,0,0,1,1,1,1,0,0,"06",0,0,3,0,0,2,1037613,"2023-10-27T00:00:00.000Z",6,FALSE,21,4197029,"G",21,21,"Oklahoma City Thunder","Vasilije Micic",0,3,4,4,1,2.5
0,0,0,0,0,0,0,0,0,"00",0,0,0,0,0,0,1037613,"2023-10-27T00:00:00.000Z",6,FALSE,21,3547271,"C",21,21,"Oklahoma City Thunder","Aleksej Pokusevski",0,0,0,0,0,0
0,0,0,0,0,0,0,0,0,"00",0,0,0,0,0,0,1037613,"2023-10-27T00:00:00.000Z",6,FALSE,21,24572055,"C",21,21,"Oklahoma City Thunder","Olivier Sarr",0,0,0,0,0,0
0,0,1,1,1,4,3,2,2,"19",1,0,9,2,0,0,1037613,"2023-10-27T00:00:00.000Z",6,FALSE,21,56677833,"G",21,21,"Oklahoma City Thunder","Cason Wallace",0,11,11,9,2,11.4
0,0,0,0,0,0,0,0,0,"01",0,0,0,0,0,0,1037613,"2023-10-27T00:00:00.000Z",6,FALSE,21,27924547,"F",21,21,"Oklahoma City Thunder","Lindy Waters III",0,0,0,0,0,0
1,1,0,0,0,0,0,0,0,"12",0,0,0,0,0,1,1037613,"2023-10-27T00:00:00.000Z",6,FALSE,21,17896078,"G",21,21,"Oklahoma City Thunder","Aaron Wiggins",1,0,1,1,1,3.5
0,0,0,0,0,0,0,0,0,"00",0,0,0,0,0,0,1037613,"2023-10-27T00:00:00.000Z",6,FALSE,21,56677853,"F",21,21,"Oklahoma City Thunder","Keyontae Johnson",0,0,0,0,0,0
0,0,0,0,0,0,0,0,0,"00",0,0,0,0,0,0,1037613,"2023-10-27T00:00:00.000Z",6,FALSE,21,38017706,"F",21,21,"Oklahoma City Thunder","Jaylin Williams",0,0,0,0,0,0
0,0,0,0,0,0,0,0,0,"00",0,0,0,0,0,0,1037613,"2023-10-27T00:00:00.000Z",6,FALSE,21,480,"G-F",21,21,"Oklahoma City Thunder","Kenrich Williams",0,0,0,0,0,0
4,1,10,2,2,26,15,2,2,"36",1,2,34,11,5,5,1037613,"2023-10-27T00:00:00.000Z",6,FALSE,21,175,"G",21,21,"Oklahoma City Thunder","Shai Gilgeous-Alexander",6,45,49,38,15,66.2
2,0,1,2,0,2,0,0,0,"11",0,3,0,1,0,0,1037613,"2023-10-27T00:00:00.000Z",6,FALSE,21,38017716,"F",21,21,"Oklahoma City Thunder","Ousmane Dieng",0,1,3,2,3,4.2
3,1,3,3,1,22,11,14,10,"41",1,2,33,4,4,2,1037614,"2023-10-27T00:00:00.000Z",5,FALSE,28,125,"G",5,5,"Chicago Bulls","DeMar DeRozan",5,37,40,36,7,55.3
1,0,3,4,1,5,1,0,0,"13",0,3,3,3,2,2,1037614,"2023-10-27T00:00:00.000Z",5,FALSE,28,3547248,"F",5,5,"Chicago Bulls","Patrick Williams",2,6,7,4,4,12.1
1,1,9,5,1,15,4,3,2,"41",3,2,11,12,0,3,1037614,"2023-10-27T00:00:00.000Z",5,FALSE,28,460,"C",5,5,"Chicago Bulls","Nikola Vucevic",1,23,24,12,13,26.9
1,0,5,6,0,14,3,2,2,"38",0,3,8,5,0,3,1037614,"2023-10-27T00:00:00.000Z",5,FALSE,28,268,"G",5,5,"Chicago Bulls","Zach LaVine",0,13,14,9,6,12.5
8,0,6,9,2,15,5,5,5,"40",0,2,17,6,1,3,1037614,"2023-10-27T00:00:00.000Z",5,FALSE,28,666956,"G",5,5,"Chicago Bulls","Coby White",1,23,31,25,14,36.2
2,1,7,5,2,9,5,2,1,"32",6,5,13,13,2,0,1037614,"2023-10-27T00:00:00.000Z",5,FALSE,28,89,"G",5,5,"Chicago Bulls","Alex Caruso",3,26,28,15,15,40.6
0,1,2,4,1,7,3,0,0,"24",3,2,7,5,1,0,1037614,"2023-10-27T00:00:00.000Z",5,FALSE,28,110,"F",5,5,"Chicago Bulls","Torrey Craig",2,12,12,7,5,19
0,0,1,1,0,4,2,0,0,"11",0,0,4,1,0,0,1037614,"2023-10-27T00:00:00.000Z",5,FALSE,28,17895983,"G",5,5,"Chicago Bulls","Ayo Dosunmu",0,5,5,4,1,5.2
0,0,0,0,0,6,3,2,2,"12",2,2,8,2,0,2,1037614,"2023-10-27T00:00:00.000Z",5,FALSE,28,137,"C",5,5,"Chicago Bulls","Andre Drummond",0,10,10,8,2,8.4
0,0,0,0,0,0,0,0,0,"00",0,0,0,0,0,0,1037614,"2023-10-27T00:00:00.000Z",5,FALSE,28,56677857,"F",5,5,"Chicago Bulls","Julian Phillips",0,0,0,0,0,0
0,0,0,0,0,0,0,0,0,"00",0,0,0,0,0,0,1037614,"2023-10-27T00:00:00.000Z",5,FALSE,28,17896116,"G",5,5,"Chicago Bulls","Terry Taylor",0,0,0,0,0,0
0,0,0,0,0,0,0,0,0,"00",0,0,0,0,0,0,1037614,"2023-10-27T00:00:00.000Z",5,FALSE,28,38017719,"F",5,5,"Chicago Bulls","Dalen Terry",0,0,0,0,0,0
0,0,0,0,0,0,0,0,0,"00",0,0,0,0,0,0,1037614,"2023-10-27T00:00:00.000Z",5,FALSE,28,27,"G",5,5,"Chicago Bulls","Lonzo Ball",0,0,0,0,0,0
0,0,0,0,0,0,0,0,0,"00",0,0,0,0,0,0,1037614,"2023-10-27T00:00:00.000Z",5,FALSE,28,56677874,"F",5,5,"Chicago Bulls","Onuralp Bitim",0,0,0,0,0,0
0,0,0,0,0,0,0,0,0,"00",0,0,0,0,0,0,1037614,"2023-10-27T00:00:00.000Z",5,FALSE,28,45969255,"F",5,5,"Chicago Bulls","Justin Lewis",0,0,0,0,0,0
0,0,0,0,0,0,0,0,0,"00",0,0,0,0,0,0,1037614,"2023-10-27T00:00:00.000Z",5,FALSE,28,56677860,"F",5,5,"Chicago Bulls","Adama Sanogo",0,0,0,0,0,0
10,2,9,2,1,14,9,4,3,"38",1,5,22,10,0,7,1037614,"2023-10-27T00:00:00.000Z",5,FALSE,28,17896055,"G-F",28,28,"Toronto Raptors","Scottie Barnes",2,32,42,32,20,48
2,0,7,5,1,15,7,5,3,"41",1,4,18,8,0,3,1037614,"2023-10-27T00:00:00.000Z",5,FALSE,28,416,"F",28,28,"Toronto Raptors","Pascal Siakam",0,26,28,20,10,27.6
0,0,6,0,0,5,4,0,0,"19",0,6,8,6,0,3,1037614,"2023-10-27T00:00:00.000Z",5,FALSE,28,373,"C",28,28,"Toronto Raptors","Jakob Poeltl",0,14,14,8,6,12.2
0,0,3,4,1,8,5,1,0,"28",0,2,11,3,2,1,1037614,"2023-10-27T00:00:00.000Z",5,FALSE,28,18,"F",28,28,"Toronto Raptors","OG Anunoby",2,14,14,11,3,19.6
1,0,3,10,3,14,6,4,1,"36",2,1,16,5,2,1,1037614,"2023-10-27T00:00:00.000Z",5,FALSE,28,3089,"",28,28,"Toronto Raptors","Gary Trent Jr.",2,21,22,17,6,28.5
10,0,2,5,2,11,3,3,2,"35",0,1,10,2,0,2,1037614,"2023-10-27T00:00:00.000Z",5,FALSE,28,409,"G",28,28,"Toronto Raptors","Dennis Schroder",0,12,22,20,12,25.4
2,0,1,2,0,2,0,0,0,"13",0,1,0,1,0,1,1037614,"2023-10-27T00:00:00.000Z",5,FALSE,28,87,"G",5,5,"Chicago Bulls","Jevon Carter",0,1,3,2,3,3.2
1,0,2,4,0,4,0,0,0,"18",1,1,0,3,1,0,1037614,"2023-10-27T00:00:00.000Z",5,FALSE,28,666762,"F",28,28,"Toronto Raptors","Jalen McDaniels",1,3,4,1,4,8.1
0,0,0,1,0,1,0,0,0,"04",0,0,0,0,0,0,1037614,"2023-10-27T00:00:00.000Z",5,FALSE,28,3547275,"G",28,28,"Toronto Raptors","Malachi Flynn",0,0,0,0,0,0
1,0,7,3,1,5,2,3,3,"23",2,6,8,9,0,3,1037614,"2023-10-27T00:00:00.000Z",5,FALSE,28,3547249,"F",28,28,"Toronto Raptors","Precious Achiuwa",0,17,18,9,10,17.3
0,0,1,2,0,2,0,0,0,"06",0,0,0,1,0,0,1037614,"2023-10-27T00:00:00.000Z",5,FALSE,28,56677828,"G",28,28,"Toronto Raptors","Gradey Dick",0,1,1,0,1,1.2
0,0,5,0,0,4,3,5,4,"17",1,3,10,6,0,1,1037614,"2023-10-27T00:00:00.000Z",5,FALSE,28,58,"F",28,28,"Toronto Raptors","Chris Boucher",0,16,16,10,6,16.2
0,0,0,0,0,0,0,0,0,"00",0,0,0,0,0,0,1037614,"2023-10-27T00:00:00.000Z",5,FALSE,28,376,"F",28,28,"Toronto Raptors","Otto Porter Jr.",0,0,0,0,0,0
0,0,0,0,0,0,0,0,0,"00",0,0,0,0,0,0,1037614,"2023-10-27T00:00:00.000Z",5,FALSE,28,436,"G-F",28,28,"Toronto Raptors","Garrett Temple",0,0,0,0,0,0
0,0,0,0,0,0,0,0,0,"00",0,0,0,0,0,0,1037614,"2023-10-27T00:00:00.000Z",5,FALSE,28,489,"F",28,28,"Toronto Raptors","Thaddeus Young",0,0,0,0,0,0
0,0,0,0,0,0,0,0,0,"00",0,0,0,0,0,0,1037614,"2023-10-27T00:00:00.000Z",5,FALSE,28,56677805,"G",28,28,"Toronto Raptors","Javon Freeman-Liberty",0,0,0,0,0,0
0,0,0,0,0,0,0,0,0,"00",0,0,0,0,0,0,1037614,"2023-10-27T00:00:00.000Z",5,FALSE,28,38017717,"F",28,28,"Toronto Raptors","Ron Harper Jr.",0,0,0,0,0,0
0,0,0,0,0,0,0,0,0,"00",0,0,0,0,0,0,1037614,"2023-10-27T00:00:00.000Z",5,FALSE,28,38017710,"C",28,28,"Toronto Raptors","Christian Koloko",0,0,0,0,0,0
0,0,0,0,0,0,0,0,0,"00",0,0,0,0,0,0,1037614,"2023-10-27T00:00:00.000Z",5,FALSE,28,56677869,"G",28,28,"Toronto Raptors","Markquis Nowell",0,0,0,0,0,0
0,0,0,0,0,0,0,0,0,"00",0,0,0,0,0,0,1037615,"2023-10-27T00:00:00.000Z",27,FALSE,11,17896059,"F",27,27,"San Antonio Spurs","Sandro Mamukelashvili",0,0,0,0,0,0
0,0,0,4,2,5,3,0,0,"16",0,0,8,0,0,0,1037615,"2023-10-27T00:00:00.000Z",27,FALSE,11,305,"F",27,27,"San Antonio Spurs","Doug McDermott",0,8,8,8,0,8
1,0,0,0,0,2,2,0,0,"07",0,1,4,0,0,0,1037615,"2023-10-27T00:00:00.000Z",27,FALSE,11,296,"C",11,11,"Houston Rockets","Boban Marjanovic",0,4,5,5,1,5.5
0,0,0,0,0,0,0,0,0,"00",0,0,0,0,0,0,1037615,"2023-10-27T00:00:00.000Z",27,FALSE,11,56677809,"F",11,11,"Houston Rockets","Jermaine Samuels Jr.",0,0,0,0,0,0
0,0,0,1,0,2,1,1,1,"14",0,1,3,0,3,1,1037615,"2023-10-27T00:00:00.000Z",27,FALSE,11,3547301,"F",11,11,"Houston Rockets","Jae'Sean Tate",3,3,3,3,0,11
3,1,1,1,0,4,2,2,0,"13",0,1,4,1,0,1,1037615,"2023-10-27T00:00:00.000Z",27,FALSE,11,56677825,"G-F",11,11,"Houston Rockets","Amen Thompson",1,5,8,7,4,11.7
0,0,0,0,0,0,0,0,0,"00",0,0,0,0,0,0,1037615,"2023-10-27T00:00:00.000Z",27,FALSE,11,56677831,"F",11,11,"Houston Rockets","Cam Whitmore",0,0,0,0,0,0
4,1,2,7,3,14,8,2,1,"35",2,5,20,4,0,3,1037615,"2023-10-27T00:00:00.000Z",27,FALSE,11,666682,"F",27,27,"San Antonio Spurs","Keldon Johnson",1,24,28,24,8,30.8
1,3,7,6,0,19,7,8,7,"31",5,2,21,12,2,4,1037615,"2023-10-27T00:00:00.000Z",27,FALSE,11,56677822,"F-C",27,27,"San Antonio Spurs","Victor Wembanyama",5,33,34,22,13,47.9
8,0,6,7,0,12,4,3,1,"39",0,5,9,6,4,4,1037615,"2023-10-27T00:00:00.000Z",27,FALSE,11,102,"F-C",27,27,"San Antonio Spurs","Zach Collins",4,15,23,17,14,36.2
2,0,3,7,3,13,7,11,8,"40",0,0,25,3,0,1,1037615,"2023-10-27T00:00:00.000Z",27,FALSE,11,3547246,"G-F",27,27,"San Antonio Spurs","Devin Vassell",0,28,30,27,5,30.6
4,0,4,1,0,9,5,4,4,"26",1,3,14,5,2,2,1037615,"2023-10-27T00:00:00.000Z",27,FALSE,11,38017699,"F",27,27,"San Antonio Spurs","Jeremy Sochan",2,19,23,18,9,30
0,0,0,0,0,0,0,0,0,"00",0,0,0,0,0,0,1037615,"2023-10-27T00:00:00.000Z",27,FALSE,11,38017730,"F",27,27,"San Antonio Spurs","Dominick Barlow",0,0,0,0,0,0
0,0,2,0,0,0,0,0,0,"08",1,1,0,3,0,0,1037615,"2023-10-27T00:00:00.000Z",27,FALSE,11,17895854,"G",27,27,"San Antonio Spurs","Charles Bassey",0,3,3,0,3,3.6
4,0,2,1,1,7,4,0,0,"14",0,0,9,2,0,1,1037615,"2023-10-27T00:00:00.000Z",27,FALSE,11,38017692,"F",27,27,"San Antonio Spurs","Malaki Branham",0,11,15,13,6,16.4
0,0,0,0,0,0,0,0,0,"00",0,0,0,0,0,0,1037615,"2023-10-27T00:00:00.000Z",27,FALSE,11,38017649,"F",27,27,"San Antonio Spurs","Julian Champagnie",0,0,0,0,0,0
0,0,0,0,0,0,0,0,0,"00",0,0,0,0,0,0,1037615,"2023-10-27T00:00:00.000Z",27,FALSE,11,180,"G",27,27,"San Antonio Spurs","Devonte' Graham",0,0,0,0,0,0
8,0,3,3,0,8,3,0,0,"33",3,0,6,6,3,0,1037615,"2023-10-27T00:00:00.000Z",27,FALSE,11,3547274,"G",27,27,"San Antonio Spurs","Tre Jones",3,12,20,14,14,34.2
1,0,2,6,4,7,5,0,0,"23",0,1,14,2,0,3,1037615,"2023-10-27T00:00:00.000Z",27,FALSE,11,359,"F",27,27,"San Antonio Spurs","Cedi Osman",0,16,17,15,3,14.9
0,0,0,0,0,0,0,0,0,"00",0,0,0,0,0,0,1037615,"2023-10-27T00:00:00.000Z",27,FALSE,11,38017693,"G",27,27,"San Antonio Spurs","Blake Wesley",0,0,0,0,0,0
0,0,0,0,0,0,0,0,0,"00",0,0,0,0,0,0,1037615,"2023-10-27T00:00:00.000Z",27,FALSE,11,56677865,"C",27,27,"San Antonio Spurs","Charles Bediako",0,0,0,0,0,0
0,0,0,0,0,0,0,0,0,"00",0,0,0,0,0,0,1037615,"2023-10-27T00:00:00.000Z",27,FALSE,11,56677817,"G",27,27,"San Antonio Spurs","Sidy Cissoko",0,0,0,0,0,0
0,0,0,0,0,0,0,0,0,"00",0,0,0,0,0,0,1037615,"2023-10-27T00:00:00.000Z",27,FALSE,11,56677870,"G",27,27,"San Antonio Spurs","Sir'Jabari Rice",0,0,0,0,0,0
2,0,2,2,1,13,7,2,2,"39",0,4,17,2,1,2,1037615,"2023-10-27T00:00:00.000Z",27,FALSE,11,66,"G-F",11,11,"Houston Rockets","Dillon Brooks",1,19,21,19,4,23.4
0,0,5,8,2,16,5,4,1,"37",4,4,13,9,1,2,1037615,"2023-10-27T00:00:00.000Z",27,FALSE,11,38017684,"F",11,11,"Houston Rockets","Jabari Smith Jr.",1,22,22,13,9,24.8
7,1,8,3,1,18,11,6,2,"41",6,6,25,14,2,6,1037615,"2023-10-27T00:00:00.000Z",27,FALSE,11,17896062,"F-C",11,11,"Houston Rockets","Alperen Sengun",3,39,46,32,21,55.3
0,0,3,1,0,1,0,0,0,"11",0,1,0,3,0,1,1037615,"2023-10-27T00:00:00.000Z",27,FALSE,11,75,"G-F",11,11,"Houston Rockets","Reggie Bullock",0,3,3,0,3,2.6
1,0,1,0,0,4,4,2,2,"21",0,1,10,1,0,0,1037615,"2023-10-27T00:00:00.000Z",27,FALSE,11,188,"F",11,11,"Houston Rockets","Jeff Green",0,11,12,11,2,12.7
0,0,0,0,0,0,0,0,0,"00",0,0,0,0,0,0,1037615,"2023-10-27T00:00:00.000Z",27,FALSE,11,213,"G",11,11,"Houston Rockets","Aaron Holiday",0,0,0,0,0,0
4,0,4,6,2,20,10,0,0,"38",1,2,22,5,0,2,1037615,"2023-10-27T00:00:00.000Z",27,FALSE,11,17895966,"G",11,11,"Houston Rockets","Jalen Green",0,27,31,26,9,32
12,0,8,10,2,20,10,3,2,"44",0,5,24,8,0,3,1037615,"2023-10-27T00:00:00.000Z",27,FALSE,11,458,"G",11,11,"Houston Rockets","Fred VanVleet",0,32,44,36,20,48.6
0,0,0,0,0,0,0,0,0,"00",0,0,0,0,0,0,1037615,"2023-10-27T00:00:00.000Z",27,FALSE,11,47738533,"G",11,11,"Houston Rockets","Jeenathan Williams",0,0,0,0,0,0
0,0,0,0,0,0,0,0,0,"00",0,0,0,0,0,0,1037615,"2023-10-27T00:00:00.000Z",27,FALSE,11,38017695,"F",11,11,"Houston Rockets","Tari Eason",0,0,0,0,0,0
0,0,0,0,0,0,0,0,0,"00",0,0,0,0,0,0,1037615,"2023-10-27T00:00:00.000Z",27,FALSE,11,3547281,"G-F",11,11,"Houston Rockets","Nate Hinton",0,0,0,0,0,0
0,0,0,0,0,0,0,0,0,"00",0,0,0,0,0,0,1037615,"2023-10-27T00:00:00.000Z",27,FALSE,11,19465326,"C",11,11,"Houston Rockets","Jock Landale",0,0,0,0,0,0
0,0,0,0,0,0,0,0,0,"00",0,0,0,0,0,0,1037615,"2023-10-27T00:00:00.000Z",27,FALSE,11,357,"G",11,11,"Houston Rockets","Victor Oladipo",0,0,0,0,0,0
1,0,1,2,0,5,2,0,0,"14",0,1,4,1,0,1,1037616,"2023-10-27T00:00:00.000Z",7,FALSE,3,247,"F-G",7,7,"Dallas Mavericks","Derrick Jones Jr.",0,5,6,5,2,5.7
0,0,6,4,1,6,2,0,0,"29",0,5,5,6,0,2,1037616,"2023-10-27T00:00:00.000Z",7,FALSE,3,666965,"F",7,7,"Dallas Mavericks","Grant Williams",0,11,11,5,6,10.2
0,1,1,0,0,4,4,2,1,"17",1,0,9,2,0,1,1037616,"2023-10-27T00:00:00.000Z",7,FALSE,3,56677840,"C",7,7,"Dallas Mavericks","Dereck Lively II",1,11,11,9,2,13.4
6,0,6,4,1,17,6,4,4,"34",1,2,17,7,0,0,1037616,"2023-10-27T00:00:00.000Z",7,FALSE,3,228,"G",7,7,"Dallas Mavericks","Kyrie Irving",0,24,30,23,13,34.4
7,0,9,14,9,25,16,10,8,"36",1,1,49,10,0,0,1037616,"2023-10-27T00:00:00.000Z",7,FALSE,3,132,"F-G",7,7,"Dallas Mavericks","Luka Doncic",0,59,66,56,17,71.5
1,0,0,0,0,1,1,0,0,"09",0,1,2,0,0,1,1037616,"2023-10-27T00:00:00.000Z",7,FALSE,3,114,"G",7,7,"Dallas Mavericks","Seth Curry",0,2,3,3,1,2.5
0,1,0,1,0,2,1,0,0,"04",0,0,2,0,1,0,1037616,"2023-10-27T00:00:00.000Z",7,FALSE,3,151,"G",7,7,"Dallas Mavericks","Dante Exum",2,2,2,2,0,8
2,0,2,3,0,7,2,6,3,"28",1,2,7,3,3,3,1037616,"2023-10-27T00:00:00.000Z",7,FALSE,3,3547258,"G",7,7,"Dallas Mavericks","Josh Green",3,10,12,9,5,19.6
1,0,3,7,3,17,6,4,4,"30",1,2,19,4,0,1,1037616,"2023-10-27T00:00:00.000Z",7,FALSE,3,191,"G",7,7,"Dallas Mavericks","Tim Hardaway Jr.",0,23,24,20,5,24.3
0,0,0,0,0,0,0,0,0,"00",0,0,0,0,0,0,1037616,"2023-10-27T00:00:00.000Z",7,FALSE,3,38017679,"G",7,7,"Dallas Mavericks","Jaden Hardy",0,0,0,0,0,0
0,0,0,0,0,0,0,0,0,"00",0,0,0,0,0,0,1037616,"2023-10-27T00:00:00.000Z",7,FALSE,3,217,"F-C",7,7,"Dallas Mavericks","Richaun Holmes",0,0,0,0,0,0
2,0,4,0,0,3,0,0,0,"26",1,1,0,5,0,0,1037616,"2023-10-27T00:00:00.000Z",7,FALSE,3,257,"F",7,7,"Dallas Mavericks","Maxi Kleber",0,5,7,2,7,9
0,0,2,0,0,2,1,0,0,"03",2,1,2,4,1,2,1037616,"2023-10-27T00:00:00.000Z",7,FALSE,3,17896038,"C",3,3,"Brooklyn Nets","Day'Ron Sharpe",1,6,6,2,4,7.8
1,0,1,0,0,3,0,0,0,"08",0,4,0,1,0,1,1037616,"2023-10-27T00:00:00.000Z",7,FALSE,3,421,"G",3,3,"Brooklyn Nets","Dennis Smith Jr.",0,1,2,1,2,1.7
2,1,1,6,4,9,5,0,0,"21",0,3,14,1,0,2,1037616,"2023-10-27T00:00:00.000Z",7,FALSE,3,464,"G",3,3,"Brooklyn Nets","Lonnie Walker IV",1,15,17,16,3,19.2
0,0,0,0,0,0,0,0,0,"00",0,0,0,0,0,0,1037616,"2023-10-27T00:00:00.000Z",7,FALSE,3,17896058,"F",3,3,"Brooklyn Nets","Trendon Watford",0,0,0,0,0,0
0,0,0,0,0,0,0,0,0,"00",0,0,0,0,0,0,1037616,"2023-10-27T00:00:00.000Z",7,FALSE,3,56677722,"F",3,3,"Brooklyn Nets","Jalen Wilson",0,0,0,0,0,0
0,0,0,0,0,0,0,0,0,"00",0,0,0,0,0,0,1037616,"2023-10-27T00:00:00.000Z",7,FALSE,3,666508,"F-C",3,3,"Brooklyn Nets","Nicolas Claxton",0,0,0,0,0,0
0,0,0,0,0,0,0,0,0,"00",0,0,0,0,0,0,1037616,"2023-10-27T00:00:00.000Z",7,FALSE,3,666679,"F",3,3,"Brooklyn Nets","Cameron Johnson",0,0,0,0,0,0
0,0,0,0,0,0,0,0,0,"00",0,0,0,0,0,0,1037616,"2023-10-27T00:00:00.000Z",7,FALSE,3,56677841,"F",3,3,"Brooklyn Nets","Dariq Whitehead",0,0,0,0,0,0
0,0,0,0,0,0,0,0,0,"00",0,0,0,0,0,0,1037616,"2023-10-27T00:00:00.000Z",7,FALSE,3,329,"F",7,7,"Dallas Mavericks","Markieff Morris",0,0,0,0,0,0
0,0,0,1,1,4,4,2,2,"13",2,0,11,2,1,0,1037616,"2023-10-27T00:00:00.000Z",7,FALSE,3,379,"F-C",7,7,"Dallas Mavericks","Dwight Powell",1,13,13,11,2,16.4
0,0,0,0,0,0,0,0,0,"00",0,0,0,0,0,0,1037616,"2023-10-27T00:00:00.000Z",7,FALSE,3,56677859,"F",7,7,"Dallas Mavericks","Olivier-Maxence Prosper",0,0,0,0,0,0
0,0,0,0,0,0,0,0,0,"00",0,0,0,0,0,0,1037616,"2023-10-27T00:00:00.000Z",7,FALSE,3,17896028,"F",7,7,"Dallas Mavericks","Greg Brown III",0,0,0,0,0,0
0,0,0,0,0,0,0,0,0,"00",0,0,0,0,0,0,1037616,"2023-10-27T00:00:00.000Z",7,FALSE,3,56677873,"G",7,7,"Dallas Mavericks","Dexter Dennis",0,0,0,0,0,0
0,0,0,0,0,0,0,0,0,"00",0,0,0,0,0,0,1037616,"2023-10-27T00:00:00.000Z",7,FALSE,3,17554004,"G",7,7,"Dallas Mavericks","AJ Lawson",0,0,0,0,0,0
2,1,7,4,1,19,12,5,5,"33",0,2,30,7,1,0,1037616,"2023-10-27T00:00:00.000Z",7,FALSE,3,17896048,"G",3,3,"Brooklyn Nets","Cam Thomas",2,37,39,32,9,47.4
3,0,3,7,3,17,6,3,3,"36",1,2,18,4,0,1,1037616,"2023-10-27T00:00:00.000Z",7,FALSE,3,61,"F",3,3,"Brooklyn Nets","Mikal Bridges",0,22,25,21,7,26.3
3,0,6,7,4,8,4,0,0,"32",1,5,12,7,0,2,1037616,"2023-10-27T00:00:00.000Z",7,FALSE,3,158,"F",3,3,"Brooklyn Nets","Dorian Finney-Smith",0,19,22,15,10,22.9
8,0,3,12,6,17,8,2,1,"40",0,4,23,3,0,2,1037616,"2023-10-27T00:00:00.000Z",7,FALSE,3,130,"G",3,3,"Brooklyn Nets","Spencer Dinwiddie",0,26,34,31,11,36.6
8,2,6,0,0,8,5,0,0,"33",4,3,10,10,2,2,1037616,"2023-10-27T00:00:00.000Z",7,FALSE,3,417,"G-F",3,3,"Brooklyn Nets","Ben Simmons",4,20,28,18,18,44
0,0,0,0,0,0,0,0,0,"00",0,0,0,0,0,0,1037616,"2023-10-27T00:00:00.000Z",7,FALSE,3,9051997,"G",3,3,"Brooklyn Nets","Armoni Brooks",0,0,0,0,0,0
0,0,0,0,0,0,0,0,0,"00",0,0,0,0,0,0,1037616,"2023-10-27T00:00:00.000Z",7,FALSE,3,56677843,"F",3,3,"Brooklyn Nets","Noah Clowney",0,0,0,0,0,0
0,0,0,0,0,0,0,0,0,"00",0,0,0,0,0,0,1037616,"2023-10-27T00:00:00.000Z",7,FALSE,3,174,"F-C",3,3,"Brooklyn Nets","Harry Giles III",0,0,0,0,0,0
3,0,8,7,3,9,4,0,0,"34",2,4,11,10,1,3,1037616,"2023-10-27T00:00:00.000Z",7,FALSE,3,351,"F",3,3,"Brooklyn Nets","Royce O'Neale",1,21,24,14,13,27.5
3,0,1,2,0,7,2,0,0,"18",0,6,4,1,1,3,1037617,"2023-10-27T00:00:00.000Z",29,FALSE,13,139,"G",29,29,"Utah Jazz","Kris Dunn",1,5,8,7,4,9.7
2,0,2,3,2,5,3,0,0,"12",1,2,8,3,0,1,1037617,"2023-10-27T00:00:00.000Z",29,FALSE,13,56677834,"G",29,29,"Utah Jazz","Keyonte George",0,11,13,10,5,13.6
0,0,0,0,0,0,0,0,0,"00",0,0,0,0,0,0,1037617,"2023-10-27T00:00:00.000Z",29,FALSE,13,38017739,"F",29,29,"Utah Jazz","Simone Fontecchio",0,0,0,0,0,0
0,0,0,0,0,0,0,0,0,"00",0,0,0,0,0,0,1037617,"2023-10-27T00:00:00.000Z",29,FALSE,13,56677824,"F",29,29,"Utah Jazz","Taylor Hendricks",0,0,0,0,0,0
0,0,0,0,0,0,0,0,0,"00",0,0,0,0,0,0,1037617,"2023-10-27T00:00:00.000Z",29,FALSE,13,666881,"F",29,29,"Utah Jazz","Luka Samanic",0,0,0,0,0,0
0,0,0,0,0,0,0,0,0,"00",0,0,0,0,0,0,1037617,"2023-10-27T00:00:00.000Z",29,FALSE,13,56677842,"F",29,29,"Utah Jazz","Brice Sensabaugh",0,0,0,0,0,0
0,0,0,0,0,0,0,0,0,"00",0,0,0,0,0,0,1037617,"2023-10-27T00:00:00.000Z",29,FALSE,13,11891374,"C",29,29,"Utah Jazz","Omer Yurtseven",0,0,0,0,0,0
0,0,0,0,0,0,0,0,0,"00",0,0,0,0,0,0,1037617,"2023-10-27T00:00:00.000Z",29,FALSE,13,17896023,"G",29,29,"Utah Jazz","Josh Christopher",0,0,0,0,0,0
0,0,0,0,0,0,0,0,0,"00",0,0,0,0,0,0,1037617,"2023-10-27T00:00:00.000Z",29,FALSE,13,38017630,"G",29,29,"Utah Jazz","Johnny Juzang",0,0,0,0,0,0
0,0,0,0,0,0,0,0,0,"00",0,0,0,0,0,0,1037617,"2023-10-27T00:00:00.000Z",29,FALSE,13,19465584,"F",29,29,"Utah Jazz","Micah Potter",0,0,0,0,0,0
2,0,1,3,1,3,1,2,1,"20",0,4,4,1,2,0,1037617,"2023-10-27T00:00:00.000Z",29,FALSE,13,108,"F",23,13,"LA Clippers","Robert Covington",2,5,7,6,3,14.2
3,0,7,13,5,23,12,6,6,"35",5,2,35,12,0,3,1037617,"2023-10-27T00:00:00.000Z",29,FALSE,13,297,"F",29,29,"Utah Jazz","Lauri Markkanen",0,47,50,38,15,50.9
0,1,7,5,1,11,4,4,4,"34",5,4,13,12,0,0,1037617,"2023-10-27T00:00:00.000Z",29,FALSE,13,101,"F-C",29,29,"Utah Jazz","John Collins",1,25,25,13,12,30.4
0,0,2,2,1,6,3,0,0,"21",2,0,7,4,0,0,1037617,"2023-10-27T00:00:00.000Z",29,FALSE,13,38017705,"C",29,29,"Utah Jazz","Walker Kessler",0,11,11,7,4,11.8
6,0,3,5,3,13,4,3,2,"34",1,0,13,4,1,2,1037617,"2023-10-27T00:00:00.000Z",29,FALSE,13,100,"G",29,29,"Utah Jazz","Jordan Clarkson",1,17,23,19,10,27.8
8,1,3,5,2,10,3,2,2,"27",0,1,10,3,3,2,1037617,"2023-10-27T00:00:00.000Z",29,FALSE,13,666650,"G",29,29,"Utah Jazz","Talen Horton-Tucker",4,13,21,18,11,35.6
2,1,1,2,0,3,1,0,0,"12",0,3,2,1,1,0,1037617,"2023-10-27T00:00:00.000Z",29,FALSE,13,38017620,"G",29,29,"Utah Jazz","Ochai Agbaji",2,3,5,4,3,12.2
3,1,1,2,2,6,5,3,3,"27",3,3,15,4,1,3,1037617,"2023-10-27T00:00:00.000Z",29,FALSE,13,358,"F",29,29,"Utah Jazz","Kelly Olynyk",2,19,22,18,7,27.3
0,0,1,2,0,12,5,4,3,"20",0,3,13,1,0,0,1037617,"2023-10-27T00:00:00.000Z",29,FALSE,13,413,"G",29,29,"Utah Jazz","Collin Sexton",0,14,14,13,1,14.2
1,0,3,9,3,17,9,15,15,"38",1,1,36,4,0,2,1037617,"2023-10-27T00:00:00.000Z",29,FALSE,13,172,"F",13,13,"LA Clippers","Paul George",0,40,41,37,5,40.3
4,1,8,1,0,4,2,0,0,"37",1,4,4,9,1,5,1037617,"2023-10-27T00:00:00.000Z",29,FALSE,13,472,"G",13,13,"LA Clippers","Russell Westbrook",2,13,17,8,13,21.8
3,3,2,3,2,4,3,0,0,"30",0,4,8,2,1,0,1037617,"2023-10-27T00:00:00.000Z",29,FALSE,13,33,"F-G",23,13,"LA Clippers","Nicolas Batum",4,10,13,11,5,26.9
0,0,0,0,0,0,0,0,0,"00",0,0,0,0,0,0,1037617,"2023-10-27T00:00:00.000Z",29,FALSE,13,56677849,"F",13,13,"LA Clippers","Kobe Brown",0,0,0,0,0,0
0,0,0,0,0,0,0,0,0,"00",0,0,0,0,0,0,1037617,"2023-10-27T00:00:00.000Z",29,FALSE,13,666511,"G",13,13,"LA Clippers","Amir Coffey",0,0,0,0,0,0
0,0,0,0,0,0,0,0,0,"00",0,0,0,0,0,0,1037617,"2023-10-27T00:00:00.000Z",29,FALSE,13,38017725,"F",13,13,"LA Clippers","Moussa Diabate",0,0,0,0,0,0
1,0,2,5,2,10,5,0,0,"22",0,2,12,2,1,3,1037617,"2023-10-27T00:00:00.000Z",29,FALSE,13,17896031,"G",13,13,"LA Clippers","Nah'Shon Hyland",1,14,15,13,3,15.9
0,0,0,0,0,0,0,0,0,"00",0,0,0,0,0,0,1037617,"2023-10-27T00:00:00.000Z",29,FALSE,13,3547294,"F",23,13,"LA Clippers","Kenyon Martin Jr.",0,0,0,0,0,0
0,0,0,0,0,0,0,0,0,"00",0,0,0,0,0,0,1037617,"2023-10-27T00:00:00.000Z",29,FALSE,13,56677856,"G",13,13,"LA Clippers","Jordan Miller",0,0,0,0,0,0
0,0,3,0,0,1,1,2,1,"12",1,2,3,4,0,1,1037617,"2023-10-27T00:00:00.000Z",29,FALSE,13,371,"F-C",13,13,"LA Clippers","Mason Plumlee",0,7,7,3,4,6.8
1,0,3,4,2,10,7,4,4,"25",0,2,20,3,1,1,1037617,"2023-10-27T00:00:00.000Z",29,FALSE,13,380,"F-G",13,13,"LA Clippers","Norman Powell",1,23,24,21,4,27.1
0,0,0,0,0,0,0,0,0,"00",0,0,0,0,0,0,1037617,"2023-10-27T00:00:00.000Z",29,FALSE,13,17896022,"G",13,13,"LA Clippers","Brandon Boston Jr.",0,0,0,0,0,0
0,0,0,0,0,0,0,0,0,"00",0,0,0,0,0,0,1037617,"2023-10-27T00:00:00.000Z",29,FALSE,13,666743,"G",13,13,"LA Clippers","Terance Mann",0,0,0,0,0,0
0,0,0,0,0,0,0,0,0,"00",0,0,0,0,0,0,1037617,"2023-10-27T00:00:00.000Z",29,FALSE,13,328,"F",23,13,"LA Clippers","Marcus Morris",0,0,0,0,0,0
0,0,0,0,0,0,0,0,0,"00",0,0,0,0,0,0,1037617,"2023-10-27T00:00:00.000Z",29,FALSE,13,17896051,"G",13,13,"LA Clippers","Joshua Primo",0,0,0,0,0,0
5,0,6,10,4,22,10,3,1,"37",3,1,25,9,2,1,1037617,"2023-10-27T00:00:00.000Z",29,FALSE,13,274,"F",13,13,"LA Clippers","Kawhi Leonard",2,34,39,30,14,48.3
0,2,2,0,0,6,3,2,0,"19",0,2,6,2,0,1,1037617,"2023-10-27T00:00:00.000Z",29,FALSE,13,493,"C",13,13,"LA Clippers","Ivica Zubac",2,8,8,6,2,13.4
0,1,2,1,0,1,0,0,0,"17",0,2,0,2,1,0,1037618,"2023-10-27T00:00:00.000Z",25,FALSE,22,666923,"G-F",25,25,"Portland Trail Blazers","Matisse Thybulle",2,2,2,0,2,8.4
3,0,4,5,1,14,4,7,6,"36",0,5,15,4,2,3,1037618,"2023-10-27T00:00:00.000Z",25,FALSE,22,182,"F",25,25,"Portland Trail Blazers","Jerami Grant",2,19,22,18,7,27.3
1,0,11,0,0,9,7,0,0,"30",4,4,14,15,0,2,1037618,"2023-10-27T00:00:00.000Z",25,FALSE,22,22,"C",25,25,"Portland Trail Blazers","Deandre Ayton",0,29,30,15,16,31.5
2,0,1,11,4,23,9,2,2,"41",4,1,24,5,2,3,1037618,"2023-10-27T00:00:00.000Z",25,FALSE,22,38017690,"G",25,25,"Portland Trail Blazers","Shaedon Sharpe",2,29,31,26,7,36
2,0,1,5,1,12,3,0,0,"25",2,5,7,3,1,5,1037618,"2023-10-27T00:00:00.000Z",25,FALSE,22,56677747,"G",25,25,"Portland Trail Blazers","Scoot Henderson",1,10,12,9,5,11.6
1,0,5,6,2,15,6,6,4,"31",2,2,18,7,0,2,1037618,"2023-10-27T00:00:00.000Z",25,FALSE,22,65,"G",25,25,"Portland Trail Blazers","Malcolm Brogdon",0,25,26,19,8,25.9
0,0,0,0,0,0,0,0,0,"00",0,0,0,0,0,0,1037618,"2023-10-27T00:00:00.000Z",25,FALSE,22,666476,"C",25,25,"Portland Trail Blazers","Moses Brown",0,0,0,0,0,0
3,0,3,2,0,4,0,2,2,"23",1,0,2,4,0,0,1037618,"2023-10-27T00:00:00.000Z",25,FALSE,22,56677850,"F",25,25,"Portland Trail Blazers","Toumani Camara",0,6,9,5,7,11.3
1,0,0,0,0,2,1,0,0,"08",0,0,2,0,0,0,1037618,"2023-10-27T00:00:00.000Z",25,FALSE,22,3547289,"G",25,25,"Portland Trail Blazers","Skylar Mays",0,2,3,3,1,3.5
0,0,0,0,0,0,0,0,0,"00",0,0,0,0,0,0,1037618,"2023-10-27T00:00:00.000Z",25,FALSE,22,56677791,"F",25,25,"Portland Trail Blazers","Kris Murray",0,0,0,0,0,0
0,0,0,0,0,0,0,0,0,"00",0,0,0,0,0,0,1037618,"2023-10-27T00:00:00.000Z",25,FALSE,22,56677829,"G-F",25,25,"Portland Trail Blazers","Rayan Rupert",0,0,0,0,0,0
0,0,3,2,1,3,2,4,4,"09",1,3,9,4,0,0,1037618,"2023-10-27T00:00:00.000Z",25,FALSE,22,38017711,"F",25,25,"Portland Trail Blazers","Jabari Walker",0,13,13,9,4,13.8
2,0,2,0,0,5,3,0,0,"20",1,2,6,3,0,1,1037618,"2023-10-27T00:00:00.000Z",25,FALSE,22,476,"C-F",25,25,"Portland Trail Blazers","Robert Williams III",0,9,11,8,5,11.6
0,0,0,0,0,0,0,0,0,"00",0,0,0,0,0,0,1037618,"2023-10-27T00:00:00.000Z",25,FALSE,22,47957121,"F",25,25,"Portland Trail Blazers","Justin Minaya",0,0,0,0,0,0
0,0,0,0,0,0,0,0,0,"00",0,0,0,0,0,0,1037618,"2023-10-27T00:00:00.000Z",25,FALSE,22,56783340,"C",25,25,"Portland Trail Blazers","Duop Reath",0,0,0,0,0,0
0,0,0,0,0,0,0,0,0,"00",0,0,0,0,0,0,1037618,"2023-10-27T00:00:00.000Z",25,FALSE,22,419,"G",25,25,"Portland Trail Blazers","Anfernee Simons",0,0,0,0,0,0
0,0,0,0,0,0,0,0,0,"00",0,0,0,0,0,0,1037618,"2023-10-27T00:00:00.000Z",25,FALSE,22,17896120,"F",25,25,"Portland Trail Blazers","Ish Wainright",0,0,0,0,0,0
3,1,5,9,3,16,6,9,8,"35",0,2,23,5,1,3,1037618,"2023-10-27T00:00:00.000Z",25,FALSE,22,17896026,"F",22,22,"Orlando Magic","Franz Wagner",2,28,31,26,8,36.5
4,0,5,0,0,12,5,9,4,"35",2,1,14,7,2,3,1037618,"2023-10-27T00:00:00.000Z",25,FALSE,22,38017683,"F",22,22,"Orlando Magic","Paolo Banchero",2,21,25,18,11,31.4
1,0,7,3,1,7,2,4,3,"26",2,1,8,9,0,2,1037618,"2023-10-27T00:00:00.000Z",25,FALSE,22,85,"F",22,22,"Orlando Magic","Wendell Carter Jr.",0,17,18,9,10,18.3
2,2,5,1,0,5,4,3,3,"27",0,3,11,5,4,1,1037618,"2023-10-27T00:00:00.000Z",25,FALSE,22,17896073,"G",22,22,"Orlando Magic","Jalen Suggs",6,16,18,13,7,37
6,0,1,2,0,8,4,0,0,"25",1,0,8,2,0,1,1037618,"2023-10-27T00:00:00.000Z",25,FALSE,22,165,"G",22,22,"Orlando Magic","Markelle Fultz",0,10,16,14,8,18.4
2,1,3,7,3,15,6,6,3,"28",1,3,18,4,0,1,1037618,"2023-10-27T00:00:00.000Z",25,FALSE,22,3547251,"G",22,22,"Orlando Magic","Cole Anthony",1,22,24,20,6,27.8
0,0,0,0,0,0,0,0,0,"00",0,0,0,0,0,0,1037618,"2023-10-27T00:00:00.000Z",25,FALSE,22,666442,"C",22,22,"Orlando Magic","Goga Bitadze",0,0,0,0,0,0
0,0,0,0,0,0,0,0,0,"00",0,0,0,0,0,0,1037618,"2023-10-27T00:00:00.000Z",25,FALSE,22,56677827,"G",22,22,"Orlando Magic","Anthony Black",0,0,0,0,0,0
1,0,1,3,1,5,1,0,0,"19",0,0,3,1,0,1,1037618,"2023-10-27T00:00:00.000Z",25,FALSE,22,196,"G",22,22,"Orlando Magic","Gary Harris",0,4,5,4,2,4.7
0,0,0,0,0,0,0,0,0,"00",0,0,0,0,0,0,1037618,"2023-10-27T00:00:00.000Z",25,FALSE,22,38017724,"G",22,22,"Orlando Magic","Caleb Houstan",0,0,0,0,0,0
0,0,0,0,0,0,0,0,0,"00",0,0,0,0,0,0,1037618,"2023-10-27T00:00:00.000Z",25,FALSE,22,56677839,"G",22,22,"Orlando Magic","Jett Howard",0,0,0,0,0,0
1,0,1,1,0,1,0,0,0,"15",0,3,0,1,1,1,1037618,"2023-10-27T00:00:00.000Z",25,FALSE,22,226,"F",22,22,"Orlando Magic","Joe Ingles",1,1,2,1,2,4.7
1,0,2,1,0,2,0,0,0,"08",0,1,0,2,1,0,1037618,"2023-10-27T00:00:00.000Z",25,FALSE,22,229,"F",22,22,"Orlando Magic","Jonathan Isaac",1,2,3,1,3,6.9
0,0,0,0,0,0,0,0,0,"00",0,0,0,0,0,0,1037618,"2023-10-27T00:00:00.000Z",25,FALSE,22,666818,"F",22,22,"Orlando Magic","Chuma Okeke",0,0,0,0,0,0
1,1,5,1,1,8,8,1,0,"22",4,2,17,9,1,1,1037618,"2023-10-27T00:00:00.000Z",25,FALSE,22,462,"C",22,22,"Orlando Magic","Moritz Wagner",2,26,27,18,10,34.3
0,0,0,0,0,0,0,0,0,"00",0,0,0,0,0,0,1037618,"2023-10-27T00:00:00.000Z",25,FALSE,22,38017607,"G",22,22,"Orlando Magic","Kevon Harris",0,0,0,0,0,0
0,0,0,0,0,0,0,0,0,"00",0,0,0,0,0,0,1037618,"2023-10-27T00:00:00.000Z",25,FALSE,22,17553983,"G",22,22,"Orlando Magic","Trevelin Queen",0,0,0,0,0,0
0,0,0,0,0,0,0,0,0,"00",0,0,0,0,0,0,1037618,"2023-10-27T00:00:00.000Z",25,FALSE,22,666885,"F",22,22,"Orlando Magic","Admiral Schofield",0,0,0,0,0,0
1,0,3,2,1,5,4,4,1,"30",1,1,10,4,1,0,1037619,"2023-10-27T00:00:00.000Z",26,FALSE,10,30,"F",26,26,"Sacramento Kings","Harrison Barnes",1,14,15,11,5,19.3
1,1,4,11,3,16,6,2,1,"39",3,2,16,7,2,4,1037619,"2023-10-27T00:00:00.000Z",26,FALSE,10,38017688,"F",26,26,"Sacramento Kings","Keegan Murray",3,23,24,17,8,30.9
7,0,14,2,0,15,7,6,5,"36",4,1,19,18,3,1,1037619,"2023-10-27T00:00:00.000Z",26,FALSE,10,406,"F",26,26,"Sacramento Kings","Domantas Sabonis",3,37,44,26,25,59.1
2,1,2,5,0,5,0,0,0,"16",0,0,0,2,0,0,1037619,"2023-10-27T00:00:00.000Z",26,FALSE,10,221,"G",26,26,"Sacramento Kings","Kevin Huerter",1,2,4,2,4,8.4
4,0,4,9,5,28,14,7,6,"39",0,3,39,4,2,2,1037619,"2023-10-27T00:00:00.000Z",26,FALSE,10,161,"G",26,26,"Sacramento Kings","De'Aaron Fox",2,43,47,43,8,53.8
3,0,1,4,0,7,1,3,2,"26",0,6,4,1,1,1,1037619,"2023-10-27T00:00:00.000Z",26,FALSE,10,17896030,"G",26,26,"Sacramento Kings","Chris Duarte",1,5,8,7,4,11.7
0,0,0,0,0,0,0,0,0,"00",0,0,0,0,0,0,1037619,"2023-10-27T00:00:00.000Z",26,FALSE,10,17896044,"F",26,26,"Sacramento Kings","Kessler Edwards",0,0,0,0,0,0
0,0,0,0,0,0,0,0,0,"00",0,0,0,0,0,0,1037619,"2023-10-27T00:00:00.000Z",26,FALSE,10,38017714,"G",26,26,"Sacramento Kings","Keon Ellis",0,0,0,0,0,0
0,0,0,0,0,0,0,0,0,"01",0,0,0,0,0,0,1037619,"2023-10-27T00:00:00.000Z",26,FALSE,10,56677845,"G",26,26,"Sacramento Kings","Colby Jones",0,0,0,0,0,0
0,0,0,0,0,0,0,0,0,"00",0,0,0,0,0,0,1037619,"2023-10-27T00:00:00.000Z",26,FALSE,10,273,"C",26,26,"Sacramento Kings","Alex Len",0,0,0,0,0,0
0,0,2,0,0,6,3,3,1,"12",2,0,7,4,0,2,1037619,"2023-10-27T00:00:00.000Z",26,FALSE,10,306,"C",26,26,"Sacramento Kings","JaVale McGee",0,11,11,7,4,9.8
0,0,0,1,0,2,0,0,0,"11",0,1,0,0,1,2,1037619,"2023-10-27T00:00:00.000Z",26,FALSE,10,17553994,"G",26,26,"Sacramento Kings","Davion Mitchell",1,0,0,0,0,1
6,1,0,2,1,4,2,4,4,"18",0,2,9,0,0,2,1037619,"2023-10-27T00:00:00.000Z",26,FALSE,10,324,"G",26,26,"Sacramento Kings","Malik Monk",1,9,15,15,6,19
0,0,0,0,0,0,0,0,0,"00",0,0,0,0,0,0,1037619,"2023-10-27T00:00:00.000Z",26,FALSE,10,56677862,"F",26,26,"Sacramento Kings","Jalen Slawson",0,0,0,0,0,0
0,0,1,4,2,6,4,0,0,"12",0,0,10,1,0,0,1037619,"2023-10-27T00:00:00.000Z",26,FALSE,10,4197162,"F",26,26,"Sacramento Kings","Aleksandar Vezenkov",0,11,11,10,1,11.2
4,0,3,4,2,12,7,2,2,"33",0,4,18,3,1,3,1037619,"2023-10-27T00:00:00.000Z",26,FALSE,10,443,"G",10,10,"Golden State Warriors","Klay Thompson",1,21,25,22,7,27.6
3,2,4,3,0,13,5,2,1,"27",1,4,11,5,0,2,1037619,"2023-10-27T00:00:00.000Z",26,FALSE,10,475,"F-G",10,10,"Golden State Warriors","Andrew Wiggins",2,16,19,14,8,25.5
6,1,9,0,0,6,4,0,0,"28",3,3,8,12,3,1,1037619,"2023-10-27T00:00:00.000Z",26,FALSE,10,282,"F",10,10,"Golden State Warriors","Kevon Looney",4,20,26,14,18,42.4
4,0,3,10,7,19,14,6,6,"35",1,0,41,4,2,4,1037619,"2023-10-27T00:00:00.000Z",26,FALSE,10,115,"G",10,10,"Golden State Warriors","Stephen Curry",2,45,49,45,8,53.8
12,0,2,2,0,12,5,0,0,"33",0,2,10,2,3,3,1037619,"2023-10-27T00:00:00.000Z",26,FALSE,10,367,"G",10,10,"Golden State Warriors","Chris Paul",3,12,24,22,14,36.4
0,0,1,0,0,0,0,0,0,"05",0,1,0,1,0,0,1037619,"2023-10-27T00:00:00.000Z",26,FALSE,10,56677799,"F",10,10,"Golden State Warriors","Trayce Jackson-Davis",0,1,1,0,1,1.2
0,0,0,0,0,0,0,0,0,"00",0,0,0,0,0,0,1037619,"2023-10-27T00:00:00.000Z",26,FALSE,10,251,"G",10,10,"Golden State Warriors","Cory Joseph",0,0,0,0,0,0
0,0,4,3,1,11,5,2,1,"26",1,3,12,5,0,2,1037619,"2023-10-27T00:00:00.000Z",26,FALSE,10,17553979,"F",10,10,"Golden State Warriors","Jonathan Kuminga",0,17,17,12,5,16
1,0,3,3,2,5,4,0,0,"21",0,0,10,3,3,1,1037619,"2023-10-27T00:00:00.000Z",26,FALSE,10,17553992,"G",10,10,"Golden State Warriors","Moses Moody",3,13,14,11,4,23.1
1,0,0,3,1,4,2,2,2,"18",0,3,7,0,1,2,1037619,"2023-10-27T00:00:00.000Z",26,FALSE,10,2189,"",10,10,"Golden State Warriors","Gary Payton II",1,7,8,8,1,9.5
0,0,0,0,0,0,0,0,0,"00",0,0,0,0,0,0,1037619,"2023-10-27T00:00:00.000Z",26,FALSE,10,56677858,"G",10,10,"Golden State Warriors","Brandin Podziemski",0,0,0,0,0,0
1,0,3,4,1,5,2,0,0,"14",1,4,5,4,1,1,1037619,"2023-10-27T00:00:00.000Z",26,FALSE,10,407,"F",10,10,"Golden State Warriors","Dario Saric",1,9,10,6,5,13.3
0,0,0,0,0,0,0,0,0,"00",0,0,0,0,0,0,1037619,"2023-10-27T00:00:00.000Z",26,FALSE,10,17896070,"F",10,10,"Golden State Warriors","Usman Garuba",0,0,0,0,0,0
0,0,0,0,0,0,0,0,0,"00",0,0,0,0,0,0,1037619,"2023-10-27T00:00:00.000Z",26,FALSE,10,185,"F",10,10,"Golden State Warriors","Draymond Green",0,0,0,0,0,0
0,0,0,0,0,0,0,0,0,"00",0,0,0,0,0,0,1037619,"2023-10-27T00:00:00.000Z",26,FALSE,10,45658838,"G",10,10,"Golden State Warriors","Lester Quinones",0,0,0,0,0,0
0,0,0,0,0,0,0,0,0,"00",0,0,0,0,0,0,1037619,"2023-10-27T00:00:00.000Z",26,FALSE,10,398,"G",10,10,"Golden State Warriors","Jerome Robinson",0,0,0,0,0,0
0,0,0,0,0,0,0,0,0,"00",0,0,0,0,0,0,1037619,"2023-10-27T00:00:00.000Z",26,FALSE,10,17895990,"G",26,26,"Sacramento Kings","Jordan Ford",0,0,0,0,0,0
0,0,0,0,0,0,0,0,0,"00",0,0,0,0,0,0,1037619,"2023-10-27T00:00:00.000Z",26,FALSE,10,290,"F",26,26,"Sacramento Kings","Trey Lyles",0,0,0,0,0,0
5,1,9,2,0,7,3,4,3,"31",3,3,9,12,1,2,1037620,"2023-10-28T00:00:00.000Z",9,FALSE,5,56677826,"G-F",9,9,"Detroit Pistons","Ausar Thompson",2,21,26,14,17,34.9
0,0,7,3,0,14,6,3,2,"34",2,4,14,9,0,2,1037620,"2023-10-28T00:00:00.000Z",9,FALSE,5,3547267,"F-C",9,9,"Detroit Pistons","Isaiah Stewart",0,23,23,14,9,22.8
5,2,9,0,0,11,9,5,5,"33",6,3,23,15,1,1,1037620,"2023-10-28T00:00:00.000Z",9,FALSE,5,38017694,"C",9,9,"Detroit Pistons","Jalen Duren",3,38,43,28,20,56.5
10,0,4,4,1,19,9,7,6,"40",0,3,25,4,0,6,1037620,"2023-10-28T00:00:00.000Z",9,FALSE,5,17896075,"G-F",9,9,"Detroit Pistons","Cade Cunningham",0,29,39,35,14,38.8
4,0,0,3,2,5,2,0,0,"23",1,2,6,1,1,1,1037620,"2023-10-28T00:00:00.000Z",9,FALSE,5,3547241,"G",9,9,"Detroit Pistons","Killian Hayes",1,7,11,10,5,15.2
0,0,4,1,1,8,5,0,0,"15",2,2,11,6,0,0,1037620,"2023-10-28T00:00:00.000Z",9,FALSE,5,24,"F",9,9,"Detroit Pistons","Marvin Bagley III",0,17,17,11,6,18.2
0,1,2,10,6,12,6,1,0,"25",0,1,18,2,0,0,1037620,"2023-10-28T00:00:00.000Z",9,FALSE,5,77,"G",9,9,"Detroit Pistons","Alec Burks",1,20,20,18,2,23.4
0,0,0,0,0,0,0,0,0,"00",0,0,0,0,0,0,1037620,"2023-10-28T00:00:00.000Z",9,FALSE,5,56677729,"G",9,9,"Detroit Pistons","Malcolm Cazalon",0,0,0,0,0,0
0,0,3,13,7,32,19,8,6,"37",1,2,51,4,1,3,1037620,"2023-10-28T00:00:00.000Z",9,FALSE,5,268,"G",5,5,"Chicago Bulls","Zach LaVine",1,55,55,51,4,55.8
1,0,2,2,0,4,0,0,0,"28",0,1,0,2,0,1,1037620,"2023-10-28T00:00:00.000Z",9,FALSE,5,666956,"G",5,5,"Chicago Bulls","Coby White",0,2,3,1,3,2.9
0,0,0,4,1,6,1,0,0,"13",1,0,3,1,0,0,1037620,"2023-10-28T00:00:00.000Z",9,FALSE,5,87,"G",5,5,"Chicago Bulls","Jevon Carter",0,4,4,3,1,4.2
4,1,3,0,0,2,1,0,0,"21",2,3,2,5,4,1,1037620,"2023-10-28T00:00:00.000Z",9,FALSE,5,89,"G",5,5,"Chicago Bulls","Alex Caruso",5,7,11,6,9,28
0,1,2,2,0,7,2,0,0,"23",1,3,4,3,0,0,1037620,"2023-10-28T00:00:00.000Z",9,FALSE,5,110,"F",5,5,"Chicago Bulls","Torrey Craig",1,7,7,4,3,10.6
3,0,1,2,1,7,2,0,0,"15",2,0,5,3,0,0,1037620,"2023-10-28T00:00:00.000Z",9,FALSE,5,17895983,"G",5,5,"Chicago Bulls","Ayo Dosunmu",0,8,11,8,6,13.1
1,0,1,2,1,2,1,0,0,"10",0,0,3,1,0,1,1037620,"2023-10-28T00:00:00.000Z",9,FALSE,5,197,"F-G",9,9,"Detroit Pistons","Joe Harris",0,4,5,4,2,4.7
3,0,0,2,1,6,3,0,0,"22",0,0,7,0,1,2,1037620,"2023-10-28T00:00:00.000Z",9,FALSE,5,38017682,"G",9,9,"Detroit Pistons","Jaden Ivey",1,7,10,10,3,12.5
0,0,0,0,0,0,0,0,0,"00",0,0,0,0,0,0,1037620,"2023-10-28T00:00:00.000Z",9,FALSE,5,42097199,"G",9,9,"Detroit Pistons","Jared Rhoden",0,0,0,0,0,0
1,0,2,1,0,2,1,0,0,"06",1,0,2,3,0,0,1037620,"2023-10-28T00:00:00.000Z",9,FALSE,5,56677792,"G",9,9,"Detroit Pistons","Marcus Sasser",0,5,6,3,4,7.1
0,0,0,0,0,0,0,0,0,"01",0,0,0,0,0,0,1037620,"2023-10-28T00:00:00.000Z",9,FALSE,5,44477024,"G",9,9,"Detroit Pistons","Stanley Umude",0,0,0,0,0,0
0,0,0,0,0,0,0,0,0,"00",0,0,0,0,0,0,1037620,"2023-10-28T00:00:00.000Z",9,FALSE,5,3547240,"C",9,9,"Detroit Pistons","James Wiseman",0,0,0,0,0,0
0,0,0,0,0,0,0,0,0,"00",0,0,0,0,0,0,1037620,"2023-10-28T00:00:00.000Z",9,FALSE,5,54,"F",9,9,"Detroit Pistons","Bojan Bogdanovic",0,0,0,0,0,0
0,0,0,0,0,0,0,0,0,"00",0,0,0,0,0,0,1037620,"2023-10-28T00:00:00.000Z",9,FALSE,5,17896071,"F",9,9,"Detroit Pistons","Isaiah Livers",0,0,0,0,0,0
0,0,0,0,0,0,0,0,0,"00",0,0,0,0,0,0,1037620,"2023-10-28T00:00:00.000Z",9,FALSE,5,330,"G",9,9,"Detroit Pistons","Monte Morris",0,0,0,0,0,0
4,2,1,1,0,13,7,7,6,"32",1,3,20,2,1,1,1037620,"2023-10-28T00:00:00.000Z",9,FALSE,5,125,"G",5,5,"Chicago Bulls","DeMar DeRozan",3,22,26,24,6,36.4
1,0,2,1,0,3,0,0,0,"21",1,3,0,3,1,1,1037620,"2023-10-28T00:00:00.000Z",9,FALSE,5,3547248,"F",5,5,"Chicago Bulls","Patrick Williams",1,3,4,1,4,7.1
1,0,4,2,1,12,5,1,1,"32",0,5,12,4,0,1,1037620,"2023-10-28T00:00:00.000Z",9,FALSE,5,460,"C",5,5,"Chicago Bulls","Nikola Vucevic",0,16,17,13,5,17.3
2,1,2,0,0,6,1,0,0,"15",3,0,2,5,3,0,1037620,"2023-10-28T00:00:00.000Z",9,FALSE,5,137,"C",5,5,"Chicago Bulls","Andre Drummond",4,7,9,4,7,23
0,0,0,0,0,0,0,0,0,"01",0,0,0,0,0,0,1037620,"2023-10-28T00:00:00.000Z",9,FALSE,5,56677857,"F",5,5,"Chicago Bulls","Julian Phillips",0,0,0,0,0,0
0,0,0,0,0,0,0,0,0,"01",0,0,0,0,0,0,1037620,"2023-10-28T00:00:00.000Z",9,FALSE,5,17896116,"G",5,5,"Chicago Bulls","Terry Taylor",0,0,0,0,0,0
0,0,0,1,1,1,1,0,0,"01",0,0,3,0,0,0,1037620,"2023-10-28T00:00:00.000Z",9,FALSE,5,38017719,"F",5,5,"Chicago Bulls","Dalen Terry",0,3,3,3,0,3
0,0,0,0,0,0,0,0,0,"00",0,0,0,0,0,0,1037620,"2023-10-28T00:00:00.000Z",9,FALSE,5,27,"G",5,5,"Chicago Bulls","Lonzo Ball",0,0,0,0,0,0
0,0,0,0,0,0,0,0,0,"00",0,0,0,0,0,0,1037620,"2023-10-28T00:00:00.000Z",9,FALSE,5,56677874,"F",5,5,"Chicago Bulls","Onuralp Bitim",0,0,0,0,0,0
0,0,0,0,0,0,0,0,0,"00",0,0,0,0,0,0,1037620,"2023-10-28T00:00:00.000Z",9,FALSE,5,45969255,"F",5,5,"Chicago Bulls","Justin Lewis",0,0,0,0,0,0
0,0,0,0,0,0,0,0,0,"00",0,0,0,0,0,0,1037620,"2023-10-28T00:00:00.000Z",9,FALSE,5,56677860,"F",5,5,"Chicago Bulls","Adama Sanogo",0,0,0,0,0,0
2,0,4,3,2,8,4,0,0,"27",2,2,10,6,1,1,1037621,"2023-10-28T00:00:00.000Z",30,FALSE,15,3547242,"F",30,30,"Washington Wizards","Deni Avdija",1,16,18,12,8,22.2
2,0,10,10,1,23,9,3,2,"36",3,2,21,13,1,0,1037621,"2023-10-28T00:00:00.000Z",30,FALSE,15,265,"F",30,30,"Washington Wizards","Kyle Kuzma",1,34,36,23,15,42.6
0,2,7,0,0,4,3,6,4,"28",4,2,10,11,0,1,1037621,"2023-10-28T00:00:00.000Z",30,FALSE,15,666577,"F",30,30,"Washington Wizards","Daniel Gafford",2,21,21,10,11,28.2
2,1,4,12,4,23,8,9,7,"36",0,2,27,4,1,5,1037621,"2023-10-28T00:00:00.000Z",30,FALSE,15,666848,"G",30,30,"Washington Wizards","Jordan Poole",2,31,33,29,6,35.8
7,0,0,8,4,12,5,0,0,"28",2,2,14,2,2,0,1037621,"2023-10-28T00:00:00.000Z",30,FALSE,15,249,"G",30,30,"Washington Wizards","Tyus Jones",2,16,23,21,9,32.9
0,0,0,0,0,0,0,0,0,"00",0,0,0,0,0,0,1037621,"2023-10-28T00:00:00.000Z",30,FALSE,15,38017704,"F",30,30,"Washington Wizards","Patrick Baldwin Jr.",0,0,0,0,0,0
0,0,0,0,0,0,0,0,0,"00",0,0,0,0,0,0,1037621,"2023-10-28T00:00:00.000Z",30,FALSE,15,18677954,"G",30,30,"Washington Wizards","Jared Butler",0,0,0,0,0,0
0,0,0,0,0,0,0,0,0,"00",0,0,0,0,0,0,1037621,"2023-10-28T00:00:00.000Z",30,FALSE,15,38124126,"F",30,30,"Washington Wizards","John Butler Jr.",0,0,0,0,0,0
0,0,0,0,0,0,0,0,0,"00",0,0,0,0,0,0,1037621,"2023-10-28T00:00:00.000Z",30,FALSE,15,38017687,"G",30,30,"Washington Wizards","Johnny Davis",0,0,0,0,0,0
0,0,0,0,0,0,0,0,0,"00",0,0,0,0,0,0,1037621,"2023-10-28T00:00:00.000Z",30,FALSE,15,414,"G",30,30,"Washington Wizards","Landry Shamet",0,0,0,0,0,0
1,0,10,12,4,14,6,0,0,"34",0,2,16,10,0,1,1037621,"2023-10-28T00:00:00.000Z",30,FALSE,15,17896027,"G-F",15,15,"Memphis Grizzlies","Ziaire Williams",0,26,27,17,11,28.5
2,1,5,4,2,12,4,6,6,"31",0,4,16,5,1,1,1037621,"2023-10-28T00:00:00.000Z",30,FALSE,15,231,"F-C",15,15,"Memphis Grizzlies","Jaren Jackson Jr.",2,21,23,18,7,30
3,0,6,2,2,7,3,0,0,"24",1,4,8,7,0,1,1037621,"2023-10-28T00:00:00.000Z",30,FALSE,15,3547285,"F",15,15,"Memphis Grizzlies","Xavier Tillman",0,15,18,11,10,19.9
5,1,1,10,4,20,10,2,2,"34",1,4,26,2,1,5,1037621,"2023-10-28T00:00:00.000Z",30,FALSE,15,3547287,"G",15,15,"Memphis Grizzlies","Desmond Bane",2,28,33,31,7,36.9
6,2,4,5,1,8,4,0,0,"32",0,2,9,4,2,2,1037621,"2023-10-28T00:00:00.000Z",30,FALSE,15,420,"G",15,15,"Memphis Grizzlies","Marcus Smart",4,13,19,15,10,32.8
0,0,0,0,0,0,0,0,0,"00",0,0,0,0,0,0,1037621,"2023-10-28T00:00:00.000Z",30,FALSE,15,48248287,"G",15,15,"Memphis Grizzlies","Jacob Gilyard",0,0,0,0,0,0
0,0,0,0,0,0,0,0,0,"00",0,0,0,0,0,0,1037621,"2023-10-28T00:00:00.000Z",30,FALSE,15,56677830,"F",15,15,"Memphis Grizzlies","GG Jackson",0,0,0,0,0,0
1,2,6,3,1,4,2,0,0,"22",3,0,5,9,2,1,1037621,"2023-10-28T00:00:00.000Z",30,FALSE,15,666703,"G-F",15,15,"Memphis Grizzlies","John Konchar",4,14,15,6,10,28.3
1,0,1,5,1,9,2,0,0,"16",0,0,5,1,0,0,1037621,"2023-10-28T00:00:00.000Z",30,FALSE,15,38017728,"F",15,15,"Memphis Grizzlies","Jake LaRavia",0,6,7,6,2,7.7
1,0,0,0,0,1,0,0,0,"05",0,2,0,0,0,1,1037621,"2023-10-28T00:00:00.000Z",30,FALSE,15,38017732,"F",15,15,"Memphis Grizzlies","Kenneth Lofton Jr.",0,0,1,1,1,0.5
0,0,0,0,0,0,0,0,0,"00",0,0,0,0,0,0,1037621,"2023-10-28T00:00:00.000Z",30,FALSE,15,666786,"G",15,15,"Memphis Grizzlies","Ja Morant",0,0,0,0,0,0
2,1,6,4,3,8,5,1,1,"24",0,3,14,6,0,1,1037621,"2023-10-28T00:00:00.000Z",30,FALSE,15,38017729,"F",15,15,"Memphis Grizzlies","David Roddy",1,20,22,16,8,26.2
5,1,0,2,1,8,3,0,0,"18",1,0,7,1,1,3,1037621,"2023-10-28T00:00:00.000Z",30,FALSE,15,401,"G",15,15,"Memphis Grizzlies","Derrick Rose",2,8,13,12,6,18.7
0,1,1,1,0,2,0,0,0,"14",0,1,0,1,0,1,1037621,"2023-10-28T00:00:00.000Z",30,FALSE,15,56677844,"G",30,30,"Washington Wizards","Bilal Coulibaly",1,1,1,0,1,3.2
1,0,0,1,0,3,2,1,1,"08",0,0,5,0,1,0,1037621,"2023-10-28T00:00:00.000Z",30,FALSE,15,167,"F",30,30,"Washington Wizards","Danilo Gallinari",1,5,6,6,1,9.5
0,0,0,0,0,0,0,0,0,"00",0,0,0,0,0,0,1037621,"2023-10-28T00:00:00.000Z",30,FALSE,15,3547302,"F",30,30,"Washington Wizards","Anthony Gill",0,0,0,0,0,0
1,0,3,10,5,14,8,1,1,"32",0,2,22,3,1,2,1037621,"2023-10-28T00:00:00.000Z",30,FALSE,15,17896045,"F",30,30,"Washington Wizards","Corey Kispert",1,25,26,23,4,28.1
2,0,3,0,0,1,1,0,0,"11",0,2,2,3,0,0,1037621,"2023-10-28T00:00:00.000Z",30,FALSE,15,337,"F-C",30,30,"Washington Wizards","Mike Muscala",0,5,7,4,5,8.6
0,0,0,0,0,0,0,0,0,"00",0,0,0,0,0,0,1037621,"2023-10-28T00:00:00.000Z",30,FALSE,15,17896106,"F",30,30,"Washington Wizards","Eugene Omoruyi",0,0,0,0,0,0
0,0,0,0,0,0,0,0,0,"00",0,0,0,0,0,0,1037621,"2023-10-28T00:00:00.000Z",30,FALSE,15,38017712,"G",30,30,"Washington Wizards","Ryan Rollins",0,0,0,0,0,0
7,1,2,1,0,3,0,2,2,"20",0,0,2,2,2,1,1037621,"2023-10-28T00:00:00.000Z",30,FALSE,15,487,"G",30,30,"Washington Wizards","Delon Wright",3,4,11,9,9,22.9
0,0,0,0,0,0,0,0,0,"00",0,0,0,0,0,0,1037621,"2023-10-28T00:00:00.000Z",30,FALSE,15,254,"G",15,15,"Memphis Grizzlies","Luke Kennard",0,0,0,0,0,0
0,0,0,0,0,0,0,0,0,"00",0,0,0,0,0,0,1037621,"2023-10-28T00:00:00.000Z",30,FALSE,15,38017731,"G",15,15,"Memphis Grizzlies","Vince Williams Jr.",0,0,0,0,0,0
0,0,0,0,0,0,0,0,0,"00",0,0,0,0,0,0,1037621,"2023-10-28T00:00:00.000Z",30,FALSE,15,3,"C",15,15,"Memphis Grizzlies","Steven Adams",0,0,0,0,0,0
0,0,0,0,0,0,0,0,0,"00",0,0,0,0,0,0,1037621,"2023-10-28T00:00:00.000Z",30,FALSE,15,17896067,"F",15,15,"Memphis Grizzlies","Santi Aldama",0,0,0,0,0,0
0,0,0,0,0,0,0,0,0,"00",0,0,0,0,0,0,1037621,"2023-10-28T00:00:00.000Z",30,FALSE,15,666505,"F",15,15,"Memphis Grizzlies","Brandon Clarke",0,0,0,0,0,0
3,0,5,3,1,17,11,4,3,"32",2,4,26,7,1,5,1037622,"2023-10-28T00:00:00.000Z",19,FALSE,20,227,"F",19,19,"New Orleans Pelicans","Brandon Ingram",1,33,36,29,10,36.9
2,0,4,0,0,17,12,2,0,"28",1,0,24,5,0,0,1037622,"2023-10-28T00:00:00.000Z",19,FALSE,20,666969,"F",19,19,"New Orleans Pelicans","Zion Williamson",0,29,31,26,7,33
0,0,4,1,0,7,3,2,2,"21",0,4,8,4,1,4,1037622,"2023-10-28T00:00:00.000Z",19,FALSE,20,455,"C",19,19,"New Orleans Pelicans","Jonas Valanciunas",1,12,12,8,4,11.8
1,3,2,2,2,6,4,0,0,"27",0,5,10,2,0,1,1037622,"2023-10-28T00:00:00.000Z",19,FALSE,20,17896024,"F",19,19,"New Orleans Pelicans","Herbert Jones",3,12,13,11,3,21.9
7,0,3,7,2,11,4,4,2,"30",0,2,12,3,4,1,1037622,"2023-10-28T00:00:00.000Z",19,FALSE,20,303,"G",19,19,"New Orleans Pelicans","CJ McCollum",4,15,22,19,10,37.1
3,0,4,3,0,7,1,4,0,"22",0,2,2,4,1,1,1037622,"2023-10-28T00:00:00.000Z",19,FALSE,20,38017677,"G",19,19,"New Orleans Pelicans","Dyson Daniels",1,6,9,5,7,13.3
1,0,4,6,3,7,3,0,0,"18",0,0,9,4,0,1,1037622,"2023-10-28T00:00:00.000Z",19,FALSE,20,56677837,"G",19,19,"New Orleans Pelicans","Jordan Hawkins",0,13,14,10,5,14.3
0,0,2,2,0,4,1,0,0,"10",0,0,2,2,0,0,1037622,"2023-10-28T00:00:00.000Z",19,FALSE,20,3547260,"G",19,19,"New Orleans Pelicans","Kira Lewis Jr.",0,4,4,2,2,4.4
0,0,2,1,0,1,0,0,0,"02",0,0,0,2,0,0,1037622,"2023-10-28T00:00:00.000Z",19,FALSE,20,38017663,"F",19,19,"New Orleans Pelicans","E.J. Liddell",0,2,2,0,2,2.4
0,1,5,0,0,1,0,0,0,"16",1,2,0,6,0,0,1037622,"2023-10-28T00:00:00.000Z",19,FALSE,20,340,"F",19,19,"New Orleans Pelicans","Larry Nance Jr.",1,6,6,0,6,10.2
3,1,3,8,1,8,1,0,0,"26",0,3,3,3,1,0,1037622,"2023-10-28T00:00:00.000Z",19,FALSE,20,17896017,"F",19,19,"New Orleans Pelicans","Matt Ryan",2,6,9,6,6,17.1
0,0,1,0,0,1,0,0,0,"08",0,0,0,1,0,0,1037622,"2023-10-28T00:00:00.000Z",19,FALSE,20,491,"C",19,19,"New Orleans Pelicans","Cody Zeller",0,1,1,0,1,1.2
0,0,0,0,0,0,0,0,0,"00",0,0,0,0,0,0,1037622,"2023-10-28T00:00:00.000Z",19,FALSE,20,17896097,"G",19,19,"New Orleans Pelicans","Jose Alvarado",0,0,0,0,0,0
0,0,0,0,0,0,0,0,0,"00",0,0,0,0,0,0,1037622,"2023-10-28T00:00:00.000Z",19,FALSE,20,666584,"F",19,19,"New Orleans Pelicans","Kaiser Gates",0,0,0,0,0,0
0,0,0,0,0,0,0,0,0,"00",0,0,0,0,0,0,1037622,"2023-10-28T00:00:00.000Z",19,FALSE,20,3547293,"F",19,19,"New Orleans Pelicans","Naji Marshall",0,0,0,0,0,0
5,0,3,5,1,14,4,6,5,"31",1,2,14,4,0,1,1037622,"2023-10-28T00:00:00.000Z",19,FALSE,20,73,"G",20,20,"New York Knicks","Jalen Brunson",0,18,23,19,9,25.3
1,0,2,5,1,7,2,0,0,"20",2,3,5,4,2,2,1037622,"2023-10-28T00:00:00.000Z",19,FALSE,20,131,"G",20,20,"New York Knicks","Donte DiVincenzo",2,9,10,6,5,15.3
2,0,8,3,1,5,1,0,0,"21",2,2,3,10,1,2,1037622,"2023-10-28T00:00:00.000Z",19,FALSE,20,202,"G",20,20,"New York Knicks","Josh Hart",1,13,15,5,12,19
1,0,2,0,0,1,1,4,2,"15",1,0,4,3,0,0,1037622,"2023-10-28T00:00:00.000Z",19,FALSE,20,201,"F-C",20,20,"New York Knicks","Isaiah Hartenstein",0,7,8,5,4,9.1
0,0,1,1,1,2,2,0,0,"03",0,0,5,1,0,0,1037622,"2023-10-28T00:00:00.000Z",19,FALSE,20,666675,"F",20,20,"New York Knicks","DaQuan Jeffries",0,6,6,5,1,6.2
1,0,1,2,0,3,1,0,0,"05",0,0,2,1,1,0,1037622,"2023-10-28T00:00:00.000Z",19,FALSE,20,17896033,"G",20,20,"New York Knicks","Miles McBride",1,3,4,3,2,7.7
1,0,1,3,0,9,4,2,2,"19",0,3,10,1,0,2,1037622,"2023-10-28T00:00:00.000Z",19,FALSE,20,3547269,"G",20,20,"New York Knicks","Immanuel Quickley",0,11,12,11,2,10.7
0,0,3,0,0,0,0,0,0,"04",0,0,0,3,0,0,1037622,"2023-10-28T00:00:00.000Z",19,FALSE,20,17896063,"F",20,20,"New York Knicks","Jericho Sims",0,3,3,0,3,3.6
0,0,0,0,0,0,0,0,0,"00",0,0,0,0,0,0,1037622,"2023-10-28T00:00:00.000Z",19,FALSE,20,18677986,"F",19,19,"New Orleans Pelicans","Trey Murphy III",0,0,0,0,0,0
0,0,0,0,0,0,0,0,0,"00",0,0,0,0,0,0,1037622,"2023-10-28T00:00:00.000Z",19,FALSE,20,38017726,"G",19,19,"New Orleans Pelicans","Dereon Seabron",0,0,0,0,0,0
2,1,3,6,1,16,7,4,3,"30",0,0,18,3,1,3,1037622,"2023-10-28T00:00:00.000Z",19,FALSE,20,666423,"F-G",20,20,"New York Knicks","RJ Barrett",2,21,23,20,5,27.6
4,0,12,5,0,15,4,2,2,"34",0,4,10,12,0,8,1037622,"2023-10-28T00:00:00.000Z",19,FALSE,20,387,"F",20,20,"New York Knicks","Julius Randle",0,22,26,14,16,22.4
0,2,5,0,0,8,4,0,0,"29",10,1,8,15,0,0,1037622,"2023-10-28T00:00:00.000Z",19,FALSE,20,399,"C",20,20,"New York Knicks","Mitchell Robinson",2,23,23,8,15,32
1,0,2,6,1,9,2,0,0,"26",0,1,5,2,2,0,1037622,"2023-10-28T00:00:00.000Z",19,FALSE,20,17895858,"G",20,20,"New York Knicks","Quentin Grimes",2,7,8,6,3,14.9
1,0,0,1,1,1,1,0,0,"03",0,1,3,0,0,0,1037622,"2023-10-28T00:00:00.000Z",19,FALSE,20,666971,"G-F",20,20,"New York Knicks","Dylan Windler",0,3,4,4,1,4.5
0,0,0,0,0,0,0,0,0,"00",0,0,0,0,0,0,1037622,"2023-10-28T00:00:00.000Z",19,FALSE,20,19,"G",20,20,"New York Knicks","Ryan Arcidiacono",0,0,0,0,0,0
0,0,0,0,0,0,0,0,0,"00",0,0,0,0,0,0,1037622,"2023-10-28T00:00:00.000Z",19,FALSE,20,160,"G-F",20,20,"New York Knicks","Evan Fournier",0,0,0,0,0,0
0,0,0,0,0,0,0,0,0,"00",0,0,0,0,0,0,1037622,"2023-10-28T00:00:00.000Z",19,FALSE,20,666474,"G",20,20,"New York Knicks","Charles Brown",0,0,0,0,0,0
0,0,0,0,0,0,0,0,0,"00",0,0,0,0,0,0,1037622,"2023-10-28T00:00:00.000Z",19,FALSE,20,56677795,"F",20,20,"New York Knicks","Jacob Toppin",0,0,0,0,0,0
0,0,0,0,0,0,0,0,0,"00",0,0,0,0,0,0,1037622,"2023-10-28T00:00:00.000Z",19,FALSE,20,17896089,"G",20,20,"New York Knicks","Duane Washington Jr.",0,0,0,0,0,0
3,1,3,0,0,8,5,2,1,"35",2,3,11,5,0,0,1037623,"2023-10-28T00:00:00.000Z",6,FALSE,12,3547247,"F-G",6,6,"Cleveland Cavaliers","Isaac Okoro",1,16,19,14,8,24.5
3,1,3,5,2,5,2,0,0,"37",0,2,6,3,0,0,1037623,"2023-10-28T00:00:00.000Z",6,FALSE,12,666940,"F",6,6,"Cleveland Cavaliers","Dean Wade",1,9,12,9,6,17.1
3,3,9,1,1,22,12,10,8,"33",5,4,33,14,0,2,1037623,"2023-10-28T00:00:00.000Z",6,FALSE,12,17896076,"F-C",6,6,"Cleveland Cavaliers","Evan Mobley",3,47,50,36,17,61.3
6,0,10,9,4,20,7,3,3,"42",1,2,21,11,0,1,1037623,"2023-10-28T00:00:00.000Z",6,FALSE,12,666908,"G",6,6,"Cleveland Cavaliers","Max Strus",0,32,38,27,17,42.2
8,0,3,10,4,28,12,9,3,"44",2,2,31,5,1,2,1037623,"2023-10-28T00:00:00.000Z",6,FALSE,12,277,"G",6,6,"Cleveland Cavaliers","Caris LeVert",1,36,44,39,13,50
0,0,0,1,0,1,0,0,0,"06",0,0,0,0,0,0,1037623,"2023-10-28T00:00:00.000Z",6,FALSE,12,56677847,"F",6,6,"Cleveland Cavaliers","Emoni Bates",0,0,0,0,0,0
0,0,1,0,0,0,0,0,0,"06",2,0,0,3,0,0,1037623,"2023-10-28T00:00:00.000Z",6,FALSE,12,248,"C",6,6,"Cleveland Cavaliers","Damian Jones",0,3,3,0,3,3.6
1,0,1,1,0,2,0,0,0,"06",1,0,0,2,1,0,1037623,"2023-10-28T00:00:00.000Z",6,FALSE,12,3547299,"G",6,6,"Cleveland Cavaliers","Sam Merrill",1,2,3,1,3,6.9
0,0,0,0,0,0,0,0,0,"00",0,0,0,0,0,0,1037623,"2023-10-28T00:00:00.000Z",6,FALSE,12,38017662,"F",6,6,"Cleveland Cavaliers","Isaiah Mobley",0,0,0,0,0,0
2,1,2,4,1,10,3,0,0,"19",1,3,7,3,0,1,1037623,"2023-10-28T00:00:00.000Z",6,FALSE,12,344,"F",6,6,"Cleveland Cavaliers","Georges Niang",1,10,12,9,5,15.6
1,0,0,0,0,0,0,0,0,"04",0,0,0,0,0,0,1037623,"2023-10-28T00:00:00.000Z",6,FALSE,12,56677872,"G",6,6,"Cleveland Cavaliers","Craig Porter",0,0,1,1,1,1.5
2,0,1,0,0,3,2,0,0,"08",4,0,4,5,0,0,1037623,"2023-10-28T00:00:00.000Z",6,FALSE,12,444,"C-F",6,6,"Cleveland Cavaliers","Tristan Thompson",0,9,11,6,7,13
0,0,0,0,0,0,0,0,0,"00",0,0,0,0,0,0,1037623,"2023-10-28T00:00:00.000Z",6,FALSE,12,9,"C",6,6,"Cleveland Cavaliers","Jarrett Allen",0,0,0,0,0,0
0,0,0,0,0,0,0,0,0,"00",0,0,0,0,0,0,1037623,"2023-10-28T00:00:00.000Z",6,FALSE,12,666581,"G",6,6,"Cleveland Cavaliers","Darius Garland",0,0,0,0,0,0
0,0,0,0,0,0,0,0,0,"00",0,0,0,0,0,0,1037623,"2023-10-28T00:00:00.000Z",6,FALSE,12,666676,"G",6,6,"Cleveland Cavaliers","Ty Jerome",0,0,0,0,0,0
0,0,0,0,0,0,0,0,0,"00",0,0,0,0,0,0,1037623,"2023-10-28T00:00:00.000Z",6,FALSE,12,322,"G",6,6,"Cleveland Cavaliers","Donovan Mitchell",0,0,0,0,0,0
0,0,0,0,0,0,0,0,0,"00",0,0,0,0,0,0,1037623,"2023-10-28T00:00:00.000Z",6,FALSE,12,404,"G",6,6,"Cleveland Cavaliers","Ricky Rubio",0,0,0,0,0,0
1,0,0,3,1,10,5,3,2,"17",0,0,13,0,0,0,1037623,"2023-10-28T00:00:00.000Z",6,FALSE,12,38017686,"G-F",12,12,"Indiana Pacers","Bennedict Mathurin",0,13,14,14,1,14.5
0,1,2,1,0,5,2,0,0,"18",2,1,4,4,0,1,1037623,"2023-10-28T00:00:00.000Z",6,FALSE,12,3547243,"F",12,12,"Indiana Pacers","Obi Toppin",1,8,8,4,4,10.8
1,2,11,5,1,14,7,5,5,"29",1,5,20,12,0,2,1037623,"2023-10-28T00:00:00.000Z",6,FALSE,12,452,"C-F",12,12,"Indiana Pacers","Myles Turner",2,32,33,21,13,39.9
2,0,4,1,0,8,3,0,0,"32",0,3,6,4,1,0,1037623,"2023-10-28T00:00:00.000Z",6,FALSE,12,69,"G",12,12,"Indiana Pacers","Bruce Brown",1,10,12,8,6,16.8
13,0,7,7,4,16,7,3,3,"32",1,2,21,8,0,1,1037623,"2023-10-28T00:00:00.000Z",6,FALSE,12,3547245,"G",12,12,"Indiana Pacers","Tyrese Haliburton",0,29,42,34,21,49.1
0,0,0,0,0,0,0,0,0,"00",0,0,0,0,0,0,1037623,"2023-10-28T00:00:00.000Z",6,FALSE,12,17896035,"F",12,12,"Indiana Pacers","Isaiah Jackson",0,0,0,0,0,0
8,0,1,0,0,5,3,2,2,"19",1,1,8,2,0,0,1037623,"2023-10-28T00:00:00.000Z",6,FALSE,12,304,"G",12,12,"Indiana Pacers","T.J. McConnell",0,10,18,16,10,22.4
4,0,2,2,0,5,2,0,0,"25",0,4,4,2,2,1,1037623,"2023-10-28T00:00:00.000Z",6,FALSE,12,38017507,"G-F",12,12,"Indiana Pacers","Andrew Nembhard",2,6,10,8,6,17.4
0,0,5,9,5,16,10,2,1,"30",4,1,26,9,0,0,1037623,"2023-10-28T00:00:00.000Z",6,FALSE,12,3547250,"G-F",12,12,"Indiana Pacers","Aaron Nesmith",0,35,35,26,9,36.8
0,0,0,0,0,0,0,0,0,"00",0,0,0,0,0,0,1037623,"2023-10-28T00:00:00.000Z",6,FALSE,12,3547207,"F",12,12,"Indiana Pacers","Jordan Nwora",0,0,0,0,0,0
0,0,0,0,0,0,0,0,0,"00",0,0,0,0,0,0,1037623,"2023-10-28T00:00:00.000Z",6,FALSE,12,56677861,"G",12,12,"Indiana Pacers","Ben Sheppard",0,0,0,0,0,0
3,0,4,3,2,7,5,2,1,"19",2,2,13,6,0,1,1037623,"2023-10-28T00:00:00.000Z",6,FALSE,12,3547264,"F-C",12,12,"Indiana Pacers","Jalen Smith",0,19,22,16,9,23.7
0,0,0,0,0,0,0,0,0,"00",0,0,0,0,0,0,1037623,"2023-10-28T00:00:00.000Z",6,FALSE,12,439,"F",13,12,"Indiana Pacers","Daniel Theis",0,0,0,0,0,0
0,0,0,0,0,0,0,0,0,"00",0,0,0,0,0,0,1037623,"2023-10-28T00:00:00.000Z",6,FALSE,12,56677832,"F",12,12,"Indiana Pacers","Jarace Walker",0,0,0,0,0,0
0,0,0,0,0,0,0,0,0,"00",0,0,0,0,0,0,1037623,"2023-10-28T00:00:00.000Z",6,FALSE,12,38017701,"G",12,12,"Indiana Pacers","Kendall Brown",0,0,0,0,0,0
0,0,0,0,0,0,0,0,0,"00",0,0,0,0,0,0,1037623,"2023-10-28T00:00:00.000Z",6,FALSE,12,56677778,"F-C",12,12,"Indiana Pacers","Oscar Tshiebwe",0,0,0,0,0,0
0,0,0,0,0,0,0,0,0,"00",0,0,0,0,0,0,1037623,"2023-10-28T00:00:00.000Z",6,FALSE,12,56677794,"G",12,12,"Indiana Pacers","Isaiah Wong",0,0,0,0,0,0
4,1,1,7,2,12,4,0,0,"19",0,1,10,1,0,1,1037623,"2023-10-28T00:00:00.000Z",6,FALSE,12,210,"G",12,12,"Indiana Pacers","Buddy Hield",1,11,15,14,5,19.2
5,2,7,5,2,16,11,0,0,"37",1,3,24,8,0,1,1037624,"2023-10-28T00:00:00.000Z",28,FALSE,23,17896055,"G-F",28,28,"Toronto Raptors","Scottie Barnes",2,32,37,29,13,46.1
4,1,6,5,2,8,3,4,3,"36",1,4,11,7,0,2,1037624,"2023-10-28T00:00:00.000Z",28,FALSE,23,416,"F",28,28,"Toronto Raptors","Pascal Siakam",1,18,22,15,11,26.4
3,1,6,0,0,5,2,3,2,"25",1,2,6,7,0,2,1037624,"2023-10-28T00:00:00.000Z",28,FALSE,23,373,"C",28,28,"Toronto Raptors","Jakob Poeltl",1,13,16,9,10,19.9
0,0,1,5,3,16,6,4,2,"33",1,0,17,2,1,1,1037624,"2023-10-28T00:00:00.000Z",28,FALSE,23,3089,"",28,28,"Toronto Raptors","Gary Trent Jr.",1,19,19,17,2,21.4
10,0,1,6,4,14,5,2,1,"35",3,1,15,4,2,1,1037624,"2023-10-28T00:00:00.000Z",28,FALSE,23,409,"G",28,28,"Toronto Raptors","Dennis Schroder",2,19,29,25,14,39.8
3,1,4,1,0,10,3,0,0,"18",3,1,6,7,0,1,1037624,"2023-10-28T00:00:00.000Z",28,FALSE,23,3547249,"F",28,28,"Toronto Raptors","Precious Achiuwa",1,13,16,9,10,20.9
1,0,0,6,4,8,5,2,2,"28",2,5,16,2,0,1,1037624,"2023-10-28T00:00:00.000Z",28,FALSE,23,56677828,"G",28,28,"Toronto Raptors","Gradey Dick",0,18,19,17,3,18.9
0,0,3,1,1,1,1,0,0,"21",0,3,3,3,0,1,1037624,"2023-10-28T00:00:00.000Z",28,FALSE,23,450,"F",13,23,"Philadelphia 76ers","PJ Tucker",0,6,6,3,3,5.6
8,2,9,3,1,21,14,6,5,"35",0,0,34,9,1,1,1037624,"2023-10-28T00:00:00.000Z",28,FALSE,23,145,"F-C",23,23,"Philadelphia 76ers","Joel Embiid",3,43,51,42,17,64.8
4,1,5,4,0,7,1,0,0,"32",0,2,2,5,1,2,1037624,"2023-10-28T00:00:00.000Z",28,FALSE,23,313,"G",23,23,"Philadelphia 76ers","De'Anthony Melton",2,7,11,6,9,18
7,1,5,9,7,20,12,3,3,"41",1,1,34,6,0,1,1037624,"2023-10-28T00:00:00.000Z",28,FALSE,23,3547254,"G",23,23,"Philadelphia 76ers","Tyrese Maxey",1,40,47,41,13,53.7
2,0,2,0,0,2,1,0,0,"17",3,2,2,5,0,1,1037624,"2023-10-28T00:00:00.000Z",28,FALSE,23,45,"G",23,23,"Philadelphia 76ers","Patrick Beverley",0,7,9,4,7,10
0,0,0,0,0,1,0,0,0,"05",0,1,0,0,0,0,1037624,"2023-10-28T00:00:00.000Z",28,FALSE,23,184,"G-F",23,23,"Philadelphia 76ers","Danny Green",0,0,0,0,0,0
0,1,2,1,0,3,1,0,0,"11",0,1,2,2,0,0,1037624,"2023-10-28T00:00:00.000Z",28,FALSE,23,2175,"",23,23,"Philadelphia 76ers","Danuel House Jr.",1,4,4,2,2,7.4
2,0,3,6,0,17,7,5,4,"29",2,3,18,5,3,0,1037624,"2023-10-28T00:00:00.000Z",28,FALSE,23,360,"F",23,23,"Philadelphia 76ers","Kelly Oubre Jr.",3,23,25,20,7,36
0,0,3,0,0,4,2,0,0,"13",2,4,4,5,1,1,1037624,"2023-10-28T00:00:00.000Z",28,FALSE,23,3547270,"F",23,23,"Philadelphia 76ers","Paul Reed",1,9,9,4,5,12
0,0,0,0,0,0,0,0,0,"00",0,0,0,0,0,0,1037624,"2023-10-28T00:00:00.000Z",28,FALSE,23,17554001,"G",23,23,"Philadelphia 76ers","Javonte Smart",0,0,0,0,0,0
0,0,0,0,0,0,0,0,0,"00",0,0,0,0,0,0,1037624,"2023-10-28T00:00:00.000Z",28,FALSE,23,56677788,"G",23,23,"Philadelphia 76ers","Terquavion Smith",0,0,0,0,0,0
0,0,0,0,0,0,0,0,0,"03",0,0,0,0,0,0,1037624,"2023-10-28T00:00:00.000Z",28,FALSE,23,666762,"F",28,28,"Toronto Raptors","Jalen McDaniels",0,0,0,0,0,0
0,0,0,0,0,0,0,0,0,"00",0,0,0,0,0,0,1037624,"2023-10-28T00:00:00.000Z",28,FALSE,23,376,"F",28,28,"Toronto Raptors","Otto Porter Jr.",0,0,0,0,0,0
0,0,0,0,0,0,0,0,0,"00",0,0,0,0,0,0,1037624,"2023-10-28T00:00:00.000Z",28,FALSE,23,436,"G-F",28,28,"Toronto Raptors","Garrett Temple",0,0,0,0,0,0
0,0,0,0,0,0,0,0,0,"00",0,0,0,0,0,0,1037624,"2023-10-28T00:00:00.000Z",28,FALSE,23,489,"F",28,28,"Toronto Raptors","Thaddeus Young",0,0,0,0,0,0
0,0,0,0,0,0,0,0,0,"00",0,0,0,0,0,0,1037624,"2023-10-28T00:00:00.000Z",28,FALSE,23,18,"F",28,28,"Toronto Raptors","OG Anunoby",0,0,0,0,0,0
0,0,0,0,0,0,0,0,0,"00",0,0,0,0,0,0,1037624,"2023-10-28T00:00:00.000Z",28,FALSE,23,38017717,"F",28,28,"Toronto Raptors","Ron Harper Jr.",0,0,0,0,0,0
0,0,0,0,0,0,0,0,0,"00",0,0,0,0,0,0,1037624,"2023-10-28T00:00:00.000Z",28,FALSE,23,38017710,"C",28,28,"Toronto Raptors","Christian Koloko",0,0,0,0,0,0
0,0,0,0,0,0,0,0,0,"00",0,0,0,0,0,0,1037624,"2023-10-28T00:00:00.000Z",28,FALSE,23,56677869,"G",28,28,"Toronto Raptors","Markquis Nowell",0,0,0,0,0,0
2,2,1,4,1,10,4,7,6,"36",1,1,15,2,2,2,1037624,"2023-10-28T00:00:00.000Z",28,FALSE,23,200,"F",23,23,"Philadelphia 76ers","Tobias Harris",4,17,19,17,4,30.4
0,0,0,0,0,0,0,0,0,"00",0,0,0,0,0,0,1037624,"2023-10-28T00:00:00.000Z",28,FALSE,23,17896025,"G",23,23,"Philadelphia 76ers","Jaden Springer",0,0,0,0,0,0
0,0,0,0,0,0,0,0,0,"00",0,0,0,0,0,0,1037624,"2023-10-28T00:00:00.000Z",28,FALSE,23,56913527,"G",23,23,"Philadelphia 76ers","Ricky Council IV",0,0,0,0,0,0
0,0,0,0,0,0,0,0,0,"00",0,0,0,0,0,0,1037624,"2023-10-28T00:00:00.000Z",28,FALSE,23,192,"G",13,23,"Philadelphia 76ers","James Harden",0,0,0,0,0,0
0,0,0,0,0,0,0,0,0,"00",0,0,0,0,0,0,1037624,"2023-10-28T00:00:00.000Z",28,FALSE,23,56677805,"G",28,28,"Toronto Raptors","Javon Freeman-Liberty",0,0,0,0,0,0
0,0,0,0,0,0,0,0,0,"00",0,0,0,0,0,0,1037624,"2023-10-28T00:00:00.000Z",28,FALSE,23,28,"C",23,23,"Philadelphia 76ers","Mo Bamba",0,0,0,0,0,0
0,0,0,0,0,0,0,0,0,"00",0,0,0,0,0,0,1037624,"2023-10-28T00:00:00.000Z",28,FALSE,23,260,"G-F",23,23,"Philadelphia 76ers","Furkan Korkmaz",0,0,0,0,0,0
0,0,0,0,0,0,0,0,0,"00",0,0,0,0,0,0,1037624,"2023-10-28T00:00:00.000Z",28,FALSE,23,17895941,"C",26,23,"Philadelphia 76ers","Filip Petrusev",0,0,0,0,0,0
2,0,0,2,2,4,2,1,1,"13",0,1,7,0,1,3,1037624,"2023-10-28T00:00:00.000Z",28,FALSE,23,3547275,"G",28,28,"Toronto Raptors","Malachi Flynn",1,7,9,9,2,10
0,0,3,2,0,6,1,3,3,"12",1,2,5,4,1,1,1037624,"2023-10-28T00:00:00.000Z",28,FALSE,23,58,"F",28,28,"Toronto Raptors","Chris Boucher",1,9,9,5,4,11.8
3,2,3,6,1,8,2,0,0,"23",0,3,5,3,1,3,1037625,"2023-10-28T00:00:00.000Z",18,FALSE,16,666400,"G",18,18,"Minnesota Timberwolves","Nickeil Alexander-Walker",3,8,11,8,6,19.1
2,0,10,4,1,12,5,2,1,"31",0,3,12,10,1,1,1037625,"2023-10-28T00:00:00.000Z",18,FALSE,16,447,"C",18,18,"Minnesota Timberwolves","Karl-Anthony Towns",1,22,24,14,12,29
1,0,10,0,0,9,7,0,0,"31",4,1,14,14,0,2,1037625,"2023-10-28T00:00:00.000Z",18,FALSE,16,176,"C",18,18,"Minnesota Timberwolves","Rudy Gobert",0,28,29,15,15,30.3
7,0,2,5,3,15,7,2,2,"33",0,3,19,2,1,2,1037625,"2023-10-28T00:00:00.000Z",18,FALSE,16,3547238,"G",18,18,"Minnesota Timberwolves","Anthony Edwards",1,21,28,26,9,32.9
5,0,2,6,2,10,6,0,0,"29",2,1,14,4,1,0,1037625,"2023-10-28T00:00:00.000Z",18,FALSE,16,104,"G",18,18,"Minnesota Timberwolves","Mike Conley",1,18,23,19,9,29.3
4,0,2,0,0,6,5,2,2,"23",0,1,12,2,2,2,1037625,"2023-10-28T00:00:00.000Z",18,FALSE,16,12,"F",18,18,"Minnesota Timberwolves","Kyle Anderson",2,14,18,16,6,24.4
1,0,2,0,0,4,2,2,1,"12",3,1,5,5,0,1,1037625,"2023-10-28T00:00:00.000Z",18,FALSE,16,74,"C",16,16,"Miami Heat","Thomas Bryant",0,10,11,6,6,11.5
0,0,2,3,0,8,4,0,0,"25",3,1,8,5,2,0,1037625,"2023-10-28T00:00:00.000Z",18,FALSE,16,38017734,"F",16,16,"Miami Heat","Jamal Cain",2,13,13,8,5,20
0,0,0,0,0,1,0,0,0,"02",0,0,0,0,0,0,1037625,"2023-10-28T00:00:00.000Z",18,FALSE,16,3547257,"G",16,16,"Miami Heat","R.J. Hampton",0,0,0,0,0,0
0,0,0,0,0,0,0,0,0,"00",0,0,0,0,0,0,1037625,"2023-10-28T00:00:00.000Z",18,FALSE,16,391,"G-F",16,16,"Miami Heat","Josh Richardson",0,0,0,0,0,0
1,0,2,10,2,12,3,0,0,"29",1,1,8,3,1,1,1037625,"2023-10-28T00:00:00.000Z",18,FALSE,16,397,"F",16,16,"Miami Heat","Duncan Robinson",1,11,12,9,4,15.1
0,1,1,0,0,2,0,0,0,"04",0,0,0,1,0,0,1037625,"2023-10-28T00:00:00.000Z",18,FALSE,16,39398582,"C",16,16,"Miami Heat","Orlando Robinson",1,1,1,0,1,4.2
4,0,1,1,1,4,2,0,0,"22",0,1,5,1,1,1,1037625,"2023-10-28T00:00:00.000Z",18,FALSE,16,19465585,"G",16,16,"Miami Heat","Dru Smith",1,6,10,9,5,14.2
0,0,1,2,1,3,2,0,0,"02",0,0,5,1,0,0,1037625,"2023-10-28T00:00:00.000Z",18,FALSE,16,38017736,"F",16,16,"Miami Heat","Cole Swider",0,6,6,5,1,6.2
0,0,0,0,0,0,0,0,0,"00",0,0,0,0,0,0,1037625,"2023-10-28T00:00:00.000Z",18,FALSE,16,79,"G-F",16,16,"Miami Heat","Jimmy Butler",0,0,0,0,0,0
0,0,0,0,0,0,0,0,0,"00",0,0,0,0,0,0,1037625,"2023-10-28T00:00:00.000Z",18,FALSE,16,3092,"",16,16,"Miami Heat","Haywood Highsmith",0,0,0,0,0,0
0,0,0,0,0,0,0,0,0,"00",0,0,0,0,0,0,1037625,"2023-10-28T00:00:00.000Z",18,FALSE,16,285,"F-C",16,16,"Miami Heat","Kevin Love",0,0,0,0,0,0
0,0,0,0,0,0,0,0,0,"00",0,0,0,0,0,0,1037625,"2023-10-28T00:00:00.000Z",18,FALSE,16,666747,"F",16,16,"Miami Heat","Caleb Martin",0,0,0,0,0,0
1,0,3,2,1,4,3,0,0,"18",0,0,7,3,0,3,1037625,"2023-10-28T00:00:00.000Z",18,FALSE,16,56677785,"G",16,16,"Miami Heat","Jaime Jaquez Jr.",0,10,11,8,4,9.1
4,0,11,4,2,6,3,0,0,"21",0,2,8,11,1,0,1037625,"2023-10-28T00:00:00.000Z",18,FALSE,16,38017696,"F",16,16,"Miami Heat","Nikola Jovic",1,19,23,12,15,30.2
2,0,2,1,0,14,7,10,5,"33",1,4,19,3,0,4,1037625,"2023-10-28T00:00:00.000Z",18,FALSE,16,4,"C-F",16,16,"Miami Heat","Bam Adebayo",0,22,24,21,5,21.6
4,0,5,11,4,23,8,2,2,"40",0,1,22,5,0,0,1037625,"2023-10-28T00:00:00.000Z",18,FALSE,16,666633,"G",16,16,"Miami Heat","Tyler Herro",0,27,31,26,9,34
7,0,3,5,1,6,1,0,0,"32",1,1,3,4,1,4,1037625,"2023-10-28T00:00:00.000Z",18,FALSE,16,286,"G",16,16,"Miami Heat","Kyle Lowry",1,7,14,10,11,17.3
2,0,1,2,0,4,1,1,0,"17",0,0,2,1,0,2,1037625,"2023-10-28T00:00:00.000Z",18,FALSE,16,320,"G",18,18,"Minnesota Timberwolves","Shake Milton",0,3,5,4,3,4.2
1,0,7,7,4,14,10,1,1,"28",1,3,25,8,2,0,1037625,"2023-10-28T00:00:00.000Z",18,FALSE,16,667378,"F-C",18,18,"Minnesota Timberwolves","Naz Reid",2,33,34,26,9,42.1
1,0,2,2,0,2,0,0,0,"15",0,1,0,2,1,2,1037625,"2023-10-28T00:00:00.000Z",18,FALSE,16,68,"F",18,18,"Minnesota Timberwolves","Troy Brown Jr.",1,2,3,1,3,4.9
4,0,0,1,1,3,1,0,0,"06",0,1,3,0,0,0,1037625,"2023-10-28T00:00:00.000Z",18,FALSE,16,666767,"G",18,18,"Minnesota Timberwolves","Jordan McLaughlin",0,3,7,7,4,9
0,0,1,0,0,1,0,0,0,"02",0,0,0,1,0,0,1037625,"2023-10-28T00:00:00.000Z",18,FALSE,16,56677782,"F",18,18,"Minnesota Timberwolves","Leonard Miller",0,1,1,0,1,1.2
0,1,0,1,0,2,0,0,0,"02",0,0,0,0,0,0,1037625,"2023-10-28T00:00:00.000Z",18,FALSE,16,38017715,"F",18,18,"Minnesota Timberwolves","Josh Minott",1,0,0,0,0,3
0,0,0,0,0,0,0,0,0,"00",0,0,0,0,0,0,1037625,"2023-10-28T00:00:00.000Z",18,FALSE,16,38017700,"G",18,18,"Minnesota Timberwolves","Wendell Moore Jr.",0,0,0,0,0,0
0,0,0,0,0,0,0,0,0,"00",0,0,0,0,0,0,1037625,"2023-10-28T00:00:00.000Z",18,FALSE,16,56677851,"G",18,18,"Minnesota Timberwolves","Jaylen Clark",0,0,0,0,0,0
0,0,0,0,0,0,0,0,0,"00",0,0,0,0,0,0,1037625,"2023-10-28T00:00:00.000Z",18,FALSE,16,17896056,"C",18,18,"Minnesota Timberwolves","Luka Garza",0,0,0,0,0,0
0,0,0,0,0,0,0,0,0,"00",0,0,0,0,0,0,1037625,"2023-10-28T00:00:00.000Z",18,FALSE,16,3547259,"F",18,18,"Minnesota Timberwolves","Jaden McDaniels",0,0,0,0,0,0
0,0,0,0,0,0,0,0,0,"00",0,0,0,0,0,0,1037625,"2023-10-28T00:00:00.000Z",18,FALSE,16,17895968,"F",18,18,"Minnesota Timberwolves","Daishen Nix",0,0,0,0,0,0
0,2,1,0,0,0,0,0,0,"04",0,0,0,1,0,2,1037626,"2023-10-28T00:00:00.000Z",24,FALSE,29,666451,"C",24,24,"Phoenix Suns","Bol Bol",2,1,1,0,1,5.2
2,2,3,0,0,7,6,0,0,"19",2,3,12,5,0,0,1037626,"2023-10-28T00:00:00.000Z",24,FALSE,29,147,"F",24,24,"Phoenix Suns","Drew Eubanks",2,17,19,14,7,27
5,0,3,5,2,9,2,6,6,"25",2,2,12,5,1,2,1037626,"2023-10-28T00:00:00.000Z",24,FALSE,29,18678058,"",24,24,"Phoenix Suns","Jordan Goodwin",1,17,22,17,10,26.5
2,1,0,1,0,2,1,0,0,"04",0,0,2,0,0,0,1037626,"2023-10-28T00:00:00.000Z",24,FALSE,29,3547298,"G",24,24,"Phoenix Suns","Saben Lee",1,2,4,4,2,8
0,0,1,5,0,8,3,0,0,"21",0,2,6,1,1,0,1037626,"2023-10-28T00:00:00.000Z",24,FALSE,29,666729,"F",24,24,"Phoenix Suns","Nassir Little",1,7,7,6,1,10.2
1,0,1,0,0,2,1,0,0,"03",0,0,2,1,0,0,1037626,"2023-10-28T00:00:00.000Z",24,FALSE,29,314,"F",24,24,"Phoenix Suns","Chimezie Metu",0,3,4,3,2,4.7
0,1,3,4,1,7,2,2,2,"20",1,2,7,4,2,0,1037626,"2023-10-28T00:00:00.000Z",24,FALSE,29,470,"G",24,24,"Phoenix Suns","Yuta Watanabe",3,11,11,7,4,20.8
0,0,0,0,0,0,0,0,0,"00",0,0,0,0,0,0,1037626,"2023-10-28T00:00:00.000Z",24,FALSE,29,37,"G",24,24,"Phoenix Suns","Bradley Beal",0,0,0,0,0,0
0,0,0,0,0,0,0,0,0,"00",0,0,0,0,0,0,1037626,"2023-10-28T00:00:00.000Z",24,FALSE,29,57,"G",24,24,"Phoenix Suns","Devin Booker",0,0,0,0,0,0
0,0,0,0,0,0,0,0,0,"00",0,0,0,0,0,0,1037626,"2023-10-28T00:00:00.000Z",24,FALSE,29,272,"G",24,24,"Phoenix Suns","Damion Lee",0,0,0,0,0,0
0,0,1,2,0,4,2,3,3,"23",0,3,7,1,0,0,1037626,"2023-10-28T00:00:00.000Z",24,FALSE,29,356,"G",24,24,"Phoenix Suns","Josh Okogie",0,8,8,7,1,8.2
7,1,4,4,1,11,8,9,9,"29",0,1,26,4,1,2,1037626,"2023-10-28T00:00:00.000Z",24,FALSE,29,140,"F",24,24,"Phoenix Suns","Kevin Durant",2,30,37,33,11,45.3
6,1,5,2,0,8,3,6,4,"23",2,3,10,7,2,2,1037626,"2023-10-28T00:00:00.000Z",24,FALSE,29,349,"C",24,24,"Phoenix Suns","Jusuf Nurkic",3,17,23,16,13,34.4
4,0,2,7,3,14,9,0,0,"26",0,1,21,2,1,0,1037626,"2023-10-28T00:00:00.000Z",24,FALSE,29,178,"G",24,24,"Phoenix Suns","Eric Gordon",1,23,27,25,6,32.4
3,0,4,7,3,10,6,2,2,"31",0,2,17,4,2,3,1037626,"2023-10-28T00:00:00.000Z",24,FALSE,29,8,"G",24,24,"Phoenix Suns","Grayson Allen",2,21,24,20,7,29.3
0,0,3,0,0,1,1,0,0,"06",0,0,2,3,0,0,1037626,"2023-10-28T00:00:00.000Z",24,FALSE,29,3547095,"C-F",24,24,"Phoenix Suns","Udoka Azubuike",0,5,5,2,3,5.6
1,0,1,0,0,2,1,0,0,"06",0,0,2,1,0,0,1037626,"2023-10-28T00:00:00.000Z",24,FALSE,29,32,"F",24,24,"Phoenix Suns","Keita Bates-Diop",0,3,4,3,2,4.7
3,0,5,3,1,9,5,0,0,"28",5,3,11,10,0,1,1037626,"2023-10-28T00:00:00.000Z",24,FALSE,29,101,"F-C",29,29,"Utah Jazz","John Collins",0,21,24,14,13,26.5
0,2,3,7,5,13,7,0,0,"28",0,1,19,3,1,1,1037626,"2023-10-28T00:00:00.000Z",24,FALSE,29,297,"F",29,29,"Utah Jazz","Lauri Markkanen",3,22,22,19,3,30.6
1,1,3,2,0,4,1,0,0,"24",2,3,2,5,0,3,1037626,"2023-10-28T00:00:00.000Z",24,FALSE,29,38017705,"C",29,29,"Utah Jazz","Walker Kessler",1,7,8,3,6,9.5
2,0,1,3,0,10,3,1,1,"22",1,3,7,2,0,5,1037626,"2023-10-28T00:00:00.000Z",24,FALSE,29,100,"G",29,29,"Utah Jazz","Jordan Clarkson",0,9,11,9,4,7.4
1,0,0,3,0,7,1,4,2,"16",0,4,4,0,1,0,1037626,"2023-10-28T00:00:00.000Z",24,FALSE,29,666650,"G",29,29,"Utah Jazz","Talen Horton-Tucker",1,4,5,5,1,8.5
0,1,0,1,0,1,0,0,0,"06",0,0,0,0,0,0,1037626,"2023-10-28T00:00:00.000Z",24,FALSE,29,38017620,"G",29,29,"Utah Jazz","Ochai Agbaji",1,0,0,0,0,3
3,0,2,1,0,7,2,0,0,"20",0,2,4,2,2,1,1037626,"2023-10-28T00:00:00.000Z",24,FALSE,29,139,"G",29,29,"Utah Jazz","Kris Dunn",2,6,9,7,5,15.9
0,1,2,6,3,8,5,0,0,"18",1,1,13,3,0,2,1037626,"2023-10-28T00:00:00.000Z",24,FALSE,29,38017739,"F",29,29,"Utah Jazz","Simone Fontecchio",1,16,16,13,3,17.6
6,0,5,8,2,12,4,2,2,"27",2,0,12,7,1,2,1037626,"2023-10-28T00:00:00.000Z",24,FALSE,29,56677834,"G",29,29,"Utah Jazz","Keyonte George",1,19,25,18,13,30.4
3,0,4,1,0,5,4,1,1,"16",2,2,9,6,0,1,1037626,"2023-10-28T00:00:00.000Z",24,FALSE,29,358,"F",29,29,"Utah Jazz","Kelly Olynyk",0,15,18,12,9,19.7
0,0,1,1,1,5,2,0,0,"06",1,0,5,2,1,0,1037626,"2023-10-28T00:00:00.000Z",24,FALSE,29,666881,"F",29,29,"Utah Jazz","Luka Samanic",1,7,7,5,2,10.4
6,0,1,0,0,8,4,6,6,"23",1,1,14,2,0,2,1037626,"2023-10-28T00:00:00.000Z",24,FALSE,29,413,"G",29,29,"Utah Jazz","Collin Sexton",0,16,22,20,8,23.4
1,0,3,1,0,3,2,0,0,"06",1,0,4,4,0,0,1037626,"2023-10-28T00:00:00.000Z",24,FALSE,29,11891374,"C",29,29,"Utah Jazz","Omer Yurtseven",0,8,9,5,5,10.3
0,0,0,0,0,0,0,0,0,"00",0,0,0,0,0,0,1037626,"2023-10-28T00:00:00.000Z",24,FALSE,29,17896023,"G",29,29,"Utah Jazz","Josh Christopher",0,0,0,0,0,0
0,0,0,0,0,0,0,0,0,"00",0,0,0,0,0,0,1037626,"2023-10-28T00:00:00.000Z",24,FALSE,29,56677824,"F",29,29,"Utah Jazz","Taylor Hendricks",0,0,0,0,0,0
0,0,0,0,0,0,0,0,0,"00",0,0,0,0,0,0,1037626,"2023-10-28T00:00:00.000Z",24,FALSE,29,38017630,"G",29,29,"Utah Jazz","Johnny Juzang",0,0,0,0,0,0
0,0,0,0,0,0,0,0,0,"00",0,0,0,0,0,0,1037626,"2023-10-28T00:00:00.000Z",24,FALSE,29,19465584,"F",29,29,"Utah Jazz","Micah Potter",0,0,0,0,0,0
0,0,0,0,0,0,0,0,0,"00",0,0,0,0,0,0,1037626,"2023-10-28T00:00:00.000Z",24,FALSE,29,56677842,"F",29,29,"Utah Jazz","Brice Sensabaugh",0,0,0,0,0,0
0,1,0,5,1,7,3,3,3,"21",1,2,10,1,1,0,1037627,"2023-10-29T00:00:00.000Z",21,FALSE,8,666541,"G",21,21,"Oklahoma City Thunder","Luguentz Dort",2,11,11,10,1,17.2
5,1,3,1,0,9,6,1,1,"28",0,2,13,3,0,0,1037627,"2023-10-29T00:00:00.000Z",21,FALSE,8,38017703,"G-F",21,21,"Oklahoma City Thunder","Jalen Williams",1,16,21,18,8,27.1
0,0,2,4,1,12,7,4,4,"26",2,2,19,4,0,1,1037627,"2023-10-29T00:00:00.000Z",21,FALSE,8,38017685,"C-F",21,21,"Oklahoma City Thunder","Chet Holmgren",0,23,23,19,4,22.8
3,0,1,2,1,13,4,0,0,"22",1,0,9,2,1,2,1037627,"2023-10-29T00:00:00.000Z",21,FALSE,8,17896065,"G",21,21,"Oklahoma City Thunder","Josh Giddey",1,11,14,12,5,16.9
7,0,3,4,0,16,2,4,3,"28",1,2,7,4,1,0,1037627,"2023-10-29T00:00:00.000Z",21,FALSE,8,175,"G",21,21,"Oklahoma City Thunder","Shai Gilgeous-Alexander",1,11,18,14,11,25.3
0,0,0,0,0,0,0,0,0,"00",0,0,0,0,0,0,1037627,"2023-10-29T00:00:00.000Z",21,FALSE,8,44,"F",21,21,"Oklahoma City Thunder","Davis Bertans",0,0,0,0,0,0
1,0,5,5,0,8,2,1,1,"19",0,0,5,5,0,0,1037627,"2023-10-29T00:00:00.000Z",21,FALSE,8,38017716,"F",21,21,"Oklahoma City Thunder","Ousmane Dieng",0,10,11,6,6,12.5
1,0,2,4,1,7,2,0,0,"17",0,3,5,2,4,1,1037627,"2023-10-29T00:00:00.000Z",21,FALSE,8,3547272,"G",21,21,"Oklahoma City Thunder","Isaiah Joe",4,7,8,6,3,19.9
0,0,0,0,0,1,0,0,0,"06",0,0,0,0,0,0,1037627,"2023-10-29T00:00:00.000Z",21,FALSE,8,56677853,"F",21,21,"Oklahoma City Thunder","Keyontae Johnson",0,0,0,0,0,0
1,0,3,2,1,7,5,1,1,"08",1,0,12,4,0,1,1037627,"2023-10-29T00:00:00.000Z",21,FALSE,8,17896036,"G",21,21,"Oklahoma City Thunder","Tre Mann",0,16,17,13,5,17.3
3,0,0,2,0,3,1,0,0,"14",0,1,2,0,0,2,1037627,"2023-10-29T00:00:00.000Z",21,FALSE,8,4197029,"G",21,21,"Oklahoma City Thunder","Vasilije Micic",0,2,5,5,3,4.5
0,1,1,1,0,1,0,2,1,"14",0,1,1,1,0,2,1037627,"2023-10-29T00:00:00.000Z",21,FALSE,8,3547271,"C",21,21,"Oklahoma City Thunder","Aleksej Pokusevski",1,2,2,1,1,3.2
0,0,0,0,0,0,0,0,0,"05",0,0,0,0,0,0,1037627,"2023-10-29T00:00:00.000Z",21,FALSE,8,24572055,"C",21,21,"Oklahoma City Thunder","Olivier Sarr",0,0,0,0,0,0
1,1,2,1,1,3,3,0,0,"22",1,1,7,3,1,0,1037627,"2023-10-29T00:00:00.000Z",21,FALSE,8,56677833,"G",21,21,"Oklahoma City Thunder","Cason Wallace",2,10,11,8,4,18.1
0,0,0,1,0,3,2,2,1,"10",0,0,5,0,0,0,1037627,"2023-10-29T00:00:00.000Z",21,FALSE,8,17896078,"G",21,21,"Oklahoma City Thunder","Aaron Wiggins",0,5,5,5,0,5
0,0,0,0,0,0,0,0,0,"00",0,0,0,0,0,0,1037627,"2023-10-29T00:00:00.000Z",21,FALSE,8,27924547,"F",21,21,"Oklahoma City Thunder","Lindy Waters III",0,0,0,0,0,0
0,0,0,0,0,0,0,0,0,"00",0,0,0,0,0,0,1037627,"2023-10-29T00:00:00.000Z",21,FALSE,8,38017706,"F",21,21,"Oklahoma City Thunder","Jaylin Williams",0,0,0,0,0,0
0,0,0,0,0,0,0,0,0,"00",0,0,0,0,0,0,1037627,"2023-10-29T00:00:00.000Z",21,FALSE,8,480,"G-F",21,21,"Oklahoma City Thunder","Kenrich Williams",0,0,0,0,0,0
2,0,6,7,4,14,8,0,0,"25",3,3,20,9,0,1,1037627,"2023-10-29T00:00:00.000Z",21,FALSE,8,375,"F",8,8,"Denver Nuggets","Michael Porter Jr.",0,29,31,22,11,32.8
2,3,2,1,0,7,4,3,1,"23",1,1,9,3,1,1,1037627,"2023-10-29T00:00:00.000Z",21,FALSE,8,177,"F",8,8,"Denver Nuggets","Aaron Gordon",4,12,14,11,5,26.6
5,0,12,2,1,16,12,3,3,"30",2,3,28,14,0,4,1037627,"2023-10-29T00:00:00.000Z",21,FALSE,8,246,"C",8,8,"Denver Nuggets","Nikola Jokic",0,42,47,33,19,48.3
1,0,3,4,1,5,2,2,2,"30",0,2,7,3,2,1,1037627,"2023-10-29T00:00:00.000Z",21,FALSE,8,81,"G",8,8,"Denver Nuggets","Kentavious Caldwell-Pope",2,10,11,8,4,17.1
8,0,1,1,1,14,9,0,0,"30",1,1,19,2,0,4,1037627,"2023-10-29T00:00:00.000Z",21,FALSE,8,335,"G",8,8,"Denver Nuggets","Jamal Murray",0,21,29,27,10,29.4
7,1,6,2,0,9,4,5,5,"21",1,2,13,7,1,0,1037627,"2023-10-29T00:00:00.000Z",21,FALSE,8,38017709,"G",8,8,"Denver Nuggets","Christian Braun",2,20,27,20,14,37.9
0,0,0,1,0,1,0,0,0,"05",0,1,0,0,1,0,1037627,"2023-10-29T00:00:00.000Z",21,FALSE,8,38017727,"G",8,8,"Denver Nuggets","Collin Gillespie",1,0,0,0,0,3
0,0,0,0,0,0,0,0,0,"03",0,0,0,0,0,0,1037627,"2023-10-29T00:00:00.000Z",21,FALSE,8,215,"F-G",8,8,"Denver Nuggets","Justin Holiday",0,0,0,0,0,0
6,0,0,2,1,3,2,0,0,"22",0,4,5,0,2,2,1037627,"2023-10-29T00:00:00.000Z",21,FALSE,8,236,"G",8,8,"Denver Nuggets","Reggie Jackson",2,5,11,11,6,18
0,0,0,0,0,0,0,0,0,"00",0,0,0,0,0,0,1037627,"2023-10-29T00:00:00.000Z",21,FALSE,8,250,"C",8,8,"Denver Nuggets","DeAndre Jordan",0,0,0,0,0,0
0,0,1,1,0,2,1,0,0,"03",0,0,2,1,0,0,1037627,"2023-10-29T00:00:00.000Z",21,FALSE,8,17896007,"G",8,8,"Denver Nuggets","Braxton Key",0,3,3,2,1,3.2
1,0,2,0,0,1,0,0,0,"15",1,2,0,3,0,0,1037627,"2023-10-29T00:00:00.000Z",21,FALSE,8,3547268,"F-C",8,8,"Denver Nuggets","Zeke Nnaji",0,3,4,1,4,5.1
1,0,1,3,2,5,3,0,0,"08",0,0,8,1,0,0,1037627,"2023-10-29T00:00:00.000Z",21,FALSE,8,56677776,"G",8,8,"Denver Nuggets","Julian Strawther",0,9,10,9,2,10.7
0,0,1,0,0,0,0,0,0,"03",0,1,0,1,0,0,1037627,"2023-10-29T00:00:00.000Z",21,FALSE,8,56677871,"F",8,8,"Denver Nuggets","Hunter Tyson",0,1,1,0,1,1.2
1,1,3,3,1,11,8,0,0,"22",1,1,17,4,1,0,1037627,"2023-10-29T00:00:00.000Z",21,FALSE,8,38017721,"G",8,8,"Denver Nuggets","Peyton Watson",2,21,22,18,5,29.3
0,0,0,0,0,0,0,0,0,"00",0,0,0,0,0,0,1037627,"2023-10-29T00:00:00.000Z",21,FALSE,8,666489,"F",8,8,"Denver Nuggets","Vlatko Cancar",0,0,0,0,0,0
0,0,0,0,0,0,0,0,0,"00",0,0,0,0,0,0,1037627,"2023-10-29T00:00:00.000Z",21,FALSE,8,17896103,"F-C",8,8,"Denver Nuggets","Jay Huff",0,0,0,0,0,0
0,0,0,0,0,0,0,0,0,"00",0,0,0,0,0,0,1037627,"2023-10-29T00:00:00.000Z",21,FALSE,8,56677582,"G",8,8,"Denver Nuggets","Jalen Pickett",0,0,0,0,0,0
2,0,4,5,2,10,4,2,2,"34",0,5,12,4,0,0,1037628,"2023-10-29T00:00:00.000Z",11,FALSE,10,66,"G-F",11,11,"Houston Rockets","Dillon Brooks",0,16,18,14,6,19.8
5,0,6,6,2,12,6,0,0,"34",2,3,14,8,2,1,1037628,"2023-10-29T00:00:00.000Z",11,FALSE,10,38017684,"F",11,11,"Houston Rockets","Jabari Smith Jr.",2,22,27,19,13,36.1
7,0,1,2,1,15,7,4,4,"33",4,3,19,5,0,0,1037628,"2023-10-29T00:00:00.000Z",11,FALSE,10,17896062,"F-C",11,11,"Houston Rockets","Alperen Sengun",0,24,31,26,12,35.5
1,1,8,5,1,20,8,5,4,"38",1,1,21,9,0,4,1037628,"2023-10-29T00:00:00.000Z",11,FALSE,10,17895966,"G",11,11,"Houston Rockets","Jalen Green",1,30,31,22,10,32.3
4,0,0,7,2,13,2,2,2,"32",0,2,8,0,2,0,1037628,"2023-10-29T00:00:00.000Z",11,FALSE,10,458,"G",11,11,"Houston Rockets","Fred VanVleet",2,8,12,12,4,20
0,0,1,2,0,2,0,0,0,"06",0,1,0,1,0,1,1037628,"2023-10-29T00:00:00.000Z",11,FALSE,10,75,"G-F",11,11,"Houston Rockets","Reggie Bullock",0,1,1,0,1,0.2
0,0,0,0,0,0,0,0,0,"00",0,0,0,0,0,0,1037628,"2023-10-29T00:00:00.000Z",11,FALSE,10,38017695,"F",11,11,"Houston Rockets","Tari Eason",0,0,0,0,0,0
2,1,2,2,0,7,2,2,2,"21",1,0,6,3,0,0,1037628,"2023-10-29T00:00:00.000Z",11,FALSE,10,188,"F",11,11,"Houston Rockets","Jeff Green",1,9,11,8,5,15.6
0,0,0,0,0,0,0,0,0,"00",0,0,0,0,0,0,1037628,"2023-10-29T00:00:00.000Z",11,FALSE,10,213,"G",11,11,"Houston Rockets","Aaron Holiday",0,0,0,0,0,0
0,0,0,0,0,0,0,0,0,"00",0,0,0,0,0,0,1037628,"2023-10-29T00:00:00.000Z",11,FALSE,10,296,"C",11,11,"Houston Rockets","Boban Marjanovic",0,0,0,0,0,0
0,0,0,0,0,0,0,0,0,"00",0,0,0,0,0,0,1037628,"2023-10-29T00:00:00.000Z",11,FALSE,10,56677809,"F",11,11,"Houston Rockets","Jermaine Samuels Jr.",0,0,0,0,0,0
1,2,6,2,0,6,2,2,2,"22",2,2,6,8,2,1,1037628,"2023-10-29T00:00:00.000Z",11,FALSE,10,3547301,"F",11,11,"Houston Rockets","Jae'Sean Tate",4,14,15,7,9,28.1
0,0,4,2,1,5,3,2,2,"20",0,3,9,4,1,0,1037628,"2023-10-29T00:00:00.000Z",11,FALSE,10,56677825,"G-F",11,11,"Houston Rockets","Amen Thompson",1,13,13,9,4,16.8
0,0,0,0,0,0,0,0,0,"00",0,0,0,0,0,0,1037628,"2023-10-29T00:00:00.000Z",11,FALSE,10,56677831,"F",11,11,"Houston Rockets","Cam Whitmore",0,0,0,0,0,0
0,0,0,0,0,0,0,0,0,"00",0,0,0,0,0,0,1037628,"2023-10-29T00:00:00.000Z",11,FALSE,10,47738533,"G",11,11,"Houston Rockets","Jeenathan Williams",0,0,0,0,0,0
0,0,0,0,0,0,0,0,0,"00",0,0,0,0,0,0,1037628,"2023-10-29T00:00:00.000Z",11,FALSE,10,3547281,"G-F",11,11,"Houston Rockets","Nate Hinton",0,0,0,0,0,0
0,0,0,0,0,0,0,0,0,"00",0,0,0,0,0,0,1037628,"2023-10-29T00:00:00.000Z",11,FALSE,10,19465326,"C",11,11,"Houston Rockets","Jock Landale",0,0,0,0,0,0
0,0,0,0,0,0,0,0,0,"00",0,0,0,0,0,0,1037628,"2023-10-29T00:00:00.000Z",11,FALSE,10,357,"G",11,11,"Houston Rockets","Victor Oladipo",0,0,0,0,0,0
0,0,0,3,1,10,4,5,4,"28",0,2,13,0,0,2,1037628,"2023-10-29T00:00:00.000Z",11,FALSE,10,475,"F-G",10,10,"Golden State Warriors","Andrew Wiggins",0,13,13,13,0,11
5,0,4,0,0,4,2,1,0,"21",1,3,4,5,0,4,1037628,"2023-10-29T00:00:00.000Z",11,FALSE,10,185,"F",10,10,"Golden State Warriors","Draymond Green",0,9,14,9,10,13.5
1,1,9,0,0,3,2,2,1,"27",2,2,5,11,1,1,1037628,"2023-10-29T00:00:00.000Z",11,FALSE,10,282,"F",10,10,"Golden State Warriors","Kevon Looney",2,16,17,6,12,24.7
0,1,3,10,5,12,7,0,0,"29",1,3,19,4,0,1,1037628,"2023-10-29T00:00:00.000Z",11,FALSE,10,443,"G",10,10,"Golden State Warriors","Klay Thompson",1,23,23,19,4,25.8
6,1,6,14,6,16,6,6,6,"31",1,1,24,7,0,1,1037628,"2023-10-29T00:00:00.000Z",11,FALSE,10,115,"G",10,10,"Golden State Warriors","Stephen Curry",1,31,37,30,13,43.4
0,0,0,0,0,0,0,0,0,"00",0,0,0,0,0,0,1037628,"2023-10-29T00:00:00.000Z",11,FALSE,10,56677799,"F",10,10,"Golden State Warriors","Trayce Jackson-Davis",0,0,0,0,0,0
0,0,0,0,0,0,0,0,0,"00",0,0,0,0,0,0,1037628,"2023-10-29T00:00:00.000Z",11,FALSE,10,251,"G",10,10,"Golden State Warriors","Cory Joseph",0,0,0,0,0,0
1,0,2,3,1,8,3,3,2,"19",0,4,9,2,1,3,1037628,"2023-10-29T00:00:00.000Z",11,FALSE,10,17553979,"F",10,10,"Golden State Warriors","Jonathan Kuminga",1,11,12,10,3,12.9
1,1,3,5,1,6,1,2,2,"18",0,1,5,3,0,0,1037628,"2023-10-29T00:00:00.000Z",11,FALSE,10,17553992,"G",10,10,"Golden State Warriors","Moses Moody",1,8,9,6,4,13.1
7,0,5,3,0,8,3,2,2,"27",0,1,8,5,1,1,1037628,"2023-10-29T00:00:00.000Z",11,FALSE,10,367,"G",10,10,"Golden State Warriors","Chris Paul",1,13,20,15,12,26.5
1,1,4,4,3,8,6,0,0,"19",0,1,15,4,3,0,1037628,"2023-10-29T00:00:00.000Z",11,FALSE,10,2189,"",10,10,"Golden State Warriors","Gary Payton II",4,19,20,16,5,33.3
0,0,0,0,0,0,0,0,0,"00",0,0,0,0,0,0,1037628,"2023-10-29T00:00:00.000Z",11,FALSE,10,56677858,"G",10,10,"Golden State Warriors","Brandin Podziemski",0,0,0,0,0,0
5,1,5,3,1,6,1,2,1,"21",3,0,4,8,0,1,1037628,"2023-10-29T00:00:00.000Z",11,FALSE,10,407,"F",10,10,"Golden State Warriors","Dario Saric",1,12,17,9,13,23.1
0,0,0,0,0,0,0,0,0,"00",0,0,0,0,0,0,1037628,"2023-10-29T00:00:00.000Z",11,FALSE,10,17896070,"F",10,10,"Golden State Warriors","Usman Garuba",0,0,0,0,0,0
0,0,0,0,0,0,0,0,0,"00",0,0,0,0,0,0,1037628,"2023-10-29T00:00:00.000Z",11,FALSE,10,45658838,"G",10,10,"Golden State Warriors","Lester Quinones",0,0,0,0,0,0
0,0,0,0,0,0,0,0,0,"00",0,0,0,0,0,0,1037628,"2023-10-29T00:00:00.000Z",11,FALSE,10,398,"G",10,10,"Golden State Warriors","Jerome Robinson",0,0,0,0,0,0
3,1,3,3,0,4,1,0,0,"26",0,1,2,3,0,0,1037629,"2023-10-29T00:00:00.000Z",17,FALSE,1,112,"F",17,17,"Milwaukee Bucks","Jae Crowder",1,5,8,5,6,13.1
3,2,6,1,0,14,9,10,8,"29",5,2,26,11,1,3,1037629,"2023-10-29T00:00:00.000Z",17,FALSE,1,15,"F",17,17,"Milwaukee Bucks","Giannis Antetokounmpo",3,37,40,29,14,49.7
1,0,2,5,2,11,5,1,1,"20",1,0,13,3,1,0,1037629,"2023-10-29T00:00:00.000Z",17,FALSE,1,283,"C",17,17,"Milwaukee Bucks","Brook Lopez",1,16,17,14,4,21.1
1,0,3,10,4,12,6,4,2,"32",1,3,18,4,2,2,1037629,"2023-10-29T00:00:00.000Z",17,FALSE,1,38,"G",17,17,"Milwaukee Bucks","Malik Beasley",2,22,23,19,5,28.3
5,0,3,8,2,12,2,0,0,"29",1,2,6,4,2,6,1037629,"2023-10-29T00:00:00.000Z",17,FALSE,1,278,"G",17,17,"Milwaukee Bucks","Damian Lillard",2,10,15,11,9,18.3
0,0,0,2,2,5,3,0,0,"16",1,3,8,1,0,1,1037629,"2023-10-29T00:00:00.000Z",17,FALSE,1,38017676,"F",17,17,"Milwaukee Bucks","MarJon Beauchamp",0,9,9,8,1,8.2
2,0,2,6,1,9,2,0,0,"23",1,1,5,3,2,1,1037629,"2023-10-29T00:00:00.000Z",17,FALSE,1,105,"G",17,17,"Milwaukee Bucks","Pat Connaughton",2,8,10,7,5,16.6
1,0,1,3,2,3,2,0,0,"14",0,4,6,1,0,1,1037629,"2023-10-29T00:00:00.000Z",17,FALSE,1,368,"G",17,17,"Milwaukee Bucks","Cameron Payne",0,7,8,7,2,7.7
2,0,3,2,0,10,5,2,2,"21",1,2,12,4,0,3,1037629,"2023-10-29T00:00:00.000Z",17,FALSE,1,377,"F",17,17,"Milwaukee Bucks","Bobby Portis",0,16,18,14,6,16.8
5,1,1,5,1,12,6,2,2,"30",0,0,15,1,2,3,1037629,"2023-10-29T00:00:00.000Z",17,FALSE,1,334,"G",1,1,"Atlanta Hawks","Dejounte Murray",3,16,21,20,6,29.7
11,0,3,8,3,14,5,9,7,"32",0,1,20,3,1,3,1037629,"2023-10-29T00:00:00.000Z",17,FALSE,1,490,"G",1,1,"Atlanta Hawks","Trae Young",1,23,34,31,14,40.1
3,0,6,3,1,9,4,5,4,"31",3,0,13,9,0,1,1037629,"2023-10-29T00:00:00.000Z",17,FALSE,1,3547256,"F",1,1,"Atlanta Hawks","Saddiq Bey",0,22,25,16,12,27.3
6,0,1,7,4,10,6,1,1,"26",0,1,17,1,2,2,1037629,"2023-10-29T00:00:00.000Z",17,FALSE,1,53,"G",1,1,"Atlanta Hawks","Bogdan Bogdanovic",2,18,24,23,7,31.2
0,0,1,1,0,2,0,2,1,"03",1,0,1,2,0,0,1037629,"2023-10-29T00:00:00.000Z",17,FALSE,1,56677838,"G",1,1,"Atlanta Hawks","Kobe Bufkin",0,3,3,1,2,3.4
2,0,3,2,0,11,7,0,0,"23",4,4,14,7,1,1,1037629,"2023-10-29T00:00:00.000Z",17,FALSE,1,3547244,"F-C",1,1,"Atlanta Hawks","Onyeka Okongwu",1,21,23,16,9,27.4
1,1,6,3,2,10,6,0,0,"26",1,4,14,7,2,2,1037629,"2023-10-29T00:00:00.000Z",17,FALSE,1,17896040,"F",1,1,"Atlanta Hawks","Jalen Johnson",3,21,22,15,8,30.9
1,0,10,0,0,10,5,2,2,"23",2,1,12,12,1,0,1037629,"2023-10-29T00:00:00.000Z",17,FALSE,1,83,"C",1,1,"Atlanta Hawks","Clint Capela",1,24,25,13,13,30.9
0,0,0,0,0,0,0,0,0,"00",0,0,0,0,0,0,1037629,"2023-10-29T00:00:00.000Z",17,FALSE,1,315,"F",17,17,"Milwaukee Bucks","Khris Middleton",0,0,0,0,0,0
0,0,0,0,0,0,0,0,0,"00",0,0,0,0,0,0,1037629,"2023-10-29T00:00:00.000Z",17,FALSE,1,666960,"G",17,17,"Milwaukee Bucks","Lindell Wigginton",0,0,0,0,0,0
1,0,2,4,2,10,6,1,1,"24",1,3,15,3,4,2,1037629,"2023-10-29T00:00:00.000Z",17,FALSE,1,666656,"F",1,1,"Atlanta Hawks","De'Andre Hunter",4,18,19,16,4,30.1
1,0,0,0,0,0,0,2,2,"06",0,0,2,0,0,1,1037629,"2023-10-29T00:00:00.000Z",17,FALSE,1,284,"C",17,17,"Milwaukee Bucks","Robin Lopez",0,2,3,3,1,2.5
0,0,0,1,1,2,1,0,0,"03",0,0,3,0,0,1,1037629,"2023-10-29T00:00:00.000Z",17,FALSE,1,38017691,"G",17,17,"Milwaukee Bucks","TyTy Washington Jr.",0,3,3,3,0,2
0,0,0,0,0,0,0,0,0,"00",0,0,0,0,0,0,1037629,"2023-10-29T00:00:00.000Z",17,FALSE,1,666453,"C",17,17,"Milwaukee Bucks","Marques Bolden",0,0,0,0,0,0
0,0,0,1,0,1,0,0,0,"05",0,1,0,0,0,2,1037629,"2023-10-29T00:00:00.000Z",17,FALSE,1,666564,"F",1,1,"Atlanta Hawks","Bruno Fernando",0,0,0,0,0,-2
1,0,0,0,0,0,0,0,0,"05",0,1,0,0,0,0,1037629,"2023-10-29T00:00:00.000Z",17,FALSE,1,3547297,"G",1,1,"Atlanta Hawks","Trent Forrest",0,0,1,1,1,1.5
1,0,0,2,2,3,2,0,0,"09",1,0,6,1,1,1,1037629,"2023-10-29T00:00:00.000Z",17,FALSE,1,38017689,"F",1,1,"Atlanta Hawks","AJ Griffin",1,7,8,7,2,10.7
0,0,0,1,0,1,0,0,0,"03",0,1,0,0,1,0,1037629,"2023-10-29T00:00:00.000Z",17,FALSE,1,56677806,"F",1,1,"Atlanta Hawks","Mouhamed Gueye",1,0,0,0,0,3
0,0,0,0,0,0,0,0,0,"00",0,0,0,0,0,0,1037629,"2023-10-29T00:00:00.000Z",17,FALSE,1,666754,"G",1,1,"Atlanta Hawks","Garrison Mathews",0,0,0,0,0,0
0,0,0,0,0,0,0,0,0,"00",0,0,0,0,0,0,1037629,"2023-10-29T00:00:00.000Z",17,FALSE,1,319,"G",1,1,"Atlanta Hawks","Patty Mills",0,0,0,0,0,0
0,0,0,0,0,0,0,0,0,"00",0,0,0,0,0,0,1037629,"2023-10-29T00:00:00.000Z",17,FALSE,1,56677855,"G",1,1,"Atlanta Hawks","Seth Lundy",0,0,0,0,0,0
0,0,0,0,0,0,0,0,0,"00",0,0,0,0,0,0,1037629,"2023-10-29T00:00:00.000Z",17,FALSE,1,301,"G-F",1,1,"Atlanta Hawks","Wesley Matthews",0,0,0,0,0,0
2,0,0,0,0,1,1,0,0,"08",0,2,2,0,1,3,1037629,"2023-10-29T00:00:00.000Z",17,FALSE,1,2148,"",17,17,"Milwaukee Bucks","Thanasis Antetokounmpo",1,2,4,4,2,5
0,0,1,2,2,2,2,1,1,"06",0,0,7,1,0,0,1037629,"2023-10-29T00:00:00.000Z",17,FALSE,1,38017733,"G",17,17,"Milwaukee Bucks","A.J. Green",0,8,8,7,1,8.2
1,0,3,1,0,1,0,0,0,"07",1,2,0,4,1,1,1037629,"2023-10-29T00:00:00.000Z",17,FALSE,1,56677852,"G",17,17,"Milwaukee Bucks","Andre Jackson Jr.",1,4,5,1,5,8.3
0,0,0,0,0,0,0,0,0,"00",0,0,0,0,0,0,1037629,"2023-10-29T00:00:00.000Z",17,FALSE,1,56677854,"F",17,17,"Milwaukee Bucks","Chris Livingston",0,0,0,0,0,0
0,0,0,0,0,0,0,0,0,"00",0,0,0,0,0,0,1037629,"2023-10-29T00:00:00.000Z",17,FALSE,1,56677875,"F",1,1,"Atlanta Hawks","Miles Norris",0,0,0,0,0,0
2,2,5,4,2,11,8,7,6,"38",0,3,24,5,1,3,1037630,"2023-10-29T00:00:00.000Z",23,FALSE,25,200,"F",23,23,"Philadelphia 76ers","Tobias Harris",3,29,31,26,7,39
0,2,4,2,1,2,1,0,0,"20",0,1,3,4,1,1,1037630,"2023-10-29T00:00:00.000Z",23,FALSE,25,450,"F",13,23,"Philadelphia 76ers","PJ Tucker",3,7,7,3,4,15.8
7,6,10,4,2,22,12,12,9,"29",5,3,35,15,2,3,1037630,"2023-10-29T00:00:00.000Z",23,FALSE,25,145,"F-C",23,23,"Philadelphia 76ers","Joel Embiid",8,50,57,42,22,84.5
8,0,2,2,1,9,4,3,3,"30",0,2,12,2,2,1,1037630,"2023-10-29T00:00:00.000Z",23,FALSE,25,313,"G",23,23,"Philadelphia 76ers","De'Anthony Melton",2,14,22,20,10,31.4
4,0,9,8,4,14,6,10,10,"35",1,1,26,10,0,2,1037630,"2023-10-29T00:00:00.000Z",23,FALSE,25,3547254,"G",23,23,"Philadelphia 76ers","Tyrese Maxey",0,36,40,30,14,42
0,1,0,0,0,0,0,0,0,"01",0,0,0,0,0,0,1037630,"2023-10-29T00:00:00.000Z",23,FALSE,25,28,"C",23,23,"Philadelphia 76ers","Mo Bamba",1,0,0,0,0,3
2,3,1,0,0,3,2,0,0,"20",1,3,4,2,1,1,1037630,"2023-10-29T00:00:00.000Z",23,FALSE,25,45,"G",23,23,"Philadelphia 76ers","Patrick Beverley",4,6,8,6,4,20.4
0,0,0,0,0,0,0,0,0,"00",0,0,0,0,0,0,1037630,"2023-10-29T00:00:00.000Z",23,FALSE,25,184,"G-F",23,23,"Philadelphia 76ers","Danny Green",0,0,0,0,0,0
2,0,1,1,0,2,1,0,0,"10",1,0,2,2,1,1,1037630,"2023-10-29T00:00:00.000Z",23,FALSE,25,2175,"",23,23,"Philadelphia 76ers","Danuel House Jr.",1,4,6,4,4,9.4
0,0,0,1,1,1,1,2,1,"03",0,0,4,0,0,0,1037630,"2023-10-29T00:00:00.000Z",23,FALSE,25,260,"G-F",23,23,"Philadelphia 76ers","Furkan Korkmaz",0,4,4,4,0,4
0,1,2,4,0,10,3,6,6,"26",1,1,12,3,2,1,1037630,"2023-10-29T00:00:00.000Z",23,FALSE,25,360,"F",23,23,"Philadelphia 76ers","Kelly Oubre Jr.",3,15,15,12,3,23.6
0,0,1,0,0,0,0,0,0,"03",0,0,0,1,0,0,1037630,"2023-10-29T00:00:00.000Z",23,FALSE,25,17895941,"C",26,23,"Philadelphia 76ers","Filip Petrusev",0,1,1,0,1,1.2
1,1,4,2,0,5,1,0,0,"17",1,2,2,5,0,1,1037630,"2023-10-29T00:00:00.000Z",23,FALSE,25,3547270,"F",23,23,"Philadelphia 76ers","Paul Reed",1,7,8,3,6,11.5
2,1,1,0,0,3,1,0,0,"08",1,4,2,2,0,1,1037630,"2023-10-29T00:00:00.000Z",23,FALSE,25,17896025,"G",23,23,"Philadelphia 76ers","Jaden Springer",1,4,6,4,4,9.4
0,0,0,0,0,0,0,0,0,"00",0,0,0,0,0,0,1037630,"2023-10-29T00:00:00.000Z",23,FALSE,25,56913527,"G",23,23,"Philadelphia 76ers","Ricky Council IV",0,0,0,0,0,0
0,0,0,0,0,0,0,0,0,"00",0,0,0,0,0,0,1037630,"2023-10-29T00:00:00.000Z",23,FALSE,25,192,"G",13,23,"Philadelphia 76ers","James Harden",0,0,0,0,0,0
0,0,0,0,0,0,0,0,0,"00",0,0,0,0,0,0,1037630,"2023-10-29T00:00:00.000Z",23,FALSE,25,17554001,"G",23,23,"Philadelphia 76ers","Javonte Smart",0,0,0,0,0,0
0,0,0,0,0,0,0,0,0,"00",0,0,0,0,0,0,1037630,"2023-10-29T00:00:00.000Z",23,FALSE,25,56677788,"G",23,23,"Philadelphia 76ers","Terquavion Smith",0,0,0,0,0,0
0,0,0,2,0,3,1,0,0,"11",0,1,2,0,0,0,1037630,"2023-10-29T00:00:00.000Z",23,FALSE,25,666923,"G-F",25,25,"Portland Trail Blazers","Matisse Thybulle",0,2,2,2,0,2
1,2,3,4,1,16,5,7,6,"28",2,2,17,5,0,2,1037630,"2023-10-29T00:00:00.000Z",23,FALSE,25,182,"F",25,25,"Portland Trail Blazers","Jerami Grant",2,22,23,18,6,28.5
2,1,7,0,0,7,3,1,1,"20",2,3,7,9,2,0,1037630,"2023-10-29T00:00:00.000Z",23,FALSE,25,22,"C",25,25,"Portland Trail Blazers","Deandre Ayton",3,16,18,9,11,29.8
5,0,4,6,2,16,7,2,2,"26",1,2,18,5,1,2,1037630,"2023-10-29T00:00:00.000Z",23,FALSE,25,65,"G",25,25,"Portland Trail Blazers","Malcolm Brogdon",1,23,28,23,10,32.5
0,0,0,0,0,0,0,0,0,"00",0,0,0,0,0,0,1037630,"2023-10-29T00:00:00.000Z",23,FALSE,25,666476,"C",25,25,"Portland Trail Blazers","Moses Brown",0,0,0,0,0,0
2,2,0,5,1,16,5,2,1,"28",3,3,12,3,0,0,1037630,"2023-10-29T00:00:00.000Z",23,FALSE,25,56677850,"F",25,25,"Portland Trail Blazers","Toumani Camara",2,15,17,14,5,24.6
1,0,0,1,0,2,0,0,0,"05",0,0,0,0,0,1,1037630,"2023-10-29T00:00:00.000Z",23,FALSE,25,3547289,"G",25,25,"Portland Trail Blazers","Skylar Mays",0,0,1,1,1,0.5
0,0,0,1,0,1,0,0,0,"06",0,1,0,0,1,0,1037630,"2023-10-29T00:00:00.000Z",23,FALSE,25,56677791,"F",25,25,"Portland Trail Blazers","Kris Murray",1,0,0,0,0,3
0,0,0,1,0,1,0,0,0,"05",0,0,0,0,0,0,1037630,"2023-10-29T00:00:00.000Z",23,FALSE,25,56677829,"G-F",25,25,"Portland Trail Blazers","Rayan Rupert",0,0,0,0,0,0
2,2,5,0,0,3,2,2,2,"26",2,2,6,7,2,1,1037630,"2023-10-29T00:00:00.000Z",23,FALSE,25,476,"C-F",25,25,"Portland Trail Blazers","Robert Williams III",4,13,15,8,9,28.4
1,1,4,3,1,9,4,3,3,"24",3,4,12,7,4,2,1037630,"2023-10-29T00:00:00.000Z",23,FALSE,25,38017711,"F",25,25,"Portland Trail Blazers","Jabari Walker",5,19,20,13,8,34.9
0,0,0,0,0,0,0,0,0,"00",0,0,0,0,0,0,1037630,"2023-10-29T00:00:00.000Z",23,FALSE,25,47957121,"F",25,25,"Portland Trail Blazers","Justin Minaya",0,0,0,0,0,0
0,0,0,0,0,0,0,0,0,"00",0,0,0,0,0,0,1037630,"2023-10-29T00:00:00.000Z",23,FALSE,25,56783340,"C",25,25,"Portland Trail Blazers","Duop Reath",0,0,0,0,0,0
0,0,0,0,0,0,0,0,0,"00",0,0,0,0,0,0,1037630,"2023-10-29T00:00:00.000Z",23,FALSE,25,419,"G",25,25,"Portland Trail Blazers","Anfernee Simons",0,0,0,0,0,0
0,0,0,0,0,0,0,0,0,"00",0,0,0,0,0,0,1037630,"2023-10-29T00:00:00.000Z",23,FALSE,25,17896120,"F",25,25,"Portland Trail Blazers","Ish Wainright",0,0,0,0,0,0
2,0,4,4,2,13,7,5,4,"35",1,3,20,5,0,3,1037630,"2023-10-29T00:00:00.000Z",23,FALSE,25,38017690,"G",25,25,"Portland Trail Blazers","Shaedon Sharpe",0,25,27,22,7,26
3,1,1,4,0,7,2,0,0,"26",0,5,4,1,0,4,1037630,"2023-10-29T00:00:00.000Z",23,FALSE,25,56677747,"G",25,25,"Portland Trail Blazers","Scoot Henderson",1,5,8,7,4,8.7
3,1,2,1,0,1,0,0,0,"26",1,1,0,3,1,0,1037631,"2023-10-29T00:00:00.000Z",13,FALSE,27,108,"F",23,13,"LA Clippers","Robert Covington",2,3,6,3,6,14.1
4,0,3,7,3,13,6,7,6,"28",0,2,21,3,2,3,1037631,"2023-10-29T00:00:00.000Z",13,FALSE,27,274,"F",13,13,"LA Clippers","Kawhi Leonard",2,24,28,25,7,33.6
0,1,6,0,0,7,6,6,4,"22",2,4,16,8,0,1,1037631,"2023-10-29T00:00:00.000Z",13,FALSE,27,493,"C",13,13,"LA Clippers","Ivica Zubac",1,24,24,16,8,27.6
5,0,3,7,2,17,8,1,1,"28",1,1,19,4,5,1,1037631,"2023-10-29T00:00:00.000Z",13,FALSE,27,172,"F",13,13,"LA Clippers","Paul George",5,23,28,24,9,45.3
3,1,7,5,3,13,8,3,0,"27",1,3,19,8,1,2,1037631,"2023-10-29T00:00:00.000Z",13,FALSE,27,472,"G",13,13,"LA Clippers","Russell Westbrook",2,27,30,22,11,37.1
1,0,2,4,0,4,0,0,0,"15",0,1,0,2,1,1,1037631,"2023-10-29T00:00:00.000Z",13,FALSE,27,33,"F-G",23,13,"LA Clippers","Nicolas Batum",1,2,3,1,3,5.9
1,0,4,2,1,2,1,0,0,"05",0,1,3,4,1,0,1037631,"2023-10-29T00:00:00.000Z",13,FALSE,27,56677849,"F",13,13,"LA Clippers","Kobe Brown",1,7,8,4,5,12.3
1,0,1,0,0,0,0,0,0,"05",0,0,0,1,0,1,1037631,"2023-10-29T00:00:00.000Z",13,FALSE,27,666511,"G",13,13,"LA Clippers","Amir Coffey",0,1,2,1,2,1.7
2,0,0,0,0,0,0,0,0,"05",1,0,0,1,0,1,1037631,"2023-10-29T00:00:00.000Z",13,FALSE,27,38017725,"F",13,13,"LA Clippers","Moussa Diabate",0,1,3,2,3,3.2
1,0,3,8,4,14,7,0,0,"21",0,1,18,3,1,4,1037631,"2023-10-29T00:00:00.000Z",13,FALSE,27,17896031,"G",13,13,"LA Clippers","Nah'Shon Hyland",1,21,22,19,4,22.1
0,1,2,3,1,6,4,2,1,"18",0,1,10,2,1,2,1037631,"2023-10-29T00:00:00.000Z",13,FALSE,27,3547294,"F",23,13,"LA Clippers","Kenyon Martin Jr.",2,12,12,10,2,16.4
0,0,0,0,0,0,0,0,0,"00",0,0,0,0,0,0,1037631,"2023-10-29T00:00:00.000Z",13,FALSE,27,56677856,"G",13,13,"LA Clippers","Jordan Miller",0,0,0,0,0,0
1,0,4,0,0,3,2,0,0,"21",2,0,4,6,0,0,1037631,"2023-10-29T00:00:00.000Z",13,FALSE,27,371,"F-C",13,13,"LA Clippers","Mason Plumlee",0,10,11,5,7,12.7
1,1,2,5,2,11,5,2,1,"19",1,1,13,3,2,0,1037631,"2023-10-29T00:00:00.000Z",13,FALSE,27,380,"F-G",13,13,"LA Clippers","Norman Powell",3,16,17,14,4,27.1
0,0,0,0,0,0,0,0,0,"00",0,0,0,0,0,0,1037631,"2023-10-29T00:00:00.000Z",13,FALSE,27,17896022,"G",13,13,"LA Clippers","Brandon Boston Jr.",0,0,0,0,0,0
0,0,0,0,0,0,0,0,0,"00",0,0,0,0,0,0,1037631,"2023-10-29T00:00:00.000Z",13,FALSE,27,666743,"G",13,13,"LA Clippers","Terance Mann",0,0,0,0,0,0
0,0,0,0,0,0,0,0,0,"00",0,0,0,0,0,0,1037631,"2023-10-29T00:00:00.000Z",13,FALSE,27,328,"F",23,13,"LA Clippers","Marcus Morris",0,0,0,0,0,0
0,0,0,0,0,0,0,0,0,"00",0,0,0,0,0,0,1037631,"2023-10-29T00:00:00.000Z",13,FALSE,27,17896051,"G",13,13,"LA Clippers","Joshua Primo",0,0,0,0,0,0
1,0,5,5,1,9,1,2,2,"24",0,4,5,5,1,0,1037631,"2023-10-29T00:00:00.000Z",13,FALSE,27,666682,"F",27,27,"San Antonio Spurs","Keldon Johnson",1,10,11,6,6,15.5
2,1,4,2,0,10,4,6,3,"26",1,1,11,5,1,5,1037631,"2023-10-29T00:00:00.000Z",13,FALSE,27,56677822,"F-C",27,27,"San Antonio Spurs","Victor Wembanyama",2,16,18,13,7,21
4,0,5,4,1,11,4,0,0,"25",1,2,9,6,0,5,1037631,"2023-10-29T00:00:00.000Z",13,FALSE,27,102,"F-C",27,27,"San Antonio Spurs","Zach Collins",0,15,19,13,10,17.2
0,0,1,3,1,10,6,1,1,"28",0,2,14,1,1,2,1037631,"2023-10-29T00:00:00.000Z",13,FALSE,27,3547246,"G-F",27,27,"San Antonio Spurs","Devin Vassell",1,15,15,14,1,16.2
3,1,2,2,0,2,0,0,0,"22",2,3,0,4,1,4,1037631,"2023-10-29T00:00:00.000Z",13,FALSE,27,38017699,"F",27,27,"San Antonio Spurs","Jeremy Sochan",2,4,7,3,7,11.3
0,0,0,0,0,0,0,0,0,"05",0,0,0,0,0,0,1037631,"2023-10-29T00:00:00.000Z",13,FALSE,27,38017730,"F",27,27,"San Antonio Spurs","Dominick Barlow",0,0,0,0,0,0
1,1,4,0,0,4,3,0,0,"16",1,2,6,5,1,0,1037631,"2023-10-29T00:00:00.000Z",13,FALSE,27,17895854,"G",27,27,"San Antonio Spurs","Charles Bassey",2,11,12,7,6,19.5
2,0,1,4,2,12,3,1,1,"21",0,1,9,1,1,3,1037631,"2023-10-29T00:00:00.000Z",13,FALSE,27,38017692,"F",27,27,"San Antonio Spurs","Malaki Branham",1,10,12,11,3,13.2
0,1,2,2,1,4,1,0,0,"07",0,0,3,2,0,1,1037631,"2023-10-29T00:00:00.000Z",13,FALSE,27,38017649,"F",27,27,"San Antonio Spurs","Julian Champagnie",1,5,5,3,2,7.4
0,0,0,0,0,0,0,0,0,"00",0,0,0,0,0,0,1037631,"2023-10-29T00:00:00.000Z",13,FALSE,27,180,"G",27,27,"San Antonio Spurs","Devonte' Graham",0,0,0,0,0,0
4,0,2,2,1,4,1,2,2,"20",0,3,5,2,1,4,1037631,"2023-10-29T00:00:00.000Z",13,FALSE,27,3547274,"G",27,27,"San Antonio Spurs","Tre Jones",1,7,11,9,6,12.4
0,0,1,0,0,0,0,0,0,"07",1,1,0,2,1,0,1037631,"2023-10-29T00:00:00.000Z",13,FALSE,27,17896059,"F",27,27,"San Antonio Spurs","Sandro Mamukelashvili",1,2,2,0,2,5.4
2,0,3,4,2,6,3,0,0,"15",0,3,8,3,0,0,1037631,"2023-10-29T00:00:00.000Z",13,FALSE,27,305,"F",27,27,"San Antonio Spurs","Doug McDermott",0,11,13,10,5,14.6
1,1,1,4,2,7,4,2,2,"17",0,1,12,1,1,0,1037631,"2023-10-29T00:00:00.000Z",13,FALSE,27,359,"F",27,27,"San Antonio Spurs","Cedi Osman",2,13,14,13,2,20.7
1,1,0,1,0,1,0,2,1,"07",0,0,1,0,0,1,1037631,"2023-10-29T00:00:00.000Z",13,FALSE,27,38017693,"G",27,27,"San Antonio Spurs","Blake Wesley",1,1,2,2,1,4.5
0,0,0,0,0,0,0,0,0,"00",0,0,0,0,0,0,1037631,"2023-10-29T00:00:00.000Z",13,FALSE,27,56677865,"C",27,27,"San Antonio Spurs","Charles Bediako",0,0,0,0,0,0
0,0,0,0,0,0,0,0,0,"00",0,0,0,0,0,0,1037631,"2023-10-29T00:00:00.000Z",13,FALSE,27,56677817,"G",27,27,"San Antonio Spurs","Sidy Cissoko",0,0,0,0,0,0
0,0,0,0,0,0,0,0,0,"00",0,0,0,0,0,0,1037631,"2023-10-29T00:00:00.000Z",13,FALSE,27,56677870,"G",27,27,"San Antonio Spurs","Sir'Jabari Rice",0,0,0,0,0,0
5,1,5,9,3,14,6,3,2,"33",3,4,17,8,2,1,1037632,"2023-10-29T00:00:00.000Z",26,FALSE,14,38017688,"F",26,26,"Sacramento Kings","Keegan Murray",3,25,30,22,13,42.1
2,1,2,4,0,9,3,2,2,"39",0,1,8,2,0,0,1037632,"2023-10-29T00:00:00.000Z",26,FALSE,14,30,"F",26,26,"Sacramento Kings","Harrison Barnes",1,10,12,10,4,16.4
5,0,14,1,1,8,5,3,1,"34",1,6,12,15,1,3,1037632,"2023-10-29T00:00:00.000Z",26,FALSE,14,406,"F",26,26,"Sacramento Kings","Domantas Sabonis",1,27,32,17,20,37.5
4,2,7,7,3,12,4,2,1,"37",0,3,12,7,0,0,1037632,"2023-10-29T00:00:00.000Z",26,FALSE,14,221,"G",26,26,"Sacramento Kings","Kevin Huerter",2,19,23,16,11,32.4
8,1,3,8,3,24,14,8,6,"34",1,5,37,4,1,3,1037632,"2023-10-29T00:00:00.000Z",26,FALSE,14,161,"G",26,26,"Sacramento Kings","De'Aaron Fox",2,41,49,45,12,56.8
0,0,2,2,0,4,2,0,0,"14",0,3,4,2,1,0,1037632,"2023-10-29T00:00:00.000Z",26,FALSE,14,17896030,"G",26,26,"Sacramento Kings","Chris Duarte",1,6,6,4,2,9.4
0,0,0,0,0,0,0,0,0,"01",0,0,0,0,0,0,1037632,"2023-10-29T00:00:00.000Z",26,FALSE,14,17896044,"F",26,26,"Sacramento Kings","Kessler Edwards",0,0,0,0,0,0
0,0,0,0,0,0,0,0,0,"00",0,0,0,0,0,0,1037632,"2023-10-29T00:00:00.000Z",26,FALSE,14,38017714,"G",26,26,"Sacramento Kings","Keon Ellis",0,0,0,0,0,0
0,0,0,0,0,0,0,0,0,"00",0,0,0,0,0,0,1037632,"2023-10-29T00:00:00.000Z",26,FALSE,14,56677845,"G",26,26,"Sacramento Kings","Colby Jones",0,0,0,0,0,0
0,0,0,0,0,0,0,0,0,"00",0,0,0,0,0,0,1037632,"2023-10-29T00:00:00.000Z",26,FALSE,14,273,"C",26,26,"Sacramento Kings","Alex Len",0,0,0,0,0,0
0,1,0,0,0,2,2,0,0,"15",0,1,4,0,1,1,1037632,"2023-10-29T00:00:00.000Z",26,FALSE,14,306,"C",26,26,"Sacramento Kings","JaVale McGee",2,4,4,4,0,9
2,0,2,2,1,4,2,0,0,"15",0,4,5,2,0,0,1037632,"2023-10-29T00:00:00.000Z",26,FALSE,14,17553994,"G",26,26,"Sacramento Kings","Davion Mitchell",0,7,9,7,4,10.4
0,0,1,1,0,2,0,0,0,"05",0,0,0,1,0,0,1037632,"2023-10-29T00:00:00.000Z",26,FALSE,14,666860,"F-G",14,14,"Los Angeles Lakers","Cameron Reddish",0,1,1,0,1,1.2
2,0,0,2,0,3,1,0,0,"32",0,4,2,0,1,0,1037632,"2023-10-29T00:00:00.000Z",26,FALSE,14,1603383,"G",14,14,"Los Angeles Lakers","Gabe Vincent",1,2,4,4,2,8
1,0,5,2,2,3,3,3,3,"14",0,0,11,5,0,0,1037632,"2023-10-29T00:00:00.000Z",26,FALSE,14,486,"F",14,14,"Los Angeles Lakers","Christian Wood",0,16,17,12,6,18.5
0,0,0,0,0,0,0,0,0,"00",0,0,0,0,0,0,1037632,"2023-10-29T00:00:00.000Z",26,FALSE,14,56677738,"C",14,14,"Los Angeles Lakers","Colin Castleton",0,0,0,0,0,0
0,0,0,0,0,0,0,0,0,"00",0,0,0,0,0,0,1037632,"2023-10-29T00:00:00.000Z",26,FALSE,14,56677867,"F",14,14,"Los Angeles Lakers","Alex Fudge",0,0,0,0,0,0
0,0,0,0,0,0,0,0,0,"00",0,0,0,0,0,0,1037632,"2023-10-29T00:00:00.000Z",26,FALSE,14,56677868,"G",14,14,"Los Angeles Lakers","D'Moi Hodge",0,0,0,0,0,0
0,0,0,0,0,0,0,0,0,"00",0,0,0,0,0,0,1037632,"2023-10-29T00:00:00.000Z",26,FALSE,14,56677835,"G",14,14,"Los Angeles Lakers","Jalen Hood-Schifino",0,0,0,0,0,0
0,0,0,0,0,0,0,0,0,"00",0,0,0,0,0,0,1037632,"2023-10-29T00:00:00.000Z",26,FALSE,14,457,"F",14,14,"Los Angeles Lakers","Jarred Vanderbilt",0,0,0,0,0,0
3,0,2,9,4,17,7,5,4,"25",1,1,22,3,0,2,1037632,"2023-10-29T00:00:00.000Z",26,FALSE,14,324,"G",26,26,"Sacramento Kings","Malik Monk",0,25,28,25,6,28.1
0,0,0,0,0,0,0,0,0,"00",0,0,0,0,0,0,1037632,"2023-10-29T00:00:00.000Z",26,FALSE,14,56677862,"F",26,26,"Sacramento Kings","Jalen Slawson",0,0,0,0,0,0
1,1,4,6,2,10,4,1,1,"18",0,0,11,4,0,0,1037632,"2023-10-29T00:00:00.000Z",26,FALSE,14,4197162,"F",26,26,"Sacramento Kings","Aleksandar Vezenkov",1,15,16,12,5,20.3
0,0,0,0,0,0,0,0,0,"00",0,0,0,0,0,0,1037632,"2023-10-29T00:00:00.000Z",26,FALSE,14,17895990,"G",26,26,"Sacramento Kings","Jordan Ford",0,0,0,0,0,0
0,0,0,0,0,0,0,0,0,"00",0,0,0,0,0,0,1037632,"2023-10-29T00:00:00.000Z",26,FALSE,14,290,"F",26,26,"Sacramento Kings","Trey Lyles",0,0,0,0,0,0
2,1,3,13,5,17,7,2,1,"41",0,3,20,3,0,1,1037632,"2023-10-29T00:00:00.000Z",26,FALSE,14,383,"F",14,14,"Los Angeles Lakers","Taurean Prince",1,23,25,22,5,28.6
8,0,15,8,3,19,11,6,2,"39",0,2,27,15,0,8,1037632,"2023-10-29T00:00:00.000Z",26,FALSE,14,237,"F",14,14,"Los Angeles Lakers","LeBron James",0,42,50,35,23,49
2,3,10,2,1,22,11,8,7,"42",6,5,30,16,2,0,1037632,"2023-10-29T00:00:00.000Z",26,FALSE,14,117,"F-C",14,14,"Los Angeles Lakers","Anthony Davis",5,46,48,32,18,67.2
2,0,2,8,1,12,1,2,2,"27",0,2,5,2,1,3,1037632,"2023-10-29T00:00:00.000Z",26,FALSE,14,17553995,"G",14,14,"Los Angeles Lakers","Austin Reaves",1,7,9,7,4,10.4
0,0,0,0,0,0,0,0,0,"00",0,0,0,0,0,0,1037632,"2023-10-29T00:00:00.000Z",26,FALSE,14,38017697,"G",14,14,"Los Angeles Lakers","Max Christie",0,0,0,0,0,0
1,0,4,4,2,6,3,4,3,"17",2,1,11,6,0,0,1037632,"2023-10-29T00:00:00.000Z",26,FALSE,14,666609,"F",14,14,"Los Angeles Lakers","Rui Hachimura",0,17,18,12,7,19.7
0,0,2,0,0,1,1,2,2,"07",0,1,4,2,0,0,1037632,"2023-10-29T00:00:00.000Z",26,FALSE,14,666626,"C",14,14,"Los Angeles Lakers","Jaxson Hayes",0,6,6,4,2,6.4
0,0,0,0,0,0,0,0,0,"00",0,0,0,0,0,0,1037632,"2023-10-29T00:00:00.000Z",26,FALSE,14,56677836,"F",14,14,"Los Angeles Lakers","Maxwell Lewis",0,0,0,0,0,0
9,0,3,5,1,13,5,7,6,"41",0,4,17,3,0,0,1037632,"2023-10-29T00:00:00.000Z",26,FALSE,14,405,"G",14,14,"Los Angeles Lakers","D'Angelo Russell",0,20,29,26,12,34.1
5,1,0,2,2,11,6,1,1,"31",0,4,15,0,2,0,1037633,"2023-10-30T00:00:00.000Z",4,FALSE,3,204,"F",4,4,"Charlotte Hornets","Gordon Hayward",3,15,20,20,5,31.5
2,0,9,3,1,14,7,1,0,"35",3,4,15,12,0,1,1037633,"2023-10-30T00:00:00.000Z",4,FALSE,3,666950,"F",4,4,"Charlotte Hornets","P.J. Washington",0,27,29,17,14,31.4
1,0,6,0,0,8,8,2,2,"23",1,1,18,7,0,1,1037633,"2023-10-30T00:00:00.000Z",4,FALSE,3,38017698,"C",4,4,"Charlotte Hornets","Mark Williams",0,25,26,19,8,26.9
9,1,3,6,2,19,10,1,1,"41",0,2,23,3,2,2,1037633,"2023-10-30T00:00:00.000Z",4,FALSE,3,403,"G",4,4,"Charlotte Hornets","Terry Rozier",3,26,35,32,12,47.1
8,0,3,6,0,12,3,2,2,"22",0,6,8,3,2,3,1037633,"2023-10-30T00:00:00.000Z",4,FALSE,3,3547239,"G",4,4,"Charlotte Hornets","LaMelo Ball",2,11,19,16,11,26.6
0,0,0,0,0,0,0,0,0,"00",0,0,0,0,0,0,1037633,"2023-10-30T00:00:00.000Z",4,FALSE,3,56677848,"G",4,4,"Charlotte Hornets","Amari Bailey",0,0,0,0,0,0
0,0,0,0,0,0,0,0,0,"00",0,0,0,0,0,0,1037633,"2023-10-30T00:00:00.000Z",4,FALSE,3,56677866,"F",4,4,"Charlotte Hornets","Leaky Black",0,0,0,0,0,0
0,0,0,0,0,0,0,0,0,"00",0,0,0,0,0,0,1037633,"2023-10-30T00:00:00.000Z",4,FALSE,3,62,"F",4,4,"Charlotte Hornets","Miles Bridges",0,0,0,0,0,0
2,0,1,5,0,9,2,5,5,"20",0,0,9,1,1,0,1037633,"2023-10-30T00:00:00.000Z",4,FALSE,3,3547253,"G",4,4,"Charlotte Hornets","Theo Maledon",1,10,12,11,3,16.2
0,0,0,0,0,0,0,0,0,"00",0,0,0,0,0,0,1037633,"2023-10-30T00:00:00.000Z",4,FALSE,3,38017708,"G",4,4,"Charlotte Hornets","Bryce McGowens",0,0,0,0,0,0
2,1,5,5,2,16,7,6,6,"36",4,3,22,9,0,0,1037633,"2023-10-30T00:00:00.000Z",4,FALSE,3,56677823,"F",4,4,"Charlotte Hornets","Brandon Miller",1,31,33,24,11,38.8
1,2,2,0,0,1,1,2,2,"13",0,2,4,2,1,1,1037633,"2023-10-30T00:00:00.000Z",4,FALSE,3,3547282,"C",4,4,"Charlotte Hornets","Nick Richards",3,6,7,5,3,15.9
0,0,0,0,0,0,0,0,0,"00",0,0,0,0,0,0,1037633,"2023-10-30T00:00:00.000Z",4,FALSE,3,56677846,"G",4,4,"Charlotte Hornets","Nick Smith Jr.",0,0,0,0,0,0
3,0,2,4,1,6,3,0,0,"19",0,1,7,2,0,1,1037633,"2023-10-30T00:00:00.000Z",4,FALSE,3,18678001,"F",4,4,"Charlotte Hornets","JT Thor",0,9,12,10,5,12.9
0,0,0,0,0,0,0,0,0,"00",0,0,0,0,0,0,1037633,"2023-10-30T00:00:00.000Z",4,FALSE,3,17896037,"G",4,4,"Charlotte Hornets","James Bouknight",0,0,0,0,0,0
0,0,0,0,0,0,0,0,0,"00",0,0,0,0,0,0,1037633,"2023-10-30T00:00:00.000Z",4,FALSE,3,666748,"F",4,4,"Charlotte Hornets","Cody Martin",0,0,0,0,0,0
0,0,0,0,0,0,0,0,0,"00",0,0,0,0,0,0,1037633,"2023-10-30T00:00:00.000Z",4,FALSE,3,347,"G",4,4,"Charlotte Hornets","Frank Ntilikina",0,0,0,0,0,0
0,0,0,0,0,0,0,0,0,"00",0,0,0,0,0,0,1037633,"2023-10-30T00:00:00.000Z",4,FALSE,3,422,"G",4,4,"Charlotte Hornets","Ish Smith",0,0,0,0,0,0
2,0,2,4,1,17,10,14,12,"38",0,4,33,2,0,2,1037633,"2023-10-30T00:00:00.000Z",4,FALSE,3,17896048,"G",3,3,"Brooklyn Nets","Cam Thomas",0,35,37,35,4,36.4
4,1,6,3,1,13,10,3,3,"38",1,3,24,7,1,5,1037633,"2023-10-30T00:00:00.000Z",4,FALSE,3,61,"F",3,3,"Brooklyn Nets","Mikal Bridges",2,31,35,28,11,39.4
1,2,6,9,4,12,7,2,1,"31",1,0,19,7,1,1,1037633,"2023-10-30T00:00:00.000Z",4,FALSE,3,158,"F",3,3,"Brooklyn Nets","Dorian Finney-Smith",3,26,27,20,8,36.9
3,0,1,3,1,6,2,0,0,"13",0,2,5,1,0,1,1037633,"2023-10-30T00:00:00.000Z",4,FALSE,3,130,"G",3,3,"Brooklyn Nets","Spencer Dinwiddie",0,6,9,8,4,9.7
8,1,7,0,0,6,5,2,1,"35",3,1,11,10,0,2,1037633,"2023-10-30T00:00:00.000Z",4,FALSE,3,417,"G-F",3,3,"Brooklyn Nets","Ben Simmons",1,21,29,19,18,36
0,0,0,0,0,0,0,0,0,"00",0,0,0,0,0,0,1037633,"2023-10-30T00:00:00.000Z",4,FALSE,3,666508,"F-C",3,3,"Brooklyn Nets","Nicolas Claxton",0,0,0,0,0,0
0,0,0,0,0,0,0,0,0,"00",0,0,0,0,0,0,1037633,"2023-10-30T00:00:00.000Z",4,FALSE,3,174,"F-C",3,3,"Brooklyn Nets","Harry Giles III",0,0,0,0,0,0
0,2,2,6,2,8,3,0,0,"32",0,1,8,2,0,0,1037633,"2023-10-30T00:00:00.000Z",4,FALSE,3,351,"F",3,3,"Brooklyn Nets","Royce O'Neale",2,10,10,8,2,16.4
1,1,4,0,0,8,5,3,1,"10",4,5,11,8,0,1,1037633,"2023-10-30T00:00:00.000Z",4,FALSE,3,17896038,"C",3,3,"Brooklyn Nets","Day'Ron Sharpe",1,19,20,12,9,24.1
2,0,3,1,0,4,1,2,1,"14",1,2,3,4,1,1,1037633,"2023-10-30T00:00:00.000Z",4,FALSE,3,421,"G",3,3,"Brooklyn Nets","Dennis Smith Jr.",1,7,9,5,6,12.8
4,1,5,7,3,13,6,6,4,"29",0,1,19,5,1,0,1037633,"2023-10-30T00:00:00.000Z",4,FALSE,3,464,"G",3,3,"Brooklyn Nets","Lonnie Walker IV",2,24,28,23,9,37
0,0,0,0,0,0,0,0,0,"00",0,0,0,0,0,0,1037633,"2023-10-30T00:00:00.000Z",4,FALSE,3,17896058,"F",3,3,"Brooklyn Nets","Trendon Watford",0,0,0,0,0,0
0,0,0,0,0,0,0,0,0,"00",0,0,0,0,0,0,1037633,"2023-10-30T00:00:00.000Z",4,FALSE,3,9051997,"G",3,3,"Brooklyn Nets","Armoni Brooks",0,0,0,0,0,0
0,0,0,0,0,0,0,0,0,"00",0,0,0,0,0,0,1037633,"2023-10-30T00:00:00.000Z",4,FALSE,3,56677843,"F",3,3,"Brooklyn Nets","Noah Clowney",0,0,0,0,0,0
0,0,0,0,0,0,0,0,0,"00",0,0,0,0,0,0,1037633,"2023-10-30T00:00:00.000Z",4,FALSE,3,666679,"F",3,3,"Brooklyn Nets","Cameron Johnson",0,0,0,0,0,0
0,0,0,0,0,0,0,0,0,"00",0,0,0,0,0,0,1037633,"2023-10-30T00:00:00.000Z",4,FALSE,3,56677841,"F",3,3,"Brooklyn Nets","Dariq Whitehead",0,0,0,0,0,0
0,0,0,0,0,0,0,0,0,"00",0,0,0,0,0,0,1037633,"2023-10-30T00:00:00.000Z",4,FALSE,3,56677722,"F",3,3,"Brooklyn Nets","Jalen Wilson",0,0,0,0,0,0
0,0,3,4,1,11,4,6,6,"28",1,5,15,4,0,2,1037634,"2023-10-30T00:00:00.000Z",12,FALSE,5,38017686,"G-F",12,12,"Indiana Pacers","Bennedict Mathurin",0,19,19,15,4,17.8
0,0,6,2,0,5,2,2,2,"24",2,1,6,8,1,0,1037634,"2023-10-30T00:00:00.000Z",12,FALSE,5,3547243,"F",12,12,"Indiana Pacers","Obi Toppin",1,14,14,6,8,18.6
3,2,9,8,3,14,6,8,5,"32",2,2,20,11,0,1,1037634,"2023-10-30T00:00:00.000Z",12,FALSE,5,452,"C-F",12,12,"Indiana Pacers","Myles Turner",2,31,34,23,14,42.7
1,0,5,6,3,12,6,0,0,"37",2,2,15,7,1,3,1037634,"2023-10-30T00:00:00.000Z",12,FALSE,5,69,"G",12,12,"Indiana Pacers","Bruce Brown",1,22,23,16,8,24.9
13,0,4,8,1,16,6,7,6,"36",1,1,19,5,2,4,1037634,"2023-10-30T00:00:00.000Z",12,FALSE,5,3547245,"G",12,12,"Indiana Pacers","Tyrese Haliburton",2,24,37,32,18,46.5
2,0,1,4,0,7,3,0,0,"21",0,4,6,1,2,4,1037634,"2023-10-30T00:00:00.000Z",12,FALSE,5,38017507,"G-F",12,12,"Indiana Pacers","Andrew Nembhard",2,7,9,8,3,12.2
0,0,0,0,0,0,0,0,0,"00",0,0,0,0,0,0,1037634,"2023-10-30T00:00:00.000Z",12,FALSE,5,38017701,"G",12,12,"Indiana Pacers","Kendall Brown",0,0,0,0,0,0
0,0,0,0,0,0,0,0,0,"00",0,0,0,0,0,0,1037634,"2023-10-30T00:00:00.000Z",12,FALSE,5,56677778,"F-C",12,12,"Indiana Pacers","Oscar Tshiebwe",0,0,0,0,0,0
0,0,0,0,0,0,0,0,0,"00",0,0,0,0,0,0,1037634,"2023-10-30T00:00:00.000Z",12,FALSE,5,56677794,"G",12,12,"Indiana Pacers","Isaiah Wong",0,0,0,0,0,0
4,1,1,1,0,19,6,8,8,"35",1,2,20,2,0,0,1037634,"2023-10-30T00:00:00.000Z",12,FALSE,5,125,"G",5,5,"Chicago Bulls","DeMar DeRozan",1,22,26,24,6,31.4
0,1,4,2,1,6,3,2,2,"22",0,0,9,4,1,1,1037634,"2023-10-30T00:00:00.000Z",12,FALSE,5,3547248,"F",5,5,"Chicago Bulls","Patrick Williams",2,13,13,9,4,18.8
3,0,12,1,0,19,10,6,4,"34",5,3,24,17,1,1,1037634,"2023-10-30T00:00:00.000Z",12,FALSE,5,460,"C",5,5,"Chicago Bulls","Nikola Vucevic",1,41,44,27,20,50.9
1,0,5,6,1,17,6,11,10,"36",0,1,23,5,0,1,1037634,"2023-10-30T00:00:00.000Z",12,FALSE,5,268,"G",5,5,"Chicago Bulls","Zach LaVine",0,28,29,24,6,29.5
3,0,2,2,1,6,3,0,0,"25",0,4,7,2,1,1,1037634,"2023-10-30T00:00:00.000Z",12,FALSE,5,666956,"G",5,5,"Chicago Bulls","Coby White",1,9,12,10,5,15.9
2,1,2,1,1,7,5,0,0,"18",0,1,11,2,1,3,1037634,"2023-10-30T00:00:00.000Z",12,FALSE,5,87,"G",5,5,"Chicago Bulls","Jevon Carter",2,13,15,13,4,19.4
3,1,3,2,1,5,3,2,1,"26",1,1,8,4,0,3,1037634,"2023-10-30T00:00:00.000Z",12,FALSE,5,89,"G",5,5,"Chicago Bulls","Alex Caruso",1,12,15,11,7,17.3
1,1,3,1,1,3,2,0,0,"20",1,3,5,4,2,2,1037634,"2023-10-30T00:00:00.000Z",12,FALSE,5,110,"F",5,5,"Chicago Bulls","Torrey Craig",3,9,10,6,5,18.3
0,1,1,1,0,1,0,0,0,"10",0,2,0,1,1,0,1037634,"2023-10-30T00:00:00.000Z",12,FALSE,5,17895983,"G",5,5,"Chicago Bulls","Ayo Dosunmu",2,1,1,0,1,7.2
2,0,1,0,0,4,2,2,1,"14",2,0,5,3,1,1,1037634,"2023-10-30T00:00:00.000Z",12,FALSE,5,137,"C",5,5,"Chicago Bulls","Andre Drummond",1,8,10,7,5,13.6
0,0,0,0,0,0,0,0,0,"00",0,0,0,0,0,0,1037634,"2023-10-30T00:00:00.000Z",12,FALSE,5,56677857,"F",5,5,"Chicago Bulls","Julian Phillips",0,0,0,0,0,0
0,0,0,0,0,0,0,0,0,"00",0,0,0,0,0,0,1037634,"2023-10-30T00:00:00.000Z",12,FALSE,5,38017719,"F",5,5,"Chicago Bulls","Dalen Terry",0,0,0,0,0,0
0,0,0,0,0,0,0,0,0,"00",0,0,0,0,0,0,1037634,"2023-10-30T00:00:00.000Z",12,FALSE,5,27,"G",5,5,"Chicago Bulls","Lonzo Ball",0,0,0,0,0,0
0,0,0,0,0,0,0,0,0,"00",0,0,0,0,0,0,1037634,"2023-10-30T00:00:00.000Z",12,FALSE,5,56677874,"F",5,5,"Chicago Bulls","Onuralp Bitim",0,0,0,0,0,0
0,0,0,0,0,0,0,0,0,"00",0,0,0,0,0,0,1037634,"2023-10-30T00:00:00.000Z",12,FALSE,5,45969255,"F",5,5,"Chicago Bulls","Justin Lewis",0,0,0,0,0,0
0,0,0,0,0,0,0,0,0,"00",0,0,0,0,0,0,1037634,"2023-10-30T00:00:00.000Z",12,FALSE,5,56677860,"F",5,5,"Chicago Bulls","Adama Sanogo",0,0,0,0,0,0
0,0,0,0,0,0,0,0,0,"00",0,0,0,0,0,0,1037634,"2023-10-30T00:00:00.000Z",12,FALSE,5,17896116,"G",5,5,"Chicago Bulls","Terry Taylor",0,0,0,0,0,0
0,0,0,0,0,0,0,0,0,"00",0,0,0,0,0,0,1037634,"2023-10-30T00:00:00.000Z",12,FALSE,5,56677861,"G",12,12,"Indiana Pacers","Ben Sheppard",0,0,0,0,0,0
0,0,0,0,0,0,0,0,0,"00",0,0,0,0,0,0,1037634,"2023-10-30T00:00:00.000Z",12,FALSE,5,439,"F",13,12,"Indiana Pacers","Daniel Theis",0,0,0,0,0,0
0,0,0,0,0,0,0,0,0,"00",0,0,0,0,0,0,1037634,"2023-10-30T00:00:00.000Z",12,FALSE,5,56677832,"F",12,12,"Indiana Pacers","Jarace Walker",0,0,0,0,0,0
3,2,4,4,1,4,1,2,2,"27",0,6,5,4,0,0,1037634,"2023-10-30T00:00:00.000Z",12,FALSE,5,3547250,"G-F",12,12,"Indiana Pacers","Aaron Nesmith",2,9,12,8,7,20.3
0,1,2,2,0,7,4,0,0,"16",0,3,8,2,1,1,1037634,"2023-10-30T00:00:00.000Z",12,FALSE,5,3547264,"F-C",12,12,"Indiana Pacers","Jalen Smith",2,10,10,8,2,15.4
4,0,2,8,3,12,4,0,0,"19",3,0,11,5,0,2,1037634,"2023-10-30T00:00:00.000Z",12,FALSE,5,210,"G",12,12,"Indiana Pacers","Buddy Hield",0,16,20,15,9,21
0,0,0,0,0,0,0,0,0,"00",0,0,0,0,0,0,1037634,"2023-10-30T00:00:00.000Z",12,FALSE,5,17896035,"F",12,12,"Indiana Pacers","Isaiah Jackson",0,0,0,0,0,0
0,0,0,0,0,0,0,0,0,"00",0,0,0,0,0,0,1037634,"2023-10-30T00:00:00.000Z",12,FALSE,5,304,"G",12,12,"Indiana Pacers","T.J. McConnell",0,0,0,0,0,0
0,0,0,0,0,0,0,0,0,"00",0,0,0,0,0,0,1037634,"2023-10-30T00:00:00.000Z",12,FALSE,5,3547207,"F",12,12,"Indiana Pacers","Jordan Nwora",0,0,0,0,0,0
1,2,3,6,1,12,4,0,0,"28",2,0,9,5,1,1,1037635,"2023-10-30T00:00:00.000Z",30,FALSE,2,56677844,"G",30,30,"Washington Wizards","Bilal Coulibaly",3,14,15,10,6,24.5
1,0,5,3,1,10,4,2,2,"22",2,4,11,7,1,0,1037635,"2023-10-30T00:00:00.000Z",30,FALSE,2,3547242,"F",30,30,"Washington Wizards","Deni Avdija",1,18,19,12,8,23.9
4,0,5,6,3,15,9,0,0,"26",0,0,21,5,0,2,1037635,"2023-10-30T00:00:00.000Z",30,FALSE,2,265,"F",30,30,"Washington Wizards","Kyle Kuzma",0,26,30,25,9,31
2,1,1,5,1,11,5,0,0,"25",2,3,11,3,3,3,1037635,"2023-10-30T00:00:00.000Z",30,FALSE,2,666848,"G",30,30,"Washington Wizards","Jordan Poole",4,14,16,13,5,26.6
7,0,3,4,1,9,5,0,0,"27",0,0,11,3,1,2,1037635,"2023-10-30T00:00:00.000Z",30,FALSE,2,249,"G",30,30,"Washington Wizards","Tyus Jones",1,14,21,18,10,26.1
1,0,0,1,0,1,0,0,0,"05",0,0,0,0,0,0,1037635,"2023-10-30T00:00:00.000Z",30,FALSE,2,38017704,"F",30,30,"Washington Wizards","Patrick Baldwin Jr.",0,0,1,1,1,1.5
0,0,1,0,0,4,2,2,1,"16",1,2,5,2,0,2,1037635,"2023-10-30T00:00:00.000Z",30,FALSE,2,38017687,"G",30,30,"Washington Wizards","Johnny Davis",0,7,7,5,2,5.4
2,0,2,2,0,5,1,2,1,"16",0,0,3,2,1,1,1037635,"2023-10-30T00:00:00.000Z",30,FALSE,2,167,"F",30,30,"Washington Wizards","Danilo Gallinari",1,5,7,5,4,10.4
0,0,2,6,3,6,3,2,0,"24",0,1,9,2,0,2,1037635,"2023-10-30T00:00:00.000Z",30,FALSE,2,17896045,"F",30,30,"Washington Wizards","Corey Kispert",0,11,11,9,2,9.4
2,0,2,0,0,2,0,2,1,"11",0,0,1,2,0,0,1037635,"2023-10-30T00:00:00.000Z",30,FALSE,2,487,"G",30,30,"Washington Wizards","Delon Wright",0,3,5,3,4,6.4
0,0,0,0,0,0,0,0,0,"00",0,0,0,0,0,0,1037635,"2023-10-30T00:00:00.000Z",30,FALSE,2,666577,"F",30,30,"Washington Wizards","Daniel Gafford",0,0,0,0,0,0
0,0,0,0,0,0,0,0,0,"00",0,0,0,0,0,0,1037635,"2023-10-30T00:00:00.000Z",30,FALSE,2,414,"G",30,30,"Washington Wizards","Landry Shamet",0,0,0,0,0,0
2,1,6,13,8,24,13,4,2,"31",0,3,36,6,3,0,1037635,"2023-10-30T00:00:00.000Z",30,FALSE,2,70,"G",2,2,"Boston Celtics","Jaylen Brown",4,42,44,38,8,58.2
3,0,6,9,4,21,14,1,1,"28",0,2,33,6,0,2,1037635,"2023-10-30T00:00:00.000Z",30,FALSE,2,434,"F",2,2,"Boston Celtics","Jayson Tatum",0,39,42,36,9,42.7
3,1,6,2,1,9,7,0,0,"24",0,2,15,6,0,2,1037635,"2023-10-30T00:00:00.000Z",30,FALSE,2,378,"F-C",2,2,"Boston Celtics","Kristaps Porzingis",1,21,24,18,9,27.7
8,1,0,2,1,3,2,0,0,"24",1,1,5,1,2,2,1037635,"2023-10-30T00:00:00.000Z",30,FALSE,2,473,"G",2,2,"Boston Celtics","Derrick White",3,6,14,13,9,25.2
3,2,4,3,1,7,4,2,2,"27",1,1,11,5,1,1,1037635,"2023-10-30T00:00:00.000Z",30,FALSE,2,214,"G",2,2,"Boston Celtics","Jrue Holiday",3,16,19,14,8,29.5
1,0,0,1,0,3,1,0,0,"10",2,1,2,2,0,1,1037635,"2023-10-30T00:00:00.000Z",30,FALSE,2,17896094,"G",2,2,"Boston Celtics","Dalano Banton",0,4,5,3,3,4.9
1,0,1,2,0,4,0,0,0,"10",1,2,0,2,1,0,1037635,"2023-10-30T00:00:00.000Z",30,FALSE,2,666468,"F",2,2,"Boston Celtics","Oshae Brissett",1,2,3,1,3,6.9
1,1,5,9,2,10,3,0,0,"25",3,3,8,8,0,1,1037635,"2023-10-30T00:00:00.000Z",30,FALSE,2,17896060,"F",2,2,"Boston Celtics","Sam Hauser",1,16,17,9,9,21.1
1,0,1,3,0,9,4,0,0,"15",4,1,8,5,2,0,1037635,"2023-10-30T00:00:00.000Z",30,FALSE,2,219,"C-F",2,2,"Boston Celtics","Al Horford",2,13,14,9,6,21.5
1,0,1,0,0,0,0,0,0,"11",0,1,0,1,0,2,1037635,"2023-10-30T00:00:00.000Z",30,FALSE,2,261,"F-C",2,2,"Boston Celtics","Luke Kornet",0,1,2,1,2,0.7
1,0,0,2,1,2,1,0,0,"05",0,0,3,0,1,0,1037635,"2023-10-30T00:00:00.000Z",30,FALSE,2,338,"G",2,2,"Boston Celtics","Svi Mykhailiuk",1,3,4,4,1,7.5
6,0,6,6,0,8,0,0,0,"25",1,3,0,7,1,4,1037635,"2023-10-30T00:00:00.000Z",30,FALSE,2,3547276,"G",2,2,"Boston Celtics","Payton Pritchard",1,7,13,6,13,16.4
0,0,0,1,1,2,2,0,0,"05",2,1,5,2,0,3,1037635,"2023-10-30T00:00:00.000Z",30,FALSE,2,3547279,"F",2,2,"Boston Celtics","Lamar Stevens",0,7,7,5,2,4.4
0,0,0,0,0,0,0,0,0,"00",0,0,0,0,0,0,1037635,"2023-10-30T00:00:00.000Z",30,FALSE,2,56677864,"G",2,2,"Boston Celtics","Jordan Walsh",0,0,0,0,0,0
0,0,0,0,0,0,0,0,0,"00",0,0,0,0,0,0,1037635,"2023-10-30T00:00:00.000Z",30,FALSE,2,38017707,"G",2,2,"Boston Celtics","JD Davison",0,0,0,0,0,0
0,0,0,0,0,0,0,0,0,"00",0,0,0,0,0,0,1037635,"2023-10-30T00:00:00.000Z",30,FALSE,2,3547295,"F-C",2,2,"Boston Celtics","Nathan Knight",0,0,0,0,0,0
0,0,0,0,0,0,0,0,0,"00",0,0,0,0,0,0,1037635,"2023-10-30T00:00:00.000Z",30,FALSE,2,17553967,"C",2,2,"Boston Celtics","Neemias Queta",0,0,0,0,0,0
1,0,2,0,0,3,1,4,3,"10",0,2,5,2,0,0,1037635,"2023-10-30T00:00:00.000Z",30,FALSE,2,3547302,"F",30,30,"Washington Wizards","Anthony Gill",0,7,8,6,3,8.9
0,0,0,0,0,0,0,0,0,"00",0,0,0,0,0,0,1037635,"2023-10-30T00:00:00.000Z",30,FALSE,2,337,"F-C",30,30,"Washington Wizards","Mike Muscala",0,0,0,0,0,0
1,1,3,1,1,5,5,4,3,"12",3,0,14,6,1,0,1037635,"2023-10-30T00:00:00.000Z",30,FALSE,2,17896106,"F",30,30,"Washington Wizards","Eugene Omoruyi",2,20,21,15,7,28.7
3,0,0,0,0,2,0,8,7,"12",1,1,7,1,4,1,1037635,"2023-10-30T00:00:00.000Z",30,FALSE,2,38017712,"G",30,30,"Washington Wizards","Ryan Rollins",4,8,11,10,4,23.7
0,0,0,0,0,0,0,0,0,"00",0,0,0,0,0,0,1037635,"2023-10-30T00:00:00.000Z",30,FALSE,2,38124126,"F",30,30,"Washington Wizards","John Butler Jr.",0,0,0,0,0,0
1,0,0,2,0,2,0,0,0,"06",0,0,0,0,0,1,1037635,"2023-10-30T00:00:00.000Z",30,FALSE,2,18677954,"G",30,30,"Washington Wizards","Jared Butler",0,0,1,1,1,0.5
2,0,4,5,3,10,6,2,1,"30",0,0,16,4,1,0,1037636,"2023-10-30T00:00:00.000Z",1,FALSE,18,666656,"F",1,1,"Atlanta Hawks","De'Andre Hunter",1,20,22,18,6,26.8
3,1,4,2,1,7,5,1,1,"33",1,3,12,5,1,2,1037636,"2023-10-30T00:00:00.000Z",1,FALSE,18,17896040,"F",1,1,"Atlanta Hawks","Jalen Johnson",2,17,20,15,8,26.5
1,5,4,0,0,3,0,2,2,"23",1,3,2,5,0,1,1037636,"2023-10-30T00:00:00.000Z",1,FALSE,18,83,"C",1,1,"Atlanta Hawks","Clint Capela",5,7,8,3,6,23.5
5,0,7,5,3,24,17,4,4,"40",0,1,41,7,2,3,1037636,"2023-10-30T00:00:00.000Z",1,FALSE,18,334,"G",1,1,"Atlanta Hawks","Dejounte Murray",2,48,53,46,12,59.9
8,0,1,7,1,22,9,5,5,"35",0,1,24,1,1,1,1037636,"2023-10-30T00:00:00.000Z",1,FALSE,18,490,"G",1,1,"Atlanta Hawks","Trae Young",1,25,33,32,9,39.2
1,1,6,3,3,5,4,0,0,"25",0,2,11,6,0,1,1037636,"2023-10-30T00:00:00.000Z",1,FALSE,18,3547256,"F",1,1,"Atlanta Hawks","Saddiq Bey",1,17,18,12,7,21.7
4,0,1,7,2,10,3,0,0,"21",0,1,8,1,1,1,1037636,"2023-10-30T00:00:00.000Z",1,FALSE,18,53,"G",1,1,"Atlanta Hawks","Bogdan Bogdanovic",1,9,13,12,5,17.2
0,0,0,0,0,1,0,0,0,"01",0,0,0,0,0,0,1037636,"2023-10-30T00:00:00.000Z",1,FALSE,18,56677838,"G",1,1,"Atlanta Hawks","Kobe Bufkin",0,0,0,0,0,0
0,0,0,0,0,0,0,0,0,"01",0,0,0,0,0,0,1037636,"2023-10-30T00:00:00.000Z",1,FALSE,18,666564,"F",1,1,"Atlanta Hawks","Bruno Fernando",0,0,0,0,0,0
0,0,0,0,0,0,0,0,0,"00",0,0,0,0,0,0,1037636,"2023-10-30T00:00:00.000Z",1,FALSE,18,3547297,"G",1,1,"Atlanta Hawks","Trent Forrest",0,0,0,0,0,0
1,0,0,1,1,1,1,0,0,"06",0,0,3,0,0,0,1037636,"2023-10-30T00:00:00.000Z",1,FALSE,18,38017689,"F",1,1,"Atlanta Hawks","AJ Griffin",0,3,4,4,1,4.5
0,0,0,0,0,0,0,0,0,"01",0,0,0,0,0,0,1037636,"2023-10-30T00:00:00.000Z",1,FALSE,18,56677806,"F",1,1,"Atlanta Hawks","Mouhamed Gueye",0,0,0,0,0,0
0,0,0,0,0,0,0,0,0,"00",0,0,0,0,0,0,1037636,"2023-10-30T00:00:00.000Z",1,FALSE,18,666754,"G",1,1,"Atlanta Hawks","Garrison Mathews",0,0,0,0,0,0
0,0,0,0,0,0,0,0,0,"00",0,0,0,0,0,0,1037636,"2023-10-30T00:00:00.000Z",1,FALSE,18,319,"G",1,1,"Atlanta Hawks","Patty Mills",0,0,0,0,0,0
3,0,5,0,0,3,3,4,4,"24",2,1,10,7,0,0,1037636,"2023-10-30T00:00:00.000Z",1,FALSE,18,3547244,"F-C",1,1,"Atlanta Hawks","Onyeka Okongwu",0,17,20,13,10,22.9
0,0,0,0,0,0,0,0,0,"00",0,0,0,0,0,0,1037636,"2023-10-30T00:00:00.000Z",1,FALSE,18,56677855,"G",1,1,"Atlanta Hawks","Seth Lundy",0,0,0,0,0,0
0,0,0,0,0,0,0,0,0,"00",0,0,0,0,0,0,1037636,"2023-10-30T00:00:00.000Z",1,FALSE,18,301,"G-F",1,1,"Atlanta Hawks","Wesley Matthews",0,0,0,0,0,0
0,0,0,0,0,0,0,0,0,"00",0,0,0,0,0,0,1037636,"2023-10-30T00:00:00.000Z",1,FALSE,18,56677875,"F",1,1,"Atlanta Hawks","Miles Norris",0,0,0,0,0,0
2,1,3,2,2,6,5,0,0,"24",0,2,12,3,0,0,1037636,"2023-10-30T00:00:00.000Z",1,FALSE,18,3547259,"F",18,18,"Minnesota Timberwolves","Jaden McDaniels",1,15,17,14,5,21.6
3,0,8,3,1,17,7,1,1,"36",2,2,16,10,1,0,1037636,"2023-10-30T00:00:00.000Z",1,FALSE,18,447,"C",18,18,"Minnesota Timberwolves","Karl-Anthony Towns",1,26,29,19,13,35.5
1,2,7,0,0,7,3,11,8,"31",6,2,14,13,1,0,1037636,"2023-10-30T00:00:00.000Z",1,FALSE,18,176,"C",18,18,"Minnesota Timberwolves","Rudy Gobert",3,27,28,15,14,40.1
7,0,5,8,5,21,13,1,0,"38",0,4,31,5,1,5,1037636,"2023-10-30T00:00:00.000Z",1,FALSE,18,3547238,"G",18,18,"Minnesota Timberwolves","Anthony Edwards",1,36,43,38,12,45.5
3,0,1,6,2,9,2,0,0,"28",1,3,6,2,0,0,1037636,"2023-10-30T00:00:00.000Z",1,FALSE,18,104,"G",18,18,"Minnesota Timberwolves","Mike Conley",0,8,11,9,5,12.9
2,0,0,3,1,3,1,2,0,"13",0,1,3,0,0,1,1037636,"2023-10-30T00:00:00.000Z",1,FALSE,18,666400,"G",18,18,"Minnesota Timberwolves","Nickeil Alexander-Walker",0,3,5,5,2,5
5,1,1,2,0,5,2,0,0,"25",1,1,4,2,2,2,1037636,"2023-10-30T00:00:00.000Z",1,FALSE,18,12,"F",18,18,"Minnesota Timberwolves","Kyle Anderson",3,6,11,9,7,20.9
0,0,0,0,0,0,0,0,0,"00",0,0,0,0,0,0,1037636,"2023-10-30T00:00:00.000Z",1,FALSE,18,68,"F",18,18,"Minnesota Timberwolves","Troy Brown Jr.",0,0,0,0,0,0
0,0,1,0,0,1,1,0,0,"01",0,0,2,1,0,0,1037636,"2023-10-30T00:00:00.000Z",1,FALSE,18,17896056,"C",18,18,"Minnesota Timberwolves","Luka Garza",0,3,3,2,1,3.2
0,1,0,0,0,0,0,0,0,"01",0,0,0,0,0,0,1037636,"2023-10-30T00:00:00.000Z",1,FALSE,18,666767,"G",18,18,"Minnesota Timberwolves","Jordan McLaughlin",1,0,0,0,0,3
1,0,1,2,2,8,4,0,0,"17",0,1,10,1,0,1,1037636,"2023-10-30T00:00:00.000Z",1,FALSE,18,320,"G",18,18,"Minnesota Timberwolves","Shake Milton",0,11,12,11,2,11.7
0,0,0,0,0,1,1,0,0,"01",0,0,2,0,0,0,1037636,"2023-10-30T00:00:00.000Z",1,FALSE,18,38017715,"F",18,18,"Minnesota Timberwolves","Josh Minott",0,2,2,2,0,2
0,0,0,0,0,0,0,0,0,"01",0,0,0,0,0,0,1037636,"2023-10-30T00:00:00.000Z",1,FALSE,18,17895968,"F",18,18,"Minnesota Timberwolves","Daishen Nix",0,0,0,0,0,0
0,0,1,7,3,12,5,0,0,"24",0,1,13,1,0,1,1037636,"2023-10-30T00:00:00.000Z",1,FALSE,18,667378,"F-C",18,18,"Minnesota Timberwolves","Naz Reid",0,14,14,13,1,13.2
0,0,0,0,0,0,0,0,0,"00",0,0,0,0,0,0,1037636,"2023-10-30T00:00:00.000Z",1,FALSE,18,56677851,"G",18,18,"Minnesota Timberwolves","Jaylen Clark",0,0,0,0,0,0
0,0,0,0,0,0,0,0,0,"00",0,0,0,0,0,0,1037636,"2023-10-30T00:00:00.000Z",1,FALSE,18,56677782,"F",18,18,"Minnesota Timberwolves","Leonard Miller",0,0,0,0,0,0
0,0,0,0,0,0,0,0,0,"00",0,0,0,0,0,0,1037636,"2023-10-30T00:00:00.000Z",1,FALSE,18,38017700,"G",18,18,"Minnesota Timberwolves","Wendell Moore Jr.",0,0,0,0,0,0
1,1,3,9,2,12,4,0,0,"30",0,0,10,3,2,2,1037637,"2023-10-30T00:00:00.000Z",28,FALSE,25,18,"F",28,28,"Toronto Raptors","OG Anunoby",3,13,14,11,4,22.1
3,0,5,6,0,21,9,3,2,"35",1,1,20,6,1,0,1037637,"2023-10-30T00:00:00.000Z",28,FALSE,25,416,"F",28,28,"Toronto Raptors","Pascal Siakam",1,26,29,23,9,34.7
1,1,5,0,0,8,6,3,2,"29",5,3,14,10,0,2,1037637,"2023-10-30T00:00:00.000Z",28,FALSE,25,373,"C",28,28,"Toronto Raptors","Jakob Poeltl",1,24,25,15,11,28.5
2,1,8,4,1,19,8,3,3,"37",4,3,20,12,2,4,1037637,"2023-10-30T00:00:00.000Z",28,FALSE,25,17896055,"G-F",28,28,"Toronto Raptors","Scottie Barnes",3,32,34,22,14,42.4
8,0,1,3,1,10,4,1,1,"32",0,1,10,1,1,1,1037637,"2023-10-30T00:00:00.000Z",28,FALSE,25,409,"G",28,28,"Toronto Raptors","Dennis Schroder",1,11,19,18,9,25.2
1,1,4,0,0,4,1,2,2,"17",3,2,4,7,0,1,1037637,"2023-10-30T00:00:00.000Z",28,FALSE,25,58,"F",28,28,"Toronto Raptors","Chris Boucher",1,11,12,5,8,15.9
0,0,5,3,0,7,2,0,0,"21",1,3,4,6,2,0,1037637,"2023-10-30T00:00:00.000Z",28,FALSE,25,56677828,"G",28,28,"Toronto Raptors","Gradey Dick",2,10,10,4,6,17.2
0,0,1,2,0,5,3,0,0,"15",0,1,6,1,1,1,1037637,"2023-10-30T00:00:00.000Z",28,FALSE,25,3547275,"G",28,28,"Toronto Raptors","Malachi Flynn",1,7,7,6,1,9.2
0,0,0,0,0,0,0,0,0,"00",0,0,0,0,0,0,1037637,"2023-10-30T00:00:00.000Z",28,FALSE,25,38017717,"F",28,28,"Toronto Raptors","Ron Harper Jr.",0,0,0,0,0,0
1,0,0,1,0,1,0,0,0,"05",0,1,0,0,0,0,1037637,"2023-10-30T00:00:00.000Z",28,FALSE,25,666762,"F",28,28,"Toronto Raptors","Jalen McDaniels",0,0,1,1,1,1.5
0,0,0,0,0,0,0,0,0,"00",0,0,0,0,0,0,1037637,"2023-10-30T00:00:00.000Z",28,FALSE,25,376,"F",28,28,"Toronto Raptors","Otto Porter Jr.",0,0,0,0,0,0
0,0,0,0,0,0,0,0,0,"00",0,0,0,0,0,0,1037637,"2023-10-30T00:00:00.000Z",28,FALSE,25,436,"G-F",28,28,"Toronto Raptors","Garrett Temple",0,0,0,0,0,0
2,0,1,1,0,7,1,3,1,"19",0,2,3,1,1,0,1037637,"2023-10-30T00:00:00.000Z",28,FALSE,25,3089,"",28,28,"Toronto Raptors","Gary Trent Jr.",1,4,6,5,3,10.2
0,0,0,0,0,0,0,0,0,"00",0,0,0,0,0,0,1037637,"2023-10-30T00:00:00.000Z",28,FALSE,25,489,"F",28,28,"Toronto Raptors","Thaddeus Young",0,0,0,0,0,0
0,0,0,0,0,0,0,0,0,"00",0,0,0,0,0,0,1037637,"2023-10-30T00:00:00.000Z",28,FALSE,25,3547249,"F",28,28,"Toronto Raptors","Precious Achiuwa",0,0,0,0,0,0
0,0,0,0,0,0,0,0,0,"00",0,0,0,0,0,0,1037637,"2023-10-30T00:00:00.000Z",28,FALSE,25,56677805,"G",28,28,"Toronto Raptors","Javon Freeman-Liberty",0,0,0,0,0,0
0,0,0,0,0,0,0,0,0,"00",0,0,0,0,0,0,1037637,"2023-10-30T00:00:00.000Z",28,FALSE,25,38017710,"C",28,28,"Toronto Raptors","Christian Koloko",0,0,0,0,0,0
0,0,0,0,0,0,0,0,0,"00",0,0,0,0,0,0,1037637,"2023-10-30T00:00:00.000Z",28,FALSE,25,56677869,"G",28,28,"Toronto Raptors","Markquis Nowell",0,0,0,0,0,0
2,0,0,4,3,4,3,0,0,"19",0,1,9,0,0,0,1037637,"2023-10-30T00:00:00.000Z",28,FALSE,25,666923,"G-F",25,25,"Portland Trail Blazers","Matisse Thybulle",0,9,11,11,2,12
0,1,5,8,2,18,8,4,4,"37",1,2,22,6,1,2,1037637,"2023-10-30T00:00:00.000Z",28,FALSE,25,182,"F",25,25,"Portland Trail Blazers","Jerami Grant",2,28,28,22,6,33.2
2,2,16,0,0,9,5,0,0,"32",7,1,10,23,1,1,1037637,"2023-10-30T00:00:00.000Z",28,FALSE,25,22,"C",25,25,"Portland Trail Blazers","Deandre Ayton",3,33,35,12,25,48.6
0,0,0,0,0,0,0,0,0,"00",0,0,0,0,0,0,1037637,"2023-10-30T00:00:00.000Z",28,FALSE,25,56783340,"C",25,25,"Portland Trail Blazers","Duop Reath",0,0,0,0,0,0
3,2,3,5,2,10,4,4,4,"38",2,3,14,5,1,4,1037637,"2023-10-30T00:00:00.000Z",28,FALSE,25,38017690,"G",25,25,"Portland Trail Blazers","Shaedon Sharpe",3,19,22,17,8,29.5
7,0,4,6,0,12,4,4,3,"35",0,6,11,4,2,4,1037637,"2023-10-30T00:00:00.000Z",28,FALSE,25,56677747,"G",25,25,"Portland Trail Blazers","Scoot Henderson",2,15,22,18,11,28.3
5,0,2,7,3,21,9,1,0,"29",1,2,21,3,0,1,1037637,"2023-10-30T00:00:00.000Z",28,FALSE,25,65,"G",25,25,"Portland Trail Blazers","Malcolm Brogdon",0,24,29,26,8,31.1
0,1,5,2,0,4,1,2,1,"23",2,2,3,7,0,1,1037637,"2023-10-30T00:00:00.000Z",28,FALSE,25,56677850,"F",25,25,"Portland Trail Blazers","Toumani Camara",1,10,10,3,7,13.4
0,1,3,0,0,3,2,0,0,"16",0,2,4,3,0,1,1037637,"2023-10-30T00:00:00.000Z",28,FALSE,25,38017711,"F",25,25,"Portland Trail Blazers","Jabari Walker",1,7,7,4,3,9.6
1,0,0,3,1,4,2,0,0,"11",0,0,5,0,1,0,1037637,"2023-10-30T00:00:00.000Z",28,FALSE,25,3547289,"G",25,25,"Portland Trail Blazers","Skylar Mays",1,5,6,6,1,9.5
0,0,0,0,0,0,0,0,0,"00",0,0,0,0,0,0,1037637,"2023-10-30T00:00:00.000Z",28,FALSE,25,666476,"C",25,25,"Portland Trail Blazers","Moses Brown",0,0,0,0,0,0
0,0,0,0,0,0,0,0,0,"00",0,0,0,0,0,0,1037637,"2023-10-30T00:00:00.000Z",28,FALSE,25,47957121,"F",25,25,"Portland Trail Blazers","Justin Minaya",0,0,0,0,0,0
0,0,0,0,0,0,0,0,0,"00",0,0,0,0,0,0,1037637,"2023-10-30T00:00:00.000Z",28,FALSE,25,56677791,"F",25,25,"Portland Trail Blazers","Kris Murray",0,0,0,0,0,0
0,0,0,0,0,0,0,0,0,"00",0,0,0,0,0,0,1037637,"2023-10-30T00:00:00.000Z",28,FALSE,25,56677829,"G-F",25,25,"Portland Trail Blazers","Rayan Rupert",0,0,0,0,0,0
0,0,0,0,0,0,0,0,0,"00",0,0,0,0,0,0,1037637,"2023-10-30T00:00:00.000Z",28,FALSE,25,476,"C-F",25,25,"Portland Trail Blazers","Robert Williams III",0,0,0,0,0,0
0,0,0,0,0,0,0,0,0,"00",0,0,0,0,0,0,1037637,"2023-10-30T00:00:00.000Z",28,FALSE,25,17896120,"F",25,25,"Portland Trail Blazers","Ish Wainright",0,0,0,0,0,0
0,0,0,0,0,0,0,0,0,"00",0,0,0,0,0,0,1037637,"2023-10-30T00:00:00.000Z",28,FALSE,25,419,"G",25,25,"Portland Trail Blazers","Anfernee Simons",0,0,0,0,0,0
2,0,6,4,2,8,3,0,0,"33",1,2,8,7,1,3,1037638,"2023-10-30T00:00:00.000Z",15,FALSE,7,17896027,"G-F",15,15,"Memphis Grizzlies","Ziaire Williams",1,15,17,10,9,19.4
4,2,7,6,3,20,10,9,7,"34",2,3,30,9,0,1,1037638,"2023-10-30T00:00:00.000Z",15,FALSE,7,231,"F-C",15,15,"Memphis Grizzlies","Jaren Jackson Jr.",2,39,43,34,13,51.8
1,1,5,5,0,14,3,3,0,"29",2,0,6,7,2,0,1037638,"2023-10-30T00:00:00.000Z",15,FALSE,7,3547285,"F",15,15,"Memphis Grizzlies","Xavier Tillman",3,13,14,7,8,24.9
3,0,4,7,3,17,12,4,3,"37",2,3,30,6,3,2,1037638,"2023-10-30T00:00:00.000Z",15,FALSE,7,3547287,"G",15,15,"Memphis Grizzlies","Desmond Bane",3,36,39,33,9,48.7
9,0,4,10,5,17,9,0,0,"35",1,6,23,5,3,6,1037638,"2023-10-30T00:00:00.000Z",15,FALSE,7,420,"G",15,15,"Memphis Grizzlies","Marcus Smart",3,28,37,32,14,45.5
0,0,0,0,0,1,0,0,0,"01",0,0,0,0,0,0,1037638,"2023-10-30T00:00:00.000Z",15,FALSE,7,48248287,"G",15,15,"Memphis Grizzlies","Jacob Gilyard",0,0,0,0,0,0
0,0,0,0,0,0,0,0,0,"00",0,0,0,0,0,0,1037638,"2023-10-30T00:00:00.000Z",15,FALSE,7,3,"C",15,15,"Memphis Grizzlies","Steven Adams",0,0,0,0,0,0
0,0,0,0,0,0,0,0,0,"00",0,0,0,0,0,0,1037638,"2023-10-30T00:00:00.000Z",15,FALSE,7,17896067,"F",15,15,"Memphis Grizzlies","Santi Aldama",0,0,0,0,0,0
0,0,0,0,0,0,0,0,0,"00",0,0,0,0,0,0,1037638,"2023-10-30T00:00:00.000Z",15,FALSE,7,666505,"F",15,15,"Memphis Grizzlies","Brandon Clarke",0,0,0,0,0,0
0,0,0,0,0,0,0,0,0,"00",0,0,0,0,0,0,1037638,"2023-10-30T00:00:00.000Z",15,FALSE,7,254,"G",15,15,"Memphis Grizzlies","Luke Kennard",0,0,0,0,0,0
0,0,4,6,4,10,7,6,4,"27",0,0,22,4,0,1,1037638,"2023-10-30T00:00:00.000Z",15,FALSE,7,247,"F-G",7,7,"Dallas Mavericks","Derrick Jones Jr.",0,26,26,22,4,25.8
2,0,2,8,4,8,4,4,3,"31",1,1,15,3,0,1,1037638,"2023-10-30T00:00:00.000Z",15,FALSE,7,666965,"F",7,7,"Dallas Mavericks","Grant Williams",0,18,20,17,5,20.6
0,1,5,0,0,2,1,0,0,"14",1,5,2,6,0,0,1037638,"2023-10-30T00:00:00.000Z",15,FALSE,7,56677840,"C",7,7,"Dallas Mavericks","Dereck Lively II",1,8,8,2,6,12.2
0,0,0,0,0,0,0,0,0,"01",0,0,0,0,0,0,1037638,"2023-10-30T00:00:00.000Z",15,FALSE,7,56677830,"F",15,15,"Memphis Grizzlies","GG Jackson",0,0,0,0,0,0
1,0,3,2,1,2,1,0,0,"19",1,2,3,4,0,0,1037638,"2023-10-30T00:00:00.000Z",15,FALSE,7,666703,"G-F",15,15,"Memphis Grizzlies","John Konchar",0,7,8,4,5,9.3
0,0,0,1,0,1,0,0,0,"06",0,3,0,0,0,0,1037638,"2023-10-30T00:00:00.000Z",15,FALSE,7,38017728,"F",15,15,"Memphis Grizzlies","Jake LaRavia",0,0,0,0,0,0
0,0,0,0,0,0,0,0,0,"01",0,0,0,0,0,0,1037638,"2023-10-30T00:00:00.000Z",15,FALSE,7,38017732,"F",15,15,"Memphis Grizzlies","Kenneth Lofton Jr.",0,0,0,0,0,0
0,0,0,0,0,0,0,0,0,"00",0,0,0,0,0,0,1037638,"2023-10-30T00:00:00.000Z",15,FALSE,7,666786,"G",15,15,"Memphis Grizzlies","Ja Morant",0,0,0,0,0,0
2,1,4,1,0,8,4,2,1,"29",1,2,9,5,0,0,1037638,"2023-10-30T00:00:00.000Z",15,FALSE,7,38017729,"F",15,15,"Memphis Grizzlies","David Roddy",1,14,16,11,7,21
0,0,1,1,0,4,0,2,1,"14",0,1,1,1,0,0,1037638,"2023-10-30T00:00:00.000Z",15,FALSE,7,401,"G",15,15,"Memphis Grizzlies","Derrick Rose",0,2,2,1,1,2.2
0,0,0,0,0,0,0,0,0,"01",0,0,0,0,0,0,1037638,"2023-10-30T00:00:00.000Z",15,FALSE,7,38017731,"G",15,15,"Memphis Grizzlies","Vince Williams Jr.",0,0,0,0,0,0
0,0,0,0,0,0,0,0,0,"00",0,0,0,0,0,0,1037638,"2023-10-30T00:00:00.000Z",15,FALSE,7,217,"F-C",7,7,"Dallas Mavericks","Richaun Holmes",0,0,0,0,0,0
0,0,0,0,0,0,0,0,0,"00",0,0,0,0,0,0,1037638,"2023-10-30T00:00:00.000Z",15,FALSE,7,329,"F",7,7,"Dallas Mavericks","Markieff Morris",0,0,0,0,0,0
0,0,0,0,0,0,0,0,0,"00",0,0,0,0,0,0,1037638,"2023-10-30T00:00:00.000Z",15,FALSE,7,56677859,"F",7,7,"Dallas Mavericks","Olivier-Maxence Prosper",0,0,0,0,0,0
0,0,0,0,0,0,0,0,0,"00",0,0,0,0,0,0,1037638,"2023-10-30T00:00:00.000Z",15,FALSE,7,17896028,"F",7,7,"Dallas Mavericks","Greg Brown III",0,0,0,0,0,0
0,0,0,0,0,0,0,0,0,"00",0,0,0,0,0,0,1037638,"2023-10-30T00:00:00.000Z",15,FALSE,7,56677873,"G",7,7,"Dallas Mavericks","Dexter Dennis",0,0,0,0,0,0
0,0,0,0,0,0,0,0,0,"00",0,0,0,0,0,0,1037638,"2023-10-30T00:00:00.000Z",15,FALSE,7,228,"G",7,7,"Dallas Mavericks","Kyrie Irving",0,0,0,0,0,0
0,0,0,0,0,0,0,0,0,"00",0,0,0,0,0,0,1037638,"2023-10-30T00:00:00.000Z",15,FALSE,7,17554004,"G",7,7,"Dallas Mavericks","AJ Lawson",0,0,0,0,0,0
3,0,1,4,2,10,5,0,0,"34",1,0,12,2,1,1,1037638,"2023-10-30T00:00:00.000Z",15,FALSE,7,3547258,"G",7,7,"Dallas Mavericks","Josh Green",1,14,17,15,5,20.9
12,1,12,12,6,22,11,10,7,"40",0,4,35,12,1,6,1037638,"2023-10-30T00:00:00.000Z",15,FALSE,7,132,"F-G",7,7,"Dallas Mavericks","Luka Doncic",2,47,59,47,24,67.4
0,0,5,7,3,14,8,2,2,"29",0,1,21,5,0,1,1037638,"2023-10-30T00:00:00.000Z",15,FALSE,7,191,"G",7,7,"Dallas Mavericks","Tim Hardaway Jr.",0,26,26,21,5,26
2,0,4,3,1,4,2,2,2,"22",1,2,7,5,1,2,1037638,"2023-10-30T00:00:00.000Z",15,FALSE,7,257,"F",7,7,"Dallas Mavericks","Maxi Kleber",1,12,14,9,7,17
1,0,0,4,2,6,2,0,0,"10",0,1,6,0,0,1,1037638,"2023-10-30T00:00:00.000Z",15,FALSE,7,38017679,"G",7,7,"Dallas Mavericks","Jaden Hardy",0,6,7,7,1,6.5
2,0,4,0,0,3,1,0,0,"06",0,0,2,4,0,0,1037638,"2023-10-30T00:00:00.000Z",15,FALSE,7,151,"G",7,7,"Dallas Mavericks","Dante Exum",0,6,8,4,6,9.8
2,1,2,3,1,5,1,0,0,"15",0,2,3,2,1,1,1037638,"2023-10-30T00:00:00.000Z",15,FALSE,7,114,"G",7,7,"Dallas Mavericks","Seth Curry",2,5,7,5,4,13.4
0,4,3,0,0,0,0,0,0,"12",2,1,0,5,0,1,1037638,"2023-10-30T00:00:00.000Z",15,FALSE,7,379,"F-C",7,7,"Dallas Mavericks","Dwight Powell",4,5,5,0,5,17
5,0,2,2,0,4,1,4,3,"17",0,2,5,2,1,1,1037639,"2023-10-30T00:00:00.000Z",17,FALSE,16,315,"F",17,17,"Milwaukee Bucks","Khris Middleton",1,7,12,10,7,16.9
2,1,6,3,1,21,12,11,8,"32",1,3,33,7,0,2,1037639,"2023-10-30T00:00:00.000Z",17,FALSE,16,15,"F",17,17,"Milwaukee Bucks","Giannis Antetokounmpo",1,40,42,35,9,45.4
3,1,4,4,1,9,5,0,0,"29",3,3,11,7,1,2,1037639,"2023-10-30T00:00:00.000Z",17,FALSE,16,283,"C",17,17,"Milwaukee Bucks","Brook Lopez",2,18,21,14,10,27.9
2,0,3,6,1,8,2,2,0,"32",0,3,5,3,2,2,1037639,"2023-10-30T00:00:00.000Z",17,FALSE,16,38,"G",17,17,"Milwaukee Bucks","Malik Beasley",2,8,10,7,5,15.6
4,0,4,7,2,14,7,11,9,"35",1,2,25,5,1,4,1037639,"2023-10-30T00:00:00.000Z",17,FALSE,16,278,"G",17,17,"Milwaukee Bucks","Damian Lillard",1,30,34,29,9,36
2,1,5,3,2,5,3,0,0,"23",0,2,8,5,0,1,1037639,"2023-10-30T00:00:00.000Z",17,FALSE,16,105,"G",17,17,"Milwaukee Bucks","Pat Connaughton",1,13,15,10,7,19
2,1,4,3,2,7,3,0,0,"25",1,2,8,5,1,1,1037639,"2023-10-30T00:00:00.000Z",17,FALSE,16,112,"F",17,17,"Milwaukee Bucks","Jae Crowder",2,13,15,10,7,22
0,0,0,0,0,0,0,0,0,"00",0,0,0,0,0,0,1037639,"2023-10-30T00:00:00.000Z",17,FALSE,16,38017734,"F",16,16,"Miami Heat","Jamal Cain",0,0,0,0,0,0
0,0,0,0,0,0,0,0,0,"00",0,0,0,0,0,0,1037639,"2023-10-30T00:00:00.000Z",17,FALSE,16,3547257,"G",16,16,"Miami Heat","R.J. Hampton",0,0,0,0,0,0
3,1,1,5,2,9,3,0,0,"23",1,2,8,2,1,0,1037639,"2023-10-30T00:00:00.000Z",17,FALSE,16,56677785,"G",16,16,"Miami Heat","Jaime Jaquez Jr.",2,10,13,11,5,20.9
0,0,4,1,1,2,1,2,2,"07",0,0,5,4,0,2,1037639,"2023-10-30T00:00:00.000Z",17,FALSE,16,38017696,"F",16,16,"Miami Heat","Nikola Jovic",0,9,9,5,4,7.8
2,0,3,2,0,7,3,0,0,"23",0,3,6,3,0,0,1037639,"2023-10-30T00:00:00.000Z",17,FALSE,16,391,"G-F",16,16,"Miami Heat","Josh Richardson",0,9,11,8,5,12.6
1,0,0,7,3,10,6,0,0,"22",1,5,15,1,0,0,1037639,"2023-10-30T00:00:00.000Z",17,FALSE,16,397,"F",16,16,"Miami Heat","Duncan Robinson",0,16,17,16,2,17.7
7,0,5,1,1,7,4,2,2,"26",2,4,11,7,1,3,1037639,"2023-10-30T00:00:00.000Z",17,FALSE,16,39398582,"C",16,16,"Miami Heat","Orlando Robinson",1,18,25,18,14,29.9
0,0,0,0,0,0,0,0,0,"00",0,0,0,0,0,0,1037639,"2023-10-30T00:00:00.000Z",17,FALSE,16,19465585,"G",16,16,"Miami Heat","Dru Smith",0,0,0,0,0,0
0,0,0,0,0,0,0,0,0,"00",0,0,0,0,0,0,1037639,"2023-10-30T00:00:00.000Z",17,FALSE,16,4,"C-F",16,16,"Miami Heat","Bam Adebayo",0,0,0,0,0,0
0,0,0,0,0,0,0,0,0,"00",0,0,0,0,0,0,1037639,"2023-10-30T00:00:00.000Z",17,FALSE,16,3092,"",16,16,"Miami Heat","Haywood Highsmith",0,0,0,0,0,0
0,0,0,0,0,0,0,0,0,"00",0,0,0,0,0,0,1037639,"2023-10-30T00:00:00.000Z",17,FALSE,16,666747,"F",16,16,"Miami Heat","Caleb Martin",0,0,0,0,0,0
0,0,0,0,0,0,0,0,0,"00",0,0,0,0,0,0,1037639,"2023-10-30T00:00:00.000Z",17,FALSE,16,38017736,"F",16,16,"Miami Heat","Cole Swider",0,0,0,0,0,0
2,1,6,2,0,10,7,2,2,"19",2,3,16,8,2,0,1037639,"2023-10-30T00:00:00.000Z",17,FALSE,16,377,"F",17,17,"Milwaukee Bucks","Bobby Portis",3,24,26,18,10,37.6
2,0,0,3,0,4,0,0,0,"15",0,3,0,0,0,0,1037639,"2023-10-30T00:00:00.000Z",17,FALSE,16,38017733,"G",17,17,"Milwaukee Bucks","A.J. Green",0,0,2,2,2,3
0,0,0,4,3,5,4,0,0,"13",1,0,11,1,0,1,1037639,"2023-10-30T00:00:00.000Z",17,FALSE,16,368,"G",17,17,"Milwaukee Bucks","Cameron Payne",0,12,12,11,1,11.2
0,0,0,0,0,0,0,0,0,"00",0,0,0,0,0,0,1037639,"2023-10-30T00:00:00.000Z",17,FALSE,16,2148,"",17,17,"Milwaukee Bucks","Thanasis Antetokounmpo",0,0,0,0,0,0
0,0,0,0,0,0,0,0,0,"00",0,0,0,0,0,0,1037639,"2023-10-30T00:00:00.000Z",17,FALSE,16,56677852,"G",17,17,"Milwaukee Bucks","Andre Jackson Jr.",0,0,0,0,0,0
0,0,0,0,0,0,0,0,0,"00",0,0,0,0,0,0,1037639,"2023-10-30T00:00:00.000Z",17,FALSE,16,56677854,"F",17,17,"Milwaukee Bucks","Chris Livingston",0,0,0,0,0,0
0,0,0,0,0,0,0,0,0,"00",0,0,0,0,0,0,1037639,"2023-10-30T00:00:00.000Z",17,FALSE,16,284,"C",17,17,"Milwaukee Bucks","Robin Lopez",0,0,0,0,0,0
0,0,0,0,0,0,0,0,0,"00",0,0,0,0,0,0,1037639,"2023-10-30T00:00:00.000Z",17,FALSE,16,38017676,"F",17,17,"Milwaukee Bucks","MarJon Beauchamp",0,0,0,0,0,0
0,0,0,0,0,0,0,0,0,"00",0,0,0,0,0,0,1037639,"2023-10-30T00:00:00.000Z",17,FALSE,16,666453,"C",17,17,"Milwaukee Bucks","Marques Bolden",0,0,0,0,0,0
0,0,0,0,0,0,0,0,0,"00",0,0,0,0,0,0,1037639,"2023-10-30T00:00:00.000Z",17,FALSE,16,38017691,"G",17,17,"Milwaukee Bucks","TyTy Washington Jr.",0,0,0,0,0,0
0,0,0,0,0,0,0,0,0,"00",0,0,0,0,0,0,1037639,"2023-10-30T00:00:00.000Z",17,FALSE,16,666960,"G",17,17,"Milwaukee Bucks","Lindell Wigginton",0,0,0,0,0,0
4,1,2,2,1,11,4,4,4,"29",2,0,13,4,0,1,1037639,"2023-10-30T00:00:00.000Z",17,FALSE,16,79,"G-F",16,16,"Miami Heat","Jimmy Butler",1,17,21,17,8,25.8
3,0,5,5,1,6,1,0,0,"18",0,1,3,5,0,2,1037639,"2023-10-30T00:00:00.000Z",17,FALSE,16,285,"F-C",16,16,"Miami Heat","Kevin Love",0,8,11,6,8,11.5
0,0,2,1,0,7,4,2,2,"22",0,0,10,2,2,1,1037639,"2023-10-30T00:00:00.000Z",17,FALSE,16,74,"C",16,16,"Miami Heat","Thomas Bryant",2,12,12,10,2,17.4
3,0,7,5,2,21,12,10,9,"42",1,1,35,8,1,3,1037639,"2023-10-30T00:00:00.000Z",17,FALSE,16,666633,"G",16,16,"Miami Heat","Tyler Herro",1,43,46,38,11,49.1
4,0,4,5,2,6,3,0,0,"28",0,4,8,4,2,2,1037639,"2023-10-30T00:00:00.000Z",17,FALSE,16,286,"G",16,16,"Miami Heat","Kyle Lowry",2,12,16,12,8,22.8
1,1,2,4,0,5,1,2,2,"22",0,4,4,2,2,0,1037640,"2023-10-30T00:00:00.000Z",19,FALSE,10,17896024,"F",19,19,"New Orleans Pelicans","Herbert Jones",3,6,7,5,3,16.9
3,0,2,1,0,16,7,9,5,"30",3,5,19,5,2,4,1037640,"2023-10-30T00:00:00.000Z",19,FALSE,10,666969,"F",19,19,"New Orleans Pelicans","Zion Williamson",2,24,27,22,8,31.5
3,2,4,5,1,11,4,2,2,"23",2,1,11,6,0,0,1037640,"2023-10-30T00:00:00.000Z",19,FALSE,10,455,"C",19,19,"New Orleans Pelicans","Jonas Valanciunas",2,17,20,14,9,28.7
2,0,3,7,2,13,6,2,0,"35",2,1,14,5,2,1,1037640,"2023-10-30T00:00:00.000Z",19,FALSE,10,56677837,"G",19,19,"New Orleans Pelicans","Jordan Hawkins",2,19,21,16,7,28
5,0,4,8,2,21,7,4,3,"34",2,1,19,6,1,0,1037640,"2023-10-30T00:00:00.000Z",19,FALSE,10,303,"G",19,19,"New Orleans Pelicans","CJ McCollum",1,25,30,24,11,36.7
3,0,4,2,1,5,3,0,0,"24",0,1,7,4,0,0,1037640,"2023-10-30T00:00:00.000Z",19,FALSE,10,38017677,"G",19,19,"New Orleans Pelicans","Dyson Daniels",0,11,14,10,7,16.3
0,0,1,2,0,4,0,0,0,"07",0,0,0,1,0,0,1037640,"2023-10-30T00:00:00.000Z",19,FALSE,10,666584,"F",19,19,"New Orleans Pelicans","Kaiser Gates",0,1,1,0,1,1.2
0,0,0,0,0,0,0,0,0,"00",0,0,0,0,0,0,1037640,"2023-10-30T00:00:00.000Z",19,FALSE,10,227,"F",19,19,"New Orleans Pelicans","Brandon Ingram",0,0,0,0,0,0
2,0,0,2,0,6,4,4,3,"16",1,1,11,1,0,0,1037640,"2023-10-30T00:00:00.000Z",19,FALSE,10,3547260,"G",19,19,"New Orleans Pelicans","Kira Lewis Jr.",0,12,14,13,3,15.2
0,0,0,0,0,0,0,0,0,"00",0,0,0,0,0,0,1037640,"2023-10-30T00:00:00.000Z",19,FALSE,10,38017663,"F",19,19,"New Orleans Pelicans","E.J. Liddell",0,0,0,0,0,0
2,0,3,1,1,2,2,0,0,"17",2,2,5,5,0,3,1037640,"2023-10-30T00:00:00.000Z",19,FALSE,10,340,"F",19,19,"New Orleans Pelicans","Larry Nance Jr.",0,10,12,7,7,11
2,0,2,7,3,9,4,1,1,"27",1,2,12,3,0,2,1037640,"2023-10-30T00:00:00.000Z",19,FALSE,10,17896017,"F",19,19,"New Orleans Pelicans","Matt Ryan",0,15,17,14,5,16.6
0,0,1,0,0,2,0,2,0,"05",1,0,0,2,0,0,1037640,"2023-10-30T00:00:00.000Z",19,FALSE,10,491,"C",19,19,"New Orleans Pelicans","Cody Zeller",0,2,2,0,2,2.4
0,0,0,0,0,0,0,0,0,"00",0,0,0,0,0,0,1037640,"2023-10-30T00:00:00.000Z",19,FALSE,10,17896097,"G",19,19,"New Orleans Pelicans","Jose Alvarado",0,0,0,0,0,0
0,0,0,0,0,0,0,0,0,"00",0,0,0,0,0,0,1037640,"2023-10-30T00:00:00.000Z",19,FALSE,10,3547293,"F",19,19,"New Orleans Pelicans","Naji Marshall",0,0,0,0,0,0
0,0,0,0,0,0,0,0,0,"00",0,0,0,0,0,0,1037640,"2023-10-30T00:00:00.000Z",19,FALSE,10,18677986,"F",19,19,"New Orleans Pelicans","Trey Murphy III",0,0,0,0,0,0
0,0,0,0,0,0,0,0,0,"00",0,0,0,0,0,0,1037640,"2023-10-30T00:00:00.000Z",19,FALSE,10,38017726,"G",19,19,"New Orleans Pelicans","Dereon Seabron",0,0,0,0,0,0
0,0,2,2,1,8,4,2,0,"20",1,2,9,3,0,3,1037640,"2023-10-30T00:00:00.000Z",19,FALSE,10,475,"F-G",10,10,"Golden State Warriors","Andrew Wiggins",0,12,12,9,3,9.6
7,1,5,2,0,8,3,0,0,"21",1,2,6,6,0,1,1037640,"2023-10-30T00:00:00.000Z",19,FALSE,10,185,"F",10,10,"Golden State Warriors","Draymond Green",1,12,19,13,13,25.7
1,0,5,0,0,5,3,2,2,"24",2,2,8,7,1,1,1037640,"2023-10-30T00:00:00.000Z",19,FALSE,10,282,"F",10,10,"Golden State Warriors","Kevon Looney",1,15,16,9,8,19.9
0,4,2,0,0,10,5,4,3,"20",8,2,13,10,0,2,1037640,"2023-10-30T00:00:00.000Z",19,FALSE,10,56677799,"F",10,10,"Golden State Warriors","Trayce Jackson-Davis",4,23,23,13,10,35
1,0,1,1,0,1,0,0,0,"05",0,2,0,1,0,0,1037640,"2023-10-30T00:00:00.000Z",19,FALSE,10,251,"G",10,10,"Golden State Warriors","Cory Joseph",0,1,2,1,2,2.7
0,0,0,0,0,0,0,0,0,"00",0,0,0,0,0,0,1037640,"2023-10-30T00:00:00.000Z",19,FALSE,10,17896070,"F",10,10,"Golden State Warriors","Usman Garuba",0,0,0,0,0,0
0,0,0,0,0,0,0,0,0,"00",0,0,0,0,0,0,1037640,"2023-10-30T00:00:00.000Z",19,FALSE,10,17553979,"F",10,10,"Golden State Warriors","Jonathan Kuminga",0,0,0,0,0,0
0,0,0,0,0,0,0,0,0,"00",0,0,0,0,0,0,1037640,"2023-10-30T00:00:00.000Z",19,FALSE,10,443,"G",10,10,"Golden State Warriors","Klay Thompson",0,0,0,0,0,0
1,1,2,6,2,10,4,0,0,"20",2,4,10,4,1,0,1037640,"2023-10-30T00:00:00.000Z",19,FALSE,10,2189,"",10,10,"Golden State Warriors","Gary Payton II",2,14,15,11,5,22.3
2,0,7,1,0,5,2,2,1,"23",1,4,5,8,0,2,1037640,"2023-10-30T00:00:00.000Z",19,FALSE,10,56677858,"G",10,10,"Golden State Warriors","Brandin Podziemski",0,13,15,7,10,15.6
0,0,0,2,1,3,2,0,0,"05",0,0,5,0,0,0,1037640,"2023-10-30T00:00:00.000Z",19,FALSE,10,45658838,"G",10,10,"Golden State Warriors","Lester Quinones",0,5,5,5,0,5
0,0,1,0,0,2,0,0,0,"05",0,0,0,1,0,0,1037640,"2023-10-30T00:00:00.000Z",19,FALSE,10,398,"G",10,10,"Golden State Warriors","Jerome Robinson",0,1,1,0,1,1.2
2,1,6,4,1,7,2,2,1,"21",4,2,6,10,0,0,1037640,"2023-10-30T00:00:00.000Z",19,FALSE,10,407,"F",10,10,"Golden State Warriors","Dario Saric",1,16,18,8,12,24
4,0,1,5,2,8,5,1,1,"21",2,0,13,3,0,0,1037640,"2023-10-30T00:00:00.000Z",19,FALSE,10,17553992,"G",10,10,"Golden State Warriors","Moses Moody",0,16,20,17,7,22.6
5,0,5,13,7,22,15,7,5,"30",0,1,42,5,2,3,1037640,"2023-10-30T00:00:00.000Z",19,FALSE,10,115,"G",10,10,"Golden State Warriors","Stephen Curry",2,47,52,47,10,58.5
5,0,6,5,1,10,6,0,0,"25",0,0,13,6,2,1,1037640,"2023-10-30T00:00:00.000Z",19,FALSE,10,367,"G",10,10,"Golden State Warriors","Chris Paul",2,19,24,18,11,32.7
0,1,2,4,1,7,3,0,0,"26",0,1,7,2,2,0,1037641,"2023-10-30T00:00:00.000Z",21,FALSE,9,666541,"G",21,21,"Oklahoma City Thunder","Luguentz Dort",3,9,9,7,2,18.4
6,1,7,3,1,14,8,2,2,"31",0,2,19,7,1,2,1037641,"2023-10-30T00:00:00.000Z",21,FALSE,9,38017703,"G-F",21,21,"Oklahoma City Thunder","Jalen Williams",2,26,32,25,13,40.4
3,4,4,5,4,5,4,2,2,"24",0,5,14,4,2,3,1037641,"2023-10-30T00:00:00.000Z",21,FALSE,9,38017685,"C-F",21,21,"Oklahoma City Thunder","Chet Holmgren",6,18,21,17,7,38.3
3,1,4,2,0,18,9,5,3,"28",3,1,21,7,1,1,1037641,"2023-10-30T00:00:00.000Z",21,FALSE,9,17896065,"G",21,21,"Oklahoma City Thunder","Josh Giddey",2,28,31,24,10,38.9
4,0,8,3,1,23,11,9,9,"33",1,2,32,9,3,5,1037641,"2023-10-30T00:00:00.000Z",21,FALSE,9,175,"G",21,21,"Oklahoma City Thunder","Shai Gilgeous-Alexander",3,41,45,36,13,52.8
0,0,1,2,1,2,1,3,3,"13",0,1,6,1,0,0,1037641,"2023-10-30T00:00:00.000Z",21,FALSE,9,44,"F",21,21,"Oklahoma City Thunder","Davis Bertans",0,7,7,6,1,7.2
2,0,0,2,2,4,4,1,0,"18",1,0,10,1,0,1,1037641,"2023-10-30T00:00:00.000Z",21,FALSE,9,38017716,"F",21,21,"Oklahoma City Thunder","Ousmane Dieng",0,11,13,12,3,13.2
0,0,0,5,3,6,3,0,0,"20",0,1,9,0,0,1,1037641,"2023-10-30T00:00:00.000Z",21,FALSE,9,3547272,"G",21,21,"Oklahoma City Thunder","Isaiah Joe",0,9,9,9,0,8
0,0,0,0,0,0,0,0,0,"02",0,0,0,0,0,0,1037641,"2023-10-30T00:00:00.000Z",21,FALSE,9,17896036,"G",21,21,"Oklahoma City Thunder","Tre Mann",0,0,0,0,0,0
0,0,0,0,0,0,0,0,0,"00",0,0,0,0,0,0,1037641,"2023-10-30T00:00:00.000Z",21,FALSE,9,4197029,"G",21,21,"Oklahoma City Thunder","Vasilije Micic",0,0,0,0,0,0
1,3,8,0,0,0,0,4,2,"21",1,2,2,9,0,0,1037641,"2023-10-30T00:00:00.000Z",21,FALSE,9,24572055,"C",21,21,"Oklahoma City Thunder","Olivier Sarr",3,11,12,3,10,23.3
2,0,4,1,0,2,1,2,2,"22",0,2,4,4,0,1,1037641,"2023-10-30T00:00:00.000Z",21,FALSE,9,56677833,"G",21,21,"Oklahoma City Thunder","Cason Wallace",0,8,10,6,6,10.8
5,0,2,7,3,15,5,5,4,"36",0,1,17,2,0,7,1037641,"2023-10-30T00:00:00.000Z",21,FALSE,9,17896075,"G-F",9,9,"Detroit Pistons","Cade Cunningham",0,19,24,22,7,19.9
1,0,3,0,0,4,3,8,7,"24",1,1,13,4,0,0,1037641,"2023-10-30T00:00:00.000Z",21,FALSE,9,24,"F",9,9,"Detroit Pistons","Marvin Bagley III",0,17,18,14,5,19.3
7,0,1,4,3,9,4,0,0,"21",1,3,11,2,0,0,1037641,"2023-10-30T00:00:00.000Z",21,FALSE,9,77,"G",9,9,"Detroit Pistons","Alec Burks",0,13,20,18,9,23.9
1,0,0,0,0,1,0,0,0,"10",0,2,0,0,0,1,1037641,"2023-10-30T00:00:00.000Z",21,FALSE,9,197,"F-G",9,9,"Detroit Pistons","Joe Harris",0,0,1,1,1,0.5
3,1,1,6,4,13,7,2,2,"19",1,5,20,2,1,1,1037641,"2023-10-30T00:00:00.000Z",21,FALSE,9,38017682,"G",9,9,"Detroit Pistons","Jaden Ivey",2,22,25,23,5,31.9
2,0,2,2,2,4,2,0,0,"14",0,1,6,2,1,0,1037641,"2023-10-30T00:00:00.000Z",21,FALSE,9,56677792,"G",9,9,"Detroit Pistons","Marcus Sasser",1,8,10,8,4,14.4
0,0,0,0,0,0,0,0,0,"00",0,0,0,0,0,0,1037641,"2023-10-30T00:00:00.000Z",21,FALSE,9,38017706,"F",21,21,"Oklahoma City Thunder","Jaylin Williams",0,0,0,0,0,0
0,0,0,0,0,0,0,0,0,"00",0,0,0,0,0,0,1037641,"2023-10-30T00:00:00.000Z",21,FALSE,9,480,"G-F",21,21,"Oklahoma City Thunder","Kenrich Williams",0,0,0,0,0,0
3,3,3,2,0,14,6,4,3,"31",7,4,15,10,1,3,1037641,"2023-10-30T00:00:00.000Z",21,FALSE,9,56677826,"G-F",9,9,"Detroit Pistons","Ausar Thompson",4,25,28,18,13,40.5
1,0,7,3,2,9,4,2,2,"31",0,2,12,7,0,2,1037641,"2023-10-30T00:00:00.000Z",21,FALSE,9,3547267,"F-C",9,9,"Detroit Pistons","Isaiah Stewart",0,19,20,13,8,19.9
1,0,4,0,0,11,4,1,0,"23",3,3,8,7,1,1,1037641,"2023-10-30T00:00:00.000Z",21,FALSE,9,38017694,"C",9,9,"Detroit Pistons","Jalen Duren",1,15,16,9,8,19.9
7,1,4,4,1,11,4,2,1,"27",0,3,10,4,1,1,1037641,"2023-10-30T00:00:00.000Z",21,FALSE,9,3547241,"G",9,9,"Detroit Pistons","Killian Hayes",2,14,21,17,11,30.3
0,0,0,0,0,0,0,0,0,"00",0,0,0,0,0,0,1037641,"2023-10-30T00:00:00.000Z",21,FALSE,9,56677729,"G",9,9,"Detroit Pistons","Malcolm Cazalon",0,0,0,0,0,0
0,0,1,0,0,0,0,0,0,"02",0,0,0,1,0,0,1037641,"2023-10-30T00:00:00.000Z",21,FALSE,9,42097199,"G",9,9,"Detroit Pistons","Jared Rhoden",0,1,1,0,1,1.2
0,0,0,0,0,0,0,0,0,"02",0,0,0,0,1,0,1037641,"2023-10-30T00:00:00.000Z",21,FALSE,9,44477024,"G",9,9,"Detroit Pistons","Stanley Umude",1,0,0,0,0,3
0,0,0,0,0,0,0,0,0,"00",0,0,0,0,0,0,1037641,"2023-10-30T00:00:00.000Z",21,FALSE,9,3547240,"C",9,9,"Detroit Pistons","James Wiseman",0,0,0,0,0,0
0,0,0,0,0,0,0,0,0,"00",0,0,0,0,0,0,1037641,"2023-10-30T00:00:00.000Z",21,FALSE,9,54,"F",9,9,"Detroit Pistons","Bojan Bogdanovic",0,0,0,0,0,0
0,0,0,0,0,0,0,0,0,"00",0,0,0,0,0,0,1037641,"2023-10-30T00:00:00.000Z",21,FALSE,9,17896071,"F",9,9,"Detroit Pistons","Isaiah Livers",0,0,0,0,0,0
0,0,0,0,0,0,0,0,0,"00",0,0,0,0,0,0,1037641,"2023-10-30T00:00:00.000Z",21,FALSE,9,330,"G",9,9,"Detroit Pistons","Monte Morris",0,0,0,0,0,0
0,0,0,2,0,2,0,0,0,"02",0,2,0,0,0,1,1037641,"2023-10-30T00:00:00.000Z",21,FALSE,9,3547271,"C",21,21,"Oklahoma City Thunder","Aleksej Pokusevski",0,0,0,0,0,-1
0,0,0,0,0,0,0,0,0,"00",0,0,0,0,0,0,1037641,"2023-10-30T00:00:00.000Z",21,FALSE,9,17896078,"G",21,21,"Oklahoma City Thunder","Aaron Wiggins",0,0,0,0,0,0
0,0,0,0,0,0,0,0,0,"00",0,0,0,0,0,0,1037641,"2023-10-30T00:00:00.000Z",21,FALSE,9,56677853,"F",21,21,"Oklahoma City Thunder","Keyontae Johnson",0,0,0,0,0,0
0,0,0,0,0,0,0,0,0,"00",0,0,0,0,0,0,1037641,"2023-10-30T00:00:00.000Z",21,FALSE,9,27924547,"F",21,21,"Oklahoma City Thunder","Lindy Waters III",0,0,0,0,0,0
2,1,1,6,2,8,3,0,0,"19",0,3,8,1,0,1,1037642,"2023-10-30T00:00:00.000Z",8,FALSE,29,375,"F",8,8,"Denver Nuggets","Michael Porter Jr.",1,9,11,10,3,14.2
2,0,4,0,0,12,10,4,1,"33",3,2,21,7,0,3,1037642,"2023-10-30T00:00:00.000Z",8,FALSE,29,177,"F",8,8,"Denver Nuggets","Aaron Gordon",0,28,30,23,9,29.4
11,2,9,3,1,16,12,5,2,"35",1,3,27,10,0,1,1037642,"2023-10-30T00:00:00.000Z",8,FALSE,29,246,"C",8,8,"Denver Nuggets","Nikola Jokic",2,37,48,38,21,60.5
0,2,3,4,2,5,3,0,0,"33",0,4,8,3,1,2,1037642,"2023-10-30T00:00:00.000Z",8,FALSE,29,81,"G",8,8,"Denver Nuggets","Kentavious Caldwell-Pope",3,11,11,8,3,18.6
14,2,3,7,3,19,7,2,1,"37",0,0,18,3,0,3,1037642,"2023-10-30T00:00:00.000Z",8,FALSE,29,335,"G",8,8,"Denver Nuggets","Jamal Murray",2,21,35,32,17,45.6
2,0,7,2,1,8,4,0,0,"30",1,0,9,8,1,1,1037642,"2023-10-30T00:00:00.000Z",8,FALSE,29,38017709,"G",8,8,"Denver Nuggets","Christian Braun",1,17,19,11,10,23.6
0,0,0,0,0,0,0,0,0,"00",0,0,0,0,0,0,1037642,"2023-10-30T00:00:00.000Z",8,FALSE,29,56677871,"F",8,8,"Denver Nuggets","Hunter Tyson",0,0,0,0,0,0
0,1,2,1,0,4,2,2,1,"15",0,0,5,2,0,0,1037642,"2023-10-30T00:00:00.000Z",8,FALSE,29,38017721,"G",8,8,"Denver Nuggets","Peyton Watson",1,7,7,5,2,10.4
0,0,0,0,0,0,0,0,0,"00",0,0,0,0,0,0,1037642,"2023-10-30T00:00:00.000Z",8,FALSE,29,38017727,"G",8,8,"Denver Nuggets","Collin Gillespie",0,0,0,0,0,0
0,0,0,0,0,0,0,0,0,"00",0,0,0,0,0,0,1037642,"2023-10-30T00:00:00.000Z",8,FALSE,29,215,"F-G",8,8,"Denver Nuggets","Justin Holiday",0,0,0,0,0,0
1,0,3,3,0,6,2,1,0,"19",1,2,4,4,0,1,1037642,"2023-10-30T00:00:00.000Z",8,FALSE,29,236,"G",8,8,"Denver Nuggets","Reggie Jackson",0,8,9,5,5,9.3
0,0,0,0,0,0,0,0,0,"00",0,0,0,0,0,0,1037642,"2023-10-30T00:00:00.000Z",8,FALSE,29,250,"C",8,8,"Denver Nuggets","DeAndre Jordan",0,0,0,0,0,0
0,0,2,0,0,2,2,3,2,"13",1,0,6,3,2,0,1037642,"2023-10-30T00:00:00.000Z",8,FALSE,29,3547268,"F-C",8,8,"Denver Nuggets","Zeke Nnaji",2,9,9,6,3,15.6
0,0,0,0,0,0,0,0,0,"00",0,0,0,0,0,0,1037642,"2023-10-30T00:00:00.000Z",8,FALSE,29,56677582,"G",8,8,"Denver Nuggets","Jalen Pickett",0,0,0,0,0,0
0,0,2,2,0,4,2,0,0,"06",0,0,4,2,0,0,1037642,"2023-10-30T00:00:00.000Z",8,FALSE,29,56677776,"G",8,8,"Denver Nuggets","Julian Strawther",0,6,6,4,2,6.4
0,0,0,0,0,0,0,0,0,"00",0,0,0,0,0,0,1037642,"2023-10-30T00:00:00.000Z",8,FALSE,29,56677842,"F",29,29,"Utah Jazz","Brice Sensabaugh",0,0,0,0,0,0
0,1,10,0,0,11,10,3,2,"29",3,4,22,13,0,2,1037642,"2023-10-30T00:00:00.000Z",8,FALSE,29,38017705,"C",29,29,"Utah Jazz","Walker Kessler",1,35,35,22,13,38.6
8,0,3,3,2,12,7,0,0,"29",0,4,16,3,0,1,1037642,"2023-10-30T00:00:00.000Z",8,FALSE,29,666650,"G",29,29,"Utah Jazz","Talen Horton-Tucker",0,19,27,24,11,30.6
6,0,1,4,0,10,2,3,0,"34",2,1,4,3,1,5,1037642,"2023-10-30T00:00:00.000Z",8,FALSE,29,100,"G",29,29,"Utah Jazz","Jordan Clarkson",1,7,13,10,9,14.6
5,0,2,2,0,2,0,4,3,"18",2,4,3,4,3,1,1037642,"2023-10-30T00:00:00.000Z",8,FALSE,29,358,"F",29,29,"Utah Jazz","Kelly Olynyk",3,7,12,8,9,23.3
0,0,0,5,2,10,5,0,0,"17",0,2,12,0,0,1,1037642,"2023-10-30T00:00:00.000Z",8,FALSE,29,413,"G",29,29,"Utah Jazz","Collin Sexton",0,12,12,12,0,11
0,0,0,0,0,0,0,0,0,"00",0,0,0,0,0,0,1037642,"2023-10-30T00:00:00.000Z",8,FALSE,29,17896007,"G",8,8,"Denver Nuggets","Braxton Key",0,0,0,0,0,0
1,0,6,3,1,16,7,3,0,"34",3,3,15,9,1,0,1037642,"2023-10-30T00:00:00.000Z",8,FALSE,29,101,"F-C",29,29,"Utah Jazz","John Collins",1,24,25,16,10,30.3
5,1,9,13,5,24,10,2,2,"38",5,2,27,14,0,2,1037642,"2023-10-30T00:00:00.000Z",8,FALSE,29,297,"F",29,29,"Utah Jazz","Lauri Markkanen",1,41,46,32,19,52.3
2,0,0,4,1,6,1,0,0,"20",1,0,3,1,1,0,1037642,"2023-10-30T00:00:00.000Z",8,FALSE,29,56677834,"G",29,29,"Utah Jazz","Keyonte George",1,4,6,5,3,10.2
2,0,1,2,0,5,0,0,0,"15",1,0,0,2,0,0,1037642,"2023-10-30T00:00:00.000Z",8,FALSE,29,38017620,"G",29,29,"Utah Jazz","Ochai Agbaji",0,2,4,2,4,5.4
1,0,2,1,0,2,0,0,0,"06",0,1,0,2,0,0,1037642,"2023-10-30T00:00:00.000Z",8,FALSE,29,139,"G",29,29,"Utah Jazz","Kris Dunn",0,2,3,1,3,3.9
0,0,0,0,0,0,0,0,0,"00",0,0,0,0,0,0,1037642,"2023-10-30T00:00:00.000Z",8,FALSE,29,38017739,"F",29,29,"Utah Jazz","Simone Fontecchio",0,0,0,0,0,0
0,0,0,0,0,0,0,0,0,"00",0,0,0,0,0,0,1037642,"2023-10-30T00:00:00.000Z",8,FALSE,29,666881,"F",29,29,"Utah Jazz","Luka Samanic",0,0,0,0,0,0
0,0,0,0,0,0,0,0,0,"00",0,0,0,0,0,0,1037642,"2023-10-30T00:00:00.000Z",8,FALSE,29,11891374,"C",29,29,"Utah Jazz","Omer Yurtseven",0,0,0,0,0,0
0,0,0,0,0,0,0,0,0,"00",0,0,0,0,0,0,1037642,"2023-10-30T00:00:00.000Z",8,FALSE,29,17896023,"G",29,29,"Utah Jazz","Josh Christopher",0,0,0,0,0,0
0,0,0,0,0,0,0,0,0,"00",0,0,0,0,0,0,1037642,"2023-10-30T00:00:00.000Z",8,FALSE,29,56677824,"F",29,29,"Utah Jazz","Taylor Hendricks",0,0,0,0,0,0
0,0,0,0,0,0,0,0,0,"00",0,0,0,0,0,0,1037642,"2023-10-30T00:00:00.000Z",8,FALSE,29,38017630,"G",29,29,"Utah Jazz","Johnny Juzang",0,0,0,0,0,0
0,0,0,0,0,0,0,0,0,"00",0,0,0,0,0,0,1037642,"2023-10-30T00:00:00.000Z",8,FALSE,29,19465584,"F",29,29,"Utah Jazz","Micah Potter",0,0,0,0,0,0
0,0,0,0,0,0,0,0,0,"00",0,0,0,0,0,0,1037642,"2023-10-30T00:00:00.000Z",8,FALSE,29,666489,"F",8,8,"Denver Nuggets","Vlatko Cancar",0,0,0,0,0,0
0,0,0,0,0,0,0,0,0,"00",0,0,0,0,0,0,1037642,"2023-10-30T00:00:00.000Z",8,FALSE,29,17896103,"F-C",8,8,"Denver Nuggets","Jay Huff",0,0,0,0,0,0
1,1,0,2,0,4,1,2,2,"26",0,3,4,0,0,0,1037643,"2023-10-30T00:00:00.000Z",14,FALSE,22,383,"F",14,14,"Los Angeles Lakers","Taurean Prince",1,4,5,5,1,8.5
4,1,3,6,2,17,7,4,3,"33",0,0,19,3,3,5,1037643,"2023-10-30T00:00:00.000Z",14,FALSE,22,237,"F",14,14,"Los Angeles Lakers","LeBron James",4,22,26,23,7,35.6
5,3,17,1,0,18,12,3,2,"38",2,3,26,19,1,1,1037643,"2023-10-30T00:00:00.000Z",14,FALSE,22,117,"F-C",14,14,"Los Angeles Lakers","Anthony Davis",4,45,50,31,24,67.3
3,1,3,4,1,12,5,0,0,"31",0,0,11,3,0,3,1037643,"2023-10-30T00:00:00.000Z",14,FALSE,22,17553995,"G",14,14,"Los Angeles Lakers","Austin Reaves",1,14,17,14,6,19.1
8,1,2,6,3,14,10,5,5,"36",0,4,28,2,1,3,1037643,"2023-10-30T00:00:00.000Z",14,FALSE,22,405,"G",14,14,"Los Angeles Lakers","D'Angelo Russell",2,30,38,36,10,45.4
0,0,0,0,0,0,0,0,0,"00",0,0,0,0,0,0,1037643,"2023-10-30T00:00:00.000Z",14,FALSE,22,56677738,"C",14,14,"Los Angeles Lakers","Colin Castleton",0,0,0,0,0,0
0,0,0,0,0,0,0,0,0,"00",0,0,0,0,0,0,1037643,"2023-10-30T00:00:00.000Z",14,FALSE,22,38017697,"G",14,14,"Los Angeles Lakers","Max Christie",0,0,0,0,0,0
0,0,2,0,0,0,0,0,0,"10",0,2,0,2,0,0,1037643,"2023-10-30T00:00:00.000Z",14,FALSE,22,666626,"C",14,14,"Los Angeles Lakers","Jaxson Hayes",0,2,2,0,2,2.4
0,0,0,0,0,0,0,0,0,"00",0,0,0,0,0,0,1037643,"2023-10-30T00:00:00.000Z",14,FALSE,22,56677868,"G",14,14,"Los Angeles Lakers","D'Moi Hodge",0,0,0,0,0,0
0,0,0,0,0,0,0,0,0,"00",0,0,0,0,0,0,1037643,"2023-10-30T00:00:00.000Z",14,FALSE,22,56677836,"F",14,14,"Los Angeles Lakers","Maxwell Lewis",0,0,0,0,0,0
2,0,2,1,0,1,0,0,0,"14",0,0,0,2,1,1,1037643,"2023-10-30T00:00:00.000Z",14,FALSE,22,666860,"F-G",14,14,"Los Angeles Lakers","Cameron Reddish",1,2,4,2,4,7.4
2,0,0,3,1,7,4,0,0,"25",0,2,9,0,1,0,1037643,"2023-10-30T00:00:00.000Z",14,FALSE,22,1603383,"G",14,14,"Los Angeles Lakers","Gabe Vincent",1,9,11,11,2,15
3,3,8,4,1,6,3,4,2,"27",1,3,9,9,0,3,1037643,"2023-10-30T00:00:00.000Z",14,FALSE,22,486,"F",14,14,"Los Angeles Lakers","Christian Wood",3,18,21,12,12,30.3
0,0,0,0,0,0,0,0,0,"00",0,0,0,0,0,0,1037643,"2023-10-30T00:00:00.000Z",14,FALSE,22,56677867,"F",14,14,"Los Angeles Lakers","Alex Fudge",0,0,0,0,0,0
0,0,0,0,0,0,0,0,0,"00",0,0,0,0,0,0,1037643,"2023-10-30T00:00:00.000Z",14,FALSE,22,666609,"F",14,14,"Los Angeles Lakers","Rui Hachimura",0,0,0,0,0,0
0,0,0,0,0,0,0,0,0,"00",0,0,0,0,0,0,1037643,"2023-10-30T00:00:00.000Z",14,FALSE,22,56677835,"G",14,14,"Los Angeles Lakers","Jalen Hood-Schifino",0,0,0,0,0,0
0,0,0,0,0,0,0,0,0,"00",0,0,0,0,0,0,1037643,"2023-10-30T00:00:00.000Z",14,FALSE,22,457,"F",14,14,"Los Angeles Lakers","Jarred Vanderbilt",0,0,0,0,0,0
4,0,6,7,2,17,5,4,4,"37",2,4,16,8,2,2,1037643,"2023-10-30T00:00:00.000Z",14,FALSE,22,17896026,"F",22,22,"Orlando Magic","Franz Wagner",2,24,28,20,12,35.6
5,0,4,5,1,14,4,2,0,"31",1,3,9,5,0,2,1037643,"2023-10-30T00:00:00.000Z",14,FALSE,22,38017683,"F",22,22,"Orlando Magic","Paolo Banchero",0,14,19,14,10,20.5
1,1,6,3,1,8,4,2,1,"35",2,4,10,8,0,0,1037643,"2023-10-30T00:00:00.000Z",14,FALSE,22,85,"F",22,22,"Orlando Magic","Wendell Carter Jr.",1,18,19,11,9,24.1
8,2,3,1,0,16,7,0,0,"33",1,2,14,4,1,1,1037643,"2023-10-30T00:00:00.000Z",14,FALSE,22,165,"G",22,22,"Orlando Magic","Markelle Fultz",3,18,26,22,12,38.8
2,0,3,3,1,12,4,4,3,"21",0,2,12,3,3,1,1037643,"2023-10-30T00:00:00.000Z",14,FALSE,22,3547251,"G",22,22,"Orlando Magic","Cole Anthony",3,15,17,14,5,26.6
0,0,0,1,0,5,2,2,1,"12",1,2,5,1,0,1,1037643,"2023-10-30T00:00:00.000Z",14,FALSE,22,462,"C",22,22,"Orlando Magic","Moritz Wagner",0,6,6,5,1,5.2
0,0,3,3,1,3,1,0,0,"11",0,1,3,3,1,0,1037643,"2023-10-30T00:00:00.000Z",14,FALSE,22,229,"F",22,22,"Orlando Magic","Jonathan Isaac",1,6,6,3,3,9.6
3,0,0,0,0,2,1,0,0,"12",1,2,2,1,2,1,1037643,"2023-10-30T00:00:00.000Z",14,FALSE,22,226,"F",22,22,"Orlando Magic","Joe Ingles",2,3,6,5,4,12.7
3,0,2,5,5,6,6,0,0,"21",1,0,17,3,0,3,1037643,"2023-10-30T00:00:00.000Z",14,FALSE,22,196,"G",22,22,"Orlando Magic","Gary Harris",0,20,23,20,6,22.1
0,0,0,0,0,0,0,0,0,"01",0,0,0,0,0,0,1037643,"2023-10-30T00:00:00.000Z",14,FALSE,22,666442,"C",22,22,"Orlando Magic","Goga Bitadze",0,0,0,0,0,0
0,0,0,0,0,0,0,0,0,"00",0,0,0,0,0,0,1037643,"2023-10-30T00:00:00.000Z",14,FALSE,22,56677827,"G",22,22,"Orlando Magic","Anthony Black",0,0,0,0,0,0
0,0,0,0,0,0,0,0,0,"00",0,0,0,0,0,0,1037643,"2023-10-30T00:00:00.000Z",14,FALSE,22,38017724,"G",22,22,"Orlando Magic","Caleb Houstan",0,0,0,0,0,0
0,0,0,0,0,0,0,0,0,"00",0,0,0,0,0,0,1037643,"2023-10-30T00:00:00.000Z",14,FALSE,22,56677839,"G",22,22,"Orlando Magic","Jett Howard",0,0,0,0,0,0
0,0,0,0,0,0,0,0,0,"00",0,0,0,0,0,0,1037643,"2023-10-30T00:00:00.000Z",14,FALSE,22,666818,"F",22,22,"Orlando Magic","Chuma Okeke",0,0,0,0,0,0
0,0,0,0,0,0,0,0,0,"00",0,0,0,0,0,0,1037643,"2023-10-30T00:00:00.000Z",14,FALSE,22,38017607,"G",22,22,"Orlando Magic","Kevon Harris",0,0,0,0,0,0
0,0,0,0,0,0,0,0,0,"00",0,0,0,0,0,0,1037643,"2023-10-30T00:00:00.000Z",14,FALSE,22,17553983,"G",22,22,"Orlando Magic","Trevelin Queen",0,0,0,0,0,0
0,0,0,0,0,0,0,0,0,"00",0,0,0,0,0,0,1037643,"2023-10-30T00:00:00.000Z",14,FALSE,22,666885,"F",22,22,"Orlando Magic","Admiral Schofield",0,0,0,0,0,0
2,0,5,7,3,12,4,4,4,"26",3,2,15,8,1,0,1037643,"2023-10-30T00:00:00.000Z",14,FALSE,22,17896073,"G",22,22,"Orlando Magic","Jalen Suggs",1,23,25,17,10,30.6
0,0,4,5,2,11,4,2,1,"25",3,2,11,7,0,1,1037644,"2023-10-31T00:00:00.000Z",6,FALSE,20,3547247,"F-G",6,6,"Cleveland Cavaliers","Isaac Okoro",0,18,18,11,7,18.4
1,0,1,4,0,5,0,0,0,"16",2,3,0,3,0,1,1037644,"2023-10-31T00:00:00.000Z",6,FALSE,20,666940,"F",6,6,"Cleveland Cavaliers","Dean Wade",0,3,4,1,4,4.1
5,2,8,0,0,9,3,0,0,"29",4,0,6,12,0,2,1037644,"2023-10-31T00:00:00.000Z",6,FALSE,20,17896076,"F-C",6,6,"Cleveland Cavaliers","Evan Mobley",2,18,23,11,17,31.9
3,0,3,7,1,9,2,2,1,"33",0,2,6,3,0,0,1037644,"2023-10-31T00:00:00.000Z",6,FALSE,20,666908,"G",6,6,"Cleveland Cavaliers","Max Strus",0,9,12,9,6,14.1
3,0,1,3,0,20,11,4,4,"29",2,2,26,3,3,2,1037644,"2023-10-31T00:00:00.000Z",6,FALSE,20,322,"G",6,6,"Cleveland Cavaliers","Donovan Mitchell",3,29,32,29,6,41.1
1,1,5,5,2,8,3,2,1,"23",1,1,9,6,0,1,1037644,"2023-10-31T00:00:00.000Z",6,FALSE,20,56677847,"F",6,6,"Cleveland Cavaliers","Emoni Bates",1,15,16,10,7,19.7
0,0,1,0,0,1,1,0,0,"05",0,0,2,1,0,0,1037644,"2023-10-31T00:00:00.000Z",6,FALSE,20,248,"C",6,6,"Cleveland Cavaliers","Damian Jones",0,3,3,2,1,3.2
2,0,1,4,2,4,2,0,0,"14",0,0,6,1,1,1,1037644,"2023-10-31T00:00:00.000Z",6,FALSE,20,3547299,"G",6,6,"Cleveland Cavaliers","Sam Merrill",1,7,9,8,3,12.2
0,0,1,0,0,0,0,0,0,"01",0,1,0,1,0,0,1037644,"2023-10-31T00:00:00.000Z",6,FALSE,20,38017662,"F",6,6,"Cleveland Cavaliers","Isaiah Mobley",0,1,1,0,1,1.2
1,0,3,9,3,12,4,0,0,"24",0,3,11,3,0,2,1037644,"2023-10-31T00:00:00.000Z",6,FALSE,20,344,"F",6,6,"Cleveland Cavaliers","Georges Niang",0,14,15,12,4,14.1
2,1,3,1,0,12,5,0,0,"22",1,3,10,4,2,3,1037644,"2023-10-31T00:00:00.000Z",6,FALSE,20,56677872,"G",6,6,"Cleveland Cavaliers","Craig Porter",3,14,16,12,6,23.8
1,2,1,0,0,1,1,2,2,"19",1,2,4,2,0,2,1037644,"2023-10-31T00:00:00.000Z",6,FALSE,20,444,"C-F",6,6,"Cleveland Cavaliers","Tristan Thompson",2,6,7,5,3,11.9
0,0,0,0,0,0,0,0,0,"00",0,0,0,0,0,0,1037644,"2023-10-31T00:00:00.000Z",6,FALSE,20,9,"C",6,6,"Cleveland Cavaliers","Jarrett Allen",0,0,0,0,0,0
0,0,0,0,0,0,0,0,0,"00",0,0,0,0,0,0,1037644,"2023-10-31T00:00:00.000Z",6,FALSE,20,666581,"G",6,6,"Cleveland Cavaliers","Darius Garland",0,0,0,0,0,0
0,0,0,0,0,0,0,0,0,"00",0,0,0,0,0,0,1037644,"2023-10-31T00:00:00.000Z",6,FALSE,20,666676,"G",6,6,"Cleveland Cavaliers","Ty Jerome",0,0,0,0,0,0
0,0,0,0,0,0,0,0,0,"00",0,0,0,0,0,0,1037644,"2023-10-31T00:00:00.000Z",6,FALSE,20,277,"G",6,6,"Cleveland Cavaliers","Caris LeVert",0,0,0,0,0,0
0,0,0,0,0,0,0,0,0,"00",0,0,0,0,0,0,1037644,"2023-10-31T00:00:00.000Z",6,FALSE,20,404,"G",6,6,"Cleveland Cavaliers","Ricky Rubio",0,0,0,0,0,0
0,0,2,5,3,13,5,4,3,"25",1,2,16,3,0,1,1037644,"2023-10-31T00:00:00.000Z",6,FALSE,20,666423,"F-G",20,20,"New York Knicks","RJ Barrett",0,19,19,16,3,18.6
2,0,7,5,2,14,5,10,7,"31",3,1,19,10,1,1,1037644,"2023-10-31T00:00:00.000Z",6,FALSE,20,387,"F",20,20,"New York Knicks","Julius Randle",1,29,31,21,12,36
1,0,0,0,0,1,0,0,0,"03",1,0,0,1,0,0,1037644,"2023-10-31T00:00:00.000Z",6,FALSE,20,17896063,"F",20,20,"New York Knicks","Jericho Sims",0,1,2,1,2,2.7
0,0,1,1,0,1,0,0,0,"03",0,0,0,1,0,0,1037644,"2023-10-31T00:00:00.000Z",6,FALSE,20,666971,"G-F",20,20,"New York Knicks","Dylan Windler",0,1,1,0,1,1.2
0,0,0,0,0,0,0,0,0,"00",0,0,0,0,0,0,1037644,"2023-10-31T00:00:00.000Z",6,FALSE,20,666474,"G",20,20,"New York Knicks","Charles Brown",0,0,0,0,0,0
0,0,0,0,0,0,0,0,0,"00",0,0,0,0,0,0,1037644,"2023-10-31T00:00:00.000Z",6,FALSE,20,56677795,"F",20,20,"New York Knicks","Jacob Toppin",0,0,0,0,0,0
0,0,0,0,0,0,0,0,0,"00",0,0,0,0,0,0,1037644,"2023-10-31T00:00:00.000Z",6,FALSE,20,17896089,"G",20,20,"New York Knicks","Duane Washington Jr.",0,0,0,0,0,0
0,0,4,0,0,4,4,0,0,"22",3,0,8,7,1,1,1037644,"2023-10-31T00:00:00.000Z",6,FALSE,20,399,"C",20,20,"New York Knicks","Mitchell Robinson",1,15,15,8,7,18.4
1,0,1,3,1,4,2,0,0,"22",0,3,5,1,2,0,1037644,"2023-10-31T00:00:00.000Z",6,FALSE,20,17895858,"G",20,20,"New York Knicks","Quentin Grimes",2,6,7,6,2,13.7
2,0,5,3,1,16,7,5,4,"34",0,1,19,5,2,5,1037644,"2023-10-31T00:00:00.000Z",6,FALSE,20,73,"G",20,20,"New York Knicks","Jalen Brunson",2,24,26,21,7,29
3,0,7,3,1,6,2,0,0,"28",0,2,5,7,0,1,1037644,"2023-10-31T00:00:00.000Z",6,FALSE,20,202,"G",20,20,"New York Knicks","Josh Hart",0,12,15,8,10,16.9
2,0,3,6,3,11,6,3,3,"24",0,0,18,3,0,3,1037644,"2023-10-31T00:00:00.000Z",6,FALSE,20,3547269,"G",20,20,"New York Knicks","Immanuel Quickley",0,21,23,20,5,21.6
1,1,3,2,0,10,5,3,3,"23",4,3,13,7,2,1,1037644,"2023-10-31T00:00:00.000Z",6,FALSE,20,201,"F-C",20,20,"New York Knicks","Isaiah Hartenstein",3,20,21,14,8,30.9
6,0,2,3,1,3,1,0,0,"15",0,3,3,2,1,1,1037644,"2023-10-31T00:00:00.000Z",6,FALSE,20,131,"G",20,20,"New York Knicks","Donte DiVincenzo",1,5,11,9,8,16.4
0,0,1,0,0,0,0,0,0,"02",0,0,0,1,0,0,1037644,"2023-10-31T00:00:00.000Z",6,FALSE,20,19,"G",20,20,"New York Knicks","Ryan Arcidiacono",0,1,1,0,1,1.2
0,0,0,0,0,0,0,0,0,"00",0,0,0,0,0,0,1037644,"2023-10-31T00:00:00.000Z",6,FALSE,20,160,"G-F",20,20,"New York Knicks","Evan Fournier",0,0,0,0,0,0
0,0,0,1,0,1,0,0,0,"04",0,1,0,0,0,0,1037644,"2023-10-31T00:00:00.000Z",6,FALSE,20,666675,"F",20,20,"New York Knicks","DaQuan Jeffries",0,0,0,0,0,0
0,0,0,2,1,2,1,0,0,"04",0,1,3,0,0,0,1037644,"2023-10-31T00:00:00.000Z",6,FALSE,20,17896033,"G",20,20,"New York Knicks","Miles McBride",0,3,3,3,0,3
2,2,1,4,1,10,3,5,4,"30",1,1,11,2,0,2,1037645,"2023-10-31T00:00:00.000Z",24,FALSE,27,356,"G",24,24,"Phoenix Suns","Josh Okogie",2,13,15,13,4,20.4
7,0,2,3,1,19,12,2,1,"37",0,0,26,2,2,5,1037645,"2023-10-31T00:00:00.000Z",24,FALSE,27,140,"F",24,24,"Phoenix Suns","Kevin Durant",2,28,35,33,9,39.9
4,2,12,5,2,10,4,2,2,"30",0,4,12,12,1,0,1037645,"2023-10-31T00:00:00.000Z",24,FALSE,27,349,"C",24,24,"Phoenix Suns","Jusuf Nurkic",3,24,28,16,16,41.4
3,1,6,7,5,9,5,4,4,"37",1,2,19,7,0,2,1037645,"2023-10-31T00:00:00.000Z",24,FALSE,27,8,"G",24,24,"Phoenix Suns","Grayson Allen",1,26,29,22,10,32.9
6,0,2,9,4,14,8,0,0,"36",0,1,20,2,0,4,1037645,"2023-10-31T00:00:00.000Z",24,FALSE,27,178,"G",24,24,"Phoenix Suns","Eric Gordon",0,22,28,26,8,27.4
0,0,0,0,0,0,0,0,0,"00",0,0,0,0,0,0,1037645,"2023-10-31T00:00:00.000Z",24,FALSE,27,3547095,"C-F",24,24,"Phoenix Suns","Udoka Azubuike",0,0,0,0,0,0
0,0,0,0,0,0,0,0,0,"00",0,0,0,0,0,0,1037645,"2023-10-31T00:00:00.000Z",24,FALSE,27,32,"F",24,24,"Phoenix Suns","Keita Bates-Diop",0,0,0,0,0,0
0,0,0,0,0,0,0,0,0,"00",0,0,0,0,0,0,1037645,"2023-10-31T00:00:00.000Z",24,FALSE,27,37,"G",24,24,"Phoenix Suns","Bradley Beal",0,0,0,0,0,0
0,0,0,0,0,0,0,0,0,"00",0,0,0,0,0,0,1037645,"2023-10-31T00:00:00.000Z",24,FALSE,27,666451,"C",24,24,"Phoenix Suns","Bol Bol",0,0,0,0,0,0
0,0,0,0,0,0,0,0,0,"00",0,0,0,0,0,0,1037645,"2023-10-31T00:00:00.000Z",24,FALSE,27,57,"G",24,24,"Phoenix Suns","Devin Booker",0,0,0,0,0,0
4,2,8,0,0,3,1,2,1,"17",1,1,3,9,1,2,1037645,"2023-10-31T00:00:00.000Z",24,FALSE,27,147,"F",24,24,"Phoenix Suns","Drew Eubanks",3,12,16,7,13,26.8
0,0,2,2,0,7,3,0,0,"15",2,3,6,4,1,1,1037645,"2023-10-31T00:00:00.000Z",24,FALSE,27,18678058,"",24,24,"Phoenix Suns","Jordan Goodwin",1,10,10,6,4,12.8
0,0,0,0,0,0,0,0,0,"00",0,0,0,0,0,0,1037645,"2023-10-31T00:00:00.000Z",24,FALSE,27,272,"G",24,24,"Phoenix Suns","Damion Lee",0,0,0,0,0,0
0,0,0,0,0,0,0,0,0,"00",0,0,0,0,0,0,1037645,"2023-10-31T00:00:00.000Z",24,FALSE,27,3547298,"G",24,24,"Phoenix Suns","Saben Lee",0,0,0,0,0,0
1,0,2,2,2,3,2,0,0,"18",0,5,6,2,2,1,1037645,"2023-10-31T00:00:00.000Z",24,FALSE,27,666729,"F",24,24,"Phoenix Suns","Nassir Little",2,8,9,7,3,14.9
0,0,0,0,0,0,0,0,0,"00",0,0,0,0,0,0,1037645,"2023-10-31T00:00:00.000Z",24,FALSE,27,314,"F",24,24,"Phoenix Suns","Chimezie Metu",0,0,0,0,0,0
0,0,0,0,0,0,0,0,0,"00",0,0,0,0,0,0,1037645,"2023-10-31T00:00:00.000Z",24,FALSE,27,56677817,"G",27,27,"San Antonio Spurs","Sidy Cissoko",0,0,0,0,0,0
0,0,0,0,0,0,0,0,0,"00",0,0,0,0,0,0,1037645,"2023-10-31T00:00:00.000Z",24,FALSE,27,56677870,"G",27,27,"San Antonio Spurs","Sir'Jabari Rice",0,0,0,0,0,0
2,0,2,7,3,8,4,0,0,"20",1,1,11,3,1,2,1037645,"2023-10-31T00:00:00.000Z",24,FALSE,27,470,"G",24,24,"Phoenix Suns","Yuta Watanabe",1,14,16,13,5,18.6
4,0,2,9,4,20,10,4,3,"33",1,1,27,3,2,0,1037645,"2023-10-31T00:00:00.000Z",24,FALSE,27,666682,"F",27,27,"San Antonio Spurs","Keldon Johnson",2,30,34,31,7,42.6
1,4,5,6,2,12,6,5,4,"28",3,3,18,8,0,5,1037645,"2023-10-31T00:00:00.000Z",24,FALSE,27,56677822,"F-C",27,27,"San Antonio Spurs","Victor Wembanyama",4,26,27,19,9,36.1
4,3,4,3,1,11,6,1,1,"27",1,3,14,5,1,2,1037645,"2023-10-31T00:00:00.000Z",24,FALSE,27,102,"F-C",27,27,"San Antonio Spurs","Zach Collins",4,19,23,18,9,36
5,0,6,1,0,8,3,3,2,"30",1,5,8,7,0,0,1037645,"2023-10-31T00:00:00.000Z",24,FALSE,27,38017699,"F",27,27,"San Antonio Spurs","Jeremy Sochan",0,15,20,13,12,23.9
5,0,5,8,3,17,7,2,1,"36",1,0,18,6,3,3,1037645,"2023-10-31T00:00:00.000Z",24,FALSE,27,3547246,"G-F",27,27,"San Antonio Spurs","Devin Vassell",3,24,29,23,11,38.7
0,0,0,0,0,0,0,0,0,"00",0,0,0,0,0,0,1037645,"2023-10-31T00:00:00.000Z",24,FALSE,27,38017730,"F",27,27,"San Antonio Spurs","Dominick Barlow",0,0,0,0,0,0
1,1,2,0,0,2,1,0,0,"16",1,4,2,3,0,1,1037645,"2023-10-31T00:00:00.000Z",24,FALSE,27,17895854,"G",27,27,"San Antonio Spurs","Charles Bassey",1,5,6,3,4,9.1
0,0,0,4,1,7,1,0,0,"09",0,0,3,0,1,1,1037645,"2023-10-31T00:00:00.000Z",24,FALSE,27,38017692,"F",27,27,"San Antonio Spurs","Malaki Branham",1,3,3,3,0,5
0,0,0,1,0,1,0,0,0,"03",0,0,0,0,0,0,1037645,"2023-10-31T00:00:00.000Z",24,FALSE,27,38017649,"F",27,27,"San Antonio Spurs","Julian Champagnie",0,0,0,0,0,0
0,0,0,0,0,0,0,0,0,"00",0,0,0,0,0,0,1037645,"2023-10-31T00:00:00.000Z",24,FALSE,27,180,"G",27,27,"San Antonio Spurs","Devonte' Graham",0,0,0,0,0,0
3,1,2,1,0,4,3,4,4,"24",0,0,10,2,1,0,1037645,"2023-10-31T00:00:00.000Z",24,FALSE,27,3547274,"G",27,27,"San Antonio Spurs","Tre Jones",2,12,15,13,5,22.9
0,0,0,0,0,0,0,0,0,"00",0,0,0,0,0,0,1037645,"2023-10-31T00:00:00.000Z",24,FALSE,27,17896059,"F",27,27,"San Antonio Spurs","Sandro Mamukelashvili",0,0,0,0,0,0
1,0,1,2,2,3,2,0,0,"15",0,1,6,1,1,0,1037645,"2023-10-31T00:00:00.000Z",24,FALSE,27,305,"F",27,27,"San Antonio Spurs","Doug McDermott",1,7,8,7,2,11.7
1,0,2,2,1,7,4,1,0,"19",0,0,9,2,1,0,1037645,"2023-10-31T00:00:00.000Z",24,FALSE,27,359,"F",27,27,"San Antonio Spurs","Cedi Osman",1,11,12,10,3,15.9
0,0,0,0,0,0,0,0,0,"00",0,0,0,0,0,0,1037645,"2023-10-31T00:00:00.000Z",24,FALSE,27,38017693,"G",27,27,"San Antonio Spurs","Blake Wesley",0,0,0,0,0,0
0,0,0,0,0,0,0,0,0,"00",0,0,0,0,0,0,1037645,"2023-10-31T00:00:00.000Z",24,FALSE,27,56677865,"C",27,27,"San Antonio Spurs","Charles Bediako",0,0,0,0,0,0
7,0,6,9,6,17,8,6,5,"33",1,2,27,7,2,3,1037646,"2023-10-31T00:00:00.000Z",13,FALSE,22,172,"F",13,13,"LA Clippers","Paul George",2,34,41,34,14,48.9
3,0,6,3,0,11,3,2,2,"33",2,1,8,8,2,1,1037646,"2023-10-31T00:00:00.000Z",13,FALSE,22,274,"F",13,13,"LA Clippers","Kawhi Leonard",2,16,19,11,11,27.1
1,1,7,0,0,8,4,2,1,"23",2,1,9,9,0,1,1037646,"2023-10-31T00:00:00.000Z",13,FALSE,22,493,"C",13,13,"LA Clippers","Ivica Zubac",1,18,19,10,10,23.3
3,0,0,7,4,14,6,2,1,"32",0,4,17,0,1,1,1037646,"2023-10-31T00:00:00.000Z",13,FALSE,22,17896031,"G",13,13,"LA Clippers","Nah'Shon Hyland",1,17,20,20,3,23.5
7,1,6,4,0,16,8,2,2,"33",0,4,18,6,5,3,1037646,"2023-10-31T00:00:00.000Z",13,FALSE,22,472,"G",13,13,"LA Clippers","Russell Westbrook",6,24,31,25,13,50.7
1,1,2,2,1,4,3,0,0,"19",1,4,7,3,0,0,1037646,"2023-10-31T00:00:00.000Z",13,FALSE,22,56677849,"F",13,13,"LA Clippers","Kobe Brown",1,10,11,8,4,15.1
0,0,0,0,0,1,0,0,0,"10",0,1,0,0,0,1,1037646,"2023-10-31T00:00:00.000Z",13,FALSE,22,666511,"G",13,13,"LA Clippers","Amir Coffey",0,0,0,0,0,-1
2,0,0,0,0,2,1,0,0,"03",1,0,2,1,0,1,1037646,"2023-10-31T00:00:00.000Z",13,FALSE,22,38017725,"F",13,13,"LA Clippers","Moussa Diabate",0,3,5,4,3,5.2
0,0,0,1,1,1,1,0,0,"03",0,1,3,0,0,0,1037646,"2023-10-31T00:00:00.000Z",13,FALSE,22,56677856,"G",13,13,"LA Clippers","Jordan Miller",0,3,3,3,0,3
2,1,5,0,0,7,5,2,0,"22",2,4,10,7,0,2,1037646,"2023-10-31T00:00:00.000Z",13,FALSE,22,371,"F-C",13,13,"LA Clippers","Mason Plumlee",1,17,19,12,9,22.4
3,0,3,5,2,8,5,7,5,"29",0,4,17,3,0,3,1037646,"2023-10-31T00:00:00.000Z",13,FALSE,22,380,"F-G",13,13,"LA Clippers","Norman Powell",0,20,23,20,6,22.1
0,0,0,0,0,0,0,0,0,"00",0,0,0,0,0,0,1037646,"2023-10-31T00:00:00.000Z",13,FALSE,22,33,"F-G",23,13,"LA Clippers","Nicolas Batum",0,0,0,0,0,0
0,0,0,0,0,0,0,0,0,"00",0,0,0,0,0,0,1037646,"2023-10-31T00:00:00.000Z",13,FALSE,22,17896022,"G",13,13,"LA Clippers","Brandon Boston Jr.",0,0,0,0,0,0
0,0,0,0,0,0,0,0,0,"00",0,0,0,0,0,0,1037646,"2023-10-31T00:00:00.000Z",13,FALSE,22,108,"F",23,13,"LA Clippers","Robert Covington",0,0,0,0,0,0
0,0,0,0,0,0,0,0,0,"00",0,0,0,0,0,0,1037646,"2023-10-31T00:00:00.000Z",13,FALSE,22,666743,"G",13,13,"LA Clippers","Terance Mann",0,0,0,0,0,0
0,0,0,0,0,0,0,0,0,"00",0,0,0,0,0,0,1037646,"2023-10-31T00:00:00.000Z",13,FALSE,22,3547294,"F",23,13,"LA Clippers","Kenyon Martin Jr.",0,0,0,0,0,0
0,0,0,0,0,0,0,0,0,"00",0,0,0,0,0,0,1037646,"2023-10-31T00:00:00.000Z",13,FALSE,22,328,"F",23,13,"LA Clippers","Marcus Morris",0,0,0,0,0,0
0,0,0,0,0,0,0,0,0,"00",0,0,0,0,0,0,1037646,"2023-10-31T00:00:00.000Z",13,FALSE,22,17896051,"G",13,13,"LA Clippers","Joshua Primo",0,0,0,0,0,0
3,1,7,7,2,13,6,0,0,"32",1,4,14,8,0,3,1037646,"2023-10-31T00:00:00.000Z",13,FALSE,22,17896026,"F",22,22,"Orlando Magic","Franz Wagner",1,22,25,17,11,28.1
4,0,4,3,1,13,5,8,4,"32",0,3,15,4,4,3,1037646,"2023-10-31T00:00:00.000Z",13,FALSE,22,38017683,"F",22,22,"Orlando Magic","Paolo Banchero",4,19,23,19,8,34.8
3,0,7,2,0,8,2,6,3,"30",1,2,7,8,1,2,1037646,"2023-10-31T00:00:00.000Z",13,FALSE,22,85,"F",22,22,"Orlando Magic","Wendell Carter Jr.",1,15,18,10,11,22.1
1,0,0,0,0,0,0,0,0,"04",0,1,0,0,0,0,1037646,"2023-10-31T00:00:00.000Z",13,FALSE,22,56677827,"G",22,22,"Orlando Magic","Anthony Black",0,0,1,1,1,1.5
2,0,2,4,2,5,3,3,1,"18",0,1,9,2,1,0,1037646,"2023-10-31T00:00:00.000Z",13,FALSE,22,196,"G",22,22,"Orlando Magic","Gary Harris",1,11,13,11,4,17.4
0,0,0,4,1,5,2,1,1,"04",0,0,6,0,0,0,1037646,"2023-10-31T00:00:00.000Z",13,FALSE,22,38017724,"G",22,22,"Orlando Magic","Caleb Houstan",0,6,6,6,0,6
0,0,1,0,0,1,1,0,0,"04",0,0,2,1,0,0,1037646,"2023-10-31T00:00:00.000Z",13,FALSE,22,56677839,"G",22,22,"Orlando Magic","Jett Howard",0,3,3,2,1,3.2
1,0,1,1,0,1,0,0,0,"13",0,0,0,1,0,0,1037646,"2023-10-31T00:00:00.000Z",13,FALSE,22,226,"F",22,22,"Orlando Magic","Joe Ingles",0,1,2,1,2,2.7
3,1,4,5,1,10,5,0,0,"32",2,5,11,6,1,3,1037646,"2023-10-31T00:00:00.000Z",13,FALSE,22,17896073,"G",22,22,"Orlando Magic","Jalen Suggs",2,17,20,14,9,25.7
1,0,4,0,0,11,6,1,0,"32",1,3,12,5,1,2,1037646,"2023-10-31T00:00:00.000Z",13,FALSE,22,165,"G",22,22,"Orlando Magic","Markelle Fultz",1,17,18,13,6,20.5
1,0,2,2,0,6,3,6,4,"17",0,3,10,2,0,1,1037646,"2023-10-31T00:00:00.000Z",13,FALSE,22,3547251,"G",22,22,"Orlando Magic","Cole Anthony",0,12,13,11,3,12.9
3,0,0,0,0,0,0,2,1,"04",1,0,1,1,0,0,1037646,"2023-10-31T00:00:00.000Z",13,FALSE,22,666442,"C",22,22,"Orlando Magic","Goga Bitadze",0,2,5,4,4,6.7
0,0,0,0,0,1,1,0,0,"04",1,0,2,1,0,1,1037646,"2023-10-31T00:00:00.000Z",13,FALSE,22,666818,"F",22,22,"Orlando Magic","Chuma Okeke",0,3,3,2,1,2.2
1,1,1,2,0,7,4,6,5,"14",0,2,13,1,1,1,1037646,"2023-10-31T00:00:00.000Z",13,FALSE,22,462,"C",22,22,"Orlando Magic","Moritz Wagner",2,14,15,14,2,20.7
0,0,0,0,0,0,0,0,0,"00",0,0,0,0,0,0,1037646,"2023-10-31T00:00:00.000Z",13,FALSE,22,38017607,"G",22,22,"Orlando Magic","Kevon Harris",0,0,0,0,0,0
0,0,0,0,0,0,0,0,0,"00",0,0,0,0,0,0,1037646,"2023-10-31T00:00:00.000Z",13,FALSE,22,229,"F",22,22,"Orlando Magic","Jonathan Isaac",0,0,0,0,0,0
0,0,0,0,0,0,0,0,0,"00",0,0,0,0,0,0,1037646,"2023-10-31T00:00:00.000Z",13,FALSE,22,17553983,"G",22,22,"Orlando Magic","Trevelin Queen",0,0,0,0,0,0
0,0,0,0,0,0,0,0,0,"00",0,0,0,0,0,0,1037646,"2023-10-31T00:00:00.000Z",13,FALSE,22,666885,"F",22,22,"Orlando Magic","Admiral Schofield",0,0,0,0,0,0
0,0,1,6,3,7,3,0,0,"30",1,4,9,2,1,1,1037653,"2023-11-01T00:00:00.000Z",21,FALSE,19,666541,"G",21,21,"Oklahoma City Thunder","Luguentz Dort",1,11,11,9,2,13.4
3,0,7,3,0,13,5,9,8,"38",1,3,18,8,0,1,1037653,"2023-11-01T00:00:00.000Z",21,FALSE,19,38017703,"G-F",21,21,"Oklahoma City Thunder","Jalen Williams",0,26,29,21,11,31.1
3,2,8,5,1,14,8,2,2,"37",3,4,19,11,1,5,1037653,"2023-11-01T00:00:00.000Z",21,FALSE,19,38017685,"C-F",21,21,"Oklahoma City Thunder","Chet Holmgren",3,30,33,22,14,40.7
4,1,9,4,1,16,6,2,2,"31",0,1,15,9,1,2,1037653,"2023-11-01T00:00:00.000Z",21,FALSE,19,17896065,"G",21,21,"Oklahoma City Thunder","Josh Giddey",2,24,28,19,13,35.8
8,0,5,5,0,20,8,5,4,"38",0,2,20,5,3,2,1037653,"2023-11-01T00:00:00.000Z",21,FALSE,19,175,"G",21,21,"Oklahoma City Thunder","Shai Gilgeous-Alexander",3,25,33,28,13,45
2,0,4,1,0,5,4,2,2,"14",0,5,10,4,0,2,1037653,"2023-11-01T00:00:00.000Z",21,FALSE,19,17896078,"G",21,21,"Oklahoma City Thunder","Aaron Wiggins",0,14,16,12,6,15.8
0,0,0,0,0,0,0,0,0,"00",0,0,0,0,0,0,1037653,"2023-11-01T00:00:00.000Z",21,FALSE,19,38017663,"F",19,19,"New Orleans Pelicans","E.J. Liddell",0,0,0,0,0,0
0,0,0,0,0,2,0,0,0,"02",2,0,0,2,0,0,1037653,"2023-11-01T00:00:00.000Z",21,FALSE,19,491,"C",19,19,"New Orleans Pelicans","Cody Zeller",0,2,2,0,2,2.4
0,0,0,0,0,0,0,0,0,"00",0,0,0,0,0,0,1037653,"2023-11-01T00:00:00.000Z",21,FALSE,19,17896097,"G",19,19,"New Orleans Pelicans","Jose Alvarado",0,0,0,0,0,0
0,0,0,0,0,0,0,0,0,"00",0,0,0,0,0,0,1037653,"2023-11-01T00:00:00.000Z",21,FALSE,19,666584,"F",19,19,"New Orleans Pelicans","Kaiser Gates",0,0,0,0,0,0
0,0,0,0,0,0,0,0,0,"00",0,0,0,0,0,0,1037653,"2023-11-01T00:00:00.000Z",21,FALSE,19,227,"F",19,19,"New Orleans Pelicans","Brandon Ingram",0,0,0,0,0,0
0,0,0,0,0,0,0,0,0,"00",0,0,0,0,0,0,1037653,"2023-11-01T00:00:00.000Z",21,FALSE,19,3547293,"F",19,19,"New Orleans Pelicans","Naji Marshall",0,0,0,0,0,0
0,0,0,0,0,0,0,0,0,"00",0,0,0,0,0,0,1037653,"2023-11-01T00:00:00.000Z",21,FALSE,19,18677986,"F",19,19,"New Orleans Pelicans","Trey Murphy III",0,0,0,0,0,0
0,0,0,0,0,0,0,0,0,"00",0,0,0,0,0,0,1037653,"2023-11-01T00:00:00.000Z",21,FALSE,19,38017726,"G",19,19,"New Orleans Pelicans","Dereon Seabron",0,0,0,0,0,0
2,0,5,1,1,5,4,2,0,"24",2,2,9,7,2,0,1037653,"2023-11-01T00:00:00.000Z",21,FALSE,19,340,"F",19,19,"New Orleans Pelicans","Larry Nance Jr.",2,16,18,11,9,26.4
1,2,1,6,1,10,3,4,1,"25",3,1,8,4,1,1,1037653,"2023-11-01T00:00:00.000Z",21,FALSE,19,38017677,"G",19,19,"New Orleans Pelicans","Dyson Daniels",3,12,13,9,5,22.3
0,0,0,2,1,4,2,0,0,"10",0,0,5,0,2,1,1037653,"2023-11-01T00:00:00.000Z",21,FALSE,19,3547260,"G",19,19,"New Orleans Pelicans","Kira Lewis Jr.",2,5,5,5,0,10
0,0,3,5,1,6,2,0,0,"20",0,2,5,3,0,1,1037653,"2023-11-01T00:00:00.000Z",21,FALSE,19,17896017,"F",19,19,"New Orleans Pelicans","Matt Ryan",0,8,8,5,3,7.6
1,0,1,7,2,7,2,3,3,"14",0,0,9,1,0,0,1037653,"2023-11-01T00:00:00.000Z",21,FALSE,19,3547272,"G",21,21,"Oklahoma City Thunder","Isaiah Joe",0,10,11,10,2,11.7
0,2,4,0,0,0,0,0,0,"07",1,1,0,5,0,1,1037653,"2023-11-01T00:00:00.000Z",21,FALSE,19,24572055,"C",21,21,"Oklahoma City Thunder","Olivier Sarr",2,5,5,0,5,11
1,0,2,0,0,2,1,2,2,"18",0,4,4,2,0,0,1037653,"2023-11-01T00:00:00.000Z",21,FALSE,19,56677833,"G",21,21,"Oklahoma City Thunder","Cason Wallace",0,6,7,5,3,7.9
0,0,0,0,0,0,0,0,0,"01",0,0,0,0,0,0,1037653,"2023-11-01T00:00:00.000Z",21,FALSE,19,27924547,"F",21,21,"Oklahoma City Thunder","Lindy Waters III",0,0,0,0,0,0
1,0,2,3,0,4,1,0,0,"12",0,0,2,2,0,0,1037653,"2023-11-01T00:00:00.000Z",21,FALSE,19,38017716,"F",21,21,"Oklahoma City Thunder","Ousmane Dieng",0,4,5,3,3,5.9
0,0,0,0,0,0,0,0,0,"00",0,0,0,0,0,0,1037653,"2023-11-01T00:00:00.000Z",21,FALSE,19,44,"F",21,21,"Oklahoma City Thunder","Davis Bertans",0,0,0,0,0,0
0,0,0,0,0,0,0,0,0,"00",0,0,0,0,0,0,1037653,"2023-11-01T00:00:00.000Z",21,FALSE,19,17896036,"G",21,21,"Oklahoma City Thunder","Tre Mann",0,0,0,0,0,0
0,0,0,0,0,0,0,0,0,"00",0,0,0,0,0,0,1037653,"2023-11-01T00:00:00.000Z",21,FALSE,19,4197029,"G",21,21,"Oklahoma City Thunder","Vasilije Micic",0,0,0,0,0,0
0,0,0,0,0,0,0,0,0,"00",0,0,0,0,0,0,1037653,"2023-11-01T00:00:00.000Z",21,FALSE,19,3547271,"C",21,21,"Oklahoma City Thunder","Aleksej Pokusevski",0,0,0,0,0,0
0,0,0,0,0,0,0,0,0,"00",0,0,0,0,0,0,1037653,"2023-11-01T00:00:00.000Z",21,FALSE,19,56677853,"F",21,21,"Oklahoma City Thunder","Keyontae Johnson",0,0,0,0,0,0
0,0,0,0,0,0,0,0,0,"00",0,0,0,0,0,0,1037653,"2023-11-01T00:00:00.000Z",21,FALSE,19,38017706,"F",21,21,"Oklahoma City Thunder","Jaylin Williams",0,0,0,0,0,0
0,0,0,0,0,0,0,0,0,"00",0,0,0,0,0,0,1037653,"2023-11-01T00:00:00.000Z",21,FALSE,19,480,"G-F",21,21,"Oklahoma City Thunder","Kenrich Williams",0,0,0,0,0,0
1,1,6,6,1,9,2,0,0,"31",0,5,5,6,0,1,1037653,"2023-11-01T00:00:00.000Z",21,FALSE,19,17896024,"F",19,19,"New Orleans Pelicans","Herbert Jones",1,11,12,6,7,15.7
8,0,3,0,0,20,7,9,6,"33",7,4,20,10,0,4,1037653,"2023-11-01T00:00:00.000Z",21,FALSE,19,666969,"F",19,19,"New Orleans Pelicans","Zion Williamson",0,30,38,28,18,40
1,1,6,1,1,10,6,7,6,"21",3,2,19,9,1,0,1037653,"2023-11-01T00:00:00.000Z",21,FALSE,19,455,"C",19,19,"New Orleans Pelicans","Jonas Valanciunas",2,28,29,20,10,37.3
5,0,2,13,2,19,4,0,0,"37",4,2,10,6,2,1,1037653,"2023-11-01T00:00:00.000Z",21,FALSE,19,56677837,"G",19,19,"New Orleans Pelicans","Jordan Hawkins",2,16,21,15,11,29.7
5,1,10,8,5,17,10,7,4,"37",1,2,29,11,0,1,1037653,"2023-11-01T00:00:00.000Z",21,FALSE,19,303,"G",19,19,"New Orleans Pelicans","CJ McCollum",1,40,45,34,16,51.7
0,0,0,0,0,0,0,0,0,"00",0,0,0,0,0,0,1037654,"2023-11-01T00:00:00.000Z",11,FALSE,4,56677846,"G",4,4,"Charlotte Hornets","Nick Smith Jr.",0,0,0,0,0,0
0,1,5,3,1,4,2,0,0,"13",0,2,5,5,3,1,1037654,"2023-11-01T00:00:00.000Z",11,FALSE,4,18678001,"F",4,4,"Charlotte Hornets","JT Thor",4,10,10,5,5,22
0,0,0,0,0,0,0,0,0,"00",0,0,0,0,0,0,1037654,"2023-11-01T00:00:00.000Z",11,FALSE,4,17896037,"G",4,4,"Charlotte Hornets","James Bouknight",0,0,0,0,0,0
0,0,0,0,0,0,0,0,0,"00",0,0,0,0,0,0,1037654,"2023-11-01T00:00:00.000Z",11,FALSE,4,666748,"F",4,4,"Charlotte Hornets","Cody Martin",0,0,0,0,0,0
0,0,0,0,0,0,0,0,0,"00",0,0,0,0,0,0,1037654,"2023-11-01T00:00:00.000Z",11,FALSE,4,347,"G",4,4,"Charlotte Hornets","Frank Ntilikina",0,0,0,0,0,0
0,0,0,0,0,0,0,0,0,"00",0,0,0,0,0,0,1037654,"2023-11-01T00:00:00.000Z",11,FALSE,4,422,"G",4,4,"Charlotte Hornets","Ish Smith",0,0,0,0,0,0
5,0,2,3,3,9,7,4,3,"39",1,4,20,3,5,7,1037654,"2023-11-01T00:00:00.000Z",11,FALSE,4,66,"G-F",11,11,"Houston Rockets","Dillon Brooks",5,23,28,25,8,39.1
4,1,6,5,3,10,7,0,0,"30",0,3,17,6,0,2,1037654,"2023-11-01T00:00:00.000Z",11,FALSE,4,38017684,"F",11,11,"Houston Rockets","Jabari Smith Jr.",1,23,27,21,10,31.2
4,0,6,1,1,12,9,1,0,"27",1,1,19,7,1,1,1037654,"2023-11-01T00:00:00.000Z",11,FALSE,4,17896062,"F-C",11,11,"Houston Rockets","Alperen Sengun",1,26,30,23,11,35.4
3,0,3,8,4,16,6,7,7,"31",1,3,23,4,2,1,1037654,"2023-11-01T00:00:00.000Z",11,FALSE,4,17895966,"G",11,11,"Houston Rockets","Jalen Green",2,27,30,26,7,37.3
11,0,3,10,5,17,8,1,1,"39",0,1,22,3,0,2,1037654,"2023-11-01T00:00:00.000Z",11,FALSE,4,458,"G",11,11,"Houston Rockets","Fred VanVleet",0,25,36,33,14,40.1
0,0,0,0,0,0,0,0,0,"00",0,0,0,0,0,0,1037654,"2023-11-01T00:00:00.000Z",11,FALSE,4,75,"G-F",11,11,"Houston Rockets","Reggie Bullock",0,0,0,0,0,0
0,0,2,2,2,3,2,4,3,"12",0,1,9,2,0,1,1037654,"2023-11-01T00:00:00.000Z",11,FALSE,4,188,"F",11,11,"Houston Rockets","Jeff Green",0,11,11,9,2,10.4
0,0,0,0,0,0,0,0,0,"00",0,0,0,0,0,0,1037654,"2023-11-01T00:00:00.000Z",11,FALSE,4,3547281,"G-F",11,11,"Houston Rockets","Nate Hinton",0,0,0,0,0,0
1,0,1,2,2,2,2,0,0,"11",0,1,6,1,0,1,1037654,"2023-11-01T00:00:00.000Z",11,FALSE,4,213,"G",11,11,"Houston Rockets","Aaron Holiday",0,7,8,7,2,7.7
1,1,2,3,0,7,1,2,2,"19",3,1,4,5,1,1,1037654,"2023-11-01T00:00:00.000Z",11,FALSE,4,19465326,"C",11,11,"Houston Rockets","Jock Landale",2,9,10,5,6,16.5
0,0,0,0,0,0,0,0,0,"00",0,0,0,0,0,0,1037654,"2023-11-01T00:00:00.000Z",11,FALSE,4,296,"C",11,11,"Houston Rockets","Boban Marjanovic",0,0,0,0,0,0
0,0,0,0,0,0,0,0,0,"00",0,0,0,0,0,0,1037654,"2023-11-01T00:00:00.000Z",11,FALSE,4,56677809,"F",11,11,"Houston Rockets","Jermaine Samuels Jr.",0,0,0,0,0,0
5,0,5,2,1,5,1,2,1,"19",1,4,4,6,0,0,1037654,"2023-11-01T00:00:00.000Z",11,FALSE,4,3547301,"F",11,11,"Houston Rockets","Jae'Sean Tate",0,10,15,9,11,18.7
1,0,1,1,0,3,1,2,2,"13",0,3,4,1,1,1,1037654,"2023-11-01T00:00:00.000Z",11,FALSE,4,56677825,"G-F",11,11,"Houston Rockets","Amen Thompson",1,5,6,5,2,8.7
0,0,0,0,0,0,0,0,0,"00",0,0,0,0,0,0,1037654,"2023-11-01T00:00:00.000Z",11,FALSE,4,56677848,"G",4,4,"Charlotte Hornets","Amari Bailey",0,0,0,0,0,0
0,0,0,0,0,0,0,0,0,"00",0,0,0,0,0,0,1037654,"2023-11-01T00:00:00.000Z",11,FALSE,4,56677866,"F",4,4,"Charlotte Hornets","Leaky Black",0,0,0,0,0,0
0,0,0,0,0,0,0,0,0,"00",0,0,0,0,0,0,1037654,"2023-11-01T00:00:00.000Z",11,FALSE,4,62,"F",4,4,"Charlotte Hornets","Miles Bridges",0,0,0,0,0,0
2,0,5,2,1,7,2,0,0,"21",1,2,5,6,1,3,1037654,"2023-11-01T00:00:00.000Z",11,FALSE,4,3547253,"G",4,4,"Charlotte Hornets","Theo Maledon",1,11,13,7,8,15.2
0,0,0,0,0,0,0,0,0,"00",0,0,0,0,0,0,1037654,"2023-11-01T00:00:00.000Z",11,FALSE,4,38017708,"G",4,4,"Charlotte Hornets","Bryce McGowens",0,0,0,0,0,0
2,0,4,3,1,9,4,2,1,"24",1,5,10,5,0,1,1037654,"2023-11-01T00:00:00.000Z",11,FALSE,4,56677823,"F",4,4,"Charlotte Hornets","Brandon Miller",0,15,17,12,7,18
0,4,4,0,0,6,3,4,4,"19",4,3,10,8,0,1,1037654,"2023-11-01T00:00:00.000Z",11,FALSE,4,3547282,"C",4,4,"Charlotte Hornets","Nick Richards",4,18,18,10,8,30.6
0,0,0,0,0,0,0,0,0,"00",0,0,0,0,0,0,1037654,"2023-11-01T00:00:00.000Z",11,FALSE,4,56677831,"F",11,11,"Houston Rockets","Cam Whitmore",0,0,0,0,0,0
0,0,0,0,0,0,0,0,0,"00",0,0,0,0,0,0,1037654,"2023-11-01T00:00:00.000Z",11,FALSE,4,38017695,"F",11,11,"Houston Rockets","Tari Eason",0,0,0,0,0,0
0,0,0,0,0,0,0,0,0,"00",0,0,0,0,0,0,1037654,"2023-11-01T00:00:00.000Z",11,FALSE,4,357,"G",11,11,"Houston Rockets","Victor Oladipo",0,0,0,0,0,0
0,0,0,0,0,0,0,0,0,"00",0,0,0,0,0,0,1037654,"2023-11-01T00:00:00.000Z",11,FALSE,4,47738533,"G",11,11,"Houston Rockets","Jeenathan Williams",0,0,0,0,0,0
5,1,5,1,0,11,6,7,5,"31",2,1,17,7,1,1,1037654,"2023-11-01T00:00:00.000Z",11,FALSE,4,204,"F",4,4,"Charlotte Hornets","Gordon Hayward",2,24,29,22,12,37.9
0,0,2,6,5,13,8,2,2,"35",1,2,23,3,0,1,1037654,"2023-11-01T00:00:00.000Z",11,FALSE,4,666950,"F",4,4,"Charlotte Hornets","P.J. Washington",0,26,26,23,3,25.6
1,2,3,0,0,4,3,6,3,"25",3,0,9,6,2,1,1037654,"2023-11-01T00:00:00.000Z",11,FALSE,4,38017698,"C",4,4,"Charlotte Hornets","Mark Williams",4,15,16,10,7,28.7
6,0,1,6,1,21,10,0,0,"39",2,0,21,3,1,4,1037654,"2023-11-01T00:00:00.000Z",11,FALSE,4,403,"G",4,4,"Charlotte Hornets","Terry Rozier",1,24,30,27,9,32.6
5,0,0,6,2,15,7,4,3,"33",1,4,19,1,1,3,1037654,"2023-11-01T00:00:00.000Z",11,FALSE,4,3547239,"G",4,4,"Charlotte Hornets","LaMelo Ball",1,20,25,24,6,27.7
0,0,0,0,0,0,0,0,0,"00",0,0,0,0,0,0,1037655,"2023-11-01T00:00:00.000Z",18,FALSE,8,250,"C",8,8,"Denver Nuggets","DeAndre Jordan",0,0,0,0,0,0
3,0,0,0,0,2,0,0,0,"05",0,2,0,0,0,0,1037655,"2023-11-01T00:00:00.000Z",18,FALSE,8,17896007,"G",8,8,"Denver Nuggets","Braxton Key",0,0,3,3,3,4.5
0,2,3,3,1,9,4,0,0,"18",2,3,9,5,0,0,1037655,"2023-11-01T00:00:00.000Z",18,FALSE,8,3547268,"F-C",8,8,"Denver Nuggets","Zeke Nnaji",2,14,14,9,5,21
0,0,2,1,0,2,1,0,0,"05",0,1,2,2,0,0,1037655,"2023-11-01T00:00:00.000Z",18,FALSE,8,56677582,"G",8,8,"Denver Nuggets","Jalen Pickett",0,4,4,2,2,4.4
0,2,0,6,1,7,2,1,0,"16",0,0,5,0,1,0,1037655,"2023-11-01T00:00:00.000Z",18,FALSE,8,56677776,"G",8,8,"Denver Nuggets","Julian Strawther",3,5,5,5,0,14
0,0,1,1,0,2,1,0,0,"04",0,2,2,1,0,0,1037655,"2023-11-01T00:00:00.000Z",18,FALSE,8,56677871,"F",8,8,"Denver Nuggets","Hunter Tyson",0,3,3,2,1,3.2
1,0,2,1,0,3,2,0,0,"16",0,2,4,2,0,2,1037655,"2023-11-01T00:00:00.000Z",18,FALSE,8,38017721,"G",8,8,"Denver Nuggets","Peyton Watson",0,6,7,5,3,5.9
0,0,0,0,0,0,0,0,0,"00",0,0,0,0,0,0,1037655,"2023-11-01T00:00:00.000Z",18,FALSE,8,666489,"F",8,8,"Denver Nuggets","Vlatko Cancar",0,0,0,0,0,0
0,0,0,0,0,0,0,0,0,"00",0,0,0,0,0,0,1037655,"2023-11-01T00:00:00.000Z",18,FALSE,8,38017727,"G",8,8,"Denver Nuggets","Collin Gillespie",0,0,0,0,0,0
0,0,0,0,0,0,0,0,0,"00",0,0,0,0,0,0,1037655,"2023-11-01T00:00:00.000Z",18,FALSE,8,17896103,"F-C",8,8,"Denver Nuggets","Jay Huff",0,0,0,0,0,0
2,2,6,1,0,5,3,0,0,"21",3,5,6,9,0,4,1037655,"2023-11-01T00:00:00.000Z",18,FALSE,8,3547259,"F",18,18,"Minnesota Timberwolves","Jaden McDaniels",2,15,17,8,11,21.8
4,0,6,4,1,19,7,6,6,"31",2,2,21,8,2,1,1037655,"2023-11-01T00:00:00.000Z",18,FALSE,8,447,"C",18,18,"Minnesota Timberwolves","Karl-Anthony Towns",2,29,33,25,12,41.6
1,2,10,0,0,7,0,4,4,"33",2,3,4,12,1,1,1037655,"2023-11-01T00:00:00.000Z",18,FALSE,8,176,"C",18,18,"Minnesota Timberwolves","Rudy Gobert",3,16,17,5,13,27.9
1,0,2,4,1,16,8,8,7,"32",0,1,24,2,2,4,1037655,"2023-11-01T00:00:00.000Z",18,FALSE,8,3547238,"G",18,18,"Minnesota Timberwolves","Anthony Edwards",2,26,27,25,3,29.9
6,0,3,4,3,9,7,0,0,"27",0,1,17,3,1,0,1037655,"2023-11-01T00:00:00.000Z",18,FALSE,8,104,"G",18,18,"Minnesota Timberwolves","Mike Conley",1,20,26,23,9,32.6
1,1,0,2,1,6,2,0,0,"21",0,2,5,0,0,0,1037655,"2023-11-01T00:00:00.000Z",18,FALSE,8,666400,"G",18,18,"Minnesota Timberwolves","Nickeil Alexander-Walker",1,5,6,6,1,9.5
2,0,3,1,1,6,4,0,0,"25",0,0,9,3,0,0,1037655,"2023-11-01T00:00:00.000Z",18,FALSE,8,12,"F",18,18,"Minnesota Timberwolves","Kyle Anderson",0,12,14,11,5,15.6
1,0,4,3,1,9,6,3,3,"19",1,0,16,5,1,1,1037655,"2023-11-01T00:00:00.000Z",18,FALSE,8,667378,"F-C",18,18,"Minnesota Timberwolves","Naz Reid",1,21,22,17,6,25.5
0,0,0,0,0,0,0,0,0,"00",0,0,0,0,0,0,1037655,"2023-11-01T00:00:00.000Z",18,FALSE,8,56677782,"F",18,18,"Minnesota Timberwolves","Leonard Miller",0,0,0,0,0,0
0,0,0,0,0,0,0,0,0,"00",0,0,0,0,0,0,1037655,"2023-11-01T00:00:00.000Z",18,FALSE,8,38017700,"G",18,18,"Minnesota Timberwolves","Wendell Moore Jr.",0,0,0,0,0,0
0,0,1,2,1,2,1,0,0,"06",0,0,3,1,0,0,1037655,"2023-11-01T00:00:00.000Z",18,FALSE,8,215,"F-G",8,8,"Denver Nuggets","Justin Holiday",0,4,4,3,1,4.2
1,0,1,0,0,3,0,2,2,"18",0,1,2,1,2,1,1037655,"2023-11-01T00:00:00.000Z",18,FALSE,8,320,"G",18,18,"Minnesota Timberwolves","Shake Milton",2,3,4,3,2,9.7
1,0,4,1,0,1,0,4,4,"05",0,0,4,4,0,1,1037655,"2023-11-01T00:00:00.000Z",18,FALSE,8,68,"F",18,18,"Minnesota Timberwolves","Troy Brown Jr.",0,8,9,5,5,9.3
0,0,0,1,0,1,0,0,0,"04",0,0,0,0,0,0,1037655,"2023-11-01T00:00:00.000Z",18,FALSE,8,666767,"G",18,18,"Minnesota Timberwolves","Jordan McLaughlin",0,0,0,0,0,0
0,0,0,0,0,1,1,0,0,"04",0,0,2,0,0,0,1037655,"2023-11-01T00:00:00.000Z",18,FALSE,8,38017715,"F",18,18,"Minnesota Timberwolves","Josh Minott",0,2,2,2,0,2
0,0,0,0,0,0,0,0,0,"00",0,0,0,0,0,0,1037655,"2023-11-01T00:00:00.000Z",18,FALSE,8,56677851,"G",18,18,"Minnesota Timberwolves","Jaylen Clark",0,0,0,0,0,0
0,0,0,0,0,0,0,0,0,"00",0,0,0,0,0,0,1037655,"2023-11-01T00:00:00.000Z",18,FALSE,8,17896056,"C",18,18,"Minnesota Timberwolves","Luka Garza",0,0,0,0,0,0
0,1,0,1,1,4,2,1,1,"26",0,2,6,0,1,1,1037655,"2023-11-01T00:00:00.000Z",18,FALSE,8,81,"G",8,8,"Denver Nuggets","Kentavious Caldwell-Pope",2,6,6,6,0,11
6,1,4,4,1,16,5,5,3,"32",2,3,14,6,1,3,1037655,"2023-11-01T00:00:00.000Z",18,FALSE,8,335,"G",8,8,"Denver Nuggets","Jamal Murray",2,20,26,20,12,33.2
5,1,0,1,0,4,1,0,0,"19",0,0,2,0,2,1,1037655,"2023-11-01T00:00:00.000Z",18,FALSE,8,236,"G",8,8,"Denver Nuggets","Reggie Jackson",3,2,7,7,5,17.5
2,1,6,1,0,8,4,0,0,"20",3,3,8,9,0,1,1037655,"2023-11-01T00:00:00.000Z",18,FALSE,8,38017709,"G",8,8,"Denver Nuggets","Christian Braun",1,17,19,10,11,23.8
0,0,0,0,0,0,0,0,0,"00",0,0,0,0,0,0,1037655,"2023-11-01T00:00:00.000Z",18,FALSE,8,17895968,"F",18,18,"Minnesota Timberwolves","Daishen Nix",0,0,0,0,0,0
1,1,3,5,0,11,2,1,1,"25",2,0,5,5,1,0,1037655,"2023-11-01T00:00:00.000Z",18,FALSE,8,375,"F",8,8,"Denver Nuggets","Michael Porter Jr.",2,10,11,6,6,18.5
2,1,1,1,0,3,2,0,0,"18",1,4,4,2,0,2,1037655,"2023-11-01T00:00:00.000Z",18,FALSE,8,177,"F",8,8,"Denver Nuggets","Aaron Gordon",1,6,8,6,4,10.4
3,0,8,6,1,23,11,2,2,"30",2,0,25,10,0,5,1037655,"2023-11-01T00:00:00.000Z",18,FALSE,8,246,"C",8,8,"Denver Nuggets","Nikola Jokic",0,35,38,28,13,36.5
1,0,4,9,3,13,7,0,0,"31",1,2,17,5,0,0,1037656,"2023-11-01T00:00:00.000Z",7,FALSE,5,247,"F-G",7,7,"Dallas Mavericks","Derrick Jones Jr.",0,22,23,18,6,24.5
1,0,3,9,7,10,7,6,4,"30",2,1,25,5,1,0,1037656,"2023-11-01T00:00:00.000Z",7,FALSE,5,666965,"F",7,7,"Dallas Mavericks","Grant Williams",1,30,31,26,6,35.5
6,1,6,0,0,5,3,4,1,"33",7,3,7,13,2,1,1037656,"2023-11-01T00:00:00.000Z",7,FALSE,5,56677840,"C",7,7,"Dallas Mavericks","Dereck Lively II",3,20,26,13,19,39.6
1,0,3,5,1,5,1,0,0,"26",0,2,3,3,0,2,1037656,"2023-11-01T00:00:00.000Z",7,FALSE,5,3547258,"G",7,7,"Dallas Mavericks","Josh Green",0,6,7,4,4,6.1
10,1,7,8,1,16,5,9,7,"40",0,2,18,7,2,6,1037656,"2023-11-01T00:00:00.000Z",7,FALSE,5,132,"F-G",7,7,"Dallas Mavericks","Luka Doncic",3,25,35,28,17,44.4
0,0,2,0,0,3,1,0,0,"10",0,0,2,2,1,1,1037656,"2023-11-01T00:00:00.000Z",7,FALSE,5,151,"G",7,7,"Dallas Mavericks","Dante Exum",1,4,4,2,2,6.4
2,0,3,13,7,15,8,1,1,"28",0,0,24,3,1,2,1037656,"2023-11-01T00:00:00.000Z",7,FALSE,5,191,"G",7,7,"Dallas Mavericks","Tim Hardaway Jr.",1,27,29,26,5,31.6
1,0,1,2,1,7,3,2,2,"14",0,0,9,1,0,0,1037656,"2023-11-01T00:00:00.000Z",7,FALSE,5,38017679,"G",7,7,"Dallas Mavericks","Jaden Hardy",0,10,11,10,2,11.7
0,0,2,1,0,2,0,0,0,"04",0,0,0,2,0,0,1037656,"2023-11-01T00:00:00.000Z",7,FALSE,5,257,"F",7,7,"Dallas Mavericks","Maxi Kleber",0,2,2,0,2,2.4
0,0,0,0,0,0,0,0,0,"00",0,0,0,0,0,0,1037656,"2023-11-01T00:00:00.000Z",7,FALSE,5,56677873,"G",7,7,"Dallas Mavericks","Dexter Dennis",0,0,0,0,0,0
0,0,0,0,0,0,0,0,0,"00",0,0,0,0,0,0,1037656,"2023-11-01T00:00:00.000Z",7,FALSE,5,228,"G",7,7,"Dallas Mavericks","Kyrie Irving",0,0,0,0,0,0
0,0,0,0,0,0,0,0,0,"00",0,0,0,0,0,0,1037656,"2023-11-01T00:00:00.000Z",7,FALSE,5,17554004,"G",7,7,"Dallas Mavericks","AJ Lawson",0,0,0,0,0,0
7,0,2,1,0,13,5,6,6,"33",1,3,16,3,1,2,1037656,"2023-11-01T00:00:00.000Z",7,FALSE,5,125,"G",5,5,"Chicago Bulls","DeMar DeRozan",1,19,26,23,10,31.1
1,1,2,5,0,6,0,0,0,"25",1,3,0,3,1,2,1037656,"2023-11-01T00:00:00.000Z",7,FALSE,5,3547248,"F",5,5,"Chicago Bulls","Patrick Williams",2,3,4,1,4,9.1
1,0,15,3,1,17,10,0,0,"36",5,2,21,20,2,3,1037656,"2023-11-01T00:00:00.000Z",7,FALSE,5,460,"C",5,5,"Chicago Bulls","Nikola Vucevic",2,41,42,22,21,49.5
1,0,2,9,5,17,7,3,3,"36",0,2,22,2,2,0,1037656,"2023-11-01T00:00:00.000Z",7,FALSE,5,268,"G",5,5,"Chicago Bulls","Zach LaVine",2,24,25,23,3,31.9
4,0,1,6,1,12,4,2,1,"33",0,3,10,1,0,3,1037656,"2023-11-01T00:00:00.000Z",7,FALSE,5,666956,"G",5,5,"Chicago Bulls","Coby White",0,11,15,14,5,14.2
2,1,1,2,2,7,5,0,0,"15",0,0,12,1,1,1,1037656,"2023-11-01T00:00:00.000Z",7,FALSE,5,87,"G",5,5,"Chicago Bulls","Jevon Carter",2,13,15,14,3,21.2
1,1,2,3,0,6,3,0,0,"22",2,4,6,4,1,2,1037656,"2023-11-01T00:00:00.000Z",7,FALSE,5,89,"G",5,5,"Chicago Bulls","Alex Caruso",2,10,11,7,5,16.3
1,0,3,1,0,2,1,0,0,"17",2,3,2,5,0,0,1037656,"2023-11-01T00:00:00.000Z",7,FALSE,5,110,"F",5,5,"Chicago Bulls","Torrey Craig",0,7,8,3,6,9.5
0,0,2,0,0,5,4,0,0,"12",1,2,8,3,2,0,1037656,"2023-11-01T00:00:00.000Z",7,FALSE,5,137,"C",5,5,"Chicago Bulls","Andre Drummond",2,11,11,8,3,17.6
1,0,0,0,0,0,0,6,5,"11",1,1,5,1,0,0,1037656,"2023-11-01T00:00:00.000Z",7,FALSE,5,379,"F-C",7,7,"Dallas Mavericks","Dwight Powell",0,6,7,6,2,7.7
0,0,1,1,0,5,2,0,0,"13",2,0,4,3,0,1,1037656,"2023-11-01T00:00:00.000Z",7,FALSE,5,114,"G",7,7,"Dallas Mavericks","Seth Curry",0,7,7,4,3,6.6
0,0,0,0,0,0,0,0,0,"00",0,0,0,0,0,0,1037656,"2023-11-01T00:00:00.000Z",7,FALSE,5,217,"F-C",7,7,"Dallas Mavericks","Richaun Holmes",0,0,0,0,0,0
0,0,0,0,0,0,0,0,0,"00",0,0,0,0,0,0,1037656,"2023-11-01T00:00:00.000Z",7,FALSE,5,329,"F",7,7,"Dallas Mavericks","Markieff Morris",0,0,0,0,0,0
0,0,0,0,0,0,0,0,0,"00",0,0,0,0,0,0,1037656,"2023-11-01T00:00:00.000Z",7,FALSE,5,56677859,"F",7,7,"Dallas Mavericks","Olivier-Maxence Prosper",0,0,0,0,0,0
0,0,0,0,0,0,0,0,0,"00",0,0,0,0,0,0,1037656,"2023-11-01T00:00:00.000Z",7,FALSE,5,17896028,"F",7,7,"Dallas Mavericks","Greg Brown III",0,0,0,0,0,0
1,0,1,3,2,4,3,0,0,"11",0,1,8,1,0,0,1037656,"2023-11-01T00:00:00.000Z",7,FALSE,5,17895983,"G",5,5,"Chicago Bulls","Ayo Dosunmu",0,9,10,9,2,10.7
0,0,0,0,0,0,0,0,0,"00",0,0,0,0,0,0,1037656,"2023-11-01T00:00:00.000Z",7,FALSE,5,56677857,"F",5,5,"Chicago Bulls","Julian Phillips",0,0,0,0,0,0
0,0,0,0,0,0,0,0,0,"00",0,0,0,0,0,0,1037656,"2023-11-01T00:00:00.000Z",7,FALSE,5,17896116,"G",5,5,"Chicago Bulls","Terry Taylor",0,0,0,0,0,0
0,0,0,0,0,0,0,0,0,"00",0,0,0,0,0,0,1037656,"2023-11-01T00:00:00.000Z",7,FALSE,5,27,"G",5,5,"Chicago Bulls","Lonzo Ball",0,0,0,0,0,0
0,0,0,0,0,0,0,0,0,"00",0,0,0,0,0,0,1037656,"2023-11-01T00:00:00.000Z",7,FALSE,5,56677874,"F",5,5,"Chicago Bulls","Onuralp Bitim",0,0,0,0,0,0
0,0,0,0,0,0,0,0,0,"00",0,0,0,0,0,0,1037656,"2023-11-01T00:00:00.000Z",7,FALSE,5,45969255,"F",5,5,"Chicago Bulls","Justin Lewis",0,0,0,0,0,0
0,0,0,0,0,0,0,0,0,"00",0,0,0,0,0,0,1037656,"2023-11-01T00:00:00.000Z",7,FALSE,5,56677860,"F",5,5,"Chicago Bulls","Adama Sanogo",0,0,0,0,0,0
0,0,0,0,0,0,0,0,0,"00",0,0,0,0,0,0,1037656,"2023-11-01T00:00:00.000Z",7,FALSE,5,38017719,"F",5,5,"Chicago Bulls","Dalen Terry",0,0,0,0,0,0
1,0,10,6,4,11,6,3,3,"28",1,5,19,11,1,0,1037657,"2023-11-01T00:00:00.000Z",29,FALSE,15,297,"F",29,29,"Utah Jazz","Lauri Markkanen",1,30,31,20,12,36.7
2,0,2,5,2,12,5,6,4,"28",2,2,16,4,2,1,1037657,"2023-11-01T00:00:00.000Z",29,FALSE,15,101,"F-C",29,29,"Utah Jazz","John Collins",2,20,22,18,6,28.8
0,2,3,0,0,4,1,4,2,"18",1,2,4,4,0,0,1037657,"2023-11-01T00:00:00.000Z",29,FALSE,15,38017705,"C",29,29,"Utah Jazz","Walker Kessler",2,8,8,4,4,14.8
5,0,6,6,4,13,8,0,0,"26",0,1,20,6,2,3,1037657,"2023-11-01T00:00:00.000Z",29,FALSE,15,100,"G",29,29,"Utah Jazz","Jordan Clarkson",2,26,31,25,11,37.7
7,0,4,3,0,8,4,1,1,"23",1,3,9,5,0,5,1037657,"2023-11-01T00:00:00.000Z",29,FALSE,15,666650,"G",29,29,"Utah Jazz","Talen Horton-Tucker",0,14,21,16,12,20.5
1,0,3,5,2,5,2,1,0,"18",0,0,6,3,0,2,1037657,"2023-11-01T00:00:00.000Z",29,FALSE,15,38017620,"G",29,29,"Utah Jazz","Ochai Agbaji",0,9,10,7,4,9.1
3,0,1,1,1,2,1,2,2,"13",0,3,5,1,0,0,1037657,"2023-11-01T00:00:00.000Z",29,FALSE,15,139,"G",29,29,"Utah Jazz","Kris Dunn",0,6,9,8,4,10.7
1,0,1,3,1,5,2,0,0,"08",0,1,5,1,0,1,1037657,"2023-11-01T00:00:00.000Z",29,FALSE,15,38017739,"F",29,29,"Utah Jazz","Simone Fontecchio",0,6,7,6,2,6.7
3,1,1,4,1,8,4,0,0,"23",0,0,9,1,1,3,1037657,"2023-11-01T00:00:00.000Z",29,FALSE,15,56677834,"G",29,29,"Utah Jazz","Keyonte George",2,10,13,12,4,17.7
0,0,0,0,0,0,0,0,0,"00",0,0,0,0,0,0,1037657,"2023-11-01T00:00:00.000Z",29,FALSE,15,56677824,"F",29,29,"Utah Jazz","Taylor Hendricks",0,0,0,0,0,0
5,0,5,4,3,7,5,2,1,"26",3,1,14,8,1,3,1037657,"2023-11-01T00:00:00.000Z",29,FALSE,15,358,"F",29,29,"Utah Jazz","Kelly Olynyk",1,22,27,19,13,31.1
0,0,0,0,0,0,0,0,0,"00",0,0,0,0,0,0,1037657,"2023-11-01T00:00:00.000Z",29,FALSE,15,666881,"F",29,29,"Utah Jazz","Luka Samanic",0,0,0,0,0,0
0,0,0,0,0,0,0,0,0,"00",0,0,0,0,0,0,1037657,"2023-11-01T00:00:00.000Z",29,FALSE,15,56677842,"F",29,29,"Utah Jazz","Brice Sensabaugh",0,0,0,0,0,0
6,0,2,6,4,10,8,3,3,"22",1,1,23,3,0,2,1037657,"2023-11-01T00:00:00.000Z",29,FALSE,15,413,"G",29,29,"Utah Jazz","Collin Sexton",0,26,32,29,9,33.6
1,0,2,0,0,2,1,2,1,"07",1,3,3,3,0,1,1037657,"2023-11-01T00:00:00.000Z",29,FALSE,15,11891374,"C",29,29,"Utah Jazz","Omer Yurtseven",0,6,7,4,4,7.1
0,0,0,0,0,0,0,0,0,"00",0,0,0,0,0,0,1037657,"2023-11-01T00:00:00.000Z",29,FALSE,15,17896023,"G",29,29,"Utah Jazz","Josh Christopher",0,0,0,0,0,0
0,0,0,0,0,0,0,0,0,"00",0,0,0,0,0,0,1037657,"2023-11-01T00:00:00.000Z",29,FALSE,15,38017630,"G",29,29,"Utah Jazz","Johnny Juzang",0,0,0,0,0,0
0,0,0,0,0,0,0,0,0,"00",0,0,0,0,0,0,1037657,"2023-11-01T00:00:00.000Z",29,FALSE,15,19465584,"F",29,29,"Utah Jazz","Micah Potter",0,0,0,0,0,0
0,2,3,5,2,5,2,2,2,"19",1,2,8,4,0,1,1037657,"2023-11-01T00:00:00.000Z",29,FALSE,15,17896027,"G-F",15,15,"Memphis Grizzlies","Ziaire Williams",2,12,12,8,4,17.8
2,1,5,8,1,17,5,8,8,"26",3,3,19,8,0,2,1037657,"2023-11-01T00:00:00.000Z",29,FALSE,15,231,"F-C",15,15,"Memphis Grizzlies","Jaren Jackson Jr.",1,27,29,21,10,32.6
0,0,1,0,0,3,0,0,0,"14",3,3,0,4,1,2,1037657,"2023-11-01T00:00:00.000Z",29,FALSE,15,3547285,"F",15,15,"Memphis Grizzlies","Xavier Tillman",1,4,4,0,4,5.8
0,0,2,12,4,19,7,3,3,"27",1,1,21,3,1,2,1037657,"2023-11-01T00:00:00.000Z",29,FALSE,15,3547287,"G",15,15,"Memphis Grizzlies","Desmond Bane",1,24,24,21,3,25.6
6,0,2,7,1,11,4,2,2,"28",0,3,11,2,4,5,1037657,"2023-11-01T00:00:00.000Z",29,FALSE,15,420,"G",15,15,"Memphis Grizzlies","Marcus Smart",4,13,19,17,8,29.4
1,1,2,3,1,8,4,0,0,"24",1,1,9,3,0,1,1037657,"2023-11-01T00:00:00.000Z",29,FALSE,15,38017729,"F",15,15,"Memphis Grizzlies","David Roddy",1,12,13,10,4,16.1
3,0,1,8,1,9,1,0,0,"21",0,0,3,1,2,0,1037657,"2023-11-01T00:00:00.000Z",29,FALSE,15,254,"G",15,15,"Memphis Grizzlies","Luke Kennard",2,4,7,6,4,14.7
6,0,3,2,1,2,1,0,0,"20",0,0,3,3,1,0,1037657,"2023-11-01T00:00:00.000Z",29,FALSE,15,48248287,"G",15,15,"Memphis Grizzlies","Jacob Gilyard",1,6,12,9,9,18.6
2,0,4,2,1,6,3,0,0,"18",3,1,7,7,0,0,1037657,"2023-11-01T00:00:00.000Z",29,FALSE,15,666703,"G-F",15,15,"Memphis Grizzlies","John Konchar",0,14,16,9,9,18.4
0,0,0,0,0,0,0,0,0,"00",0,0,0,0,0,0,1037657,"2023-11-01T00:00:00.000Z",29,FALSE,15,56677830,"F",15,15,"Memphis Grizzlies","GG Jackson",0,0,0,0,0,0
0,0,0,0,0,0,0,0,0,"00",0,0,0,0,0,0,1037657,"2023-11-01T00:00:00.000Z",29,FALSE,15,401,"G",15,15,"Memphis Grizzlies","Derrick Rose",0,0,0,0,0,0
2,0,3,1,1,7,4,9,3,"19",2,5,12,5,2,1,1037657,"2023-11-01T00:00:00.000Z",29,FALSE,15,38017732,"F",15,15,"Memphis Grizzlies","Kenneth Lofton Jr.",2,17,19,14,7,26
3,3,2,4,1,5,2,8,7,"16",0,3,12,2,1,1,1037657,"2023-11-01T00:00:00.000Z",29,FALSE,15,38017731,"G",15,15,"Memphis Grizzlies","Vince Williams Jr.",4,14,17,15,5,29.9
0,0,0,2,0,4,2,0,0,"08",0,0,4,0,0,0,1037657,"2023-11-01T00:00:00.000Z",29,FALSE,15,38017728,"F",15,15,"Memphis Grizzlies","Jake LaRavia",0,4,4,4,0,4
0,0,0,0,0,0,0,0,0,"00",0,0,0,0,0,0,1037657,"2023-11-01T00:00:00.000Z",29,FALSE,15,666786,"G",15,15,"Memphis Grizzlies","Ja Morant",0,0,0,0,0,0
0,0,0,0,0,0,0,0,0,"00",0,0,0,0,0,0,1037657,"2023-11-01T00:00:00.000Z",29,FALSE,15,3,"C",15,15,"Memphis Grizzlies","Steven Adams",0,0,0,0,0,0
0,0,0,0,0,0,0,0,0,"00",0,0,0,0,0,0,1037657,"2023-11-01T00:00:00.000Z",29,FALSE,15,17896067,"F",15,15,"Memphis Grizzlies","Santi Aldama",0,0,0,0,0,0
0,0,0,0,0,0,0,0,0,"00",0,0,0,0,0,0,1037657,"2023-11-01T00:00:00.000Z",29,FALSE,15,666505,"F",15,15,"Memphis Grizzlies","Brandon Clarke",0,0,0,0,0,0
0,0,2,1,0,10,6,2,2,"25",0,2,14,2,0,1,1037658,"2023-11-01T00:00:00.000Z",10,FALSE,26,475,"F-G",10,10,"Golden State Warriors","Andrew Wiggins",0,16,16,14,2,15.4
9,2,0,4,2,7,4,4,3,"28",2,1,13,2,2,2,1037658,"2023-11-01T00:00:00.000Z",10,FALSE,26,185,"F",10,10,"Golden State Warriors","Draymond Green",4,15,24,22,11,38.9
6,0,7,0,0,4,3,0,0,"23",2,2,6,9,0,0,1037658,"2023-11-01T00:00:00.000Z",10,FALSE,26,282,"F",10,10,"Golden State Warriors","Kevon Looney",0,15,21,12,15,25.8
2,3,1,4,1,15,6,1,1,"29",1,3,14,2,0,2,1037658,"2023-11-01T00:00:00.000Z",10,FALSE,26,443,"G",10,10,"Golden State Warriors","Klay Thompson",3,16,18,16,4,26.4
3,0,4,10,4,15,7,3,3,"32",1,3,21,5,0,7,1037658,"2023-11-01T00:00:00.000Z",10,FALSE,26,115,"G",10,10,"Golden State Warriors","Stephen Curry",0,26,29,24,8,24.5
0,0,0,0,0,0,0,0,0,"01",0,0,0,0,0,0,1037658,"2023-11-01T00:00:00.000Z",10,FALSE,26,56677799,"F",10,10,"Golden State Warriors","Trayce Jackson-Davis",0,0,0,0,0,0
0,0,0,0,0,0,0,0,0,"00",0,0,0,0,0,0,1037658,"2023-11-01T00:00:00.000Z",10,FALSE,26,17896044,"F",26,26,"Sacramento Kings","Kessler Edwards",0,0,0,0,0,0
0,0,0,0,0,0,0,0,0,"00",0,0,0,0,0,0,1037658,"2023-11-01T00:00:00.000Z",10,FALSE,26,38017714,"G",26,26,"Sacramento Kings","Keon Ellis",0,0,0,0,0,0
0,0,0,0,0,0,0,0,0,"00",0,0,0,0,0,0,1037658,"2023-11-01T00:00:00.000Z",10,FALSE,26,17895990,"G",26,26,"Sacramento Kings","Jordan Ford",0,0,0,0,0,0
1,1,2,0,0,4,2,0,0,"17",1,3,4,3,1,0,1037658,"2023-11-01T00:00:00.000Z",10,FALSE,26,56677845,"G",26,26,"Sacramento Kings","Colby Jones",2,7,8,5,4,15.1
0,0,0,0,0,0,0,0,0,"00",0,0,0,0,0,0,1037658,"2023-11-01T00:00:00.000Z",10,FALSE,26,273,"C",26,26,"Sacramento Kings","Alex Len",0,0,0,0,0,0
0,1,4,0,0,7,3,0,0,"10",2,0,6,6,0,1,1037658,"2023-11-01T00:00:00.000Z",10,FALSE,26,306,"C",26,26,"Sacramento Kings","JaVale McGee",1,12,12,6,6,15.2
2,2,0,5,3,9,5,3,3,"25",3,1,16,3,0,3,1037658,"2023-11-01T00:00:00.000Z",10,FALSE,26,324,"G",26,26,"Sacramento Kings","Malik Monk",2,19,21,18,5,25.6
0,0,0,0,0,0,0,0,0,"00",0,0,0,0,0,0,1037658,"2023-11-01T00:00:00.000Z",10,FALSE,26,56677862,"F",26,26,"Sacramento Kings","Jalen Slawson",0,0,0,0,0,0
0,0,5,3,0,6,1,0,0,"17",0,2,2,5,0,1,1037658,"2023-11-01T00:00:00.000Z",10,FALSE,26,4197162,"F",26,26,"Sacramento Kings","Aleksandar Vezenkov",0,7,7,2,5,7
0,0,0,0,0,0,0,0,0,"00",0,0,0,0,0,0,1037658,"2023-11-01T00:00:00.000Z",10,FALSE,26,251,"G",10,10,"Golden State Warriors","Cory Joseph",0,0,0,0,0,0
1,0,1,2,1,9,4,3,3,"17",0,2,12,1,1,1,1037658,"2023-11-01T00:00:00.000Z",10,FALSE,26,17553979,"F",10,10,"Golden State Warriors","Jonathan Kuminga",1,13,14,13,2,16.7
0,1,3,2,0,3,0,2,1,"15",0,1,1,3,0,0,1037658,"2023-11-01T00:00:00.000Z",10,FALSE,26,17553992,"G",10,10,"Golden State Warriors","Moses Moody",1,4,4,1,3,7.6
8,0,3,3,0,5,1,0,0,"28",1,2,2,4,1,0,1037658,"2023-11-01T00:00:00.000Z",10,FALSE,26,367,"G",10,10,"Golden State Warriors","Chris Paul",1,6,14,10,12,21.8
1,0,2,0,0,4,2,0,0,"22",0,0,4,2,1,1,1037658,"2023-11-01T00:00:00.000Z",10,FALSE,26,2189,"",10,10,"Golden State Warriors","Gary Payton II",1,6,7,5,3,9.9
0,0,0,0,0,0,0,0,0,"00",0,0,0,0,0,0,1037658,"2023-11-01T00:00:00.000Z",10,FALSE,26,56677858,"G",10,10,"Golden State Warriors","Brandin Podziemski",0,0,0,0,0,0
2,0,6,5,3,9,6,0,0,"20",0,1,15,6,0,3,1037658,"2023-11-01T00:00:00.000Z",10,FALSE,26,407,"F",10,10,"Golden State Warriors","Dario Saric",0,21,23,17,8,22.2
0,0,0,0,0,0,0,0,0,"00",0,0,0,0,0,0,1037658,"2023-11-01T00:00:00.000Z",10,FALSE,26,17896070,"F",10,10,"Golden State Warriors","Usman Garuba",0,0,0,0,0,0
0,0,0,0,0,0,0,0,0,"00",0,0,0,0,0,0,1037658,"2023-11-01T00:00:00.000Z",10,FALSE,26,45658838,"G",10,10,"Golden State Warriors","Lester Quinones",0,0,0,0,0,0
0,0,0,0,0,0,0,0,0,"00",0,0,0,0,0,0,1037658,"2023-11-01T00:00:00.000Z",10,FALSE,26,398,"G",10,10,"Golden State Warriors","Jerome Robinson",0,0,0,0,0,0
1,0,0,7,4,8,4,2,2,"31",1,0,14,1,1,1,1037658,"2023-11-01T00:00:00.000Z",10,FALSE,26,30,"F",26,26,"Sacramento Kings","Harrison Barnes",1,15,16,15,2,18.7
2,0,4,7,0,15,4,2,2,"39",2,2,10,6,2,0,1037658,"2023-11-01T00:00:00.000Z",10,FALSE,26,38017688,"F",26,26,"Sacramento Kings","Keegan Murray",2,16,18,12,8,26.2
7,0,8,1,0,16,8,12,7,"37",3,2,23,11,0,2,1037658,"2023-11-01T00:00:00.000Z",10,FALSE,26,406,"F",26,26,"Sacramento Kings","Domantas Sabonis",0,34,41,30,18,44.7
3,0,7,5,1,11,4,2,2,"27",2,3,11,9,1,1,1037658,"2023-11-01T00:00:00.000Z",10,FALSE,26,221,"G",26,26,"Sacramento Kings","Kevin Huerter",1,20,23,14,12,28.3
4,0,3,6,3,9,5,0,0,"30",0,1,13,3,3,2,1037658,"2023-11-01T00:00:00.000Z",10,FALSE,26,17553994,"G",26,26,"Sacramento Kings","Davion Mitchell",3,16,20,17,7,29.6
2,0,1,1,0,3,0,2,2,"07",0,3,2,1,0,1,1037658,"2023-11-01T00:00:00.000Z",10,FALSE,26,17896030,"G",26,26,"Sacramento Kings","Chris Duarte",0,3,5,4,3,5.2
0,0,0,0,0,0,0,0,0,"00",0,0,0,0,0,0,1037658,"2023-11-01T00:00:00.000Z",10,FALSE,26,161,"G",26,26,"Sacramento Kings","De'Aaron Fox",0,0,0,0,0,0
0,0,0,0,0,0,0,0,0,"00",0,0,0,0,0,0,1037658,"2023-11-01T00:00:00.000Z",10,FALSE,26,290,"F",26,26,"Sacramento Kings","Trey Lyles",0,0,0,0,0,0
7,2,12,8,4,19,13,10,5,"42",0,3,35,12,1,4,1037659,"2023-11-01T00:00:00.000Z",14,FALSE,13,237,"F",14,14,"Los Angeles Lakers","LeBron James",3,47,54,42,19,64.9
3,4,6,0,0,18,10,9,7,"48",4,3,27,10,2,0,1037659,"2023-11-01T00:00:00.000Z",14,FALSE,13,117,"F-C",14,14,"Los Angeles Lakers","Anthony Davis",6,37,40,30,13,61.5
7,0,5,3,0,13,5,5,5,"38",2,4,15,7,3,5,1037659,"2023-11-01T00:00:00.000Z",14,FALSE,13,17553995,"G",14,14,"Los Angeles Lakers","Austin Reaves",3,22,29,22,14,37.9
6,0,2,7,3,19,10,4,4,"36",0,2,27,2,0,3,1037659,"2023-11-01T00:00:00.000Z",14,FALSE,13,405,"G",14,14,"Los Angeles Lakers","D'Angelo Russell",0,29,35,33,8,35.4
0,0,3,5,1,7,1,2,2,"22",0,3,5,3,0,0,1037659,"2023-11-01T00:00:00.000Z",14,FALSE,13,38017697,"G",14,14,"Los Angeles Lakers","Max Christie",0,8,8,5,3,8.6
4,1,4,5,1,7,2,4,3,"37",0,5,8,4,3,0,1037659,"2023-11-01T00:00:00.000Z",14,FALSE,13,666860,"F-G",14,14,"Los Angeles Lakers","Cameron Reddish",4,12,16,12,8,30.8
0,1,9,4,2,6,4,0,0,"29",2,3,10,11,1,2,1037659,"2023-11-01T00:00:00.000Z",14,FALSE,13,486,"F",14,14,"Los Angeles Lakers","Christian Wood",2,21,21,10,11,27.2
0,0,0,0,0,0,0,0,0,"00",0,0,0,0,0,0,1037659,"2023-11-01T00:00:00.000Z",14,FALSE,13,56677836,"F",14,14,"Los Angeles Lakers","Maxwell Lewis",0,0,0,0,0,0
0,0,0,0,0,0,0,0,0,"00",0,0,0,0,0,0,1037659,"2023-11-01T00:00:00.000Z",14,FALSE,13,56677738,"C",14,14,"Los Angeles Lakers","Colin Castleton",0,0,0,0,0,0
0,0,0,0,0,0,0,0,0,"00",0,0,0,0,0,0,1037659,"2023-11-01T00:00:00.000Z",14,FALSE,13,56677867,"F",14,14,"Los Angeles Lakers","Alex Fudge",0,0,0,0,0,0
0,0,0,0,0,0,0,0,0,"00",0,0,0,0,0,0,1037659,"2023-11-01T00:00:00.000Z",14,FALSE,13,56677868,"G",14,14,"Los Angeles Lakers","D'Moi Hodge",0,0,0,0,0,0
0,0,0,0,0,0,0,0,0,"00",0,0,0,0,0,0,1037659,"2023-11-01T00:00:00.000Z",14,FALSE,13,383,"F",14,14,"Los Angeles Lakers","Taurean Prince",0,0,0,0,0,0
0,0,0,0,0,0,0,0,0,"00",0,0,0,0,0,0,1037659,"2023-11-01T00:00:00.000Z",14,FALSE,13,666609,"F",14,14,"Los Angeles Lakers","Rui Hachimura",0,0,0,0,0,0
0,0,0,0,0,0,0,0,0,"00",0,0,0,0,0,0,1037659,"2023-11-01T00:00:00.000Z",14,FALSE,13,56677835,"G",14,14,"Los Angeles Lakers","Jalen Hood-Schifino",0,0,0,0,0,0
0,0,0,0,0,0,0,0,0,"00",0,0,0,0,0,0,1037659,"2023-11-01T00:00:00.000Z",14,FALSE,13,457,"F",14,14,"Los Angeles Lakers","Jarred Vanderbilt",0,0,0,0,0,0
0,0,0,0,0,0,0,0,0,"00",0,0,0,0,0,0,1037659,"2023-11-01T00:00:00.000Z",14,FALSE,13,1603383,"G",14,14,"Los Angeles Lakers","Gabe Vincent",0,0,0,0,0,0
1,0,6,9,6,16,11,8,7,"37",0,6,35,6,2,3,1037659,"2023-11-01T00:00:00.000Z",14,FALSE,13,172,"F",13,13,"LA Clippers","Paul George",2,41,42,36,7,46.7
5,0,5,11,5,28,15,6,3,"41",1,2,38,6,2,2,1037659,"2023-11-01T00:00:00.000Z",14,FALSE,13,274,"F",13,13,"LA Clippers","Kawhi Leonard",2,44,49,43,11,56.7
0,0,7,0,0,8,3,2,1,"29",2,5,7,9,0,1,1037659,"2023-11-01T00:00:00.000Z",14,FALSE,13,493,"C",13,13,"LA Clippers","Ivica Zubac",0,16,16,7,9,16.8
5,0,1,3,0,7,2,0,0,"34",0,3,4,1,1,0,1037659,"2023-11-01T00:00:00.000Z",14,FALSE,13,17896031,"G",13,13,"LA Clippers","Nah'Shon Hyland",1,5,10,9,6,15.7
8,0,7,6,3,21,9,5,3,"44",4,5,24,11,4,6,1037659,"2023-11-01T00:00:00.000Z",14,FALSE,13,472,"G",13,13,"LA Clippers","Russell Westbrook",4,35,43,32,19,55.2
0,0,0,1,0,1,0,0,0,"05",0,0,0,0,0,0,1037659,"2023-11-01T00:00:00.000Z",14,FALSE,13,56677849,"F",13,13,"LA Clippers","Kobe Brown",0,0,0,0,0,0
0,0,0,0,0,0,0,0,0,"00",0,0,0,0,0,0,1037659,"2023-11-01T00:00:00.000Z",14,FALSE,13,666511,"G",13,13,"LA Clippers","Amir Coffey",0,0,0,0,0,0
0,0,0,0,0,0,0,0,0,"00",0,0,0,0,0,0,1037659,"2023-11-01T00:00:00.000Z",14,FALSE,13,38017725,"F",13,13,"LA Clippers","Moussa Diabate",0,0,0,0,0,0
0,0,0,0,0,0,0,0,0,"00",0,0,0,0,0,0,1037659,"2023-11-01T00:00:00.000Z",14,FALSE,13,56677856,"G",13,13,"LA Clippers","Jordan Miller",0,0,0,0,0,0
0,0,6,0,0,3,1,6,3,"19",0,0,5,6,3,1,1037659,"2023-11-01T00:00:00.000Z",14,FALSE,13,371,"F-C",13,13,"LA Clippers","Mason Plumlee",3,11,11,5,6,20.2
3,1,2,4,0,14,6,0,0,"35",0,6,12,2,0,0,1037659,"2023-11-01T00:00:00.000Z",14,FALSE,13,380,"F-G",13,13,"LA Clippers","Norman Powell",1,14,17,15,5,21.9
0,0,0,0,0,1,0,0,0,"21",5,4,0,5,0,0,1037659,"2023-11-01T00:00:00.000Z",14,FALSE,13,450,"F",13,13,"LA Clippers","PJ Tucker",0,5,5,0,5,6
1,1,1,0,0,1,1,2,1,"13",1,1,3,2,0,0,1037659,"2023-11-01T00:00:00.000Z",14,FALSE,13,666626,"C",14,14,"Los Angeles Lakers","Jaxson Hayes",1,5,6,4,3,9.9
0,0,0,0,0,0,0,0,0,"00",0,0,0,0,0,0,1037659,"2023-11-01T00:00:00.000Z",14,FALSE,13,17896051,"G",13,13,"LA Clippers","Joshua Primo",0,0,0,0,0,0
0,0,0,0,0,0,0,0,0,"00",0,0,0,0,0,0,1037659,"2023-11-01T00:00:00.000Z",14,FALSE,13,17896022,"G",13,13,"LA Clippers","Brandon Boston Jr.",0,0,0,0,0,0
0,0,0,0,0,0,0,0,0,"00",0,0,0,0,0,0,1037659,"2023-11-01T00:00:00.000Z",14,FALSE,13,192,"G",13,13,"LA Clippers","James Harden",0,0,0,0,0,0
0,0,0,0,0,0,0,0,0,"00",0,0,0,0,0,0,1037659,"2023-11-01T00:00:00.000Z",14,FALSE,13,666743,"G",13,13,"LA Clippers","Terance Mann",0,0,0,0,0,0
2,0,4,3,0,14,8,0,0,"30",3,4,16,7,2,2,1037647,"2023-11-01T00:00:00.000Z",9,FALSE,25,56677826,"G-F",9,9,"Detroit Pistons","Ausar Thompson",2,23,25,18,9,31.4
4,0,4,4,2,8,5,0,0,"33",2,5,12,6,1,2,1037647,"2023-11-01T00:00:00.000Z",9,FALSE,25,3547267,"F-C",9,9,"Detroit Pistons","Isaiah Stewart",1,18,22,16,10,26.2
3,2,6,2,0,10,3,5,4,"33",0,3,10,6,0,5,1037647,"2023-11-01T00:00:00.000Z",9,FALSE,25,24,"F",9,9,"Detroit Pistons","Marvin Bagley III",2,16,19,13,9,22.7
4,0,5,9,5,27,11,3,3,"37",0,3,30,5,1,6,1037647,"2023-11-01T00:00:00.000Z",9,FALSE,25,17896075,"G-F",9,9,"Detroit Pistons","Cade Cunningham",1,35,39,34,9,39
1,0,3,1,0,6,0,0,0,"26",0,2,0,3,3,1,1037647,"2023-11-01T00:00:00.000Z",9,FALSE,25,3547241,"G",9,9,"Detroit Pistons","Killian Hayes",3,3,4,1,4,13.1
0,0,0,0,0,0,0,0,0,"00",0,0,0,0,0,0,1037647,"2023-11-01T00:00:00.000Z",9,FALSE,25,56677729,"G",9,9,"Detroit Pistons","Malcolm Cazalon",0,0,0,0,0,0
1,0,1,6,3,7,4,0,0,"17",1,1,11,2,0,0,1037647,"2023-11-01T00:00:00.000Z",9,FALSE,25,197,"F-G",9,9,"Detroit Pistons","Joe Harris",0,13,14,12,3,14.9
2,1,2,3,1,7,3,3,3,"22",0,3,10,2,1,1,1037647,"2023-11-01T00:00:00.000Z",9,FALSE,25,38017682,"G",9,9,"Detroit Pistons","Jaden Ivey",2,12,14,12,4,20.4
0,0,0,0,0,0,0,0,0,"00",0,0,0,0,0,0,1037647,"2023-11-01T00:00:00.000Z",9,FALSE,25,42097199,"G",9,9,"Detroit Pistons","Jared Rhoden",0,0,0,0,0,0
6,1,3,1,0,6,4,0,0,"24",0,3,8,3,4,0,1037647,"2023-11-01T00:00:00.000Z",9,FALSE,25,56677792,"G",9,9,"Detroit Pistons","Marcus Sasser",5,11,17,14,9,35.6
0,0,2,0,0,1,0,0,0,"12",0,3,0,2,0,0,1037647,"2023-11-01T00:00:00.000Z",9,FALSE,25,44477024,"G",9,9,"Detroit Pistons","Stanley Umude",0,2,2,0,2,2.4
1,0,2,0,0,4,2,0,0,"06",0,4,4,2,0,1,1037647,"2023-11-01T00:00:00.000Z",9,FALSE,25,3547240,"C",9,9,"Detroit Pistons","James Wiseman",0,6,7,5,3,6.9
0,0,0,0,0,0,0,0,0,"00",0,0,0,0,0,0,1037647,"2023-11-01T00:00:00.000Z",9,FALSE,25,54,"F",9,9,"Detroit Pistons","Bojan Bogdanovic",0,0,0,0,0,0
0,0,0,0,0,0,0,0,0,"00",0,0,0,0,0,0,1037647,"2023-11-01T00:00:00.000Z",9,FALSE,25,77,"G",9,9,"Detroit Pistons","Alec Burks",0,0,0,0,0,0
0,0,0,0,0,0,0,0,0,"00",0,0,0,0,0,0,1037647,"2023-11-01T00:00:00.000Z",9,FALSE,25,56783340,"C",25,25,"Portland Trail Blazers","Duop Reath",0,0,0,0,0,0
0,0,0,0,0,0,0,0,0,"00",0,0,0,0,0,0,1037647,"2023-11-01T00:00:00.000Z",9,FALSE,25,419,"G",25,25,"Portland Trail Blazers","Anfernee Simons",0,0,0,0,0,0
0,0,0,0,0,0,0,0,0,"00",0,0,0,0,0,0,1037647,"2023-11-01T00:00:00.000Z",9,FALSE,25,17896120,"F",25,25,"Portland Trail Blazers","Ish Wainright",0,0,0,0,0,0
0,0,0,0,0,0,0,0,0,"00",0,0,0,0,0,0,1037647,"2023-11-01T00:00:00.000Z",9,FALSE,25,38017694,"C",9,9,"Detroit Pistons","Jalen Duren",0,0,0,0,0,0
0,0,0,0,0,0,0,0,0,"00",0,0,0,0,0,0,1037647,"2023-11-01T00:00:00.000Z",9,FALSE,25,17896071,"F",9,9,"Detroit Pistons","Isaiah Livers",0,0,0,0,0,0
0,0,0,0,0,0,0,0,0,"00",0,0,0,0,0,0,1037647,"2023-11-01T00:00:00.000Z",9,FALSE,25,330,"G",9,9,"Detroit Pistons","Monte Morris",0,0,0,0,0,0
1,0,1,3,0,3,0,0,0,"17",0,1,0,1,1,0,1037647,"2023-11-01T00:00:00.000Z",9,FALSE,25,666923,"G-F",25,25,"Portland Trail Blazers","Matisse Thybulle",1,1,2,1,2,5.7
0,0,1,4,2,16,7,10,8,"38",0,4,24,1,1,4,1037647,"2023-11-01T00:00:00.000Z",9,FALSE,25,182,"F",25,25,"Portland Trail Blazers","Jerami Grant",1,25,25,24,1,24.2
1,1,10,0,0,13,8,0,0,"34",1,0,16,11,5,2,1037647,"2023-11-01T00:00:00.000Z",9,FALSE,25,22,"C",25,25,"Portland Trail Blazers","Deandre Ayton",6,27,28,17,12,46.7
5,2,5,6,3,16,9,10,8,"42",2,1,29,7,1,2,1037647,"2023-11-01T00:00:00.000Z",9,FALSE,25,38017690,"G",25,25,"Portland Trail Blazers","Shaedon Sharpe",3,36,41,34,12,51.9
7,0,0,3,1,10,4,2,2,"20",0,2,11,0,0,3,1037647,"2023-11-01T00:00:00.000Z",9,FALSE,25,56677747,"G",25,25,"Portland Trail Blazers","Scoot Henderson",0,11,18,18,7,18.5
1,2,8,0,0,4,2,2,2,"19",0,4,6,8,0,1,1037647,"2023-11-01T00:00:00.000Z",9,FALSE,25,476,"C-F",25,25,"Portland Trail Blazers","Robert Williams III",2,14,15,7,9,22.1
6,0,5,5,1,11,5,4,3,"26",1,1,14,6,1,2,1037647,"2023-11-01T00:00:00.000Z",9,FALSE,25,65,"G",25,25,"Portland Trail Blazers","Malcolm Brogdon",1,20,26,20,12,31.2
0,1,6,0,0,3,2,3,3,"26",2,2,7,8,1,1,1037647,"2023-11-01T00:00:00.000Z",9,FALSE,25,56677850,"F",25,25,"Portland Trail Blazers","Toumani Camara",2,15,15,7,8,21.6
0,1,1,0,0,2,0,2,1,"10",0,0,1,1,0,1,1037647,"2023-11-01T00:00:00.000Z",9,FALSE,25,38017711,"F",25,25,"Portland Trail Blazers","Jabari Walker",1,2,2,1,1,4.2
2,0,0,0,0,3,1,0,0,"08",1,0,2,1,0,1,1037647,"2023-11-01T00:00:00.000Z",9,FALSE,25,3547289,"G",25,25,"Portland Trail Blazers","Skylar Mays",0,3,5,4,3,5.2
0,0,0,0,0,0,0,0,0,"00",0,0,0,0,0,0,1037647,"2023-11-01T00:00:00.000Z",9,FALSE,25,666476,"C",25,25,"Portland Trail Blazers","Moses Brown",0,0,0,0,0,0
0,0,0,0,0,0,0,0,0,"00",0,0,0,0,0,0,1037647,"2023-11-01T00:00:00.000Z",9,FALSE,25,56677791,"F",25,25,"Portland Trail Blazers","Kris Murray",0,0,0,0,0,0
0,0,0,0,0,0,0,0,0,"00",0,0,0,0,0,0,1037647,"2023-11-01T00:00:00.000Z",9,FALSE,25,56677829,"G-F",25,25,"Portland Trail Blazers","Rayan Rupert",0,0,0,0,0,0
0,0,0,0,0,0,0,0,0,"00",0,0,0,0,0,0,1037647,"2023-11-01T00:00:00.000Z",9,FALSE,25,47957121,"F",25,25,"Portland Trail Blazers","Justin Minaya",0,0,0,0,0,0
3,0,2,1,1,7,7,2,1,"25",0,5,16,2,1,2,1037648,"2023-11-01T00:00:00.000Z",28,FALSE,17,18,"F",28,28,"Toronto Raptors","OG Anunoby",1,18,21,19,5,23.9
7,0,6,8,5,13,9,3,3,"33",0,3,26,6,0,3,1037648,"2023-11-01T00:00:00.000Z",28,FALSE,17,416,"F",28,28,"Toronto Raptors","Pascal Siakam",0,32,39,33,13,40.7
2,4,7,0,0,10,7,0,0,"29",4,4,14,11,0,2,1037648,"2023-11-01T00:00:00.000Z",28,FALSE,17,373,"C",28,28,"Toronto Raptors","Jakob Poeltl",4,25,27,16,13,40.2
5,2,7,6,4,16,8,1,1,"29",5,1,21,12,1,3,1037648,"2023-11-01T00:00:00.000Z",28,FALSE,17,17896055,"G-F",28,28,"Toronto Raptors","Scottie Barnes",3,33,38,26,17,48.9
11,0,3,4,2,13,9,4,4,"29",1,2,24,4,1,2,1037648,"2023-11-01T00:00:00.000Z",28,FALSE,17,409,"G",28,28,"Toronto Raptors","Dennis Schroder",1,28,39,35,15,46.3
1,0,4,1,0,4,2,2,2,"13",1,3,6,5,1,0,1037648,"2023-11-01T00:00:00.000Z",28,FALSE,17,58,"F",28,28,"Toronto Raptors","Chris Boucher",1,11,12,7,6,16.5
0,0,1,8,1,10,2,0,0,"21",0,1,5,1,0,0,1037648,"2023-11-01T00:00:00.000Z",28,FALSE,17,56677828,"G",28,28,"Toronto Raptors","Gradey Dick",0,6,6,5,1,6.2
4,0,2,1,0,3,1,0,0,"19",1,1,2,3,3,3,1037648,"2023-11-01T00:00:00.000Z",28,FALSE,17,3547275,"G",28,28,"Toronto Raptors","Malachi Flynn",3,5,9,6,7,17.6
0,0,0,0,0,0,0,0,0,"00",0,0,0,0,0,0,1037648,"2023-11-01T00:00:00.000Z",28,FALSE,17,666762,"F",28,28,"Toronto Raptors","Jalen McDaniels",0,0,0,0,0,0
1,0,2,5,0,11,4,0,0,"23",1,2,8,3,0,1,1037648,"2023-11-01T00:00:00.000Z",28,FALSE,17,3089,"",28,28,"Toronto Raptors","Gary Trent Jr.",0,11,12,9,4,12.1
0,0,0,0,0,1,0,0,0,"04",0,0,0,0,0,0,1037648,"2023-11-01T00:00:00.000Z",28,FALSE,17,2148,"",17,17,"Milwaukee Bucks","Thanasis Antetokounmpo",0,0,0,0,0,0
0,0,0,0,0,0,0,0,0,"00",0,0,0,0,0,0,1037648,"2023-11-01T00:00:00.000Z",28,FALSE,17,666960,"G",17,17,"Milwaukee Bucks","Lindell Wigginton",0,0,0,0,0,0
0,0,2,5,2,5,2,2,2,"16",0,0,8,2,0,0,1037648,"2023-11-01T00:00:00.000Z",28,FALSE,17,38017676,"F",17,17,"Milwaukee Bucks","MarJon Beauchamp",0,10,10,8,2,10.4
1,0,2,1,0,2,1,2,1,"23",0,1,3,2,0,1,1037648,"2023-11-01T00:00:00.000Z",28,FALSE,17,105,"G",17,17,"Milwaukee Bucks","Pat Connaughton",0,5,6,4,3,5.9
3,1,0,3,2,5,3,3,1,"25",1,2,9,1,0,0,1037648,"2023-11-01T00:00:00.000Z",28,FALSE,17,112,"F",17,17,"Milwaukee Bucks","Jae Crowder",1,10,13,12,4,17.7
1,0,1,0,0,1,1,0,0,"05",0,1,2,1,0,0,1037648,"2023-11-01T00:00:00.000Z",28,FALSE,17,38017733,"G",17,17,"Milwaukee Bucks","A.J. Green",0,3,4,3,2,4.7
3,0,1,0,0,1,1,0,0,"06",0,2,2,1,1,0,1037648,"2023-11-01T00:00:00.000Z",28,FALSE,17,56677852,"G",17,17,"Milwaukee Bucks","Andre Jackson Jr.",1,3,6,5,4,10.7
1,0,0,1,1,2,2,0,0,"05",0,0,5,0,0,0,1037648,"2023-11-01T00:00:00.000Z",28,FALSE,17,56677854,"F",17,17,"Milwaukee Bucks","Chris Livingston",0,5,6,6,1,6.5
0,0,0,0,0,0,0,0,0,"00",0,0,0,0,0,0,1037648,"2023-11-01T00:00:00.000Z",28,FALSE,17,284,"C",17,17,"Milwaukee Bucks","Robin Lopez",0,0,0,0,0,0
1,0,2,2,0,5,2,0,0,"19",0,2,4,2,0,1,1037648,"2023-11-01T00:00:00.000Z",28,FALSE,17,368,"G",17,17,"Milwaukee Bucks","Cameron Payne",0,6,7,5,3,6.9
1,0,5,1,0,6,2,9,6,"19",1,1,10,6,2,1,1037648,"2023-11-01T00:00:00.000Z",28,FALSE,17,377,"F",17,17,"Milwaukee Bucks","Bobby Portis",2,16,17,11,7,23.7
0,0,0,0,0,0,0,0,0,"00",0,0,0,0,0,0,1037648,"2023-11-01T00:00:00.000Z",28,FALSE,17,666453,"C",17,17,"Milwaukee Bucks","Marques Bolden",0,0,0,0,0,0
0,0,0,0,0,0,0,0,0,"00",0,0,0,0,0,0,1037648,"2023-11-01T00:00:00.000Z",28,FALSE,17,38017691,"G",17,17,"Milwaukee Bucks","TyTy Washington Jr.",0,0,0,0,0,0
1,1,1,4,2,4,2,0,0,"16",2,3,6,3,0,0,1037648,"2023-11-01T00:00:00.000Z",28,FALSE,17,376,"F",28,28,"Toronto Raptors","Otto Porter Jr.",1,9,10,7,4,14.1
0,0,0,0,0,0,0,2,2,"03",0,0,2,0,0,0,1037648,"2023-11-01T00:00:00.000Z",28,FALSE,17,436,"G-F",28,28,"Toronto Raptors","Garrett Temple",0,2,2,2,0,2
0,0,0,0,0,0,0,0,0,"00",0,0,0,0,0,0,1037648,"2023-11-01T00:00:00.000Z",28,FALSE,17,489,"F",28,28,"Toronto Raptors","Thaddeus Young",0,0,0,0,0,0
0,0,0,0,0,0,0,0,0,"00",0,0,0,0,0,0,1037648,"2023-11-01T00:00:00.000Z",28,FALSE,17,3547249,"F",28,28,"Toronto Raptors","Precious Achiuwa",0,0,0,0,0,0
0,0,0,0,0,0,0,0,0,"00",0,0,0,0,0,0,1037648,"2023-11-01T00:00:00.000Z",28,FALSE,17,56677805,"G",28,28,"Toronto Raptors","Javon Freeman-Liberty",0,0,0,0,0,0
0,0,0,0,0,0,0,0,0,"00",0,0,0,0,0,0,1037648,"2023-11-01T00:00:00.000Z",28,FALSE,17,38017717,"F",28,28,"Toronto Raptors","Ron Harper Jr.",0,0,0,0,0,0
0,0,0,0,0,0,0,0,0,"00",0,0,0,0,0,0,1037648,"2023-11-01T00:00:00.000Z",28,FALSE,17,38017710,"C",28,28,"Toronto Raptors","Christian Koloko",0,0,0,0,0,0
0,0,0,0,0,0,0,0,0,"00",0,0,0,0,0,0,1037648,"2023-11-01T00:00:00.000Z",28,FALSE,17,56677869,"G",28,28,"Toronto Raptors","Markquis Nowell",0,0,0,0,0,0
0,0,3,4,1,10,4,2,2,"17",0,2,11,3,1,4,1037648,"2023-11-01T00:00:00.000Z",28,FALSE,17,315,"F",17,17,"Milwaukee Bucks","Khris Middleton",1,14,14,11,3,13.6
2,0,1,0,0,11,5,9,6,"28",3,3,16,4,1,3,1037648,"2023-11-01T00:00:00.000Z",28,FALSE,17,15,"F",17,17,"Milwaukee Bucks","Giannis Antetokounmpo",1,20,22,18,6,23.8
0,1,1,4,0,8,1,4,4,"17",2,0,6,3,2,0,1037648,"2023-11-01T00:00:00.000Z",28,FALSE,17,283,"C",17,17,"Milwaukee Bucks","Brook Lopez",3,9,9,6,3,18.6
0,0,2,9,6,10,7,0,0,"25",0,2,20,2,2,0,1037648,"2023-11-01T00:00:00.000Z",28,FALSE,17,38,"G",17,17,"Milwaukee Bucks","Malik Beasley",2,22,22,20,2,28.4
6,0,2,4,1,9,4,7,6,"31",0,1,15,2,0,2,1037648,"2023-11-01T00:00:00.000Z",28,FALSE,17,278,"G",17,17,"Milwaukee Bucks","Damian Lillard",0,17,23,21,8,24.4
3,0,7,7,2,16,8,6,5,"33",0,5,23,7,2,5,1037649,"2023-11-01T00:00:00.000Z",1,FALSE,30,666656,"F",1,1,"Atlanta Hawks","De'Andre Hunter",2,30,33,26,10,36.9
0,0,6,7,2,10,4,4,4,"32",1,1,14,7,1,1,1037649,"2023-11-01T00:00:00.000Z",1,FALSE,30,3547256,"F",1,1,"Atlanta Hawks","Saddiq Bey",1,21,21,14,7,24.4
0,0,7,0,0,6,4,2,2,"20",4,0,10,11,1,0,1037649,"2023-11-01T00:00:00.000Z",1,FALSE,30,83,"C",1,1,"Atlanta Hawks","Clint Capela",1,21,21,10,11,26.2
8,1,4,5,3,15,10,2,1,"34",0,2,24,4,1,4,1037649,"2023-11-01T00:00:00.000Z",1,FALSE,30,334,"G",1,1,"Atlanta Hawks","Dejounte Murray",2,28,36,32,12,42.8
10,0,3,3,1,18,7,9,8,"35",0,1,23,3,2,3,1037649,"2023-11-01T00:00:00.000Z",1,FALSE,30,490,"G",1,1,"Atlanta Hawks","Trae Young",2,26,36,33,13,44.6
1,1,3,5,1,10,4,3,3,"23",0,2,12,3,1,1,1037649,"2023-11-01T00:00:00.000Z",1,FALSE,30,53,"G",1,1,"Atlanta Hawks","Bogdan Bogdanovic",2,15,16,13,4,22.1
0,0,0,0,0,0,0,0,0,"00",0,0,0,0,0,0,1037649,"2023-11-01T00:00:00.000Z",1,FALSE,30,56677838,"G",1,1,"Atlanta Hawks","Kobe Bufkin",0,0,0,0,0,0
0,0,0,0,0,0,0,0,0,"00",0,0,0,0,0,0,1037649,"2023-11-01T00:00:00.000Z",1,FALSE,30,666564,"F",1,1,"Atlanta Hawks","Bruno Fernando",0,0,0,0,0,0
0,0,0,0,0,0,0,0,0,"00",0,0,0,0,0,0,1037649,"2023-11-01T00:00:00.000Z",1,FALSE,30,3547297,"G",1,1,"Atlanta Hawks","Trent Forrest",0,0,0,0,0,0
0,0,0,2,0,2,0,0,0,"12",0,0,0,0,0,0,1037649,"2023-11-01T00:00:00.000Z",1,FALSE,30,38017689,"F",1,1,"Atlanta Hawks","AJ Griffin",0,0,0,0,0,0
0,0,0,0,0,0,0,0,0,"00",0,0,0,0,0,0,1037649,"2023-11-01T00:00:00.000Z",1,FALSE,30,56677806,"F",1,1,"Atlanta Hawks","Mouhamed Gueye",0,0,0,0,0,0
2,0,7,2,0,7,3,2,2,"24",4,2,8,11,0,5,1037649,"2023-11-01T00:00:00.000Z",1,FALSE,30,17896040,"F",1,1,"Atlanta Hawks","Jalen Johnson",0,19,21,10,13,19.2
0,0,0,0,0,0,0,0,0,"00",0,0,0,0,0,0,1037649,"2023-11-01T00:00:00.000Z",1,FALSE,30,666754,"G",1,1,"Atlanta Hawks","Garrison Mathews",0,0,0,0,0,0
0,0,0,0,0,0,0,0,0,"00",0,0,0,0,0,0,1037649,"2023-11-01T00:00:00.000Z",1,FALSE,30,319,"G",1,1,"Atlanta Hawks","Patty Mills",0,0,0,0,0,0
2,1,6,1,0,8,6,4,4,"27",5,3,16,11,0,1,1037649,"2023-11-01T00:00:00.000Z",1,FALSE,30,3547244,"F-C",1,1,"Atlanta Hawks","Onyeka Okongwu",1,27,29,18,13,34.2
0,0,0,0,0,0,0,0,0,"00",0,0,0,0,0,0,1037649,"2023-11-01T00:00:00.000Z",1,FALSE,30,56677855,"G",1,1,"Atlanta Hawks","Seth Lundy",0,0,0,0,0,0
0,0,0,0,0,0,0,0,0,"00",0,0,0,0,0,0,1037649,"2023-11-01T00:00:00.000Z",1,FALSE,30,301,"G-F",1,1,"Atlanta Hawks","Wesley Matthews",0,0,0,0,0,0
0,0,0,0,0,0,0,0,0,"00",0,0,0,0,0,0,1037649,"2023-11-01T00:00:00.000Z",1,FALSE,30,56677875,"F",1,1,"Atlanta Hawks","Miles Norris",0,0,0,0,0,0
3,1,2,4,2,16,10,1,0,"24",3,5,22,5,2,1,1037649,"2023-11-01T00:00:00.000Z",1,FALSE,30,3547242,"F",30,30,"Washington Wizards","Deni Avdija",3,27,30,25,8,40.5
6,0,9,6,1,21,11,3,2,"25",0,1,25,9,0,1,1037649,"2023-11-01T00:00:00.000Z",1,FALSE,30,265,"F",30,30,"Washington Wizards","Kyle Kuzma",0,34,40,31,15,43.8
1,1,3,4,1,7,2,2,2,"22",1,3,7,4,1,2,1037649,"2023-11-01T00:00:00.000Z",1,FALSE,30,337,"F-C",30,30,"Washington Wizards","Mike Muscala",2,11,12,8,5,17.3
1,0,0,6,2,13,5,1,1,"20",0,1,13,0,1,1,1037649,"2023-11-01T00:00:00.000Z",1,FALSE,30,666848,"G",30,30,"Washington Wizards","Jordan Poole",1,13,14,14,1,16.5
3,0,1,3,0,6,3,0,0,"22",0,1,6,1,1,1,1037649,"2023-11-01T00:00:00.000Z",1,FALSE,30,249,"G",30,30,"Washington Wizards","Tyus Jones",1,7,10,9,4,13.7
0,0,0,0,0,0,0,0,0,"00",0,0,0,0,0,0,1037649,"2023-11-01T00:00:00.000Z",1,FALSE,30,18677954,"G",30,30,"Washington Wizards","Jared Butler",0,0,0,0,0,0
3,0,2,4,1,5,2,2,0,"28",1,2,5,3,3,3,1037649,"2023-11-01T00:00:00.000Z",1,FALSE,30,56677844,"G",30,30,"Washington Wizards","Bilal Coulibaly",3,8,11,8,6,19.1
0,0,1,1,0,6,3,1,1,"10",0,3,7,1,3,0,1037649,"2023-11-01T00:00:00.000Z",1,FALSE,30,38017687,"G",30,30,"Washington Wizards","Johnny Davis",3,8,8,7,1,17.2
0,0,4,0,0,5,4,0,0,"19",1,1,8,5,0,0,1037649,"2023-11-01T00:00:00.000Z",1,FALSE,30,167,"F",30,30,"Washington Wizards","Danilo Gallinari",0,13,13,8,5,14
2,0,1,0,0,1,1,0,0,"07",0,0,2,1,0,1,1037649,"2023-11-01T00:00:00.000Z",1,FALSE,30,3547302,"F",30,30,"Washington Wizards","Anthony Gill",0,3,5,4,3,5.2
1,0,0,4,0,5,1,0,0,"14",0,1,2,0,0,0,1037649,"2023-11-01T00:00:00.000Z",1,FALSE,30,17896045,"F",30,30,"Washington Wizards","Corey Kispert",0,2,3,3,1,3.5
0,0,2,1,0,6,3,2,1,"08",0,1,7,2,0,1,1037649,"2023-11-01T00:00:00.000Z",1,FALSE,30,17896106,"F",30,30,"Washington Wizards","Eugene Omoruyi",0,9,9,7,2,8.4
1,1,0,0,0,2,2,2,2,"07",0,2,6,0,0,0,1037649,"2023-11-01T00:00:00.000Z",1,FALSE,30,38017712,"G",30,30,"Washington Wizards","Ryan Rollins",1,6,7,7,1,10.5
2,0,1,4,2,5,3,0,0,"12",0,3,8,1,1,0,1037649,"2023-11-01T00:00:00.000Z",1,FALSE,30,414,"G",30,30,"Washington Wizards","Landry Shamet",1,9,11,10,3,15.2
9,0,3,3,1,3,1,0,0,"22",0,1,3,3,2,0,1037649,"2023-11-01T00:00:00.000Z",1,FALSE,30,487,"G",30,30,"Washington Wizards","Delon Wright",2,6,15,12,12,26.1
0,0,0,0,0,0,0,0,0,"00",0,0,0,0,0,0,1037649,"2023-11-01T00:00:00.000Z",1,FALSE,30,38017704,"F",30,30,"Washington Wizards","Patrick Baldwin Jr.",0,0,0,0,0,0
0,0,0,0,0,0,0,0,0,"00",0,0,0,0,0,0,1037649,"2023-11-01T00:00:00.000Z",1,FALSE,30,38124126,"F",30,30,"Washington Wizards","John Butler Jr.",0,0,0,0,0,0
0,0,0,0,0,0,0,0,0,"00",0,0,0,0,0,0,1037649,"2023-11-01T00:00:00.000Z",1,FALSE,30,666577,"F",30,30,"Washington Wizards","Daniel Gafford",0,0,0,0,0,0
1,0,6,1,0,15,7,2,2,"25",1,3,16,7,0,2,1037650,"2023-11-01T00:00:00.000Z",2,FALSE,12,70,"G",2,2,"Boston Celtics","Jaylen Brown",0,23,24,17,8,23.9
4,0,10,5,3,15,9,10,9,"27",2,1,30,12,0,2,1037650,"2023-11-01T00:00:00.000Z",2,FALSE,12,434,"F",2,2,"Boston Celtics","Jayson Tatum",0,42,46,34,16,48.4
2,0,5,3,1,7,3,6,6,"27",1,3,13,6,0,2,1037650,"2023-11-01T00:00:00.000Z",2,FALSE,12,378,"F-C",2,2,"Boston Celtics","Kristaps Porzingis",0,19,21,15,8,21.2
4,1,7,4,3,9,6,0,0,"25",0,0,15,7,0,1,1037650,"2023-11-01T00:00:00.000Z",2,FALSE,12,214,"G",2,2,"Boston Celtics","Jrue Holiday",1,22,26,19,11,31.4
4,0,2,7,4,10,7,0,0,"27",1,3,18,3,0,2,1037650,"2023-11-01T00:00:00.000Z",2,FALSE,12,473,"G",2,2,"Boston Celtics","Derrick White",0,21,25,22,7,25.6
0,0,3,6,5,7,5,2,2,"20",0,3,17,3,1,1,1037650,"2023-11-01T00:00:00.000Z",2,FALSE,12,17896060,"F",2,2,"Boston Celtics","Sam Hauser",1,20,20,17,3,22.6
0,1,2,1,1,3,1,2,2,"11",2,0,5,4,1,1,1037650,"2023-11-01T00:00:00.000Z",2,FALSE,12,219,"C-F",2,2,"Boston Celtics","Al Horford",2,9,9,5,4,14.8
3,0,1,4,0,8,2,1,1,"21",0,2,5,1,0,3,1037650,"2023-11-01T00:00:00.000Z",2,FALSE,12,3547207,"F",12,12,"Indiana Pacers","Jordan Nwora",0,6,9,8,4,7.7
2,0,1,4,2,4,2,0,0,"15",1,3,6,2,0,0,1037650,"2023-11-01T00:00:00.000Z",2,FALSE,12,56677861,"G",12,12,"Indiana Pacers","Ben Sheppard",0,8,10,8,4,11.4
0,0,0,0,0,0,0,0,0,"00",0,0,0,0,0,0,1037650,"2023-11-01T00:00:00.000Z",2,FALSE,12,439,"F",13,12,"Indiana Pacers","Daniel Theis",0,0,0,0,0,0
3,1,2,1,0,6,4,0,0,"12",0,1,8,2,0,0,1037650,"2023-11-01T00:00:00.000Z",2,FALSE,12,56677832,"F",12,12,"Indiana Pacers","Jarace Walker",1,10,13,11,5,17.9
0,0,0,0,0,0,0,0,0,"00",0,0,0,0,0,0,1037650,"2023-11-01T00:00:00.000Z",2,FALSE,12,38017701,"G",12,12,"Indiana Pacers","Kendall Brown",0,0,0,0,0,0
0,0,0,0,0,0,0,0,0,"00",0,0,0,0,0,0,1037650,"2023-11-01T00:00:00.000Z",2,FALSE,12,3547245,"G",12,12,"Indiana Pacers","Tyrese Haliburton",0,0,0,0,0,0
0,0,0,0,0,0,0,0,0,"00",0,0,0,0,0,0,1037650,"2023-11-01T00:00:00.000Z",2,FALSE,12,3547264,"F-C",12,12,"Indiana Pacers","Jalen Smith",0,0,0,0,0,0
0,0,0,0,0,0,0,0,0,"00",0,0,0,0,0,0,1037650,"2023-11-01T00:00:00.000Z",2,FALSE,12,56677778,"F-C",12,12,"Indiana Pacers","Oscar Tshiebwe",0,0,0,0,0,0
0,0,0,0,0,0,0,0,0,"00",0,0,0,0,0,0,1037650,"2023-11-01T00:00:00.000Z",2,FALSE,12,56677794,"G",12,12,"Indiana Pacers","Isaiah Wong",0,0,0,0,0,0
5,0,3,4,1,8,3,0,0,"24",1,3,7,4,1,1,1037650,"2023-11-01T00:00:00.000Z",2,FALSE,12,210,"G",12,12,"Indiana Pacers","Buddy Hield",1,11,16,12,9,21.3
1,0,0,6,1,9,4,1,0,"18",1,4,9,1,0,0,1037650,"2023-11-01T00:00:00.000Z",2,FALSE,12,3547250,"G-F",12,12,"Indiana Pacers","Aaron Nesmith",0,10,11,10,2,11.7
5,0,5,1,0,13,8,2,2,"28",2,2,18,7,1,1,1037650,"2023-11-01T00:00:00.000Z",2,FALSE,12,304,"G",12,12,"Indiana Pacers","T.J. McConnell",1,25,30,23,12,35.9
1,4,3,0,0,5,3,2,1,"19",0,1,7,3,0,1,1037650,"2023-11-01T00:00:00.000Z",2,FALSE,12,17896035,"F",12,12,"Indiana Pacers","Isaiah Jackson",4,10,11,8,4,23.1
9,0,3,3,2,10,6,1,1,"26",1,2,15,4,0,0,1037650,"2023-11-01T00:00:00.000Z",2,FALSE,12,3547276,"G",2,2,"Boston Celtics","Payton Pritchard",0,19,28,24,13,33.3
0,0,1,1,0,4,1,2,2,"20",0,0,4,1,2,0,1037650,"2023-11-01T00:00:00.000Z",2,FALSE,12,666468,"F",2,2,"Boston Celtics","Oshae Brissett",2,5,5,4,1,11.2
1,0,3,0,0,4,4,3,3,"08",0,2,11,3,1,0,1037650,"2023-11-01T00:00:00.000Z",2,FALSE,12,17896094,"G",2,2,"Boston Celtics","Dalano Banton",1,14,15,12,4,19.1
0,0,1,0,0,1,1,0,0,"06",1,0,2,2,0,0,1037650,"2023-11-01T00:00:00.000Z",2,FALSE,12,261,"F-C",2,2,"Boston Celtics","Luke Kornet",0,4,4,2,2,4.4
0,0,3,4,1,6,2,0,0,"11",0,0,5,3,0,0,1037650,"2023-11-01T00:00:00.000Z",2,FALSE,12,338,"G",2,2,"Boston Celtics","Svi Mykhailiuk",0,8,8,5,3,8.6
2,0,0,0,0,4,2,0,0,"07",2,2,4,2,0,0,1037650,"2023-11-01T00:00:00.000Z",2,FALSE,12,3547279,"F",2,2,"Boston Celtics","Lamar Stevens",0,6,8,6,4,9.4
0,0,0,0,0,0,0,0,0,"00",0,0,0,0,0,0,1037650,"2023-11-01T00:00:00.000Z",2,FALSE,12,38017707,"G",2,2,"Boston Celtics","JD Davison",0,0,0,0,0,0
0,0,0,0,0,0,0,0,0,"00",0,0,0,0,0,0,1037650,"2023-11-01T00:00:00.000Z",2,FALSE,12,3547295,"F-C",2,2,"Boston Celtics","Nathan Knight",0,0,0,0,0,0
0,0,0,0,0,0,0,0,0,"00",0,0,0,0,0,0,1037650,"2023-11-01T00:00:00.000Z",2,FALSE,12,17553967,"C",2,2,"Boston Celtics","Neemias Queta",0,0,0,0,0,0
0,0,0,0,0,0,0,0,0,"00",0,0,0,0,0,0,1037650,"2023-11-01T00:00:00.000Z",2,FALSE,12,56677864,"G",2,2,"Boston Celtics","Jordan Walsh",0,0,0,0,0,0
0,0,1,3,0,7,4,0,0,"15",0,1,8,1,0,0,1037650,"2023-11-01T00:00:00.000Z",2,FALSE,12,38017686,"G-F",12,12,"Indiana Pacers","Bennedict Mathurin",0,9,9,8,1,9.2
1,0,0,1,0,6,5,2,1,"25",2,1,11,2,2,1,1037650,"2023-11-01T00:00:00.000Z",2,FALSE,12,3547243,"F",12,12,"Indiana Pacers","Obi Toppin",2,13,14,12,3,19.9
3,1,4,3,0,12,4,0,0,"22",1,1,8,5,1,1,1037650,"2023-11-01T00:00:00.000Z",2,FALSE,12,452,"C-F",12,12,"Indiana Pacers","Myles Turner",2,13,16,11,8,23.5
1,0,1,3,0,6,1,2,1,"21",0,1,3,1,1,0,1037650,"2023-11-01T00:00:00.000Z",2,FALSE,12,69,"G",12,12,"Indiana Pacers","Bruce Brown",1,4,5,4,2,8.7
1,0,2,7,1,17,6,2,1,"20",0,0,14,2,0,1,1037650,"2023-11-01T00:00:00.000Z",2,FALSE,12,38017507,"G-F",12,12,"Indiana Pacers","Andrew Nembhard",0,16,17,15,3,16.9
3,0,3,2,0,16,7,8,6,"34",4,1,20,7,1,1,1037651,"2023-11-01T00:00:00.000Z",16,FALSE,3,79,"G-F",16,16,"Miami Heat","Jimmy Butler",1,27,30,23,10,34.9
1,1,2,6,0,9,1,0,0,"19",2,4,2,4,2,2,1037651,"2023-11-01T00:00:00.000Z",16,FALSE,3,56677785,"G",16,16,"Miami Heat","Jaime Jaquez Jr.",3,6,7,3,5,15.3
3,2,10,0,0,12,8,5,5,"33",4,0,21,14,2,4,1037651,"2023-11-01T00:00:00.000Z",16,FALSE,3,4,"C-F",16,16,"Miami Heat","Bam Adebayo",4,35,38,24,17,50.3
5,0,3,10,6,23,12,1,0,"36",0,2,30,3,0,3,1037651,"2023-11-01T00:00:00.000Z",16,FALSE,3,666633,"G",16,16,"Miami Heat","Tyler Herro",0,33,38,35,8,38.1
3,1,3,5,2,5,2,0,0,"30",0,3,6,3,2,2,1037651,"2023-11-01T00:00:00.000Z",16,FALSE,3,286,"G",16,16,"Miami Heat","Kyle Lowry",3,9,12,9,6,21.1
0,0,4,0,0,4,3,2,2,"15",1,4,8,5,1,2,1037651,"2023-11-01T00:00:00.000Z",16,FALSE,3,74,"C",16,16,"Miami Heat","Thomas Bryant",1,13,13,8,5,15
2,1,4,4,3,5,3,0,0,"22",0,0,9,4,1,1,1037651,"2023-11-01T00:00:00.000Z",16,FALSE,3,3092,"",16,16,"Miami Heat","Haywood Highsmith",2,13,15,11,6,21.8
0,0,0,0,0,0,0,0,0,"00",0,0,0,0,0,0,1037651,"2023-11-01T00:00:00.000Z",16,FALSE,3,38017696,"F",16,16,"Miami Heat","Nikola Jovic",0,0,0,0,0,0
0,0,0,0,0,0,0,0,0,"00",0,0,0,0,0,0,1037651,"2023-11-01T00:00:00.000Z",16,FALSE,3,666747,"F",16,16,"Miami Heat","Caleb Martin",0,0,0,0,0,0
3,0,3,5,1,9,1,2,1,"30",0,2,4,3,1,0,1037651,"2023-11-01T00:00:00.000Z",16,FALSE,3,391,"G-F",16,16,"Miami Heat","Josh Richardson",1,7,10,7,6,15.1
2,0,3,6,1,8,2,0,0,"21",0,4,5,3,0,1,1037651,"2023-11-01T00:00:00.000Z",16,FALSE,3,397,"F",16,16,"Miami Heat","Duncan Robinson",0,8,10,7,5,10.6
0,0,0,0,0,0,0,0,0,"00",0,0,0,0,0,0,1037651,"2023-11-01T00:00:00.000Z",16,FALSE,3,39398582,"C",16,16,"Miami Heat","Orlando Robinson",0,0,0,0,0,0
0,0,0,0,0,0,0,0,0,"00",0,0,0,0,0,0,1037651,"2023-11-01T00:00:00.000Z",16,FALSE,3,19465585,"G",16,16,"Miami Heat","Dru Smith",0,0,0,0,0,0
0,0,0,0,0,0,0,0,0,"00",0,0,0,0,0,0,1037651,"2023-11-01T00:00:00.000Z",16,FALSE,3,38017734,"F",16,16,"Miami Heat","Jamal Cain",0,0,0,0,0,0
0,0,0,0,0,0,0,0,0,"00",0,0,0,0,0,0,1037651,"2023-11-01T00:00:00.000Z",16,FALSE,3,3547257,"G",16,16,"Miami Heat","R.J. Hampton",0,0,0,0,0,0
0,0,0,0,0,0,0,0,0,"00",0,0,0,0,0,0,1037651,"2023-11-01T00:00:00.000Z",16,FALSE,3,285,"F-C",16,16,"Miami Heat","Kevin Love",0,0,0,0,0,0
1,0,6,0,0,3,2,2,1,"13",1,0,5,7,1,0,1037651,"2023-11-01T00:00:00.000Z",16,FALSE,3,17896038,"C",3,3,"Brooklyn Nets","Day'Ron Sharpe",1,12,13,6,8,17.9
4,0,2,4,1,9,4,11,8,"25",1,1,17,3,3,3,1037651,"2023-11-01T00:00:00.000Z",16,FALSE,3,464,"G",3,3,"Brooklyn Nets","Lonnie Walker IV",3,20,24,21,7,32.6
4,0,3,2,1,6,4,2,2,"14",1,2,11,4,1,1,1037651,"2023-11-01T00:00:00.000Z",16,FALSE,3,17896058,"F",3,3,"Brooklyn Nets","Trendon Watford",1,15,19,15,8,23.8
0,1,1,0,0,1,0,0,0,"05",0,0,0,1,0,0,1037651,"2023-11-01T00:00:00.000Z",16,FALSE,3,56677722,"F",3,3,"Brooklyn Nets","Jalen Wilson",1,1,1,0,1,4.2
0,0,0,0,0,0,0,0,0,"00",0,0,0,0,0,0,1037651,"2023-11-01T00:00:00.000Z",16,FALSE,3,56677843,"F",3,3,"Brooklyn Nets","Noah Clowney",0,0,0,0,0,0
0,0,0,0,0,0,0,0,0,"00",0,0,0,0,0,0,1037651,"2023-11-01T00:00:00.000Z",16,FALSE,3,130,"G",3,3,"Brooklyn Nets","Spencer Dinwiddie",0,0,0,0,0,0
0,0,0,0,0,0,0,0,0,"00",0,0,0,0,0,0,1037651,"2023-11-01T00:00:00.000Z",16,FALSE,3,666679,"F",3,3,"Brooklyn Nets","Cameron Johnson",0,0,0,0,0,0
0,0,0,0,0,0,0,0,0,"00",0,0,0,0,0,0,1037651,"2023-11-01T00:00:00.000Z",16,FALSE,3,17896041,"G",3,3,"Brooklyn Nets","Keon Johnson",0,0,0,0,0,0
0,0,0,0,0,0,0,0,0,"00",0,0,0,0,0,0,1037651,"2023-11-01T00:00:00.000Z",16,FALSE,3,421,"G",3,3,"Brooklyn Nets","Dennis Smith Jr.",0,0,0,0,0,0
0,0,0,0,0,0,0,0,0,"00",0,0,0,0,0,0,1037651,"2023-11-01T00:00:00.000Z",16,FALSE,3,56677841,"F",3,3,"Brooklyn Nets","Dariq Whitehead",0,0,0,0,0,0
5,1,7,5,2,6,2,0,0,"38",0,5,6,7,2,3,1037651,"2023-11-01T00:00:00.000Z",16,FALSE,3,351,"F",3,3,"Brooklyn Nets","Royce O'Neale",3,13,18,11,12,27.9
2,0,3,5,3,10,6,0,0,"30",0,3,15,3,0,1,1037651,"2023-11-01T00:00:00.000Z",16,FALSE,3,158,"F",3,3,"Brooklyn Nets","Dorian Finney-Smith",0,18,20,17,5,20.6
1,1,2,7,2,19,4,4,3,"34",0,2,13,2,3,4,1037651,"2023-11-01T00:00:00.000Z",16,FALSE,3,17896048,"G",3,3,"Brooklyn Nets","Cam Thomas",4,15,16,14,3,24.9
5,1,9,0,0,5,2,2,0,"34",2,4,4,11,0,4,1037651,"2023-11-01T00:00:00.000Z",16,FALSE,3,417,"G-F",3,3,"Brooklyn Nets","Ben Simmons",1,15,20,9,16,23.7
0,0,2,6,5,7,6,0,0,"16",0,0,17,2,0,0,1037651,"2023-11-01T00:00:00.000Z",16,FALSE,3,9051997,"G",3,3,"Brooklyn Nets","Armoni Brooks",0,19,19,17,2,19.4
0,0,0,0,0,0,0,0,0,"00",0,0,0,0,0,0,1037651,"2023-11-01T00:00:00.000Z",16,FALSE,3,666508,"F-C",3,3,"Brooklyn Nets","Nicolas Claxton",0,0,0,0,0,0
0,0,0,0,0,0,0,0,0,"00",0,0,0,0,0,0,1037651,"2023-11-01T00:00:00.000Z",16,FALSE,3,174,"F-C",3,3,"Brooklyn Nets","Harry Giles III",0,0,0,0,0,0
5,0,5,7,2,16,7,5,5,"31",2,1,21,7,1,2,1037651,"2023-11-01T00:00:00.000Z",16,FALSE,3,61,"F",3,3,"Brooklyn Nets","Mikal Bridges",1,28,33,26,12,37.9
0,0,0,0,0,0,0,0,0,"00",0,0,0,0,0,0,1037651,"2023-11-01T00:00:00.000Z",16,FALSE,3,38017736,"F",16,16,"Miami Heat","Cole Swider",0,0,0,0,0,0
3,0,5,5,1,14,5,0,0,"29",3,1,11,8,0,2,1037652,"2023-11-01T00:00:00.000Z",20,FALSE,6,202,"G",20,20,"New York Knicks","Josh Hart",0,19,22,14,11,23.1
4,0,6,6,0,15,3,0,0,"35",0,2,6,6,1,3,1037652,"2023-11-01T00:00:00.000Z",20,FALSE,6,387,"F",20,20,"New York Knicks","Julius Randle",1,12,16,10,10,19.2
0,2,8,0,0,3,1,8,4,"32",8,3,6,16,0,1,1037652,"2023-11-01T00:00:00.000Z",20,FALSE,6,399,"C",20,20,"New York Knicks","Mitchell Robinson",2,22,22,6,16,30.2
4,0,3,2,0,23,8,9,8,"39",1,4,24,4,0,1,1037652,"2023-11-01T00:00:00.000Z",20,FALSE,6,73,"G",20,20,"New York Knicks","Jalen Brunson",0,28,32,28,8,33.8
1,0,2,6,1,7,2,0,0,"22",0,0,5,2,1,1,1037652,"2023-11-01T00:00:00.000Z",20,FALSE,6,17895858,"G",20,20,"New York Knicks","Quentin Grimes",1,7,8,6,3,10.9
0,0,0,0,0,0,0,0,0,"00",0,0,0,0,0,0,1037652,"2023-11-01T00:00:00.000Z",20,FALSE,6,19,"G",20,20,"New York Knicks","Ryan Arcidiacono",0,0,0,0,0,0
0,0,0,0,0,0,0,0,0,"00",0,0,0,0,0,0,1037652,"2023-11-01T00:00:00.000Z",20,FALSE,6,666423,"F-G",20,20,"New York Knicks","RJ Barrett",0,0,0,0,0,0
0,1,2,7,3,10,5,5,3,"30",0,3,16,2,2,3,1037652,"2023-11-01T00:00:00.000Z",20,FALSE,6,131,"G",20,20,"New York Knicks","Donte DiVincenzo",3,18,18,16,2,24.4
0,0,0,0,0,0,0,0,0,"00",0,0,0,0,0,0,1037652,"2023-11-01T00:00:00.000Z",20,FALSE,6,160,"G-F",20,20,"New York Knicks","Evan Fournier",0,0,0,0,0,0
2,0,4,0,0,2,0,0,0,"16",2,2,0,6,3,2,1037652,"2023-11-01T00:00:00.000Z",20,FALSE,6,201,"F-C",20,20,"New York Knicks","Isaiah Hartenstein",3,6,8,2,8,17.2
0,0,0,0,0,0,0,0,0,"00",0,0,0,0,0,0,1037652,"2023-11-01T00:00:00.000Z",20,FALSE,6,666675,"F",20,20,"New York Knicks","DaQuan Jeffries",0,0,0,0,0,0
0,0,0,1,0,2,1,2,1,"09",0,1,3,0,2,0,1037652,"2023-11-01T00:00:00.000Z",20,FALSE,6,17896033,"G",20,20,"New York Knicks","Miles McBride",2,3,3,3,0,9
4,0,4,3,0,16,7,6,4,"28",2,0,18,6,1,0,1037652,"2023-11-01T00:00:00.000Z",20,FALSE,6,3547269,"G",20,20,"New York Knicks","Immanuel Quickley",1,24,28,22,10,34.2
0,0,0,0,0,0,0,0,0,"00",0,0,0,0,0,0,1037652,"2023-11-01T00:00:00.000Z",20,FALSE,6,17896063,"F",20,20,"New York Knicks","Jericho Sims",0,0,0,0,0,0
0,0,0,0,0,0,0,0,0,"00",0,0,0,0,0,0,1037652,"2023-11-01T00:00:00.000Z",20,FALSE,6,666971,"G-F",20,20,"New York Knicks","Dylan Windler",0,0,0,0,0,0
0,0,0,0,0,0,0,0,0,"00",0,0,0,0,0,0,1037652,"2023-11-01T00:00:00.000Z",20,FALSE,6,666474,"G",20,20,"New York Knicks","Charles Brown",0,0,0,0,0,0
0,0,0,0,0,0,0,0,0,"00",0,0,0,0,0,0,1037652,"2023-11-01T00:00:00.000Z",20,FALSE,6,56677795,"F",20,20,"New York Knicks","Jacob Toppin",0,0,0,0,0,0
0,0,0,0,0,0,0,0,0,"00",0,0,0,0,0,0,1037652,"2023-11-01T00:00:00.000Z",20,FALSE,6,17896089,"G",20,20,"New York Knicks","Duane Washington Jr.",0,0,0,0,0,0
2,0,10,3,1,6,1,2,2,"28",0,4,5,10,1,0,1037652,"2023-11-01T00:00:00.000Z",20,FALSE,6,344,"F",6,6,"Cleveland Cavaliers","Georges Niang",1,15,17,7,12,23
2,0,3,2,0,3,1,0,0,"31",0,6,2,3,1,1,1037652,"2023-11-01T00:00:00.000Z",20,FALSE,6,3547247,"F-G",6,6,"Cleveland Cavaliers","Isaac Okoro",1,5,7,4,5,10.6
5,2,6,0,0,12,6,3,2,"35",2,2,14,8,2,2,1037652,"2023-11-01T00:00:00.000Z",20,FALSE,6,17896076,"F-C",6,6,"Cleveland Cavaliers","Evan Mobley",4,22,27,19,13,41.1
4,1,5,15,6,22,9,6,6,"37",1,5,30,6,1,5,1037652,"2023-11-01T00:00:00.000Z",20,FALSE,6,322,"G",6,6,"Cleveland Cavaliers","Donovan Mitchell",2,36,40,34,10,44.2
4,2,4,5,0,9,3,3,3,"35",0,3,9,4,0,5,1037652,"2023-11-01T00:00:00.000Z",20,FALSE,6,666908,"G",6,6,"Cleveland Cavaliers","Max Strus",2,13,17,13,8,20.8
0,0,0,0,0,0,0,0,0,"00",0,0,0,0,0,0,1037652,"2023-11-01T00:00:00.000Z",20,FALSE,6,56677847,"F",6,6,"Cleveland Cavaliers","Emoni Bates",0,0,0,0,0,0
0,0,0,0,0,0,0,0,0,"00",0,0,0,0,0,0,1037652,"2023-11-01T00:00:00.000Z",20,FALSE,6,248,"C",6,6,"Cleveland Cavaliers","Damian Jones",0,0,0,0,0,0
5,0,6,4,3,14,6,4,4,"30",0,3,19,6,1,3,1037652,"2023-11-01T00:00:00.000Z",20,FALSE,6,277,"G",6,6,"Cleveland Cavaliers","Caris LeVert",1,25,30,24,11,33.7
0,0,0,0,0,0,0,0,0,"00",0,0,0,0,0,0,1037652,"2023-11-01T00:00:00.000Z",20,FALSE,6,3547299,"G",6,6,"Cleveland Cavaliers","Sam Merrill",0,0,0,0,0,0
0,0,0,0,0,0,0,0,0,"00",0,0,0,0,0,0,1037652,"2023-11-01T00:00:00.000Z",20,FALSE,6,38017662,"F",6,6,"Cleveland Cavaliers","Isaiah Mobley",0,0,0,0,0,0
0,0,1,0,0,1,1,2,2,"11",0,3,4,1,1,0,1037652,"2023-11-01T00:00:00.000Z",20,FALSE,6,56677872,"G",6,6,"Cleveland Cavaliers","Craig Porter",1,5,5,4,1,8.2
0,0,3,0,0,4,3,0,0,"13",2,1,6,5,0,2,1037652,"2023-11-01T00:00:00.000Z",20,FALSE,6,444,"C-F",6,6,"Cleveland Cavaliers","Tristan Thompson",0,11,11,6,5,10
0,0,2,3,2,3,2,0,0,"20",1,0,6,3,0,0,1037652,"2023-11-01T00:00:00.000Z",20,FALSE,6,666940,"F",6,6,"Cleveland Cavaliers","Dean Wade",0,9,9,6,3,9.6
0,0,0,0,0,0,0,0,0,"00",0,0,0,0,0,0,1037652,"2023-11-01T00:00:00.000Z",20,FALSE,6,9,"C",6,6,"Cleveland Cavaliers","Jarrett Allen",0,0,0,0,0,0
0,0,0,0,0,0,0,0,0,"00",0,0,0,0,0,0,1037652,"2023-11-01T00:00:00.000Z",20,FALSE,6,666581,"G",6,6,"Cleveland Cavaliers","Darius Garland",0,0,0,0,0,0
0,0,0,0,0,0,0,0,0,"00",0,0,0,0,0,0,1037652,"2023-11-01T00:00:00.000Z",20,FALSE,6,666676,"G",6,6,"Cleveland Cavaliers","Ty Jerome",0,0,0,0,0,0
0,0,0,0,0,0,0,0,0,"00",0,0,0,0,0,0,1037652,"2023-11-01T00:00:00.000Z",20,FALSE,6,404,"G",6,6,"Cleveland Cavaliers","Ricky Rubio",0,0,0,0,0,0
0,0,1,2,1,3,2,0,0,"09",0,0,5,1,0,0,1037660,"2023-11-02T00:00:00.000Z",23,FALSE,28,666762,"F",28,28,"Toronto Raptors","Jalen McDaniels",0,6,6,5,1,6.2
0,0,0,0,0,1,1,0,0,"02",0,0,2,0,0,0,1037660,"2023-11-02T00:00:00.000Z",23,FALSE,28,436,"G-F",28,28,"Toronto Raptors","Garrett Temple",0,2,2,2,0,2
1,0,1,0,0,0,0,2,0,"02",0,0,0,1,0,0,1037660,"2023-11-02T00:00:00.000Z",23,FALSE,28,489,"F",28,28,"Toronto Raptors","Thaddeus Young",0,1,2,1,2,2.7
0,0,0,0,0,0,0,0,0,"00",0,0,0,0,0,0,1037660,"2023-11-02T00:00:00.000Z",23,FALSE,28,3547249,"F",28,28,"Toronto Raptors","Precious Achiuwa",0,0,0,0,0,0
0,0,0,0,0,0,0,0,0,"00",0,0,0,0,0,0,1037660,"2023-11-02T00:00:00.000Z",23,FALSE,28,56677805,"G",28,28,"Toronto Raptors","Javon Freeman-Liberty",0,0,0,0,0,0
0,0,2,6,5,13,8,3,2,"30",3,3,23,5,1,0,1037660,"2023-11-02T00:00:00.000Z",23,FALSE,28,360,"F",23,23,"Philadelphia 76ers","Kelly Oubre Jr.",1,28,28,23,5,32
3,0,7,6,2,17,10,2,1,"40",0,1,23,7,3,2,1037660,"2023-11-02T00:00:00.000Z",23,FALSE,28,200,"F",23,23,"Philadelphia 76ers","Tobias Harris",3,30,33,26,10,42.9
7,1,8,2,0,22,8,13,12,"35",5,2,28,13,0,4,1037660,"2023-11-02T00:00:00.000Z",23,FALSE,28,145,"F-C",23,23,"Philadelphia 76ers","Joel Embiid",1,41,48,35,20,53.1
5,0,5,3,1,6,1,2,1,"21",0,4,4,5,1,1,1037660,"2023-11-02T00:00:00.000Z",23,FALSE,28,313,"G",23,23,"Philadelphia 76ers","De'Anthony Melton",1,9,14,9,10,19.5
4,0,1,3,0,16,7,4,4,"40",0,1,18,1,2,1,1037660,"2023-11-02T00:00:00.000Z",23,FALSE,28,3547254,"G",23,23,"Philadelphia 76ers","Tyrese Maxey",2,19,23,22,5,30.2
0,0,2,0,0,0,0,0,0,"01",0,1,0,2,0,1,1037660,"2023-11-02T00:00:00.000Z",23,FALSE,28,28,"C",23,23,"Philadelphia 76ers","Mo Bamba",0,2,2,0,2,1.4
0,0,0,0,0,0,0,0,0,"01",0,0,0,0,0,0,1037660,"2023-11-02T00:00:00.000Z",23,FALSE,28,108,"F",23,23,"Philadelphia 76ers","Robert Covington",0,0,0,0,0,0
0,0,0,0,0,0,0,0,0,"00",0,0,0,0,0,0,1037660,"2023-11-02T00:00:00.000Z",23,FALSE,28,2175,"",23,23,"Philadelphia 76ers","Danuel House Jr.",0,0,0,0,0,0
0,0,1,2,1,7,4,1,1,"22",0,0,10,1,3,1,1037660,"2023-11-02T00:00:00.000Z",23,FALSE,28,260,"G-F",23,23,"Philadelphia 76ers","Furkan Korkmaz",3,11,11,10,1,19.2
0,0,0,0,0,0,0,0,0,"01",0,1,0,0,0,0,1037660,"2023-11-02T00:00:00.000Z",23,FALSE,28,3547294,"F",23,23,"Philadelphia 76ers","Kenyon Martin Jr.",0,0,0,0,0,0
0,0,0,0,0,0,0,0,0,"00",0,0,0,0,0,0,1037660,"2023-11-02T00:00:00.000Z",23,FALSE,28,328,"F",23,23,"Philadelphia 76ers","Marcus Morris",0,0,0,0,0,0
0,1,2,0,0,4,3,0,0,"12",3,2,6,5,0,1,1037660,"2023-11-02T00:00:00.000Z",23,FALSE,28,3547270,"F",23,23,"Philadelphia 76ers","Paul Reed",1,11,11,6,5,14
1,0,1,0,0,1,0,0,0,"09",1,1,0,2,0,1,1037660,"2023-11-02T00:00:00.000Z",23,FALSE,28,17896025,"G",23,23,"Philadelphia 76ers","Jaden Springer",0,2,3,1,3,2.9
0,0,0,0,0,0,0,0,0,"00",0,0,0,0,0,0,1037660,"2023-11-02T00:00:00.000Z",23,FALSE,28,33,"F-G",23,23,"Philadelphia 76ers","Nicolas Batum",0,0,0,0,0,0
1,1,2,3,0,6,1,0,0,"28",3,3,2,5,2,2,1037660,"2023-11-02T00:00:00.000Z",23,FALSE,28,45,"G",23,23,"Philadelphia 76ers","Patrick Beverley",3,7,8,3,6,16.5
0,0,0,0,0,0,0,0,0,"00",0,0,0,0,0,0,1037660,"2023-11-02T00:00:00.000Z",23,FALSE,28,56913527,"G",23,23,"Philadelphia 76ers","Ricky Council IV",0,0,0,0,0,0
0,0,0,0,0,0,0,0,0,"00",0,0,0,0,0,0,1037660,"2023-11-02T00:00:00.000Z",23,FALSE,28,17554001,"G",23,23,"Philadelphia 76ers","Javonte Smart",0,0,0,0,0,0
0,0,0,0,0,0,0,0,0,"00",0,0,0,0,0,0,1037660,"2023-11-02T00:00:00.000Z",23,FALSE,28,56677788,"G",23,23,"Philadelphia 76ers","Terquavion Smith",0,0,0,0,0,0
8,0,6,7,2,16,9,4,4,"35",2,4,24,8,0,1,1037660,"2023-11-02T00:00:00.000Z",23,FALSE,28,17896055,"G-F",28,28,"Toronto Raptors","Scottie Barnes",0,32,40,32,16,44.6
10,0,3,2,1,9,4,6,4,"31",0,0,13,3,1,3,1037660,"2023-11-02T00:00:00.000Z",23,FALSE,28,409,"G",28,28,"Toronto Raptors","Dennis Schroder",1,16,26,23,13,31.6
0,1,2,2,0,4,2,2,2,"13",2,3,6,4,0,1,1037660,"2023-11-02T00:00:00.000Z",23,FALSE,28,58,"F",28,28,"Toronto Raptors","Chris Boucher",1,10,10,6,4,12.8
1,0,0,0,0,2,0,0,0,"14",0,1,0,0,0,1,1037660,"2023-11-02T00:00:00.000Z",23,FALSE,28,56677828,"G",28,28,"Toronto Raptors","Gradey Dick",0,0,1,1,1,0.5
1,0,2,3,2,5,2,0,0,"17",1,2,6,3,2,1,1037660,"2023-11-02T00:00:00.000Z",23,FALSE,28,3547275,"G",28,28,"Toronto Raptors","Malachi Flynn",2,9,10,7,4,16.1
0,0,5,5,2,8,2,4,2,"23",0,1,8,5,1,3,1037660,"2023-11-02T00:00:00.000Z",23,FALSE,28,3089,"",28,28,"Toronto Raptors","Gary Trent Jr.",1,13,13,8,5,14
1,1,3,4,2,12,7,0,0,"33",1,2,16,4,0,3,1037660,"2023-11-02T00:00:00.000Z",23,FALSE,28,18,"F",28,28,"Toronto Raptors","OG Anunoby",1,20,21,17,5,22.3
6,0,2,3,0,11,5,0,0,"33",1,5,10,3,0,2,1037660,"2023-11-02T00:00:00.000Z",23,FALSE,28,416,"F",28,28,"Toronto Raptors","Pascal Siakam",0,13,19,16,9,20.6
2,1,7,0,0,8,4,1,1,"28",2,2,9,9,0,4,1037660,"2023-11-02T00:00:00.000Z",23,FALSE,28,373,"C",28,28,"Toronto Raptors","Jakob Poeltl",1,18,20,11,11,21.8
0,0,0,0,0,0,0,0,0,"00",0,0,0,0,0,0,1037660,"2023-11-02T00:00:00.000Z",23,FALSE,28,376,"F",28,28,"Toronto Raptors","Otto Porter Jr.",0,0,0,0,0,0
0,0,0,0,0,0,0,0,0,"00",0,0,0,0,0,0,1037660,"2023-11-02T00:00:00.000Z",23,FALSE,28,38017717,"F",28,28,"Toronto Raptors","Ron Harper Jr.",0,0,0,0,0,0
0,0,0,0,0,0,0,0,0,"00",0,0,0,0,0,0,1037660,"2023-11-02T00:00:00.000Z",23,FALSE,28,38017710,"C",28,28,"Toronto Raptors","Christian Koloko",0,0,0,0,0,0
0,0,0,0,0,0,0,0,0,"00",0,0,0,0,0,0,1037660,"2023-11-02T00:00:00.000Z",23,FALSE,28,56677869,"G",28,28,"Toronto Raptors","Markquis Nowell",0,0,0,0,0,0
0,0,0,0,0,0,0,0,0,"00",0,0,0,0,0,0,1037661,"2023-11-02T00:00:00.000Z",19,FALSE,9,17896097,"G",19,19,"New Orleans Pelicans","Jose Alvarado",0,0,0,0,0,0
0,0,0,0,0,0,0,0,0,"00",0,0,0,0,0,0,1037661,"2023-11-02T00:00:00.000Z",19,FALSE,9,666584,"F",19,19,"New Orleans Pelicans","Kaiser Gates",0,0,0,0,0,0
0,0,0,0,0,0,0,0,0,"00",0,0,0,0,0,0,1037661,"2023-11-02T00:00:00.000Z",19,FALSE,9,227,"F",19,19,"New Orleans Pelicans","Brandon Ingram",0,0,0,0,0,0
0,0,0,0,0,0,0,0,0,"00",0,0,0,0,0,0,1037661,"2023-11-02T00:00:00.000Z",19,FALSE,9,38017663,"F",19,19,"New Orleans Pelicans","E.J. Liddell",0,0,0,0,0,0
1,0,0,0,0,2,0,2,2,"13",0,1,2,0,0,0,1037661,"2023-11-02T00:00:00.000Z",19,FALSE,9,38017726,"G",19,19,"New Orleans Pelicans","Dereon Seabron",0,2,3,3,1,3.5
0,0,0,0,0,0,0,0,0,"00",0,0,0,0,0,0,1037661,"2023-11-02T00:00:00.000Z",19,FALSE,9,666969,"F",19,19,"New Orleans Pelicans","Zion Williamson",0,0,0,0,0,0
0,0,0,0,0,0,0,0,0,"00",0,0,0,0,0,0,1037661,"2023-11-02T00:00:00.000Z",19,FALSE,9,491,"C",19,19,"New Orleans Pelicans","Cody Zeller",0,0,0,0,0,0
0,0,0,0,0,0,0,0,0,"00",0,0,0,0,0,0,1037661,"2023-11-02T00:00:00.000Z",19,FALSE,9,3547240,"C",9,9,"Detroit Pistons","James Wiseman",0,0,0,0,0,0
3,4,5,1,0,7,6,9,9,"34",0,4,21,5,3,0,1037661,"2023-11-02T00:00:00.000Z",19,FALSE,9,17896024,"F",19,19,"New Orleans Pelicans","Herbert Jones",7,26,29,24,8,52.5
2,0,2,8,6,10,7,0,0,"35",0,0,20,2,0,3,1037661,"2023-11-02T00:00:00.000Z",19,FALSE,9,17896017,"F",19,19,"New Orleans Pelicans","Matt Ryan",0,22,24,22,4,22.4
5,3,9,3,2,16,9,4,3,"33",4,5,23,13,0,2,1037661,"2023-11-02T00:00:00.000Z",19,FALSE,9,455,"C",19,19,"New Orleans Pelicans","Jonas Valanciunas",3,36,41,28,18,53.1
0,0,1,5,1,7,1,3,3,"29",0,0,6,1,0,1,1037661,"2023-11-02T00:00:00.000Z",19,FALSE,9,56677837,"G",19,19,"New Orleans Pelicans","Jordan Hawkins",0,7,7,6,1,6.2
5,0,3,10,3,23,10,11,10,"35",1,3,33,4,0,4,1037661,"2023-11-02T00:00:00.000Z",19,FALSE,9,303,"G",19,19,"New Orleans Pelicans","CJ McCollum",0,37,42,38,9,41.3
6,0,6,2,2,4,3,2,2,"25",1,2,10,7,1,1,1037661,"2023-11-02T00:00:00.000Z",19,FALSE,9,38017677,"G",19,19,"New Orleans Pelicans","Dyson Daniels",1,17,23,16,13,29.4
4,0,3,1,0,5,1,4,4,"20",0,1,6,3,1,1,1037661,"2023-11-02T00:00:00.000Z",19,FALSE,9,3547260,"G",19,19,"New Orleans Pelicans","Kira Lewis Jr.",1,9,13,10,7,17.6
1,0,0,2,0,6,2,0,0,"16",1,2,4,1,0,0,1037661,"2023-11-02T00:00:00.000Z",19,FALSE,9,340,"F",19,19,"New Orleans Pelicans","Larry Nance Jr.",0,5,6,5,2,6.7
9,0,2,4,2,8,4,0,0,"39",3,4,10,5,1,0,1037661,"2023-11-02T00:00:00.000Z",19,FALSE,9,3547241,"G",9,9,"Detroit Pistons","Killian Hayes",1,15,24,19,14,32.5
11,0,2,7,2,22,8,5,4,"34",0,4,22,2,1,6,1037661,"2023-11-02T00:00:00.000Z",19,FALSE,9,17896075,"G-F",9,9,"Detroit Pistons","Cade Cunningham",1,24,35,33,13,37.9
0,1,5,0,0,7,3,0,0,"13",4,0,6,9,0,1,1037661,"2023-11-02T00:00:00.000Z",19,FALSE,9,24,"F",9,9,"Detroit Pistons","Marvin Bagley III",1,15,15,6,9,18.8
0,0,0,0,0,0,0,0,0,"00",0,0,0,0,0,0,1037661,"2023-11-02T00:00:00.000Z",19,FALSE,9,56677729,"G",9,9,"Detroit Pistons","Malcolm Cazalon",0,0,0,0,0,0
1,0,2,6,2,8,3,0,0,"24",1,4,8,3,1,1,1037661,"2023-11-02T00:00:00.000Z",19,FALSE,9,197,"F-G",9,9,"Detroit Pistons","Joe Harris",1,11,12,9,4,15.1
0,1,4,3,1,6,4,4,3,"21",3,4,12,7,0,2,1037661,"2023-11-02T00:00:00.000Z",19,FALSE,9,38017682,"G",9,9,"Detroit Pistons","Jaden Ivey",1,19,19,12,7,21.4
0,0,0,0,0,0,0,0,0,"00",0,0,0,0,0,0,1037661,"2023-11-02T00:00:00.000Z",19,FALSE,9,42097199,"G",9,9,"Detroit Pistons","Jared Rhoden",0,0,0,0,0,0
3,0,1,8,5,10,6,2,2,"23",1,2,19,2,1,0,1037661,"2023-11-02T00:00:00.000Z",19,FALSE,9,56677792,"G",9,9,"Detroit Pistons","Marcus Sasser",1,21,24,22,5,28.9
0,0,0,1,0,1,0,0,0,"01",0,0,0,0,0,0,1037661,"2023-11-02T00:00:00.000Z",19,FALSE,9,44477024,"G",9,9,"Detroit Pistons","Stanley Umude",0,0,0,0,0,0
0,0,0,0,0,0,0,0,0,"00",0,0,0,0,0,0,1037661,"2023-11-02T00:00:00.000Z",19,FALSE,9,330,"G",9,9,"Detroit Pistons","Monte Morris",0,0,0,0,0,0
0,0,0,0,0,0,0,0,0,"00",0,0,0,0,0,0,1037661,"2023-11-02T00:00:00.000Z",19,FALSE,9,54,"F",9,9,"Detroit Pistons","Bojan Bogdanovic",0,0,0,0,0,0
0,0,0,0,0,0,0,0,0,"00",0,0,0,0,0,0,1037661,"2023-11-02T00:00:00.000Z",19,FALSE,9,77,"G",9,9,"Detroit Pistons","Alec Burks",0,0,0,0,0,0
0,0,0,0,0,0,0,0,0,"00",0,0,0,0,0,0,1037661,"2023-11-02T00:00:00.000Z",19,FALSE,9,17896071,"F",9,9,"Detroit Pistons","Isaiah Livers",0,0,0,0,0,0
0,2,6,3,1,7,3,6,4,"35",2,3,11,8,0,2,1037661,"2023-11-02T00:00:00.000Z",19,FALSE,9,3547267,"F-C",9,9,"Detroit Pistons","Isaiah Stewart",2,19,19,11,8,24.6
1,0,5,0,0,8,5,2,2,"25",0,5,12,5,0,1,1037661,"2023-11-02T00:00:00.000Z",19,FALSE,9,38017694,"C",9,9,"Detroit Pistons","Jalen Duren",0,17,18,13,6,18.5
0,0,0,0,0,0,0,0,0,"00",0,0,0,0,0,0,1037661,"2023-11-02T00:00:00.000Z",19,FALSE,9,3547293,"F",19,19,"New Orleans Pelicans","Naji Marshall",0,0,0,0,0,0
0,0,0,0,0,0,0,0,0,"00",0,0,0,0,0,0,1037661,"2023-11-02T00:00:00.000Z",19,FALSE,9,18677986,"F",19,19,"New Orleans Pelicans","Trey Murphy III",0,0,0,0,0,0
5,1,2,6,0,17,5,7,6,"25",5,5,16,7,0,3,1037661,"2023-11-02T00:00:00.000Z",19,FALSE,9,56677826,"G-F",9,9,"Detroit Pistons","Ausar Thompson",1,23,28,21,12,31.9
5,0,3,5,2,21,9,2,1,"38",1,4,21,4,4,2,1037662,"2023-11-02T00:00:00.000Z",29,FALSE,22,17896026,"F",22,22,"Orlando Magic","Franz Wagner",4,25,30,26,9,43.3
5,2,7,2,1,13,9,15,11,"36",2,4,30,9,3,6,1037662,"2023-11-02T00:00:00.000Z",29,FALSE,22,38017683,"F",22,22,"Orlando Magic","Paolo Banchero",5,39,44,35,14,57.3
2,1,8,6,3,12,5,2,1,"29",2,4,14,10,0,2,1037662,"2023-11-02T00:00:00.000Z",29,FALSE,22,85,"F",22,22,"Orlando Magic","Wendell Carter Jr.",1,24,26,16,12,30
1,1,0,2,0,2,0,0,0,"14",0,1,0,0,0,0,1037662,"2023-11-02T00:00:00.000Z",29,FALSE,22,196,"G",22,22,"Orlando Magic","Gary Harris",1,0,1,1,1,4.5
3,0,2,0,0,7,1,4,4,"21",2,4,6,4,4,3,1037662,"2023-11-02T00:00:00.000Z",29,FALSE,22,17896073,"G",22,22,"Orlando Magic","Jalen Suggs",4,10,13,9,7,24.3
1,0,1,4,1,5,1,2,1,"24",1,0,4,2,0,0,1037662,"2023-11-02T00:00:00.000Z",29,FALSE,22,226,"F",22,22,"Orlando Magic","Joe Ingles",0,6,7,5,3,7.9
1,0,6,10,4,17,9,2,0,"33",1,4,22,7,2,3,1037662,"2023-11-02T00:00:00.000Z",29,FALSE,22,297,"F",29,29,"Utah Jazz","Lauri Markkanen",2,29,30,23,8,34.9
0,1,7,4,3,10,7,4,3,"33",3,5,20,10,0,2,1037662,"2023-11-02T00:00:00.000Z",29,FALSE,22,101,"F-C",29,29,"Utah Jazz","John Collins",1,30,30,20,10,33
1,5,7,0,0,6,2,0,0,"25",3,2,4,10,0,1,1037662,"2023-11-02T00:00:00.000Z",29,FALSE,22,38017705,"C",29,29,"Utah Jazz","Walker Kessler",5,14,15,5,11,31.5
6,0,3,8,2,20,5,9,9,"37",3,1,21,6,1,6,1037662,"2023-11-02T00:00:00.000Z",29,FALSE,22,100,"G",29,29,"Utah Jazz","Jordan Clarkson",1,27,33,27,12,34.2
8,1,3,4,1,14,7,0,0,"31",0,4,15,3,3,2,1037662,"2023-11-02T00:00:00.000Z",29,FALSE,22,666650,"G",29,29,"Utah Jazz","Talen Horton-Tucker",4,18,26,23,11,40.6
3,0,2,1,1,2,1,5,3,"17",0,1,6,2,0,2,1037662,"2023-11-02T00:00:00.000Z",29,FALSE,22,56677834,"G",29,29,"Utah Jazz","Keyonte George",0,8,11,9,5,10.9
3,0,1,1,0,4,2,0,0,"19",1,5,4,2,3,2,1037662,"2023-11-02T00:00:00.000Z",29,FALSE,22,358,"F",29,29,"Utah Jazz","Kelly Olynyk",3,6,9,7,5,17.9
1,0,0,2,0,8,3,6,4,"17",1,1,10,1,0,2,1037662,"2023-11-02T00:00:00.000Z",29,FALSE,22,413,"G",29,29,"Utah Jazz","Collin Sexton",0,11,12,11,2,10.7
0,0,0,0,0,0,0,0,0,"00",0,0,0,0,0,0,1037662,"2023-11-02T00:00:00.000Z",29,FALSE,22,38017630,"G",29,29,"Utah Jazz","Johnny Juzang",0,0,0,0,0,0
0,0,0,0,0,0,0,0,0,"00",0,0,0,0,0,0,1037662,"2023-11-02T00:00:00.000Z",29,FALSE,22,19465584,"F",29,29,"Utah Jazz","Micah Potter",0,0,0,0,0,0
1,0,0,1,0,2,1,0,0,"08",0,2,2,0,0,0,1037662,"2023-11-02T00:00:00.000Z",29,FALSE,22,38017620,"G",29,29,"Utah Jazz","Ochai Agbaji",0,2,3,3,1,3.5
3,0,2,0,0,2,1,0,0,"05",0,0,2,2,0,0,1037662,"2023-11-02T00:00:00.000Z",29,FALSE,22,139,"G",29,29,"Utah Jazz","Kris Dunn",0,4,7,5,5,8.9
0,0,2,1,0,1,0,0,0,"07",0,0,0,2,0,0,1037662,"2023-11-02T00:00:00.000Z",29,FALSE,22,38017739,"F",29,29,"Utah Jazz","Simone Fontecchio",0,2,2,0,2,2.4
0,0,0,0,0,0,0,0,0,"00",0,0,0,0,0,0,1037662,"2023-11-02T00:00:00.000Z",29,FALSE,22,56677824,"F",29,29,"Utah Jazz","Taylor Hendricks",0,0,0,0,0,0
0,0,0,0,0,0,0,0,0,"00",0,0,0,0,0,0,1037662,"2023-11-02T00:00:00.000Z",29,FALSE,22,666881,"F",29,29,"Utah Jazz","Luka Samanic",0,0,0,0,0,0
0,0,0,0,0,0,0,0,0,"00",0,0,0,0,0,0,1037662,"2023-11-02T00:00:00.000Z",29,FALSE,22,56677842,"F",29,29,"Utah Jazz","Brice Sensabaugh",0,0,0,0,0,0
0,0,2,1,1,3,3,0,0,"08",1,2,7,3,0,0,1037662,"2023-11-02T00:00:00.000Z",29,FALSE,22,11891374,"C",29,29,"Utah Jazz","Omer Yurtseven",0,10,10,7,3,10.6
0,0,0,0,0,0,0,0,0,"00",0,0,0,0,0,0,1037662,"2023-11-02T00:00:00.000Z",29,FALSE,22,17896023,"G",29,29,"Utah Jazz","Josh Christopher",0,0,0,0,0,0
1,2,1,2,1,6,4,1,1,"19",0,2,10,1,0,0,1037662,"2023-11-02T00:00:00.000Z",29,FALSE,22,462,"C",22,22,"Orlando Magic","Moritz Wagner",2,11,12,11,2,18.7
7,0,7,4,2,10,5,6,6,"31",0,3,18,7,2,3,1037662,"2023-11-02T00:00:00.000Z",29,FALSE,22,3547251,"G",22,22,"Orlando Magic","Cole Anthony",2,25,32,25,14,39.9
0,0,0,0,0,0,0,0,0,"00",0,0,0,0,0,0,1037662,"2023-11-02T00:00:00.000Z",29,FALSE,22,666442,"C",22,22,"Orlando Magic","Goga Bitadze",0,0,0,0,0,0
1,0,2,0,0,4,4,3,1,"16",1,2,9,3,2,1,1037662,"2023-11-02T00:00:00.000Z",29,FALSE,22,56677827,"G",22,22,"Orlando Magic","Anthony Black",2,12,13,10,4,19.1
0,0,0,0,0,0,0,0,0,"00",0,0,0,0,0,0,1037662,"2023-11-02T00:00:00.000Z",29,FALSE,22,165,"G",22,22,"Orlando Magic","Markelle Fultz",0,0,0,0,0,0
0,0,0,0,0,0,0,0,0,"00",0,0,0,0,0,0,1037662,"2023-11-02T00:00:00.000Z",29,FALSE,22,38017724,"G",22,22,"Orlando Magic","Caleb Houstan",0,0,0,0,0,0
0,0,0,0,0,0,0,0,0,"00",0,0,0,0,0,0,1037662,"2023-11-02T00:00:00.000Z",29,FALSE,22,56677839,"G",22,22,"Orlando Magic","Jett Howard",0,0,0,0,0,0
1,3,2,3,0,4,1,1,1,"12",1,1,3,3,1,0,1037662,"2023-11-02T00:00:00.000Z",29,FALSE,22,229,"F",22,22,"Orlando Magic","Jonathan Isaac",4,6,7,4,4,20.1
0,0,0,0,0,0,0,0,0,"00",0,0,0,0,0,0,1037662,"2023-11-02T00:00:00.000Z",29,FALSE,22,666818,"F",22,22,"Orlando Magic","Chuma Okeke",0,0,0,0,0,0
0,0,0,0,0,0,0,0,0,"00",0,0,0,0,0,0,1037662,"2023-11-02T00:00:00.000Z",29,FALSE,22,38017607,"G",22,22,"Orlando Magic","Kevon Harris",0,0,0,0,0,0
0,0,0,0,0,0,0,0,0,"00",0,0,0,0,0,0,1037662,"2023-11-02T00:00:00.000Z",29,FALSE,22,17553983,"G",22,22,"Orlando Magic","Trevelin Queen",0,0,0,0,0,0
0,0,0,0,0,0,0,0,0,"00",0,0,0,0,0,0,1037662,"2023-11-02T00:00:00.000Z",29,FALSE,22,666885,"F",22,22,"Orlando Magic","Admiral Schofield",0,0,0,0,0,0
0,0,0,0,0,0,0,0,0,"00",0,0,0,0,0,0,1037663,"2023-11-02T00:00:00.000Z",24,FALSE,27,38017649,"F",27,27,"San Antonio Spurs","Julian Champagnie",0,0,0,0,0,0
0,0,0,0,0,0,0,0,0,"00",0,0,0,0,0,0,1037663,"2023-11-02T00:00:00.000Z",24,FALSE,27,180,"G",27,27,"San Antonio Spurs","Devonte' Graham",0,0,0,0,0,0
10,0,4,4,2,8,3,4,4,"28",1,3,12,5,1,1,1037663,"2023-11-02T00:00:00.000Z",24,FALSE,27,3547274,"G",27,27,"San Antonio Spurs","Tre Jones",1,17,27,22,15,35
0,0,0,0,0,0,0,0,0,"00",0,0,0,0,0,0,1037663,"2023-11-02T00:00:00.000Z",24,FALSE,27,17896059,"F",27,27,"San Antonio Spurs","Sandro Mamukelashvili",0,0,0,0,0,0
0,0,0,3,2,4,2,0,0,"16",0,0,6,0,1,0,1037663,"2023-11-02T00:00:00.000Z",24,FALSE,27,305,"F",27,27,"San Antonio Spurs","Doug McDermott",1,6,6,6,0,9
1,0,2,6,3,8,5,0,0,"23",0,1,13,2,1,0,1037663,"2023-11-02T00:00:00.000Z",24,FALSE,27,359,"F",27,27,"San Antonio Spurs","Cedi Osman",1,15,16,14,3,19.9
0,0,0,0,0,0,0,0,0,"00",0,0,0,0,0,0,1037663,"2023-11-02T00:00:00.000Z",24,FALSE,27,38017693,"G",27,27,"San Antonio Spurs","Blake Wesley",0,0,0,0,0,0
0,0,0,0,0,0,0,0,0,"00",0,0,0,0,0,0,1037663,"2023-11-02T00:00:00.000Z",24,FALSE,27,56677865,"C",27,27,"San Antonio Spurs","Charles Bediako",0,0,0,0,0,0
0,0,0,0,0,0,0,0,0,"00",0,0,0,0,0,0,1037663,"2023-11-02T00:00:00.000Z",24,FALSE,27,56677817,"G",27,27,"San Antonio Spurs","Sidy Cissoko",0,0,0,0,0,0
0,0,1,1,0,2,0,0,0,"12",0,0,0,1,2,0,1037663,"2023-11-02T00:00:00.000Z",24,FALSE,27,356,"G",24,24,"Phoenix Suns","Josh Okogie",2,1,1,0,1,7.2
1,2,6,5,3,15,10,9,5,"37",0,3,28,6,0,3,1037663,"2023-11-02T00:00:00.000Z",24,FALSE,27,140,"F",24,24,"Phoenix Suns","Kevin Durant",2,34,35,29,7,39.7
2,0,2,3,1,5,2,2,2,"19",1,3,7,3,1,2,1037663,"2023-11-02T00:00:00.000Z",24,FALSE,27,349,"C",24,24,"Phoenix Suns","Jusuf Nurkic",1,10,12,9,5,14.6
4,0,1,5,4,10,6,0,0,"33",1,1,16,2,0,2,1037663,"2023-11-02T00:00:00.000Z",24,FALSE,27,8,"G",24,24,"Phoenix Suns","Grayson Allen",0,18,22,20,6,22.4
13,0,8,7,5,19,10,6,6,"35",1,4,31,9,0,5,1037663,"2023-11-02T00:00:00.000Z",24,FALSE,27,57,"G",24,24,"Phoenix Suns","Devin Booker",0,40,53,44,22,56.3
0,0,0,0,0,0,0,0,0,"00",0,0,0,0,0,0,1037663,"2023-11-02T00:00:00.000Z",24,FALSE,27,3547095,"C-F",24,24,"Phoenix Suns","Udoka Azubuike",0,0,0,0,0,0
0,0,2,3,1,7,5,4,2,"18",0,1,13,2,0,0,1037663,"2023-11-02T00:00:00.000Z",24,FALSE,27,32,"F",24,24,"Phoenix Suns","Keita Bates-Diop",0,15,15,13,2,15.4
0,0,0,0,0,0,0,0,0,"00",0,0,0,0,0,0,1037663,"2023-11-02T00:00:00.000Z",24,FALSE,27,666451,"C",24,24,"Phoenix Suns","Bol Bol",0,0,0,0,0,0
1,1,4,0,0,9,5,3,3,"27",1,1,13,5,0,1,1037663,"2023-11-02T00:00:00.000Z",24,FALSE,27,147,"F",24,24,"Phoenix Suns","Drew Eubanks",1,18,19,14,6,22.5
3,0,0,2,1,3,1,0,0,"09",1,0,3,1,1,1,1037663,"2023-11-02T00:00:00.000Z",24,FALSE,27,18678058,"",24,24,"Phoenix Suns","Jordan Goodwin",1,4,7,6,4,10.7
1,1,1,2,1,5,3,0,0,"24",0,1,7,1,1,0,1037663,"2023-11-02T00:00:00.000Z",24,FALSE,27,178,"G",24,24,"Phoenix Suns","Eric Gordon",2,8,9,8,2,15.7
0,0,0,0,0,0,0,0,0,"00",0,0,0,0,0,0,1037663,"2023-11-02T00:00:00.000Z",24,FALSE,27,3547298,"G",24,24,"Phoenix Suns","Saben Lee",0,0,0,0,0,0
0,0,0,0,0,0,0,0,0,"00",0,0,0,0,0,0,1037663,"2023-11-02T00:00:00.000Z",24,FALSE,27,666729,"F",24,24,"Phoenix Suns","Nassir Little",0,0,0,0,0,0
0,0,0,0,0,0,0,0,0,"00",0,0,0,0,0,0,1037663,"2023-11-02T00:00:00.000Z",24,FALSE,27,314,"F",24,24,"Phoenix Suns","Chimezie Metu",0,0,0,0,0,0
1,0,4,4,0,5,1,2,1,"26",0,1,3,4,0,0,1037663,"2023-11-02T00:00:00.000Z",24,FALSE,27,470,"G",24,24,"Phoenix Suns","Yuta Watanabe",0,7,8,4,5,9.3
0,0,0,0,0,0,0,0,0,"00",0,0,0,0,0,0,1037663,"2023-11-02T00:00:00.000Z",24,FALSE,27,37,"G",24,24,"Phoenix Suns","Bradley Beal",0,0,0,0,0,0
0,0,0,0,0,0,0,0,0,"00",0,0,0,0,0,0,1037663,"2023-11-02T00:00:00.000Z",24,FALSE,27,272,"G",24,24,"Phoenix Suns","Damion Lee",0,0,0,0,0,0
6,1,6,6,1,11,3,0,0,"35",1,5,7,7,2,0,1037663,"2023-11-02T00:00:00.000Z",24,FALSE,27,666682,"F",27,27,"San Antonio Spurs","Keldon Johnson",3,14,20,13,13,33.4
2,2,8,6,3,26,15,6,5,"34",2,3,38,10,1,2,1037663,"2023-11-02T00:00:00.000Z",24,FALSE,27,56677822,"F-C",27,27,"San Antonio Spurs","Victor Wembanyama",3,48,50,40,12,60
4,0,4,3,3,10,7,2,2,"35",4,2,19,8,0,3,1037663,"2023-11-02T00:00:00.000Z",24,FALSE,27,102,"F-C",27,27,"San Antonio Spurs","Zach Collins",0,27,31,23,12,31.6
1,0,2,3,3,10,7,0,0,"17",0,2,17,2,0,0,1037663,"2023-11-02T00:00:00.000Z",24,FALSE,27,3547246,"G-F",27,27,"San Antonio Spurs","Devin Vassell",0,19,20,18,3,20.9
9,1,4,0,0,13,7,0,0,"26",1,4,14,5,0,1,1037663,"2023-11-02T00:00:00.000Z",24,FALSE,27,38017699,"F",27,27,"San Antonio Spurs","Jeremy Sochan",1,19,28,23,14,35.5
0,0,0,0,0,0,0,0,0,"00",0,0,0,0,0,0,1037663,"2023-11-02T00:00:00.000Z",24,FALSE,27,38017730,"F",27,27,"San Antonio Spurs","Dominick Barlow",0,0,0,0,0,0
1,0,1,0,0,1,1,1,1,"06",0,0,3,1,1,1,1037663,"2023-11-02T00:00:00.000Z",24,FALSE,27,17895854,"G",27,27,"San Antonio Spurs","Charles Bassey",1,4,5,4,2,7.7
3,1,1,6,1,7,1,0,0,"20",0,1,3,1,0,0,1037663,"2023-11-02T00:00:00.000Z",24,FALSE,27,38017692,"F",27,27,"San Antonio Spurs","Malaki Branham",1,4,7,6,4,11.7
0,0,0,0,0,0,0,0,0,"00",0,0,0,0,0,0,1037663,"2023-11-02T00:00:00.000Z",24,FALSE,27,56677870,"G",27,27,"San Antonio Spurs","Sir'Jabari Rice",0,0,0,0,0,0
5,0,2,2,1,7,2,3,0,"24",1,1,5,3,1,1,3277349,"2023-11-03T00:00:00.000Z",12,FALSE,6,38017686,"G-F",12,12,"Indiana Pacers","Bennedict Mathurin",1,8,13,10,8,18.1
1,0,3,1,0,6,3,0,0,"21",1,2,6,4,0,0,3277349,"2023-11-03T00:00:00.000Z",12,FALSE,6,3547243,"F",12,12,"Indiana Pacers","Obi Toppin",0,10,11,7,5,12.3
0,2,8,5,4,14,9,6,5,"31",1,4,27,9,2,3,3277349,"2023-11-03T00:00:00.000Z",12,FALSE,6,452,"C-F",12,12,"Indiana Pacers","Myles Turner",4,36,36,27,9,46.8
2,0,6,6,3,15,8,0,0,"37",1,2,19,7,0,2,3277349,"2023-11-03T00:00:00.000Z",12,FALSE,6,69,"G",12,12,"Indiana Pacers","Bruce Brown",0,26,28,21,9,28.4
13,0,2,5,0,14,5,9,8,"34",0,2,18,2,2,4,3277349,"2023-11-03T00:00:00.000Z",12,FALSE,6,3547245,"G",12,12,"Indiana Pacers","Tyrese Haliburton",2,20,33,31,15,41.9
2,1,5,7,4,9,5,0,0,"30",0,2,14,5,0,1,3277349,"2023-11-03T00:00:00.000Z",12,FALSE,6,210,"G",12,12,"Indiana Pacers","Buddy Hield",1,19,21,16,7,25
0,0,0,0,0,0,0,0,0,"00",0,0,0,0,0,0,3277349,"2023-11-03T00:00:00.000Z",12,FALSE,6,17896035,"F",12,12,"Indiana Pacers","Isaiah Jackson",0,0,0,0,0,0
0,0,0,0,0,0,0,0,0,"00",0,0,0,0,0,0,3277349,"2023-11-03T00:00:00.000Z",12,FALSE,6,304,"G",12,12,"Indiana Pacers","T.J. McConnell",0,0,0,0,0,0
3,0,0,0,0,5,2,2,2,"18",0,0,6,0,0,2,3277349,"2023-11-03T00:00:00.000Z",12,FALSE,6,38017507,"G-F",12,12,"Indiana Pacers","Andrew Nembhard",0,6,9,9,3,8.5
0,1,4,4,2,8,5,4,1,"28",1,3,13,5,2,2,3277349,"2023-11-03T00:00:00.000Z",12,FALSE,6,3547250,"G-F",12,12,"Indiana Pacers","Aaron Nesmith",3,18,18,13,5,26
0,0,0,0,0,0,0,0,0,"00",0,0,0,0,0,0,3277349,"2023-11-03T00:00:00.000Z",12,FALSE,6,3547207,"F",12,12,"Indiana Pacers","Jordan Nwora",0,0,0,0,0,0
0,0,0,0,0,0,0,0,0,"00",0,0,0,0,0,0,3277349,"2023-11-03T00:00:00.000Z",12,FALSE,6,56677861,"G",12,12,"Indiana Pacers","Ben Sheppard",0,0,0,0,0,0
2,1,3,1,1,8,6,0,0,"17",2,2,13,5,0,3,3277349,"2023-11-03T00:00:00.000Z",12,FALSE,6,3547264,"F-C",12,12,"Indiana Pacers","Jalen Smith",1,18,20,15,7,22
0,0,0,0,0,0,0,0,0,"00",0,0,0,0,0,0,3277349,"2023-11-03T00:00:00.000Z",12,FALSE,6,439,"F",13,12,"Indiana Pacers","Daniel Theis",0,0,0,0,0,0
0,0,0,0,0,0,0,0,0,"00",0,0,0,0,0,0,3277349,"2023-11-03T00:00:00.000Z",12,FALSE,6,56677832,"F",12,12,"Indiana Pacers","Jarace Walker",0,0,0,0,0,0
0,0,0,0,0,0,0,0,0,"00",0,0,0,0,0,0,3277349,"2023-11-03T00:00:00.000Z",12,FALSE,6,38017701,"G",12,12,"Indiana Pacers","Kendall Brown",0,0,0,0,0,0
0,0,0,0,0,0,0,0,0,"00",0,0,0,0,0,0,3277349,"2023-11-03T00:00:00.000Z",12,FALSE,6,56677778,"F-C",12,12,"Indiana Pacers","Oscar Tshiebwe",0,0,0,0,0,0
0,0,0,0,0,0,0,0,0,"00",0,0,0,0,0,0,3277349,"2023-11-03T00:00:00.000Z",12,FALSE,6,56677794,"G",12,12,"Indiana Pacers","Isaiah Wong",0,0,0,0,0,0
0,1,1,6,1,9,4,2,1,"28",0,2,10,1,1,1,3277349,"2023-11-03T00:00:00.000Z",12,FALSE,6,666908,"G",6,6,"Cleveland Cavaliers","Max Strus",2,11,11,10,1,16.2
5,4,8,2,0,13,7,0,0,"36",2,2,14,10,3,2,3277349,"2023-11-03T00:00:00.000Z",12,FALSE,6,17896076,"F-C",6,6,"Cleveland Cavaliers","Evan Mobley",7,24,29,19,15,52.5
0,2,5,0,0,6,4,3,2,"21",2,4,10,7,1,1,3277349,"2023-11-03T00:00:00.000Z",12,FALSE,6,9,"C",6,6,"Cleveland Cavaliers","Jarrett Allen",3,17,17,10,7,26.4
9,0,4,7,4,21,13,10,8,"37",1,1,38,5,1,3,3277349,"2023-11-03T00:00:00.000Z",12,FALSE,6,322,"G",6,6,"Cleveland Cavaliers","Donovan Mitchell",1,43,52,47,14,57.5
6,1,0,2,0,11,5,4,4,"32",0,1,14,0,2,4,3277349,"2023-11-03T00:00:00.000Z",12,FALSE,6,666581,"G",6,6,"Cleveland Cavaliers","Darius Garland",3,14,20,20,6,28
0,0,0,0,0,0,0,0,0,"00",0,0,0,0,0,0,3277349,"2023-11-03T00:00:00.000Z",12,FALSE,6,248,"C",6,6,"Cleveland Cavaliers","Damian Jones",0,0,0,0,0,0
0,0,0,0,0,0,0,0,0,"00",0,0,0,0,0,0,3277349,"2023-11-03T00:00:00.000Z",12,FALSE,6,3547299,"G",6,6,"Cleveland Cavaliers","Sam Merrill",0,0,0,0,0,0
0,0,0,0,0,0,0,0,0,"00",0,0,0,0,0,0,3277349,"2023-11-03T00:00:00.000Z",12,FALSE,6,56677872,"G",6,6,"Cleveland Cavaliers","Craig Porter",0,0,0,0,0,0
0,0,1,0,0,0,0,0,0,"03",0,1,0,1,0,0,3277349,"2023-11-03T00:00:00.000Z",12,FALSE,6,444,"C-F",6,6,"Cleveland Cavaliers","Tristan Thompson",0,1,1,0,1,1.2
0,0,0,0,0,0,0,0,0,"03",0,1,0,0,0,0,3277349,"2023-11-03T00:00:00.000Z",12,FALSE,6,666940,"F",6,6,"Cleveland Cavaliers","Dean Wade",0,0,0,0,0,0
0,0,0,0,0,0,0,0,0,"00",0,0,0,0,0,0,3277349,"2023-11-03T00:00:00.000Z",12,FALSE,6,56677847,"F",6,6,"Cleveland Cavaliers","Emoni Bates",0,0,0,0,0,0
0,0,0,0,0,0,0,0,0,"00",0,0,0,0,0,0,3277349,"2023-11-03T00:00:00.000Z",12,FALSE,6,666676,"G",6,6,"Cleveland Cavaliers","Ty Jerome",0,0,0,0,0,0
0,0,0,0,0,0,0,0,0,"00",0,0,0,0,0,0,3277349,"2023-11-03T00:00:00.000Z",12,FALSE,6,38017662,"F",6,6,"Cleveland Cavaliers","Isaiah Mobley",0,0,0,0,0,0
0,0,0,0,0,0,0,0,0,"00",0,0,0,0,0,0,3277349,"2023-11-03T00:00:00.000Z",12,FALSE,6,404,"G",6,6,"Cleveland Cavaliers","Ricky Rubio",0,0,0,0,0,0
1,0,5,6,2,9,4,2,2,"27",0,2,12,5,0,0,3277349,"2023-11-03T00:00:00.000Z",12,FALSE,6,344,"F",6,6,"Cleveland Cavaliers","Georges Niang",0,17,18,13,6,19.5
4,1,5,4,0,12,5,4,3,"30",0,2,13,5,0,1,3277349,"2023-11-03T00:00:00.000Z",12,FALSE,6,277,"G",6,6,"Cleveland Cavaliers","Caris LeVert",1,18,22,17,9,27
2,0,1,1,1,3,2,0,0,"23",0,4,5,1,2,1,3277349,"2023-11-03T00:00:00.000Z",12,FALSE,6,3547247,"F-G",6,6,"Cleveland Cavaliers","Isaac Okoro",2,6,8,7,3,14.2
4,0,6,3,2,10,5,0,0,"21",3,1,12,9,0,0,3277350,"2023-11-03T00:00:00.000Z",17,FALSE,20,315,"F",17,17,"Milwaukee Bucks","Khris Middleton",0,21,25,16,13,28.8
6,1,7,3,3,10,6,13,7,"36",1,3,22,8,0,7,3277350,"2023-11-03T00:00:00.000Z",17,FALSE,20,15,"F",17,17,"Milwaukee Bucks","Giannis Antetokounmpo",1,30,36,28,14,36.6
0,8,5,10,4,15,4,2,1,"35",0,2,13,5,1,1,3277350,"2023-11-03T00:00:00.000Z",17,FALSE,20,283,"C",17,17,"Milwaukee Bucks","Brook Lopez",9,18,18,13,5,45
3,0,3,1,0,2,0,0,0,"22",0,2,0,3,0,0,3277350,"2023-11-03T00:00:00.000Z",17,FALSE,20,38,"G",17,17,"Milwaukee Bucks","Malik Beasley",0,3,6,3,6,8.1
4,1,4,7,4,15,7,12,12,"36",0,0,30,4,1,4,3277350,"2023-11-03T00:00:00.000Z",17,FALSE,20,278,"G",17,17,"Milwaukee Bucks","Damian Lillard",2,34,38,34,8,42.8
0,0,0,0,0,0,0,0,0,"00",0,0,0,0,0,0,3277350,"2023-11-03T00:00:00.000Z",17,FALSE,20,2148,"",17,17,"Milwaukee Bucks","Thanasis Antetokounmpo",0,0,0,0,0,0
2,0,1,5,3,7,5,1,0,"13",1,2,13,2,0,0,3277350,"2023-11-03T00:00:00.000Z",17,FALSE,20,38017676,"F",17,17,"Milwaukee Bucks","MarJon Beauchamp",0,15,17,15,4,18.4
2,0,0,2,0,4,1,0,0,"24",2,2,2,2,1,1,3277350,"2023-11-03T00:00:00.000Z",17,FALSE,20,105,"G",17,17,"Milwaukee Bucks","Pat Connaughton",1,4,6,4,4,9.4
2,0,6,6,4,8,5,0,0,"24",0,1,14,6,1,0,3277350,"2023-11-03T00:00:00.000Z",17,FALSE,20,112,"F",17,17,"Milwaukee Bucks","Jae Crowder",1,20,22,16,8,27.2
0,0,0,0,0,0,0,0,0,"00",0,0,0,0,0,0,3277350,"2023-11-03T00:00:00.000Z",17,FALSE,20,38017733,"G",17,17,"Milwaukee Bucks","A.J. Green",0,0,0,0,0,0
0,0,0,0,0,0,0,0,0,"00",0,0,0,0,0,0,3277350,"2023-11-03T00:00:00.000Z",17,FALSE,20,56677852,"G",17,17,"Milwaukee Bucks","Andre Jackson Jr.",0,0,0,0,0,0
0,0,0,0,0,0,0,0,0,"00",0,0,0,0,0,0,3277350,"2023-11-03T00:00:00.000Z",17,FALSE,20,56677854,"F",17,17,"Milwaukee Bucks","Chris Livingston",0,0,0,0,0,0
0,0,0,0,0,0,0,0,0,"00",0,0,0,0,0,0,3277350,"2023-11-03T00:00:00.000Z",17,FALSE,20,284,"C",17,17,"Milwaukee Bucks","Robin Lopez",0,0,0,0,0,0
1,0,0,0,0,1,0,0,0,"12",0,2,0,0,0,1,3277350,"2023-11-03T00:00:00.000Z",17,FALSE,20,368,"G",17,17,"Milwaukee Bucks","Cameron Payne",0,0,1,1,1,0.5
0,0,2,2,0,10,2,0,0,"17",0,1,4,2,2,0,3277350,"2023-11-03T00:00:00.000Z",17,FALSE,20,377,"F",17,17,"Milwaukee Bucks","Bobby Portis",2,6,6,4,2,12.4
0,0,0,0,0,0,0,0,0,"00",0,0,0,0,0,0,3277350,"2023-11-03T00:00:00.000Z",17,FALSE,20,666453,"C",17,17,"Milwaukee Bucks","Marques Bolden",0,0,0,0,0,0
0,0,0,0,0,0,0,0,0,"00",0,0,0,0,0,0,3277350,"2023-11-03T00:00:00.000Z",17,FALSE,20,38017691,"G",17,17,"Milwaukee Bucks","TyTy Washington Jr.",0,0,0,0,0,0
0,0,0,0,0,0,0,0,0,"00",0,0,0,0,0,0,3277350,"2023-11-03T00:00:00.000Z",17,FALSE,20,666960,"G",17,17,"Milwaukee Bucks","Lindell Wigginton",0,0,0,0,0,0
5,1,8,4,0,9,2,2,2,"36",2,4,6,10,3,0,3277350,"2023-11-03T00:00:00.000Z",17,FALSE,20,202,"G",20,20,"New York Knicks","Josh Hart",4,16,21,11,15,37.5
5,0,8,9,1,20,5,9,5,"39",4,4,16,12,2,1,3277350,"2023-11-03T00:00:00.000Z",17,FALSE,20,387,"F",20,20,"New York Knicks","Julius Randle",2,28,33,21,17,42.9
0,0,0,0,0,0,0,0,0,"00",0,0,0,0,0,0,3277350,"2023-11-03T00:00:00.000Z",17,FALSE,20,19,"G",20,20,"New York Knicks","Ryan Arcidiacono",0,0,0,0,0,0
0,0,0,0,0,0,0,0,0,"00",0,0,0,0,0,0,3277350,"2023-11-03T00:00:00.000Z",17,FALSE,20,160,"G-F",20,20,"New York Knicks","Evan Fournier",0,0,0,0,0,0
0,0,0,0,0,0,0,0,0,"00",0,0,0,0,0,0,3277350,"2023-11-03T00:00:00.000Z",17,FALSE,20,17896063,"F",20,20,"New York Knicks","Jericho Sims",0,0,0,0,0,0
0,0,0,0,0,0,0,0,0,"00",0,0,0,0,0,0,3277350,"2023-11-03T00:00:00.000Z",17,FALSE,20,666971,"G-F",20,20,"New York Knicks","Dylan Windler",0,0,0,0,0,0
0,0,0,0,0,0,0,0,0,"00",0,0,0,0,0,0,3277350,"2023-11-03T00:00:00.000Z",17,FALSE,20,666423,"F-G",20,20,"New York Knicks","RJ Barrett",0,0,0,0,0,0
0,0,0,0,0,0,0,0,0,"00",0,0,0,0,0,0,3277350,"2023-11-03T00:00:00.000Z",17,FALSE,20,666474,"G",20,20,"New York Knicks","Charles Brown",0,0,0,0,0,0
0,0,0,0,0,0,0,0,0,"00",0,0,0,0,0,0,3277350,"2023-11-03T00:00:00.000Z",17,FALSE,20,56677795,"F",20,20,"New York Knicks","Jacob Toppin",0,0,0,0,0,0
0,0,0,0,0,0,0,0,0,"00",0,0,0,0,0,0,3277350,"2023-11-03T00:00:00.000Z",17,FALSE,20,17896089,"G",20,20,"New York Knicks","Duane Washington Jr.",0,0,0,0,0,0
0,0,0,0,0,0,0,0,0,"00",0,0,0,0,0,0,3277350,"2023-11-03T00:00:00.000Z",17,FALSE,20,666675,"F",20,20,"New York Knicks","DaQuan Jeffries",0,0,0,0,0,0
0,0,0,1,0,1,0,0,0,"02",0,0,0,0,0,0,3277350,"2023-11-03T00:00:00.000Z",17,FALSE,20,17896033,"G",20,20,"New York Knicks","Miles McBride",0,0,0,0,0,0
1,0,9,0,0,4,0,0,0,"29",6,4,0,15,0,0,3277350,"2023-11-03T00:00:00.000Z",17,FALSE,20,399,"C",20,20,"New York Knicks","Mitchell Robinson",0,15,16,1,16,19.5
2,0,4,10,5,11,6,0,0,"34",0,3,17,4,0,1,3277350,"2023-11-03T00:00:00.000Z",17,FALSE,20,17895858,"G",20,20,"New York Knicks","Quentin Grimes",0,21,23,19,6,23.8
4,0,3,8,2,30,17,11,9,"42",2,3,45,5,1,4,3277350,"2023-11-03T00:00:00.000Z",17,FALSE,20,73,"G",20,20,"New York Knicks","Jalen Brunson",1,50,54,49,9,56
1,0,3,3,1,10,5,3,3,"22",0,1,14,3,0,1,3277350,"2023-11-03T00:00:00.000Z",17,FALSE,20,3547269,"G",20,20,"New York Knicks","Immanuel Quickley",0,17,18,15,4,18.1
0,0,2,0,0,3,2,0,0,"18",1,3,4,3,0,2,3277350,"2023-11-03T00:00:00.000Z",17,FALSE,20,201,"F-C",20,20,"New York Knicks","Isaiah Hartenstein",0,7,7,4,3,5.6
0,0,3,4,1,8,1,0,0,"18",1,0,3,4,0,1,3277350,"2023-11-03T00:00:00.000Z",17,FALSE,20,131,"G",20,20,"New York Knicks","Donte DiVincenzo",0,7,7,3,4,6.8
2,0,7,2,1,11,7,6,5,"31",0,1,20,7,3,2,3277351,"2023-11-03T00:00:00.000Z",16,FALSE,30,79,"G-F",16,16,"Miami Heat","Jimmy Butler",3,27,29,22,9,38.4
0,0,0,3,2,4,3,0,0,"22",0,3,8,0,0,2,3277351,"2023-11-03T00:00:00.000Z",16,FALSE,30,3092,"",16,16,"Miami Heat","Haywood Highsmith",0,8,8,8,0,6
3,0,4,0,0,15,8,2,2,"30",0,3,18,4,0,4,3277351,"2023-11-03T00:00:00.000Z",16,FALSE,30,4,"C-F",16,16,"Miami Heat","Bam Adebayo",0,22,25,21,7,23.3
9,0,10,7,4,17,9,2,2,"37",0,3,24,10,2,3,3277351,"2023-11-03T00:00:00.000Z",16,FALSE,30,666633,"G",16,16,"Miami Heat","Tyler Herro",2,34,43,33,19,52.5
7,0,1,4,1,4,1,0,0,"26",2,1,3,3,2,2,3277351,"2023-11-03T00:00:00.000Z",16,FALSE,30,286,"G",16,16,"Miami Heat","Kyle Lowry",2,6,13,10,10,21.1
0,1,2,0,0,7,5,2,1,"18",2,4,11,4,0,2,3277351,"2023-11-03T00:00:00.000Z",16,FALSE,30,74,"C",16,16,"Miami Heat","Thomas Bryant",1,15,15,11,4,16.8
3,0,4,2,1,8,6,2,1,"24",0,1,14,4,0,2,3277351,"2023-11-03T00:00:00.000Z",16,FALSE,30,3547242,"F",30,30,"Washington Wizards","Deni Avdija",0,18,21,17,7,21.3
3,0,3,9,4,19,8,2,2,"31",1,3,22,4,0,5,3277351,"2023-11-03T00:00:00.000Z",16,FALSE,30,265,"F",30,30,"Washington Wizards","Kyle Kuzma",0,26,29,25,7,26.3
1,2,4,0,0,1,1,3,2,"20",1,5,4,5,0,2,3277351,"2023-11-03T00:00:00.000Z",16,FALSE,30,666577,"F",30,30,"Washington Wizards","Daniel Gafford",2,9,10,5,6,15.5
6,0,1,4,3,14,8,1,0,"29",0,3,19,1,4,2,3277351,"2023-11-03T00:00:00.000Z",16,FALSE,30,666848,"G",30,30,"Washington Wizards","Jordan Poole",4,20,26,25,7,39.2
5,0,2,2,1,5,3,0,0,"24",0,1,7,2,0,2,3277351,"2023-11-03T00:00:00.000Z",16,FALSE,30,249,"G",30,30,"Washington Wizards","Tyus Jones",0,9,14,12,7,14.9
0,0,0,0,0,0,0,0,0,"00",0,0,0,0,0,0,3277351,"2023-11-03T00:00:00.000Z",16,FALSE,30,38017704,"F",30,30,"Washington Wizards","Patrick Baldwin Jr.",0,0,0,0,0,0
3,0,3,2,1,5,4,2,0,"26",0,1,9,3,0,1,3277351,"2023-11-03T00:00:00.000Z",16,FALSE,30,56677844,"G",30,30,"Washington Wizards","Bilal Coulibaly",0,12,15,12,6,16.1
0,0,1,1,1,5,5,0,0,"13",0,0,11,1,1,0,3277351,"2023-11-03T00:00:00.000Z",16,FALSE,30,38017687,"G",30,30,"Washington Wizards","Johnny Davis",1,12,12,11,1,15.2
3,0,2,1,0,5,3,2,0,"09",1,0,6,3,0,1,3277351,"2023-11-03T00:00:00.000Z",16,FALSE,30,167,"F",30,30,"Washington Wizards","Danilo Gallinari",0,9,12,9,6,13.1
0,1,1,0,0,3,2,2,2,"07",1,1,6,2,0,1,3277351,"2023-11-03T00:00:00.000Z",16,FALSE,30,3547302,"F",30,30,"Washington Wizards","Anthony Gill",1,8,8,6,2,10.4
2,0,0,0,0,2,2,0,0,"07",0,1,4,0,1,1,3277351,"2023-11-03T00:00:00.000Z",16,FALSE,30,17896106,"F",30,30,"Washington Wizards","Eugene Omoruyi",1,4,6,6,2,9
2,1,1,1,1,4,2,3,2,"07",0,1,7,1,0,0,3277351,"2023-11-03T00:00:00.000Z",16,FALSE,30,38017712,"G",30,30,"Washington Wizards","Ryan Rollins",1,8,10,9,3,14.2
2,0,1,2,0,2,0,0,0,"14",0,0,0,1,0,0,3277351,"2023-11-03T00:00:00.000Z",16,FALSE,30,414,"G",30,30,"Washington Wizards","Landry Shamet",0,1,3,2,3,4.2
2,0,2,0,0,3,0,0,0,"17",0,0,0,2,1,2,3277351,"2023-11-03T00:00:00.000Z",16,FALSE,30,487,"G",30,30,"Washington Wizards","Delon Wright",1,2,4,2,4,6.4
0,0,0,0,0,0,0,0,0,"00",0,0,0,0,0,0,3277351,"2023-11-03T00:00:00.000Z",16,FALSE,30,18677954,"G",30,30,"Washington Wizards","Jared Butler",0,0,0,0,0,0
0,0,0,0,0,0,0,0,0,"00",0,0,0,0,0,0,3277351,"2023-11-03T00:00:00.000Z",16,FALSE,30,38124126,"F",30,30,"Washington Wizards","John Butler Jr.",0,0,0,0,0,0
0,0,0,0,0,0,0,0,0,"00",0,0,0,0,0,0,3277351,"2023-11-03T00:00:00.000Z",16,FALSE,30,17896045,"F",30,30,"Washington Wizards","Corey Kispert",0,0,0,0,0,0
3,0,2,1,0,5,4,1,1,"22",3,1,9,5,1,0,3277351,"2023-11-03T00:00:00.000Z",16,FALSE,30,56677785,"G",16,16,"Miami Heat","Jaime Jaquez Jr.",1,14,17,12,8,22.5
0,0,0,0,0,0,0,0,0,"00",0,0,0,0,0,0,3277351,"2023-11-03T00:00:00.000Z",16,FALSE,30,38017696,"F",16,16,"Miami Heat","Nikola Jovic",0,0,0,0,0,0
0,0,0,0,0,0,0,0,0,"00",0,0,0,0,0,0,3277351,"2023-11-03T00:00:00.000Z",16,FALSE,30,285,"F-C",16,16,"Miami Heat","Kevin Love",0,0,0,0,0,0
5,0,3,2,1,6,4,1,1,"25",0,2,10,3,0,2,3277351,"2023-11-03T00:00:00.000Z",16,FALSE,30,391,"G-F",16,16,"Miami Heat","Josh Richardson",0,13,18,15,8,19.1
6,0,1,8,4,11,7,0,0,"29",0,0,18,1,1,2,3277351,"2023-11-03T00:00:00.000Z",16,FALSE,30,397,"F",16,16,"Miami Heat","Duncan Robinson",1,19,25,24,7,29.2
0,0,0,0,0,0,0,0,0,"00",0,0,0,0,0,0,3277351,"2023-11-03T00:00:00.000Z",16,FALSE,30,39398582,"C",16,16,"Miami Heat","Orlando Robinson",0,0,0,0,0,0
0,0,0,0,0,0,0,0,0,"00",0,0,0,0,0,0,3277351,"2023-11-03T00:00:00.000Z",16,FALSE,30,19465585,"G",16,16,"Miami Heat","Dru Smith",0,0,0,0,0,0
0,0,0,0,0,0,0,0,0,"00",0,0,0,0,0,0,3277351,"2023-11-03T00:00:00.000Z",16,FALSE,30,38017734,"F",16,16,"Miami Heat","Jamal Cain",0,0,0,0,0,0
1,0,1,4,1,5,2,0,0,"12",0,1,5,1,0,1,3277351,"2023-11-03T00:00:00.000Z",16,FALSE,30,337,"F-C",30,30,"Washington Wizards","Mike Muscala",0,6,7,6,2,6.7
0,0,0,0,0,0,0,0,0,"00",0,0,0,0,0,0,3277351,"2023-11-03T00:00:00.000Z",16,FALSE,30,3547257,"G",16,16,"Miami Heat","R.J. Hampton",0,0,0,0,0,0
0,0,0,0,0,0,0,0,0,"00",0,0,0,0,0,0,3277351,"2023-11-03T00:00:00.000Z",16,FALSE,30,666747,"F",16,16,"Miami Heat","Caleb Martin",0,0,0,0,0,0
0,0,0,0,0,0,0,0,0,"00",0,0,0,0,0,0,3277351,"2023-11-03T00:00:00.000Z",16,FALSE,30,38017736,"F",16,16,"Miami Heat","Cole Swider",0,0,0,0,0,0
4,0,0,4,2,20,9,4,4,"34",1,0,24,1,0,0,3277352,"2023-11-03T00:00:00.000Z",5,FALSE,3,125,"G",5,5,"Chicago Bulls","DeMar DeRozan",0,25,29,28,5,31.2
3,0,7,1,1,13,6,0,0,"36",6,1,13,13,0,0,3277352,"2023-11-03T00:00:00.000Z",5,FALSE,3,460,"C",5,5,"Chicago Bulls","Nikola Vucevic",0,26,29,16,16,33.1
5,1,6,6,1,21,10,4,3,"39",1,2,24,7,1,2,3277352,"2023-11-03T00:00:00.000Z",5,FALSE,3,268,"G",5,5,"Chicago Bulls","Zach LaVine",2,31,36,29,12,43.9
2,1,2,8,2,17,7,2,2,"35",1,0,18,3,0,2,3277352,"2023-11-03T00:00:00.000Z",5,FALSE,3,666956,"G",5,5,"Chicago Bulls","Coby White",1,21,23,20,5,25.6
0,0,1,2,1,3,2,0,0,"14",0,2,5,1,1,2,3277352,"2023-11-03T00:00:00.000Z",5,FALSE,3,87,"G",5,5,"Chicago Bulls","Jevon Carter",1,6,6,5,1,7.2
4,0,6,2,1,4,1,0,0,"23",0,4,3,6,1,1,3277352,"2023-11-03T00:00:00.000Z",5,FALSE,3,110,"F",5,5,"Chicago Bulls","Torrey Craig",1,9,13,7,10,18.2
0,0,0,0,0,0,0,0,0,"00",0,0,0,0,0,0,3277352,"2023-11-03T00:00:00.000Z",5,FALSE,3,56677860,"F",5,5,"Chicago Bulls","Adama Sanogo",0,0,0,0,0,0
4,1,4,9,3,18,6,2,2,"31",1,1,17,5,0,0,3277352,"2023-11-03T00:00:00.000Z",5,FALSE,3,17896048,"G",3,3,"Brooklyn Nets","Cam Thomas",1,22,26,21,9,32
3,0,2,8,3,17,8,2,1,"33",0,0,20,2,0,0,3277352,"2023-11-03T00:00:00.000Z",5,FALSE,3,61,"F",3,3,"Brooklyn Nets","Mikal Bridges",0,22,25,23,5,26.9
0,1,1,9,5,14,8,0,0,"33",2,1,21,3,0,0,3277352,"2023-11-03T00:00:00.000Z",5,FALSE,3,158,"F",3,3,"Brooklyn Nets","Dorian Finney-Smith",1,24,24,21,3,27.6
9,0,3,4,2,7,4,0,0,"31",0,0,10,3,2,3,3277352,"2023-11-03T00:00:00.000Z",5,FALSE,3,130,"G",3,3,"Brooklyn Nets","Spencer Dinwiddie",2,13,22,19,12,30.1
6,0,6,0,0,8,4,0,0,"33",3,3,8,9,1,4,3277352,"2023-11-03T00:00:00.000Z",5,FALSE,3,417,"G-F",3,3,"Brooklyn Nets","Ben Simmons",1,17,23,14,15,26.8
8,1,5,9,3,10,3,0,0,"32",0,4,9,5,0,0,3277352,"2023-11-03T00:00:00.000Z",5,FALSE,3,351,"F",3,3,"Brooklyn Nets","Royce O'Neale",1,14,22,17,13,30
1,0,0,2,1,9,3,0,0,"16",1,0,7,1,1,1,3277352,"2023-11-03T00:00:00.000Z",5,FALSE,3,421,"G",3,3,"Brooklyn Nets","Dennis Smith Jr.",1,8,9,8,2,11.7
1,1,1,4,1,10,5,0,0,"16",0,2,11,1,0,0,3277352,"2023-11-03T00:00:00.000Z",5,FALSE,3,464,"G",3,3,"Brooklyn Nets","Lonnie Walker IV",1,12,13,12,2,16.7
0,0,0,0,0,0,0,0,0,"00",0,0,0,0,0,0,3277352,"2023-11-03T00:00:00.000Z",5,FALSE,3,17896041,"G",3,3,"Brooklyn Nets","Keon Johnson",0,0,0,0,0,0
0,0,0,0,0,0,0,0,0,"00",0,0,0,0,0,0,3277352,"2023-11-03T00:00:00.000Z",5,FALSE,3,56677841,"F",3,3,"Brooklyn Nets","Dariq Whitehead",0,0,0,0,0,0
0,0,0,0,0,0,0,0,0,"00",0,0,0,0,0,0,3277352,"2023-11-03T00:00:00.000Z",5,FALSE,3,56677843,"F",3,3,"Brooklyn Nets","Noah Clowney",0,0,0,0,0,0
0,0,0,0,0,0,0,0,0,"00",0,0,0,0,0,0,3277352,"2023-11-03T00:00:00.000Z",5,FALSE,3,666679,"F",3,3,"Brooklyn Nets","Cameron Johnson",0,0,0,0,0,0
0,0,9,0,0,3,3,1,0,"15",1,1,6,10,0,0,3277352,"2023-11-03T00:00:00.000Z",5,FALSE,3,17896038,"C",3,3,"Brooklyn Nets","Day'Ron Sharpe",0,16,16,6,10,18
0,0,0,0,0,0,0,0,0,"00",0,0,0,0,0,0,3277352,"2023-11-03T00:00:00.000Z",5,FALSE,3,9051997,"G",3,3,"Brooklyn Nets","Armoni Brooks",0,0,0,0,0,0
0,0,0,0,0,0,0,0,0,"00",0,0,0,0,0,0,3277352,"2023-11-03T00:00:00.000Z",5,FALSE,3,174,"F-C",3,3,"Brooklyn Nets","Harry Giles III",0,0,0,0,0,0
0,0,0,0,0,0,0,0,0,"00",0,0,0,0,0,0,3277352,"2023-11-03T00:00:00.000Z",5,FALSE,3,17896058,"F",3,3,"Brooklyn Nets","Trendon Watford",0,0,0,0,0,0
0,0,0,0,0,0,0,0,0,"00",0,0,0,0,0,0,3277352,"2023-11-03T00:00:00.000Z",5,FALSE,3,56677722,"F",3,3,"Brooklyn Nets","Jalen Wilson",0,0,0,0,0,0
0,0,0,0,0,0,0,0,0,"00",0,0,0,0,0,0,3277352,"2023-11-03T00:00:00.000Z",5,FALSE,3,666508,"F-C",3,3,"Brooklyn Nets","Nicolas Claxton",0,0,0,0,0,0
0,0,0,0,0,0,0,0,0,"00",0,0,0,0,0,0,3277352,"2023-11-03T00:00:00.000Z",5,FALSE,3,38017719,"F",5,5,"Chicago Bulls","Dalen Terry",0,0,0,0,0,0
0,0,0,0,0,0,0,0,0,"00",0,0,0,0,0,0,3277352,"2023-11-03T00:00:00.000Z",5,FALSE,3,27,"G",5,5,"Chicago Bulls","Lonzo Ball",0,0,0,0,0,0
0,0,0,0,0,0,0,0,0,"00",0,0,0,0,0,0,3277352,"2023-11-03T00:00:00.000Z",5,FALSE,3,56677874,"F",5,5,"Chicago Bulls","Onuralp Bitim",0,0,0,0,0,0
0,0,0,0,0,0,0,0,0,"00",0,0,0,0,0,0,3277352,"2023-11-03T00:00:00.000Z",5,FALSE,3,17895983,"G",5,5,"Chicago Bulls","Ayo Dosunmu",0,0,0,0,0,0
2,1,2,2,1,2,1,0,0,"26",0,2,3,2,0,0,3277352,"2023-11-03T00:00:00.000Z",5,FALSE,3,89,"G",5,5,"Chicago Bulls","Alex Caruso",1,5,7,5,4,11.4
1,1,5,3,2,6,4,0,0,"21",0,1,10,5,0,2,3277352,"2023-11-03T00:00:00.000Z",5,FALSE,3,3547248,"F",5,5,"Chicago Bulls","Patrick Williams",1,15,16,11,6,18.5
0,0,4,0,0,3,3,4,1,"12",0,1,7,4,1,1,3277352,"2023-11-03T00:00:00.000Z",5,FALSE,3,137,"C",5,5,"Chicago Bulls","Andre Drummond",1,11,11,7,4,13.8
0,0,0,0,0,0,0,0,0,"00",0,0,0,0,0,0,3277352,"2023-11-03T00:00:00.000Z",5,FALSE,3,56677857,"F",5,5,"Chicago Bulls","Julian Phillips",0,0,0,0,0,0
0,0,0,0,0,0,0,0,0,"00",0,0,0,0,0,0,3277352,"2023-11-03T00:00:00.000Z",5,FALSE,3,17896116,"G",5,5,"Chicago Bulls","Terry Taylor",0,0,0,0,0,0
0,0,0,0,0,0,0,0,0,"00",0,0,0,0,0,0,3277352,"2023-11-03T00:00:00.000Z",5,FALSE,3,45969255,"F",5,5,"Chicago Bulls","Justin Lewis",0,0,0,0,0,0
0,0,3,6,6,12,9,7,5,"30",2,4,29,5,0,1,3277353,"2023-11-03T00:00:00.000Z",21,FALSE,10,666541,"G",21,21,"Oklahoma City Thunder","Luguentz Dort",0,34,34,29,5,34
8,0,2,0,0,12,8,5,2,"35",1,6,18,3,1,6,3277353,"2023-11-03T00:00:00.000Z",21,FALSE,10,38017703,"G-F",21,21,"Oklahoma City Thunder","Jalen Williams",1,21,29,26,11,30.6
5,1,5,2,2,9,7,8,8,"32",3,4,24,8,1,2,3277353,"2023-11-03T00:00:00.000Z",21,FALSE,10,38017685,"C-F",21,21,"Oklahoma City Thunder","Chet Holmgren",2,32,37,29,13,45.1
4,0,5,3,0,15,8,2,2,"31",0,2,18,5,0,6,3277353,"2023-11-03T00:00:00.000Z",21,FALSE,10,17896065,"G",21,21,"Oklahoma City Thunder","Josh Giddey",0,23,27,22,9,24
1,0,1,2,1,10,6,0,0,"36",1,1,13,2,0,1,3277353,"2023-11-03T00:00:00.000Z",21,FALSE,10,56677833,"G",21,21,"Oklahoma City Thunder","Cason Wallace",0,15,16,14,3,15.9
0,0,0,0,0,0,0,0,0,"00",0,0,0,0,0,0,3277353,"2023-11-03T00:00:00.000Z",21,FALSE,10,44,"F",21,21,"Oklahoma City Thunder","Davis Bertans",0,0,0,0,0,0
1,0,1,3,1,3,1,0,0,"06",0,0,3,1,0,1,3277353,"2023-11-03T00:00:00.000Z",21,FALSE,10,38017716,"F",21,21,"Oklahoma City Thunder","Ousmane Dieng",0,4,5,4,2,4.7
1,0,0,5,3,6,4,6,5,"26",0,0,16,0,0,1,3277353,"2023-11-03T00:00:00.000Z",21,FALSE,10,3547272,"G",21,21,"Oklahoma City Thunder","Isaiah Joe",0,16,17,17,1,16.5
0,0,0,0,0,0,0,0,0,"00",0,0,0,0,0,0,3277353,"2023-11-03T00:00:00.000Z",21,FALSE,10,17896036,"G",21,21,"Oklahoma City Thunder","Tre Mann",0,0,0,0,0,0
3,0,1,2,1,5,2,0,0,"12",0,1,5,1,0,0,3277353,"2023-11-03T00:00:00.000Z",21,FALSE,10,4197029,"G",21,21,"Oklahoma City Thunder","Vasilije Micic",0,6,9,8,4,10.7
0,0,0,0,0,0,0,0,0,"00",0,0,0,0,0,0,3277353,"2023-11-03T00:00:00.000Z",21,FALSE,10,3547271,"C",21,21,"Oklahoma City Thunder","Aleksej Pokusevski",0,0,0,0,0,0
0,0,0,0,0,0,0,0,0,"00",0,0,0,0,0,0,3277353,"2023-11-03T00:00:00.000Z",21,FALSE,10,24572055,"C",21,21,"Oklahoma City Thunder","Olivier Sarr",0,0,0,0,0,0
0,0,0,0,0,0,0,0,0,"00",0,0,0,0,0,0,3277353,"2023-11-03T00:00:00.000Z",21,FALSE,10,27924547,"F",21,21,"Oklahoma City Thunder","Lindy Waters III",0,0,0,0,0,0
0,0,2,3,1,6,3,0,0,"17",0,1,7,2,1,0,3277353,"2023-11-03T00:00:00.000Z",21,FALSE,10,17896078,"G",21,21,"Oklahoma City Thunder","Aaron Wiggins",1,9,9,7,2,12.4
0,0,0,0,0,0,0,0,0,"00",0,0,0,0,0,0,3277353,"2023-11-03T00:00:00.000Z",21,FALSE,10,17896070,"F",10,10,"Golden State Warriors","Usman Garuba",0,0,0,0,0,0
0,0,0,0,0,0,0,0,0,"00",0,0,0,0,0,0,3277353,"2023-11-03T00:00:00.000Z",21,FALSE,10,251,"G",10,10,"Golden State Warriors","Cory Joseph",0,0,0,0,0,0
1,0,1,2,0,15,9,2,1,"22",1,2,19,2,0,3,3277353,"2023-11-03T00:00:00.000Z",21,FALSE,10,17553979,"F",10,10,"Golden State Warriors","Jonathan Kuminga",0,21,22,20,3,19.9
2,0,0,5,2,7,3,0,0,"17",1,3,8,1,1,1,3277353,"2023-11-03T00:00:00.000Z",21,FALSE,10,17553992,"G",10,10,"Golden State Warriors","Moses Moody",1,9,11,10,3,14.2
3,0,5,3,0,5,2,2,2,"15",0,1,6,5,0,1,3277353,"2023-11-03T00:00:00.000Z",21,FALSE,10,38017706,"F",21,21,"Oklahoma City Thunder","Jaylin Williams",0,11,14,9,8,15.5
0,0,0,0,0,0,0,0,0,"00",0,0,0,0,0,0,3277353,"2023-11-03T00:00:00.000Z",21,FALSE,10,175,"G",21,21,"Oklahoma City Thunder","Shai Gilgeous-Alexander",0,0,0,0,0,0
0,0,0,0,0,0,0,0,0,"00",0,0,0,0,0,0,3277353,"2023-11-03T00:00:00.000Z",21,FALSE,10,56677853,"F",21,21,"Oklahoma City Thunder","Keyontae Johnson",0,0,0,0,0,0
0,0,0,0,0,0,0,0,0,"00",0,0,0,0,0,0,3277353,"2023-11-03T00:00:00.000Z",21,FALSE,10,480,"G-F",21,21,"Oklahoma City Thunder","Kenrich Williams",0,0,0,0,0,0
1,0,1,1,0,11,6,8,5,"27",4,1,17,5,0,0,3277353,"2023-11-03T00:00:00.000Z",21,FALSE,10,475,"F-G",10,10,"Golden State Warriors","Andrew Wiggins",0,22,23,18,6,24.5
3,1,3,4,2,11,5,3,3,"29",2,5,15,5,0,3,3277353,"2023-11-03T00:00:00.000Z",21,FALSE,10,185,"F",10,10,"Golden State Warriors","Draymond Green",1,20,23,18,8,25.5
4,1,2,0,0,2,1,2,2,"11",1,4,4,3,1,2,3277353,"2023-11-03T00:00:00.000Z",21,FALSE,10,282,"F",10,10,"Golden State Warriors","Kevon Looney",2,7,11,8,7,17.6
1,0,3,6,4,10,6,2,2,"33",0,4,18,3,0,1,3277353,"2023-11-03T00:00:00.000Z",21,FALSE,10,443,"G",10,10,"Golden State Warriors","Klay Thompson",0,21,22,19,4,22.1
7,0,5,10,5,15,9,7,7,"31",3,1,30,8,2,3,3277353,"2023-11-03T00:00:00.000Z",21,FALSE,10,115,"G",10,10,"Golden State Warriors","Stephen Curry",2,38,45,37,15,53.1
0,0,0,0,0,0,0,0,0,"00",0,0,0,0,0,0,3277353,"2023-11-03T00:00:00.000Z",21,FALSE,10,56677858,"G",10,10,"Golden State Warriors","Brandin Podziemski",0,0,0,0,0,0
0,0,0,0,0,0,0,0,0,"00",0,0,0,0,0,0,3277353,"2023-11-03T00:00:00.000Z",21,FALSE,10,45658838,"G",10,10,"Golden State Warriors","Lester Quinones",0,0,0,0,0,0
13,0,2,2,0,6,0,2,1,"28",0,1,1,2,2,0,3277353,"2023-11-03T00:00:00.000Z",21,FALSE,10,367,"G",10,10,"Golden State Warriors","Chris Paul",2,3,16,14,15,28.9
1,0,3,3,1,6,4,0,0,"22",0,2,9,3,2,1,3277353,"2023-11-03T00:00:00.000Z",21,FALSE,10,2189,"",10,10,"Golden State Warriors","Gary Payton II",2,12,13,10,4,19.1
0,0,0,0,0,0,0,0,0,"00",0,0,0,0,0,0,3277353,"2023-11-03T00:00:00.000Z",21,FALSE,10,398,"G",10,10,"Golden State Warriors","Jerome Robinson",0,0,0,0,0,0
3,0,5,7,4,9,6,4,4,"20",1,2,20,6,1,1,3277353,"2023-11-03T00:00:00.000Z",21,FALSE,10,407,"F",10,10,"Golden State Warriors","Dario Saric",1,26,29,23,9,33.7
0,0,0,0,0,0,0,0,0,"00",0,0,0,0,0,0,3277353,"2023-11-03T00:00:00.000Z",21,FALSE,10,56677799,"F",10,10,"Golden State Warriors","Trayce Jackson-Davis",0,0,0,0,0,0
1,2,4,8,4,18,10,0,0,"34",5,2,24,9,0,1,3277354,"2023-11-03T00:00:00.000Z",8,FALSE,7,375,"F",8,8,"Denver Nuggets","Michael Porter Jr.",2,33,34,25,10,41.3
6,1,6,6,2,17,8,0,0,"35",2,2,18,8,2,4,3277354,"2023-11-03T00:00:00.000Z",8,FALSE,7,177,"F",8,8,"Denver Nuggets","Aaron Gordon",3,26,32,24,14,41.6
9,1,7,2,2,16,14,5,3,"36",7,3,33,14,1,4,3277354,"2023-11-03T00:00:00.000Z",8,FALSE,7,246,"C",8,8,"Denver Nuggets","Nikola Jokic",2,47,56,42,23,65.3
1,0,5,3,2,7,3,0,0,"37",0,0,8,5,2,1,3277354,"2023-11-03T00:00:00.000Z",8,FALSE,7,81,"G",8,8,"Denver Nuggets","Kentavious Caldwell-Pope",2,13,14,9,6,20.5
13,0,2,6,2,15,5,6,6,"39",0,4,18,2,1,2,3277354,"2023-11-03T00:00:00.000Z",8,FALSE,7,335,"G",8,8,"Denver Nuggets","Jamal Murray",1,20,33,31,15,40.9
0,0,3,0,0,4,3,3,3,"15",2,3,9,5,1,1,3277354,"2023-11-03T00:00:00.000Z",8,FALSE,7,38017709,"G",8,8,"Denver Nuggets","Christian Braun",1,14,14,9,5,17
0,0,0,0,0,0,0,0,0,"00",0,0,0,0,0,0,3277354,"2023-11-03T00:00:00.000Z",8,FALSE,7,38017727,"G",8,8,"Denver Nuggets","Collin Gillespie",0,0,0,0,0,0
0,0,0,0,0,0,0,0,0,"00",0,0,0,0,0,0,3277354,"2023-11-03T00:00:00.000Z",8,FALSE,7,215,"F-G",8,8,"Denver Nuggets","Justin Holiday",0,0,0,0,0,0
2,0,1,4,1,10,3,2,1,"20",0,1,8,1,4,3,3277354,"2023-11-03T00:00:00.000Z",8,FALSE,7,236,"G",8,8,"Denver Nuggets","Reggie Jackson",4,9,11,10,3,21.2
0,0,0,0,0,0,0,0,0,"00",0,0,0,0,0,0,3277354,"2023-11-03T00:00:00.000Z",8,FALSE,7,250,"C",8,8,"Denver Nuggets","DeAndre Jordan",0,0,0,0,0,0
0,0,0,0,0,0,0,0,0,"00",0,0,0,0,0,0,3277354,"2023-11-03T00:00:00.000Z",8,FALSE,7,17896007,"G",8,8,"Denver Nuggets","Braxton Key",0,0,0,0,0,0
0,0,3,0,0,2,2,1,0,"12",1,0,4,4,0,1,3277354,"2023-11-03T00:00:00.000Z",8,FALSE,7,3547268,"F-C",8,8,"Denver Nuggets","Zeke Nnaji",0,8,8,4,4,7.8
0,0,0,0,0,0,0,0,0,"00",0,0,0,0,0,0,3277354,"2023-11-03T00:00:00.000Z",8,FALSE,7,56677582,"G",8,8,"Denver Nuggets","Jalen Pickett",0,0,0,0,0,0
0,0,0,0,0,0,0,0,0,"00",0,0,0,0,0,0,3277354,"2023-11-03T00:00:00.000Z",8,FALSE,7,56677776,"G",8,8,"Denver Nuggets","Julian Strawther",0,0,0,0,0,0
2,0,3,5,1,8,3,2,2,"27",0,3,9,3,1,2,3277354,"2023-11-03T00:00:00.000Z",8,FALSE,7,191,"G",7,7,"Dallas Mavericks","Tim Hardaway Jr.",1,12,14,11,5,16.6
3,0,2,4,2,6,2,0,0,"14",1,2,6,3,0,0,3277354,"2023-11-03T00:00:00.000Z",8,FALSE,7,38017679,"G",7,7,"Dallas Mavericks","Jaden Hardy",0,9,12,9,6,14.1
0,0,0,0,0,0,0,0,0,"00",0,0,0,0,0,0,3277354,"2023-11-03T00:00:00.000Z",8,FALSE,7,217,"F-C",7,7,"Dallas Mavericks","Richaun Holmes",0,0,0,0,0,0
1,0,0,0,0,5,2,2,2,"17",1,2,6,1,0,0,3277354,"2023-11-03T00:00:00.000Z",8,FALSE,7,379,"F-C",7,7,"Dallas Mavericks","Dwight Powell",0,7,8,7,2,8.7
0,0,0,0,0,1,0,0,0,"01",0,0,0,0,0,0,3277354,"2023-11-03T00:00:00.000Z",8,FALSE,7,56677859,"F",7,7,"Dallas Mavericks","Olivier-Maxence Prosper",0,0,0,0,0,0
0,0,0,0,0,0,0,0,0,"00",0,0,0,0,0,0,3277354,"2023-11-03T00:00:00.000Z",8,FALSE,7,17896028,"F",7,7,"Dallas Mavericks","Greg Brown III",0,0,0,0,0,0
0,0,0,0,0,0,0,0,0,"00",0,0,0,0,0,0,3277354,"2023-11-03T00:00:00.000Z",8,FALSE,7,56677873,"G",7,7,"Dallas Mavericks","Dexter Dennis",0,0,0,0,0,0
0,0,0,0,0,0,0,0,0,"00",0,0,0,0,0,0,3277354,"2023-11-03T00:00:00.000Z",8,FALSE,7,257,"F",7,7,"Dallas Mavericks","Maxi Kleber",0,0,0,0,0,0
0,0,0,0,0,0,0,0,0,"00",0,0,0,0,0,0,3277354,"2023-11-03T00:00:00.000Z",8,FALSE,7,17554004,"G",7,7,"Dallas Mavericks","AJ Lawson",0,0,0,0,0,0
1,2,1,1,0,4,1,2,1,"12",2,2,3,3,0,0,3277354,"2023-11-03T00:00:00.000Z",8,FALSE,7,38017721,"G",8,8,"Denver Nuggets","Peyton Watson",2,6,7,4,4,14.1
0,0,0,0,0,0,0,0,0,"00",0,0,0,0,0,0,3277354,"2023-11-03T00:00:00.000Z",8,FALSE,7,666489,"F",8,8,"Denver Nuggets","Vlatko Cancar",0,0,0,0,0,0
0,0,0,0,0,0,0,0,0,"00",0,0,0,0,0,0,3277354,"2023-11-03T00:00:00.000Z",8,FALSE,7,17896103,"F-C",8,8,"Denver Nuggets","Jay Huff",0,0,0,0,0,0
0,0,0,0,0,0,0,0,0,"00",0,0,0,0,0,0,3277354,"2023-11-03T00:00:00.000Z",8,FALSE,7,56677871,"F",8,8,"Denver Nuggets","Hunter Tyson",0,0,0,0,0,0
1,0,0,3,1,5,3,0,0,"17",1,0,7,1,2,0,3277354,"2023-11-03T00:00:00.000Z",8,FALSE,7,247,"F-G",7,7,"Dallas Mavericks","Derrick Jones Jr.",2,8,9,8,2,15.7
2,2,3,7,3,10,4,2,2,"33",2,4,13,5,1,1,3277354,"2023-11-03T00:00:00.000Z",8,FALSE,7,666965,"F",7,7,"Dallas Mavericks","Grant Williams",3,18,20,15,7,30
0,1,3,1,0,3,2,0,0,"25",1,2,4,4,1,0,3277354,"2023-11-03T00:00:00.000Z",8,FALSE,7,56677840,"C",7,7,"Dallas Mavericks","Dereck Lively II",2,8,8,4,4,14.8
8,1,7,11,6,24,11,7,6,"38",3,2,34,10,0,9,3277354,"2023-11-03T00:00:00.000Z",8,FALSE,7,132,"F-G",7,7,"Dallas Mavericks","Luka Doncic",1,44,52,42,18,52
7,2,1,5,1,15,9,4,3,"35",0,1,22,1,4,3,3277354,"2023-11-03T00:00:00.000Z",8,FALSE,7,228,"G",7,7,"Dallas Mavericks","Kyrie Irving",6,23,30,29,8,48.7
1,0,1,1,0,1,0,0,0,"05",0,1,0,1,1,0,3277354,"2023-11-03T00:00:00.000Z",8,FALSE,7,114,"G",7,7,"Dallas Mavericks","Seth Curry",1,1,2,1,2,5.7
0,0,0,0,0,0,0,0,0,"01",0,0,0,0,0,0,3277354,"2023-11-03T00:00:00.000Z",8,FALSE,7,151,"G",7,7,"Dallas Mavericks","Dante Exum",0,0,0,0,0,0
2,0,4,5,3,8,5,0,0,"27",1,2,13,5,2,0,3277354,"2023-11-03T00:00:00.000Z",8,FALSE,7,3547258,"G",7,7,"Dallas Mavericks","Josh Green",2,18,20,15,7,28
0,0,0,0,0,0,0,0,0,"00",0,0,0,0,0,0,3277354,"2023-11-03T00:00:00.000Z",8,FALSE,7,329,"F",7,7,"Dallas Mavericks","Markieff Morris",0,0,0,0,0,0
0,2,0,3,1,4,2,0,0,"19",0,1,5,0,0,0,3277355,"2023-11-03T00:00:00.000Z",25,FALSE,15,666923,"G-F",25,25,"Portland Trail Blazers","Matisse Thybulle",2,5,5,5,0,11
3,1,6,7,3,23,9,9,5,"44",2,0,26,8,0,3,3277355,"2023-11-03T00:00:00.000Z",25,FALSE,15,182,"F",25,25,"Portland Trail Blazers","Jerami Grant",1,34,37,29,11,40.1
2,1,8,0,0,11,7,2,2,"36",4,4,16,12,3,1,3277355,"2023-11-03T00:00:00.000Z",25,FALSE,15,22,"C",25,25,"Portland Trail Blazers","Deandre Ayton",4,28,30,18,14,44.4
2,1,4,5,2,17,7,7,6,"46",1,2,22,5,1,3,3277355,"2023-11-03T00:00:00.000Z",25,FALSE,15,38017690,"G",25,25,"Portland Trail Blazers","Shaedon Sharpe",2,27,29,24,7,34
10,0,7,9,2,19,6,12,10,"44",0,1,24,7,3,4,3277355,"2023-11-03T00:00:00.000Z",25,FALSE,15,65,"G",25,25,"Portland Trail Blazers","Malcolm Brogdon",3,31,41,34,17,52.4
0,0,0,0,0,0,0,0,0,"00",0,0,0,0,0,0,3277355,"2023-11-03T00:00:00.000Z",25,FALSE,15,666476,"C",25,25,"Portland Trail Blazers","Moses Brown",0,0,0,0,0,0
1,0,0,3,0,8,2,1,1,"32",3,4,5,3,2,1,3277355,"2023-11-03T00:00:00.000Z",25,FALSE,15,56677850,"F",25,25,"Portland Trail Blazers","Toumani Camara",2,8,9,6,4,15.1
5,2,6,2,0,8,3,0,0,"24",1,5,6,7,1,1,3277355,"2023-11-03T00:00:00.000Z",25,FALSE,15,3547285,"F",15,15,"Memphis Grizzlies","Xavier Tillman",3,13,18,11,12,29.9
1,0,2,2,0,2,0,0,0,"10",0,1,0,2,0,1,3277355,"2023-11-03T00:00:00.000Z",25,FALSE,15,38017731,"G",15,15,"Memphis Grizzlies","Vince Williams Jr.",0,2,3,1,3,2.9
0,0,0,0,0,0,0,0,0,"00",0,0,0,0,0,0,3277355,"2023-11-03T00:00:00.000Z",25,FALSE,15,3,"C",15,15,"Memphis Grizzlies","Steven Adams",0,0,0,0,0,0
0,0,0,0,0,0,0,0,0,"00",0,0,0,0,0,0,3277355,"2023-11-03T00:00:00.000Z",25,FALSE,15,17896067,"F",15,15,"Memphis Grizzlies","Santi Aldama",0,0,0,0,0,0
0,0,0,0,0,0,0,0,0,"00",0,0,0,0,0,0,3277355,"2023-11-03T00:00:00.000Z",25,FALSE,15,666505,"F",15,15,"Memphis Grizzlies","Brandon Clarke",0,0,0,0,0,0
0,0,0,0,0,0,0,0,0,"00",0,0,0,0,0,0,3277355,"2023-11-03T00:00:00.000Z",25,FALSE,15,56677830,"F",15,15,"Memphis Grizzlies","GG Jackson",0,0,0,0,0,0
0,0,0,0,0,0,0,0,0,"00",0,0,0,0,0,0,3277355,"2023-11-03T00:00:00.000Z",25,FALSE,15,666786,"G",15,15,"Memphis Grizzlies","Ja Morant",0,0,0,0,0,0
0,0,0,0,0,0,0,0,0,"00",0,0,0,0,0,0,3277355,"2023-11-03T00:00:00.000Z",25,FALSE,15,401,"G",15,15,"Memphis Grizzlies","Derrick Rose",0,0,0,0,0,0
1,0,1,5,1,8,3,2,2,"15",0,0,9,1,1,1,3277355,"2023-11-03T00:00:00.000Z",25,FALSE,15,3547289,"G",25,25,"Portland Trail Blazers","Skylar Mays",1,10,11,10,2,13.7
0,0,0,0,0,0,0,0,0,"00",0,0,0,0,0,0,3277355,"2023-11-03T00:00:00.000Z",25,FALSE,15,47957121,"F",25,25,"Portland Trail Blazers","Justin Minaya",0,0,0,0,0,0
0,0,0,0,0,0,0,0,0,"00",0,0,0,0,0,0,3277355,"2023-11-03T00:00:00.000Z",25,FALSE,15,56677791,"F",25,25,"Portland Trail Blazers","Kris Murray",0,0,0,0,0,0
0,0,0,0,0,0,0,0,0,"00",0,0,0,0,0,0,3277355,"2023-11-03T00:00:00.000Z",25,FALSE,15,56677829,"G-F",25,25,"Portland Trail Blazers","Rayan Rupert",0,0,0,0,0,0
0,1,3,0,0,2,0,0,0,"09",1,2,0,4,0,0,3277355,"2023-11-03T00:00:00.000Z",25,FALSE,15,38017711,"F",25,25,"Portland Trail Blazers","Jabari Walker",1,4,4,0,4,7.8
0,1,6,0,0,4,3,3,2,"20",4,1,8,10,2,1,3277355,"2023-11-03T00:00:00.000Z",25,FALSE,15,476,"C-F",25,25,"Portland Trail Blazers","Robert Williams III",3,18,18,8,10,28
0,0,0,0,0,0,0,0,0,"00",0,0,0,0,0,0,3277355,"2023-11-03T00:00:00.000Z",25,FALSE,15,56677747,"G",25,25,"Portland Trail Blazers","Scoot Henderson",0,0,0,0,0,0
0,0,0,0,0,0,0,0,0,"00",0,0,0,0,0,0,3277355,"2023-11-03T00:00:00.000Z",25,FALSE,15,56783340,"C",25,25,"Portland Trail Blazers","Duop Reath",0,0,0,0,0,0
0,0,0,0,0,0,0,0,0,"00",0,0,0,0,0,0,3277355,"2023-11-03T00:00:00.000Z",25,FALSE,15,419,"G",25,25,"Portland Trail Blazers","Anfernee Simons",0,0,0,0,0,0
0,0,0,0,0,0,0,0,0,"00",0,0,0,0,0,0,3277355,"2023-11-03T00:00:00.000Z",25,FALSE,15,17896120,"F",25,25,"Portland Trail Blazers","Ish Wainright",0,0,0,0,0,0
3,1,6,1,1,8,5,2,2,"27",0,6,13,6,1,2,3277355,"2023-11-03T00:00:00.000Z",25,FALSE,15,17896027,"G-F",15,15,"Memphis Grizzlies","Ziaire Williams",2,19,22,16,9,28.7
0,0,2,4,0,14,8,0,0,"32",1,4,16,3,0,0,3277355,"2023-11-03T00:00:00.000Z",25,FALSE,15,38017729,"F",15,15,"Memphis Grizzlies","David Roddy",0,19,19,16,3,19.6
3,3,8,8,5,17,11,6,3,"38",2,1,30,10,1,4,3277355,"2023-11-03T00:00:00.000Z",25,FALSE,15,231,"F-C",15,15,"Memphis Grizzlies","Jaren Jackson Jr.",4,40,43,33,13,54.5
7,3,7,9,3,26,13,5,4,"45",1,5,33,8,4,3,3277355,"2023-11-03T00:00:00.000Z",25,FALSE,15,3547287,"G",15,15,"Memphis Grizzlies","Desmond Bane",7,41,48,40,15,71.1
4,0,2,5,0,12,4,0,0,"39",1,2,8,3,1,5,3277355,"2023-11-03T00:00:00.000Z",25,FALSE,15,420,"G",15,15,"Memphis Grizzlies","Marcus Smart",1,11,15,12,7,15.6
0,0,0,0,0,0,0,0,0,"01",0,0,0,0,0,0,3277355,"2023-11-03T00:00:00.000Z",25,FALSE,15,48,"C",15,15,"Memphis Grizzlies","Bismack Biyombo",0,0,0,0,0,0
3,0,0,0,0,0,0,0,0,"12",0,0,0,0,0,1,3277355,"2023-11-03T00:00:00.000Z",25,FALSE,15,48248287,"G",15,15,"Memphis Grizzlies","Jacob Gilyard",0,0,3,3,3,3.5
3,0,7,4,1,7,2,0,0,"27",1,1,5,8,0,0,3277355,"2023-11-03T00:00:00.000Z",25,FALSE,15,254,"G",15,15,"Memphis Grizzlies","Luke Kennard",0,13,16,8,11,19.1
0,1,1,0,0,2,1,0,0,"10",0,0,2,1,0,0,3277355,"2023-11-03T00:00:00.000Z",25,FALSE,15,666703,"G-F",15,15,"Memphis Grizzlies","John Konchar",1,3,3,2,1,6.2
0,0,0,0,0,0,0,0,0,"00",0,0,0,0,0,0,3277355,"2023-11-03T00:00:00.000Z",25,FALSE,15,38017728,"F",15,15,"Memphis Grizzlies","Jake LaRavia",0,0,0,0,0,0
0,0,0,0,0,0,0,0,0,"00",0,0,0,0,0,0,3277355,"2023-11-03T00:00:00.000Z",25,FALSE,15,38017732,"F",15,15,"Memphis Grizzlies","Kenneth Lofton Jr.",0,0,0,0,0,0
0,1,3,7,3,18,10,3,2,"35",0,3,25,3,0,0,1037671,"2023-11-04T00:00:00.000Z",23,FALSE,24,360,"F",23,23,"Philadelphia 76ers","Kelly Oubre Jr.",1,28,28,25,3,31.6
2,0,8,1,0,10,7,4,4,"35",2,4,18,10,1,3,1037671,"2023-11-04T00:00:00.000Z",23,FALSE,24,200,"F",23,23,"Philadelphia 76ers","Tobias Harris",1,28,30,20,12,33
3,1,8,3,3,18,9,5,5,"31",3,2,26,11,0,4,1037671,"2023-11-04T00:00:00.000Z",23,FALSE,24,145,"F-C",23,23,"Philadelphia 76ers","Joel Embiid",1,37,40,29,14,42.7
4,1,0,7,2,10,3,2,0,"25",2,3,8,2,1,2,1037671,"2023-11-04T00:00:00.000Z",23,FALSE,24,313,"G",23,23,"Philadelphia 76ers","De'Anthony Melton",2,10,14,12,6,20.4
10,1,3,6,2,18,9,2,2,"36",2,0,22,5,0,3,1037671,"2023-11-04T00:00:00.000Z",23,FALSE,24,3547254,"G",23,23,"Philadelphia 76ers","Tyrese Maxey",1,27,37,32,15,43
0,0,0,0,0,2,0,0,0,"02",2,1,0,2,0,0,1037671,"2023-11-04T00:00:00.000Z",23,FALSE,24,28,"C",23,23,"Philadelphia 76ers","Mo Bamba",0,2,2,0,2,2.4
1,0,3,1,0,1,0,0,0,"12",1,1,0,4,0,0,1037671,"2023-11-04T00:00:00.000Z",23,FALSE,24,45,"G",23,23,"Philadelphia 76ers","Patrick Beverley",0,4,5,1,5,6.3
0,1,3,3,0,3,0,2,2,"18",1,3,2,4,2,2,1037671,"2023-11-04T00:00:00.000Z",23,FALSE,24,108,"F",23,23,"Philadelphia 76ers","Robert Covington",3,6,6,2,4,13.8
0,0,0,0,0,0,0,0,0,"00",0,0,0,0,0,0,1037671,"2023-11-04T00:00:00.000Z",23,FALSE,24,2175,"",23,23,"Philadelphia 76ers","Danuel House Jr.",0,0,0,0,0,0
1,0,2,1,1,2,2,0,0,"18",0,2,5,2,1,1,1037671,"2023-11-04T00:00:00.000Z",23,FALSE,24,260,"G-F",23,23,"Philadelphia 76ers","Furkan Korkmaz",1,7,8,6,3,10.9
0,0,0,0,0,0,0,0,0,"02",0,1,0,0,0,1,1037671,"2023-11-04T00:00:00.000Z",23,FALSE,24,3547294,"F",23,23,"Philadelphia 76ers","Kenyon Martin Jr.",0,0,0,0,0,-1
0,0,0,0,0,0,0,0,0,"00",0,0,0,0,0,0,1037671,"2023-11-04T00:00:00.000Z",23,FALSE,24,328,"F",23,23,"Philadelphia 76ers","Marcus Morris",0,0,0,0,0,0
1,0,4,0,0,4,2,0,0,"15",1,3,4,5,0,0,1037671,"2023-11-04T00:00:00.000Z",23,FALSE,24,3547270,"F",23,23,"Philadelphia 76ers","Paul Reed",0,9,10,5,6,11.5
2,1,2,1,0,4,1,0,0,"11",1,1,2,3,0,1,1037671,"2023-11-04T00:00:00.000Z",23,FALSE,24,17896025,"G",23,23,"Philadelphia 76ers","Jaden Springer",1,5,7,4,5,10.6
0,0,0,0,0,0,0,0,0,"00",0,0,0,0,0,0,1037671,"2023-11-04T00:00:00.000Z",23,FALSE,24,33,"F-G",23,23,"Philadelphia 76ers","Nicolas Batum",0,0,0,0,0,0
0,0,0,0,0,0,0,0,0,"00",0,0,0,0,0,0,1037671,"2023-11-04T00:00:00.000Z",23,FALSE,24,17554001,"G",23,23,"Philadelphia 76ers","Javonte Smart",0,0,0,0,0,0
0,0,0,0,0,0,0,0,0,"00",0,0,0,0,0,0,1037671,"2023-11-04T00:00:00.000Z",23,FALSE,24,56677788,"G",23,23,"Philadelphia 76ers","Terquavion Smith",0,0,0,0,0,0
2,2,3,3,2,6,3,1,0,"24",0,0,8,3,1,0,1037671,"2023-11-04T00:00:00.000Z",23,FALSE,24,32,"F",24,24,"Phoenix Suns","Keita Bates-Diop",3,11,13,10,5,23.6
3,2,7,4,1,20,9,14,12,"36",1,1,31,8,1,5,1037671,"2023-11-04T00:00:00.000Z",23,FALSE,24,140,"F",24,24,"Phoenix Suns","Kevin Durant",3,39,42,34,11,49.1
5,1,6,6,1,14,4,4,2,"23",3,2,11,9,1,0,1037671,"2023-11-04T00:00:00.000Z",23,FALSE,24,349,"C",24,24,"Phoenix Suns","Jusuf Nurkic",2,20,25,16,14,35.3
2,0,2,5,2,7,3,0,0,"27",1,3,8,3,0,1,1037671,"2023-11-04T00:00:00.000Z",23,FALSE,24,8,"G",24,24,"Phoenix Suns","Grayson Allen",0,11,13,10,5,13.6
3,2,1,4,1,15,6,0,0,"34",0,1,13,1,2,1,1037671,"2023-11-04T00:00:00.000Z",23,FALSE,24,178,"G",24,24,"Phoenix Suns","Eric Gordon",4,14,17,16,4,29.7
0,0,0,0,0,0,0,0,0,"00",0,0,0,0,0,0,1037671,"2023-11-04T00:00:00.000Z",23,FALSE,24,56913527,"G",23,23,"Philadelphia 76ers","Ricky Council IV",0,0,0,0,0,0
0,0,2,4,1,4,1,2,2,"22",3,2,5,5,1,1,1037671,"2023-11-04T00:00:00.000Z",23,FALSE,24,470,"G",24,24,"Phoenix Suns","Yuta Watanabe",1,10,10,5,5,13
2,1,0,2,0,7,2,0,0,"26",1,0,4,1,2,1,1037671,"2023-11-04T00:00:00.000Z",23,FALSE,24,356,"G",24,24,"Phoenix Suns","Josh Okogie",3,5,7,6,3,16.2
0,2,1,6,1,10,2,2,1,"15",2,0,6,3,2,0,1037671,"2023-11-04T00:00:00.000Z",23,FALSE,24,18678058,"",24,24,"Phoenix Suns","Jordan Goodwin",4,9,9,6,3,21.6
0,0,0,0,0,0,0,0,0,"00",0,0,0,0,0,0,1037671,"2023-11-04T00:00:00.000Z",23,FALSE,24,3547095,"C-F",24,24,"Phoenix Suns","Udoka Azubuike",0,0,0,0,0,0
0,0,0,0,0,0,0,0,0,"00",0,0,0,0,0,0,1037671,"2023-11-04T00:00:00.000Z",23,FALSE,24,666451,"C",24,24,"Phoenix Suns","Bol Bol",0,0,0,0,0,0
4,1,3,0,0,4,2,6,6,"20",2,1,10,5,1,0,1037671,"2023-11-04T00:00:00.000Z",23,FALSE,24,147,"F",24,24,"Phoenix Suns","Drew Eubanks",2,15,19,14,9,28
1,0,1,0,0,1,0,0,0,"04",1,1,0,2,0,0,1037671,"2023-11-04T00:00:00.000Z",23,FALSE,24,3547298,"G",24,24,"Phoenix Suns","Saben Lee",0,2,3,1,3,3.9
0,0,0,0,0,0,0,2,2,"04",1,0,2,1,0,0,1037671,"2023-11-04T00:00:00.000Z",23,FALSE,24,666729,"F",24,24,"Phoenix Suns","Nassir Little",0,3,3,2,1,3.2
0,1,1,1,0,1,0,2,2,"05",0,0,2,1,0,1,1037671,"2023-11-04T00:00:00.000Z",23,FALSE,24,314,"F",24,24,"Phoenix Suns","Chimezie Metu",1,3,3,2,1,5.2
0,0,0,0,0,0,0,0,0,"00",0,0,0,0,0,0,1037671,"2023-11-04T00:00:00.000Z",23,FALSE,24,37,"G",24,24,"Phoenix Suns","Bradley Beal",0,0,0,0,0,0
0,0,0,0,0,0,0,0,0,"00",0,0,0,0,0,0,1037671,"2023-11-04T00:00:00.000Z",23,FALSE,24,57,"G",24,24,"Phoenix Suns","Devin Booker",0,0,0,0,0,0
0,0,0,0,0,0,0,0,0,"00",0,0,0,0,0,0,1037671,"2023-11-04T00:00:00.000Z",23,FALSE,24,272,"G",24,24,"Phoenix Suns","Damion Lee",0,0,0,0,0,0
5,0,1,2,0,11,3,2,2,"24",4,1,8,5,1,3,1037672,"2023-11-04T00:00:00.000Z",12,FALSE,4,38017686,"G-F",12,12,"Indiana Pacers","Bennedict Mathurin",1,13,18,13,10,21.5
0,0,3,2,1,7,5,0,0,"26",1,2,11,4,0,0,1037672,"2023-11-04T00:00:00.000Z",12,FALSE,4,3547243,"F",12,12,"Indiana Pacers","Obi Toppin",0,15,15,11,4,15.8
2,0,6,5,3,9,5,2,1,"26",0,4,14,6,1,4,1037672,"2023-11-04T00:00:00.000Z",12,FALSE,4,452,"C-F",12,12,"Indiana Pacers","Myles Turner",1,20,22,16,8,23.2
6,0,1,4,1,8,3,0,0,"32",0,3,7,1,2,0,1037672,"2023-11-04T00:00:00.000Z",12,FALSE,4,69,"G",12,12,"Indiana Pacers","Bruce Brown",2,8,14,13,7,23.2
12,1,2,12,8,21,14,7,7,"37",0,2,43,2,0,3,1037672,"2023-11-04T00:00:00.000Z",12,FALSE,4,3547245,"G",12,12,"Indiana Pacers","Tyrese Haliburton",1,45,57,55,14,63.4
2,2,4,13,5,15,7,1,0,"26",2,1,19,6,0,2,1037672,"2023-11-04T00:00:00.000Z",12,FALSE,4,210,"G",12,12,"Indiana Pacers","Buddy Hield",2,25,27,21,8,33.2
0,0,0,0,0,0,0,0,0,"00",0,0,0,0,0,0,1037672,"2023-11-04T00:00:00.000Z",12,FALSE,4,17896035,"F",12,12,"Indiana Pacers","Isaiah Jackson",0,0,0,0,0,0
0,0,0,0,0,2,0,0,0,"05",0,1,0,0,0,1,1037672,"2023-11-04T00:00:00.000Z",12,FALSE,4,304,"G",12,12,"Indiana Pacers","T.J. McConnell",0,0,0,0,0,-1
2,0,0,3,1,9,3,0,0,"18",1,0,7,1,2,0,1037672,"2023-11-04T00:00:00.000Z",12,FALSE,4,38017507,"G-F",12,12,"Indiana Pacers","Andrew Nembhard",2,8,10,9,3,17.2
1,2,2,1,1,5,1,2,1,"25",0,0,4,2,1,0,1037672,"2023-11-04T00:00:00.000Z",12,FALSE,4,3547250,"G-F",12,12,"Indiana Pacers","Aaron Nesmith",3,6,7,5,3,16.9
0,0,0,0,0,0,0,0,0,"00",0,0,0,0,0,0,1037672,"2023-11-04T00:00:00.000Z",12,FALSE,4,3547207,"F",12,12,"Indiana Pacers","Jordan Nwora",0,0,0,0,0,0
0,0,0,0,0,0,0,0,0,"00",0,0,0,0,0,0,1037672,"2023-11-04T00:00:00.000Z",12,FALSE,4,56677861,"G",12,12,"Indiana Pacers","Ben Sheppard",0,0,0,0,0,0
1,0,6,3,2,6,4,2,1,"21",3,4,11,9,0,1,1037672,"2023-11-04T00:00:00.000Z",12,FALSE,4,3547264,"F-C",12,12,"Indiana Pacers","Jalen Smith",0,20,21,12,10,22.3
0,0,0,0,0,0,0,0,0,"00",0,0,0,0,0,0,1037672,"2023-11-04T00:00:00.000Z",12,FALSE,4,439,"F",13,12,"Indiana Pacers","Daniel Theis",0,0,0,0,0,0
0,0,0,0,0,0,0,0,0,"00",0,0,0,0,0,0,1037672,"2023-11-04T00:00:00.000Z",12,FALSE,4,38017701,"G",12,12,"Indiana Pacers","Kendall Brown",0,0,0,0,0,0
0,0,0,0,0,0,0,0,0,"00",0,0,0,0,0,0,1037672,"2023-11-04T00:00:00.000Z",12,FALSE,4,56677778,"F-C",12,12,"Indiana Pacers","Oscar Tshiebwe",0,0,0,0,0,0
3,2,5,2,1,17,10,2,2,"34",1,3,23,6,0,1,1037672,"2023-11-04T00:00:00.000Z",12,FALSE,4,204,"F",4,4,"Charlotte Hornets","Gordon Hayward",2,29,32,26,9,39.7
4,2,2,1,1,13,6,2,2,"33",1,0,15,3,1,1,1037672,"2023-11-04T00:00:00.000Z",12,FALSE,4,666950,"F",4,4,"Charlotte Hornets","P.J. Washington",3,18,22,19,7,32.6
1,2,3,0,0,12,9,9,9,"30",4,2,27,7,2,3,1037672,"2023-11-04T00:00:00.000Z",12,FALSE,4,38017698,"C",4,4,"Charlotte Hornets","Mark Williams",4,34,35,28,8,45.9
3,1,6,5,3,14,7,5,5,"31",0,0,22,6,0,0,1037672,"2023-11-04T00:00:00.000Z",12,FALSE,4,403,"G",4,4,"Charlotte Hornets","Terry Rozier",1,28,31,25,9,36.7
11,0,1,7,2,15,4,1,1,"31",1,5,11,2,2,6,1037672,"2023-11-04T00:00:00.000Z",12,FALSE,4,3547239,"G",4,4,"Charlotte Hornets","LaMelo Ball",2,13,24,22,13,29.9
0,0,0,0,0,0,0,0,0,"00",0,0,0,0,0,0,1037672,"2023-11-04T00:00:00.000Z",12,FALSE,4,56677848,"G",4,4,"Charlotte Hornets","Amari Bailey",0,0,0,0,0,0
0,0,0,0,0,0,0,0,0,"00",0,0,0,0,0,0,1037672,"2023-11-04T00:00:00.000Z",12,FALSE,4,56677866,"F",4,4,"Charlotte Hornets","Leaky Black",0,0,0,0,0,0
0,0,0,0,0,0,0,0,0,"00",0,0,0,0,0,0,1037672,"2023-11-04T00:00:00.000Z",12,FALSE,4,62,"F",4,4,"Charlotte Hornets","Miles Bridges",0,0,0,0,0,0
0,0,0,2,0,3,0,0,0,"14",0,4,0,0,0,1,1037672,"2023-11-04T00:00:00.000Z",12,FALSE,4,3547253,"G",4,4,"Charlotte Hornets","Theo Maledon",0,0,0,0,0,-1
0,0,0,0,0,0,0,0,0,"00",0,0,0,0,0,0,1037672,"2023-11-04T00:00:00.000Z",12,FALSE,4,38017708,"G",4,4,"Charlotte Hornets","Bryce McGowens",0,0,0,0,0,0
1,1,2,2,0,7,4,2,2,"34",1,4,10,3,0,0,1037672,"2023-11-04T00:00:00.000Z",12,FALSE,4,56677823,"F",4,4,"Charlotte Hornets","Brandon Miller",1,13,14,11,4,18.1
0,2,7,0,0,4,4,2,2,"18",3,1,10,10,0,1,1037672,"2023-11-04T00:00:00.000Z",12,FALSE,4,3547282,"C",4,4,"Charlotte Hornets","Nick Richards",2,20,20,10,10,27
0,0,0,0,0,0,0,0,0,"00",0,0,0,0,0,0,1037672,"2023-11-04T00:00:00.000Z",12,FALSE,4,56677832,"F",12,12,"Indiana Pacers","Jarace Walker",0,0,0,0,0,0
0,0,0,0,0,0,0,0,0,"00",0,0,0,0,0,0,1037672,"2023-11-04T00:00:00.000Z",12,FALSE,4,56677794,"G",12,12,"Indiana Pacers","Isaiah Wong",0,0,0,0,0,0
0,0,0,0,0,0,0,0,0,"00",0,0,0,0,0,0,1037672,"2023-11-04T00:00:00.000Z",12,FALSE,4,666748,"F",4,4,"Charlotte Hornets","Cody Martin",0,0,0,0,0,0
0,0,0,0,0,0,0,0,0,"00",0,0,0,0,0,0,1037672,"2023-11-04T00:00:00.000Z",12,FALSE,4,347,"G",4,4,"Charlotte Hornets","Frank Ntilikina",0,0,0,0,0,0
0,0,0,0,0,0,0,0,0,"00",0,0,0,0,0,0,1037672,"2023-11-04T00:00:00.000Z",12,FALSE,4,422,"G",4,4,"Charlotte Hornets","Ish Smith",0,0,0,0,0,0
0,0,0,0,0,0,0,0,0,"00",0,0,0,0,0,0,1037672,"2023-11-04T00:00:00.000Z",12,FALSE,4,56677846,"G",4,4,"Charlotte Hornets","Nick Smith Jr.",0,0,0,0,0,0
0,0,3,1,1,3,3,0,0,"15",1,1,7,4,0,0,1037672,"2023-11-04T00:00:00.000Z",12,FALSE,4,18678001,"F",4,4,"Charlotte Hornets","JT Thor",0,11,11,7,4,11.8
0,0,0,0,0,0,0,0,0,"00",0,0,0,0,0,0,1037672,"2023-11-04T00:00:00.000Z",12,FALSE,4,17896037,"G",4,4,"Charlotte Hornets","James Bouknight",0,0,0,0,0,0
0,0,0,0,0,0,0,0,0,"00",0,0,0,0,0,0,1037673,"2023-11-04T00:00:00.000Z",22,FALSE,14,196,"G",22,22,"Orlando Magic","Gary Harris",0,0,0,0,0,0
0,0,0,0,0,0,0,0,0,"00",0,0,0,0,0,0,1037673,"2023-11-04T00:00:00.000Z",22,FALSE,14,38017607,"G",22,22,"Orlando Magic","Kevon Harris",0,0,0,0,0,0
0,0,0,0,0,0,0,0,0,"00",0,0,0,0,0,0,1037673,"2023-11-04T00:00:00.000Z",22,FALSE,14,17553983,"G",22,22,"Orlando Magic","Trevelin Queen",0,0,0,0,0,0
0,0,3,1,0,5,1,0,0,"24",0,4,2,3,0,1,1037673,"2023-11-04T00:00:00.000Z",22,FALSE,14,666860,"F-G",14,14,"Los Angeles Lakers","Cameron Reddish",0,5,5,2,3,4.6
5,0,8,5,2,15,8,7,6,"35",1,1,24,9,3,3,1037673,"2023-11-04T00:00:00.000Z",22,FALSE,14,237,"F",14,14,"Los Angeles Lakers","LeBron James",3,33,38,29,14,48.3
3,7,7,0,0,15,10,8,8,"32",6,5,28,13,0,4,1037673,"2023-11-04T00:00:00.000Z",22,FALSE,14,117,"F-C",14,14,"Los Angeles Lakers","Anthony Davis",7,41,44,31,16,65.1
2,0,2,5,3,11,7,4,3,"34",0,0,20,2,2,1,1037673,"2023-11-04T00:00:00.000Z",22,FALSE,14,17553995,"G",14,14,"Los Angeles Lakers","Austin Reaves",2,22,24,22,4,30.4
4,0,2,10,1,17,4,2,2,"35",2,2,11,4,0,1,1037673,"2023-11-04T00:00:00.000Z",22,FALSE,14,405,"G",14,14,"Los Angeles Lakers","D'Angelo Russell",0,15,19,15,8,20.8
2,2,2,5,2,6,2,0,0,"30",0,3,6,2,1,3,1037673,"2023-11-04T00:00:00.000Z",22,FALSE,14,486,"F",14,14,"Los Angeles Lakers","Christian Wood",3,8,10,8,4,17.4
2,1,3,3,1,28,12,2,1,"33",2,1,26,5,1,1,1037673,"2023-11-04T00:00:00.000Z",22,FALSE,14,17896026,"F",22,22,"Orlando Magic","Franz Wagner",2,31,33,28,7,40
10,1,6,4,2,15,9,7,5,"34",1,2,25,7,1,4,1037673,"2023-11-04T00:00:00.000Z",22,FALSE,14,38017683,"F",22,22,"Orlando Magic","Paolo Banchero",2,32,42,35,17,50.4
2,5,6,1,0,6,3,4,4,"26",4,2,10,10,0,0,1037673,"2023-11-04T00:00:00.000Z",22,FALSE,14,666442,"C",22,22,"Orlando Magic","Goga Bitadze",5,20,22,12,12,40
5,1,5,2,0,11,4,1,1,"27",1,1,9,6,1,2,1037673,"2023-11-04T00:00:00.000Z",22,FALSE,14,17896073,"G",22,22,"Orlando Magic","Jalen Suggs",2,15,20,14,11,27.7
2,0,3,3,2,6,4,1,1,"30",1,2,11,4,1,0,1037673,"2023-11-04T00:00:00.000Z",22,FALSE,14,56677827,"G",22,22,"Orlando Magic","Anthony Black",1,15,17,13,6,21.8
1,0,2,5,3,9,4,3,3,"23",3,1,14,5,0,3,1037673,"2023-11-04T00:00:00.000Z",22,FALSE,14,3547251,"G",22,22,"Orlando Magic","Cole Anthony",0,19,20,15,6,18.5
1,0,1,0,0,0,0,0,0,"03",0,0,0,1,0,0,1037673,"2023-11-04T00:00:00.000Z",22,FALSE,14,38017724,"G",22,22,"Orlando Magic","Caleb Houstan",0,1,2,1,2,2.7
0,0,0,1,0,2,0,0,0,"03",1,0,0,1,0,0,1037673,"2023-11-04T00:00:00.000Z",22,FALSE,14,56677839,"G",22,22,"Orlando Magic","Jett Howard",0,1,1,0,1,1.2
3,0,3,5,2,6,2,1,1,"25",0,2,7,3,1,2,1037673,"2023-11-04T00:00:00.000Z",22,FALSE,14,226,"F",22,22,"Orlando Magic","Joe Ingles",1,10,13,10,6,16.1
0,1,0,2,0,3,0,0,0,"11",0,2,0,0,0,1,1037673,"2023-11-04T00:00:00.000Z",22,FALSE,14,229,"F",22,22,"Orlando Magic","Jonathan Isaac",1,0,0,0,0,2
1,0,0,1,0,1,0,0,0,"03",1,0,0,1,0,0,1037673,"2023-11-04T00:00:00.000Z",22,FALSE,14,666818,"F",22,22,"Orlando Magic","Chuma Okeke",0,1,2,1,2,2.7
0,0,0,3,1,4,2,0,0,"03",0,0,5,0,0,0,1037673,"2023-11-04T00:00:00.000Z",22,FALSE,14,666885,"F",22,22,"Orlando Magic","Admiral Schofield",0,5,5,5,0,5
2,0,3,3,1,10,6,0,0,"19",5,5,13,8,1,2,1037673,"2023-11-04T00:00:00.000Z",22,FALSE,14,462,"C",22,22,"Orlando Magic","Moritz Wagner",1,21,23,15,10,26.6
0,0,0,0,0,0,0,0,0,"00",0,0,0,0,0,0,1037673,"2023-11-04T00:00:00.000Z",22,FALSE,14,85,"F",22,22,"Orlando Magic","Wendell Carter Jr.",0,0,0,0,0,0
0,0,0,0,0,0,0,0,0,"00",0,0,0,0,0,0,1037673,"2023-11-04T00:00:00.000Z",22,FALSE,14,165,"G",22,22,"Orlando Magic","Markelle Fultz",0,0,0,0,0,0
0,0,0,0,0,1,0,0,0,"04",0,0,0,0,0,0,1037673,"2023-11-04T00:00:00.000Z",22,FALSE,14,56677867,"F",14,14,"Los Angeles Lakers","Alex Fudge",0,0,0,0,0,0
0,0,0,2,0,2,0,0,0,"04",0,1,0,0,0,0,1037673,"2023-11-04T00:00:00.000Z",22,FALSE,14,56677868,"G",14,14,"Los Angeles Lakers","D'Moi Hodge",0,0,0,0,0,0
0,0,0,0,0,0,0,0,0,"04",0,0,0,0,0,1,1037673,"2023-11-04T00:00:00.000Z",22,FALSE,14,56677836,"F",14,14,"Los Angeles Lakers","Maxwell Lewis",0,0,0,0,0,-1
0,0,0,0,0,0,0,0,0,"00",0,0,0,0,0,0,1037673,"2023-11-04T00:00:00.000Z",22,FALSE,14,666609,"F",14,14,"Los Angeles Lakers","Rui Hachimura",0,0,0,0,0,0
0,0,0,0,0,0,0,0,0,"00",0,0,0,0,0,0,1037673,"2023-11-04T00:00:00.000Z",22,FALSE,14,56677835,"G",14,14,"Los Angeles Lakers","Jalen Hood-Schifino",0,0,0,0,0,0
0,0,0,0,0,0,0,0,0,"00",0,0,0,0,0,0,1037673,"2023-11-04T00:00:00.000Z",22,FALSE,14,383,"F",14,14,"Los Angeles Lakers","Taurean Prince",0,0,0,0,0,0
0,0,0,0,0,0,0,0,0,"00",0,0,0,0,0,0,1037673,"2023-11-04T00:00:00.000Z",22,FALSE,14,457,"F",14,14,"Los Angeles Lakers","Jarred Vanderbilt",0,0,0,0,0,0
0,0,1,0,0,1,1,0,0,"04",0,0,2,1,0,0,1037673,"2023-11-04T00:00:00.000Z",22,FALSE,14,56677738,"C",14,14,"Los Angeles Lakers","Colin Castleton",0,3,3,2,1,3.2
0,0,5,2,0,7,3,0,0,"23",0,2,6,5,0,1,1037673,"2023-11-04T00:00:00.000Z",22,FALSE,14,38017697,"G",14,14,"Los Angeles Lakers","Max Christie",0,11,11,6,5,11
1,1,0,0,0,4,1,0,0,"11",1,3,2,1,0,2,1037673,"2023-11-04T00:00:00.000Z",22,FALSE,14,666626,"C",14,14,"Los Angeles Lakers","Jaxson Hayes",1,3,4,3,2,5.7
0,0,0,0,0,0,0,0,0,"00",0,0,0,0,0,0,1037673,"2023-11-04T00:00:00.000Z",22,FALSE,14,1603383,"G",14,14,"Los Angeles Lakers","Gabe Vincent",0,0,0,0,0,0
2,2,2,10,2,14,4,0,0,"21",3,1,10,5,1,0,1037674,"2023-11-04T00:00:00.000Z",19,FALSE,1,53,"G",1,1,"Atlanta Hawks","Bogdan Bogdanovic",3,15,17,12,7,28
0,0,0,0,0,0,0,0,0,"00",0,0,0,0,0,0,1037674,"2023-11-04T00:00:00.000Z",19,FALSE,1,666564,"F",1,1,"Atlanta Hawks","Bruno Fernando",0,0,0,0,0,0
0,0,0,0,0,0,0,0,0,"00",0,0,0,0,0,0,1037674,"2023-11-04T00:00:00.000Z",19,FALSE,1,3547297,"G",1,1,"Atlanta Hawks","Trent Forrest",0,0,0,0,0,0
0,0,0,0,0,0,0,0,0,"00",0,0,0,0,0,0,1037674,"2023-11-04T00:00:00.000Z",19,FALSE,1,38017689,"F",1,1,"Atlanta Hawks","AJ Griffin",0,0,0,0,0,0
0,0,0,0,0,0,0,0,0,"00",0,0,0,0,0,0,1037674,"2023-11-04T00:00:00.000Z",19,FALSE,1,56677806,"F",1,1,"Atlanta Hawks","Mouhamed Gueye",0,0,0,0,0,0
0,0,0,0,0,0,0,0,0,"03",0,1,0,0,0,0,1037674,"2023-11-04T00:00:00.000Z",19,FALSE,1,666754,"G",1,1,"Atlanta Hawks","Garrison Mathews",0,0,0,0,0,0
0,0,0,0,0,0,0,0,0,"00",0,0,0,0,0,0,1037674,"2023-11-04T00:00:00.000Z",19,FALSE,1,319,"G",1,1,"Atlanta Hawks","Patty Mills",0,0,0,0,0,0
0,1,4,3,2,6,4,8,7,"20",2,0,17,6,1,0,1037674,"2023-11-04T00:00:00.000Z",19,FALSE,1,3547244,"F-C",1,1,"Atlanta Hawks","Onyeka Okongwu",2,23,23,17,6,30.2
3,1,6,3,1,10,6,3,3,"32",1,1,16,7,0,1,1037674,"2023-11-04T00:00:00.000Z",19,FALSE,1,227,"F",19,19,"New Orleans Pelicans","Brandon Ingram",1,23,26,19,10,30.9
3,0,3,0,0,16,9,10,7,"32",2,2,25,5,0,0,1037674,"2023-11-04T00:00:00.000Z",19,FALSE,1,666969,"F",19,19,"New Orleans Pelicans","Zion Williamson",0,30,33,28,8,35.5
0,1,5,0,0,6,3,0,0,"21",2,1,6,7,1,3,1037674,"2023-11-04T00:00:00.000Z",19,FALSE,1,455,"C",19,19,"New Orleans Pelicans","Jonas Valanciunas",2,13,13,6,7,17.4
1,1,1,5,1,13,6,0,0,"33",1,1,13,2,3,3,1037674,"2023-11-04T00:00:00.000Z",19,FALSE,1,17896024,"F",19,19,"New Orleans Pelicans","Herbert Jones",4,15,16,14,3,25.9
6,2,1,6,1,12,5,3,2,"33",0,3,13,1,2,0,1037674,"2023-11-04T00:00:00.000Z",19,FALSE,1,303,"G",19,19,"New Orleans Pelicans","CJ McCollum",4,14,20,19,7,35.2
4,0,0,2,0,3,0,0,0,"10",0,1,0,0,1,0,1037674,"2023-11-04T00:00:00.000Z",19,FALSE,1,3547260,"G",19,19,"New Orleans Pelicans","Kira Lewis Jr.",1,0,4,4,4,9
2,0,1,7,2,13,5,0,0,"26",4,2,12,5,1,0,1037674,"2023-11-04T00:00:00.000Z",19,FALSE,1,3547256,"F",1,1,"Atlanta Hawks","Saddiq Bey",1,17,19,14,7,24
0,0,0,0,0,0,0,0,0,"00",0,0,0,0,0,0,1037674,"2023-11-04T00:00:00.000Z",19,FALSE,1,56677838,"G",1,1,"Atlanta Hawks","Kobe Bufkin",0,0,0,0,0,0
0,0,0,0,0,0,0,0,0,"00",0,0,0,0,0,0,1037674,"2023-11-04T00:00:00.000Z",19,FALSE,1,56677855,"G",1,1,"Atlanta Hawks","Seth Lundy",0,0,0,0,0,0
0,0,0,0,0,0,0,0,0,"00",0,0,0,0,0,0,1037674,"2023-11-04T00:00:00.000Z",19,FALSE,1,301,"G-F",1,1,"Atlanta Hawks","Wesley Matthews",0,0,0,0,0,0
0,0,0,0,0,0,0,0,0,"00",0,0,0,0,0,0,1037674,"2023-11-04T00:00:00.000Z",19,FALSE,1,56677875,"F",1,1,"Atlanta Hawks","Miles Norris",0,0,0,0,0,0
0,0,5,8,4,11,5,1,1,"24",0,3,15,5,1,1,1037674,"2023-11-04T00:00:00.000Z",19,FALSE,1,56677837,"G",19,19,"New Orleans Pelicans","Jordan Hawkins",1,20,20,15,5,23
5,1,2,2,1,4,3,0,0,"22",1,0,7,3,1,0,1037674,"2023-11-04T00:00:00.000Z",19,FALSE,1,38017677,"G",19,19,"New Orleans Pelicans","Dyson Daniels",2,10,15,12,8,24.1
0,0,0,0,0,0,0,0,0,"01",0,0,0,0,0,0,1037674,"2023-11-04T00:00:00.000Z",19,FALSE,1,38017663,"F",19,19,"New Orleans Pelicans","E.J. Liddell",0,0,0,0,0,0
1,0,1,3,0,4,1,2,2,"17",1,2,4,2,0,1,1037674,"2023-11-04T00:00:00.000Z",19,FALSE,1,17896017,"F",19,19,"New Orleans Pelicans","Matt Ryan",0,6,7,5,3,6.9
0,0,0,0,0,0,0,0,0,"00",0,0,0,0,0,0,1037674,"2023-11-04T00:00:00.000Z",19,FALSE,1,491,"C",19,19,"New Orleans Pelicans","Cody Zeller",0,0,0,0,0,0
0,0,0,0,0,0,0,0,0,"00",0,0,0,0,0,0,1037674,"2023-11-04T00:00:00.000Z",19,FALSE,1,17896097,"G",19,19,"New Orleans Pelicans","Jose Alvarado",0,0,0,0,0,0
0,0,0,0,0,0,0,0,0,"00",0,0,0,0,0,0,1037674,"2023-11-04T00:00:00.000Z",19,FALSE,1,3547293,"F",19,19,"New Orleans Pelicans","Naji Marshall",0,0,0,0,0,0
0,0,0,0,0,0,0,0,0,"00",0,0,0,0,0,0,1037674,"2023-11-04T00:00:00.000Z",19,FALSE,1,18677986,"F",19,19,"New Orleans Pelicans","Trey Murphy III",0,0,0,0,0,0
0,0,0,0,0,0,0,0,0,"00",0,0,0,0,0,0,1037674,"2023-11-04T00:00:00.000Z",19,FALSE,1,17896021,"F",19,19,"New Orleans Pelicans","Jeremiah Robinson-Earl",0,0,0,0,0,0
0,0,0,0,0,0,0,0,0,"00",0,0,0,0,0,0,1037674,"2023-11-04T00:00:00.000Z",19,FALSE,1,38017726,"G",19,19,"New Orleans Pelicans","Dereon Seabron",0,0,0,0,0,0
1,0,4,2,1,3,1,2,1,"30",1,3,4,5,0,2,1037674,"2023-11-04T00:00:00.000Z",19,FALSE,1,666656,"F",1,1,"Atlanta Hawks","De'Andre Hunter",0,9,10,5,6,9.5
4,0,9,3,2,13,8,4,3,"36",2,3,21,11,0,1,1037674,"2023-11-04T00:00:00.000Z",19,FALSE,1,17896040,"F",1,1,"Atlanta Hawks","Jalen Johnson",0,32,36,25,15,39.2
0,2,5,0,0,9,8,2,1,"28",2,2,17,7,0,0,1037674,"2023-11-04T00:00:00.000Z",19,FALSE,1,83,"C",1,1,"Atlanta Hawks","Clint Capela",2,24,24,17,7,31.4
7,0,6,9,2,20,8,2,2,"37",2,1,20,8,0,3,1037674,"2023-11-04T00:00:00.000Z",19,FALSE,1,334,"G",1,1,"Atlanta Hawks","Dejounte Murray",0,28,35,27,15,37.1
12,0,2,7,3,15,7,6,5,"39",3,3,22,5,1,5,1037674,"2023-11-04T00:00:00.000Z",19,FALSE,1,490,"G",1,1,"Atlanta Hawks","Trae Young",1,27,39,34,17,44
1,0,2,2,0,5,2,2,2,"15",1,1,6,3,0,0,1037674,"2023-11-04T00:00:00.000Z",19,FALSE,1,340,"F",19,19,"New Orleans Pelicans","Larry Nance Jr.",0,9,10,7,4,11.1
4,1,4,11,4,20,7,1,1,"38",2,4,19,6,1,0,1037675,"2023-11-04T00:00:00.000Z",3,FALSE,2,61,"F",3,3,"Brooklyn Nets","Mikal Bridges",2,25,29,23,10,38.2
3,1,3,13,2,15,2,0,0,"37",1,4,6,4,1,0,1037675,"2023-11-04T00:00:00.000Z",3,FALSE,2,351,"F",3,3,"Brooklyn Nets","Royce O'Neale",2,10,13,9,7,21.3
1,0,4,9,4,10,5,0,0,"37",4,3,14,8,0,0,1037675,"2023-11-04T00:00:00.000Z",3,FALSE,2,158,"F",3,3,"Brooklyn Nets","Dorian Finney-Smith",0,22,23,15,9,25.1
3,1,5,6,2,24,11,3,3,"37",0,2,27,5,1,0,1037675,"2023-11-04T00:00:00.000Z",3,FALSE,2,17896048,"G",3,3,"Brooklyn Nets","Cam Thomas",2,32,35,30,8,43.5
6,0,6,7,3,14,8,3,0,"35",0,1,19,6,0,1,1037675,"2023-11-04T00:00:00.000Z",3,FALSE,2,130,"G",3,3,"Brooklyn Nets","Spencer Dinwiddie",0,25,31,25,12,34.2
1,2,1,4,1,5,2,0,0,"15",0,3,5,1,1,1,1037675,"2023-11-04T00:00:00.000Z",3,FALSE,2,421,"G",3,3,"Brooklyn Nets","Dennis Smith Jr.",3,6,7,6,2,15.7
1,0,3,2,1,8,5,2,2,"17",0,0,13,3,0,1,1037675,"2023-11-04T00:00:00.000Z",3,FALSE,2,464,"G",3,3,"Brooklyn Nets","Lonnie Walker IV",0,16,17,14,4,17.1
0,0,0,0,0,0,0,0,0,"00",0,0,0,0,0,0,1037675,"2023-11-04T00:00:00.000Z",3,FALSE,2,666508,"F-C",3,3,"Brooklyn Nets","Nicolas Claxton",0,0,0,0,0,0
0,0,0,0,0,0,0,0,0,"00",0,0,0,0,0,0,1037675,"2023-11-04T00:00:00.000Z",3,FALSE,2,56677843,"F",3,3,"Brooklyn Nets","Noah Clowney",0,0,0,0,0,0
0,0,0,0,0,0,0,0,0,"00",0,0,0,0,0,0,1037675,"2023-11-04T00:00:00.000Z",3,FALSE,2,666679,"F",3,3,"Brooklyn Nets","Cameron Johnson",0,0,0,0,0,0
0,0,0,0,0,0,0,0,0,"00",0,0,0,0,0,0,1037675,"2023-11-04T00:00:00.000Z",3,FALSE,2,17896041,"G",3,3,"Brooklyn Nets","Keon Johnson",0,0,0,0,0,0
0,0,0,0,0,0,0,0,0,"00",0,0,0,0,0,0,1037675,"2023-11-04T00:00:00.000Z",3,FALSE,2,417,"G-F",3,3,"Brooklyn Nets","Ben Simmons",0,0,0,0,0,0
0,0,0,0,0,0,0,0,0,"00",0,0,0,0,0,0,1037675,"2023-11-04T00:00:00.000Z",3,FALSE,2,56677841,"F",3,3,"Brooklyn Nets","Dariq Whitehead",0,0,0,0,0,0
1,0,10,10,6,20,10,6,6,"41",1,1,32,11,0,3,1037675,"2023-11-04T00:00:00.000Z",3,FALSE,2,434,"F",2,2,"Boston Celtics","Jayson Tatum",0,43,44,33,12,43.7
3,1,5,3,0,7,4,0,0,"30",2,1,8,7,1,0,1037675,"2023-11-04T00:00:00.000Z",3,FALSE,2,219,"C-F",2,2,"Boston Celtics","Al Horford",2,15,18,11,10,26.9
1,3,5,2,1,10,8,8,5,"30",2,2,22,7,0,1,1037675,"2023-11-04T00:00:00.000Z",3,FALSE,2,378,"F-C",2,2,"Boston Celtics","Kristaps Porzingis",3,29,30,23,8,39.9
0,0,1,2,1,3,2,0,0,"19",0,3,5,1,2,1,1037675,"2023-11-04T00:00:00.000Z",3,FALSE,2,17896060,"F",2,2,"Boston Celtics","Sam Hauser",2,6,6,5,1,11.2
1,0,2,4,1,4,1,2,2,"11",1,0,5,3,0,0,1037675,"2023-11-04T00:00:00.000Z",3,FALSE,2,666468,"F",2,2,"Boston Celtics","Oshae Brissett",0,8,9,6,4,10.1
0,0,0,0,0,0,0,0,0,"00",0,0,0,0,0,0,1037675,"2023-11-04T00:00:00.000Z",3,FALSE,2,17896094,"G",2,2,"Boston Celtics","Dalano Banton",0,0,0,0,0,0
0,0,7,0,0,5,5,1,1,"15",0,3,11,7,1,0,1037675,"2023-11-04T00:00:00.000Z",3,FALSE,2,261,"F-C",2,2,"Boston Celtics","Luke Kornet",1,18,18,11,7,22.4
0,0,0,0,0,0,0,0,0,"00",0,0,0,0,0,0,1037675,"2023-11-04T00:00:00.000Z",3,FALSE,2,338,"G",2,2,"Boston Celtics","Svi Mykhailiuk",0,0,0,0,0,0
0,0,0,0,0,0,0,0,0,"00",0,0,0,0,0,0,1037675,"2023-11-04T00:00:00.000Z",3,FALSE,2,3547279,"F",2,2,"Boston Celtics","Lamar Stevens",0,0,0,0,0,0
0,0,0,0,0,0,0,0,0,"00",0,0,0,0,0,0,1037675,"2023-11-04T00:00:00.000Z",3,FALSE,2,38017707,"G",2,2,"Boston Celtics","JD Davison",0,0,0,0,0,0
2,0,2,0,0,0,0,0,0,"05",0,1,0,2,0,0,1037675,"2023-11-04T00:00:00.000Z",3,FALSE,2,17896058,"F",3,3,"Brooklyn Nets","Trendon Watford",0,2,4,2,4,5.4
1,0,4,0,0,4,3,8,5,"17",3,3,11,7,0,2,1037675,"2023-11-04T00:00:00.000Z",3,FALSE,2,17896038,"C",3,3,"Brooklyn Nets","Day'Ron Sharpe",0,18,19,12,8,18.9
0,0,0,0,0,0,0,0,0,"01",0,0,0,0,0,0,1037675,"2023-11-04T00:00:00.000Z",3,FALSE,2,9051997,"G",3,3,"Brooklyn Nets","Armoni Brooks",0,0,0,0,0,0
0,0,0,0,0,0,0,0,0,"00",0,0,0,0,0,0,1037675,"2023-11-04T00:00:00.000Z",3,FALSE,2,174,"F-C",3,3,"Brooklyn Nets","Harry Giles III",0,0,0,0,0,0
0,0,0,0,0,0,0,0,0,"01",0,0,0,0,0,0,1037675,"2023-11-04T00:00:00.000Z",3,FALSE,2,56677722,"F",3,3,"Brooklyn Nets","Jalen Wilson",0,0,0,0,0,0
0,0,0,0,0,0,0,0,0,"00",0,0,0,0,0,0,1037675,"2023-11-04T00:00:00.000Z",3,FALSE,2,56677864,"G",2,2,"Boston Celtics","Jordan Walsh",0,0,0,0,0,0
0,0,0,0,0,0,0,0,0,"00",0,0,0,0,0,0,1037675,"2023-11-04T00:00:00.000Z",3,FALSE,2,473,"G",2,2,"Boston Celtics","Derrick White",0,0,0,0,0,0
0,0,0,0,0,0,0,0,0,"00",0,0,0,0,0,0,1037675,"2023-11-04T00:00:00.000Z",3,FALSE,2,3547295,"F-C",2,2,"Boston Celtics","Nathan Knight",0,0,0,0,0,0
0,0,0,0,0,0,0,0,0,"00",0,0,0,0,0,0,1037675,"2023-11-04T00:00:00.000Z",3,FALSE,2,17553967,"C",2,2,"Boston Celtics","Neemias Queta",0,0,0,0,0,0
4,1,5,11,2,22,7,8,7,"35",0,4,23,5,0,2,1037675,"2023-11-04T00:00:00.000Z",3,FALSE,2,70,"G",2,2,"Boston Celtics","Jaylen Brown",1,28,32,27,9,36
10,1,5,9,4,15,6,2,2,"40",4,1,18,9,0,3,1037675,"2023-11-04T00:00:00.000Z",3,FALSE,2,214,"G",2,2,"Boston Celtics","Jrue Holiday",1,27,37,28,19,43.8
2,0,0,4,0,4,0,0,0,"19",0,2,0,0,0,1,1037675,"2023-11-04T00:00:00.000Z",3,FALSE,2,3547276,"G",2,2,"Boston Celtics","Payton Pritchard",0,0,2,2,2,2
1,0,6,4,2,14,9,6,6,"38",3,0,26,9,1,1,1037676,"2023-11-04T00:00:00.000Z",11,FALSE,26,66,"G-F",11,11,"Houston Rockets","Dillon Brooks",1,35,36,27,10,40.3
0,1,8,6,3,15,9,0,0,"35",3,4,21,11,0,0,1037676,"2023-11-04T00:00:00.000Z",11,FALSE,26,38017684,"F",11,11,"Houston Rockets","Jabari Smith Jr.",1,32,32,21,11,37.2
6,0,9,3,1,13,7,0,0,"34",0,2,15,9,2,2,1037676,"2023-11-04T00:00:00.000Z",11,FALSE,26,17896062,"F-C",11,11,"Houston Rockets","Alperen Sengun",2,24,30,21,15,38.8
5,0,2,2,0,10,4,7,2,"36",0,1,10,2,0,3,1037676,"2023-11-04T00:00:00.000Z",11,FALSE,26,17895966,"G",11,11,"Houston Rockets","Jalen Green",0,12,17,15,7,16.9
12,2,6,14,4,22,7,3,3,"36",0,4,21,6,0,2,1037676,"2023-11-04T00:00:00.000Z",11,FALSE,26,458,"G",11,11,"Houston Rockets","Fred VanVleet",2,27,39,33,18,50.2
1,0,4,3,3,6,4,0,0,"21",0,4,11,4,0,0,1037676,"2023-11-04T00:00:00.000Z",11,FALSE,26,3547301,"F",11,11,"Houston Rockets","Jae'Sean Tate",0,15,16,12,5,17.3
0,0,2,2,0,4,0,0,0,"19",1,1,0,3,0,1,1037676,"2023-11-04T00:00:00.000Z",11,FALSE,26,213,"G",11,11,"Houston Rockets","Aaron Holiday",0,3,3,0,3,2.6
0,0,2,4,1,7,2,0,0,"18",1,1,5,3,0,3,1037676,"2023-11-04T00:00:00.000Z",11,FALSE,26,56677845,"G",26,26,"Sacramento Kings","Colby Jones",0,8,8,5,3,5.6
0,0,0,0,0,0,0,0,0,"00",0,0,0,0,0,0,1037676,"2023-11-04T00:00:00.000Z",11,FALSE,26,56677862,"F",26,26,"Sacramento Kings","Jalen Slawson",0,0,0,0,0,0
0,0,4,1,0,9,5,2,2,"15",2,0,12,6,0,0,1037676,"2023-11-04T00:00:00.000Z",11,FALSE,26,306,"C",26,26,"Sacramento Kings","JaVale McGee",0,18,18,12,6,19.2
3,0,2,1,0,1,0,0,0,"12",1,1,0,3,1,0,1037676,"2023-11-04T00:00:00.000Z",11,FALSE,26,19465326,"C",11,11,"Houston Rockets","Jock Landale",1,3,6,3,6,11.1
0,0,0,0,0,0,0,0,0,"00",0,0,0,0,0,0,1037676,"2023-11-04T00:00:00.000Z",11,FALSE,26,75,"G-F",11,11,"Houston Rockets","Reggie Bullock",0,0,0,0,0,0
0,0,3,0,0,1,0,2,1,"06",2,0,1,5,0,1,1037676,"2023-11-04T00:00:00.000Z",11,FALSE,26,188,"F",11,11,"Houston Rockets","Jeff Green",0,6,6,1,5,6
0,0,0,0,0,0,0,0,0,"01",0,0,0,0,0,0,1037676,"2023-11-04T00:00:00.000Z",11,FALSE,26,3547281,"G-F",11,11,"Houston Rockets","Nate Hinton",0,0,0,0,0,0
0,0,0,0,0,0,0,0,0,"00",0,0,0,0,0,0,1037676,"2023-11-04T00:00:00.000Z",11,FALSE,26,296,"C",11,11,"Houston Rockets","Boban Marjanovic",0,0,0,0,0,0
0,0,0,1,0,1,0,2,2,"01",0,1,2,0,0,0,1037676,"2023-11-04T00:00:00.000Z",11,FALSE,26,56677809,"F",11,11,"Houston Rockets","Jermaine Samuels Jr.",0,2,2,2,0,2
0,0,1,0,0,0,0,0,0,"01",0,0,0,1,0,1,1037676,"2023-11-04T00:00:00.000Z",11,FALSE,26,56677831,"F",11,11,"Houston Rockets","Cam Whitmore",0,1,1,0,1,0.2
0,0,0,0,0,0,0,0,0,"00",0,0,0,0,0,0,1037676,"2023-11-04T00:00:00.000Z",11,FALSE,26,38017695,"F",11,11,"Houston Rockets","Tari Eason",0,0,0,0,0,0
0,0,0,0,0,0,0,0,0,"00",0,0,0,0,0,0,1037676,"2023-11-04T00:00:00.000Z",11,FALSE,26,357,"G",11,11,"Houston Rockets","Victor Oladipo",0,0,0,0,0,0
0,0,0,0,0,0,0,0,0,"00",0,0,0,0,0,0,1037676,"2023-11-04T00:00:00.000Z",11,FALSE,26,56677825,"G-F",11,11,"Houston Rockets","Amen Thompson",0,0,0,0,0,0
0,0,0,0,0,0,0,0,0,"00",0,0,0,0,0,0,1037676,"2023-11-04T00:00:00.000Z",11,FALSE,26,47738533,"G",11,11,"Houston Rockets","Jeenathan Williams",0,0,0,0,0,0
0,1,1,1,0,2,0,0,0,"11",0,3,0,1,1,0,1037676,"2023-11-04T00:00:00.000Z",11,FALSE,26,4197162,"F",26,26,"Sacramento Kings","Aleksandar Vezenkov",2,1,1,0,1,7.2
1,1,2,6,2,8,3,2,2,"26",0,4,10,2,1,0,1037676,"2023-11-04T00:00:00.000Z",11,FALSE,26,17896030,"G",26,26,"Sacramento Kings","Chris Duarte",2,12,13,11,3,19.9
0,0,0,0,0,0,0,0,0,"01",0,0,0,0,0,0,1037676,"2023-11-04T00:00:00.000Z",11,FALSE,26,17896044,"F",26,26,"Sacramento Kings","Kessler Edwards",0,0,0,0,0,0
0,0,0,1,0,1,0,0,0,"01",0,1,0,0,1,0,1037676,"2023-11-04T00:00:00.000Z",11,FALSE,26,38017714,"G",26,26,"Sacramento Kings","Keon Ellis",1,0,0,0,0,3
0,0,0,0,0,0,0,2,2,"01",0,0,2,0,0,0,1037676,"2023-11-04T00:00:00.000Z",11,FALSE,26,17895990,"G",26,26,"Sacramento Kings","Jordan Ford",0,2,2,2,0,2
0,0,1,0,0,0,0,0,0,"03",0,0,0,1,0,0,1037676,"2023-11-04T00:00:00.000Z",11,FALSE,26,273,"C",26,26,"Sacramento Kings","Alex Len",0,1,1,0,1,1.2
0,0,0,0,0,0,0,0,0,"00",0,0,0,0,0,0,1037676,"2023-11-04T00:00:00.000Z",11,FALSE,26,17895941,"C",26,26,"Sacramento Kings","Filip Petrusev",0,0,0,0,0,0
0,0,3,4,3,7,3,5,4,"32",0,0,13,3,0,0,1037676,"2023-11-04T00:00:00.000Z",11,FALSE,26,30,"F",26,26,"Sacramento Kings","Harrison Barnes",0,16,16,13,3,16.6
1,0,2,8,1,12,3,0,0,"33",0,1,7,2,0,0,1037676,"2023-11-04T00:00:00.000Z",11,FALSE,26,38017688,"F",26,26,"Sacramento Kings","Keegan Murray",0,9,10,8,3,10.9
4,2,12,2,0,10,5,4,1,"31",3,2,11,15,1,5,1037676,"2023-11-04T00:00:00.000Z",11,FALSE,26,406,"F",26,26,"Sacramento Kings","Domantas Sabonis",3,26,30,15,19,39
2,0,2,3,0,8,2,0,0,"16",2,3,4,4,1,1,1037676,"2023-11-04T00:00:00.000Z",11,FALSE,26,221,"G",26,26,"Sacramento Kings","Kevin Huerter",1,8,10,6,6,13.8
5,1,3,4,1,7,3,0,0,"26",0,3,7,3,0,1,1037676,"2023-11-04T00:00:00.000Z",11,FALSE,26,17553994,"G",26,26,"Sacramento Kings","Davion Mitchell",1,10,15,12,8,20.1
7,1,3,7,3,13,6,4,3,"26",0,1,18,3,0,1,1037676,"2023-11-04T00:00:00.000Z",11,FALSE,26,324,"G",26,26,"Sacramento Kings","Malik Monk",1,21,28,25,10,34.1
0,0,0,0,0,0,0,0,0,"00",0,0,0,0,0,0,1037676,"2023-11-04T00:00:00.000Z",11,FALSE,26,161,"G",26,26,"Sacramento Kings","De'Aaron Fox",0,0,0,0,0,0
0,0,0,0,0,0,0,0,0,"00",0,0,0,0,0,0,1037676,"2023-11-04T00:00:00.000Z",11,FALSE,26,290,"F",26,26,"Sacramento Kings","Trey Lyles",0,0,0,0,0,0
1,1,0,2,1,4,2,0,0,"20",0,6,5,0,1,0,1037677,"2023-11-04T00:00:00.000Z",18,FALSE,29,3547259,"F",18,18,"Minnesota Timberwolves","Jaden McDaniels",2,5,6,6,1,12.5
1,0,7,6,2,14,7,10,9,"32",0,4,25,7,2,2,1037677,"2023-11-04T00:00:00.000Z",18,FALSE,29,447,"C",18,18,"Minnesota Timberwolves","Karl-Anthony Towns",2,32,33,26,8,38.9
1,4,6,0,0,10,5,2,1,"28",4,3,11,10,0,1,1037677,"2023-11-04T00:00:00.000Z",18,FALSE,29,176,"C",18,18,"Minnesota Timberwolves","Rudy Gobert",4,21,22,12,11,35.5
6,0,8,4,2,19,13,5,3,"36",0,0,31,8,1,6,1037677,"2023-11-04T00:00:00.000Z",18,FALSE,29,3547238,"G",18,18,"Minnesota Timberwolves","Anthony Edwards",1,39,45,37,14,46.6
6,0,3,4,1,9,3,0,0,"28",0,4,7,3,1,0,1037677,"2023-11-04T00:00:00.000Z",18,FALSE,29,104,"G",18,18,"Minnesota Timberwolves","Mike Conley",1,10,16,13,9,22.6
1,3,2,1,0,3,0,1,0,"17",1,0,0,3,2,0,1037677,"2023-11-04T00:00:00.000Z",18,FALSE,29,666400,"G",18,18,"Minnesota Timberwolves","Nickeil Alexander-Walker",5,3,4,1,4,20.1
6,2,2,0,0,6,5,2,2,"27",1,3,12,3,1,0,1037677,"2023-11-04T00:00:00.000Z",18,FALSE,29,12,"F",18,18,"Minnesota Timberwolves","Kyle Anderson",3,15,21,18,9,33.6
0,0,2,0,0,1,1,0,0,"04",0,0,2,2,0,0,1037677,"2023-11-04T00:00:00.000Z",18,FALSE,29,68,"F",18,18,"Minnesota Timberwolves","Troy Brown Jr.",0,4,4,2,2,4.4
1,0,0,0,0,0,0,0,0,"04",0,1,0,0,0,0,1037677,"2023-11-04T00:00:00.000Z",18,FALSE,29,666767,"G",18,18,"Minnesota Timberwolves","Jordan McLaughlin",0,0,1,1,1,1.5
0,1,1,2,0,4,2,4,4,"15",1,2,8,2,1,0,1037677,"2023-11-04T00:00:00.000Z",18,FALSE,29,320,"G",18,18,"Minnesota Timberwolves","Shake Milton",2,10,10,8,2,16.4
1,0,0,0,0,1,1,3,2,"04",0,0,4,0,0,0,1037677,"2023-11-04T00:00:00.000Z",18,FALSE,29,38017715,"F",18,18,"Minnesota Timberwolves","Josh Minott",0,4,5,5,1,5.5
0,0,0,0,0,1,1,0,0,"03",0,0,2,0,1,0,1037677,"2023-11-04T00:00:00.000Z",18,FALSE,29,17895968,"F",18,18,"Minnesota Timberwolves","Daishen Nix",1,2,2,2,0,5
1,0,3,5,3,9,5,4,3,"22",2,0,16,5,0,1,1037677,"2023-11-04T00:00:00.000Z",18,FALSE,29,667378,"F-C",18,18,"Minnesota Timberwolves","Naz Reid",0,21,22,17,6,22.5
0,0,0,0,0,0,0,0,0,"00",0,0,0,0,0,0,1037677,"2023-11-04T00:00:00.000Z",18,FALSE,29,56677851,"G",18,18,"Minnesota Timberwolves","Jaylen Clark",0,0,0,0,0,0
0,0,0,0,0,0,0,0,0,"00",0,0,0,0,0,0,1037677,"2023-11-04T00:00:00.000Z",18,FALSE,29,17896056,"C",18,18,"Minnesota Timberwolves","Luka Garza",0,0,0,0,0,0
0,0,0,0,0,0,0,0,0,"00",0,0,0,0,0,0,1037677,"2023-11-04T00:00:00.000Z",18,FALSE,29,56677782,"F",18,18,"Minnesota Timberwolves","Leonard Miller",0,0,0,0,0,0
0,0,0,0,0,0,0,0,0,"00",0,0,0,0,0,0,1037677,"2023-11-04T00:00:00.000Z",18,FALSE,29,38017700,"G",18,18,"Minnesota Timberwolves","Wendell Moore Jr.",0,0,0,0,0,0
1,1,4,11,4,20,7,5,4,"35",4,4,22,8,0,2,1037677,"2023-11-04T00:00:00.000Z",18,FALSE,29,297,"F",29,29,"Utah Jazz","Lauri Markkanen",1,30,31,23,9,34.1
0,1,4,5,1,10,5,4,3,"29",2,5,14,6,1,2,1037677,"2023-11-04T00:00:00.000Z",18,FALSE,29,101,"F-C",29,29,"Utah Jazz","John Collins",2,20,20,14,6,25.2
0,3,3,0,0,3,2,0,0,"22",1,0,4,4,0,0,1037677,"2023-11-04T00:00:00.000Z",18,FALSE,29,38017705,"C",29,29,"Utah Jazz","Walker Kessler",3,8,8,4,4,17.8
3,0,1,5,0,14,5,0,0,"32",2,0,10,3,0,0,1037677,"2023-11-04T00:00:00.000Z",18,FALSE,29,100,"G",29,29,"Utah Jazz","Jordan Clarkson",0,13,16,13,6,18.1
5,1,2,6,2,20,6,0,0,"24",2,1,14,4,2,2,1037677,"2023-11-04T00:00:00.000Z",18,FALSE,29,666650,"G",29,29,"Utah Jazz","Talen Horton-Tucker",3,18,23,19,9,33.3
1,0,2,2,0,4,0,0,0,"18",2,4,0,4,0,2,1037677,"2023-11-04T00:00:00.000Z",18,FALSE,29,358,"F",29,29,"Utah Jazz","Kelly Olynyk",0,4,5,1,5,4.3
1,0,0,4,2,5,3,1,0,"17",2,1,8,2,0,0,1037677,"2023-11-04T00:00:00.000Z",18,FALSE,29,38017620,"G",29,29,"Utah Jazz","Ochai Agbaji",0,10,11,9,3,11.9
0,0,0,0,0,0,0,0,0,"00",0,0,0,0,0,0,1037677,"2023-11-04T00:00:00.000Z",18,FALSE,29,139,"G",29,29,"Utah Jazz","Kris Dunn",0,0,0,0,0,0
4,0,0,4,1,6,3,2,1,"27",0,2,8,0,0,3,1037677,"2023-11-04T00:00:00.000Z",18,FALSE,29,56677834,"G",29,29,"Utah Jazz","Keyonte George",0,8,12,12,4,11
4,1,2,3,1,3,1,4,4,"19",2,2,7,4,0,6,1037677,"2023-11-04T00:00:00.000Z",18,FALSE,29,413,"G",29,29,"Utah Jazz","Collin Sexton",1,11,15,11,8,14.8
0,0,0,0,0,0,0,0,0,"00",0,0,0,0,0,0,1037677,"2023-11-04T00:00:00.000Z",18,FALSE,29,17896023,"G",29,29,"Utah Jazz","Josh Christopher",0,0,0,0,0,0
0,0,0,0,0,0,0,0,0,"00",0,0,0,0,0,0,1037677,"2023-11-04T00:00:00.000Z",18,FALSE,29,56677824,"F",29,29,"Utah Jazz","Taylor Hendricks",0,0,0,0,0,0
0,0,0,0,0,0,0,0,0,"00",0,0,0,0,0,0,1037677,"2023-11-04T00:00:00.000Z",18,FALSE,29,38017630,"G",29,29,"Utah Jazz","Johnny Juzang",0,0,0,0,0,0
0,0,0,0,0,0,0,0,0,"00",0,0,0,0,0,0,1037677,"2023-11-04T00:00:00.000Z",18,FALSE,29,19465584,"F",29,29,"Utah Jazz","Micah Potter",0,0,0,0,0,0
0,0,0,0,0,0,0,0,0,"00",0,0,0,0,0,0,1037677,"2023-11-04T00:00:00.000Z",18,FALSE,29,56677842,"F",29,29,"Utah Jazz","Brice Sensabaugh",0,0,0,0,0,0
0,0,2,1,1,3,2,0,0,"09",0,0,5,2,0,1,1037677,"2023-11-04T00:00:00.000Z",18,FALSE,29,38017739,"F",29,29,"Utah Jazz","Simone Fontecchio",0,7,7,5,2,6.4
0,0,2,1,0,2,1,1,1,"04",0,0,3,2,0,0,1037677,"2023-11-04T00:00:00.000Z",18,FALSE,29,666881,"F",29,29,"Utah Jazz","Luka Samanic",0,5,5,3,2,5.4
1,0,0,1,0,1,0,0,0,"04",0,1,0,0,0,0,1037677,"2023-11-04T00:00:00.000Z",18,FALSE,29,11891374,"C",29,29,"Utah Jazz","Omer Yurtseven",0,0,1,1,1,1.5
2,2,5,10,5,16,9,5,4,"31",1,4,27,6,1,2,1037678,"2023-11-04T00:00:00.000Z",8,FALSE,5,375,"F",8,8,"Denver Nuggets","Michael Porter Jr.",3,33,35,29,8,44.2
5,1,9,3,1,9,4,8,6,"35",3,2,15,12,2,3,1037678,"2023-11-04T00:00:00.000Z",8,FALSE,5,177,"F",8,8,"Denver Nuggets","Aaron Gordon",3,27,32,20,17,42.9
9,0,12,3,1,16,9,9,9,"33",4,3,28,16,3,1,1037678,"2023-11-04T00:00:00.000Z",8,FALSE,5,246,"C",8,8,"Denver Nuggets","Nikola Jokic",3,44,53,37,25,68.7
2,0,0,4,2,8,4,0,0,"30",0,1,10,0,1,1,1037678,"2023-11-04T00:00:00.000Z",8,FALSE,5,81,"G",8,8,"Denver Nuggets","Kentavious Caldwell-Pope",1,10,12,12,2,15
0,0,2,0,0,3,1,0,0,"10",0,0,2,2,0,0,1037678,"2023-11-04T00:00:00.000Z",8,FALSE,5,335,"G",8,8,"Denver Nuggets","Jamal Murray",0,4,4,2,2,4.4
4,0,4,3,1,8,4,2,1,"18",1,1,10,5,1,0,1037678,"2023-11-04T00:00:00.000Z",8,FALSE,5,38017709,"G",8,8,"Denver Nuggets","Christian Braun",1,15,19,14,9,25
3,1,1,5,3,10,6,2,1,"25",0,0,16,1,0,1,1037678,"2023-11-04T00:00:00.000Z",8,FALSE,5,236,"G",8,8,"Denver Nuggets","Reggie Jackson",1,17,20,19,4,23.7
1,0,0,0,0,0,0,2,1,"12",1,2,1,1,0,1,1037678,"2023-11-04T00:00:00.000Z",8,FALSE,5,250,"C",8,8,"Denver Nuggets","DeAndre Jordan",0,2,3,2,2,2.7
2,0,2,1,0,3,1,0,0,"18",0,2,2,2,2,2,1037678,"2023-11-04T00:00:00.000Z",8,FALSE,5,38017721,"G",8,8,"Denver Nuggets","Peyton Watson",2,4,6,4,4,11.4
0,0,0,0,0,0,0,0,0,"00",0,0,0,0,0,0,1037678,"2023-11-04T00:00:00.000Z",8,FALSE,5,17895983,"G",5,5,"Chicago Bulls","Ayo Dosunmu",0,0,0,0,0,0
0,0,0,0,0,0,0,0,0,"00",0,0,0,0,0,0,1037678,"2023-11-04T00:00:00.000Z",8,FALSE,5,45969255,"F",5,5,"Chicago Bulls","Justin Lewis",0,0,0,0,0,0
0,0,0,0,0,0,0,0,0,"00",0,0,0,0,0,0,1037678,"2023-11-04T00:00:00.000Z",8,FALSE,5,56677860,"F",5,5,"Chicago Bulls","Adama Sanogo",0,0,0,0,0,0
3,0,5,2,1,17,8,2,2,"30",2,3,19,7,0,2,1037678,"2023-11-04T00:00:00.000Z",8,FALSE,5,460,"C",5,5,"Chicago Bulls","Nikola Vucevic",0,26,29,22,10,29.9
4,0,4,5,1,12,4,4,3,"31",0,2,12,4,1,3,1037678,"2023-11-04T00:00:00.000Z",8,FALSE,5,268,"G",5,5,"Chicago Bulls","Zach LaVine",1,16,20,16,8,22.8
5,1,2,4,1,10,4,2,2,"31",0,2,11,2,2,2,1037678,"2023-11-04T00:00:00.000Z",8,FALSE,5,666956,"G",5,5,"Chicago Bulls","Coby White",3,13,18,16,7,27.9
0,0,0,0,0,0,0,0,0,"03",0,0,0,0,0,0,1037678,"2023-11-04T00:00:00.000Z",8,FALSE,5,56677874,"F",5,5,"Chicago Bulls","Onuralp Bitim",0,0,0,0,0,0
1,0,0,5,4,9,6,1,0,"18",0,2,16,0,0,1,1037678,"2023-11-04T00:00:00.000Z",8,FALSE,5,87,"G",5,5,"Chicago Bulls","Jevon Carter",0,16,17,17,1,16.5
2,0,0,2,0,3,1,1,1,"14",0,3,3,0,1,2,1037678,"2023-11-04T00:00:00.000Z",8,FALSE,5,89,"G",5,5,"Chicago Bulls","Alex Caruso",1,3,5,5,2,7
0,0,7,0,0,3,2,2,1,"15",4,1,5,11,1,0,1037678,"2023-11-04T00:00:00.000Z",8,FALSE,5,137,"C",5,5,"Chicago Bulls","Andre Drummond",1,16,16,5,11,21.2
0,0,0,0,0,0,0,0,0,"03",0,0,0,0,0,0,1037678,"2023-11-04T00:00:00.000Z",8,FALSE,5,56677857,"F",5,5,"Chicago Bulls","Julian Phillips",0,0,0,0,0,0
3,2,2,5,0,7,2,4,3,"28",1,0,7,3,1,1,1037678,"2023-11-04T00:00:00.000Z",8,FALSE,5,3547248,"F",5,5,"Chicago Bulls","Patrick Williams",3,10,13,10,6,23.1
2,0,1,3,1,4,2,0,0,"12",0,1,5,1,0,0,1037678,"2023-11-04T00:00:00.000Z",8,FALSE,5,38017727,"G",8,8,"Denver Nuggets","Collin Gillespie",0,6,8,7,3,9.2
0,0,0,0,0,0,0,0,0,"00",0,0,0,0,0,0,1037678,"2023-11-04T00:00:00.000Z",8,FALSE,5,215,"F-G",8,8,"Denver Nuggets","Justin Holiday",0,0,0,0,0,0
0,0,1,0,0,0,0,2,1,"03",0,1,1,1,0,0,1037678,"2023-11-04T00:00:00.000Z",8,FALSE,5,3547268,"F-C",8,8,"Denver Nuggets","Zeke Nnaji",0,2,2,1,1,2.2
0,0,0,1,1,1,1,0,0,"02",0,0,3,0,0,0,1037678,"2023-11-04T00:00:00.000Z",8,FALSE,5,56677582,"G",8,8,"Denver Nuggets","Jalen Pickett",0,3,3,3,0,3
1,0,1,2,1,2,1,0,0,"09",0,0,3,1,0,0,1037678,"2023-11-04T00:00:00.000Z",8,FALSE,5,56677776,"G",8,8,"Denver Nuggets","Julian Strawther",0,4,5,4,2,5.7
0,0,1,1,0,1,0,0,0,"02",0,1,0,1,0,0,1037678,"2023-11-04T00:00:00.000Z",8,FALSE,5,56677871,"F",8,8,"Denver Nuggets","Hunter Tyson",0,1,1,0,1,1.2
0,0,0,0,0,1,1,0,0,"03",0,0,2,0,0,0,1037678,"2023-11-04T00:00:00.000Z",8,FALSE,5,17896116,"G",5,5,"Chicago Bulls","Terry Taylor",0,2,2,2,0,2
1,0,1,1,0,2,1,2,0,"03",0,1,2,1,0,0,1037678,"2023-11-04T00:00:00.000Z",8,FALSE,5,38017719,"F",5,5,"Chicago Bulls","Dalen Terry",0,3,4,3,2,4.7
0,0,0,0,0,0,0,0,0,"00",0,0,0,0,0,0,1037678,"2023-11-04T00:00:00.000Z",8,FALSE,5,27,"G",5,5,"Chicago Bulls","Lonzo Ball",0,0,0,0,0,0
0,0,0,0,0,0,0,0,0,"00",0,0,0,0,0,0,1037678,"2023-11-04T00:00:00.000Z",8,FALSE,5,666489,"F",8,8,"Denver Nuggets","Vlatko Cancar",0,0,0,0,0,0
0,0,0,0,0,0,0,0,0,"00",0,0,0,0,0,0,1037678,"2023-11-04T00:00:00.000Z",8,FALSE,5,17896103,"F-C",8,8,"Denver Nuggets","Jay Huff",0,0,0,0,0,0
0,0,0,0,0,0,0,0,0,"00",0,0,0,0,0,0,1037678,"2023-11-04T00:00:00.000Z",8,FALSE,5,17896007,"G",8,8,"Denver Nuggets","Braxton Key",0,0,0,0,0,0
6,0,3,1,0,16,7,4,3,"34",0,4,17,3,0,0,1037678,"2023-11-04T00:00:00.000Z",8,FALSE,5,125,"G",5,5,"Chicago Bulls","DeMar DeRozan",0,20,26,23,9,29.6
3,0,4,1,0,6,3,1,1,"27",2,1,7,6,1,0,1037678,"2023-11-04T00:00:00.000Z",8,FALSE,5,110,"F",5,5,"Chicago Bulls","Torrey Craig",1,13,16,10,9,21.7
4,4,4,3,2,14,6,0,0,"38",5,3,14,9,4,1,1037679,"2023-11-05T00:00:00.000Z",9,FALSE,24,56677826,"G-F",9,9,"Detroit Pistons","Ausar Thompson",8,23,27,18,13,53.8
1,0,2,2,1,6,3,2,1,"34",0,0,8,2,0,3,1037679,"2023-11-05T00:00:00.000Z",9,FALSE,24,3547267,"F-C",9,9,"Detroit Pistons","Isaiah Stewart",0,10,11,9,3,8.9
3,0,8,0,0,10,6,0,0,"31",3,4,12,11,2,5,1037679,"2023-11-05T00:00:00.000Z",9,FALSE,24,38017694,"C",9,9,"Detroit Pistons","Jalen Duren",2,23,26,15,14,30.7
6,1,2,6,0,24,12,3,2,"39",1,2,26,3,0,6,1037679,"2023-11-05T00:00:00.000Z",9,FALSE,24,17896075,"G-F",9,9,"Detroit Pistons","Cade Cunningham",1,29,35,32,9,35.6
5,1,2,3,1,8,4,4,4,"34",0,4,13,2,0,0,1037679,"2023-11-05T00:00:00.000Z",9,FALSE,24,3547241,"G",9,9,"Detroit Pistons","Killian Hayes",1,15,20,18,7,25.9
1,0,1,0,0,5,3,5,5,"11",1,5,11,2,0,1,1037679,"2023-11-05T00:00:00.000Z",9,FALSE,24,24,"F",9,9,"Detroit Pistons","Marvin Bagley III",0,13,14,12,3,13.9
0,0,0,0,0,0,0,0,0,"03",0,0,0,0,0,0,1037679,"2023-11-05T00:00:00.000Z",9,FALSE,24,56677729,"G",9,9,"Detroit Pistons","Malcolm Cazalon",0,0,0,0,0,0
1,0,1,2,0,2,0,0,0,"13",0,1,0,1,0,0,1037679,"2023-11-05T00:00:00.000Z",9,FALSE,24,197,"F-G",9,9,"Detroit Pistons","Joe Harris",0,1,2,1,2,2.7
0,0,0,0,0,0,0,0,0,"00",0,0,0,0,0,0,1037679,"2023-11-05T00:00:00.000Z",9,FALSE,24,38017682,"G",9,9,"Detroit Pistons","Jaden Ivey",0,0,0,0,0,0
0,0,0,0,0,0,0,0,0,"03",0,0,0,0,0,0,1037679,"2023-11-05T00:00:00.000Z",9,FALSE,24,42097199,"G",9,9,"Detroit Pistons","Jared Rhoden",0,0,0,0,0,0
4,0,3,6,4,16,9,0,0,"30",0,3,22,3,1,0,1037679,"2023-11-05T00:00:00.000Z",9,FALSE,24,56677792,"G",9,9,"Detroit Pistons","Marcus Sasser",1,25,29,26,7,34.6
0,0,0,1,0,2,0,0,0,"04",0,1,0,0,0,0,1037679,"2023-11-05T00:00:00.000Z",9,FALSE,24,44477024,"G",9,9,"Detroit Pistons","Stanley Umude",0,0,0,0,0,0
0,0,1,0,0,0,0,0,0,"03",0,1,0,1,0,0,1037679,"2023-11-05T00:00:00.000Z",9,FALSE,24,3547095,"C-F",24,24,"Phoenix Suns","Udoka Azubuike",0,1,1,0,1,1.2
0,0,0,0,0,1,1,0,0,"03",0,0,2,0,0,0,1037679,"2023-11-05T00:00:00.000Z",9,FALSE,24,666451,"C",24,24,"Phoenix Suns","Bol Bol",0,2,2,2,0,2
1,3,2,0,0,5,4,0,0,"18",1,4,8,3,1,2,1037679,"2023-11-05T00:00:00.000Z",9,FALSE,24,147,"F",24,24,"Phoenix Suns","Drew Eubanks",4,11,12,9,4,23.1
0,0,0,0,0,0,0,0,0,"00",0,0,0,0,0,0,1037679,"2023-11-05T00:00:00.000Z",9,FALSE,24,3547240,"C",9,9,"Detroit Pistons","James Wiseman",0,0,0,0,0,0
0,0,0,0,0,0,0,0,0,"00",0,0,0,0,0,0,1037679,"2023-11-05T00:00:00.000Z",9,FALSE,24,54,"F",9,9,"Detroit Pistons","Bojan Bogdanovic",0,0,0,0,0,0
0,0,0,0,0,0,0,0,0,"00",0,0,0,0,0,0,1037679,"2023-11-05T00:00:00.000Z",9,FALSE,24,77,"G",9,9,"Detroit Pistons","Alec Burks",0,0,0,0,0,0
0,0,0,0,0,0,0,0,0,"00",0,0,0,0,0,0,1037679,"2023-11-05T00:00:00.000Z",9,FALSE,24,17896071,"F",9,9,"Detroit Pistons","Isaiah Livers",0,0,0,0,0,0
0,0,0,0,0,0,0,0,0,"00",0,0,0,0,0,0,1037679,"2023-11-05T00:00:00.000Z",9,FALSE,24,330,"G",9,9,"Detroit Pistons","Monte Morris",0,0,0,0,0,0
5,2,4,3,1,27,14,12,12,"34",0,1,41,4,1,3,1037679,"2023-11-05T00:00:00.000Z",9,FALSE,24,140,"F",24,24,"Phoenix Suns","Kevin Durant",3,45,50,46,9,59.3
1,1,4,1,0,3,0,0,0,"20",2,0,0,6,0,0,1037679,"2023-11-05T00:00:00.000Z",9,FALSE,24,32,"F",24,24,"Phoenix Suns","Keita Bates-Diop",1,6,7,1,7,11.7
7,3,1,1,0,4,1,6,4,"28",3,2,6,4,2,2,1037679,"2023-11-05T00:00:00.000Z",9,FALSE,24,349,"C",24,24,"Phoenix Suns","Jusuf Nurkic",5,10,17,13,11,34.3
3,1,7,4,2,7,2,2,2,"21",0,2,8,7,1,2,1037679,"2023-11-05T00:00:00.000Z",9,FALSE,24,18678058,"",24,24,"Phoenix Suns","Jordan Goodwin",2,15,18,11,10,24.9
0,0,0,0,0,3,2,0,0,"02",1,0,4,1,0,0,1037679,"2023-11-05T00:00:00.000Z",9,FALSE,24,3547298,"G",24,24,"Phoenix Suns","Saben Lee",0,5,5,4,1,5.2
0,0,0,0,0,0,0,0,0,"00",0,0,0,0,0,0,1037679,"2023-11-05T00:00:00.000Z",9,FALSE,24,666729,"F",24,24,"Phoenix Suns","Nassir Little",0,0,0,0,0,0
0,0,0,0,0,0,0,0,0,"02",0,0,0,0,0,0,1037679,"2023-11-05T00:00:00.000Z",9,FALSE,24,314,"F",24,24,"Phoenix Suns","Chimezie Metu",0,0,0,0,0,0
2,0,3,1,0,6,3,5,4,"29",4,1,10,7,2,2,1037679,"2023-11-05T00:00:00.000Z",9,FALSE,24,356,"G",24,24,"Phoenix Suns","Josh Okogie",2,17,19,12,9,25.4
0,0,1,3,1,4,2,1,1,"20",0,1,6,1,0,2,1037679,"2023-11-05T00:00:00.000Z",9,FALSE,24,470,"G",24,24,"Phoenix Suns","Yuta Watanabe",0,7,7,6,1,5.2
0,0,0,0,0,0,0,0,0,"00",0,0,0,0,0,0,1037679,"2023-11-05T00:00:00.000Z",9,FALSE,24,37,"G",24,24,"Phoenix Suns","Bradley Beal",0,0,0,0,0,0
0,0,0,0,0,0,0,0,0,"00",0,0,0,0,0,0,1037679,"2023-11-05T00:00:00.000Z",9,FALSE,24,57,"G",24,24,"Phoenix Suns","Devin Booker",0,0,0,0,0,0
0,0,0,0,0,0,0,0,0,"00",0,0,0,0,0,0,1037679,"2023-11-05T00:00:00.000Z",9,FALSE,24,272,"G",24,24,"Phoenix Suns","Damion Lee",0,0,0,0,0,0
2,0,3,3,1,12,6,1,1,"29",1,1,14,4,0,4,1037679,"2023-11-05T00:00:00.000Z",9,FALSE,24,8,"G",24,24,"Phoenix Suns","Grayson Allen",0,18,20,16,6,17.8
8,0,3,5,3,14,8,2,2,"31",2,0,21,5,1,1,1037679,"2023-11-05T00:00:00.000Z",9,FALSE,24,178,"G",24,24,"Phoenix Suns","Eric Gordon",1,26,34,29,13,41
3,0,5,4,2,18,11,2,2,"38",1,1,26,6,2,0,1037680,"2023-11-05T00:00:00.000Z",27,FALSE,28,666682,"F",27,27,"San Antonio Spurs","Keldon Johnson",2,32,35,29,9,43.7
4,5,7,7,2,16,7,5,4,"38",2,1,20,9,1,2,1037680,"2023-11-05T00:00:00.000Z",27,FALSE,28,56677822,"F-C",27,27,"San Antonio Spurs","Victor Wembanyama",6,29,33,24,13,52.8
5,1,9,6,1,17,8,6,4,"38",2,3,21,11,0,1,1037680,"2023-11-05T00:00:00.000Z",27,FALSE,28,102,"F-C",27,27,"San Antonio Spurs","Zach Collins",1,32,37,26,16,43.7
2,0,5,0,0,9,8,0,0,"25",1,4,16,6,0,1,1037680,"2023-11-05T00:00:00.000Z",27,FALSE,28,38017692,"F",27,27,"San Antonio Spurs","Malaki Branham",0,22,24,18,8,25.2
5,0,3,1,0,8,2,0,0,"29",1,1,4,4,3,3,1037680,"2023-11-05T00:00:00.000Z",27,FALSE,28,38017699,"F",27,27,"San Antonio Spurs","Jeremy Sochan",3,8,13,9,9,22.3
0,0,0,0,0,0,0,0,0,"00",0,0,0,0,0,0,1037680,"2023-11-05T00:00:00.000Z",27,FALSE,28,38017730,"F",27,27,"San Antonio Spurs","Dominick Barlow",0,0,0,0,0,0
0,0,1,0,0,1,1,0,0,"09",1,1,2,2,0,1,1037680,"2023-11-05T00:00:00.000Z",27,FALSE,28,17895854,"G",27,27,"San Antonio Spurs","Charles Bassey",0,4,4,2,2,3.4
0,0,0,2,0,3,1,0,0,"06",0,0,2,0,1,1,1037680,"2023-11-05T00:00:00.000Z",27,FALSE,28,38017649,"F",27,27,"San Antonio Spurs","Julian Champagnie",1,2,2,2,0,4
0,0,0,0,0,0,0,0,0,"00",0,0,0,0,0,0,1037680,"2023-11-05T00:00:00.000Z",27,FALSE,28,56677817,"G",27,27,"San Antonio Spurs","Sidy Cissoko",0,0,0,0,0,0
3,0,4,2,1,6,3,0,0,"26",0,4,7,4,0,2,1037680,"2023-11-05T00:00:00.000Z",27,FALSE,28,359,"F",27,27,"San Antonio Spurs","Cedi Osman",0,11,14,10,7,14.3
0,0,0,0,0,0,0,0,0,"00",0,0,0,0,0,0,1037680,"2023-11-05T00:00:00.000Z",27,FALSE,28,56677865,"C",27,27,"San Antonio Spurs","Charles Bediako",0,0,0,0,0,0
0,0,0,0,0,0,0,0,0,"00",0,0,0,0,0,0,1037680,"2023-11-05T00:00:00.000Z",27,FALSE,28,56677870,"G",27,27,"San Antonio Spurs","Sir'Jabari Rice",0,0,0,0,0,0
0,0,0,0,0,0,0,0,0,"00",0,0,0,0,0,0,1037680,"2023-11-05T00:00:00.000Z",27,FALSE,28,3547246,"G-F",27,27,"San Antonio Spurs","Devin Vassell",0,0,0,0,0,0
4,0,5,13,7,16,8,4,1,"38",2,3,24,7,1,1,1037680,"2023-11-05T00:00:00.000Z",27,FALSE,28,18,"F",28,28,"Toronto Raptors","OG Anunoby",1,31,35,28,11,40.4
0,0,0,0,0,0,0,0,0,"00",0,0,0,0,0,0,1037680,"2023-11-05T00:00:00.000Z",27,FALSE,28,180,"G",27,27,"San Antonio Spurs","Devonte' Graham",0,0,0,0,0,0
6,1,2,2,0,11,3,0,0,"32",1,4,6,3,0,3,1037680,"2023-11-05T00:00:00.000Z",27,FALSE,28,3547274,"G",27,27,"San Antonio Spurs","Tre Jones",1,9,15,12,9,18.6
0,0,0,0,0,0,0,0,0,"00",0,0,0,0,0,0,1037680,"2023-11-05T00:00:00.000Z",27,FALSE,28,17896059,"F",27,27,"San Antonio Spurs","Sandro Mamukelashvili",0,0,0,0,0,0
2,0,1,8,4,8,4,0,0,"24",0,2,12,1,0,2,1037680,"2023-11-05T00:00:00.000Z",27,FALSE,28,305,"F",27,27,"San Antonio Spurs","Doug McDermott",0,13,15,14,3,14.2
0,0,0,0,0,0,0,0,0,"00",0,0,0,0,0,0,1037680,"2023-11-05T00:00:00.000Z",27,FALSE,28,38017693,"G",27,27,"San Antonio Spurs","Blake Wesley",0,0,0,0,0,0
6,3,7,10,5,20,9,11,7,"42",4,1,30,11,3,3,1037680,"2023-11-05T00:00:00.000Z",27,FALSE,28,17896055,"G-F",28,28,"Toronto Raptors","Scottie Barnes",6,41,47,36,17,67.2
6,1,1,8,1,19,10,4,3,"38",2,1,24,3,2,2,1037680,"2023-11-05T00:00:00.000Z",27,FALSE,28,409,"G",28,28,"Toronto Raptors","Dennis Schroder",3,27,33,30,9,43.6
0,0,0,4,2,8,4,0,0,"29",0,1,10,0,1,2,1037680,"2023-11-05T00:00:00.000Z",27,FALSE,28,3089,"",28,28,"Toronto Raptors","Gary Trent Jr.",1,10,10,10,0,11
4,0,2,2,0,2,0,0,0,"14",1,1,0,3,0,1,1037680,"2023-11-05T00:00:00.000Z",27,FALSE,28,56677828,"G",28,28,"Toronto Raptors","Gradey Dick",0,3,7,4,7,8.6
4,1,2,2,1,3,1,2,2,"15",1,1,5,3,0,0,1037680,"2023-11-05T00:00:00.000Z",27,FALSE,28,3547275,"G",28,28,"Toronto Raptors","Malachi Flynn",1,8,12,9,7,17.6
0,0,1,1,0,3,0,0,0,"05",0,0,0,1,0,1,1037680,"2023-11-05T00:00:00.000Z",27,FALSE,28,666762,"F",28,28,"Toronto Raptors","Jalen McDaniels",0,1,1,0,1,0.2
0,1,4,4,2,4,2,0,0,"19",0,2,6,4,0,0,1037680,"2023-11-05T00:00:00.000Z",27,FALSE,28,376,"F",28,28,"Toronto Raptors","Otto Porter Jr.",1,10,10,6,4,13.8
5,0,6,4,1,12,2,3,3,"36",0,3,8,6,1,3,1037680,"2023-11-05T00:00:00.000Z",27,FALSE,28,416,"F",28,28,"Toronto Raptors","Pascal Siakam",1,14,19,13,11,22.7
0,1,7,0,0,10,8,2,0,"29",3,2,16,10,3,1,1037680,"2023-11-05T00:00:00.000Z",27,FALSE,28,373,"C",28,28,"Toronto Raptors","Jakob Poeltl",4,26,26,16,10,39
0,0,0,0,0,0,0,0,0,"00",0,0,0,0,0,0,1037680,"2023-11-05T00:00:00.000Z",27,FALSE,28,38017717,"F",28,28,"Toronto Raptors","Ron Harper Jr.",0,0,0,0,0,0
0,0,0,0,0,0,0,0,0,"00",0,0,0,0,0,0,1037680,"2023-11-05T00:00:00.000Z",27,FALSE,28,38017710,"C",28,28,"Toronto Raptors","Christian Koloko",0,0,0,0,0,0
0,0,0,0,0,0,0,0,0,"00",0,0,0,0,0,0,1037680,"2023-11-05T00:00:00.000Z",27,FALSE,28,56677869,"G",28,28,"Toronto Raptors","Markquis Nowell",0,0,0,0,0,0
0,0,0,0,0,0,0,0,0,"00",0,0,0,0,0,0,1037680,"2023-11-05T00:00:00.000Z",27,FALSE,28,58,"F",28,28,"Toronto Raptors","Chris Boucher",0,0,0,0,0,0
0,0,0,0,0,0,0,0,0,"00",0,0,0,0,0,0,1037680,"2023-11-05T00:00:00.000Z",27,FALSE,28,436,"G-F",28,28,"Toronto Raptors","Garrett Temple",0,0,0,0,0,0
0,0,0,0,0,0,0,0,0,"00",0,0,0,0,0,0,1037680,"2023-11-05T00:00:00.000Z",27,FALSE,28,489,"F",28,28,"Toronto Raptors","Thaddeus Young",0,0,0,0,0,0
0,0,0,0,0,0,0,0,0,"00",0,0,0,0,0,0,1037680,"2023-11-05T00:00:00.000Z",27,FALSE,28,3547249,"F",28,28,"Toronto Raptors","Precious Achiuwa",0,0,0,0,0,0
0,0,0,0,0,0,0,0,0,"00",0,0,0,0,0,0,1037680,"2023-11-05T00:00:00.000Z",27,FALSE,28,56677805,"G",28,28,"Toronto Raptors","Javon Freeman-Liberty",0,0,0,0,0,0
4,0,4,10,3,13,6,0,0,"36",0,3,15,4,1,0,1037681,"2023-11-05T00:00:00.000Z",6,FALSE,10,666908,"G",6,6,"Cleveland Cavaliers","Max Strus",1,19,23,19,8,28.8
2,1,11,1,0,10,6,4,1,"29",5,4,13,16,0,5,1037681,"2023-11-05T00:00:00.000Z",6,FALSE,10,17896076,"F-C",6,6,"Cleveland Cavaliers","Evan Mobley",1,29,31,15,18,33.2
3,0,4,0,0,7,5,2,2,"28",5,1,12,9,0,2,1037681,"2023-11-05T00:00:00.000Z",6,FALSE,10,9,"C",6,6,"Cleveland Cavaliers","Jarrett Allen",0,21,24,15,12,25.3
7,0,1,11,5,19,11,4,4,"34",1,3,31,2,2,4,1037681,"2023-11-05T00:00:00.000Z",6,FALSE,10,322,"G",6,6,"Cleveland Cavaliers","Donovan Mitchell",2,33,40,38,9,45.9
7,0,3,5,0,17,6,13,12,"30",0,3,24,3,0,6,1037681,"2023-11-05T00:00:00.000Z",6,FALSE,10,666581,"G",6,6,"Cleveland Cavaliers","Darius Garland",0,27,34,31,10,32.1
2,0,5,3,0,6,3,2,2,"32",0,0,8,5,2,1,1037681,"2023-11-05T00:00:00.000Z",6,FALSE,10,277,"G",6,6,"Cleveland Cavaliers","Caris LeVert",2,13,15,10,7,22
1,0,6,4,2,6,2,0,0,"25",0,4,6,6,0,0,1037681,"2023-11-05T00:00:00.000Z",6,FALSE,10,344,"F",6,6,"Cleveland Cavaliers","Georges Niang",0,12,13,7,7,14.7
0,1,4,0,0,2,1,3,1,"11",1,2,3,5,0,0,1037681,"2023-11-05T00:00:00.000Z",6,FALSE,10,444,"C-F",6,6,"Cleveland Cavaliers","Tristan Thompson",1,8,8,3,5,12
0,0,0,0,0,0,0,0,0,"00",0,0,0,0,0,0,1037681,"2023-11-05T00:00:00.000Z",6,FALSE,10,404,"G",6,6,"Cleveland Cavaliers","Ricky Rubio",0,0,0,0,0,0
1,0,2,2,1,9,3,4,1,"26",3,1,8,5,0,0,1037681,"2023-11-05T00:00:00.000Z",6,FALSE,10,475,"F-G",10,10,"Golden State Warriors","Andrew Wiggins",0,13,14,9,6,15.5
8,1,3,3,2,11,5,6,6,"29",0,0,18,3,3,1,1037681,"2023-11-05T00:00:00.000Z",6,FALSE,10,185,"F",10,10,"Golden State Warriors","Draymond Green",4,21,29,26,11,44.6
5,0,6,0,0,2,1,0,0,"15",5,1,2,11,0,0,1037681,"2023-11-05T00:00:00.000Z",6,FALSE,10,282,"F",10,10,"Golden State Warriors","Kevon Looney",0,13,18,7,16,22.7
2,0,1,9,3,14,5,2,2,"32",2,2,15,3,1,2,1037681,"2023-11-05T00:00:00.000Z",6,FALSE,10,443,"G",10,10,"Golden State Warriors","Klay Thompson",1,18,20,17,5,22.6
4,0,2,11,7,16,8,6,5,"31",0,0,28,2,1,6,1037681,"2023-11-05T00:00:00.000Z",6,FALSE,10,115,"G",10,10,"Golden State Warriors","Stephen Curry",1,30,34,32,6,33.4
2,0,1,5,1,10,2,0,0,"25",0,3,5,1,1,0,1037681,"2023-11-05T00:00:00.000Z",6,FALSE,10,367,"G",10,10,"Golden State Warriors","Chris Paul",1,6,8,7,3,12.2
1,0,0,3,1,7,2,0,0,"12",2,2,5,2,0,0,1037681,"2023-11-05T00:00:00.000Z",6,FALSE,10,2189,"",10,10,"Golden State Warriors","Gary Payton II",0,7,8,6,3,8.9
0,0,4,1,0,3,0,0,0,"13",1,2,0,5,0,1,1037681,"2023-11-05T00:00:00.000Z",6,FALSE,10,407,"F",10,10,"Golden State Warriors","Dario Saric",0,5,5,0,5,5
0,0,0,0,0,0,0,0,0,"00",0,0,0,0,0,0,1037681,"2023-11-05T00:00:00.000Z",6,FALSE,10,17896070,"F",10,10,"Golden State Warriors","Usman Garuba",0,0,0,0,0,0
0,0,0,0,0,0,0,0,0,"00",0,0,0,0,0,0,1037681,"2023-11-05T00:00:00.000Z",6,FALSE,10,45658838,"G",10,10,"Golden State Warriors","Lester Quinones",0,0,0,0,0,0
0,0,0,0,0,0,0,0,0,"00",0,0,0,0,0,0,1037681,"2023-11-05T00:00:00.000Z",6,FALSE,10,398,"G",10,10,"Golden State Warriors","Jerome Robinson",0,0,0,0,0,0
0,0,3,3,1,3,1,0,0,"13",1,1,3,4,3,0,1037681,"2023-11-05T00:00:00.000Z",6,FALSE,10,666940,"F",6,6,"Cleveland Cavaliers","Dean Wade",3,7,7,3,4,16.8
0,0,0,0,0,0,0,0,0,"01",0,0,0,0,0,0,1037681,"2023-11-05T00:00:00.000Z",6,FALSE,10,248,"C",6,6,"Cleveland Cavaliers","Damian Jones",0,0,0,0,0,0
0,0,0,0,0,0,0,0,0,"01",0,0,0,0,0,0,1037681,"2023-11-05T00:00:00.000Z",6,FALSE,10,3547299,"G",6,6,"Cleveland Cavaliers","Sam Merrill",0,0,0,0,0,0
0,0,0,0,0,0,0,0,0,"00",0,0,0,0,0,0,1037681,"2023-11-05T00:00:00.000Z",6,FALSE,10,56677847,"F",6,6,"Cleveland Cavaliers","Emoni Bates",0,0,0,0,0,0
0,0,0,0,0,0,0,0,0,"00",0,0,0,0,0,0,1037681,"2023-11-05T00:00:00.000Z",6,FALSE,10,666676,"G",6,6,"Cleveland Cavaliers","Ty Jerome",0,0,0,0,0,0
0,0,0,0,0,0,0,0,0,"00",0,0,0,0,0,0,1037681,"2023-11-05T00:00:00.000Z",6,FALSE,10,38017662,"F",6,6,"Cleveland Cavaliers","Isaiah Mobley",0,0,0,0,0,0
0,0,0,0,0,0,0,0,0,"00",0,0,0,0,0,0,1037681,"2023-11-05T00:00:00.000Z",6,FALSE,10,3547247,"F-G",6,6,"Cleveland Cavaliers","Isaac Okoro",0,0,0,0,0,0
0,0,0,0,0,0,0,0,0,"00",0,0,0,0,0,0,1037681,"2023-11-05T00:00:00.000Z",6,FALSE,10,56677872,"G",6,6,"Cleveland Cavaliers","Craig Porter",0,0,0,0,0,0
0,2,2,4,1,14,5,4,4,"20",1,2,15,3,0,1,1037681,"2023-11-05T00:00:00.000Z",6,FALSE,10,17553979,"F",10,10,"Golden State Warriors","Jonathan Kuminga",2,18,18,15,3,23.6
0,0,2,2,0,3,1,2,1,"14",1,1,3,3,1,0,1037681,"2023-11-05T00:00:00.000Z",6,FALSE,10,17553992,"G",10,10,"Golden State Warriors","Moses Moody",1,6,6,3,3,9.6
1,1,3,0,0,3,2,6,1,"12",1,4,5,4,1,0,1037681,"2023-11-05T00:00:00.000Z",6,FALSE,10,56677799,"F",10,10,"Golden State Warriors","Trayce Jackson-Davis",2,9,10,6,5,17.3
0,0,0,0,0,0,0,0,0,"03",0,0,0,0,1,0,1037681,"2023-11-05T00:00:00.000Z",6,FALSE,10,251,"G",10,10,"Golden State Warriors","Cory Joseph",1,0,0,0,0,3
2,0,1,1,0,2,0,0,0,"08",1,0,0,2,1,2,1037681,"2023-11-05T00:00:00.000Z",6,FALSE,10,56677858,"G",10,10,"Golden State Warriors","Brandin Podziemski",1,2,4,2,4,6.4
1,1,0,1,0,2,0,0,0,"17",0,1,0,0,1,1,1037682,"2023-11-05T00:00:00.000Z",7,FALSE,4,247,"F-G",7,7,"Dallas Mavericks","Derrick Jones Jr.",2,0,1,1,1,6.5
3,1,4,5,4,9,7,1,0,"31",0,3,18,4,0,0,1037682,"2023-11-05T00:00:00.000Z",7,FALSE,4,666965,"F",7,7,"Dallas Mavericks","Grant Williams",1,22,25,21,7,30.3
1,1,11,0,0,9,7,2,1,"32",3,4,15,14,0,2,1037682,"2023-11-05T00:00:00.000Z",7,FALSE,4,56677840,"C",7,7,"Dallas Mavericks","Dereck Lively II",1,29,30,16,15,34.3
10,1,3,6,2,14,6,4,4,"34",0,3,18,3,1,2,1037682,"2023-11-05T00:00:00.000Z",7,FALSE,4,228,"G",7,7,"Dallas Mavericks","Kyrie Irving",2,21,31,28,13,40.6
9,1,11,9,1,19,8,7,6,"36",1,3,23,12,0,4,1037682,"2023-11-05T00:00:00.000Z",7,FALSE,4,132,"F-G",7,7,"Dallas Mavericks","Luka Doncic",1,35,44,32,21,49.9
0,0,0,0,0,0,0,0,0,"00",0,0,0,0,0,0,1037682,"2023-11-05T00:00:00.000Z",7,FALSE,4,114,"G",7,7,"Dallas Mavericks","Seth Curry",0,0,0,0,0,0
0,0,1,1,1,2,1,0,0,"03",0,1,3,1,0,0,1037682,"2023-11-05T00:00:00.000Z",7,FALSE,4,151,"G",7,7,"Dallas Mavericks","Dante Exum",0,4,4,3,1,4.2
0,0,0,0,0,0,0,0,0,"00",0,0,0,0,0,0,1037682,"2023-11-05T00:00:00.000Z",7,FALSE,4,56677859,"F",7,7,"Dallas Mavericks","Olivier-Maxence Prosper",0,0,0,0,0,0
0,0,0,0,0,0,0,0,0,"00",0,0,0,0,0,0,1037682,"2023-11-05T00:00:00.000Z",7,FALSE,4,17896028,"F",7,7,"Dallas Mavericks","Greg Brown III",0,0,0,0,0,0
0,0,0,0,0,0,0,0,0,"00",0,0,0,0,0,0,1037682,"2023-11-05T00:00:00.000Z",7,FALSE,4,56677873,"G",7,7,"Dallas Mavericks","Dexter Dennis",0,0,0,0,0,0
0,0,0,0,0,0,0,0,0,"00",0,0,0,0,0,0,1037682,"2023-11-05T00:00:00.000Z",7,FALSE,4,257,"F",7,7,"Dallas Mavericks","Maxi Kleber",0,0,0,0,0,0
0,0,0,0,0,0,0,0,0,"00",0,0,0,0,0,0,1037682,"2023-11-05T00:00:00.000Z",7,FALSE,4,17554004,"G",7,7,"Dallas Mavericks","AJ Lawson",0,0,0,0,0,0
8,0,2,4,1,23,9,4,1,"34",2,2,20,4,1,1,1037682,"2023-11-05T00:00:00.000Z",7,FALSE,4,204,"F",4,4,"Charlotte Hornets","Gordon Hayward",1,24,32,28,12,38.8
1,0,4,4,1,15,8,4,3,"34",0,3,20,4,0,0,1037682,"2023-11-05T00:00:00.000Z",7,FALSE,4,666950,"F",4,4,"Charlotte Hornets","P.J. Washington",0,24,25,21,5,26.3
1,0,8,0,0,8,8,6,3,"27",2,3,19,10,0,2,1037682,"2023-11-05T00:00:00.000Z",7,FALSE,4,38017698,"C",4,4,"Charlotte Hornets","Mark Williams",0,29,30,20,11,30.5
1,0,1,5,0,12,3,2,1,"36",0,3,7,1,1,0,1037682,"2023-11-05T00:00:00.000Z",7,FALSE,4,56677823,"F",4,4,"Charlotte Hornets","Brandon Miller",1,8,9,8,2,12.7
13,1,8,10,5,23,11,3,3,"39",2,6,30,10,1,3,1037682,"2023-11-05T00:00:00.000Z",7,FALSE,4,3547239,"G",4,4,"Charlotte Hornets","LaMelo Ball",2,40,53,43,23,64.5
0,0,0,0,0,0,0,0,0,"00",0,0,0,0,0,0,1037682,"2023-11-05T00:00:00.000Z",7,FALSE,4,56677848,"G",4,4,"Charlotte Hornets","Amari Bailey",0,0,0,0,0,0
0,0,0,0,0,0,0,0,0,"00",0,0,0,0,0,0,1037682,"2023-11-05T00:00:00.000Z",7,FALSE,4,56677866,"F",4,4,"Charlotte Hornets","Leaky Black",0,0,0,0,0,0
4,0,0,6,1,9,4,0,0,"21",0,1,9,0,0,1,1037682,"2023-11-05T00:00:00.000Z",7,FALSE,4,3547253,"G",4,4,"Charlotte Hornets","Theo Maledon",0,9,13,13,4,14
3,1,2,4,1,9,3,2,0,"24",0,1,7,2,1,1,1037682,"2023-11-05T00:00:00.000Z",7,FALSE,4,3547258,"G",7,7,"Dallas Mavericks","Josh Green",2,9,12,10,5,18.9
1,0,2,12,4,17,5,2,2,"32",0,0,16,2,0,0,1037682,"2023-11-05T00:00:00.000Z",7,FALSE,4,191,"G",7,7,"Dallas Mavericks","Tim Hardaway Jr.",0,18,19,17,3,19.9
0,0,4,4,1,7,3,8,7,"15",0,1,14,4,0,0,1037682,"2023-11-05T00:00:00.000Z",7,FALSE,4,38017679,"G",7,7,"Dallas Mavericks","Jaden Hardy",0,18,18,14,4,18.8
0,0,0,0,0,0,0,0,0,"00",0,0,0,0,0,0,1037682,"2023-11-05T00:00:00.000Z",7,FALSE,4,217,"F-C",7,7,"Dallas Mavericks","Richaun Holmes",0,0,0,0,0,0
0,0,0,0,0,0,0,0,0,"00",0,0,0,0,0,0,1037682,"2023-11-05T00:00:00.000Z",7,FALSE,4,329,"F",7,7,"Dallas Mavericks","Markieff Morris",0,0,0,0,0,0
3,0,0,0,0,3,3,6,4,"16",5,2,10,5,0,0,1037682,"2023-11-05T00:00:00.000Z",7,FALSE,4,379,"F-C",7,7,"Dallas Mavericks","Dwight Powell",0,15,18,13,8,20.5
0,0,2,1,0,1,0,2,1,"10",0,0,1,2,2,0,1037682,"2023-11-05T00:00:00.000Z",7,FALSE,4,38017708,"G",4,4,"Charlotte Hornets","Bryce McGowens",2,3,3,1,2,9.4
1,1,6,0,0,7,6,0,0,"21",3,4,12,9,0,0,1037682,"2023-11-05T00:00:00.000Z",7,FALSE,4,3547282,"C",4,4,"Charlotte Hornets","Nick Richards",1,21,22,13,10,27.3
0,0,0,0,0,0,0,0,0,"03",0,3,0,0,0,1,1037682,"2023-11-05T00:00:00.000Z",7,FALSE,4,422,"G",4,4,"Charlotte Hornets","Ish Smith",0,0,0,0,0,-1
0,0,0,0,0,0,0,0,0,"00",0,0,0,0,0,0,1037682,"2023-11-05T00:00:00.000Z",7,FALSE,4,56677846,"G",4,4,"Charlotte Hornets","Nick Smith Jr.",0,0,0,0,0,0
1,0,2,0,0,1,0,0,0,"15",1,0,0,3,0,0,1037682,"2023-11-05T00:00:00.000Z",7,FALSE,4,18678001,"F",4,4,"Charlotte Hornets","JT Thor",0,3,4,1,4,5.1
0,0,0,0,0,0,0,0,0,"00",0,0,0,0,0,0,1037682,"2023-11-05T00:00:00.000Z",7,FALSE,4,17896037,"G",4,4,"Charlotte Hornets","James Bouknight",0,0,0,0,0,0
0,0,0,0,0,0,0,0,0,"00",0,0,0,0,0,0,1037682,"2023-11-05T00:00:00.000Z",7,FALSE,4,62,"F",4,4,"Charlotte Hornets","Miles Bridges",0,0,0,0,0,0
0,0,0,0,0,0,0,0,0,"00",0,0,0,0,0,0,1037682,"2023-11-05T00:00:00.000Z",7,FALSE,4,666748,"F",4,4,"Charlotte Hornets","Cody Martin",0,0,0,0,0,0
0,0,0,0,0,0,0,0,0,"00",0,0,0,0,0,0,1037682,"2023-11-05T00:00:00.000Z",7,FALSE,4,347,"G",4,4,"Charlotte Hornets","Frank Ntilikina",0,0,0,0,0,0
0,0,0,0,0,0,0,0,0,"00",0,0,0,0,0,0,1037682,"2023-11-05T00:00:00.000Z",7,FALSE,4,403,"G",4,4,"Charlotte Hornets","Terry Rozier",0,0,0,0,0,0
4,3,6,0,0,6,3,2,2,"26",5,5,8,11,0,2,1037683,"2023-11-05T00:00:00.000Z",25,FALSE,15,48,"C",15,15,"Memphis Grizzlies","Bismack Biyombo",3,19,23,12,15,34.2
1,2,3,3,2,3,2,0,0,"19",0,1,6,3,1,1,1037683,"2023-11-05T00:00:00.000Z",25,FALSE,15,666923,"G-F",25,25,"Portland Trail Blazers","Matisse Thybulle",3,9,10,7,4,19.1
3,0,1,13,4,22,10,4,3,"38",2,3,27,3,0,2,1037683,"2023-11-05T00:00:00.000Z",25,FALSE,15,182,"F",25,25,"Portland Trail Blazers","Jerami Grant",0,30,33,30,6,33.1
0,1,9,0,0,9,3,0,0,"35",2,4,6,11,2,3,1037683,"2023-11-05T00:00:00.000Z",25,FALSE,15,22,"C",25,25,"Portland Trail Blazers","Deandre Ayton",3,17,17,6,11,25.2
3,1,7,8,3,15,7,3,1,"41",1,1,18,8,1,3,1037683,"2023-11-05T00:00:00.000Z",25,FALSE,15,38017690,"G",25,25,"Portland Trail Blazers","Shaedon Sharpe",2,26,29,21,11,35.1
11,0,4,8,2,20,6,4,4,"39",3,2,18,7,1,1,1037683,"2023-11-05T00:00:00.000Z",25,FALSE,15,65,"G",25,25,"Portland Trail Blazers","Malcolm Brogdon",1,25,36,29,18,44.9
0,0,0,0,0,0,0,0,0,"00",0,0,0,0,0,0,1037683,"2023-11-05T00:00:00.000Z",25,FALSE,15,666476,"C",25,25,"Portland Trail Blazers","Moses Brown",0,0,0,0,0,0
2,0,3,3,2,5,3,0,0,"25",3,1,8,6,1,3,1037683,"2023-11-05T00:00:00.000Z",25,FALSE,15,56677850,"F",25,25,"Portland Trail Blazers","Toumani Camara",1,14,16,10,8,18.2
2,0,1,5,1,9,2,2,2,"16",0,3,7,1,2,0,1037683,"2023-11-05T00:00:00.000Z",25,FALSE,15,3547289,"G",25,25,"Portland Trail Blazers","Skylar Mays",2,8,10,9,3,17.2
0,0,0,0,0,0,0,0,0,"00",0,0,0,0,0,0,1037683,"2023-11-05T00:00:00.000Z",25,FALSE,15,47957121,"F",25,25,"Portland Trail Blazers","Justin Minaya",0,0,0,0,0,0
0,0,0,0,0,0,0,0,0,"00",0,0,0,0,0,0,1037683,"2023-11-05T00:00:00.000Z",25,FALSE,15,56677791,"F",25,25,"Portland Trail Blazers","Kris Murray",0,0,0,0,0,0
0,0,0,0,0,0,0,0,0,"00",0,0,0,0,0,0,1037683,"2023-11-05T00:00:00.000Z",25,FALSE,15,56677829,"G-F",25,25,"Portland Trail Blazers","Rayan Rupert",0,0,0,0,0,0
1,1,2,5,0,9,2,1,1,"16",3,2,5,5,3,0,1037683,"2023-11-05T00:00:00.000Z",25,FALSE,15,38017711,"F",25,25,"Portland Trail Blazers","Jabari Walker",4,10,11,6,6,24.5
0,0,1,0,0,3,2,1,1,"11",2,4,5,3,0,1,1037683,"2023-11-05T00:00:00.000Z",25,FALSE,15,476,"C-F",25,25,"Portland Trail Blazers","Robert Williams III",0,8,8,5,3,7.6
0,0,0,0,0,0,0,0,0,"00",0,0,0,0,0,0,1037683,"2023-11-05T00:00:00.000Z",25,FALSE,15,56677747,"G",25,25,"Portland Trail Blazers","Scoot Henderson",0,0,0,0,0,0
0,0,0,0,0,0,0,0,0,"00",0,0,0,0,0,0,1037683,"2023-11-05T00:00:00.000Z",25,FALSE,15,56783340,"C",25,25,"Portland Trail Blazers","Duop Reath",0,0,0,0,0,0
0,0,0,0,0,0,0,0,0,"00",0,0,0,0,0,0,1037683,"2023-11-05T00:00:00.000Z",25,FALSE,15,419,"G",25,25,"Portland Trail Blazers","Anfernee Simons",0,0,0,0,0,0
0,0,0,0,0,0,0,0,0,"00",0,0,0,0,0,0,1037683,"2023-11-05T00:00:00.000Z",25,FALSE,15,17896120,"F",25,25,"Portland Trail Blazers","Ish Wainright",0,0,0,0,0,0
1,1,6,2,1,4,2,2,1,"28",1,2,6,7,0,2,1037683,"2023-11-05T00:00:00.000Z",25,FALSE,15,17896027,"G-F",15,15,"Memphis Grizzlies","Ziaire Williams",1,13,14,7,8,16.9
2,1,4,4,1,18,11,6,4,"37",3,1,27,7,1,2,1037683,"2023-11-05T00:00:00.000Z",25,FALSE,15,231,"F-C",15,15,"Memphis Grizzlies","Jaren Jackson Jr.",2,34,36,29,9,42.4
5,0,8,9,3,27,13,1,1,"34",0,5,30,8,1,3,1037683,"2023-11-05T00:00:00.000Z",25,FALSE,15,3547287,"G",15,15,"Memphis Grizzlies","Desmond Bane",1,38,43,35,13,47.1
5,0,2,5,2,9,4,0,0,"29",0,3,10,2,2,3,1037683,"2023-11-05T00:00:00.000Z",25,FALSE,15,420,"G",15,15,"Memphis Grizzlies","Marcus Smart",2,12,17,15,7,22.9
3,0,4,3,1,8,3,0,0,"20",1,0,7,5,0,2,1037683,"2023-11-05T00:00:00.000Z",25,FALSE,15,17896067,"F",15,15,"Memphis Grizzlies","Santi Aldama",0,12,15,10,8,15.5
2,1,0,0,0,0,0,0,0,"11",0,1,0,0,0,1,1037683,"2023-11-05T00:00:00.000Z",25,FALSE,15,48248287,"G",15,15,"Memphis Grizzlies","Jacob Gilyard",1,0,2,2,2,5
2,0,5,6,4,9,5,1,1,"32",0,0,15,5,1,1,1037683,"2023-11-05T00:00:00.000Z",25,FALSE,15,254,"G",15,15,"Memphis Grizzlies","Luke Kennard",1,20,22,17,7,26
0,0,0,0,0,0,0,0,0,"00",0,0,0,0,0,0,1037683,"2023-11-05T00:00:00.000Z",25,FALSE,15,38017728,"F",15,15,"Memphis Grizzlies","Jake LaRavia",0,0,0,0,0,0
3,1,2,2,1,3,2,1,0,"10",0,0,5,2,0,0,1037683,"2023-11-05T00:00:00.000Z",25,FALSE,15,38017732,"F",15,15,"Memphis Grizzlies","Kenneth Lofton Jr.",1,7,10,8,5,14.9
0,0,2,1,0,5,2,0,0,"13",0,1,4,2,1,0,1037683,"2023-11-05T00:00:00.000Z",25,FALSE,15,38017729,"F",15,15,"Memphis Grizzlies","David Roddy",1,6,6,4,2,9.4
0,0,0,0,0,0,0,0,0,"00",0,0,0,0,0,0,1037683,"2023-11-05T00:00:00.000Z",25,FALSE,15,3547285,"F",15,15,"Memphis Grizzlies","Xavier Tillman",0,0,0,0,0,0
0,0,0,0,0,0,0,0,0,"00",0,0,0,0,0,0,1037683,"2023-11-05T00:00:00.000Z",25,FALSE,15,38017731,"G",15,15,"Memphis Grizzlies","Vince Williams Jr.",0,0,0,0,0,0
0,0,0,0,0,0,0,0,0,"00",0,0,0,0,0,0,1037683,"2023-11-05T00:00:00.000Z",25,FALSE,15,3,"C",15,15,"Memphis Grizzlies","Steven Adams",0,0,0,0,0,0
0,0,0,0,0,0,0,0,0,"00",0,0,0,0,0,0,1037683,"2023-11-05T00:00:00.000Z",25,FALSE,15,666505,"F",15,15,"Memphis Grizzlies","Brandon Clarke",0,0,0,0,0,0
0,0,0,0,0,0,0,0,0,"00",0,0,0,0,0,0,1037683,"2023-11-05T00:00:00.000Z",25,FALSE,15,56677830,"F",15,15,"Memphis Grizzlies","GG Jackson",0,0,0,0,0,0
0,0,0,0,0,0,0,0,0,"00",0,0,0,0,0,0,1037683,"2023-11-05T00:00:00.000Z",25,FALSE,15,666703,"G-F",15,15,"Memphis Grizzlies","John Konchar",0,0,0,0,0,0
0,0,0,0,0,0,0,0,0,"00",0,0,0,0,0,0,1037683,"2023-11-05T00:00:00.000Z",25,FALSE,15,666786,"G",15,15,"Memphis Grizzlies","Ja Morant",0,0,0,0,0,0
0,0,0,0,0,0,0,0,0,"00",0,0,0,0,0,0,1037683,"2023-11-05T00:00:00.000Z",25,FALSE,15,401,"G",15,15,"Memphis Grizzlies","Derrick Rose",0,0,0,0,0,0
2,0,3,4,1,10,6,3,3,"38",4,2,16,7,4,1,1037684,"2023-11-06T00:00:00.000Z",9,FALSE,10,56677826,"G-F",9,9,"Detroit Pistons","Ausar Thompson",4,23,25,18,9,38.4
4,1,9,5,3,9,5,4,4,"39",2,3,17,11,0,3,1037684,"2023-11-06T00:00:00.000Z",9,FALSE,10,3547267,"F-C",9,9,"Detroit Pistons","Isaiah Stewart",1,28,32,21,15,36.2
1,0,2,0,0,8,4,2,2,"24",0,1,10,2,0,1,1037684,"2023-11-06T00:00:00.000Z",9,FALSE,10,24,"F",9,9,"Detroit Pistons","Marvin Bagley III",0,12,13,11,3,12.9
5,0,4,6,1,18,7,7,6,"40",0,2,21,4,2,5,1037684,"2023-11-06T00:00:00.000Z",9,FALSE,10,17896075,"G-F",9,9,"Detroit Pistons","Cade Cunningham",2,25,30,26,9,34.3
7,1,4,4,3,12,8,2,2,"34",0,3,21,4,1,0,1037684,"2023-11-06T00:00:00.000Z",9,FALSE,10,3547241,"G",9,9,"Detroit Pistons","Killian Hayes",2,25,32,28,11,42.3
0,0,0,0,0,0,0,0,0,"00",0,0,0,0,0,0,1037684,"2023-11-06T00:00:00.000Z",9,FALSE,10,56677729,"G",9,9,"Detroit Pistons","Malcolm Cazalon",0,0,0,0,0,0
0,0,0,0,0,0,0,0,0,"00",0,0,0,0,0,0,1037684,"2023-11-06T00:00:00.000Z",9,FALSE,10,38017694,"C",9,9,"Detroit Pistons","Jalen Duren",0,0,0,0,0,0
0,0,0,0,0,0,0,0,0,"00",0,0,0,0,0,0,1037684,"2023-11-06T00:00:00.000Z",9,FALSE,10,197,"F-G",9,9,"Detroit Pistons","Joe Harris",0,0,0,0,0,0
0,0,3,5,4,8,5,1,1,"16",0,3,15,3,0,1,1037684,"2023-11-06T00:00:00.000Z",9,FALSE,10,44477024,"G",9,9,"Detroit Pistons","Stanley Umude",0,18,18,15,3,17.6
0,0,3,0,0,3,0,0,0,"11",0,0,0,3,0,0,1037684,"2023-11-06T00:00:00.000Z",9,FALSE,10,3547240,"C",9,9,"Detroit Pistons","James Wiseman",0,3,3,0,3,3.6
0,0,0,0,0,0,0,0,0,"00",0,0,0,0,0,0,1037684,"2023-11-06T00:00:00.000Z",9,FALSE,10,54,"F",9,9,"Detroit Pistons","Bojan Bogdanovic",0,0,0,0,0,0
0,0,0,0,0,0,0,0,0,"00",0,0,0,0,0,0,1037684,"2023-11-06T00:00:00.000Z",9,FALSE,10,77,"G",9,9,"Detroit Pistons","Alec Burks",0,0,0,0,0,0
0,0,0,0,0,0,0,0,0,"00",0,0,0,0,0,0,1037684,"2023-11-06T00:00:00.000Z",9,FALSE,10,17896071,"F",9,9,"Detroit Pistons","Isaiah Livers",0,0,0,0,0,0
0,0,0,0,0,0,0,0,0,"00",0,0,0,0,0,0,1037684,"2023-11-06T00:00:00.000Z",9,FALSE,10,330,"G",9,9,"Detroit Pistons","Monte Morris",0,0,0,0,0,0
1,1,3,2,0,9,2,2,0,"21",3,0,4,6,1,2,1037684,"2023-11-06T00:00:00.000Z",9,FALSE,10,475,"F-G",10,10,"Golden State Warriors","Andrew Wiggins",2,10,11,5,7,16.7
8,0,6,1,0,4,2,2,2,"27",3,2,6,9,0,2,1037684,"2023-11-06T00:00:00.000Z",9,FALSE,10,185,"F",10,10,"Golden State Warriors","Draymond Green",0,15,23,14,17,26.8
1,2,4,0,0,6,5,0,0,"25",2,4,10,6,0,2,1037684,"2023-11-06T00:00:00.000Z",9,FALSE,10,282,"F",10,10,"Golden State Warriors","Kevon Looney",2,16,17,11,7,22.7
3,0,0,8,1,16,8,0,0,"28",1,1,17,1,0,2,1037684,"2023-11-06T00:00:00.000Z",9,FALSE,10,443,"G",10,10,"Golden State Warriors","Klay Thompson",0,18,21,20,4,20.7
4,0,2,17,7,26,12,4,3,"33",0,1,34,2,0,2,1037684,"2023-11-06T00:00:00.000Z",9,FALSE,10,115,"G",10,10,"Golden State Warriors","Stephen Curry",0,36,40,38,6,40.4
0,0,0,0,0,0,0,0,0,"01",0,0,0,0,0,0,1037684,"2023-11-06T00:00:00.000Z",9,FALSE,10,56677799,"F",10,10,"Golden State Warriors","Trayce Jackson-Davis",0,0,0,0,0,0
0,0,0,0,0,0,0,0,0,"00",0,0,0,0,0,0,1037684,"2023-11-06T00:00:00.000Z",9,FALSE,10,251,"G",10,10,"Golden State Warriors","Cory Joseph",0,0,0,0,0,0
0,1,1,3,0,8,2,8,6,"19",0,3,10,1,1,1,1037684,"2023-11-06T00:00:00.000Z",9,FALSE,10,17553979,"F",10,10,"Golden State Warriors","Jonathan Kuminga",2,11,11,10,1,16.2
0,0,2,0,0,5,3,0,0,"24",4,2,6,6,2,0,1037684,"2023-11-06T00:00:00.000Z",9,FALSE,10,2189,"",10,10,"Golden State Warriors","Gary Payton II",2,12,12,6,6,19.2
1,0,3,5,2,8,4,2,2,"21",3,1,12,6,1,0,1037684,"2023-11-06T00:00:00.000Z",9,FALSE,10,407,"F",10,10,"Golden State Warriors","Dario Saric",1,18,19,13,7,23.7
0,0,0,0,0,0,0,0,0,"00",0,0,0,0,0,0,1037684,"2023-11-06T00:00:00.000Z",9,FALSE,10,38017682,"G",9,9,"Detroit Pistons","Jaden Ivey",0,0,0,0,0,0
0,0,1,1,0,2,0,2,2,"05",1,1,2,2,0,1,1037684,"2023-11-06T00:00:00.000Z",9,FALSE,10,42097199,"G",9,9,"Detroit Pistons","Jared Rhoden",0,4,4,2,2,3.4
4,0,3,5,1,10,3,0,0,"33",0,5,7,3,1,2,1037684,"2023-11-06T00:00:00.000Z",9,FALSE,10,56677792,"G",9,9,"Detroit Pistons","Marcus Sasser",1,10,14,11,7,17.6
2,0,1,2,0,6,2,0,0,"19",1,0,4,2,3,0,1037684,"2023-11-06T00:00:00.000Z",9,FALSE,10,17553992,"G",10,10,"Golden State Warriors","Moses Moody",3,6,8,6,4,18.4
6,0,5,3,2,9,6,3,3,"21",0,0,17,5,0,0,1037684,"2023-11-06T00:00:00.000Z",9,FALSE,10,367,"G",10,10,"Golden State Warriors","Chris Paul",0,22,28,23,11,32
0,0,0,0,0,0,0,0,0,"01",0,0,0,0,0,0,1037684,"2023-11-06T00:00:00.000Z",9,FALSE,10,56677858,"G",10,10,"Golden State Warriors","Brandin Podziemski",0,0,0,0,0,0
0,0,0,0,0,0,0,0,0,"00",0,0,0,0,0,0,1037684,"2023-11-06T00:00:00.000Z",9,FALSE,10,17896070,"F",10,10,"Golden State Warriors","Usman Garuba",0,0,0,0,0,0
0,0,0,0,0,0,0,0,0,"00",0,0,0,0,0,0,1037684,"2023-11-06T00:00:00.000Z",9,FALSE,10,45658838,"G",10,10,"Golden State Warriors","Lester Quinones",0,0,0,0,0,0
0,0,0,0,0,0,0,0,0,"00",0,0,0,0,0,0,1037684,"2023-11-06T00:00:00.000Z",9,FALSE,10,398,"G",10,10,"Golden State Warriors","Jerome Robinson",0,0,0,0,0,0
2,0,2,2,0,8,4,2,2,"22",1,2,10,3,1,1,1037685,"2023-11-06T00:00:00.000Z",12,FALSE,27,38017686,"G-F",12,12,"Indiana Pacers","Bennedict Mathurin",1,13,15,12,5,18.6
1,0,2,3,1,11,6,6,6,"27",0,3,19,2,2,1,1037685,"2023-11-06T00:00:00.000Z",12,FALSE,27,3547243,"F",12,12,"Indiana Pacers","Obi Toppin",2,21,22,20,3,27.9
2,1,7,1,1,7,5,4,4,"21",4,3,15,11,0,0,1037685,"2023-11-06T00:00:00.000Z",12,FALSE,27,452,"C-F",12,12,"Indiana Pacers","Myles Turner",1,26,28,17,13,34.2
4,0,5,3,1,7,3,0,0,"24",0,1,7,5,0,0,1037685,"2023-11-06T00:00:00.000Z",12,FALSE,27,69,"G",12,12,"Indiana Pacers","Bruce Brown",0,12,16,11,9,19
8,1,2,7,3,19,9,2,2,"27",0,1,23,2,1,2,1037685,"2023-11-06T00:00:00.000Z",12,FALSE,27,3547245,"G",12,12,"Indiana Pacers","Tyrese Haliburton",2,25,33,31,10,41.4
2,0,2,6,5,8,7,0,0,"21",0,1,19,2,1,4,1037685,"2023-11-06T00:00:00.000Z",12,FALSE,27,210,"G",12,12,"Indiana Pacers","Buddy Hield",1,21,23,21,4,23.4
1,2,1,0,0,3,3,1,1,"15",2,5,7,3,0,0,1037685,"2023-11-06T00:00:00.000Z",12,FALSE,27,17896035,"F",12,12,"Indiana Pacers","Isaiah Jackson",2,10,11,8,4,18.1
4,0,3,0,0,2,1,2,2,"09",0,1,4,3,0,1,1037685,"2023-11-06T00:00:00.000Z",12,FALSE,27,304,"G",12,12,"Indiana Pacers","T.J. McConnell",0,7,11,8,7,12.6
8,0,2,5,3,7,3,0,0,"16",0,3,9,2,0,2,1037685,"2023-11-06T00:00:00.000Z",12,FALSE,27,38017507,"G-F",12,12,"Indiana Pacers","Andrew Nembhard",0,11,19,17,10,21.4
2,0,1,4,3,8,5,2,2,"16",1,0,15,2,2,0,1037685,"2023-11-06T00:00:00.000Z",12,FALSE,27,3547250,"G-F",12,12,"Indiana Pacers","Aaron Nesmith",2,17,19,17,4,26.4
0,0,4,2,1,3,2,2,1,"09",0,0,6,4,0,2,1037685,"2023-11-06T00:00:00.000Z",12,FALSE,27,3547207,"F",12,12,"Indiana Pacers","Jordan Nwora",0,10,10,6,4,8.8
0,0,2,4,1,7,3,0,0,"12",0,1,7,2,0,0,1037685,"2023-11-06T00:00:00.000Z",12,FALSE,27,56677861,"G",12,12,"Indiana Pacers","Ben Sheppard",0,9,9,7,2,9.4
2,0,6,1,1,4,4,0,0,"12",1,3,9,7,0,1,1037685,"2023-11-06T00:00:00.000Z",12,FALSE,27,3547264,"F-C",12,12,"Indiana Pacers","Jalen Smith",0,16,18,11,9,19.4
0,0,0,0,0,0,0,0,0,"00",0,0,0,0,0,0,1037685,"2023-11-06T00:00:00.000Z",12,FALSE,27,439,"F",13,12,"Indiana Pacers","Daniel Theis",0,0,0,0,0,0
2,0,1,0,0,1,0,2,2,"09",0,0,2,1,0,0,1037685,"2023-11-06T00:00:00.000Z",12,FALSE,27,56677832,"F",12,12,"Indiana Pacers","Jarace Walker",0,3,5,4,3,6.2
0,0,0,0,0,0,0,0,0,"00",0,0,0,0,0,0,1037685,"2023-11-06T00:00:00.000Z",12,FALSE,27,38017701,"G",12,12,"Indiana Pacers","Kendall Brown",0,0,0,0,0,0
0,0,0,0,0,0,0,0,0,"00",0,0,0,0,0,0,1037685,"2023-11-06T00:00:00.000Z",12,FALSE,27,56677778,"F-C",12,12,"Indiana Pacers","Oscar Tshiebwe",0,0,0,0,0,0
0,0,0,0,0,0,0,0,0,"00",0,0,0,0,0,0,1037685,"2023-11-06T00:00:00.000Z",12,FALSE,27,56677794,"G",12,12,"Indiana Pacers","Isaiah Wong",0,0,0,0,0,0
3,0,2,0,0,12,6,5,4,"23",1,1,16,3,0,1,1037685,"2023-11-06T00:00:00.000Z",12,FALSE,27,666682,"F",27,27,"San Antonio Spurs","Keldon Johnson",0,19,22,19,6,23.1
0,2,9,5,2,12,3,6,5,"21",1,1,13,10,1,2,1037685,"2023-11-06T00:00:00.000Z",12,FALSE,27,56677822,"F-C",27,27,"San Antonio Spurs","Victor Wembanyama",3,23,23,13,10,32
2,0,3,2,1,8,6,3,1,"20",2,2,14,5,0,2,1037685,"2023-11-06T00:00:00.000Z",12,FALSE,27,102,"F-C",27,27,"San Antonio Spurs","Zach Collins",0,19,21,16,7,21
2,0,0,2,0,6,3,2,2,"28",0,0,8,0,0,0,1037685,"2023-11-06T00:00:00.000Z",12,FALSE,27,38017692,"F",27,27,"San Antonio Spurs","Malaki Branham",0,8,10,10,2,11
1,0,2,1,0,9,3,0,0,"21",1,2,6,3,0,2,1037685,"2023-11-06T00:00:00.000Z",12,FALSE,27,38017699,"F",27,27,"San Antonio Spurs","Jeremy Sochan",0,9,10,7,4,9.1
0,0,0,0,0,4,1,2,2,"08",0,1,4,0,0,0,1037685,"2023-11-06T00:00:00.000Z",12,FALSE,27,38017730,"F",27,27,"San Antonio Spurs","Dominick Barlow",0,4,4,4,0,4
1,0,1,0,0,5,5,0,0,"17",2,3,10,3,3,1,1037685,"2023-11-06T00:00:00.000Z",12,FALSE,27,17895854,"G",27,27,"San Antonio Spurs","Charles Bassey",3,13,14,11,4,23.1
0,2,2,3,0,8,2,0,0,"16",0,0,4,2,0,1,1037685,"2023-11-06T00:00:00.000Z",12,FALSE,27,38017649,"F",27,27,"San Antonio Spurs","Julian Champagnie",2,6,6,4,2,11.4
1,1,0,1,0,2,0,2,2,"12",1,0,2,1,2,0,1037685,"2023-11-06T00:00:00.000Z",12,FALSE,27,180,"G",27,27,"San Antonio Spurs","Devonte' Graham",3,3,4,3,2,13.7
8,0,0,2,0,5,1,2,2,"19",1,1,4,1,0,1,1037685,"2023-11-06T00:00:00.000Z",12,FALSE,27,3547274,"G",27,27,"San Antonio Spurs","Tre Jones",0,5,13,12,9,16.2
1,0,2,2,0,4,2,2,1,"09",2,0,5,4,0,0,1037685,"2023-11-06T00:00:00.000Z",12,FALSE,27,17896059,"F",27,27,"San Antonio Spurs","Sandro Mamukelashvili",0,9,10,6,5,11.3
4,0,1,6,4,9,5,4,3,"19",0,1,17,1,0,0,1037685,"2023-11-06T00:00:00.000Z",12,FALSE,27,305,"F",27,27,"San Antonio Spurs","Doug McDermott",0,18,22,21,5,24.2
2,0,2,2,1,6,2,2,1,"19",1,1,6,3,1,1,1037685,"2023-11-06T00:00:00.000Z",12,FALSE,27,359,"F",27,27,"San Antonio Spurs","Cedi Osman",1,9,11,8,5,14.6
1,0,0,0,0,4,1,0,0,"08",0,2,2,0,0,0,1037685,"2023-11-06T00:00:00.000Z",12,FALSE,27,38017693,"G",27,27,"San Antonio Spurs","Blake Wesley",0,2,3,3,1,3.5
0,0,0,0,0,0,0,0,0,"00",0,0,0,0,0,0,1037685,"2023-11-06T00:00:00.000Z",12,FALSE,27,56677865,"C",27,27,"San Antonio Spurs","Charles Bediako",0,0,0,0,0,0
0,0,0,0,0,0,0,0,0,"00",0,0,0,0,0,0,1037685,"2023-11-06T00:00:00.000Z",12,FALSE,27,56677817,"G",27,27,"San Antonio Spurs","Sidy Cissoko",0,0,0,0,0,0
0,0,0,0,0,0,0,0,0,"00",0,0,0,0,0,0,1037685,"2023-11-06T00:00:00.000Z",12,FALSE,27,56677870,"G",27,27,"San Antonio Spurs","Sir'Jabari Rice",0,0,0,0,0,0
0,0,0,0,0,0,0,0,0,"00",0,0,0,0,0,0,1037685,"2023-11-06T00:00:00.000Z",12,FALSE,27,3547246,"G-F",27,27,"San Antonio Spurs","Devin Vassell",0,0,0,0,0,0
4,0,5,4,1,13,5,2,1,"33",0,3,12,5,1,1,1037686,"2023-11-06T00:00:00.000Z",22,FALSE,7,17896026,"F",22,22,"Orlando Magic","Franz Wagner",1,17,21,16,9,26
6,0,4,1,0,18,8,6,6,"37",1,5,22,5,0,6,1037686,"2023-11-06T00:00:00.000Z",22,FALSE,7,38017683,"F",22,22,"Orlando Magic","Paolo Banchero",0,27,33,28,11,31
0,1,4,1,0,5,3,1,1,"22",2,3,7,6,2,1,1037686,"2023-11-06T00:00:00.000Z",22,FALSE,7,666442,"C",22,22,"Orlando Magic","Goga Bitadze",3,13,13,7,6,22.2
7,1,3,6,1,12,4,2,1,"24",1,3,10,4,1,4,1037686,"2023-11-06T00:00:00.000Z",22,FALSE,7,17896073,"G",22,22,"Orlando Magic","Jalen Suggs",2,14,21,17,11,27.3
2,0,3,4,2,7,3,0,0,"33",2,2,8,5,0,1,1037686,"2023-11-06T00:00:00.000Z",22,FALSE,7,56677827,"G",22,22,"Orlando Magic","Anthony Black",0,13,15,10,7,16
5,2,2,5,2,13,7,5,3,"30",0,3,19,2,1,3,1037686,"2023-11-06T00:00:00.000Z",22,FALSE,7,3547251,"G",22,22,"Orlando Magic","Cole Anthony",3,21,26,24,7,34.9
0,0,1,2,1,2,1,0,0,"14",0,1,3,1,0,0,1037686,"2023-11-06T00:00:00.000Z",22,FALSE,7,38017724,"G",22,22,"Orlando Magic","Caleb Houstan",0,4,4,3,1,4.2
0,0,0,0,0,0,0,0,0,"00",0,0,0,0,0,0,1037686,"2023-11-06T00:00:00.000Z",22,FALSE,7,56677839,"G",22,22,"Orlando Magic","Jett Howard",0,0,0,0,0,0
3,0,5,0,0,2,1,0,0,"21",0,1,2,5,0,2,1037686,"2023-11-06T00:00:00.000Z",22,FALSE,7,226,"F",22,22,"Orlando Magic","Joe Ingles",0,7,10,5,8,10.5
0,0,0,0,0,0,0,0,0,"00",0,0,0,0,0,0,1037686,"2023-11-06T00:00:00.000Z",22,FALSE,7,666818,"F",22,22,"Orlando Magic","Chuma Okeke",0,0,0,0,0,0
0,0,0,0,0,0,0,0,0,"00",0,0,0,0,0,0,1037686,"2023-11-06T00:00:00.000Z",22,FALSE,7,666885,"F",22,22,"Orlando Magic","Admiral Schofield",0,0,0,0,0,0
0,0,0,0,0,0,0,0,0,"00",0,0,0,0,0,0,1037686,"2023-11-06T00:00:00.000Z",22,FALSE,7,38017607,"G",22,22,"Orlando Magic","Kevon Harris",0,0,0,0,0,0
0,0,0,0,0,0,0,0,0,"00",0,0,0,0,0,0,1037686,"2023-11-06T00:00:00.000Z",22,FALSE,7,229,"F",22,22,"Orlando Magic","Jonathan Isaac",0,0,0,0,0,0
0,0,0,0,0,0,0,0,0,"00",0,0,0,0,0,0,1037686,"2023-11-06T00:00:00.000Z",22,FALSE,7,17553983,"G",22,22,"Orlando Magic","Trevelin Queen",0,0,0,0,0,0
1,2,3,3,1,5,2,0,0,"28",1,3,5,4,0,1,1037686,"2023-11-06T00:00:00.000Z",22,FALSE,7,247,"F-G",7,7,"Dallas Mavericks","Derrick Jones Jr.",2,9,10,6,5,16.3
0,1,1,5,2,9,5,3,1,"33",1,2,13,2,0,0,1037686,"2023-11-06T00:00:00.000Z",22,FALSE,7,666965,"F",7,7,"Dallas Mavericks","Grant Williams",1,15,15,13,2,18.4
0,1,3,0,0,5,4,2,2,"16",2,5,10,5,1,2,1037686,"2023-11-06T00:00:00.000Z",22,FALSE,7,56677840,"C",7,7,"Dallas Mavericks","Dereck Lively II",2,15,15,10,5,20
10,0,6,6,2,20,8,5,3,"37",1,2,21,7,3,3,1037686,"2023-11-06T00:00:00.000Z",22,FALSE,7,228,"G",7,7,"Dallas Mavericks","Kyrie Irving",3,28,38,31,17,50.4
0,0,5,4,1,13,8,2,2,"26",0,3,19,5,1,2,1037686,"2023-11-06T00:00:00.000Z",22,FALSE,7,462,"C",22,22,"Orlando Magic","Moritz Wagner",1,24,24,19,5,26
0,0,0,0,0,0,0,0,0,"00",0,0,0,0,0,0,1037686,"2023-11-06T00:00:00.000Z",22,FALSE,7,85,"F",22,22,"Orlando Magic","Wendell Carter Jr.",0,0,0,0,0,0
0,0,0,0,0,0,0,0,0,"00",0,0,0,0,0,0,1037686,"2023-11-06T00:00:00.000Z",22,FALSE,7,165,"G",22,22,"Orlando Magic","Markelle Fultz",0,0,0,0,0,0
0,0,0,0,0,0,0,0,0,"00",0,0,0,0,0,0,1037686,"2023-11-06T00:00:00.000Z",22,FALSE,7,196,"G",22,22,"Orlando Magic","Gary Harris",0,0,0,0,0,0
6,0,3,10,5,17,9,6,6,"35",0,2,29,3,2,6,1037686,"2023-11-06T00:00:00.000Z",22,FALSE,7,132,"F-G",7,7,"Dallas Mavericks","Luka Doncic",2,32,38,35,9,41.6
1,0,2,2,1,3,2,2,1,"20",0,3,6,2,1,1,1037686,"2023-11-06T00:00:00.000Z",22,FALSE,7,3547258,"G",7,7,"Dallas Mavericks","Josh Green",1,8,9,7,3,11.9
0,0,6,11,4,16,8,1,1,"31",0,0,21,6,0,0,1037686,"2023-11-06T00:00:00.000Z",22,FALSE,7,191,"G",7,7,"Dallas Mavericks","Tim Hardaway Jr.",0,27,27,21,6,28.2
0,0,0,0,0,0,0,0,0,"00",0,0,0,0,0,0,1037686,"2023-11-06T00:00:00.000Z",22,FALSE,7,114,"G",7,7,"Dallas Mavericks","Seth Curry",0,0,0,0,0,0
0,0,0,0,0,0,0,0,0,"00",0,0,0,0,0,0,1037686,"2023-11-06T00:00:00.000Z",22,FALSE,7,151,"G",7,7,"Dallas Mavericks","Dante Exum",0,0,0,0,0,0
1,0,1,3,0,5,1,4,3,"11",0,0,5,1,1,1,1037686,"2023-11-06T00:00:00.000Z",22,FALSE,7,38017679,"G",7,7,"Dallas Mavericks","Jaden Hardy",1,6,7,6,2,9.7
0,0,0,0,0,0,0,0,0,"00",0,0,0,0,0,0,1037686,"2023-11-06T00:00:00.000Z",22,FALSE,7,217,"F-C",7,7,"Dallas Mavericks","Richaun Holmes",0,0,0,0,0,0
0,0,0,0,0,0,0,0,0,"00",0,0,0,0,0,0,1037686,"2023-11-06T00:00:00.000Z",22,FALSE,7,329,"F",7,7,"Dallas Mavericks","Markieff Morris",0,0,0,0,0,0
2,2,1,0,0,2,2,5,3,"29",0,3,7,1,1,0,1037686,"2023-11-06T00:00:00.000Z",22,FALSE,7,379,"F-C",7,7,"Dallas Mavericks","Dwight Powell",3,8,10,9,3,20.2
0,0,0,0,0,0,0,0,0,"00",0,0,0,0,0,0,1037686,"2023-11-06T00:00:00.000Z",22,FALSE,7,56677859,"F",7,7,"Dallas Mavericks","Olivier-Maxence Prosper",0,0,0,0,0,0
0,0,0,0,0,0,0,0,0,"00",0,0,0,0,0,0,1037686,"2023-11-06T00:00:00.000Z",22,FALSE,7,257,"F",7,7,"Dallas Mavericks","Maxi Kleber",0,0,0,0,0,0
0,0,0,0,0,0,0,0,0,"00",0,0,0,0,0,0,1037686,"2023-11-06T00:00:00.000Z",22,FALSE,7,17554004,"G",7,7,"Dallas Mavericks","AJ Lawson",0,0,0,0,0,0
0,0,0,0,0,0,0,0,0,"00",0,0,0,0,0,0,1037686,"2023-11-06T00:00:00.000Z",22,FALSE,7,17896028,"F",7,7,"Dallas Mavericks","Greg Brown III",0,0,0,0,0,0
0,0,0,0,0,0,0,0,0,"00",0,0,0,0,0,0,1037686,"2023-11-06T00:00:00.000Z",22,FALSE,7,56677873,"G",7,7,"Dallas Mavericks","Dexter Dennis",0,0,0,0,0,0
1,1,4,2,0,5,1,2,1,"27",1,2,3,5,1,3,1037687,"2023-11-06T00:00:00.000Z",23,FALSE,30,360,"F",23,23,"Philadelphia 76ers","Kelly Oubre Jr.",2,8,9,4,6,13.5
5,0,4,2,0,11,6,6,6,"31",1,1,18,5,1,2,1037687,"2023-11-06T00:00:00.000Z",23,FALSE,30,200,"F",23,23,"Philadelphia 76ers","Tobias Harris",1,23,28,23,10,32.5
6,1,9,2,0,25,17,14,14,"31",2,2,48,11,1,1,1037687,"2023-11-06T00:00:00.000Z",23,FALSE,30,145,"F-C",23,23,"Philadelphia 76ers","Joel Embiid",2,59,65,54,17,75.2
4,0,3,5,4,10,5,0,0,"26",0,1,14,3,1,1,1037687,"2023-11-06T00:00:00.000Z",23,FALSE,30,313,"G",23,23,"Philadelphia 76ers","De'Anthony Melton",1,17,21,18,7,25.6
11,1,1,9,3,16,9,1,1,"32",0,2,22,1,1,0,1037687,"2023-11-06T00:00:00.000Z",23,FALSE,30,3547254,"G",23,23,"Philadelphia 76ers","Tyrese Maxey",2,23,34,33,12,45.7
0,1,2,0,0,0,0,2,2,"04",0,1,2,2,0,2,1037687,"2023-11-06T00:00:00.000Z",23,FALSE,30,28,"C",23,23,"Philadelphia 76ers","Mo Bamba",1,4,4,2,2,5.4
0,0,2,4,3,5,4,0,0,"17",0,1,11,2,1,0,1037687,"2023-11-06T00:00:00.000Z",23,FALSE,30,33,"F-G",23,23,"Philadelphia 76ers","Nicolas Batum",1,13,13,11,2,16.4
0,0,0,0,0,0,0,0,0,"00",0,0,0,0,0,0,1037687,"2023-11-06T00:00:00.000Z",23,FALSE,30,56913527,"G",23,23,"Philadelphia 76ers","Ricky Council IV",0,0,0,0,0,0
0,0,0,0,0,0,0,0,0,"00",0,0,0,0,0,0,1037687,"2023-11-06T00:00:00.000Z",23,FALSE,30,17554001,"G",23,23,"Philadelphia 76ers","Javonte Smart",0,0,0,0,0,0
0,0,0,0,0,0,0,0,0,"00",0,0,0,0,0,0,1037687,"2023-11-06T00:00:00.000Z",23,FALSE,30,56677788,"G",23,23,"Philadelphia 76ers","Terquavion Smith",0,0,0,0,0,0
6,0,4,4,2,8,5,4,4,"28",1,1,16,5,1,1,1037687,"2023-11-06T00:00:00.000Z",23,FALSE,30,3547242,"F",30,30,"Washington Wizards","Deni Avdija",1,21,27,22,11,33
4,1,4,5,4,20,12,1,0,"30",2,2,28,6,0,2,1037687,"2023-11-06T00:00:00.000Z",23,FALSE,30,265,"F",30,30,"Washington Wizards","Kyle Kuzma",1,34,38,32,10,42.2
3,5,4,0,0,7,6,0,0,"30",3,5,12,7,0,4,1037687,"2023-11-06T00:00:00.000Z",23,FALSE,30,666577,"F",30,30,"Washington Wizards","Daniel Gafford",5,19,22,15,10,35.9
6,1,1,9,4,15,8,3,3,"31",0,4,23,1,0,2,1037687,"2023-11-06T00:00:00.000Z",23,FALSE,30,666848,"G",30,30,"Washington Wizards","Jordan Poole",1,24,30,29,7,34.2
1,0,1,0,0,8,2,0,0,"14",2,0,4,3,0,0,1037687,"2023-11-06T00:00:00.000Z",23,FALSE,30,38017687,"G",30,30,"Washington Wizards","Johnny Davis",0,7,8,5,4,9.1
0,0,1,2,0,2,0,1,1,"04",0,0,1,1,0,0,1037687,"2023-11-06T00:00:00.000Z",23,FALSE,30,167,"F",30,30,"Washington Wizards","Danilo Gallinari",0,2,2,1,1,2.2
0,2,0,1,0,3,2,2,1,"08",1,0,5,1,1,0,1037687,"2023-11-06T00:00:00.000Z",23,FALSE,30,3547302,"F",30,30,"Washington Wizards","Anthony Gill",3,6,6,5,1,15.2
1,0,1,0,0,1,0,0,0,"04",0,0,0,1,0,0,1037687,"2023-11-06T00:00:00.000Z",23,FALSE,30,3547294,"F",23,23,"Philadelphia 76ers","Kenyon Martin Jr.",0,1,2,1,2,2.7
0,1,1,0,0,2,1,1,1,"06",0,0,3,1,0,0,1037687,"2023-11-06T00:00:00.000Z",23,FALSE,30,328,"F",23,23,"Philadelphia 76ers","Marcus Morris",1,4,4,3,1,7.2
2,0,4,0,0,3,3,0,0,"13",2,1,6,6,1,1,1037687,"2023-11-06T00:00:00.000Z",23,FALSE,30,3547270,"F",23,23,"Philadelphia 76ers","Paul Reed",1,12,14,8,8,18.2
0,0,0,1,0,4,0,4,2,"12",1,1,2,1,1,1,1037687,"2023-11-06T00:00:00.000Z",23,FALSE,30,17896025,"G",23,23,"Philadelphia 76ers","Jaden Springer",1,3,3,2,1,5.2
0,0,1,2,0,2,0,4,3,"14",0,2,3,1,0,2,1037687,"2023-11-06T00:00:00.000Z",23,FALSE,30,17896045,"F",30,30,"Washington Wizards","Corey Kispert",0,4,4,3,1,2.2
0,0,0,0,0,1,0,0,0,"03",0,1,0,0,0,0,1037687,"2023-11-06T00:00:00.000Z",23,FALSE,30,337,"F-C",30,30,"Washington Wizards","Mike Muscala",0,0,0,0,0,0
2,0,4,2,1,2,1,2,1,"11",0,4,4,4,0,3,1037687,"2023-11-06T00:00:00.000Z",23,FALSE,30,17896106,"F",30,30,"Washington Wizards","Eugene Omoruyi",0,8,10,6,6,8.8
3,0,4,1,0,5,3,0,0,"10",1,2,6,5,2,5,1037687,"2023-11-06T00:00:00.000Z",23,FALSE,30,38017712,"G",30,30,"Washington Wizards","Ryan Rollins",2,11,14,9,8,17.5
0,0,0,0,0,0,0,0,0,"00",0,0,0,0,0,0,1037687,"2023-11-06T00:00:00.000Z",23,FALSE,30,414,"G",30,30,"Washington Wizards","Landry Shamet",0,0,0,0,0,0
0,0,0,1,0,3,2,0,0,"05",0,0,4,0,0,0,1037687,"2023-11-06T00:00:00.000Z",23,FALSE,30,487,"G",30,30,"Washington Wizards","Delon Wright",0,4,4,4,0,4
0,0,0,0,0,0,0,0,0,"00",0,0,0,0,0,0,1037687,"2023-11-06T00:00:00.000Z",23,FALSE,30,38017704,"F",30,30,"Washington Wizards","Patrick Baldwin Jr.",0,0,0,0,0,0
0,0,0,0,0,0,0,0,0,"00",0,0,0,0,0,0,1037687,"2023-11-06T00:00:00.000Z",23,FALSE,30,18677954,"G",30,30,"Washington Wizards","Jared Butler",0,0,0,0,0,0
0,0,0,0,0,0,0,0,0,"00",0,0,0,0,0,0,1037687,"2023-11-06T00:00:00.000Z",23,FALSE,30,38124126,"F",30,30,"Washington Wizards","John Butler Jr.",0,0,0,0,0,0
5,1,2,2,1,3,2,1,1,"12",2,0,6,4,1,1,1037687,"2023-11-06T00:00:00.000Z",23,FALSE,30,45,"G",23,23,"Philadelphia 76ers","Patrick Beverley",2,10,15,11,9,23.3
0,1,0,1,1,2,2,2,2,"04",0,2,7,0,3,0,1037687,"2023-11-06T00:00:00.000Z",23,FALSE,30,108,"F",23,23,"Philadelphia 76ers","Robert Covington",4,7,7,7,0,19
0,0,0,1,0,2,1,1,1,"07",0,0,3,0,0,2,1037687,"2023-11-06T00:00:00.000Z",23,FALSE,30,2175,"",23,23,"Philadelphia 76ers","Danuel House Jr.",0,3,3,3,0,1
2,0,2,2,0,2,0,2,1,"14",1,1,1,3,0,1,1037687,"2023-11-06T00:00:00.000Z",23,FALSE,30,260,"G-F",23,23,"Philadelphia 76ers","Furkan Korkmaz",0,4,6,3,5,6.6
6,0,1,4,2,13,5,0,0,"33",0,2,12,1,2,0,1037687,"2023-11-06T00:00:00.000Z",23,FALSE,30,249,"G",30,30,"Washington Wizards","Tyus Jones",2,13,19,18,7,28.2
0,1,3,3,1,7,3,3,3,"19",0,3,10,3,0,0,1037687,"2023-11-06T00:00:00.000Z",23,FALSE,30,56677844,"G",30,30,"Washington Wizards","Bilal Coulibaly",1,13,13,10,3,16.6
3,0,3,16,6,33,17,6,5,"40",1,3,45,4,1,1,1037688,"2023-11-06T00:00:00.000Z",3,FALSE,17,17896048,"G",3,3,"Brooklyn Nets","Cam Thomas",1,49,52,48,7,56.3
4,1,4,5,1,21,12,7,6,"39",1,2,31,5,0,1,1037688,"2023-11-06T00:00:00.000Z",3,FALSE,17,61,"F",3,3,"Brooklyn Nets","Mikal Bridges",1,36,40,35,9,45
2,1,2,7,1,12,3,0,0,"37",4,2,7,6,1,1,1037688,"2023-11-06T00:00:00.000Z",3,FALSE,17,158,"F",3,3,"Brooklyn Nets","Dorian Finney-Smith",2,13,15,9,8,22.2
4,0,12,0,0,3,1,0,0,"33",3,3,2,15,0,1,1037688,"2023-11-06T00:00:00.000Z",3,FALSE,17,417,"G-F",3,3,"Brooklyn Nets","Ben Simmons",0,17,21,6,19,25
0,0,0,0,0,0,0,0,0,"00",0,0,0,0,0,0,1037688,"2023-11-06T00:00:00.000Z",3,FALSE,17,9051997,"G",3,3,"Brooklyn Nets","Armoni Brooks",0,0,0,0,0,0
3,0,2,3,1,4,1,0,0,"24",1,0,3,3,0,0,1037688,"2023-11-06T00:00:00.000Z",3,FALSE,17,130,"G",3,3,"Brooklyn Nets","Spencer Dinwiddie",0,6,9,6,6,11.1
0,0,0,0,0,0,0,0,0,"00",0,0,0,0,0,0,1037688,"2023-11-06T00:00:00.000Z",3,FALSE,17,174,"F-C",3,3,"Brooklyn Nets","Harry Giles III",0,0,0,0,0,0
2,0,0,1,1,2,1,0,0,"16",1,0,3,1,1,1,1037688,"2023-11-06T00:00:00.000Z",3,FALSE,17,38017676,"F",17,17,"Milwaukee Bucks","MarJon Beauchamp",1,4,6,5,3,9.2
3,0,0,5,2,7,4,0,0,"20",1,1,10,1,0,1,1037688,"2023-11-06T00:00:00.000Z",3,FALSE,17,105,"G",17,17,"Milwaukee Bucks","Pat Connaughton",0,11,14,13,4,14.7
0,0,3,9,4,10,5,2,1,"30",2,1,15,5,1,2,1037688,"2023-11-06T00:00:00.000Z",3,FALSE,17,112,"F",17,17,"Milwaukee Bucks","Jae Crowder",1,20,20,15,5,22
0,0,0,0,0,0,0,0,0,"00",0,0,0,0,0,0,1037688,"2023-11-06T00:00:00.000Z",3,FALSE,17,38017733,"G",17,17,"Milwaukee Bucks","A.J. Green",0,0,0,0,0,0
0,0,0,0,0,0,0,0,0,"00",0,0,0,0,0,0,1037688,"2023-11-06T00:00:00.000Z",3,FALSE,17,56677852,"G",17,17,"Milwaukee Bucks","Andre Jackson Jr.",0,0,0,0,0,0
0,0,0,0,0,0,0,0,0,"00",0,0,0,0,0,0,1037688,"2023-11-06T00:00:00.000Z",3,FALSE,17,56677854,"F",17,17,"Milwaukee Bucks","Chris Livingston",0,0,0,0,0,0
0,0,0,0,0,0,0,0,0,"00",0,0,0,0,0,0,1037688,"2023-11-06T00:00:00.000Z",3,FALSE,17,284,"C",17,17,"Milwaukee Bucks","Robin Lopez",0,0,0,0,0,0
3,0,1,4,3,6,4,0,0,"17",0,1,11,1,0,0,1037688,"2023-11-06T00:00:00.000Z",3,FALSE,17,368,"G",17,17,"Milwaukee Bucks","Cameron Payne",0,12,15,14,4,16.7
2,0,6,2,1,8,3,4,4,"26",0,2,11,6,2,1,1037688,"2023-11-06T00:00:00.000Z",3,FALSE,17,377,"F",17,17,"Milwaukee Bucks","Bobby Portis",2,17,19,13,8,26.2
0,0,0,0,0,0,0,0,0,"00",0,0,0,0,0,0,1037688,"2023-11-06T00:00:00.000Z",3,FALSE,17,666453,"C",17,17,"Milwaukee Bucks","Marques Bolden",0,0,0,0,0,0
0,0,0,0,0,0,0,0,0,"00",0,0,0,0,0,0,1037688,"2023-11-06T00:00:00.000Z",3,FALSE,17,38017691,"G",17,17,"Milwaukee Bucks","TyTy Washington Jr.",0,0,0,0,0,0
0,0,0,0,0,0,0,0,0,"00",0,0,0,0,0,0,1037688,"2023-11-06T00:00:00.000Z",3,FALSE,17,666960,"G",17,17,"Milwaukee Bucks","Lindell Wigginton",0,0,0,0,0,0
3,1,8,7,4,8,4,0,0,"25",1,4,12,9,0,1,1037688,"2023-11-06T00:00:00.000Z",3,FALSE,17,351,"F",3,3,"Brooklyn Nets","Royce O'Neale",1,21,24,15,12,29.3
0,1,0,0,0,3,2,0,0,"08",0,0,4,0,0,0,1037688,"2023-11-06T00:00:00.000Z",3,FALSE,17,17896038,"C",3,3,"Brooklyn Nets","Day'Ron Sharpe",1,4,4,4,0,7
1,0,0,0,0,3,1,0,0,"11",0,1,2,0,0,0,1037688,"2023-11-06T00:00:00.000Z",3,FALSE,17,421,"G",3,3,"Brooklyn Nets","Dennis Smith Jr.",0,2,3,3,1,3.5
2,0,4,7,3,14,8,0,0,"23",0,1,19,4,0,3,1037688,"2023-11-06T00:00:00.000Z",3,FALSE,17,464,"G",3,3,"Brooklyn Nets","Lonnie Walker IV",0,23,25,21,6,23.8
0,0,0,0,0,0,0,0,0,"00",0,0,0,0,0,0,1037688,"2023-11-06T00:00:00.000Z",3,FALSE,17,17896058,"F",3,3,"Brooklyn Nets","Trendon Watford",0,0,0,0,0,0
0,0,0,0,0,0,0,0,0,"00",0,0,0,0,0,0,1037688,"2023-11-06T00:00:00.000Z",3,FALSE,17,56677722,"F",3,3,"Brooklyn Nets","Jalen Wilson",0,0,0,0,0,0
0,0,0,0,0,0,0,0,0,"00",0,0,0,0,0,0,1037688,"2023-11-06T00:00:00.000Z",3,FALSE,17,666508,"F-C",3,3,"Brooklyn Nets","Nicolas Claxton",0,0,0,0,0,0
0,0,0,0,0,0,0,0,0,"00",0,0,0,0,0,0,1037688,"2023-11-06T00:00:00.000Z",3,FALSE,17,56677843,"F",3,3,"Brooklyn Nets","Noah Clowney",0,0,0,0,0,0
0,0,0,0,0,0,0,0,0,"00",0,0,0,0,0,0,1037688,"2023-11-06T00:00:00.000Z",3,FALSE,17,666679,"F",3,3,"Brooklyn Nets","Cameron Johnson",0,0,0,0,0,0
0,0,0,0,0,0,0,0,0,"00",0,0,0,0,0,0,1037688,"2023-11-06T00:00:00.000Z",3,FALSE,17,17896041,"G",3,3,"Brooklyn Nets","Keon Johnson",0,0,0,0,0,0
0,0,0,0,0,0,0,0,0,"00",0,0,0,0,0,0,1037688,"2023-11-06T00:00:00.000Z",3,FALSE,17,56677841,"F",3,3,"Brooklyn Nets","Dariq Whitehead",0,0,0,0,0,0
4,0,3,4,1,10,6,2,2,"21",0,1,15,3,0,0,1037688,"2023-11-06T00:00:00.000Z",3,FALSE,17,315,"F",17,17,"Milwaukee Bucks","Khris Middleton",0,18,22,19,7,24.6
3,2,10,7,1,27,15,6,5,"35",2,1,36,12,1,3,1037688,"2023-11-06T00:00:00.000Z",3,FALSE,17,15,"F",17,17,"Milwaukee Bucks","Giannis Antetokounmpo",3,48,51,39,15,60.9
2,0,3,3,0,6,2,0,0,"27",4,3,4,7,0,0,1037688,"2023-11-06T00:00:00.000Z",3,FALSE,17,283,"C",17,17,"Milwaukee Bucks","Brook Lopez",0,11,13,6,9,15.4
0,0,6,5,1,5,1,0,0,"14",0,2,3,6,0,1,1037688,"2023-11-06T00:00:00.000Z",3,FALSE,17,38,"G",17,17,"Milwaukee Bucks","Malik Beasley",0,9,9,3,6,9.2
7,0,4,8,2,15,5,10,9,"34",2,1,21,6,1,1,1037688,"2023-11-06T00:00:00.000Z",3,FALSE,17,278,"G",17,17,"Milwaukee Bucks","Damian Lillard",1,27,34,28,13,40.7
0,0,0,0,0,0,0,0,0,"00",0,0,0,0,0,0,1037688,"2023-11-06T00:00:00.000Z",3,FALSE,17,2148,"",17,17,"Milwaukee Bucks","Thanasis Antetokounmpo",0,0,0,0,0,0
6,0,2,4,3,15,9,7,7,"37",2,0,28,4,2,3,1037689,"2023-11-06T00:00:00.000Z",16,FALSE,14,79,"G-F",16,16,"Miami Heat","Jimmy Butler",2,32,38,34,10,44.8
0,1,1,5,1,6,2,0,0,"22",0,2,5,1,1,0,1037689,"2023-11-06T00:00:00.000Z",16,FALSE,14,3092,"",16,16,"Miami Heat","Haywood Highsmith",2,6,6,5,1,12.2
10,2,15,1,1,20,9,5,3,"38",5,2,22,20,2,4,1037689,"2023-11-06T00:00:00.000Z",16,FALSE,14,4,"C-F",16,16,"Miami Heat","Bam Adebayo",4,42,52,32,30,69
5,0,4,10,2,20,8,4,4,"35",1,1,22,5,3,6,1037689,"2023-11-06T00:00:00.000Z",16,FALSE,14,666633,"G",16,16,"Miami Heat","Tyler Herro",3,27,32,27,10,38.5
5,0,2,5,1,6,2,0,0,"33",2,2,5,4,1,0,1037689,"2023-11-06T00:00:00.000Z",16,FALSE,14,286,"G",16,16,"Miami Heat","Kyle Lowry",1,9,14,10,9,20.3
1,0,1,4,1,7,4,0,0,"18",1,1,9,2,1,1,1037689,"2023-11-06T00:00:00.000Z",16,FALSE,14,56677785,"G",16,16,"Miami Heat","Jaime Jaquez Jr.",1,11,12,10,3,14.9
0,0,2,2,1,2,1,0,0,"21",0,4,3,2,0,1,1037689,"2023-11-06T00:00:00.000Z",16,FALSE,14,391,"G-F",16,16,"Miami Heat","Josh Richardson",0,5,5,3,2,4.4
3,0,2,6,2,11,5,0,0,"26",0,1,12,2,1,1,1037689,"2023-11-06T00:00:00.000Z",16,FALSE,14,397,"F",16,16,"Miami Heat","Duncan Robinson",1,14,17,15,5,20.9
1,0,1,1,0,3,2,0,0,"15",0,2,4,1,0,1,1037689,"2023-11-06T00:00:00.000Z",16,FALSE,14,38017697,"G",14,14,"Los Angeles Lakers","Max Christie",0,5,6,5,2,5.7
0,0,0,0,0,0,0,0,0,"00",0,0,0,0,0,0,1037689,"2023-11-06T00:00:00.000Z",16,FALSE,14,56677867,"F",14,14,"Los Angeles Lakers","Alex Fudge",0,0,0,0,0,0
0,0,0,0,0,0,0,0,0,"00",0,0,0,0,0,0,1037689,"2023-11-06T00:00:00.000Z",16,FALSE,14,56677835,"G",14,14,"Los Angeles Lakers","Jalen Hood-Schifino",0,0,0,0,0,0
0,0,0,0,0,0,0,0,0,"00",0,0,0,0,0,0,1037689,"2023-11-06T00:00:00.000Z",16,FALSE,14,56677836,"F",14,14,"Los Angeles Lakers","Maxwell Lewis",0,0,0,0,0,0
2,0,2,0,0,5,2,4,3,"29",2,0,7,4,1,2,1037689,"2023-11-06T00:00:00.000Z",16,FALSE,14,666860,"F-G",14,14,"Los Angeles Lakers","Cameron Reddish",1,11,13,9,6,15.8
1,0,6,6,3,10,4,2,1,"30",0,2,12,6,1,1,1037689,"2023-11-06T00:00:00.000Z",16,FALSE,14,486,"F",14,14,"Los Angeles Lakers","Christian Wood",1,18,19,13,7,22.7
0,0,0,0,0,0,0,0,0,"00",0,0,0,0,0,0,1037689,"2023-11-06T00:00:00.000Z",16,FALSE,14,666609,"F",14,14,"Los Angeles Lakers","Rui Hachimura",0,0,0,0,0,0
0,0,0,0,0,0,0,0,0,"00",0,0,0,0,0,0,1037689,"2023-11-06T00:00:00.000Z",16,FALSE,14,666626,"C",14,14,"Los Angeles Lakers","Jaxson Hayes",0,0,0,0,0,0
0,0,0,0,0,0,0,0,0,"00",0,0,0,0,0,0,1037689,"2023-11-06T00:00:00.000Z",16,FALSE,14,56677868,"G",14,14,"Los Angeles Lakers","D'Moi Hodge",0,0,0,0,0,0
0,0,0,0,0,0,0,0,0,"00",0,0,0,0,0,0,1037689,"2023-11-06T00:00:00.000Z",16,FALSE,14,457,"F",14,14,"Los Angeles Lakers","Jarred Vanderbilt",0,0,0,0,0,0
0,0,0,0,0,0,0,0,0,"00",0,0,0,0,0,0,1037689,"2023-11-06T00:00:00.000Z",16,FALSE,14,1603383,"G",14,14,"Los Angeles Lakers","Gabe Vincent",0,0,0,0,0,0
0,0,0,0,0,0,0,0,0,"00",0,0,0,0,0,0,1037689,"2023-11-06T00:00:00.000Z",16,FALSE,14,19465585,"G",16,16,"Miami Heat","Dru Smith",0,0,0,0,0,0
0,0,0,0,0,0,0,0,0,"00",0,0,0,0,0,0,1037689,"2023-11-06T00:00:00.000Z",16,FALSE,14,38017734,"F",16,16,"Miami Heat","Jamal Cain",0,0,0,0,0,0
0,0,0,0,0,0,0,0,0,"00",0,0,0,0,0,0,1037689,"2023-11-06T00:00:00.000Z",16,FALSE,14,3547257,"G",16,16,"Miami Heat","R.J. Hampton",0,0,0,0,0,0
0,0,0,0,0,0,0,0,0,"00",0,0,0,0,0,0,1037689,"2023-11-06T00:00:00.000Z",16,FALSE,14,38017696,"F",16,16,"Miami Heat","Nikola Jovic",0,0,0,0,0,0
0,0,0,0,0,0,0,0,0,"00",0,0,0,0,0,0,1037689,"2023-11-06T00:00:00.000Z",16,FALSE,14,666747,"F",16,16,"Miami Heat","Caleb Martin",0,0,0,0,0,0
0,0,0,0,0,0,0,0,0,"00",0,0,0,0,0,0,1037689,"2023-11-06T00:00:00.000Z",16,FALSE,14,38017736,"F",16,16,"Miami Heat","Cole Swider",0,0,0,0,0,0
2,0,3,4,1,9,4,0,0,"35",0,4,9,3,2,0,1037689,"2023-11-06T00:00:00.000Z",16,FALSE,14,383,"F",14,14,"Los Angeles Lakers","Taurean Prince",2,12,14,11,5,21.6
3,3,4,4,0,23,13,4,4,"37",0,4,30,4,1,5,1037689,"2023-11-06T00:00:00.000Z",16,FALSE,14,237,"F",14,14,"Los Angeles Lakers","LeBron James",4,34,37,33,7,46.3
4,1,6,0,0,7,4,1,1,"25",0,2,9,6,0,1,1037689,"2023-11-06T00:00:00.000Z",16,FALSE,14,117,"F-C",14,14,"Los Angeles Lakers","Anthony Davis",1,15,19,13,10,24.2
9,0,7,8,3,14,9,3,2,"40",3,1,23,10,1,4,1037689,"2023-11-06T00:00:00.000Z",16,FALSE,14,17553995,"G",14,14,"Los Angeles Lakers","Austin Reaves",1,33,42,32,19,47.5
6,1,4,3,1,10,6,0,0,"29",0,2,13,4,0,3,1037689,"2023-11-06T00:00:00.000Z",16,FALSE,14,405,"G",14,14,"Los Angeles Lakers","D'Angelo Russell",1,17,23,19,10,26.8
0,0,0,0,0,0,0,0,0,"00",0,0,0,0,0,0,1037689,"2023-11-06T00:00:00.000Z",16,FALSE,14,56677738,"C",14,14,"Los Angeles Lakers","Colin Castleton",0,0,0,0,0,0
0,0,0,0,0,0,0,0,0,"00",0,0,0,0,0,0,1037689,"2023-11-06T00:00:00.000Z",16,FALSE,14,285,"F-C",16,16,"Miami Heat","Kevin Love",0,0,0,0,0,0
0,0,0,0,0,0,0,0,0,"00",0,0,0,0,0,0,1037689,"2023-11-06T00:00:00.000Z",16,FALSE,14,39398582,"C",16,16,"Miami Heat","Orlando Robinson",0,0,0,0,0,0
0,1,4,0,0,1,1,0,0,"10",0,1,2,4,0,1,1037689,"2023-11-06T00:00:00.000Z",16,FALSE,14,74,"C",16,16,"Miami Heat","Thomas Bryant",1,6,6,2,4,8.8
4,0,5,4,2,16,9,6,6,"31",1,1,26,6,0,5,1037690,"2023-11-06T00:00:00.000Z",20,FALSE,13,666423,"F-G",20,20,"New York Knicks","RJ Barrett",0,32,36,30,10,34.2
3,0,8,8,3,21,9,6,6,"37",2,3,27,10,0,6,1037690,"2023-11-06T00:00:00.000Z",20,FALSE,13,387,"F",20,20,"New York Knicks","Julius Randle",0,37,40,30,13,37.5
0,0,6,0,0,10,6,1,1,"35",9,2,13,15,4,0,1037690,"2023-11-06T00:00:00.000Z",20,FALSE,13,399,"C",20,20,"New York Knicks","Mitchell Robinson",4,28,28,13,15,43
6,0,1,3,1,12,2,2,2,"35",2,1,7,3,3,4,1037690,"2023-11-06T00:00:00.000Z",20,FALSE,13,73,"G",20,20,"New York Knicks","Jalen Brunson",3,10,16,13,9,24.6
0,0,1,4,1,4,1,0,0,"21",0,1,3,1,1,1,1037690,"2023-11-06T00:00:00.000Z",20,FALSE,13,17895858,"G",20,20,"New York Knicks","Quentin Grimes",1,4,4,3,1,6.2
0,0,0,0,0,0,0,0,0,"00",0,0,0,0,0,0,1037690,"2023-11-06T00:00:00.000Z",20,FALSE,13,19,"G",20,20,"New York Knicks","Ryan Arcidiacono",0,0,0,0,0,0
1,1,4,5,3,6,4,2,1,"16",2,1,12,6,1,1,1037690,"2023-11-06T00:00:00.000Z",20,FALSE,13,131,"G",20,20,"New York Knicks","Donte DiVincenzo",2,18,19,13,7,25.7
0,0,0,0,0,0,0,0,0,"00",0,0,0,0,0,0,1037690,"2023-11-06T00:00:00.000Z",20,FALSE,13,160,"G-F",20,20,"New York Knicks","Evan Fournier",0,0,0,0,0,0
7,0,3,4,1,9,4,1,1,"32",0,2,10,3,2,2,1037690,"2023-11-06T00:00:00.000Z",20,FALSE,13,202,"G",20,20,"New York Knicks","Josh Hart",2,13,20,17,10,28.1
2,0,1,0,0,5,3,0,0,"13",2,2,6,3,2,0,1037690,"2023-11-06T00:00:00.000Z",20,FALSE,13,201,"F-C",20,20,"New York Knicks","Isaiah Hartenstein",2,9,11,8,5,18.6
0,0,0,0,0,0,0,0,0,"00",0,0,0,0,0,0,1037690,"2023-11-06T00:00:00.000Z",20,FALSE,13,666675,"F",20,20,"New York Knicks","DaQuan Jeffries",0,0,0,0,0,0
0,0,0,0,0,0,0,0,0,"00",0,0,0,0,0,0,1037690,"2023-11-06T00:00:00.000Z",20,FALSE,13,17896033,"G",20,20,"New York Knicks","Miles McBride",0,0,0,0,0,0
5,0,1,3,1,5,3,0,0,"20",0,0,7,1,0,0,1037690,"2023-11-06T00:00:00.000Z",20,FALSE,13,3547269,"G",20,20,"New York Knicks","Immanuel Quickley",0,8,13,12,6,15.7
0,0,0,0,0,0,0,0,0,"00",0,0,0,0,0,0,1037690,"2023-11-06T00:00:00.000Z",20,FALSE,13,17896063,"F",20,20,"New York Knicks","Jericho Sims",0,0,0,0,0,0
0,0,0,0,0,0,0,0,0,"00",0,0,0,0,0,0,1037690,"2023-11-06T00:00:00.000Z",20,FALSE,13,666971,"G-F",20,20,"New York Knicks","Dylan Windler",0,0,0,0,0,0
0,0,0,0,0,0,0,0,0,"00",0,0,0,0,0,0,1037690,"2023-11-06T00:00:00.000Z",20,FALSE,13,666474,"G",20,20,"New York Knicks","Charles Brown",0,0,0,0,0,0
0,0,0,2,0,2,0,2,2,"11",1,1,2,1,1,0,1037690,"2023-11-06T00:00:00.000Z",20,FALSE,13,450,"F",13,13,"LA Clippers","PJ Tucker",1,3,3,2,1,6.2
0,0,0,0,0,0,0,0,0,"00",0,0,0,0,0,0,1037690,"2023-11-06T00:00:00.000Z",20,FALSE,13,17896022,"G",13,13,"LA Clippers","Brandon Boston Jr.",0,0,0,0,0,0
0,0,0,0,0,0,0,0,0,"00",0,0,0,0,0,0,1037690,"2023-11-06T00:00:00.000Z",20,FALSE,13,666743,"G",13,13,"LA Clippers","Terance Mann",0,0,0,0,0,0
0,0,0,0,0,0,0,0,0,"00",0,0,0,0,0,0,1037690,"2023-11-06T00:00:00.000Z",20,FALSE,13,56677856,"G",13,13,"LA Clippers","Jordan Miller",0,0,0,0,0,0
0,0,0,0,0,0,0,0,0,"00",0,0,0,0,0,0,1037690,"2023-11-06T00:00:00.000Z",20,FALSE,13,17896051,"G",13,13,"LA Clippers","Joshua Primo",0,0,0,0,0,0
3,0,7,6,1,11,2,5,5,"34",0,2,10,7,3,4,1037690,"2023-11-06T00:00:00.000Z",20,FALSE,13,172,"F",13,13,"LA Clippers","Paul George",3,17,20,13,10,27.9
3,0,3,6,2,16,8,0,0,"32",2,2,18,5,0,0,1037690,"2023-11-06T00:00:00.000Z",20,FALSE,13,274,"F",13,13,"LA Clippers","Kawhi Leonard",0,23,26,21,8,28.5
0,3,3,0,0,3,3,4,2,"30",4,3,8,7,1,5,1037690,"2023-11-06T00:00:00.000Z",20,FALSE,13,493,"C",13,13,"LA Clippers","Ivica Zubac",4,15,15,8,7,23.4
6,0,3,4,2,9,6,3,3,"31",0,2,17,3,1,2,1037690,"2023-11-06T00:00:00.000Z",20,FALSE,13,192,"G",13,13,"LA Clippers","James Harden",1,20,26,23,9,30.6
4,0,4,3,1,13,8,0,0,"31",0,2,17,4,0,4,1037690,"2023-11-06T00:00:00.000Z",20,FALSE,13,472,"G",13,13,"LA Clippers","Russell Westbrook",0,21,25,21,8,23.8
0,0,0,1,0,1,0,0,0,"05",0,0,0,0,0,0,1037690,"2023-11-06T00:00:00.000Z",20,FALSE,13,56677849,"F",13,13,"LA Clippers","Kobe Brown",0,0,0,0,0,0
0,0,0,0,0,0,0,0,0,"05",0,0,0,0,0,0,1037690,"2023-11-06T00:00:00.000Z",20,FALSE,13,666511,"G",13,13,"LA Clippers","Amir Coffey",0,0,0,0,0,0
0,0,0,0,0,1,1,2,2,"06",0,0,4,0,0,0,1037690,"2023-11-06T00:00:00.000Z",20,FALSE,13,38017725,"F",13,13,"LA Clippers","Moussa Diabate",0,4,4,4,0,4
4,0,1,4,1,9,2,0,0,"22",0,2,5,1,1,3,1037690,"2023-11-06T00:00:00.000Z",20,FALSE,13,17896031,"G",13,13,"LA Clippers","Nah'Shon Hyland",1,6,10,9,5,12.2
1,0,2,0,0,1,1,0,0,"11",0,0,2,2,1,1,1037690,"2023-11-06T00:00:00.000Z",20,FALSE,13,371,"F-C",13,13,"LA Clippers","Mason Plumlee",1,4,5,3,3,7.9
0,1,1,6,4,7,5,0,0,"22",0,1,14,1,0,3,1037690,"2023-11-06T00:00:00.000Z",20,FALSE,13,380,"F-G",13,13,"LA Clippers","Norman Powell",1,15,15,14,1,15.2
0,0,0,0,0,0,0,0,0,"00",0,0,0,0,0,0,1037690,"2023-11-06T00:00:00.000Z",20,FALSE,13,56677795,"F",20,20,"New York Knicks","Jacob Toppin",0,0,0,0,0,0
0,0,0,0,0,0,0,0,0,"00",0,0,0,0,0,0,1037690,"2023-11-06T00:00:00.000Z",20,FALSE,13,17896089,"G",20,20,"New York Knicks","Duane Washington Jr.",0,0,0,0,0,0
4,0,2,1,1,13,8,5,4,"30",3,3,21,5,4,1,1037691,"2023-11-06T00:00:00.000Z",5,FALSE,29,125,"G",5,5,"Chicago Bulls","DeMar DeRozan",4,26,30,25,9,44
2,1,3,1,1,3,1,0,0,"20",0,5,3,3,1,0,1037691,"2023-11-06T00:00:00.000Z",5,FALSE,29,110,"F",5,5,"Chicago Bulls","Torrey Craig",2,6,8,5,5,15.6
4,1,7,2,0,11,5,0,0,"31",1,1,10,8,1,0,1037691,"2023-11-06T00:00:00.000Z",5,FALSE,29,460,"C",5,5,"Chicago Bulls","Nikola Vucevic",2,18,22,14,12,31.6
3,0,2,5,2,17,8,7,6,"31",0,3,24,2,1,2,1037691,"2023-11-06T00:00:00.000Z",5,FALSE,29,268,"G",5,5,"Chicago Bulls","Zach LaVine",1,26,29,27,5,31.9
7,0,3,6,4,9,7,0,0,"29",0,1,18,3,1,1,1037691,"2023-11-06T00:00:00.000Z",5,FALSE,29,666956,"G",5,5,"Chicago Bulls","Coby White",1,21,28,25,10,34.1
1,0,0,8,4,8,4,0,0,"17",0,1,12,0,2,0,1037691,"2023-11-06T00:00:00.000Z",5,FALSE,29,87,"G",5,5,"Chicago Bulls","Jevon Carter",2,12,13,13,1,19.5
3,0,0,2,2,3,3,2,2,"20",1,1,10,1,1,0,1037691,"2023-11-06T00:00:00.000Z",5,FALSE,29,89,"G",5,5,"Chicago Bulls","Alex Caruso",1,11,14,13,4,18.7
0,0,1,3,2,5,2,2,2,"16",0,0,8,1,0,1,1037691,"2023-11-06T00:00:00.000Z",5,FALSE,29,17895983,"G",5,5,"Chicago Bulls","Ayo Dosunmu",0,9,9,8,1,8.2
1,1,2,0,0,10,5,3,2,"14",5,2,12,7,1,2,1037691,"2023-11-06T00:00:00.000Z",5,FALSE,29,137,"C",5,5,"Chicago Bulls","Andre Drummond",2,19,20,13,8,25.9
0,0,1,1,0,1,0,0,0,"02",0,0,0,1,0,0,1037691,"2023-11-06T00:00:00.000Z",5,FALSE,29,56677857,"F",5,5,"Chicago Bulls","Julian Phillips",0,1,1,0,1,1.2
0,0,1,0,0,0,0,0,0,"02",0,0,0,1,0,0,1037691,"2023-11-06T00:00:00.000Z",5,FALSE,29,17896116,"G",5,5,"Chicago Bulls","Terry Taylor",0,1,1,0,1,1.2
1,0,1,1,0,3,1,0,0,"03",0,0,2,1,0,1,1037691,"2023-11-06T00:00:00.000Z",5,FALSE,29,38017719,"F",5,5,"Chicago Bulls","Dalen Terry",0,3,4,3,2,3.7
0,0,3,4,2,10,4,0,0,"25",0,1,10,3,0,0,1037691,"2023-11-06T00:00:00.000Z",5,FALSE,29,3547248,"F",5,5,"Chicago Bulls","Patrick Williams",0,13,13,10,3,13.6
0,0,0,0,0,0,0,0,0,"00",0,0,0,0,0,0,1037691,"2023-11-06T00:00:00.000Z",5,FALSE,29,27,"G",5,5,"Chicago Bulls","Lonzo Ball",0,0,0,0,0,0
0,0,0,0,0,0,0,0,0,"00",0,0,0,0,0,0,1037691,"2023-11-06T00:00:00.000Z",5,FALSE,29,56677874,"F",5,5,"Chicago Bulls","Onuralp Bitim",0,0,0,0,0,0
3,1,4,12,5,15,8,8,8,"34",1,2,29,5,0,1,1037691,"2023-11-06T00:00:00.000Z",5,FALSE,29,297,"F",29,29,"Utah Jazz","Lauri Markkanen",1,34,37,32,8,41.5
0,0,5,2,1,9,6,1,1,"29",1,5,14,6,1,2,1037691,"2023-11-06T00:00:00.000Z",5,FALSE,29,101,"F-C",29,29,"Utah Jazz","John Collins",1,20,20,14,6,22.2
0,4,4,2,1,12,5,6,4,"31",11,3,15,15,0,1,1037691,"2023-11-06T00:00:00.000Z",5,FALSE,29,38017705,"C",29,29,"Utah Jazz","Walker Kessler",4,30,30,15,15,44
6,0,0,8,1,14,3,0,0,"29",1,1,7,1,0,5,1037691,"2023-11-06T00:00:00.000Z",5,FALSE,29,100,"G",29,29,"Utah Jazz","Jordan Clarkson",0,8,14,13,7,12.2
4,0,6,3,1,5,2,0,0,"23",0,0,5,6,0,5,1037691,"2023-11-06T00:00:00.000Z",5,FALSE,29,666650,"G",29,29,"Utah Jazz","Talen Horton-Tucker",0,11,15,9,10,13.2
1,1,1,2,1,3,1,0,0,"11",0,2,3,1,0,2,1037691,"2023-11-06T00:00:00.000Z",5,FALSE,29,38017620,"G",29,29,"Utah Jazz","Ochai Agbaji",1,4,5,4,2,6.7
3,0,3,1,1,1,1,0,0,"10",2,1,3,5,0,2,1037691,"2023-11-06T00:00:00.000Z",5,FALSE,29,139,"G",29,29,"Utah Jazz","Kris Dunn",0,8,11,6,8,11.5
2,0,2,3,1,10,6,1,1,"17",1,3,14,3,0,1,1037691,"2023-11-06T00:00:00.000Z",5,FALSE,29,413,"G",29,29,"Utah Jazz","Collin Sexton",0,17,19,16,5,19.6
0,1,0,0,0,1,1,0,0,"04",0,0,2,0,0,0,1037691,"2023-11-06T00:00:00.000Z",5,FALSE,29,11891374,"C",29,29,"Utah Jazz","Omer Yurtseven",1,2,2,2,0,5
0,0,0,0,0,0,0,0,0,"00",0,0,0,0,0,0,1037691,"2023-11-06T00:00:00.000Z",5,FALSE,29,17896023,"G",29,29,"Utah Jazz","Josh Christopher",0,0,0,0,0,0
0,0,0,0,0,0,0,0,0,"00",0,0,0,0,0,0,1037691,"2023-11-06T00:00:00.000Z",5,FALSE,29,56677824,"F",29,29,"Utah Jazz","Taylor Hendricks",0,0,0,0,0,0
0,0,0,0,0,0,0,0,0,"00",0,0,0,0,0,0,1037691,"2023-11-06T00:00:00.000Z",5,FALSE,29,38017630,"G",29,29,"Utah Jazz","Johnny Juzang",0,0,0,0,0,0
0,0,0,0,0,0,0,0,0,"00",0,0,0,0,0,0,1037691,"2023-11-06T00:00:00.000Z",5,FALSE,29,45969255,"F",5,5,"Chicago Bulls","Justin Lewis",0,0,0,0,0,0
0,0,0,0,0,0,0,0,0,"00",0,0,0,0,0,0,1037691,"2023-11-06T00:00:00.000Z",5,FALSE,29,56677860,"F",5,5,"Chicago Bulls","Adama Sanogo",0,0,0,0,0,0
0,0,0,2,0,2,0,0,0,"04",0,0,0,0,0,1,1037691,"2023-11-06T00:00:00.000Z",5,FALSE,29,38017739,"F",29,29,"Utah Jazz","Simone Fontecchio",0,0,0,0,0,-1
4,0,2,3,1,5,2,0,0,"21",0,1,5,2,0,2,1037691,"2023-11-06T00:00:00.000Z",5,FALSE,29,56677834,"G",29,29,"Utah Jazz","Keyonte George",0,7,11,9,6,11.4
8,0,7,3,2,7,5,1,1,"23",0,1,13,7,0,0,1037691,"2023-11-06T00:00:00.000Z",5,FALSE,29,358,"F",29,29,"Utah Jazz","Kelly Olynyk",0,20,28,21,15,33.4
1,0,1,2,1,2,1,0,0,"04",0,1,3,1,0,0,1037691,"2023-11-06T00:00:00.000Z",5,FALSE,29,666881,"F",29,29,"Utah Jazz","Luka Samanic",0,4,5,4,2,5.7
0,0,0,0,0,0,0,0,0,"00",0,0,0,0,0,0,1037691,"2023-11-06T00:00:00.000Z",5,FALSE,29,19465584,"F",29,29,"Utah Jazz","Micah Potter",0,0,0,0,0,0
0,0,0,0,0,0,0,0,0,"00",0,0,0,0,0,0,1037691,"2023-11-06T00:00:00.000Z",5,FALSE,29,56677842,"F",29,29,"Utah Jazz","Brice Sensabaugh",0,0,0,0,0,0
0,0,0,0,0,0,0,0,0,"00",0,0,0,0,0,0,1037692,"2023-11-06T00:00:00.000Z",11,FALSE,26,17895941,"C",26,26,"Sacramento Kings","Filip Petrusev",0,0,0,0,0,0
1,0,0,3,0,4,1,0,0,"12",0,2,2,0,0,0,1037692,"2023-11-06T00:00:00.000Z",11,FALSE,26,4197162,"F",26,26,"Sacramento Kings","Aleksandar Vezenkov",0,2,3,3,1,3.5
0,0,0,0,0,0,0,0,0,"00",0,0,0,0,0,0,1037692,"2023-11-06T00:00:00.000Z",11,FALSE,26,161,"G",26,26,"Sacramento Kings","De'Aaron Fox",0,0,0,0,0,0
0,0,0,0,0,0,0,0,0,"00",0,0,0,0,0,0,1037692,"2023-11-06T00:00:00.000Z",11,FALSE,26,290,"F",26,26,"Sacramento Kings","Trey Lyles",0,0,0,0,0,0
0,0,0,0,0,0,0,0,0,"00",0,0,0,0,0,0,1037692,"2023-11-06T00:00:00.000Z",11,FALSE,26,56677862,"F",26,26,"Sacramento Kings","Jalen Slawson",0,0,0,0,0,0
0,0,0,2,2,4,2,0,0,"06",0,1,6,0,0,0,1037692,"2023-11-06T00:00:00.000Z",11,FALSE,26,3547281,"G-F",11,11,"Houston Rockets","Nate Hinton",0,6,6,6,0,6
1,0,3,0,0,6,6,1,1,"21",0,1,13,3,1,2,1037692,"2023-11-06T00:00:00.000Z",11,FALSE,26,213,"G",11,11,"Houston Rockets","Aaron Holiday",1,16,17,14,4,19.1
1,0,0,2,1,3,2,0,0,"16",1,2,5,1,1,2,1037692,"2023-11-06T00:00:00.000Z",11,FALSE,26,19465326,"C",11,11,"Houston Rockets","Jock Landale",1,6,7,6,2,8.7
2,1,1,1,0,3,0,0,0,"06",0,0,0,1,0,0,1037692,"2023-11-06T00:00:00.000Z",11,FALSE,26,296,"C",11,11,"Houston Rockets","Boban Marjanovic",1,1,3,2,3,7.2
0,1,2,0,0,2,2,0,0,"12",1,1,4,3,0,0,1037692,"2023-11-06T00:00:00.000Z",11,FALSE,26,56677809,"F",11,11,"Houston Rockets","Jermaine Samuels Jr.",1,7,7,4,3,10.6
1,0,3,4,2,5,3,0,0,"21",1,2,8,4,2,0,1037692,"2023-11-06T00:00:00.000Z",11,FALSE,26,3547301,"F",11,11,"Houston Rockets","Jae'Sean Tate",2,12,13,9,5,20.3
1,0,1,1,0,5,3,2,1,"12",0,1,7,1,1,0,1037692,"2023-11-06T00:00:00.000Z",11,FALSE,26,56677831,"F",11,11,"Houston Rockets","Cam Whitmore",1,8,9,8,2,12.7
0,0,0,0,0,0,0,0,0,"00",0,0,0,0,0,0,1037692,"2023-11-06T00:00:00.000Z",11,FALSE,26,38017695,"F",11,11,"Houston Rockets","Tari Eason",0,0,0,0,0,0
0,0,0,0,0,0,0,0,0,"00",0,0,0,0,0,0,1037692,"2023-11-06T00:00:00.000Z",11,FALSE,26,357,"G",11,11,"Houston Rockets","Victor Oladipo",0,0,0,0,0,0
1,0,6,3,1,6,3,2,2,"28",0,1,9,6,0,1,1037692,"2023-11-06T00:00:00.000Z",11,FALSE,26,66,"G-F",11,11,"Houston Rockets","Dillon Brooks",0,15,16,10,7,16.7
0,1,4,5,3,8,5,0,0,"22",0,4,13,4,0,0,1037692,"2023-11-06T00:00:00.000Z",11,FALSE,26,38017684,"F",11,11,"Houston Rockets","Jabari Smith Jr.",1,17,17,13,4,20.8
12,0,6,2,0,13,7,4,3,"26",2,3,17,8,1,1,1037692,"2023-11-06T00:00:00.000Z",11,FALSE,26,17896062,"F-C",11,11,"Houston Rockets","Alperen Sengun",1,25,37,29,20,46.6
2,1,2,5,3,9,5,12,10,"26",0,0,23,2,1,3,1037692,"2023-11-06T00:00:00.000Z",11,FALSE,26,17895966,"G",11,11,"Houston Rockets","Jalen Green",2,25,27,25,4,31.4
5,0,4,5,3,8,3,2,2,"27",0,1,11,4,0,1,1037692,"2023-11-06T00:00:00.000Z",11,FALSE,26,458,"G",11,11,"Houston Rockets","Fred VanVleet",0,15,20,16,9,22.3
2,0,1,1,0,1,0,0,0,"12",0,1,0,1,0,0,1037692,"2023-11-06T00:00:00.000Z",11,FALSE,26,75,"G-F",11,11,"Houston Rockets","Reggie Bullock",0,1,3,2,3,4.2
0,0,1,0,0,2,2,4,2,"05",0,1,6,1,1,0,1037692,"2023-11-06T00:00:00.000Z",11,FALSE,26,188,"F",11,11,"Houston Rockets","Jeff Green",1,7,7,6,1,10.2
2,0,1,2,1,4,1,2,1,"12",0,1,4,1,1,0,1037692,"2023-11-06T00:00:00.000Z",11,FALSE,26,17896044,"F",26,26,"Sacramento Kings","Kessler Edwards",1,5,7,6,3,11.2
1,0,1,6,4,7,5,4,1,"14",1,1,15,2,1,0,1037692,"2023-11-06T00:00:00.000Z",11,FALSE,26,38017714,"G",26,26,"Sacramento Kings","Keon Ellis",1,17,18,16,3,21.9
1,0,1,1,1,3,2,0,0,"09",0,0,5,1,0,0,1037692,"2023-11-06T00:00:00.000Z",11,FALSE,26,17895990,"G",26,26,"Sacramento Kings","Jordan Ford",0,6,7,6,2,7.7
1,0,2,0,0,6,4,2,2,"13",3,1,10,5,0,0,1037692,"2023-11-06T00:00:00.000Z",11,FALSE,26,56677845,"G",26,26,"Sacramento Kings","Colby Jones",0,15,16,11,6,17.5
1,1,2,1,0,1,0,0,0,"08",1,0,0,3,0,0,1037692,"2023-11-06T00:00:00.000Z",11,FALSE,26,273,"C",26,26,"Sacramento Kings","Alex Len",1,3,4,1,4,8.1
0,0,0,0,0,5,4,2,2,"10",3,4,10,3,0,2,1037692,"2023-11-06T00:00:00.000Z",11,FALSE,26,306,"C",26,26,"Sacramento Kings","JaVale McGee",0,13,13,10,3,11.6
2,0,1,3,1,6,2,0,0,"15",0,3,5,1,1,1,1037692,"2023-11-06T00:00:00.000Z",11,FALSE,26,324,"G",26,26,"Sacramento Kings","Malik Monk",1,6,8,7,3,11.2
0,0,0,0,0,0,0,0,0,"00",0,0,0,0,0,0,1037692,"2023-11-06T00:00:00.000Z",11,FALSE,26,47738533,"G",11,11,"Houston Rockets","Jeenathan Williams",0,0,0,0,0,0
1,0,0,4,0,6,1,2,1,"22",0,0,3,0,0,0,1037692,"2023-11-06T00:00:00.000Z",11,FALSE,26,30,"F",26,26,"Sacramento Kings","Harrison Barnes",0,3,4,4,1,4.5
1,0,5,6,2,11,5,0,0,"28",0,3,12,5,1,2,1037692,"2023-11-06T00:00:00.000Z",11,FALSE,26,38017688,"F",26,26,"Sacramento Kings","Keegan Murray",1,17,18,13,6,20.5
5,0,5,0,0,4,3,3,2,"30",3,4,8,8,0,4,1037692,"2023-11-06T00:00:00.000Z",11,FALSE,26,406,"F",26,26,"Sacramento Kings","Domantas Sabonis",0,16,21,13,13,21.1
2,0,3,8,3,10,5,1,0,"25",0,0,13,3,1,3,1037692,"2023-11-06T00:00:00.000Z",11,FALSE,26,221,"G",26,26,"Sacramento Kings","Kevin Huerter",1,16,18,15,5,19.6
2,1,0,5,1,11,2,0,0,"27",1,2,5,1,0,0,1037692,"2023-11-06T00:00:00.000Z",11,FALSE,26,17553994,"G",26,26,"Sacramento Kings","Davion Mitchell",1,6,8,7,3,12.2
2,0,1,1,1,3,1,4,2,"15",0,1,5,1,0,1,1037692,"2023-11-06T00:00:00.000Z",11,FALSE,26,17896030,"G",26,26,"Sacramento Kings","Chris Duarte",0,6,8,7,3,8.2
0,0,0,0,0,0,0,0,0,"00",0,0,0,0,0,0,1037692,"2023-11-06T00:00:00.000Z",11,FALSE,26,56677825,"G-F",11,11,"Houston Rockets","Amen Thompson",0,0,0,0,0,0
1,0,1,9,4,18,8,0,0,"45",1,3,20,2,1,3,1037693,"2023-11-06T00:00:00.000Z",18,FALSE,2,3547259,"F",18,18,"Minnesota Timberwolves","Jaden McDaniels",1,22,23,21,3,23.9
3,0,10,7,1,10,3,0,0,"28",0,6,7,10,0,7,1037693,"2023-11-06T00:00:00.000Z",18,FALSE,2,447,"C",18,18,"Minnesota Timberwolves","Karl-Anthony Towns",0,17,20,10,13,16.5
1,1,10,0,0,6,6,11,2,"41",2,4,14,12,0,2,1037693,"2023-11-06T00:00:00.000Z",18,FALSE,2,176,"C",18,18,"Minnesota Timberwolves","Rudy Gobert",1,26,27,15,13,30.9
7,0,9,8,2,25,15,7,6,"38",0,5,38,9,1,3,1037693,"2023-11-06T00:00:00.000Z",18,FALSE,2,3547238,"G",18,18,"Minnesota Timberwolves","Anthony Edwards",1,47,54,45,16,59.3
3,0,2,3,2,5,3,0,0,"36",0,1,8,2,2,0,1037693,"2023-11-06T00:00:00.000Z",18,FALSE,2,104,"G",18,18,"Minnesota Timberwolves","Mike Conley",2,10,13,11,5,20.9
3,0,1,4,2,6,3,1,0,"20",0,3,8,1,1,1,1037693,"2023-11-06T00:00:00.000Z",18,FALSE,2,666400,"G",18,18,"Minnesota Timberwolves","Nickeil Alexander-Walker",1,9,12,11,4,15.7
6,1,3,2,0,6,1,2,1,"25",2,4,3,5,0,4,1037693,"2023-11-06T00:00:00.000Z",18,FALSE,2,12,"F",18,18,"Minnesota Timberwolves","Kyle Anderson",1,8,14,9,11,17
0,0,0,0,0,0,0,0,0,"00",0,0,0,0,0,0,1037693,"2023-11-06T00:00:00.000Z",18,FALSE,2,68,"F",18,18,"Minnesota Timberwolves","Troy Brown Jr.",0,0,0,0,0,0
0,1,0,0,0,0,0,2,2,"04",0,0,2,0,0,0,1037693,"2023-11-06T00:00:00.000Z",18,FALSE,2,666767,"G",18,18,"Minnesota Timberwolves","Jordan McLaughlin",1,2,2,2,0,5
0,0,0,0,0,0,0,0,0,"03",0,0,0,0,0,0,1037693,"2023-11-06T00:00:00.000Z",18,FALSE,2,320,"G",18,18,"Minnesota Timberwolves","Shake Milton",0,0,0,0,0,0
0,0,0,0,0,0,0,0,0,"00",0,0,0,0,0,0,1037693,"2023-11-06T00:00:00.000Z",18,FALSE,2,38017715,"F",18,18,"Minnesota Timberwolves","Josh Minott",0,0,0,0,0,0
0,0,0,0,0,0,0,0,0,"00",0,0,0,0,0,0,1037693,"2023-11-06T00:00:00.000Z",18,FALSE,2,17895968,"F",18,18,"Minnesota Timberwolves","Daishen Nix",0,0,0,0,0,0
2,2,3,4,2,9,5,2,2,"25",1,0,14,4,2,3,1037693,"2023-11-06T00:00:00.000Z",18,FALSE,2,667378,"F-C",18,18,"Minnesota Timberwolves","Naz Reid",4,18,20,16,6,30.8
0,0,0,0,0,0,0,0,0,"00",0,0,0,0,0,0,1037693,"2023-11-06T00:00:00.000Z",18,FALSE,2,56677851,"G",18,18,"Minnesota Timberwolves","Jaylen Clark",0,0,0,0,0,0
0,0,0,0,0,0,0,0,0,"00",0,0,0,0,0,0,1037693,"2023-11-06T00:00:00.000Z",18,FALSE,2,17896056,"C",18,18,"Minnesota Timberwolves","Luka Garza",0,0,0,0,0,0
0,0,0,0,0,0,0,0,0,"00",0,0,0,0,0,0,1037693,"2023-11-06T00:00:00.000Z",18,FALSE,2,56677782,"F",18,18,"Minnesota Timberwolves","Leonard Miller",0,0,0,0,0,0
0,0,0,0,0,0,0,0,0,"00",0,0,0,0,0,0,1037693,"2023-11-06T00:00:00.000Z",18,FALSE,2,38017700,"G",18,18,"Minnesota Timberwolves","Wendell Moore Jr.",0,0,0,0,0,0
2,0,5,8,2,22,12,8,6,"43",0,2,32,5,5,6,1037693,"2023-11-06T00:00:00.000Z",18,FALSE,2,434,"F",2,2,"Boston Celtics","Jayson Tatum",5,37,39,34,7,50
4,0,3,4,1,5,1,0,0,"36",2,4,3,5,1,2,1037693,"2023-11-06T00:00:00.000Z",18,FALSE,2,219,"C-F",2,2,"Boston Celtics","Al Horford",1,8,12,7,9,16
1,1,4,6,2,14,5,10,8,"36",1,5,20,5,1,1,1037693,"2023-11-06T00:00:00.000Z",18,FALSE,2,378,"F-C",2,2,"Boston Celtics","Kristaps Porzingis",2,25,26,21,6,32.5
4,0,7,8,3,21,10,4,3,"39",0,5,26,7,1,3,1037693,"2023-11-06T00:00:00.000Z",18,FALSE,2,70,"G",2,2,"Boston Celtics","Jaylen Brown",1,33,37,30,11,40.4
6,0,8,4,0,16,4,6,4,"42",3,3,12,11,1,3,1037693,"2023-11-06T00:00:00.000Z",18,FALSE,2,214,"G",2,2,"Boston Celtics","Jrue Holiday",1,23,29,18,17,34.2
0,1,3,8,3,8,3,2,2,"25",1,3,11,4,1,1,1037693,"2023-11-06T00:00:00.000Z",18,FALSE,2,17896060,"F",2,2,"Boston Celtics","Sam Hauser",2,15,15,11,4,20.8
3,0,3,1,0,3,0,0,0,"20",3,2,0,6,0,0,1037693,"2023-11-06T00:00:00.000Z",18,FALSE,2,3547276,"G",2,2,"Boston Celtics","Payton Pritchard",0,6,9,3,9,11.7
0,0,1,0,0,1,0,0,0,"04",0,0,0,1,1,0,1037693,"2023-11-06T00:00:00.000Z",18,FALSE,2,3547279,"F",2,2,"Boston Celtics","Lamar Stevens",1,1,1,0,1,4.2
0,0,0,0,0,0,0,0,0,"00",0,0,0,0,0,0,1037693,"2023-11-06T00:00:00.000Z",18,FALSE,2,17553967,"C",2,2,"Boston Celtics","Neemias Queta",0,0,0,0,0,0
0,0,0,0,0,0,0,0,0,"00",0,0,0,0,0,0,1037693,"2023-11-06T00:00:00.000Z",18,FALSE,2,56677864,"G",2,2,"Boston Celtics","Jordan Walsh",0,0,0,0,0,0
0,0,0,0,0,0,0,0,0,"00",0,0,0,0,0,0,1037693,"2023-11-06T00:00:00.000Z",18,FALSE,2,473,"G",2,2,"Boston Celtics","Derrick White",0,0,0,0,0,0
0,0,0,0,0,0,0,0,0,"04",0,0,0,0,0,0,1037693,"2023-11-06T00:00:00.000Z",18,FALSE,2,338,"G",2,2,"Boston Celtics","Svi Mykhailiuk",0,0,0,0,0,0
0,0,0,0,0,2,1,4,3,"16",1,2,5,1,2,0,1037693,"2023-11-06T00:00:00.000Z",18,FALSE,2,261,"F-C",2,2,"Boston Celtics","Luke Kornet",2,6,6,5,1,12.2
0,0,0,0,0,0,0,0,0,"00",0,0,0,0,0,0,1037693,"2023-11-06T00:00:00.000Z",18,FALSE,2,17896094,"G",2,2,"Boston Celtics","Dalano Banton",0,0,0,0,0,0
0,0,0,0,0,0,0,0,0,"00",0,0,0,0,0,0,1037693,"2023-11-06T00:00:00.000Z",18,FALSE,2,666468,"F",2,2,"Boston Celtics","Oshae Brissett",0,0,0,0,0,0
0,0,0,0,0,0,0,0,0,"00",0,0,0,0,0,0,1037693,"2023-11-06T00:00:00.000Z",18,FALSE,2,38017707,"G",2,2,"Boston Celtics","JD Davison",0,0,0,0,0,0
0,0,0,0,0,0,0,0,0,"00",0,0,0,0,0,0,1037693,"2023-11-06T00:00:00.000Z",18,FALSE,2,3547295,"F-C",2,2,"Boston Celtics","Nathan Knight",0,0,0,0,0,0
3,2,7,5,2,10,6,5,5,"32",2,1,19,9,0,2,1037694,"2023-11-06T00:00:00.000Z",21,FALSE,1,666541,"G",21,21,"Oklahoma City Thunder","Luguentz Dort",2,28,31,22,12,38.3
2,1,3,5,2,13,8,3,3,"36",0,5,21,3,0,2,1037694,"2023-11-06T00:00:00.000Z",21,FALSE,1,38017703,"G-F",21,21,"Oklahoma City Thunder","Jalen Williams",1,24,26,23,5,28.6
3,3,9,3,1,14,4,7,7,"34",3,3,16,12,1,1,1037694,"2023-11-06T00:00:00.000Z",21,FALSE,1,38017685,"C-F",21,21,"Oklahoma City Thunder","Chet Holmgren",4,28,31,19,15,45.9
4,0,4,0,0,13,4,0,0,"27",3,3,8,7,0,4,1037694,"2023-11-06T00:00:00.000Z",21,FALSE,1,17896065,"G",21,21,"Oklahoma City Thunder","Josh Giddey",0,15,19,12,11,18.4
6,0,7,7,3,20,11,6,5,"37",1,5,30,8,1,2,1037694,"2023-11-06T00:00:00.000Z",21,FALSE,1,175,"G",21,21,"Oklahoma City Thunder","Shai Gilgeous-Alexander",1,38,44,36,14,49.6
0,0,0,0,0,0,0,0,0,"00",0,0,0,0,0,0,1037694,"2023-11-06T00:00:00.000Z",21,FALSE,1,44,"F",21,21,"Oklahoma City Thunder","Davis Bertans",0,0,0,0,0,0
0,0,1,2,1,4,1,0,0,"10",1,0,3,2,0,1,1037694,"2023-11-06T00:00:00.000Z",21,FALSE,1,38017716,"F",21,21,"Oklahoma City Thunder","Ousmane Dieng",0,5,5,3,2,4.4
3,0,3,8,4,8,4,0,0,"20",0,1,12,3,0,0,1037694,"2023-11-06T00:00:00.000Z",21,FALSE,1,3547272,"G",21,21,"Oklahoma City Thunder","Isaiah Joe",0,15,18,15,6,20.1
0,0,0,0,0,0,0,0,0,"00",0,0,0,0,0,0,1037694,"2023-11-06T00:00:00.000Z",21,FALSE,1,17896036,"G",21,21,"Oklahoma City Thunder","Tre Mann",0,0,0,0,0,0
0,0,0,0,0,0,0,0,0,"00",0,0,0,0,0,0,1037694,"2023-11-06T00:00:00.000Z",21,FALSE,1,4197029,"G",21,21,"Oklahoma City Thunder","Vasilije Micic",0,0,0,0,0,0
0,0,0,0,0,0,0,0,0,"00",0,0,0,0,0,0,1037694,"2023-11-06T00:00:00.000Z",21,FALSE,1,3547271,"C",21,21,"Oklahoma City Thunder","Aleksej Pokusevski",0,0,0,0,0,0
4,0,2,3,0,6,3,0,0,"24",0,1,6,2,4,1,1037694,"2023-11-06T00:00:00.000Z",21,FALSE,1,56677833,"G",21,21,"Oklahoma City Thunder","Cason Wallace",4,8,12,10,6,25.4
0,0,0,0,0,0,0,0,0,"00",0,0,0,0,0,0,1037694,"2023-11-06T00:00:00.000Z",21,FALSE,1,27924547,"F",21,21,"Oklahoma City Thunder","Lindy Waters III",0,0,0,0,0,0
0,0,0,1,1,2,2,0,0,"07",1,0,5,1,0,0,1037694,"2023-11-06T00:00:00.000Z",21,FALSE,1,17896078,"G",21,21,"Oklahoma City Thunder","Aaron Wiggins",0,6,6,5,1,6.2
2,1,2,2,0,5,2,2,2,"13",0,3,6,2,1,0,1037694,"2023-11-06T00:00:00.000Z",21,FALSE,1,38017706,"F",21,21,"Oklahoma City Thunder","Jaylin Williams",2,8,10,8,4,17.4
0,0,0,0,0,0,0,0,0,"00",0,0,0,0,0,0,1037694,"2023-11-06T00:00:00.000Z",21,FALSE,1,56677853,"F",21,21,"Oklahoma City Thunder","Keyontae Johnson",0,0,0,0,0,0
0,0,0,0,0,0,0,0,0,"00",0,0,0,0,0,0,1037694,"2023-11-06T00:00:00.000Z",21,FALSE,1,24572055,"C",21,21,"Oklahoma City Thunder","Olivier Sarr",0,0,0,0,0,0
0,0,0,0,0,0,0,0,0,"00",0,0,0,0,0,0,1037694,"2023-11-06T00:00:00.000Z",21,FALSE,1,480,"G-F",21,21,"Oklahoma City Thunder","Kenrich Williams",0,0,0,0,0,0
0,0,2,7,1,13,2,4,3,"33",0,2,8,2,0,0,1037694,"2023-11-06T00:00:00.000Z",21,FALSE,1,666656,"F",1,1,"Atlanta Hawks","De'Andre Hunter",0,10,10,8,2,10.4
0,2,6,0,0,5,2,4,2,"22",6,2,6,12,1,1,1037694,"2023-11-06T00:00:00.000Z",21,FALSE,1,83,"C",1,1,"Atlanta Hawks","Clint Capela",3,18,18,6,12,28.4
6,0,2,9,6,16,7,10,9,"33",2,4,29,4,1,3,1037694,"2023-11-06T00:00:00.000Z",21,FALSE,1,334,"G",1,1,"Atlanta Hawks","Dejounte Murray",1,33,39,35,10,42.8
11,0,3,5,1,18,5,11,11,"36",1,1,22,4,1,7,1037694,"2023-11-06T00:00:00.000Z",21,FALSE,1,490,"G",1,1,"Atlanta Hawks","Trae Young",1,26,37,33,15,39.3
2,0,4,6,3,11,6,0,0,"26",4,1,15,8,0,2,1037694,"2023-11-06T00:00:00.000Z",21,FALSE,1,3547256,"F",1,1,"Atlanta Hawks","Saddiq Bey",0,23,25,17,10,25.6
3,0,2,8,3,14,7,0,0,"27",0,1,17,2,2,0,1037694,"2023-11-06T00:00:00.000Z",21,FALSE,1,53,"G",1,1,"Atlanta Hawks","Bogdan Bogdanovic",2,19,22,20,5,29.9
0,0,0,0,0,0,0,0,0,"00",0,0,0,0,0,0,1037694,"2023-11-06T00:00:00.000Z",21,FALSE,1,666564,"F",1,1,"Atlanta Hawks","Bruno Fernando",0,0,0,0,0,0
0,0,0,0,0,0,0,0,0,"00",0,0,0,0,0,0,1037694,"2023-11-06T00:00:00.000Z",21,FALSE,1,3547297,"G",1,1,"Atlanta Hawks","Trent Forrest",0,0,0,0,0,0
0,0,0,0,0,0,0,0,0,"00",0,0,0,0,0,0,1037694,"2023-11-06T00:00:00.000Z",21,FALSE,1,38017689,"F",1,1,"Atlanta Hawks","AJ Griffin",0,0,0,0,0,0
0,0,0,0,0,0,0,0,0,"00",0,0,0,0,0,0,1037694,"2023-11-06T00:00:00.000Z",21,FALSE,1,56677806,"F",1,1,"Atlanta Hawks","Mouhamed Gueye",0,0,0,0,0,0
0,0,1,2,0,2,0,0,0,"04",0,0,0,1,0,0,1037694,"2023-11-06T00:00:00.000Z",21,FALSE,1,666754,"G",1,1,"Atlanta Hawks","Garrison Mathews",0,1,1,0,1,1.2
0,0,0,0,0,0,0,0,0,"00",0,0,0,0,0,0,1037694,"2023-11-06T00:00:00.000Z",21,FALSE,1,319,"G",1,1,"Atlanta Hawks","Patty Mills",0,0,0,0,0,0
0,0,8,1,0,8,3,1,1,"25",6,3,7,14,0,2,1037694,"2023-11-06T00:00:00.000Z",21,FALSE,1,3547244,"F-C",1,1,"Atlanta Hawks","Onyeka Okongwu",0,21,21,7,14,21.8
0,0,0,0,0,0,0,0,0,"00",0,0,0,0,0,0,1037694,"2023-11-06T00:00:00.000Z",21,FALSE,1,56677838,"G",1,1,"Atlanta Hawks","Kobe Bufkin",0,0,0,0,0,0
0,0,0,0,0,0,0,0,0,"00",0,0,0,0,0,0,1037694,"2023-11-06T00:00:00.000Z",21,FALSE,1,56677855,"G",1,1,"Atlanta Hawks","Seth Lundy",0,0,0,0,0,0
0,0,0,0,0,0,0,0,0,"00",0,0,0,0,0,0,1037694,"2023-11-06T00:00:00.000Z",21,FALSE,1,301,"G-F",1,1,"Atlanta Hawks","Wesley Matthews",0,0,0,0,0,0
0,0,0,0,0,0,0,0,0,"00",0,0,0,0,0,0,1037694,"2023-11-06T00:00:00.000Z",21,FALSE,1,56677875,"F",1,1,"Atlanta Hawks","Miles Norris",0,0,0,0,0,0
5,1,6,4,0,15,6,2,1,"34",6,2,13,12,3,0,1037694,"2023-11-06T00:00:00.000Z",21,FALSE,1,17896040,"F",1,1,"Atlanta Hawks","Jalen Johnson",4,25,30,18,17,46.9
3,0,7,6,2,16,8,4,4,"29",2,2,22,9,0,1,1037695,"2023-11-06T00:00:00.000Z",8,FALSE,19,375,"F",8,8,"Denver Nuggets","Michael Porter Jr.",0,31,34,25,12,36.3
6,1,7,2,0,11,7,2,1,"36",5,1,15,12,0,2,1037695,"2023-11-06T00:00:00.000Z",8,FALSE,19,177,"F",8,8,"Denver Nuggets","Aaron Gordon",1,27,33,21,18,39.4
12,1,11,6,2,24,15,5,3,"36",3,1,35,14,1,2,1037695,"2023-11-06T00:00:00.000Z",8,FALSE,19,246,"C",8,8,"Denver Nuggets","Nikola Jokic",2,49,61,47,26,73.8
7,0,1,7,3,10,5,2,2,"33",0,4,15,1,1,2,1037695,"2023-11-06T00:00:00.000Z",8,FALSE,19,81,"G",8,8,"Denver Nuggets","Kentavious Caldwell-Pope",1,16,23,22,8,27.7
4,0,1,4,1,8,2,2,2,"24",0,1,7,1,0,0,1037695,"2023-11-06T00:00:00.000Z",8,FALSE,19,236,"G",8,8,"Denver Nuggets","Reggie Jackson",0,8,12,11,5,14.2
1,0,0,1,0,5,1,6,4,"18",0,1,6,0,0,0,1037695,"2023-11-06T00:00:00.000Z",8,FALSE,19,38017709,"G",8,8,"Denver Nuggets","Christian Braun",0,6,7,7,1,7.5
0,0,0,0,0,0,0,0,0,"01",0,0,0,0,0,0,1037695,"2023-11-06T00:00:00.000Z",8,FALSE,19,56677871,"F",8,8,"Denver Nuggets","Hunter Tyson",0,0,0,0,0,0
1,2,3,0,0,3,2,0,0,"19",0,0,4,3,2,0,1037695,"2023-11-06T00:00:00.000Z",8,FALSE,19,38017721,"G",8,8,"Denver Nuggets","Peyton Watson",4,7,8,5,4,21.1
0,0,0,0,0,0,0,0,0,"00",0,0,0,0,0,0,1037695,"2023-11-06T00:00:00.000Z",8,FALSE,19,666489,"F",8,8,"Denver Nuggets","Vlatko Cancar",0,0,0,0,0,0
0,0,0,0,0,0,0,0,0,"00",0,0,0,0,0,0,1037695,"2023-11-06T00:00:00.000Z",8,FALSE,19,17896103,"F-C",8,8,"Denver Nuggets","Jay Huff",0,0,0,0,0,0
0,0,0,0,0,0,0,0,0,"00",0,0,0,0,0,0,1037695,"2023-11-06T00:00:00.000Z",8,FALSE,19,335,"G",8,8,"Denver Nuggets","Jamal Murray",0,0,0,0,0,0
5,0,1,4,0,22,10,2,2,"36",1,1,22,2,0,5,1037695,"2023-11-06T00:00:00.000Z",8,FALSE,19,227,"F",19,19,"New Orleans Pelicans","Brandon Ingram",0,24,29,27,7,26.9
9,0,7,0,0,22,10,1,0,"37",3,2,20,10,2,0,1037695,"2023-11-06T00:00:00.000Z",8,FALSE,19,666969,"F",19,19,"New Orleans Pelicans","Zion Williamson",2,30,39,29,19,51.5
2,1,9,1,0,6,2,2,2,"24",2,6,6,11,0,2,1037695,"2023-11-06T00:00:00.000Z",8,FALSE,19,455,"C",19,19,"New Orleans Pelicans","Jonas Valanciunas",1,17,19,8,13,23.2
1,0,1,3,1,4,2,1,1,"17",0,3,6,1,2,0,1037695,"2023-11-06T00:00:00.000Z",8,FALSE,19,38017727,"G",8,8,"Denver Nuggets","Collin Gillespie",2,7,8,7,2,14.7
0,0,0,0,0,0,0,0,0,"00",0,0,0,0,0,0,1037695,"2023-11-06T00:00:00.000Z",8,FALSE,19,215,"F-G",8,8,"Denver Nuggets","Justin Holiday",0,0,0,0,0,0
0,0,0,0,0,0,0,0,0,"00",0,0,0,0,0,0,1037695,"2023-11-06T00:00:00.000Z",8,FALSE,19,250,"C",8,8,"Denver Nuggets","DeAndre Jordan",0,0,0,0,0,0
0,0,0,0,0,0,0,0,0,"01",0,0,0,0,0,0,1037695,"2023-11-06T00:00:00.000Z",8,FALSE,19,17896007,"G",8,8,"Denver Nuggets","Braxton Key",0,0,0,0,0,0
1,1,1,0,0,0,0,0,0,"06",1,2,0,2,0,1,1037695,"2023-11-06T00:00:00.000Z",8,FALSE,19,3547268,"F-C",8,8,"Denver Nuggets","Zeke Nnaji",1,2,3,1,3,5.9
0,0,0,1,1,1,1,0,0,"01",0,0,3,0,0,0,1037695,"2023-11-06T00:00:00.000Z",8,FALSE,19,56677582,"G",8,8,"Denver Nuggets","Jalen Pickett",0,3,3,3,0,3
1,0,2,9,5,13,8,1,0,"19",0,1,21,2,0,1,1037695,"2023-11-06T00:00:00.000Z",8,FALSE,19,56677776,"G",8,8,"Denver Nuggets","Julian Strawther",0,23,24,22,3,23.9
3,0,6,14,7,19,10,5,4,"38",1,2,31,7,1,1,1037695,"2023-11-06T00:00:00.000Z",8,FALSE,19,56677837,"G",19,19,"New Orleans Pelicans","Jordan Hawkins",1,38,41,34,10,45.9
1,1,2,1,1,5,4,0,0,"21",0,0,9,2,1,3,1037695,"2023-11-06T00:00:00.000Z",8,FALSE,19,38017677,"G",19,19,"New Orleans Pelicans","Dyson Daniels",2,11,12,10,3,15.9
0,0,0,1,0,2,1,0,0,"09",0,1,2,0,0,0,1037695,"2023-11-06T00:00:00.000Z",8,FALSE,19,3547260,"G",19,19,"New Orleans Pelicans","Kira Lewis Jr.",0,2,2,2,0,2
0,0,0,0,0,0,0,0,0,"00",0,0,0,0,0,0,1037695,"2023-11-06T00:00:00.000Z",8,FALSE,19,38017663,"F",19,19,"New Orleans Pelicans","E.J. Liddell",0,0,0,0,0,0
1,0,2,1,1,3,2,0,0,"15",1,1,5,3,0,1,1037695,"2023-11-06T00:00:00.000Z",8,FALSE,19,340,"F",19,19,"New Orleans Pelicans","Larry Nance Jr.",0,8,9,6,4,9.1
1,0,0,6,4,8,5,3,3,"25",0,3,17,0,0,0,1037695,"2023-11-06T00:00:00.000Z",8,FALSE,19,17896017,"F",19,19,"New Orleans Pelicans","Matt Ryan",0,17,18,18,1,18.5
0,0,1,0,0,0,0,0,0,"04",0,0,0,1,0,0,1037695,"2023-11-06T00:00:00.000Z",8,FALSE,19,491,"C",19,19,"New Orleans Pelicans","Cody Zeller",0,1,1,0,1,1.2
0,0,0,0,0,0,0,0,0,"00",0,0,0,0,0,0,1037695,"2023-11-06T00:00:00.000Z",8,FALSE,19,18677986,"F",19,19,"New Orleans Pelicans","Trey Murphy III",0,0,0,0,0,0
0,0,0,0,0,0,0,0,0,"00",0,0,0,0,0,0,1037695,"2023-11-06T00:00:00.000Z",8,FALSE,19,17896021,"F",19,19,"New Orleans Pelicans","Jeremiah Robinson-Earl",0,0,0,0,0,0
2,0,2,2,0,3,1,2,2,"31",0,2,4,2,2,1,1037695,"2023-11-06T00:00:00.000Z",8,FALSE,19,17896024,"F",19,19,"New Orleans Pelicans","Herbert Jones",2,6,8,6,4,14.4
0,0,0,0,0,0,0,0,0,"00",0,0,0,0,0,0,1037695,"2023-11-06T00:00:00.000Z",8,FALSE,19,3547293,"F",19,19,"New Orleans Pelicans","Naji Marshall",0,0,0,0,0,0
0,0,0,0,0,0,0,0,0,"00",0,0,0,0,0,0,1037695,"2023-11-06T00:00:00.000Z",8,FALSE,19,303,"G",19,19,"New Orleans Pelicans","CJ McCollum",0,0,0,0,0,0
0,0,0,0,0,0,0,0,0,"00",0,0,0,0,0,0,1037695,"2023-11-06T00:00:00.000Z",8,FALSE,19,38017726,"G",19,19,"New Orleans Pelicans","Dereon Seabron",0,0,0,0,0,0
0,0,0,0,0,0,0,0,0,"00",0,0,0,0,0,0,1037695,"2023-11-06T00:00:00.000Z",8,FALSE,19,17896097,"G",19,19,"New Orleans Pelicans","Jose Alvarado",0,0,0,0,0,0
4,0,6,4,2,14,6,6,4,"32",1,2,18,7,3,3,1037696,"2023-11-08T00:00:00.000Z",4,FALSE,30,204,"F",4,4,"Charlotte Hornets","Gordon Hayward",3,25,29,22,11,38.4
1,2,6,5,0,11,4,7,6,"36",1,2,14,7,0,2,1037696,"2023-11-08T00:00:00.000Z",4,FALSE,30,666950,"F",4,4,"Charlotte Hornets","P.J. Washington",2,21,22,15,8,27.9
0,1,5,0,0,5,5,6,4,"18",2,4,14,7,0,1,1037696,"2023-11-08T00:00:00.000Z",4,FALSE,30,38017698,"C",4,4,"Charlotte Hornets","Mark Williams",1,21,21,14,7,24.4
2,0,3,2,1,11,5,3,2,"30",2,2,13,5,1,2,1037696,"2023-11-08T00:00:00.000Z",4,FALSE,30,56677823,"F",4,4,"Charlotte Hornets","Brandon Miller",1,18,20,15,7,23
7,0,1,9,3,22,13,7,5,"36",3,3,34,4,1,6,1037696,"2023-11-08T00:00:00.000Z",4,FALSE,30,3547239,"G",4,4,"Charlotte Hornets","LaMelo Ball",1,38,45,41,11,46.3
0,0,0,0,0,0,0,0,0,"00",0,0,0,0,0,0,1037696,"2023-11-08T00:00:00.000Z",4,FALSE,30,56677848,"G",4,4,"Charlotte Hornets","Amari Bailey",0,0,0,0,0,0
0,1,0,0,0,1,0,0,0,"04",0,0,0,0,0,0,1037696,"2023-11-08T00:00:00.000Z",4,FALSE,30,56677866,"F",4,4,"Charlotte Hornets","Leaky Black",1,0,0,0,0,3
0,0,1,2,1,7,4,0,0,"18",0,2,9,1,1,1,1037696,"2023-11-08T00:00:00.000Z",4,FALSE,30,3547253,"G",4,4,"Charlotte Hornets","Theo Maledon",1,10,10,9,1,12.2
1,0,3,0,0,0,0,2,2,"15",0,2,2,3,0,2,1037696,"2023-11-08T00:00:00.000Z",4,FALSE,30,38017708,"G",4,4,"Charlotte Hornets","Bryce McGowens",0,5,6,3,4,5.1
1,0,6,0,0,3,2,4,3,"16",0,2,7,6,0,0,1037696,"2023-11-08T00:00:00.000Z",4,FALSE,30,3547282,"C",4,4,"Charlotte Hornets","Nick Richards",0,13,14,8,7,15.7
0,0,1,0,0,0,0,0,0,"10",0,0,0,1,1,2,1037696,"2023-11-08T00:00:00.000Z",4,FALSE,30,422,"G",4,4,"Charlotte Hornets","Ish Smith",1,1,1,0,1,2.2
0,0,1,1,1,2,2,0,0,"04",0,0,5,1,1,1,1037696,"2023-11-08T00:00:00.000Z",4,FALSE,30,56677846,"G",4,4,"Charlotte Hornets","Nick Smith Jr.",1,6,6,5,1,8.2
1,1,3,2,0,3,0,0,0,"21",2,3,0,5,0,0,1037696,"2023-11-08T00:00:00.000Z",4,FALSE,30,18678001,"F",4,4,"Charlotte Hornets","JT Thor",1,5,6,1,6,10.5
0,0,0,0,0,0,0,0,0,"00",0,0,0,0,0,0,1037696,"2023-11-08T00:00:00.000Z",4,FALSE,30,17896037,"G",4,4,"Charlotte Hornets","James Bouknight",0,0,0,0,0,0
0,0,0,0,0,0,0,0,0,"00",0,0,0,0,0,0,1037696,"2023-11-08T00:00:00.000Z",4,FALSE,30,62,"F",4,4,"Charlotte Hornets","Miles Bridges",0,0,0,0,0,0
0,0,0,0,0,0,0,0,0,"00",0,0,0,0,0,0,1037696,"2023-11-08T00:00:00.000Z",4,FALSE,30,666748,"F",4,4,"Charlotte Hornets","Cody Martin",0,0,0,0,0,0
0,0,0,0,0,0,0,0,0,"00",0,0,0,0,0,0,1037696,"2023-11-08T00:00:00.000Z",4,FALSE,30,347,"G",4,4,"Charlotte Hornets","Frank Ntilikina",0,0,0,0,0,0
0,0,0,0,0,0,0,0,0,"00",0,0,0,0,0,0,1037696,"2023-11-08T00:00:00.000Z",4,FALSE,30,403,"G",4,4,"Charlotte Hornets","Terry Rozier",0,0,0,0,0,0
4,0,6,11,4,24,13,3,3,"31",3,1,33,9,0,2,1037696,"2023-11-08T00:00:00.000Z",4,FALSE,30,265,"F",30,30,"Washington Wizards","Kyle Kuzma",0,42,46,37,13,47.8
5,1,2,1,0,10,3,3,3,"28",1,4,9,3,0,2,1037696,"2023-11-08T00:00:00.000Z",4,FALSE,30,3547242,"F",30,30,"Washington Wizards","Deni Avdija",1,12,17,14,8,21.1
1,2,2,0,0,3,2,2,1,"13",3,4,5,5,0,0,1037696,"2023-11-08T00:00:00.000Z",4,FALSE,30,666577,"F",30,30,"Washington Wizards","Daniel Gafford",2,10,11,6,6,18.5
1,0,1,5,1,12,3,5,4,"20",1,2,11,2,0,1,1037696,"2023-11-08T00:00:00.000Z",4,FALSE,30,666848,"G",30,30,"Washington Wizards","Jordan Poole",0,13,14,12,3,13.9
4,0,5,2,0,6,1,0,0,"19",1,1,2,6,1,1,1037696,"2023-11-08T00:00:00.000Z",4,FALSE,30,249,"G",30,30,"Washington Wizards","Tyus Jones",1,8,12,6,10,17.2
1,0,2,3,2,3,2,0,0,"30",0,5,6,2,0,0,1037696,"2023-11-08T00:00:00.000Z",4,FALSE,30,56677844,"G",30,30,"Washington Wizards","Bilal Coulibaly",0,8,9,7,3,9.9
0,1,0,0,0,0,0,0,0,"03",0,0,0,0,0,0,1037696,"2023-11-08T00:00:00.000Z",4,FALSE,30,38017687,"G",30,30,"Washington Wizards","Johnny Davis",1,0,0,0,0,3
2,1,4,7,4,11,7,2,0,"20",0,3,18,4,0,1,1037696,"2023-11-08T00:00:00.000Z",4,FALSE,30,167,"F",30,30,"Washington Wizards","Danilo Gallinari",1,22,24,20,6,27.8
0,0,0,0,0,3,0,0,0,"04",1,0,0,1,0,0,1037696,"2023-11-08T00:00:00.000Z",4,FALSE,30,3547302,"F",30,30,"Washington Wizards","Anthony Gill",0,1,1,0,1,1.2
2,1,1,6,3,9,6,1,0,"17",0,3,15,1,1,0,1037696,"2023-11-08T00:00:00.000Z",4,FALSE,30,414,"G",30,30,"Washington Wizards","Landry Shamet",2,16,18,17,3,25.2
3,0,1,3,2,5,4,8,8,"26",2,1,18,3,4,1,1037696,"2023-11-08T00:00:00.000Z",4,FALSE,30,487,"G",30,30,"Washington Wizards","Delon Wright",4,21,24,21,6,37.1
0,0,0,0,0,0,0,0,0,"00",0,0,0,0,0,0,1037696,"2023-11-08T00:00:00.000Z",4,FALSE,30,38017704,"F",30,30,"Washington Wizards","Patrick Baldwin Jr.",0,0,0,0,0,0
0,0,0,0,0,0,0,0,0,"00",0,0,0,0,0,0,1037696,"2023-11-08T00:00:00.000Z",4,FALSE,30,18677954,"G",30,30,"Washington Wizards","Jared Butler",0,0,0,0,0,0
0,0,0,0,0,0,0,0,0,"00",0,0,0,0,0,0,1037696,"2023-11-08T00:00:00.000Z",4,FALSE,30,38124126,"F",30,30,"Washington Wizards","John Butler Jr.",0,0,0,0,0,0
3,0,2,4,2,9,5,0,0,"23",1,2,12,3,1,2,1037696,"2023-11-08T00:00:00.000Z",4,FALSE,30,17896045,"F",30,30,"Washington Wizards","Corey Kispert",1,15,18,15,6,21.1
0,0,0,0,0,0,0,0,0,"00",0,0,0,0,0,0,1037696,"2023-11-08T00:00:00.000Z",4,FALSE,30,337,"F-C",30,30,"Washington Wizards","Mike Muscala",0,0,0,0,0,0
0,0,1,1,0,1,0,0,0,"03",0,0,0,1,1,0,1037696,"2023-11-08T00:00:00.000Z",4,FALSE,30,17896106,"F",30,30,"Washington Wizards","Eugene Omoruyi",1,1,1,0,1,4.2
0,0,0,0,0,1,1,1,1,"03",0,0,3,0,2,0,1037696,"2023-11-08T00:00:00.000Z",4,FALSE,30,38017712,"G",30,30,"Washington Wizards","Ryan Rollins",2,3,3,3,0,9
4,0,4,7,4,18,9,0,0,"39",5,1,22,9,2,3,1037697,"2023-11-08T00:00:00.000Z",12,FALSE,29,38017686,"G-F",12,12,"Indiana Pacers","Bennedict Mathurin",2,31,35,26,13,41.8
0,1,1,3,0,7,3,0,0,"19",0,2,6,1,3,1,1037697,"2023-11-08T00:00:00.000Z",12,FALSE,29,3547243,"F",12,12,"Indiana Pacers","Obi Toppin",4,7,7,6,1,18.2
0,3,3,2,0,12,8,8,6,"23",3,2,22,6,0,0,1037697,"2023-11-08T00:00:00.000Z",12,FALSE,29,452,"C-F",12,12,"Indiana Pacers","Myles Turner",3,28,28,22,6,38.2
0,1,4,4,1,11,4,0,0,"32",0,2,9,4,2,2,1037697,"2023-11-08T00:00:00.000Z",12,FALSE,29,69,"G",12,12,"Indiana Pacers","Bruce Brown",3,13,13,9,4,20.8
13,0,5,6,1,12,6,3,3,"31",1,0,16,6,1,2,1037697,"2023-11-08T00:00:00.000Z",12,FALSE,29,3547245,"G",12,12,"Indiana Pacers","Tyrese Haliburton",1,22,35,29,19,43.7
1,1,3,12,2,16,4,0,0,"22",0,2,10,3,1,1,1037697,"2023-11-08T00:00:00.000Z",12,FALSE,29,210,"G",12,12,"Indiana Pacers","Buddy Hield",2,13,14,11,4,20.1
0,0,1,6,4,13,9,2,2,"30",1,4,24,2,2,1,1037697,"2023-11-08T00:00:00.000Z",12,FALSE,29,3547250,"G-F",12,12,"Indiana Pacers","Aaron Nesmith",2,26,26,24,2,31.4
1,1,8,0,0,8,5,7,6,"25",3,0,16,11,2,1,1037697,"2023-11-08T00:00:00.000Z",12,FALSE,29,3547264,"F-C",12,12,"Indiana Pacers","Jalen Smith",3,27,28,17,12,38.7
0,0,0,0,0,0,0,0,0,"00",0,0,0,0,0,0,1037697,"2023-11-08T00:00:00.000Z",12,FALSE,29,56677778,"F-C",12,12,"Indiana Pacers","Oscar Tshiebwe",0,0,0,0,0,0
0,0,0,0,0,0,0,0,0,"00",0,0,0,0,0,0,1037697,"2023-11-08T00:00:00.000Z",12,FALSE,29,56677794,"G",12,12,"Indiana Pacers","Isaiah Wong",0,0,0,0,0,0
1,1,3,3,1,3,1,0,0,"26",1,0,3,4,0,3,1037697,"2023-11-08T00:00:00.000Z",12,FALSE,29,38017620,"G",29,29,"Utah Jazz","Ochai Agbaji",1,7,8,4,5,9.3
1,0,8,2,1,9,6,1,1,"27",1,3,14,9,0,2,1037697,"2023-11-08T00:00:00.000Z",12,FALSE,29,101,"F-C",29,29,"Utah Jazz","John Collins",0,23,24,15,10,24.3
0,1,4,5,3,16,8,6,5,"35",5,1,24,9,1,1,1037697,"2023-11-08T00:00:00.000Z",12,FALSE,29,297,"F",29,29,"Utah Jazz","Lauri Markkanen",2,33,33,24,9,39.8
5,1,1,3,1,26,12,8,8,"34",2,3,33,3,1,6,1037697,"2023-11-08T00:00:00.000Z",12,FALSE,29,100,"G",29,29,"Utah Jazz","Jordan Clarkson",2,36,41,38,8,44.1
9,0,2,3,1,8,3,0,0,"31",0,2,7,2,0,1,1037697,"2023-11-08T00:00:00.000Z",12,FALSE,29,56677834,"G",29,29,"Utah Jazz","Keyonte George",0,9,18,16,11,21.9
2,0,3,1,1,5,3,0,0,"12",1,0,7,4,0,0,1037697,"2023-11-08T00:00:00.000Z",12,FALSE,29,139,"G",29,29,"Utah Jazz","Kris Dunn",0,11,13,9,6,14.8
1,1,2,5,2,8,4,0,0,"18",3,2,10,5,0,2,1037697,"2023-11-08T00:00:00.000Z",12,FALSE,29,38017739,"F",29,29,"Utah Jazz","Simone Fontecchio",1,15,16,11,6,18.5
0,0,0,0,0,0,0,0,0,"00",0,0,0,0,0,0,1037697,"2023-11-08T00:00:00.000Z",12,FALSE,29,666881,"F",29,29,"Utah Jazz","Luka Samanic",0,0,0,0,0,0
0,0,0,0,0,0,0,0,0,"00",0,0,0,0,0,0,1037697,"2023-11-08T00:00:00.000Z",12,FALSE,29,11891374,"C",29,29,"Utah Jazz","Omer Yurtseven",0,0,0,0,0,0
0,0,0,0,0,0,0,0,0,"00",0,0,0,0,0,0,1037697,"2023-11-08T00:00:00.000Z",12,FALSE,29,17896023,"G",29,29,"Utah Jazz","Josh Christopher",0,0,0,0,0,0
0,0,0,0,0,0,0,0,0,"00",0,0,0,0,0,0,1037697,"2023-11-08T00:00:00.000Z",12,FALSE,29,56677824,"F",29,29,"Utah Jazz","Taylor Hendricks",0,0,0,0,0,0
0,0,0,0,0,0,0,0,0,"00",0,0,0,0,0,0,1037697,"2023-11-08T00:00:00.000Z",12,FALSE,29,38017630,"G",29,29,"Utah Jazz","Johnny Juzang",0,0,0,0,0,0
0,0,0,0,0,0,0,0,0,"00",0,0,0,0,0,0,1037697,"2023-11-08T00:00:00.000Z",12,FALSE,29,38017705,"C",29,29,"Utah Jazz","Walker Kessler",0,0,0,0,0,0
0,0,0,0,0,0,0,0,0,"00",0,0,0,0,0,0,1037697,"2023-11-08T00:00:00.000Z",12,FALSE,29,19465584,"F",29,29,"Utah Jazz","Micah Potter",0,0,0,0,0,0
7,0,3,1,1,4,4,0,0,"19",1,2,9,4,1,0,1037697,"2023-11-08T00:00:00.000Z",12,FALSE,29,38017507,"G-F",12,12,"Indiana Pacers","Andrew Nembhard",1,13,20,16,11,27.3
0,0,0,0,0,0,0,0,0,"00",0,0,0,0,0,0,1037697,"2023-11-08T00:00:00.000Z",12,FALSE,29,17896035,"F",12,12,"Indiana Pacers","Isaiah Jackson",0,0,0,0,0,0
0,0,0,0,0,0,0,0,0,"00",0,0,0,0,0,0,1037697,"2023-11-08T00:00:00.000Z",12,FALSE,29,304,"G",12,12,"Indiana Pacers","T.J. McConnell",0,0,0,0,0,0
0,0,0,0,0,0,0,0,0,"00",0,0,0,0,0,0,1037697,"2023-11-08T00:00:00.000Z",12,FALSE,29,3547207,"F",12,12,"Indiana Pacers","Jordan Nwora",0,0,0,0,0,0
0,0,0,0,0,0,0,0,0,"00",0,0,0,0,0,0,1037697,"2023-11-08T00:00:00.000Z",12,FALSE,29,56677861,"G",12,12,"Indiana Pacers","Ben Sheppard",0,0,0,0,0,0
0,0,0,0,0,0,0,0,0,"00",0,0,0,0,0,0,1037697,"2023-11-08T00:00:00.000Z",12,FALSE,29,439,"F",13,12,"Indiana Pacers","Daniel Theis",0,0,0,0,0,0
0,0,0,0,0,0,0,0,0,"00",0,0,0,0,0,0,1037697,"2023-11-08T00:00:00.000Z",12,FALSE,29,56677832,"F",12,12,"Indiana Pacers","Jarace Walker",0,0,0,0,0,0
0,0,0,0,0,0,0,0,0,"00",0,0,0,0,0,0,1037697,"2023-11-08T00:00:00.000Z",12,FALSE,29,38017701,"G",12,12,"Indiana Pacers","Kendall Brown",0,0,0,0,0,0
0,0,0,0,0,0,0,0,0,"00",0,0,0,0,0,0,1037697,"2023-11-08T00:00:00.000Z",12,FALSE,29,56677842,"F",29,29,"Utah Jazz","Brice Sensabaugh",0,0,0,0,0,0
0,0,4,2,0,4,2,0,0,"21",1,5,4,5,1,2,1037697,"2023-11-08T00:00:00.000Z",12,FALSE,29,358,"F",29,29,"Utah Jazz","Kelly Olynyk",1,9,9,4,5,11
5,1,2,1,0,8,3,0,0,"20",2,1,6,4,0,4,1037697,"2023-11-08T00:00:00.000Z",12,FALSE,29,666650,"G",29,29,"Utah Jazz","Talen Horton-Tucker",1,10,15,11,9,17.3
2,0,2,2,1,9,3,3,3,"16",0,0,10,2,0,0,1037697,"2023-11-08T00:00:00.000Z",12,FALSE,29,413,"G",29,29,"Utah Jazz","Collin Sexton",0,12,14,12,4,15.4
0,0,0,0,0,0,0,0,0,"00",0,0,0,0,0,0,1037698,"2023-11-08T00:00:00.000Z",23,FALSE,2,17896094,"G",2,2,"Boston Celtics","Dalano Banton",0,0,0,0,0,0
0,0,0,0,0,0,0,0,0,"00",0,0,0,0,0,0,1037698,"2023-11-08T00:00:00.000Z",23,FALSE,2,666468,"F",2,2,"Boston Celtics","Oshae Brissett",0,0,0,0,0,0
1,0,7,3,1,11,6,2,1,"27",1,0,14,8,1,0,1037698,"2023-11-08T00:00:00.000Z",23,FALSE,2,360,"F",23,23,"Philadelphia 76ers","Kelly Oubre Jr.",1,22,23,15,9,28.1
3,0,7,4,1,12,5,6,6,"38",2,1,17,9,0,2,1037698,"2023-11-08T00:00:00.000Z",23,FALSE,2,200,"F",23,23,"Philadelphia 76ers","Tobias Harris",0,26,29,20,12,30.3
4,4,9,4,1,20,10,6,6,"37",1,3,27,10,1,6,1037698,"2023-11-08T00:00:00.000Z",23,FALSE,2,145,"F-C",23,23,"Philadelphia 76ers","Joel Embiid",5,37,41,31,14,54
2,0,4,7,1,9,1,0,0,"29",0,2,3,4,1,1,1037698,"2023-11-08T00:00:00.000Z",23,FALSE,2,313,"G",23,23,"Philadelphia 76ers","De'Anthony Melton",1,7,9,5,6,12.8
5,2,8,11,3,27,11,1,0,"39",1,4,25,9,1,1,1037698,"2023-11-08T00:00:00.000Z",23,FALSE,2,3547254,"G",23,23,"Philadelphia 76ers","Tyrese Maxey",3,34,39,30,14,51.3
0,0,0,0,0,0,0,0,0,"00",0,0,0,0,0,0,1037698,"2023-11-08T00:00:00.000Z",23,FALSE,2,28,"C",23,23,"Philadelphia 76ers","Mo Bamba",0,0,0,0,0,0
1,1,2,2,1,3,2,0,0,"26",2,2,5,4,0,0,1037698,"2023-11-08T00:00:00.000Z",23,FALSE,2,33,"F-G",23,23,"Philadelphia 76ers","Nicolas Batum",1,9,10,6,5,14.3
4,0,5,1,0,2,1,0,0,"15",0,2,2,5,0,0,1037698,"2023-11-08T00:00:00.000Z",23,FALSE,2,45,"G",23,23,"Philadelphia 76ers","Patrick Beverley",0,7,11,6,9,14
0,0,1,2,1,4,2,0,0,"15",2,2,5,3,2,0,1037698,"2023-11-08T00:00:00.000Z",23,FALSE,2,108,"F",23,23,"Philadelphia 76ers","Robert Covington",2,8,8,5,3,14.6
0,1,4,6,3,8,5,0,0,"19",0,0,13,4,1,0,1037698,"2023-11-08T00:00:00.000Z",23,FALSE,2,17896060,"F",2,2,"Boston Celtics","Sam Hauser",2,17,17,13,4,23.8
3,2,5,6,1,6,1,0,0,"26",0,1,3,5,0,1,1037698,"2023-11-08T00:00:00.000Z",23,FALSE,2,219,"C-F",2,2,"Boston Celtics","Al Horford",2,8,11,6,8,18.5
0,0,0,0,0,0,0,0,0,"03",0,0,0,0,0,0,1037698,"2023-11-08T00:00:00.000Z",23,FALSE,2,261,"F-C",2,2,"Boston Celtics","Luke Kornet",0,0,0,0,0,0
0,0,0,0,0,0,0,0,0,"00",0,0,0,0,0,0,1037698,"2023-11-08T00:00:00.000Z",23,FALSE,2,338,"G",2,2,"Boston Celtics","Svi Mykhailiuk",0,0,0,0,0,0
4,0,0,2,0,4,0,0,0,"16",2,0,0,2,0,1,1037698,"2023-11-08T00:00:00.000Z",23,FALSE,2,3547276,"G",2,2,"Boston Celtics","Payton Pritchard",0,2,6,4,6,7.4
0,0,0,0,0,0,0,0,0,"00",0,0,0,0,0,0,1037698,"2023-11-08T00:00:00.000Z",23,FALSE,2,3547279,"F",2,2,"Boston Celtics","Lamar Stevens",0,0,0,0,0,0
0,0,0,0,0,0,0,0,0,"00",0,0,0,0,0,0,1037698,"2023-11-08T00:00:00.000Z",23,FALSE,2,38017707,"G",2,2,"Boston Celtics","JD Davison",0,0,0,0,0,0
0,0,0,0,0,0,0,0,0,"00",0,0,0,0,0,0,1037698,"2023-11-08T00:00:00.000Z",23,FALSE,2,3547295,"F-C",2,2,"Boston Celtics","Nathan Knight",0,0,0,0,0,0
0,0,0,0,0,0,0,0,0,"00",0,0,0,0,0,0,1037698,"2023-11-08T00:00:00.000Z",23,FALSE,2,17553967,"C",2,2,"Boston Celtics","Neemias Queta",0,0,0,0,0,0
0,0,0,0,0,0,0,0,0,"00",0,0,0,0,0,0,1037698,"2023-11-08T00:00:00.000Z",23,FALSE,2,56677864,"G",2,2,"Boston Celtics","Jordan Walsh",0,0,0,0,0,0
0,0,0,0,0,0,0,0,0,"00",0,0,0,0,0,0,1037698,"2023-11-08T00:00:00.000Z",23,FALSE,2,2175,"",23,23,"Philadelphia 76ers","Danuel House Jr.",0,0,0,0,0,0
0,0,0,0,0,2,0,0,0,"03",0,0,0,0,0,1,1037698,"2023-11-08T00:00:00.000Z",23,FALSE,2,260,"G-F",23,23,"Philadelphia 76ers","Furkan Korkmaz",0,0,0,0,0,-1
0,0,0,0,0,0,0,0,0,"00",0,0,0,0,0,0,1037698,"2023-11-08T00:00:00.000Z",23,FALSE,2,3547294,"F",23,23,"Philadelphia 76ers","Kenyon Martin Jr.",0,0,0,0,0,0
0,0,0,0,0,0,0,0,0,"00",0,0,0,0,0,0,1037698,"2023-11-08T00:00:00.000Z",23,FALSE,2,328,"F",23,23,"Philadelphia 76ers","Marcus Morris",0,0,0,0,0,0
0,0,1,0,0,5,4,0,0,"11",3,0,8,4,1,1,1037698,"2023-11-08T00:00:00.000Z",23,FALSE,2,3547270,"F",23,23,"Philadelphia 76ers","Paul Reed",1,12,12,8,4,14.8
0,0,0,0,0,0,0,0,0,"00",0,0,0,0,0,0,1037698,"2023-11-08T00:00:00.000Z",23,FALSE,2,17896025,"G",23,23,"Philadelphia 76ers","Jaden Springer",0,0,0,0,0,0
0,0,0,0,0,0,0,0,0,"00",0,0,0,0,0,0,1037698,"2023-11-08T00:00:00.000Z",23,FALSE,2,56913527,"G",23,23,"Philadelphia 76ers","Ricky Council IV",0,0,0,0,0,0
0,0,0,0,0,0,0,0,0,"00",0,0,0,0,0,0,1037698,"2023-11-08T00:00:00.000Z",23,FALSE,2,17554001,"G",23,23,"Philadelphia 76ers","Javonte Smart",0,0,0,0,0,0
0,0,0,0,0,0,0,0,0,"00",0,0,0,0,0,0,1037698,"2023-11-08T00:00:00.000Z",23,FALSE,2,56677788,"G",23,23,"Philadelphia 76ers","Terquavion Smith",0,0,0,0,0,0
2,1,2,7,2,13,4,2,1,"35",0,2,11,2,1,4,1037698,"2023-11-08T00:00:00.000Z",23,FALSE,2,70,"G",2,2,"Boston Celtics","Jaylen Brown",2,13,15,13,4,18.4
6,0,14,6,2,14,6,3,2,"37",1,2,16,15,3,2,1037698,"2023-11-08T00:00:00.000Z",23,FALSE,2,434,"F",2,2,"Boston Celtics","Jayson Tatum",3,31,37,22,21,50
3,1,2,6,2,19,10,8,7,"31",4,4,29,6,0,0,1037698,"2023-11-08T00:00:00.000Z",23,FALSE,2,378,"F-C",2,2,"Boston Celtics","Kristaps Porzingis",1,35,38,32,9,43.7
5,1,3,11,3,18,6,4,4,"38",1,3,19,4,2,2,1037698,"2023-11-08T00:00:00.000Z",23,FALSE,2,473,"G",2,2,"Boston Celtics","Derrick White",3,23,28,24,9,38.3
5,0,4,3,2,9,4,2,2,"35",1,1,12,5,1,2,1037698,"2023-11-08T00:00:00.000Z",23,FALSE,2,214,"G",2,2,"Boston Celtics","Jrue Holiday",1,17,22,17,10,26.5
7,2,7,4,1,11,4,2,1,"34",1,1,10,8,2,3,1037699,"2023-11-08T00:00:00.000Z",3,FALSE,13,61,"F",3,3,"Brooklyn Nets","Mikal Bridges",4,18,25,17,15,39.1
2,3,7,8,4,10,4,0,0,"34",3,1,12,10,0,0,1037699,"2023-11-08T00:00:00.000Z",3,FALSE,13,351,"F",3,3,"Brooklyn Nets","Royce O'Neale",3,22,24,14,12,36
2,3,6,8,4,11,4,0,0,"35",3,2,12,9,0,0,1037699,"2023-11-08T00:00:00.000Z",3,FALSE,13,158,"F",3,3,"Brooklyn Nets","Dorian Finney-Smith",3,21,23,14,11,34.8
0,1,2,2,0,14,6,2,2,"20",0,1,14,2,0,2,1037699,"2023-11-08T00:00:00.000Z",3,FALSE,13,17896048,"G",3,3,"Brooklyn Nets","Cam Thomas",1,16,16,14,2,17.4
4,0,3,7,2,8,2,2,1,"26",0,0,7,3,0,2,1037699,"2023-11-08T00:00:00.000Z",3,FALSE,13,130,"G",3,3,"Brooklyn Nets","Spencer Dinwiddie",0,10,14,11,7,14.6
0,0,0,0,0,0,0,0,0,"00",0,0,0,0,0,0,1037699,"2023-11-08T00:00:00.000Z",3,FALSE,13,9051997,"G",3,3,"Brooklyn Nets","Armoni Brooks",0,0,0,0,0,0
0,0,0,0,0,0,0,0,0,"00",0,0,0,0,0,0,1037699,"2023-11-08T00:00:00.000Z",3,FALSE,13,174,"F-C",3,3,"Brooklyn Nets","Harry Giles III",0,0,0,0,0,0
0,0,6,0,0,9,4,3,3,"19",4,3,11,10,2,2,1037699,"2023-11-08T00:00:00.000Z",3,FALSE,13,17896038,"C",3,3,"Brooklyn Nets","Day'Ron Sharpe",2,21,21,11,10,27
5,0,0,3,0,7,2,0,0,"25",1,4,4,1,2,1,1037699,"2023-11-08T00:00:00.000Z",3,FALSE,13,421,"G",3,3,"Brooklyn Nets","Dennis Smith Jr.",2,5,10,9,6,17.7
0,0,0,0,0,0,0,0,0,"00",0,0,0,0,0,0,1037699,"2023-11-08T00:00:00.000Z",3,FALSE,13,56677841,"F",3,3,"Brooklyn Nets","Dariq Whitehead",0,0,0,0,0,0
1,1,6,10,2,20,7,8,8,"39",1,2,24,7,3,3,1037699,"2023-11-08T00:00:00.000Z",3,FALSE,13,172,"F",13,13,"LA Clippers","Paul George",4,31,32,25,8,42.9
2,1,6,6,1,16,7,2,2,"36",0,1,17,6,1,1,1037699,"2023-11-08T00:00:00.000Z",3,FALSE,13,274,"F",13,13,"LA Clippers","Kawhi Leonard",2,23,25,19,8,32.2
1,3,7,0,0,9,5,0,0,"29",3,5,10,10,0,1,1037699,"2023-11-08T00:00:00.000Z",3,FALSE,13,493,"C",13,13,"LA Clippers","Ivica Zubac",3,20,21,11,11,31.5
5,0,8,5,2,9,4,2,2,"36",0,0,12,8,2,5,1037699,"2023-11-08T00:00:00.000Z",3,FALSE,13,192,"G",13,13,"LA Clippers","James Harden",2,20,25,17,13,30.1
8,0,4,5,1,18,6,0,0,"31",3,1,13,7,0,1,1037699,"2023-11-08T00:00:00.000Z",3,FALSE,13,472,"G",13,13,"LA Clippers","Russell Westbrook",0,20,28,21,15,32.4
0,0,0,0,0,0,0,0,0,"00",0,0,0,0,0,0,1037699,"2023-11-08T00:00:00.000Z",3,FALSE,13,56677849,"F",13,13,"LA Clippers","Kobe Brown",0,0,0,0,0,0
0,0,0,0,0,0,0,0,0,"00",0,0,0,0,0,0,1037699,"2023-11-08T00:00:00.000Z",3,FALSE,13,666511,"G",13,13,"LA Clippers","Amir Coffey",0,0,0,0,0,0
0,0,0,0,0,0,0,0,0,"00",0,0,0,0,0,0,1037699,"2023-11-08T00:00:00.000Z",3,FALSE,13,38017725,"F",13,13,"LA Clippers","Moussa Diabate",0,0,0,0,0,0
0,1,1,7,3,16,8,2,2,"28",0,0,21,1,1,0,1037699,"2023-11-08T00:00:00.000Z",3,FALSE,13,464,"G",3,3,"Brooklyn Nets","Lonnie Walker IV",2,22,22,21,1,28.2
2,0,3,2,1,6,3,2,2,"19",2,2,9,5,3,4,1037699,"2023-11-08T00:00:00.000Z",3,FALSE,13,17896058,"F",3,3,"Brooklyn Nets","Trendon Watford",3,14,16,11,7,23
0,0,0,0,0,0,0,0,0,"00",0,0,0,0,0,0,1037699,"2023-11-08T00:00:00.000Z",3,FALSE,13,56677722,"F",3,3,"Brooklyn Nets","Jalen Wilson",0,0,0,0,0,0
0,0,0,0,0,0,0,0,0,"00",0,0,0,0,0,0,1037699,"2023-11-08T00:00:00.000Z",3,FALSE,13,666508,"F-C",3,3,"Brooklyn Nets","Nicolas Claxton",0,0,0,0,0,0
0,0,0,0,0,0,0,0,0,"00",0,0,0,0,0,0,1037699,"2023-11-08T00:00:00.000Z",3,FALSE,13,56677843,"F",3,3,"Brooklyn Nets","Noah Clowney",0,0,0,0,0,0
0,0,0,0,0,0,0,0,0,"00",0,0,0,0,0,0,1037699,"2023-11-08T00:00:00.000Z",3,FALSE,13,666679,"F",3,3,"Brooklyn Nets","Cameron Johnson",0,0,0,0,0,0
0,0,0,0,0,0,0,0,0,"00",0,0,0,0,0,0,1037699,"2023-11-08T00:00:00.000Z",3,FALSE,13,17896041,"G",3,3,"Brooklyn Nets","Keon Johnson",0,0,0,0,0,0
0,0,0,0,0,0,0,0,0,"00",0,0,0,0,0,0,1037699,"2023-11-08T00:00:00.000Z",3,FALSE,13,417,"G-F",3,3,"Brooklyn Nets","Ben Simmons",0,0,0,0,0,0
3,1,3,1,0,3,1,1,1,"21",3,3,3,6,1,0,1037699,"2023-11-08T00:00:00.000Z",3,FALSE,13,450,"F",13,13,"LA Clippers","PJ Tucker",2,9,12,6,9,20.7
0,0,1,2,0,6,2,0,0,"06",1,0,4,2,0,1,1037699,"2023-11-08T00:00:00.000Z",3,FALSE,13,17896031,"G",13,13,"LA Clippers","Nah'Shon Hyland",0,6,6,4,2,5.4
1,0,4,2,0,2,0,0,0,"19",0,1,0,4,0,2,1037699,"2023-11-08T00:00:00.000Z",3,FALSE,13,666743,"G",13,13,"LA Clippers","Terance Mann",0,4,5,1,5,4.3
1,2,1,5,2,8,4,0,0,"23",0,2,10,1,3,1,1037699,"2023-11-08T00:00:00.000Z",3,FALSE,13,380,"F-G",13,13,"LA Clippers","Norman Powell",5,11,12,11,2,26.7
0,0,0,0,0,0,0,0,0,"00",0,0,0,0,0,0,1037699,"2023-11-08T00:00:00.000Z",3,FALSE,13,17896022,"G",13,13,"LA Clippers","Brandon Boston Jr.",0,0,0,0,0,0
0,0,0,0,0,0,0,0,0,"00",0,0,0,0,0,0,1037699,"2023-11-08T00:00:00.000Z",3,FALSE,13,56677856,"G",13,13,"LA Clippers","Jordan Miller",0,0,0,0,0,0
0,0,0,0,0,0,0,0,0,"00",0,0,0,0,0,0,1037699,"2023-11-08T00:00:00.000Z",3,FALSE,13,371,"F-C",13,13,"LA Clippers","Mason Plumlee",0,0,0,0,0,0
0,0,0,0,0,0,0,0,0,"00",0,0,0,0,0,0,1037699,"2023-11-08T00:00:00.000Z",3,FALSE,13,17896051,"G",13,13,"LA Clippers","Joshua Primo",0,0,0,0,0,0
6,0,2,9,5,17,8,3,3,"32",0,2,24,2,1,0,1037700,"2023-11-08T00:00:00.000Z",20,FALSE,27,666423,"F-G",20,20,"New York Knicks","RJ Barrett",1,26,32,30,8,38.4
5,0,12,6,2,19,8,8,5,"31",4,1,23,16,1,2,1037700,"2023-11-08T00:00:00.000Z",20,FALSE,27,387,"F",20,20,"New York Knicks","Julius Randle",1,39,44,28,21,50.7
1,0,7,0,0,4,3,6,2,"31",5,3,8,12,0,0,1037700,"2023-11-08T00:00:00.000Z",20,FALSE,27,399,"C",20,20,"New York Knicks","Mitchell Robinson",0,20,21,9,13,23.9
6,0,2,8,5,19,8,4,4,"33",0,2,25,2,0,0,1037700,"2023-11-08T00:00:00.000Z",20,FALSE,27,73,"G",20,20,"New York Knicks","Jalen Brunson",0,27,33,31,8,36.4
3,0,1,4,2,5,3,0,0,"19",0,0,8,1,0,0,1037700,"2023-11-08T00:00:00.000Z",20,FALSE,27,17895858,"G",20,20,"New York Knicks","Quentin Grimes",0,9,12,11,4,13.7
0,0,0,0,0,0,0,0,0,"01",0,0,0,0,0,0,1037700,"2023-11-08T00:00:00.000Z",20,FALSE,27,19,"G",20,20,"New York Knicks","Ryan Arcidiacono",0,0,0,0,0,0
2,0,3,3,1,6,1,0,0,"20",1,1,3,4,1,0,1037700,"2023-11-08T00:00:00.000Z",20,FALSE,27,131,"G",20,20,"New York Knicks","Donte DiVincenzo",1,7,9,5,6,13.8
0,0,0,0,0,0,0,0,0,"00",0,0,0,0,0,0,1037700,"2023-11-08T00:00:00.000Z",20,FALSE,27,160,"G-F",20,20,"New York Knicks","Evan Fournier",0,0,0,0,0,0
0,0,5,2,1,3,1,0,0,"24",0,0,3,5,1,0,1037700,"2023-11-08T00:00:00.000Z",20,FALSE,27,202,"G",20,20,"New York Knicks","Josh Hart",1,8,8,3,5,12
0,0,0,0,0,9,6,1,1,"15",3,4,13,3,2,0,1037700,"2023-11-08T00:00:00.000Z",20,FALSE,27,201,"F-C",20,20,"New York Knicks","Isaiah Hartenstein",2,16,16,13,3,22.6
0,0,1,1,0,1,0,0,0,"02",0,0,0,1,0,1,1037700,"2023-11-08T00:00:00.000Z",20,FALSE,27,666675,"F",20,20,"New York Knicks","DaQuan Jeffries",0,1,1,0,1,0.2
0,0,0,0,0,0,0,0,0,"02",0,0,0,0,0,0,1037700,"2023-11-08T00:00:00.000Z",20,FALSE,27,17896033,"G",20,20,"New York Knicks","Miles McBride",0,0,0,0,0,0
5,0,0,9,3,17,8,0,0,"28",0,1,19,0,1,0,1037700,"2023-11-08T00:00:00.000Z",20,FALSE,27,3547269,"G",20,20,"New York Knicks","Immanuel Quickley",1,19,24,24,5,29.5
0,0,1,0,0,0,0,0,0,"01",0,0,0,1,0,0,1037700,"2023-11-08T00:00:00.000Z",20,FALSE,27,17896063,"F",20,20,"New York Knicks","Jericho Sims",0,1,1,0,1,1.2
0,0,0,0,0,0,0,0,0,"01",0,0,0,0,0,0,1037700,"2023-11-08T00:00:00.000Z",20,FALSE,27,666971,"G-F",20,20,"New York Knicks","Dylan Windler",0,0,0,0,0,0
0,0,0,0,0,0,0,0,0,"00",0,0,0,0,0,0,1037700,"2023-11-08T00:00:00.000Z",20,FALSE,27,666474,"G",20,20,"New York Knicks","Charles Brown",0,0,0,0,0,0
0,0,0,0,0,0,0,0,0,"00",0,0,0,0,0,0,1037700,"2023-11-08T00:00:00.000Z",20,FALSE,27,56677795,"F",20,20,"New York Knicks","Jacob Toppin",0,0,0,0,0,0
0,0,0,0,0,0,0,0,0,"00",0,0,0,0,0,0,1037700,"2023-11-08T00:00:00.000Z",20,FALSE,27,17896089,"G",20,20,"New York Knicks","Duane Washington Jr.",0,0,0,0,0,0
5,0,6,4,2,12,7,0,0,"29",0,5,16,6,0,0,1037700,"2023-11-08T00:00:00.000Z",20,FALSE,27,38017699,"F",27,27,"San Antonio Spurs","Jeremy Sochan",0,22,27,21,11,30.7
2,1,5,4,0,14,4,6,6,"30",4,2,14,9,0,3,1037700,"2023-11-08T00:00:00.000Z",20,FALSE,27,56677822,"F-C",27,27,"San Antonio Spurs","Victor Wembanyama",1,23,25,16,11,27.8
3,3,5,2,1,6,4,2,2,"25",2,4,11,7,0,2,1037700,"2023-11-08T00:00:00.000Z",20,FALSE,27,102,"F-C",27,27,"San Antonio Spurs","Zach Collins",3,18,21,14,10,30.9
1,0,0,2,2,9,6,0,0,"24",0,2,14,0,0,1,1037700,"2023-11-08T00:00:00.000Z",20,FALSE,27,38017692,"F",27,27,"San Antonio Spurs","Malaki Branham",0,14,15,15,1,14.5
8,0,7,4,1,9,4,2,0,"33",0,4,9,7,0,3,1037700,"2023-11-08T00:00:00.000Z",20,FALSE,27,666682,"F",27,27,"San Antonio Spurs","Keldon Johnson",0,16,24,17,15,26.4
0,0,1,0,0,1,1,2,0,"03",0,0,2,1,0,0,1037700,"2023-11-08T00:00:00.000Z",20,FALSE,27,38017730,"F",27,27,"San Antonio Spurs","Dominick Barlow",0,3,3,2,1,3.2
1,2,3,0,0,3,3,0,0,"15",1,1,6,4,1,0,1037700,"2023-11-08T00:00:00.000Z",20,FALSE,27,17895854,"G",27,27,"San Antonio Spurs","Charles Bassey",3,10,11,7,5,21.3
0,0,0,2,0,2,0,0,0,"03",0,0,0,0,0,0,1037700,"2023-11-08T00:00:00.000Z",20,FALSE,27,38017649,"F",27,27,"San Antonio Spurs","Julian Champagnie",0,0,0,0,0,0
0,0,0,0,0,0,0,0,0,"00",0,0,0,0,0,0,1037700,"2023-11-08T00:00:00.000Z",20,FALSE,27,180,"G",27,27,"San Antonio Spurs","Devonte' Graham",0,0,0,0,0,0
0,0,0,0,0,0,0,0,0,"00",0,0,0,0,0,0,1037700,"2023-11-08T00:00:00.000Z",20,FALSE,27,56677865,"C",27,27,"San Antonio Spurs","Charles Bediako",0,0,0,0,0,0
0,0,0,0,0,0,0,0,0,"00",0,0,0,0,0,0,1037700,"2023-11-08T00:00:00.000Z",20,FALSE,27,56677817,"G",27,27,"San Antonio Spurs","Sidy Cissoko",0,0,0,0,0,0
0,0,0,0,0,0,0,0,0,"00",0,0,0,0,0,0,1037700,"2023-11-08T00:00:00.000Z",20,FALSE,27,56677870,"G",27,27,"San Antonio Spurs","Sir'Jabari Rice",0,0,0,0,0,0
5,1,1,2,0,11,6,1,0,"25",0,0,12,1,1,0,1037700,"2023-11-08T00:00:00.000Z",20,FALSE,27,3547274,"G",27,27,"San Antonio Spurs","Tre Jones",2,13,18,17,6,26.7
0,0,0,1,0,1,0,0,0,"03",1,1,0,1,0,0,1037700,"2023-11-08T00:00:00.000Z",20,FALSE,27,17896059,"F",27,27,"San Antonio Spurs","Sandro Mamukelashvili",0,1,1,0,1,1.2
1,0,2,8,3,9,4,0,0,"22",1,3,11,3,0,3,1037700,"2023-11-08T00:00:00.000Z",20,FALSE,27,305,"F",27,27,"San Antonio Spurs","Doug McDermott",0,14,15,12,4,13.1
2,0,2,3,0,4,1,0,0,"13",1,0,2,3,0,0,1037700,"2023-11-08T00:00:00.000Z",20,FALSE,27,359,"F",27,27,"San Antonio Spurs","Cedi Osman",0,5,7,4,5,8.6
2,0,2,2,0,6,2,0,0,"12",0,0,4,2,0,1,1037700,"2023-11-08T00:00:00.000Z",20,FALSE,27,3547246,"G-F",27,27,"San Antonio Spurs","Devin Vassell",0,6,8,6,4,8.4
1,0,1,0,0,3,2,0,0,"03",1,0,4,2,0,0,1037700,"2023-11-08T00:00:00.000Z",20,FALSE,27,38017693,"G",27,27,"San Antonio Spurs","Blake Wesley",0,6,7,5,3,7.9
7,2,2,4,1,20,6,11,9,"40",0,2,22,2,1,2,1037701,"2023-11-08T00:00:00.000Z",5,FALSE,24,125,"G",5,5,"Chicago Bulls","DeMar DeRozan",3,24,31,29,9,41.9
1,0,2,2,0,3,0,0,0,"19",0,3,0,2,1,0,1037701,"2023-11-08T00:00:00.000Z",5,FALSE,24,110,"F",5,5,"Chicago Bulls","Torrey Craig",1,2,3,1,3,6.9
3,1,4,5,2,18,11,3,2,"41",2,5,26,6,1,3,1037701,"2023-11-08T00:00:00.000Z",5,FALSE,24,460,"C",5,5,"Chicago Bulls","Nikola Vucevic",2,32,35,29,9,40.7
8,0,7,6,3,13,7,7,5,"41",1,2,22,8,1,3,1037701,"2023-11-08T00:00:00.000Z",5,FALSE,24,268,"G",5,5,"Chicago Bulls","Zach LaVine",1,30,38,30,16,43.6
6,1,6,5,1,14,5,0,0,"37",0,3,11,6,3,1,1037701,"2023-11-08T00:00:00.000Z",5,FALSE,24,666956,"G",5,5,"Chicago Bulls","Coby White",4,17,23,17,12,38.2
0,1,0,4,2,8,3,0,0,"13",0,2,8,0,0,0,1037701,"2023-11-08T00:00:00.000Z",5,FALSE,24,87,"G",5,5,"Chicago Bulls","Jevon Carter",1,8,8,8,0,11
2,2,3,5,4,9,7,2,1,"31",1,3,19,4,3,1,1037701,"2023-11-08T00:00:00.000Z",5,FALSE,24,89,"G",5,5,"Chicago Bulls","Alex Caruso",5,23,25,21,6,40.8
1,0,1,0,0,2,1,0,0,"10",2,0,2,3,0,1,1037701,"2023-11-08T00:00:00.000Z",5,FALSE,24,17895983,"G",5,5,"Chicago Bulls","Ayo Dosunmu",0,5,6,3,4,6.1
0,0,0,0,0,0,0,0,0,"00",0,0,0,0,0,0,1037701,"2023-11-08T00:00:00.000Z",5,FALSE,24,56677857,"F",5,5,"Chicago Bulls","Julian Phillips",0,0,0,0,0,0
0,0,0,0,0,0,0,0,0,"00",0,0,0,0,0,0,1037701,"2023-11-08T00:00:00.000Z",5,FALSE,24,17896116,"G",5,5,"Chicago Bulls","Terry Taylor",0,0,0,0,0,0
0,0,0,0,0,0,0,0,0,"00",0,0,0,0,0,0,1037701,"2023-11-08T00:00:00.000Z",5,FALSE,24,38017719,"F",5,5,"Chicago Bulls","Dalen Terry",0,0,0,0,0,0
0,1,4,5,2,5,2,0,0,"18",0,2,6,4,0,3,1037701,"2023-11-08T00:00:00.000Z",5,FALSE,24,470,"G",24,24,"Phoenix Suns","Yuta Watanabe",1,10,10,6,4,10.8
0,0,0,0,0,0,0,0,0,"00",0,0,0,0,0,0,1037701,"2023-11-08T00:00:00.000Z",5,FALSE,24,57,"G",24,24,"Phoenix Suns","Devin Booker",0,0,0,0,0,0
0,0,0,0,0,0,0,0,0,"00",0,0,0,0,0,0,1037701,"2023-11-08T00:00:00.000Z",5,FALSE,24,272,"G",24,24,"Phoenix Suns","Damion Lee",0,0,0,0,0,0
4,1,9,13,8,16,9,0,0,"37",0,3,26,9,1,1,1037701,"2023-11-08T00:00:00.000Z",5,FALSE,24,8,"G",24,24,"Phoenix Suns","Grayson Allen",2,35,39,30,13,47.8
4,2,4,6,3,12,3,4,4,"24",0,0,13,4,0,2,1037701,"2023-11-08T00:00:00.000Z",5,FALSE,24,37,"G",24,24,"Phoenix Suns","Bradley Beal",2,17,21,17,8,27.8
0,0,0,0,0,0,0,0,0,"00",0,0,0,0,0,0,1037701,"2023-11-08T00:00:00.000Z",5,FALSE,24,3547095,"C-F",24,24,"Phoenix Suns","Udoka Azubuike",0,0,0,0,0,0
0,0,0,0,0,0,0,0,0,"01",0,0,0,0,0,0,1037701,"2023-11-08T00:00:00.000Z",5,FALSE,24,666451,"C",24,24,"Phoenix Suns","Bol Bol",0,0,0,0,0,0
2,1,3,0,0,1,1,2,2,"14",0,2,4,3,1,0,1037701,"2023-11-08T00:00:00.000Z",5,FALSE,24,147,"F",24,24,"Phoenix Suns","Drew Eubanks",2,7,9,6,5,16.6
0,0,1,3,2,5,2,0,0,"17",1,1,6,2,0,0,1037701,"2023-11-08T00:00:00.000Z",5,FALSE,24,18678058,"",24,24,"Phoenix Suns","Jordan Goodwin",0,8,8,6,2,8.4
2,0,1,8,0,9,1,0,0,"25",0,1,2,1,0,3,1037701,"2023-11-08T00:00:00.000Z",5,FALSE,24,178,"G",24,24,"Phoenix Suns","Eric Gordon",0,3,5,4,3,3.2
0,0,0,0,0,0,0,0,0,"00",0,0,0,0,0,0,1037701,"2023-11-08T00:00:00.000Z",5,FALSE,24,3547298,"G",24,24,"Phoenix Suns","Saben Lee",0,0,0,0,0,0
0,0,0,0,0,0,0,0,0,"00",0,0,0,0,0,0,1037701,"2023-11-08T00:00:00.000Z",5,FALSE,24,666729,"F",24,24,"Phoenix Suns","Nassir Little",0,0,0,0,0,0
0,0,0,0,0,0,0,0,0,"00",0,0,0,0,0,0,1037701,"2023-11-08T00:00:00.000Z",5,FALSE,24,314,"F",24,24,"Phoenix Suns","Chimezie Metu",0,0,0,0,0,0
0,0,0,2,0,6,3,2,1,"18",2,2,7,2,1,0,1037701,"2023-11-08T00:00:00.000Z",5,FALSE,24,356,"G",24,24,"Phoenix Suns","Josh Okogie",1,9,9,7,2,12.4
1,0,3,2,1,7,1,0,0,"21",1,0,3,4,1,1,1037701,"2023-11-08T00:00:00.000Z",5,FALSE,24,3547248,"F",5,5,"Chicago Bulls","Patrick Williams",1,7,8,4,5,11.3
0,0,0,0,0,0,0,0,0,"00",0,0,0,0,0,0,1037701,"2023-11-08T00:00:00.000Z",5,FALSE,24,27,"G",5,5,"Chicago Bulls","Lonzo Ball",0,0,0,0,0,0
0,0,0,0,0,0,0,0,0,"00",0,0,0,0,0,0,1037701,"2023-11-08T00:00:00.000Z",5,FALSE,24,56677874,"F",5,5,"Chicago Bulls","Onuralp Bitim",0,0,0,0,0,0
0,0,0,0,0,0,0,0,0,"00",0,0,0,0,0,0,1037701,"2023-11-08T00:00:00.000Z",5,FALSE,24,45969255,"F",5,5,"Chicago Bulls","Justin Lewis",0,0,0,0,0,0
0,0,0,0,0,0,0,0,0,"00",0,0,0,0,0,0,1037701,"2023-11-08T00:00:00.000Z",5,FALSE,24,56677860,"F",5,5,"Chicago Bulls","Adama Sanogo",0,0,0,0,0,0
9,1,6,5,2,16,7,9,9,"42",1,2,25,7,1,6,1037701,"2023-11-08T00:00:00.000Z",5,FALSE,24,140,"F",24,24,"Phoenix Suns","Kevin Durant",2,32,41,34,16,46.9
3,3,4,4,2,4,2,2,1,"31",1,3,7,5,1,0,1037701,"2023-11-08T00:00:00.000Z",5,FALSE,24,32,"F",24,24,"Phoenix Suns","Keita Bates-Diop",4,12,15,10,8,29.5
8,0,9,2,0,15,8,6,4,"38",7,4,20,16,2,6,1037701,"2023-11-08T00:00:00.000Z",5,FALSE,24,349,"C",24,24,"Phoenix Suns","Jusuf Nurkic",2,36,44,28,24,51.2
1,0,2,0,0,1,1,0,0,"12",1,2,2,3,1,2,1037701,"2023-11-08T00:00:00.000Z",5,FALSE,24,137,"C",5,5,"Chicago Bulls","Andre Drummond",1,5,6,3,4,8.1
1,0,4,3,1,6,2,0,0,"25",0,4,5,4,0,2,1037702,"2023-11-08T00:00:00.000Z",11,FALSE,14,66,"G-F",11,11,"Houston Rockets","Dillon Brooks",0,9,10,6,5,9.3
0,0,5,4,2,8,4,2,2,"26",1,2,12,6,1,2,1037702,"2023-11-08T00:00:00.000Z",11,FALSE,14,38017684,"F",11,11,"Houston Rockets","Jabari Smith Jr.",1,18,18,12,6,20.2
4,0,7,0,0,10,8,4,3,"25",0,1,19,7,0,1,1037702,"2023-11-08T00:00:00.000Z",11,FALSE,14,17896062,"F-C",11,11,"Houston Rockets","Alperen Sengun",0,26,30,23,11,32.4
3,0,6,6,5,15,11,4,1,"22",1,3,28,7,1,1,1037702,"2023-11-08T00:00:00.000Z",11,FALSE,14,17895966,"G",11,11,"Houston Rockets","Jalen Green",1,35,38,31,10,42.9
10,0,3,6,1,9,2,4,4,"29",1,2,9,4,1,1,1037702,"2023-11-08T00:00:00.000Z",11,FALSE,14,458,"G",11,11,"Houston Rockets","Fred VanVleet",1,13,23,19,14,30.8
1,0,1,2,1,3,1,0,0,"12",0,0,3,1,0,0,1037702,"2023-11-08T00:00:00.000Z",11,FALSE,14,75,"G-F",11,11,"Houston Rockets","Reggie Bullock",0,4,5,4,2,5.7
2,1,5,2,1,10,4,0,0,"14",4,1,9,9,0,2,1037702,"2023-11-08T00:00:00.000Z",11,FALSE,14,38017695,"F",11,11,"Houston Rockets","Tari Eason",1,18,20,11,11,23.8
0,0,3,0,0,5,4,2,1,"11",3,3,9,6,0,1,1037702,"2023-11-08T00:00:00.000Z",11,FALSE,14,188,"F",11,11,"Houston Rockets","Jeff Green",0,15,15,9,6,15.2
3,0,2,2,1,6,3,0,0,"23",0,3,7,2,0,0,1037702,"2023-11-08T00:00:00.000Z",11,FALSE,14,213,"G",11,11,"Houston Rockets","Aaron Holiday",0,9,12,10,5,13.9
0,1,2,1,0,3,1,0,0,"12",1,0,2,3,0,1,1037702,"2023-11-08T00:00:00.000Z",11,FALSE,14,19465326,"C",11,11,"Houston Rockets","Jock Landale",1,5,5,2,3,7.6
0,0,5,0,0,4,3,1,0,"06",2,1,6,7,0,0,1037702,"2023-11-08T00:00:00.000Z",11,FALSE,14,296,"C",11,11,"Houston Rockets","Boban Marjanovic",0,13,13,6,7,14.4
1,1,0,6,2,10,6,0,0,"27",1,3,14,1,0,0,1037702,"2023-11-08T00:00:00.000Z",11,FALSE,14,3547301,"F",11,11,"Houston Rockets","Jae'Sean Tate",1,15,16,15,2,19.7
1,0,0,1,0,4,2,2,1,"08",0,0,5,0,1,0,1037702,"2023-11-08T00:00:00.000Z",11,FALSE,14,47738533,"G",11,11,"Houston Rockets","Jeenathan Williams",1,5,6,6,1,9.5
0,0,0,0,0,0,0,0,0,"00",0,0,0,0,0,0,1037702,"2023-11-08T00:00:00.000Z",11,FALSE,14,3547281,"G-F",11,11,"Houston Rockets","Nate Hinton",0,0,0,0,0,0
0,0,0,0,0,0,0,0,0,"00",0,0,0,0,0,0,1037702,"2023-11-08T00:00:00.000Z",11,FALSE,14,357,"G",11,11,"Houston Rockets","Victor Oladipo",0,0,0,0,0,0
0,0,0,0,0,0,0,0,0,"00",0,0,0,0,0,0,1037702,"2023-11-08T00:00:00.000Z",11,FALSE,14,56677809,"F",11,11,"Houston Rockets","Jermaine Samuels Jr.",0,0,0,0,0,0
0,0,0,0,0,0,0,0,0,"00",0,0,0,0,0,0,1037702,"2023-11-08T00:00:00.000Z",11,FALSE,14,56677825,"G-F",11,11,"Houston Rockets","Amen Thompson",0,0,0,0,0,0
2,0,0,0,0,3,1,0,0,"14",2,5,2,2,0,0,1037702,"2023-11-08T00:00:00.000Z",11,FALSE,14,56677738,"C",14,14,"Los Angeles Lakers","Colin Castleton",0,4,6,4,4,7.4
0,0,0,0,0,0,0,0,0,"00",0,0,0,0,0,0,1037702,"2023-11-08T00:00:00.000Z",11,FALSE,14,117,"F-C",14,14,"Los Angeles Lakers","Anthony Davis",0,0,0,0,0,0
2,1,7,3,2,14,10,5,2,"25",1,0,24,8,2,0,1037702,"2023-11-08T00:00:00.000Z",11,FALSE,14,666609,"F",14,14,"Los Angeles Lakers","Rui Hachimura",3,32,34,26,10,45.6
1,1,0,2,0,3,1,2,1,"10",0,1,3,0,0,1,1037702,"2023-11-08T00:00:00.000Z",11,FALSE,14,56677868,"G",14,14,"Los Angeles Lakers","D'Moi Hodge",1,3,4,4,1,6.5
0,0,1,0,0,2,0,0,0,"08",0,0,0,1,0,0,1037702,"2023-11-08T00:00:00.000Z",11,FALSE,14,56677836,"F",14,14,"Los Angeles Lakers","Maxwell Lewis",0,1,1,0,1,1.2
0,0,1,3,0,7,2,4,3,"25",0,0,7,1,3,0,1037702,"2023-11-08T00:00:00.000Z",11,FALSE,14,666860,"F-G",14,14,"Los Angeles Lakers","Cameron Reddish",3,8,8,7,1,17.2
0,0,0,0,0,0,0,0,0,"00",0,0,0,0,0,0,1037702,"2023-11-08T00:00:00.000Z",11,FALSE,14,56677867,"F",14,14,"Los Angeles Lakers","Alex Fudge",0,0,0,0,0,0
0,0,0,0,0,0,0,0,0,"00",0,0,0,0,0,0,1037702,"2023-11-08T00:00:00.000Z",11,FALSE,14,666626,"C",14,14,"Los Angeles Lakers","Jaxson Hayes",0,0,0,0,0,0
0,0,0,0,0,0,0,0,0,"00",0,0,0,0,0,0,1037702,"2023-11-08T00:00:00.000Z",11,FALSE,14,56677835,"G",14,14,"Los Angeles Lakers","Jalen Hood-Schifino",0,0,0,0,0,0
0,0,0,0,0,0,0,0,0,"00",0,0,0,0,0,0,1037702,"2023-11-08T00:00:00.000Z",11,FALSE,14,457,"F",14,14,"Los Angeles Lakers","Jarred Vanderbilt",0,0,0,0,0,0
0,0,0,0,0,0,0,0,0,"00",0,0,0,0,0,0,1037702,"2023-11-08T00:00:00.000Z",11,FALSE,14,1603383,"G",14,14,"Los Angeles Lakers","Gabe Vincent",0,0,0,0,0,0
1,0,4,0,0,1,0,2,0,"22",0,4,0,4,0,0,1037702,"2023-11-08T00:00:00.000Z",11,FALSE,14,486,"F",14,14,"Los Angeles Lakers","Christian Wood",0,4,5,1,5,6.3
4,0,1,4,0,9,2,3,3,"26",0,1,7,1,2,2,1037702,"2023-11-08T00:00:00.000Z",11,FALSE,14,17553995,"G",14,14,"Los Angeles Lakers","Austin Reaves",2,8,12,11,5,18.2
4,3,2,7,4,18,9,0,0,"28",0,1,22,2,0,1,1037702,"2023-11-08T00:00:00.000Z",11,FALSE,14,405,"G",14,14,"Los Angeles Lakers","D'Angelo Russell",3,24,28,26,6,38.4
3,1,7,2,0,8,1,3,2,"28",1,2,4,8,0,1,1037702,"2023-11-08T00:00:00.000Z",11,FALSE,14,38017697,"G",14,14,"Los Angeles Lakers","Max Christie",1,12,15,7,11,20.1
2,0,5,2,0,13,7,5,4,"27",1,1,18,6,0,3,1037702,"2023-11-08T00:00:00.000Z",11,FALSE,14,237,"F",14,14,"Los Angeles Lakers","LeBron James",0,24,26,20,8,25.2
0,0,0,0,0,0,0,0,0,"00",0,0,0,0,0,0,1037702,"2023-11-08T00:00:00.000Z",11,FALSE,14,56677831,"F",11,11,"Houston Rockets","Cam Whitmore",0,0,0,0,0,0
1,0,1,2,1,6,3,0,0,"27",0,3,7,1,0,1,1037702,"2023-11-08T00:00:00.000Z",11,FALSE,14,383,"F",14,14,"Los Angeles Lakers","Taurean Prince",0,8,9,8,2,8.7
2,0,1,0,0,4,2,3,2,"08",0,2,6,1,1,0,1037703,"2023-11-08T00:00:00.000Z",15,FALSE,16,666633,"G",16,16,"Miami Heat","Tyler Herro",1,7,9,8,3,13.2
9,0,8,7,4,11,5,3,3,"35",3,4,17,11,1,4,1037703,"2023-11-08T00:00:00.000Z",15,FALSE,16,286,"G",16,16,"Miami Heat","Kyle Lowry",1,28,37,26,20,42.7
0,0,5,0,0,3,1,0,0,"12",1,1,2,6,0,1,1037703,"2023-11-08T00:00:00.000Z",15,FALSE,16,74,"C",16,16,"Miami Heat","Thomas Bryant",0,8,8,2,6,8.2
2,0,3,1,1,5,4,3,2,"21",0,5,11,3,2,0,1037703,"2023-11-08T00:00:00.000Z",15,FALSE,16,56677785,"G",16,16,"Miami Heat","Jaime Jaquez Jr.",2,14,16,13,5,23.6
2,1,0,5,0,9,1,0,0,"17",0,1,2,0,0,4,1037703,"2023-11-08T00:00:00.000Z",15,FALSE,16,391,"G-F",16,16,"Miami Heat","Josh Richardson",1,2,4,4,2,4
2,0,3,5,2,7,3,2,1,"35",0,3,9,3,0,5,1037703,"2023-11-08T00:00:00.000Z",15,FALSE,16,397,"F",16,16,"Miami Heat","Duncan Robinson",0,12,14,11,5,10.6
1,1,2,2,0,3,1,0,0,"14",2,0,2,4,1,0,1037703,"2023-11-08T00:00:00.000Z",15,FALSE,16,19465585,"G",16,16,"Miami Heat","Dru Smith",2,6,7,3,5,14.3
0,0,1,5,0,9,1,0,0,"21",1,2,2,2,2,1,1037703,"2023-11-08T00:00:00.000Z",15,FALSE,16,17896027,"G-F",15,15,"Memphis Grizzlies","Ziaire Williams",2,4,4,2,2,9.4
2,1,2,8,2,18,9,10,8,"33",2,5,28,4,0,1,1037703,"2023-11-08T00:00:00.000Z",15,FALSE,16,231,"F-C",15,15,"Memphis Grizzlies","Jaren Jackson Jr.",1,32,34,30,6,37.8
0,0,4,0,0,4,4,2,1,"30",6,4,9,10,1,1,1037703,"2023-11-08T00:00:00.000Z",15,FALSE,16,48,"C",15,15,"Memphis Grizzlies","Bismack Biyombo",1,19,19,9,10,23
3,2,5,8,2,16,4,6,5,"36",0,3,15,5,1,1,1037703,"2023-11-08T00:00:00.000Z",15,FALSE,16,3547287,"G",15,15,"Memphis Grizzlies","Desmond Bane",3,20,23,18,8,33.5
7,0,4,3,0,14,4,4,3,"32",0,4,11,4,2,3,1037703,"2023-11-08T00:00:00.000Z",15,FALSE,16,420,"G",15,15,"Memphis Grizzlies","Marcus Smart",2,15,22,18,11,29.3
0,1,6,4,2,14,5,2,0,"26",2,4,12,8,2,1,1037703,"2023-11-08T00:00:00.000Z",15,FALSE,16,17896067,"F",15,15,"Memphis Grizzlies","Santi Aldama",3,20,20,12,8,29.6
4,0,0,3,2,3,2,0,0,"15",0,1,6,0,0,0,1037703,"2023-11-08T00:00:00.000Z",15,FALSE,16,48248287,"G",15,15,"Memphis Grizzlies","Jacob Gilyard",0,6,10,10,4,12
0,0,0,0,0,0,0,0,0,"00",0,0,0,0,0,0,1037703,"2023-11-08T00:00:00.000Z",15,FALSE,16,56677830,"F",15,15,"Memphis Grizzlies","GG Jackson",0,0,0,0,0,0
3,0,2,6,3,7,4,2,2,"27",0,1,13,2,1,3,1037703,"2023-11-08T00:00:00.000Z",15,FALSE,16,254,"G",15,15,"Memphis Grizzlies","Luke Kennard",1,15,18,16,5,19.9
0,0,0,0,0,0,0,0,0,"00",0,0,0,0,0,0,1037703,"2023-11-08T00:00:00.000Z",15,FALSE,16,38017728,"F",15,15,"Memphis Grizzlies","Jake LaRavia",0,0,0,0,0,0
1,0,0,0,0,3,1,0,0,"07",0,1,2,0,0,0,1037703,"2023-11-08T00:00:00.000Z",15,FALSE,16,38017732,"F",15,15,"Memphis Grizzlies","Kenneth Lofton Jr.",0,2,3,3,1,3.5
1,3,11,0,0,15,8,16,14,"36",0,5,30,11,1,4,1037703,"2023-11-08T00:00:00.000Z",15,FALSE,16,4,"C-F",16,16,"Miami Heat","Bam Adebayo",4,41,42,31,12,52.7
0,0,0,0,0,0,0,0,0,"00",0,0,0,0,0,0,1037703,"2023-11-08T00:00:00.000Z",15,FALSE,16,38017734,"F",16,16,"Miami Heat","Jamal Cain",0,0,0,0,0,0
0,0,0,0,0,0,0,0,0,"00",0,0,0,0,0,0,1037703,"2023-11-08T00:00:00.000Z",15,FALSE,16,3547257,"G",16,16,"Miami Heat","R.J. Hampton",0,0,0,0,0,0
0,0,0,0,0,0,0,0,0,"00",0,0,0,0,0,0,1037703,"2023-11-08T00:00:00.000Z",15,FALSE,16,38017696,"F",16,16,"Miami Heat","Nikola Jovic",0,0,0,0,0,0
0,0,0,0,0,0,0,0,0,"00",0,0,0,0,0,0,1037703,"2023-11-08T00:00:00.000Z",15,FALSE,16,666747,"F",16,16,"Miami Heat","Caleb Martin",0,0,0,0,0,0
0,0,0,0,0,0,0,0,0,"00",0,0,0,0,0,0,1037703,"2023-11-08T00:00:00.000Z",15,FALSE,16,38017736,"F",16,16,"Miami Heat","Cole Swider",0,0,0,0,0,0
0,0,1,0,0,2,1,2,2,"13",2,2,4,3,1,2,1037703,"2023-11-08T00:00:00.000Z",15,FALSE,16,38017729,"F",15,15,"Memphis Grizzlies","David Roddy",1,7,7,4,3,8.6
0,0,0,0,0,0,0,0,0,"00",0,0,0,0,0,0,1037703,"2023-11-08T00:00:00.000Z",15,FALSE,16,38017731,"G",15,15,"Memphis Grizzlies","Vince Williams Jr.",0,0,0,0,0,0
0,0,0,0,0,0,0,0,0,"00",0,0,0,0,0,0,1037703,"2023-11-08T00:00:00.000Z",15,FALSE,16,3,"C",15,15,"Memphis Grizzlies","Steven Adams",0,0,0,0,0,0
0,0,0,0,0,0,0,0,0,"00",0,0,0,0,0,0,1037703,"2023-11-08T00:00:00.000Z",15,FALSE,16,666505,"F",15,15,"Memphis Grizzlies","Brandon Clarke",0,0,0,0,0,0
0,0,0,0,0,0,0,0,0,"00",0,0,0,0,0,0,1037703,"2023-11-08T00:00:00.000Z",15,FALSE,16,666703,"G-F",15,15,"Memphis Grizzlies","John Konchar",0,0,0,0,0,0
0,0,0,0,0,0,0,0,0,"00",0,0,0,0,0,0,1037703,"2023-11-08T00:00:00.000Z",15,FALSE,16,666786,"G",15,15,"Memphis Grizzlies","Ja Morant",0,0,0,0,0,0
0,0,0,0,0,0,0,0,0,"00",0,0,0,0,0,0,1037703,"2023-11-08T00:00:00.000Z",15,FALSE,16,401,"G",15,15,"Memphis Grizzlies","Derrick Rose",0,0,0,0,0,0
0,0,0,0,0,0,0,0,0,"00",0,0,0,0,0,0,1037703,"2023-11-08T00:00:00.000Z",15,FALSE,16,3547285,"F",15,15,"Memphis Grizzlies","Xavier Tillman",0,0,0,0,0,0
2,0,2,4,2,13,5,3,3,"35",1,1,15,3,1,1,1037703,"2023-11-08T00:00:00.000Z",15,FALSE,16,79,"G-F",16,16,"Miami Heat","Jimmy Butler",1,18,20,17,5,23.6
1,3,0,4,2,7,5,2,2,"27",2,2,14,2,2,0,1037703,"2023-11-08T00:00:00.000Z",15,FALSE,16,3092,"",16,16,"Miami Heat","Haywood Highsmith",5,16,17,15,3,32.9
0,0,0,0,0,0,0,0,0,"00",0,0,0,0,0,0,1037703,"2023-11-08T00:00:00.000Z",15,FALSE,16,285,"F-C",16,16,"Miami Heat","Kevin Love",0,0,0,0,0,0
0,0,0,0,0,0,0,0,0,"00",0,0,0,0,0,0,1037703,"2023-11-08T00:00:00.000Z",15,FALSE,16,39398582,"C",16,16,"Miami Heat","Orlando Robinson",0,0,0,0,0,0
2,0,5,4,2,6,3,3,2,"37",0,2,10,5,1,0,1037704,"2023-11-08T00:00:00.000Z",17,FALSE,9,112,"F",17,17,"Milwaukee Bucks","Jae Crowder",1,15,17,12,7,22
5,3,9,2,0,16,6,6,3,"22",0,1,15,9,0,1,1037704,"2023-11-08T00:00:00.000Z",17,FALSE,9,15,"F",17,17,"Milwaukee Bucks","Giannis Antetokounmpo",3,24,29,20,14,41.3
0,4,6,6,4,8,5,0,0,"26",0,4,14,6,0,3,1037704,"2023-11-08T00:00:00.000Z",17,FALSE,9,283,"C",17,17,"Milwaukee Bucks","Brook Lopez",4,20,20,14,6,30.2
2,0,4,2,1,6,4,1,1,"25",2,0,10,6,1,0,1037704,"2023-11-08T00:00:00.000Z",17,FALSE,9,38,"G",17,17,"Milwaukee Bucks","Malik Beasley",1,16,18,12,8,23.2
3,0,2,12,2,25,10,13,12,"34",0,1,34,2,3,1,1037704,"2023-11-08T00:00:00.000Z",17,FALSE,9,278,"G",17,17,"Milwaukee Bucks","Damian Lillard",3,36,39,37,5,48.9
1,0,1,3,0,8,4,2,2,"26",1,4,10,2,0,1,1037704,"2023-11-08T00:00:00.000Z",17,FALSE,9,38017676,"F",17,17,"Milwaukee Bucks","MarJon Beauchamp",0,12,13,11,3,12.9
2,0,3,4,1,14,7,3,3,"23",2,1,18,5,0,2,1037704,"2023-11-08T00:00:00.000Z",17,FALSE,9,377,"F",17,17,"Milwaukee Bucks","Bobby Portis",0,23,25,20,7,25
1,2,3,7,2,9,3,0,0,"37",1,4,8,4,0,1,1037704,"2023-11-08T00:00:00.000Z",17,FALSE,9,3547267,"F-C",9,9,"Detroit Pistons","Isaiah Stewart",2,12,13,9,5,19.3
5,0,9,1,0,10,5,1,1,"28",3,5,11,12,0,2,1037704,"2023-11-08T00:00:00.000Z",17,FALSE,9,38017694,"C",9,9,"Detroit Pistons","Jalen Duren",0,23,28,16,17,30.9
8,0,6,8,2,27,11,10,9,"39",2,2,33,8,0,5,1037704,"2023-11-08T00:00:00.000Z",17,FALSE,9,17896075,"G-F",9,9,"Detroit Pistons","Cade Cunningham",0,41,49,41,16,49.6
4,0,5,3,0,15,6,2,2,"29",0,1,14,5,1,1,1037704,"2023-11-08T00:00:00.000Z",17,FALSE,9,3547241,"G",9,9,"Detroit Pistons","Killian Hayes",1,19,23,18,9,28
2,1,0,0,0,6,5,2,2,"20",2,4,12,2,0,1,1037704,"2023-11-08T00:00:00.000Z",17,FALSE,9,24,"F",9,9,"Detroit Pistons","Marvin Bagley III",1,14,16,14,4,19.4
0,0,0,0,0,0,0,0,0,"00",0,0,0,0,0,0,1037704,"2023-11-08T00:00:00.000Z",17,FALSE,9,56677729,"G",9,9,"Detroit Pistons","Malcolm Cazalon",0,0,0,0,0,0
0,0,0,0,0,0,0,0,0,"00",0,0,0,0,0,0,1037704,"2023-11-08T00:00:00.000Z",17,FALSE,9,197,"F-G",9,9,"Detroit Pistons","Joe Harris",0,0,0,0,0,0
0,0,0,0,0,0,0,0,0,"00",0,0,0,0,0,0,1037704,"2023-11-08T00:00:00.000Z",17,FALSE,9,38017682,"G",9,9,"Detroit Pistons","Jaden Ivey",0,0,0,0,0,0
3,0,1,1,0,4,3,0,0,"13",0,2,6,1,0,0,1037704,"2023-11-08T00:00:00.000Z",17,FALSE,9,42097199,"G",9,9,"Detroit Pistons","Jared Rhoden",0,7,10,9,4,11.7
0,1,0,1,0,2,1,0,0,"09",0,1,2,0,0,2,1037704,"2023-11-08T00:00:00.000Z",17,FALSE,9,44477024,"G",9,9,"Detroit Pistons","Stanley Umude",1,2,2,2,0,3
0,0,0,0,0,0,0,0,0,"00",0,0,0,0,0,0,1037704,"2023-11-08T00:00:00.000Z",17,FALSE,9,3547240,"C",9,9,"Detroit Pistons","James Wiseman",0,0,0,0,0,0
0,0,0,0,0,0,0,0,0,"00",0,0,0,0,0,0,1037704,"2023-11-08T00:00:00.000Z",17,FALSE,9,54,"F",9,9,"Detroit Pistons","Bojan Bogdanovic",0,0,0,0,0,0
0,0,0,0,0,0,0,0,0,"00",0,0,0,0,0,0,1037704,"2023-11-08T00:00:00.000Z",17,FALSE,9,77,"G",9,9,"Detroit Pistons","Alec Burks",0,0,0,0,0,0
1,0,0,1,0,3,1,0,0,"19",0,0,2,0,0,1,1037704,"2023-11-08T00:00:00.000Z",17,FALSE,9,105,"G",17,17,"Milwaukee Bucks","Pat Connaughton",0,2,3,3,1,2.5
3,0,1,3,1,4,1,4,4,"24",0,2,7,1,2,1,1037704,"2023-11-08T00:00:00.000Z",17,FALSE,9,368,"G",17,17,"Milwaukee Bucks","Cameron Payne",2,8,11,10,4,17.7
0,0,0,0,0,0,0,0,0,"00",0,0,0,0,0,0,1037704,"2023-11-08T00:00:00.000Z",17,FALSE,9,2148,"",17,17,"Milwaukee Bucks","Thanasis Antetokounmpo",0,0,0,0,0,0
0,0,0,0,0,0,0,0,0,"00",0,0,0,0,0,0,1037704,"2023-11-08T00:00:00.000Z",17,FALSE,9,38017733,"G",17,17,"Milwaukee Bucks","A.J. Green",0,0,0,0,0,0
0,0,0,0,0,0,0,0,0,"04",0,3,0,0,1,0,1037704,"2023-11-08T00:00:00.000Z",17,FALSE,9,56677852,"G",17,17,"Milwaukee Bucks","Andre Jackson Jr.",1,0,0,0,0,3
0,0,0,0,0,0,0,0,0,"00",0,0,0,0,0,0,1037704,"2023-11-08T00:00:00.000Z",17,FALSE,9,56677854,"F",17,17,"Milwaukee Bucks","Chris Livingston",0,0,0,0,0,0
0,0,0,0,0,0,0,0,0,"00",0,0,0,0,0,0,1037704,"2023-11-08T00:00:00.000Z",17,FALSE,9,284,"C",17,17,"Milwaukee Bucks","Robin Lopez",0,0,0,0,0,0
0,0,0,0,0,0,0,0,0,"00",0,0,0,0,0,0,1037704,"2023-11-08T00:00:00.000Z",17,FALSE,9,259,"F",9,9,"Detroit Pistons","Kevin Knox",0,0,0,0,0,0
0,0,0,0,0,0,0,0,0,"00",0,0,0,0,0,0,1037704,"2023-11-08T00:00:00.000Z",17,FALSE,9,17896071,"F",9,9,"Detroit Pistons","Isaiah Livers",0,0,0,0,0,0
0,0,0,0,0,0,0,0,0,"00",0,0,0,0,0,0,1037704,"2023-11-08T00:00:00.000Z",17,FALSE,9,330,"G",9,9,"Detroit Pistons","Monte Morris",0,0,0,0,0,0
2,0,6,7,3,17,11,1,1,"28",0,1,26,6,1,3,1037704,"2023-11-08T00:00:00.000Z",17,FALSE,9,56677792,"G",9,9,"Detroit Pistons","Marcus Sasser",1,32,34,28,8,36.2
0,0,0,0,0,0,0,0,0,"00",0,0,0,0,0,0,1037704,"2023-11-08T00:00:00.000Z",17,FALSE,9,666960,"G",17,17,"Milwaukee Bucks","Lindell Wigginton",0,0,0,0,0,0
0,0,0,0,0,0,0,0,0,"00",0,0,0,0,0,0,1037704,"2023-11-08T00:00:00.000Z",17,FALSE,9,666453,"C",17,17,"Milwaukee Bucks","Marques Bolden",0,0,0,0,0,0
0,0,0,0,0,0,0,0,0,"00",0,0,0,0,0,0,1037704,"2023-11-08T00:00:00.000Z",17,FALSE,9,315,"F",17,17,"Milwaukee Bucks","Khris Middleton",0,0,0,0,0,0
0,0,0,0,0,0,0,0,0,"00",0,0,0,0,0,0,1037704,"2023-11-08T00:00:00.000Z",17,FALSE,9,38017691,"G",17,17,"Milwaukee Bucks","TyTy Washington Jr.",0,0,0,0,0,0
3,1,12,1,0,8,3,0,0,"37",3,4,6,15,0,2,1037704,"2023-11-08T00:00:00.000Z",17,FALSE,9,56677826,"G-F",9,9,"Detroit Pistons","Ausar Thompson",1,21,24,9,18,29.5
3,0,0,5,2,7,4,0,0,"26",0,2,10,0,0,0,1037705,"2023-11-08T00:00:00.000Z",18,FALSE,19,3547259,"F",18,18,"Minnesota Timberwolves","Jaden McDaniels",0,10,13,13,3,14.5
0,1,3,5,4,12,9,2,1,"28",0,6,23,3,0,3,1037705,"2023-11-08T00:00:00.000Z",18,FALSE,19,447,"C",18,18,"Minnesota Timberwolves","Karl-Anthony Towns",1,26,26,23,3,26.6
1,2,16,0,0,5,4,12,9,"32",5,2,17,21,0,4,1037705,"2023-11-08T00:00:00.000Z",18,FALSE,19,176,"C",18,18,"Minnesota Timberwolves","Rudy Gobert",2,38,39,18,22,45.7
8,2,3,8,2,22,10,5,4,"33",0,1,26,3,3,3,1037705,"2023-11-08T00:00:00.000Z",18,FALSE,19,3547238,"G",18,18,"Minnesota Timberwolves","Anthony Edwards",5,29,37,34,11,53.6
4,0,4,5,4,5,4,0,0,"21",0,2,12,4,1,0,1037705,"2023-11-08T00:00:00.000Z",18,FALSE,19,104,"G",18,18,"Minnesota Timberwolves","Mike Conley",1,16,20,16,8,25.8
8,0,4,1,0,1,0,0,0,"18",0,0,0,4,1,2,1037705,"2023-11-08T00:00:00.000Z",18,FALSE,19,666400,"G",18,18,"Minnesota Timberwolves","Nickeil Alexander-Walker",1,4,12,8,12,17.8
5,2,2,2,1,3,2,2,1,"25",0,2,6,2,1,2,1037705,"2023-11-08T00:00:00.000Z",18,FALSE,19,12,"F",18,18,"Minnesota Timberwolves","Kyle Anderson",3,8,13,11,7,22.9
0,0,0,1,0,5,2,0,0,"05",1,0,4,1,0,0,1037705,"2023-11-08T00:00:00.000Z",18,FALSE,19,68,"F",18,18,"Minnesota Timberwolves","Troy Brown Jr.",0,5,5,4,1,5.2
0,0,1,0,0,4,2,2,1,"05",1,3,5,2,0,0,1037705,"2023-11-08T00:00:00.000Z",18,FALSE,19,17896056,"C",18,18,"Minnesota Timberwolves","Luka Garza",0,7,7,5,2,7.4
1,0,4,5,1,9,4,1,1,"19",0,1,10,4,2,2,1037705,"2023-11-08T00:00:00.000Z",18,FALSE,19,320,"G",18,18,"Minnesota Timberwolves","Shake Milton",2,14,15,11,5,20.3
0,0,0,1,0,1,0,0,0,"03",0,2,0,0,0,0,1037705,"2023-11-08T00:00:00.000Z",18,FALSE,19,38017715,"F",18,18,"Minnesota Timberwolves","Josh Minott",0,0,0,0,0,0
0,0,0,0,0,0,0,0,0,"03",0,0,0,0,0,0,1037705,"2023-11-08T00:00:00.000Z",18,FALSE,19,17895968,"F",18,18,"Minnesota Timberwolves","Daishen Nix",0,0,0,0,0,0
0,0,3,4,1,8,4,0,0,"22",1,2,9,4,1,0,1037705,"2023-11-08T00:00:00.000Z",18,FALSE,19,667378,"F-C",18,18,"Minnesota Timberwolves","Naz Reid",1,13,13,9,4,16.8
0,0,0,0,0,0,0,0,0,"00",0,0,0,0,0,0,1037705,"2023-11-08T00:00:00.000Z",18,FALSE,19,56677851,"G",18,18,"Minnesota Timberwolves","Jaylen Clark",0,0,0,0,0,0
0,0,0,0,0,0,0,0,0,"00",0,0,0,0,0,0,1037705,"2023-11-08T00:00:00.000Z",18,FALSE,19,666767,"G",18,18,"Minnesota Timberwolves","Jordan McLaughlin",0,0,0,0,0,0
0,0,0,0,0,0,0,0,0,"00",0,0,0,0,0,0,1037705,"2023-11-08T00:00:00.000Z",18,FALSE,19,56677782,"F",18,18,"Minnesota Timberwolves","Leonard Miller",0,0,0,0,0,0
0,0,0,0,0,0,0,0,0,"00",0,0,0,0,0,0,1037705,"2023-11-08T00:00:00.000Z",18,FALSE,19,38017700,"G",18,18,"Minnesota Timberwolves","Wendell Moore Jr.",0,0,0,0,0,0
6,0,3,6,1,25,11,1,1,"32",0,1,24,3,0,2,1037705,"2023-11-08T00:00:00.000Z",18,FALSE,19,227,"F",19,19,"New Orleans Pelicans","Brandon Ingram",0,27,33,30,9,34.6
1,0,6,2,1,7,3,4,4,"28",3,2,11,9,0,2,1037705,"2023-11-08T00:00:00.000Z",18,FALSE,19,17896021,"F",19,19,"New Orleans Pelicans","Jeremiah Robinson-Earl",0,20,21,12,10,21.3
0,0,5,2,0,9,4,0,0,"22",1,1,8,6,0,0,1037705,"2023-11-08T00:00:00.000Z",18,FALSE,19,455,"C",19,19,"New Orleans Pelicans","Jonas Valanciunas",0,14,14,8,6,15.2
5,0,2,3,1,10,3,0,0,"31",1,2,7,3,4,3,1037705,"2023-11-08T00:00:00.000Z",18,FALSE,19,38017677,"G",19,19,"New Orleans Pelicans","Dyson Daniels",4,10,15,12,8,27.1
1,0,1,5,2,11,4,4,4,"30",0,5,14,1,0,2,1037705,"2023-11-08T00:00:00.000Z",18,FALSE,19,56677837,"G",19,19,"New Orleans Pelicans","Jordan Hawkins",0,15,16,15,2,14.7
0,0,1,1,0,7,3,0,0,"18",2,1,6,3,2,1,1037705,"2023-11-08T00:00:00.000Z",18,FALSE,19,340,"F",19,19,"New Orleans Pelicans","Larry Nance Jr.",2,9,9,6,3,14.6
1,0,4,4,2,5,2,6,6,"26",0,4,12,4,0,5,1037705,"2023-11-08T00:00:00.000Z",18,FALSE,19,17896017,"F",19,19,"New Orleans Pelicans","Matt Ryan",0,16,17,13,5,13.3
2,0,2,1,0,7,1,0,0,"19",1,2,2,3,0,1,1037705,"2023-11-08T00:00:00.000Z",18,FALSE,19,3547260,"G",19,19,"New Orleans Pelicans","Kira Lewis Jr.",0,5,7,4,5,7.6
1,0,2,2,1,7,3,2,2,"17",1,1,9,3,0,0,1037705,"2023-11-08T00:00:00.000Z",18,FALSE,19,38017726,"G",19,19,"New Orleans Pelicans","Dereon Seabron",0,12,13,10,4,14.1
0,1,0,2,0,3,1,2,2,"05",0,1,4,0,0,1,1037705,"2023-11-08T00:00:00.000Z",18,FALSE,19,38017663,"F",19,19,"New Orleans Pelicans","E.J. Liddell",1,4,4,4,0,6
0,0,0,0,0,0,0,0,0,"00",0,0,0,0,0,0,1037705,"2023-11-08T00:00:00.000Z",18,FALSE,19,666969,"F",19,19,"New Orleans Pelicans","Zion Williamson",0,0,0,0,0,0
6,0,3,0,0,2,1,3,2,"12",2,3,4,5,0,0,1037705,"2023-11-08T00:00:00.000Z",18,FALSE,19,491,"C",19,19,"New Orleans Pelicans","Cody Zeller",0,9,15,10,11,19
0,0,0,0,0,0,0,0,0,"00",0,0,0,0,0,0,1037705,"2023-11-08T00:00:00.000Z",18,FALSE,19,17896097,"G",19,19,"New Orleans Pelicans","Jose Alvarado",0,0,0,0,0,0
0,0,0,0,0,0,0,0,0,"00",0,0,0,0,0,0,1037705,"2023-11-08T00:00:00.000Z",18,FALSE,19,17896024,"F",19,19,"New Orleans Pelicans","Herbert Jones",0,0,0,0,0,0
0,0,0,0,0,0,0,0,0,"00",0,0,0,0,0,0,1037705,"2023-11-08T00:00:00.000Z",18,FALSE,19,3547293,"F",19,19,"New Orleans Pelicans","Naji Marshall",0,0,0,0,0,0
0,0,0,0,0,0,0,0,0,"00",0,0,0,0,0,0,1037705,"2023-11-08T00:00:00.000Z",18,FALSE,19,303,"G",19,19,"New Orleans Pelicans","CJ McCollum",0,0,0,0,0,0
0,0,0,0,0,0,0,0,0,"00",0,0,0,0,0,0,1037705,"2023-11-08T00:00:00.000Z",18,FALSE,19,18677986,"F",19,19,"New Orleans Pelicans","Trey Murphy III",0,0,0,0,0,0
3,3,3,5,3,9,3,6,5,"36",1,3,14,4,2,3,1037706,"2023-11-08T00:00:00.000Z",21,FALSE,6,666541,"G",21,21,"Oklahoma City Thunder","Luguentz Dort",5,18,21,17,7,35.3
2,0,3,1,1,10,5,4,4,"33",1,3,15,4,1,1,1037706,"2023-11-08T00:00:00.000Z",21,FALSE,6,38017703,"G-F",21,21,"Oklahoma City Thunder","Jalen Williams",1,19,21,17,6,24.8
2,3,4,1,1,10,7,0,0,"29",3,4,15,7,1,2,1037706,"2023-11-08T00:00:00.000Z",21,FALSE,6,38017685,"C-F",21,21,"Oklahoma City Thunder","Chet Holmgren",4,22,24,17,9,36.4
6,1,4,2,0,11,4,0,0,"25",1,0,8,5,1,1,1037706,"2023-11-08T00:00:00.000Z",21,FALSE,6,17896065,"G",21,21,"Oklahoma City Thunder","Josh Giddey",2,13,19,14,11,28
6,1,5,2,1,22,15,13,12,"37",2,3,43,7,3,3,1037706,"2023-11-08T00:00:00.000Z",21,FALSE,6,175,"G",21,21,"Oklahoma City Thunder","Shai Gilgeous-Alexander",4,50,56,49,13,69.4
1,0,0,3,0,3,0,3,3,"10",0,2,3,0,1,0,1037706,"2023-11-08T00:00:00.000Z",21,FALSE,6,44,"F",21,21,"Oklahoma City Thunder","Davis Bertans",1,3,4,4,1,7.5
1,0,3,1,0,2,1,2,2,"09",2,1,4,5,1,0,1037706,"2023-11-08T00:00:00.000Z",21,FALSE,6,38017716,"F",21,21,"Oklahoma City Thunder","Ousmane Dieng",1,9,10,5,6,14.5
0,0,3,6,2,7,2,0,0,"18",0,4,6,3,0,1,1037706,"2023-11-08T00:00:00.000Z",21,FALSE,6,3547272,"G",21,21,"Oklahoma City Thunder","Isaiah Joe",0,9,9,6,3,8.6
0,0,0,0,0,0,0,0,0,"00",0,0,0,0,0,0,1037706,"2023-11-08T00:00:00.000Z",21,FALSE,6,17896036,"G",21,21,"Oklahoma City Thunder","Tre Mann",0,0,0,0,0,0
0,0,0,0,0,0,0,0,0,"00",0,0,0,0,0,0,1037706,"2023-11-08T00:00:00.000Z",21,FALSE,6,4197029,"G",21,21,"Oklahoma City Thunder","Vasilije Micic",0,0,0,0,0,0
0,0,0,0,0,0,0,0,0,"00",0,0,0,0,0,0,1037706,"2023-11-08T00:00:00.000Z",21,FALSE,6,3547271,"C",21,21,"Oklahoma City Thunder","Aleksej Pokusevski",0,0,0,0,0,0
2,0,2,3,2,7,5,2,2,"24",1,3,14,3,0,2,1037706,"2023-11-08T00:00:00.000Z",21,FALSE,6,56677833,"G",21,21,"Oklahoma City Thunder","Cason Wallace",0,17,19,16,5,18.6
0,0,0,2,0,3,0,0,0,"09",0,0,0,0,0,0,1037706,"2023-11-08T00:00:00.000Z",21,FALSE,6,17896078,"G",21,21,"Oklahoma City Thunder","Aaron Wiggins",0,0,0,0,0,0
0,0,2,2,2,2,2,0,0,"10",1,4,6,3,0,1,1037706,"2023-11-08T00:00:00.000Z",21,FALSE,6,38017706,"F",21,21,"Oklahoma City Thunder","Jaylin Williams",0,9,9,6,3,8.6
0,0,0,0,0,0,0,0,0,"00",0,0,0,0,0,0,1037706,"2023-11-08T00:00:00.000Z",21,FALSE,6,56677853,"F",21,21,"Oklahoma City Thunder","Keyontae Johnson",0,0,0,0,0,0
0,0,0,0,0,0,0,0,0,"00",0,0,0,0,0,0,1037706,"2023-11-08T00:00:00.000Z",21,FALSE,6,24572055,"C",21,21,"Oklahoma City Thunder","Olivier Sarr",0,0,0,0,0,0
0,0,0,0,0,0,0,0,0,"00",0,0,0,0,0,0,1037706,"2023-11-08T00:00:00.000Z",21,FALSE,6,27924547,"F",21,21,"Oklahoma City Thunder","Lindy Waters III",0,0,0,0,0,0
0,0,0,0,0,0,0,0,0,"00",0,0,0,0,0,0,1037706,"2023-11-08T00:00:00.000Z",21,FALSE,6,480,"G-F",21,21,"Oklahoma City Thunder","Kenrich Williams",0,0,0,0,0,0
3,1,5,6,4,7,4,0,0,"32",2,2,12,7,0,1,1037706,"2023-11-08T00:00:00.000Z",21,FALSE,6,666908,"G",6,6,"Cleveland Cavaliers","Max Strus",1,19,22,15,10,26.9
1,1,3,1,0,16,9,4,4,"33",2,2,22,5,1,1,1037706,"2023-11-08T00:00:00.000Z",21,FALSE,6,17896076,"F-C",6,6,"Cleveland Cavaliers","Evan Mobley",2,27,28,23,6,34.5
1,1,2,0,0,6,4,9,6,"26",4,0,14,6,2,1,1037706,"2023-11-08T00:00:00.000Z",21,FALSE,6,9,"C",6,6,"Cleveland Cavaliers","Jarrett Allen",3,20,21,15,7,30.7
9,1,2,3,1,11,7,1,0,"36",1,4,15,3,2,8,1037706,"2023-11-08T00:00:00.000Z",21,FALSE,6,666581,"G",6,6,"Cleveland Cavaliers","Darius Garland",3,18,27,24,12,33.1
5,0,5,9,1,23,8,3,3,"37",0,2,20,5,2,0,1037706,"2023-11-08T00:00:00.000Z",21,FALSE,6,322,"G",6,6,"Cleveland Cavaliers","Donovan Mitchell",2,25,30,25,10,39.5
0,0,0,0,0,0,0,0,0,"00",0,0,0,0,0,0,1037706,"2023-11-08T00:00:00.000Z",21,FALSE,6,248,"C",6,6,"Cleveland Cavaliers","Damian Jones",0,0,0,0,0,0
5,0,5,6,2,14,7,16,13,"34",0,5,29,5,0,3,1037706,"2023-11-08T00:00:00.000Z",21,FALSE,6,277,"G",6,6,"Cleveland Cavaliers","Caris LeVert",0,34,39,34,10,39.5
0,0,2,3,1,5,3,0,0,"18",0,3,7,2,0,1,1037706,"2023-11-08T00:00:00.000Z",21,FALSE,6,344,"F",6,6,"Cleveland Cavaliers","Georges Niang",0,9,9,7,2,8.4
0,0,0,0,0,0,0,0,0,"00",0,0,0,0,0,0,1037706,"2023-11-08T00:00:00.000Z",21,FALSE,6,404,"G",6,6,"Cleveland Cavaliers","Ricky Rubio",0,0,0,0,0,0
0,1,4,1,0,1,0,2,0,"11",2,4,0,6,1,2,1037706,"2023-11-08T00:00:00.000Z",21,FALSE,6,666940,"F",6,6,"Cleveland Cavaliers","Dean Wade",2,6,6,0,6,11.2
0,0,0,0,0,0,0,0,0,"00",0,0,0,0,0,0,1037706,"2023-11-08T00:00:00.000Z",21,FALSE,6,56677847,"F",6,6,"Cleveland Cavaliers","Emoni Bates",0,0,0,0,0,0
0,0,0,0,0,0,0,0,0,"00",0,0,0,0,0,0,1037706,"2023-11-08T00:00:00.000Z",21,FALSE,6,666676,"G",6,6,"Cleveland Cavaliers","Ty Jerome",0,0,0,0,0,0
0,0,0,0,0,0,0,0,0,"00",0,0,0,0,0,0,1037706,"2023-11-08T00:00:00.000Z",21,FALSE,6,3547299,"G",6,6,"Cleveland Cavaliers","Sam Merrill",0,0,0,0,0,0
0,0,0,0,0,0,0,0,0,"00",0,0,0,0,0,0,1037706,"2023-11-08T00:00:00.000Z",21,FALSE,6,38017662,"F",6,6,"Cleveland Cavaliers","Isaiah Mobley",0,0,0,0,0,0
0,0,0,0,0,0,0,0,0,"00",0,0,0,0,0,0,1037706,"2023-11-08T00:00:00.000Z",21,FALSE,6,3547247,"F-G",6,6,"Cleveland Cavaliers","Isaac Okoro",0,0,0,0,0,0
0,0,0,0,0,0,0,0,0,"00",0,0,0,0,0,0,1037706,"2023-11-08T00:00:00.000Z",21,FALSE,6,56677872,"G",6,6,"Cleveland Cavaliers","Craig Porter",0,0,0,0,0,0
2,0,2,0,0,0,0,2,1,"13",0,2,1,2,1,2,1037706,"2023-11-08T00:00:00.000Z",21,FALSE,6,444,"C-F",6,6,"Cleveland Cavaliers","Tristan Thompson",1,3,5,3,4,7.4
1,0,1,0,0,2,1,0,0,"07",2,2,2,3,0,1,1037707,"2023-11-08T00:00:00.000Z",7,FALSE,28,217,"F-C",7,7,"Dallas Mavericks","Richaun Holmes",0,5,6,3,4,6.1
4,0,2,0,0,0,0,8,4,"15",0,2,4,2,0,2,1037707,"2023-11-08T00:00:00.000Z",7,FALSE,28,257,"F",7,7,"Dallas Mavericks","Maxi Kleber",0,6,10,8,6,10.4
0,0,0,0,0,0,0,0,0,"00",0,0,0,0,0,0,1037707,"2023-11-08T00:00:00.000Z",7,FALSE,28,329,"F",7,7,"Dallas Mavericks","Markieff Morris",0,0,0,0,0,0
0,0,0,0,0,0,0,0,0,"00",0,0,0,0,0,0,1037707,"2023-11-08T00:00:00.000Z",7,FALSE,28,56677859,"F",7,7,"Dallas Mavericks","Olivier-Maxence Prosper",0,0,0,0,0,0
0,0,0,0,0,0,0,0,0,"00",0,0,0,0,0,0,1037707,"2023-11-08T00:00:00.000Z",7,FALSE,28,17896028,"F",7,7,"Dallas Mavericks","Greg Brown III",0,0,0,0,0,0
0,0,0,0,0,0,0,0,0,"00",0,0,0,0,0,0,1037707,"2023-11-08T00:00:00.000Z",7,FALSE,28,56677873,"G",7,7,"Dallas Mavericks","Dexter Dennis",0,0,0,0,0,0
0,0,0,0,0,0,0,0,0,"00",0,0,0,0,0,0,1037707,"2023-11-08T00:00:00.000Z",7,FALSE,28,17554004,"G",7,7,"Dallas Mavericks","AJ Lawson",0,0,0,0,0,0
0,0,0,0,0,0,0,0,0,"00",0,0,0,0,0,0,1037707,"2023-11-08T00:00:00.000Z",7,FALSE,28,56677840,"C",7,7,"Dallas Mavericks","Dereck Lively II",0,0,0,0,0,0
2,0,4,8,3,17,9,6,5,"36",1,4,26,5,0,2,1037707,"2023-11-08T00:00:00.000Z",7,FALSE,28,18,"F",28,28,"Toronto Raptors","OG Anunoby",0,31,33,28,7,33
5,0,8,5,0,25,15,4,1,"37",4,2,31,12,0,3,1037707,"2023-11-08T00:00:00.000Z",7,FALSE,28,416,"F",28,28,"Toronto Raptors","Pascal Siakam",0,43,48,36,17,49.9
3,0,3,0,0,5,2,1,0,"21",3,4,4,6,2,1,1037707,"2023-11-08T00:00:00.000Z",7,FALSE,28,373,"C",28,28,"Toronto Raptors","Jakob Poeltl",2,10,13,7,9,20.7
1,3,4,5,3,8,6,0,0,"29",1,3,15,5,0,3,1037707,"2023-11-08T00:00:00.000Z",7,FALSE,28,247,"F-G",7,7,"Dallas Mavericks","Derrick Jones Jr.",3,20,21,16,6,28.5
1,0,2,5,2,7,2,0,0,"27",0,4,6,2,0,0,1037707,"2023-11-08T00:00:00.000Z",7,FALSE,28,666965,"F",7,7,"Dallas Mavericks","Grant Williams",0,8,9,7,3,9.9
0,1,6,0,0,1,1,5,3,"24",0,2,5,6,0,0,1037707,"2023-11-08T00:00:00.000Z",7,FALSE,28,379,"F-C",7,7,"Dallas Mavericks","Dwight Powell",1,11,11,5,6,15.2
5,0,4,7,3,19,8,3,3,"36",0,2,22,4,0,1,1037707,"2023-11-08T00:00:00.000Z",7,FALSE,28,228,"G",7,7,"Dallas Mavericks","Kyrie Irving",0,26,31,27,9,33.3
8,1,7,10,2,26,11,10,7,"38",0,3,31,7,4,4,1037707,"2023-11-08T00:00:00.000Z",7,FALSE,28,132,"F-G",7,7,"Dallas Mavericks","Luka Doncic",5,38,46,39,15,62.4
0,0,0,0,0,0,0,0,0,"00",0,0,0,0,0,0,1037707,"2023-11-08T00:00:00.000Z",7,FALSE,28,114,"G",7,7,"Dallas Mavericks","Seth Curry",0,0,0,0,0,0
0,0,3,0,0,3,2,3,1,"08",2,1,5,5,0,0,1037707,"2023-11-08T00:00:00.000Z",7,FALSE,28,151,"G",7,7,"Dallas Mavericks","Dante Exum",0,10,10,5,5,11
0,0,0,0,0,0,0,0,0,"00",0,0,0,0,0,0,1037707,"2023-11-08T00:00:00.000Z",7,FALSE,28,56677869,"G",28,28,"Toronto Raptors","Markquis Nowell",0,0,0,0,0,0
0,0,0,0,0,0,0,0,0,"00",0,0,0,0,0,0,1037707,"2023-11-08T00:00:00.000Z",7,FALSE,28,489,"F",28,28,"Toronto Raptors","Thaddeus Young",0,0,0,0,0,0
0,0,0,0,0,0,0,0,0,"00",0,0,0,0,0,0,1037707,"2023-11-08T00:00:00.000Z",7,FALSE,28,3547249,"F",28,28,"Toronto Raptors","Precious Achiuwa",0,0,0,0,0,0
0,0,0,0,0,0,0,0,0,"00",0,0,0,0,0,0,1037707,"2023-11-08T00:00:00.000Z",7,FALSE,28,56677805,"G",28,28,"Toronto Raptors","Javon Freeman-Liberty",0,0,0,0,0,0
0,0,0,0,0,0,0,0,0,"00",0,0,0,0,0,0,1037707,"2023-11-08T00:00:00.000Z",7,FALSE,28,38017717,"F",28,28,"Toronto Raptors","Ron Harper Jr.",0,0,0,0,0,0
0,0,0,0,0,0,0,0,0,"00",0,0,0,0,0,0,1037707,"2023-11-08T00:00:00.000Z",7,FALSE,28,38017710,"C",28,28,"Toronto Raptors","Christian Koloko",0,0,0,0,0,0
2,1,1,2,1,3,1,0,0,"18",0,2,3,1,0,1,1037707,"2023-11-08T00:00:00.000Z",7,FALSE,28,3547258,"G",7,7,"Dallas Mavericks","Josh Green",1,4,6,5,3,9.2
1,0,1,9,5,11,6,0,0,"26",1,0,17,2,0,3,1037707,"2023-11-08T00:00:00.000Z",7,FALSE,28,191,"G",7,7,"Dallas Mavericks","Tim Hardaway Jr.",0,19,20,18,3,17.9
2,0,1,3,1,4,2,2,1,"12",0,0,6,1,0,0,1037707,"2023-11-08T00:00:00.000Z",7,FALSE,28,38017679,"G",7,7,"Dallas Mavericks","Jaden Hardy",0,7,9,8,3,10.2
0,0,0,0,0,1,0,0,0,"06",0,1,0,0,0,2,1037707,"2023-11-08T00:00:00.000Z",7,FALSE,28,56677828,"G",28,28,"Toronto Raptors","Gradey Dick",0,0,0,0,0,-2
3,0,4,4,2,5,2,2,2,"15",0,2,8,4,0,0,1037707,"2023-11-08T00:00:00.000Z",7,FALSE,28,3547275,"G",28,28,"Toronto Raptors","Malachi Flynn",0,12,15,11,7,17.3
0,0,3,2,0,3,0,0,0,"15",0,1,0,3,1,0,1037707,"2023-11-08T00:00:00.000Z",7,FALSE,28,376,"F",28,28,"Toronto Raptors","Otto Porter Jr.",1,3,3,0,3,6.6
1,0,2,8,4,11,6,0,0,"26",0,0,16,2,1,0,1037707,"2023-11-08T00:00:00.000Z",7,FALSE,28,3089,"",28,28,"Toronto Raptors","Gary Trent Jr.",1,18,19,17,3,22.9
7,2,8,4,0,15,4,8,6,"39",6,2,14,14,4,0,1037707,"2023-11-08T00:00:00.000Z",7,FALSE,28,17896055,"G-F",28,28,"Toronto Raptors","Scottie Barnes",6,28,35,21,21,59.3
5,1,2,4,1,13,7,4,3,"30",0,4,18,2,2,2,1037707,"2023-11-08T00:00:00.000Z",7,FALSE,28,409,"G",28,28,"Toronto Raptors","Dennis Schroder",3,20,25,23,7,34.9
0,1,1,1,1,4,4,2,1,"15",1,5,10,2,0,1,1037707,"2023-11-08T00:00:00.000Z",7,FALSE,28,58,"F",28,28,"Toronto Raptors","Chris Boucher",1,12,12,10,2,14.4
0,0,0,0,0,0,0,0,0,"00",0,0,0,0,0,0,1037707,"2023-11-08T00:00:00.000Z",7,FALSE,28,666762,"F",28,28,"Toronto Raptors","Jalen McDaniels",0,0,0,0,0,0
0,0,0,0,0,0,0,0,0,"00",0,0,0,0,0,0,1037707,"2023-11-08T00:00:00.000Z",7,FALSE,28,436,"G-F",28,28,"Toronto Raptors","Garrett Temple",0,0,0,0,0,0
2,2,6,8,3,17,7,0,0,"37",2,1,17,8,0,0,1037708,"2023-11-08T00:00:00.000Z",8,FALSE,10,375,"F",8,8,"Denver Nuggets","Michael Porter Jr.",2,25,27,19,10,35.6
3,1,7,2,1,14,5,4,3,"34",4,2,14,11,3,2,1037708,"2023-11-08T00:00:00.000Z",8,FALSE,10,177,"F",8,8,"Denver Nuggets","Aaron Gordon",4,25,28,17,14,41.7
5,1,10,8,1,25,14,10,6,"37",3,3,35,13,3,3,1037708,"2023-11-08T00:00:00.000Z",8,FALSE,10,246,"C",8,8,"Denver Nuggets","Nikola Jokic",4,48,53,40,18,67.1
3,0,2,3,0,8,3,4,4,"35",1,3,10,3,1,0,1037708,"2023-11-08T00:00:00.000Z",8,FALSE,10,81,"G",8,8,"Denver Nuggets","Kentavious Caldwell-Pope",1,13,16,13,6,21.1
6,0,2,7,3,17,8,2,1,"32",0,5,20,2,0,0,1037708,"2023-11-08T00:00:00.000Z",8,FALSE,10,236,"G",8,8,"Denver Nuggets","Reggie Jackson",0,22,28,26,8,31.4
2,0,2,2,1,3,1,2,1,"16",0,1,4,2,0,0,1037708,"2023-11-08T00:00:00.000Z",8,FALSE,10,38017709,"G",8,8,"Denver Nuggets","Christian Braun",0,6,8,6,4,9.4
1,0,0,2,1,2,1,0,0,"16",0,2,3,0,0,1,1037708,"2023-11-08T00:00:00.000Z",8,FALSE,10,38017727,"G",8,8,"Denver Nuggets","Collin Gillespie",0,3,4,4,1,3.5
4,0,4,13,6,17,6,5,5,"34",1,2,23,5,1,3,1037708,"2023-11-08T00:00:00.000Z",8,FALSE,10,115,"G",10,10,"Golden State Warriors","Stephen Curry",1,28,32,27,9,35
1,0,2,0,0,3,2,5,4,"18",0,4,8,2,0,0,1037708,"2023-11-08T00:00:00.000Z",8,FALSE,10,56677799,"F",10,10,"Golden State Warriors","Trayce Jackson-Davis",0,10,11,9,3,11.9
0,0,0,0,0,0,0,0,0,"00",0,0,0,0,0,0,1037708,"2023-11-08T00:00:00.000Z",8,FALSE,10,251,"G",10,10,"Golden State Warriors","Cory Joseph",0,0,0,0,0,0
2,0,2,1,0,12,4,2,2,"19",2,1,10,4,0,0,1037708,"2023-11-08T00:00:00.000Z",8,FALSE,10,17553979,"F",10,10,"Golden State Warriors","Jonathan Kuminga",0,14,16,12,6,17.8
1,0,3,3,2,7,4,0,0,"14",0,0,10,3,1,0,1037708,"2023-11-08T00:00:00.000Z",8,FALSE,10,17553992,"G",10,10,"Golden State Warriors","Moses Moody",1,13,14,11,4,18.1
4,0,4,4,1,10,4,0,0,"27",1,2,9,5,1,1,1037708,"2023-11-08T00:00:00.000Z",8,FALSE,10,367,"G",10,10,"Golden State Warriors","Chris Paul",1,14,18,13,9,23
2,0,2,0,0,3,2,1,1,"11",1,2,5,3,0,0,1037708,"2023-11-08T00:00:00.000Z",8,FALSE,10,56677858,"G",10,10,"Golden State Warriors","Brandin Podziemski",0,8,10,7,5,11.6
0,0,0,0,0,0,0,0,0,"00",0,0,0,0,0,0,1037708,"2023-11-08T00:00:00.000Z",8,FALSE,10,17896007,"G",8,8,"Denver Nuggets","Braxton Key",0,0,0,0,0,0
2,0,2,0,0,1,0,0,0,"06",0,0,0,2,0,0,1037708,"2023-11-08T00:00:00.000Z",8,FALSE,10,3547268,"F-C",8,8,"Denver Nuggets","Zeke Nnaji",0,2,4,2,4,5.4
0,0,0,0,0,0,0,0,0,"00",0,0,0,0,0,0,1037708,"2023-11-08T00:00:00.000Z",8,FALSE,10,56677582,"G",8,8,"Denver Nuggets","Jalen Pickett",0,0,0,0,0,0
0,0,1,1,0,1,0,0,0,"08",0,2,0,1,0,0,1037708,"2023-11-08T00:00:00.000Z",8,FALSE,10,56677776,"G",8,8,"Denver Nuggets","Julian Strawther",0,1,1,0,1,1.2
0,0,0,0,0,0,0,0,0,"00",0,0,0,0,0,0,1037708,"2023-11-08T00:00:00.000Z",8,FALSE,10,56677871,"F",8,8,"Denver Nuggets","Hunter Tyson",0,0,0,0,0,0
0,0,0,0,0,2,1,0,0,"11",0,0,2,0,0,0,1037708,"2023-11-08T00:00:00.000Z",8,FALSE,10,38017721,"G",8,8,"Denver Nuggets","Peyton Watson",0,2,2,2,0,2
0,0,0,0,0,0,0,0,0,"00",0,0,0,0,0,0,1037708,"2023-11-08T00:00:00.000Z",8,FALSE,10,666489,"F",8,8,"Denver Nuggets","Vlatko Cancar",0,0,0,0,0,0
0,0,0,0,0,0,0,0,0,"00",0,0,0,0,0,0,1037708,"2023-11-08T00:00:00.000Z",8,FALSE,10,17896103,"F-C",8,8,"Denver Nuggets","Jay Huff",0,0,0,0,0,0
0,0,0,0,0,0,0,0,0,"00",0,0,0,0,0,0,1037708,"2023-11-08T00:00:00.000Z",8,FALSE,10,335,"G",8,8,"Denver Nuggets","Jamal Murray",0,0,0,0,0,0
0,0,2,3,0,13,4,4,3,"29",3,3,11,5,0,1,1037708,"2023-11-08T00:00:00.000Z",8,FALSE,10,475,"F-G",10,10,"Golden State Warriors","Andrew Wiggins",0,16,16,11,5,16
0,0,3,2,1,2,1,0,0,"08",0,1,3,3,0,0,1037708,"2023-11-08T00:00:00.000Z",8,FALSE,10,215,"F-G",8,8,"Denver Nuggets","Justin Holiday",0,6,6,3,3,6.6
0,0,0,0,0,0,0,0,0,"00",0,0,0,0,0,0,1037708,"2023-11-08T00:00:00.000Z",8,FALSE,10,250,"C",8,8,"Denver Nuggets","DeAndre Jordan",0,0,0,0,0,0
2,0,7,3,0,5,2,0,0,"26",1,0,4,8,0,0,1037708,"2023-11-08T00:00:00.000Z",8,FALSE,10,407,"F",10,10,"Golden State Warriors","Dario Saric",0,12,14,6,10,16.6
4,0,6,0,0,4,4,3,2,"30",2,5,10,8,1,2,1037708,"2023-11-08T00:00:00.000Z",8,FALSE,10,282,"F",10,10,"Golden State Warriors","Kevon Looney",1,18,22,14,12,26.6
1,0,6,8,2,12,5,6,3,"32",0,1,15,6,1,2,1037708,"2023-11-08T00:00:00.000Z",8,FALSE,10,443,"G",10,10,"Golden State Warriors","Klay Thompson",1,21,22,16,7,24.7
0,0,0,0,0,0,0,0,0,"00",0,0,0,0,0,0,1037708,"2023-11-08T00:00:00.000Z",8,FALSE,10,398,"G",10,10,"Golden State Warriors","Jerome Robinson",0,0,0,0,0,0
0,0,0,0,0,0,0,0,0,"00",0,0,0,0,0,0,1037708,"2023-11-08T00:00:00.000Z",8,FALSE,10,17896070,"F",10,10,"Golden State Warriors","Usman Garuba",0,0,0,0,0,0
0,0,0,0,0,0,0,0,0,"00",0,0,0,0,0,0,1037708,"2023-11-08T00:00:00.000Z",8,FALSE,10,185,"F",10,10,"Golden State Warriors","Draymond Green",0,0,0,0,0,0
0,0,0,0,0,0,0,0,0,"00",0,0,0,0,0,0,1037708,"2023-11-08T00:00:00.000Z",8,FALSE,10,2189,"",10,10,"Golden State Warriors","Gary Payton II",0,0,0,0,0,0
0,0,0,0,0,0,0,0,0,"00",0,0,0,0,0,0,1037708,"2023-11-08T00:00:00.000Z",8,FALSE,10,45658838,"G",10,10,"Golden State Warriors","Lester Quinones",0,0,0,0,0,0
0,0,0,0,0,0,0,0,0,"00",0,0,0,0,0,0,1037708,"2023-11-08T00:00:00.000Z",8,FALSE,10,57875092,"F",10,10,"Golden State Warriors","Gui Santos",0,0,0,0,0,0
0,0,4,5,2,8,5,0,0,"36",1,3,12,5,1,1,1037709,"2023-11-08T00:00:00.000Z",26,FALSE,25,30,"F",26,26,"Sacramento Kings","Harrison Barnes",1,17,17,12,5,20
3,2,5,6,1,17,4,0,0,"31",2,3,9,7,1,1,1037709,"2023-11-08T00:00:00.000Z",26,FALSE,25,38017688,"F",26,26,"Sacramento Kings","Keegan Murray",3,16,19,12,10,29.9
9,1,4,0,0,14,11,7,5,"40",7,4,27,11,1,6,1037709,"2023-11-08T00:00:00.000Z",26,FALSE,25,406,"F",26,26,"Sacramento Kings","Domantas Sabonis",2,38,47,36,20,53.7
4,0,5,9,4,13,5,3,3,"39",0,2,17,5,2,3,1037709,"2023-11-08T00:00:00.000Z",26,FALSE,25,221,"G",26,26,"Sacramento Kings","Kevin Huerter",2,22,26,21,9,32
0,0,4,2,0,3,1,3,2,"21",0,1,4,4,3,2,1037709,"2023-11-08T00:00:00.000Z",26,FALSE,25,38017714,"G",26,26,"Sacramento Kings","Keon Ellis",3,8,8,4,4,15.8
0,0,2,3,1,4,1,0,0,"11",0,2,3,2,1,0,1037709,"2023-11-08T00:00:00.000Z",26,FALSE,25,17896030,"G",26,26,"Sacramento Kings","Chris Duarte",1,5,5,3,2,8.4
1,1,4,1,0,1,0,0,0,"16",0,4,0,4,0,1,1037709,"2023-11-08T00:00:00.000Z",26,FALSE,25,17896044,"F",26,26,"Sacramento Kings","Kessler Edwards",1,4,5,1,5,8.3
0,0,0,0,0,0,0,0,0,"00",0,0,0,0,0,0,1037709,"2023-11-08T00:00:00.000Z",26,FALSE,25,17895990,"G",26,26,"Sacramento Kings","Jordan Ford",0,0,0,0,0,0
0,0,0,0,0,0,0,0,0,"00",0,0,0,0,0,0,1037709,"2023-11-08T00:00:00.000Z",26,FALSE,25,56677845,"G",26,26,"Sacramento Kings","Colby Jones",0,0,0,0,0,0
1,2,3,0,0,4,4,5,2,"13",3,1,10,6,1,0,1037709,"2023-11-08T00:00:00.000Z",26,FALSE,25,273,"C",26,26,"Sacramento Kings","Alex Len",3,16,17,11,7,27.7
0,0,0,0,0,0,0,0,0,"00",0,0,0,0,0,0,1037709,"2023-11-08T00:00:00.000Z",26,FALSE,25,306,"C",26,26,"Sacramento Kings","JaVale McGee",0,0,0,0,0,0
4,0,0,4,3,9,6,1,1,"28",0,4,16,0,0,2,1037709,"2023-11-08T00:00:00.000Z",26,FALSE,25,17553994,"G",26,26,"Sacramento Kings","Davion Mitchell",0,16,20,20,4,20
10,0,4,7,0,16,4,19,15,"30",2,0,23,6,1,5,1037709,"2023-11-08T00:00:00.000Z",26,FALSE,25,324,"G",26,26,"Sacramento Kings","Malik Monk",1,29,39,33,16,43.2
0,0,0,0,0,0,0,0,0,"00",0,0,0,0,0,0,1037709,"2023-11-08T00:00:00.000Z",26,FALSE,25,17895941,"C",26,26,"Sacramento Kings","Filip Petrusev",0,0,0,0,0,0
0,0,0,0,0,0,0,0,0,"00",0,0,0,0,0,0,1037709,"2023-11-08T00:00:00.000Z",26,FALSE,25,4197162,"F",26,26,"Sacramento Kings","Aleksandar Vezenkov",0,0,0,0,0,0
0,0,0,0,0,0,0,0,0,"00",0,0,0,0,0,0,1037709,"2023-11-08T00:00:00.000Z",26,FALSE,25,161,"G",26,26,"Sacramento Kings","De'Aaron Fox",0,0,0,0,0,0
0,0,0,0,0,0,0,0,0,"00",0,0,0,0,0,0,1037709,"2023-11-08T00:00:00.000Z",26,FALSE,25,290,"F",26,26,"Sacramento Kings","Trey Lyles",0,0,0,0,0,0
0,1,0,0,0,1,0,0,0,"09",0,1,0,0,0,0,1037709,"2023-11-08T00:00:00.000Z",26,FALSE,25,56677791,"F",25,25,"Portland Trail Blazers","Kris Murray",1,0,0,0,0,3
1,0,2,1,0,2,1,0,0,"15",0,4,2,2,0,1,1037709,"2023-11-08T00:00:00.000Z",26,FALSE,25,38017711,"F",25,25,"Portland Trail Blazers","Jabari Walker",0,4,5,3,3,4.9
0,0,0,0,0,0,0,0,0,"00",0,0,0,0,0,0,1037709,"2023-11-08T00:00:00.000Z",26,FALSE,25,56677862,"F",26,26,"Sacramento Kings","Jalen Slawson",0,0,0,0,0,0
1,0,1,4,1,8,4,5,4,"34",1,1,13,2,4,2,1037709,"2023-11-08T00:00:00.000Z",26,FALSE,25,666923,"G-F",25,25,"Portland Trail Blazers","Matisse Thybulle",4,15,16,14,3,26.9
1,0,1,2,1,3,2,0,0,"05",0,1,5,1,0,0,1037709,"2023-11-08T00:00:00.000Z",26,FALSE,25,65,"G",25,25,"Portland Trail Blazers","Malcolm Brogdon",0,6,7,6,2,7.7
11,0,2,2,0,15,8,2,2,"37",0,4,18,2,2,3,1037709,"2023-11-08T00:00:00.000Z",26,FALSE,25,3547289,"G",25,25,"Portland Trail Blazers","Skylar Mays",2,20,31,29,13,39.9
1,0,3,0,0,2,1,0,0,"25",1,3,2,4,3,1,1037709,"2023-11-08T00:00:00.000Z",26,FALSE,25,56677850,"F",25,25,"Portland Trail Blazers","Toumani Camara",3,6,7,3,5,16.3
1,1,1,0,0,3,2,2,0,"05",2,1,4,3,0,0,1037709,"2023-11-08T00:00:00.000Z",26,FALSE,25,666476,"C",25,25,"Portland Trail Blazers","Moses Brown",1,7,8,5,4,12.1
5,3,8,8,5,25,12,12,9,"46",1,2,38,9,0,4,1037709,"2023-11-08T00:00:00.000Z",26,FALSE,25,182,"F",25,25,"Portland Trail Blazers","Jerami Grant",3,47,52,43,14,61.3
2,0,9,0,0,14,9,0,0,"41",1,5,18,10,0,2,1037709,"2023-11-08T00:00:00.000Z",26,FALSE,25,22,"C",25,25,"Portland Trail Blazers","Deandre Ayton",0,28,30,20,12,31
3,0,1,5,1,14,5,8,7,"40",0,6,18,1,1,4,1037709,"2023-11-08T00:00:00.000Z",26,FALSE,25,38017690,"G",25,25,"Portland Trail Blazers","Shaedon Sharpe",1,19,22,21,4,22.7
0,0,1,0,0,0,0,0,0,"08",1,1,0,2,0,1,1037709,"2023-11-08T00:00:00.000Z",26,FALSE,25,47957121,"F",25,25,"Portland Trail Blazers","Justin Minaya",0,2,2,0,2,1.4
0,0,0,0,0,0,0,0,0,"00",0,0,0,0,0,0,1037709,"2023-11-08T00:00:00.000Z",26,FALSE,25,56677829,"G-F",25,25,"Portland Trail Blazers","Rayan Rupert",0,0,0,0,0,0
0,0,0,0,0,0,0,0,0,"00",0,0,0,0,0,0,1037709,"2023-11-08T00:00:00.000Z",26,FALSE,25,56677747,"G",25,25,"Portland Trail Blazers","Scoot Henderson",0,0,0,0,0,0
0,0,0,0,0,0,0,0,0,"00",0,0,0,0,0,0,1037709,"2023-11-08T00:00:00.000Z",26,FALSE,25,56783340,"C",25,25,"Portland Trail Blazers","Duop Reath",0,0,0,0,0,0
0,0,0,0,0,0,0,0,0,"00",0,0,0,0,0,0,1037709,"2023-11-08T00:00:00.000Z",26,FALSE,25,419,"G",25,25,"Portland Trail Blazers","Anfernee Simons",0,0,0,0,0,0
0,0,0,0,0,0,0,0,0,"00",0,0,0,0,0,0,1037709,"2023-11-08T00:00:00.000Z",26,FALSE,25,17896120,"F",25,25,"Portland Trail Blazers","Ish Wainright",0,0,0,0,0,0
0,0,0,0,0,0,0,0,0,"00",0,0,0,0,0,0,1037709,"2023-11-08T00:00:00.000Z",26,FALSE,25,476,"C-F",25,25,"Portland Trail Blazers","Robert Williams III",0,0,0,0,0,0
2,1,7,7,3,18,9,6,5,"36",4,1,26,11,1,1,1037710,"2023-11-09T00:00:00.000Z",12,FALSE,17,38017686,"G-F",12,12,"Indiana Pacers","Bennedict Mathurin",2,37,39,28,13,47.2
0,0,0,2,1,3,2,2,2,"13",0,4,7,0,0,1,1037710,"2023-11-09T00:00:00.000Z",12,FALSE,17,3547243,"F",12,12,"Indiana Pacers","Obi Toppin",0,7,7,7,0,6
4,1,5,9,4,16,8,1,1,"37",1,4,21,6,0,1,1037710,"2023-11-09T00:00:00.000Z",12,FALSE,17,452,"C-F",12,12,"Indiana Pacers","Myles Turner",1,27,31,25,10,36.2
7,1,7,4,1,9,3,4,4,"38",2,0,11,9,2,2,1037710,"2023-11-09T00:00:00.000Z",12,FALSE,17,69,"G",12,12,"Indiana Pacers","Bruce Brown",3,20,27,18,16,39.3
10,1,5,9,5,17,10,4,4,"38",1,1,29,6,0,2,1037710,"2023-11-09T00:00:00.000Z",12,FALSE,17,3547245,"G",12,12,"Indiana Pacers","Tyrese Haliburton",1,35,45,39,16,52.2
2,0,2,11,2,14,4,1,1,"22",0,3,11,2,1,2,1037710,"2023-11-09T00:00:00.000Z",12,FALSE,17,210,"G",12,12,"Indiana Pacers","Buddy Hield",1,13,15,13,4,17.4
0,2,2,0,0,2,1,2,1,"11",1,3,3,3,1,0,1037710,"2023-11-09T00:00:00.000Z",12,FALSE,17,17896035,"F",12,12,"Indiana Pacers","Isaiah Jackson",3,6,6,3,3,15.6
0,0,0,0,0,0,0,0,0,"00",0,0,0,0,0,0,1037710,"2023-11-09T00:00:00.000Z",12,FALSE,17,304,"G",12,12,"Indiana Pacers","T.J. McConnell",0,0,0,0,0,0
2,0,2,2,2,5,4,0,0,"20",0,3,10,2,1,1,1037710,"2023-11-09T00:00:00.000Z",12,FALSE,17,38017507,"G-F",12,12,"Indiana Pacers","Andrew Nembhard",1,12,14,12,4,17.4
0,0,1,3,2,4,2,0,0,"17",0,5,6,1,0,1,1037710,"2023-11-09T00:00:00.000Z",12,FALSE,17,3547250,"G-F",12,12,"Indiana Pacers","Aaron Nesmith",0,7,7,6,1,6.2
0,0,0,0,0,0,0,0,0,"00",0,0,0,0,0,0,1037710,"2023-11-09T00:00:00.000Z",12,FALSE,17,3547207,"F",12,12,"Indiana Pacers","Jordan Nwora",0,0,0,0,0,0
0,0,0,0,0,0,0,0,0,"00",0,0,0,0,0,0,1037710,"2023-11-09T00:00:00.000Z",12,FALSE,17,56677861,"G",12,12,"Indiana Pacers","Ben Sheppard",0,0,0,0,0,0
0,0,0,0,0,0,0,0,0,"00",0,0,0,0,0,0,1037710,"2023-11-09T00:00:00.000Z",12,FALSE,17,3547264,"F-C",12,12,"Indiana Pacers","Jalen Smith",0,0,0,0,0,0
0,0,0,1,0,4,1,0,0,"08",0,1,2,0,0,0,1037710,"2023-11-09T00:00:00.000Z",12,FALSE,17,439,"F",13,12,"Indiana Pacers","Daniel Theis",0,2,2,2,0,2
0,0,0,0,0,0,0,0,0,"00",0,0,0,0,0,0,1037710,"2023-11-09T00:00:00.000Z",12,FALSE,17,56677832,"F",12,12,"Indiana Pacers","Jarace Walker",0,0,0,0,0,0
0,0,0,0,0,0,0,0,0,"00",0,0,0,0,0,0,1037710,"2023-11-09T00:00:00.000Z",12,FALSE,17,38017701,"G",12,12,"Indiana Pacers","Kendall Brown",0,0,0,0,0,0
0,0,0,0,0,0,0,0,0,"00",0,0,0,0,0,0,1037710,"2023-11-09T00:00:00.000Z",12,FALSE,17,56677778,"F-C",12,12,"Indiana Pacers","Oscar Tshiebwe",0,0,0,0,0,0
0,0,0,0,0,0,0,0,0,"00",0,0,0,0,0,0,1037710,"2023-11-09T00:00:00.000Z",12,FALSE,17,56677794,"G",12,12,"Indiana Pacers","Isaiah Wong",0,0,0,0,0,0
4,0,1,6,2,13,7,4,3,"20",1,1,19,2,0,2,1037710,"2023-11-09T00:00:00.000Z",12,FALSE,17,315,"F",17,17,"Milwaukee Bucks","Khris Middleton",0,21,25,23,6,25.4
3,0,10,1,0,25,19,18,16,"36",2,4,54,12,0,8,1037710,"2023-11-09T00:00:00.000Z",12,FALSE,17,15,"F",17,17,"Milwaukee Bucks","Giannis Antetokounmpo",0,66,69,57,15,64.9
0,3,1,4,0,7,1,0,0,"29",0,2,2,1,2,0,1037710,"2023-11-09T00:00:00.000Z",12,FALSE,17,283,"C",17,17,"Milwaukee Bucks","Brook Lopez",5,3,3,2,1,18.2
2,0,3,6,3,10,4,2,2,"29",1,2,13,4,1,0,1037710,"2023-11-09T00:00:00.000Z",12,FALSE,17,38,"G",17,17,"Milwaukee Bucks","Malik Beasley",1,17,19,15,6,23.8
5,1,4,2,1,9,3,0,0,"30",0,4,7,4,0,1,1037710,"2023-11-09T00:00:00.000Z",12,FALSE,17,368,"G",17,17,"Milwaukee Bucks","Cameron Payne",1,11,16,12,9,21.3
1,0,4,1,1,2,2,0,0,"29",0,2,5,4,1,0,1037710,"2023-11-09T00:00:00.000Z",12,FALSE,17,112,"F",17,17,"Milwaukee Bucks","Jae Crowder",1,9,10,6,5,14.3
2,1,8,2,0,11,5,1,1,"24",0,2,11,8,1,3,1037710,"2023-11-09T00:00:00.000Z",12,FALSE,17,377,"F",17,17,"Milwaukee Bucks","Bobby Portis",2,19,21,13,10,26.6
4,0,2,3,1,6,3,1,1,"25",0,0,8,2,1,0,1037710,"2023-11-09T00:00:00.000Z",12,FALSE,17,105,"G",17,17,"Milwaukee Bucks","Pat Connaughton",1,10,14,12,6,19.4
2,0,3,2,1,4,2,0,0,"13",1,0,5,4,0,0,1037710,"2023-11-09T00:00:00.000Z",12,FALSE,17,38017676,"F",17,17,"Milwaukee Bucks","MarJon Beauchamp",0,9,11,7,6,12.8
0,0,0,0,0,0,0,0,0,"05",0,2,0,0,0,0,1037710,"2023-11-09T00:00:00.000Z",12,FALSE,17,56677852,"G",17,17,"Milwaukee Bucks","Andre Jackson Jr.",0,0,0,0,0,0
0,0,0,0,0,0,0,0,0,"00",0,0,0,0,0,0,1037710,"2023-11-09T00:00:00.000Z",12,FALSE,17,2148,"",17,17,"Milwaukee Bucks","Thanasis Antetokounmpo",0,0,0,0,0,0
0,0,0,0,0,0,0,0,0,"00",0,0,0,0,0,0,1037710,"2023-11-09T00:00:00.000Z",12,FALSE,17,38017733,"G",17,17,"Milwaukee Bucks","A.J. Green",0,0,0,0,0,0
0,0,0,0,0,0,0,0,0,"00",0,0,0,0,0,0,1037710,"2023-11-09T00:00:00.000Z",12,FALSE,17,56677854,"F",17,17,"Milwaukee Bucks","Chris Livingston",0,0,0,0,0,0
0,0,0,0,0,0,0,0,0,"00",0,0,0,0,0,0,1037710,"2023-11-09T00:00:00.000Z",12,FALSE,17,284,"C",17,17,"Milwaukee Bucks","Robin Lopez",0,0,0,0,0,0
0,0,0,0,0,0,0,0,0,"00",0,0,0,0,0,0,1037710,"2023-11-09T00:00:00.000Z",12,FALSE,17,666960,"G",17,17,"Milwaukee Bucks","Lindell Wigginton",0,0,0,0,0,0
0,0,0,0,0,0,0,0,0,"00",0,0,0,0,0,0,1037710,"2023-11-09T00:00:00.000Z",12,FALSE,17,666453,"C",17,17,"Milwaukee Bucks","Marques Bolden",0,0,0,0,0,0
0,0,0,0,0,0,0,0,0,"00",0,0,0,0,0,0,1037710,"2023-11-09T00:00:00.000Z",12,FALSE,17,278,"G",17,17,"Milwaukee Bucks","Damian Lillard",0,0,0,0,0,0
0,0,0,0,0,0,0,0,0,"00",0,0,0,0,0,0,1037710,"2023-11-09T00:00:00.000Z",12,FALSE,17,38017691,"G",17,17,"Milwaukee Bucks","TyTy Washington Jr.",0,0,0,0,0,0
3,0,4,1,0,12,5,2,2,"29",2,2,12,6,0,4,1037711,"2023-11-09T00:00:00.000Z",22,FALSE,1,17896026,"F",22,22,"Orlando Magic","Franz Wagner",0,18,21,15,9,19.7
4,0,4,3,1,14,7,4,2,"34",4,4,17,8,1,5,1037711,"2023-11-09T00:00:00.000Z",22,FALSE,1,38017683,"F",22,22,"Orlando Magic","Paolo Banchero",1,25,29,21,12,30.6
0,2,3,0,0,7,5,4,2,"21",2,2,12,5,0,1,1037711,"2023-11-09T00:00:00.000Z",22,FALSE,1,666442,"C",22,22,"Orlando Magic","Goga Bitadze",2,17,17,12,5,23
1,0,3,5,4,10,7,6,3,"31",0,5,21,3,7,2,1037711,"2023-11-09T00:00:00.000Z",22,FALSE,1,17896073,"G",22,22,"Orlando Magic","Jalen Suggs",7,24,25,22,4,45.1
3,0,0,0,0,12,5,3,3,"28",1,1,13,1,0,0,1037711,"2023-11-09T00:00:00.000Z",22,FALSE,1,165,"G",22,22,"Orlando Magic","Markelle Fultz",0,14,17,16,4,18.7
2,0,1,4,0,7,1,6,5,"24",1,3,7,2,0,3,1037711,"2023-11-09T00:00:00.000Z",22,FALSE,1,3547251,"G",22,22,"Orlando Magic","Cole Anthony",0,9,11,9,4,9.4
0,0,0,0,0,0,0,0,0,"00",0,0,0,0,0,0,1037711,"2023-11-09T00:00:00.000Z",22,FALSE,1,38017724,"G",22,22,"Orlando Magic","Caleb Houstan",0,0,0,0,0,0
0,0,0,0,0,0,0,0,0,"00",0,0,0,0,0,0,1037711,"2023-11-09T00:00:00.000Z",22,FALSE,1,56677839,"G",22,22,"Orlando Magic","Jett Howard",0,0,0,0,0,0
5,1,1,3,1,6,1,0,0,"18",2,1,3,3,3,0,1037711,"2023-11-09T00:00:00.000Z",22,FALSE,1,226,"F",22,22,"Orlando Magic","Joe Ingles",4,6,11,8,8,26.1
0,0,0,0,0,0,0,0,0,"01",0,1,0,0,0,0,1037711,"2023-11-09T00:00:00.000Z",22,FALSE,1,666564,"F",1,1,"Atlanta Hawks","Bruno Fernando",0,0,0,0,0,0
0,0,0,1,0,2,1,0,0,"10",0,1,2,0,0,2,1037711,"2023-11-09T00:00:00.000Z",22,FALSE,1,38017689,"F",1,1,"Atlanta Hawks","AJ Griffin",0,2,2,2,0,0
0,0,0,0,0,0,0,0,0,"00",0,0,0,0,0,0,1037711,"2023-11-09T00:00:00.000Z",22,FALSE,1,56677855,"G",1,1,"Atlanta Hawks","Seth Lundy",0,0,0,0,0,0
0,0,0,0,0,0,0,0,0,"00",0,0,0,0,0,0,1037711,"2023-11-09T00:00:00.000Z",22,FALSE,1,666754,"G",1,1,"Atlanta Hawks","Garrison Mathews",0,0,0,0,0,0
0,0,0,1,0,1,0,0,0,"02",1,0,0,1,0,0,1037711,"2023-11-09T00:00:00.000Z",22,FALSE,1,666818,"F",22,22,"Orlando Magic","Chuma Okeke",0,1,1,0,1,1.2
0,0,0,0,0,0,0,0,0,"00",0,0,0,0,0,0,1037711,"2023-11-09T00:00:00.000Z",22,FALSE,1,666885,"F",22,22,"Orlando Magic","Admiral Schofield",0,0,0,0,0,0
0,0,6,4,2,9,5,1,1,"20",1,2,13,7,0,2,1037711,"2023-11-09T00:00:00.000Z",22,FALSE,1,462,"C",22,22,"Orlando Magic","Moritz Wagner",0,20,20,13,7,19.4
0,0,0,0,0,0,0,0,0,"00",0,0,0,0,0,0,1037711,"2023-11-09T00:00:00.000Z",22,FALSE,1,85,"F",22,22,"Orlando Magic","Wendell Carter Jr.",0,0,0,0,0,0
0,0,0,0,0,0,0,0,0,"00",0,0,0,0,0,0,1037711,"2023-11-09T00:00:00.000Z",22,FALSE,1,196,"G",22,22,"Orlando Magic","Gary Harris",0,0,0,0,0,0
0,0,0,0,0,0,0,0,0,"00",0,0,0,0,0,0,1037711,"2023-11-09T00:00:00.000Z",22,FALSE,1,38017607,"G",22,22,"Orlando Magic","Kevon Harris",0,0,0,0,0,0
0,0,0,0,0,0,0,0,0,"00",0,0,0,0,0,0,1037711,"2023-11-09T00:00:00.000Z",22,FALSE,1,17553983,"G",22,22,"Orlando Magic","Trevelin Queen",0,0,0,0,0,0
1,1,0,5,2,9,3,5,4,"26",0,4,12,0,1,2,1037711,"2023-11-09T00:00:00.000Z",22,FALSE,1,666656,"F",1,1,"Atlanta Hawks","De'Andre Hunter",2,12,13,13,1,17.5
2,1,7,4,2,9,7,4,3,"31",2,4,19,9,0,3,1037711,"2023-11-09T00:00:00.000Z",22,FALSE,1,17896040,"F",1,1,"Atlanta Hawks","Jalen Johnson",1,28,30,21,11,32.8
4,1,9,0,0,4,2,4,2,"26",2,2,6,11,0,0,1037711,"2023-11-09T00:00:00.000Z",22,FALSE,1,83,"C",1,1,"Atlanta Hawks","Clint Capela",1,17,21,10,15,28.2
2,0,3,7,3,15,6,2,1,"33",0,2,16,3,2,4,1037711,"2023-11-09T00:00:00.000Z",22,FALSE,1,334,"G",1,1,"Atlanta Hawks","Dejounte Murray",2,19,21,18,5,24.6
0,0,0,0,0,0,0,0,0,"00",0,0,0,0,0,0,1037711,"2023-11-09T00:00:00.000Z",22,FALSE,1,319,"G",1,1,"Atlanta Hawks","Patty Mills",0,0,0,0,0,0
2,4,1,1,0,4,3,2,1,"21",1,4,7,2,3,1,1037711,"2023-11-09T00:00:00.000Z",22,FALSE,1,3547244,"F-C",1,1,"Atlanta Hawks","Onyeka Okongwu",7,9,11,9,4,32.4
0,0,0,0,0,0,0,0,0,"00",0,0,0,0,0,0,1037711,"2023-11-09T00:00:00.000Z",22,FALSE,1,56677838,"G",1,1,"Atlanta Hawks","Kobe Bufkin",0,0,0,0,0,0
0,0,0,0,0,0,0,0,0,"00",0,0,0,0,0,0,1037711,"2023-11-09T00:00:00.000Z",22,FALSE,1,3547297,"G",1,1,"Atlanta Hawks","Trent Forrest",0,0,0,0,0,0
0,0,0,0,0,0,0,0,0,"00",0,0,0,0,0,0,1037711,"2023-11-09T00:00:00.000Z",22,FALSE,1,56677806,"F",1,1,"Atlanta Hawks","Mouhamed Gueye",0,0,0,0,0,0
0,0,0,0,0,0,0,0,0,"00",0,0,0,0,0,0,1037711,"2023-11-09T00:00:00.000Z",22,FALSE,1,301,"G-F",1,1,"Atlanta Hawks","Wesley Matthews",0,0,0,0,0,0
0,0,0,0,0,0,0,0,0,"00",0,0,0,0,0,0,1037711,"2023-11-09T00:00:00.000Z",22,FALSE,1,56677875,"F",1,1,"Atlanta Hawks","Miles Norris",0,0,0,0,0,0
8,0,3,15,5,27,12,13,12,"34",2,1,41,5,2,3,1037711,"2023-11-09T00:00:00.000Z",22,FALSE,1,490,"G",1,1,"Atlanta Hawks","Trae Young",2,46,54,49,13,62
3,0,4,6,3,11,6,0,0,"29",0,3,15,4,3,1,1037711,"2023-11-09T00:00:00.000Z",22,FALSE,1,53,"G",1,1,"Atlanta Hawks","Bogdan Bogdanovic",3,19,22,18,7,32.3
0,0,2,0,0,4,1,0,0,"29",1,3,2,3,1,1,1037711,"2023-11-09T00:00:00.000Z",22,FALSE,1,3547256,"F",1,1,"Atlanta Hawks","Saddiq Bey",1,5,5,2,3,7.6
1,1,1,2,1,4,3,2,2,"17",2,3,9,3,1,1,1037711,"2023-11-09T00:00:00.000Z",22,FALSE,1,56677827,"G",22,22,"Orlando Magic","Anthony Black",2,12,13,10,4,19.1
0,2,6,4,1,8,3,7,5,"16",1,1,12,7,0,0,1037711,"2023-11-09T00:00:00.000Z",22,FALSE,1,229,"F",22,22,"Orlando Magic","Jonathan Isaac",2,19,19,12,7,26.4
4,3,9,1,0,10,6,1,0,"32",3,4,12,12,1,3,3277397,"2023-11-10T00:00:00.000Z",9,FALSE,23,56677826,"G-F",9,9,"Detroit Pistons","Ausar Thompson",4,24,28,16,16,41.4
2,1,5,5,2,10,4,0,0,"32",1,5,10,6,0,3,3277397,"2023-11-10T00:00:00.000Z",9,FALSE,23,3547267,"F-C",9,9,"Detroit Pistons","Isaiah Stewart",1,16,18,12,8,20.2
3,1,3,0,0,5,2,0,0,"23",1,1,4,4,0,3,3277397,"2023-11-10T00:00:00.000Z",9,FALSE,23,38017694,"C",9,9,"Detroit Pistons","Jalen Duren",1,8,11,7,7,13.3
7,0,3,5,1,18,8,4,4,"36",1,5,21,4,0,4,3277397,"2023-11-10T00:00:00.000Z",9,FALSE,23,17896075,"G-F",9,9,"Detroit Pistons","Cade Cunningham",0,25,32,28,11,32.3
6,0,5,6,2,17,8,7,5,"39",1,1,23,6,2,2,3277397,"2023-11-10T00:00:00.000Z",9,FALSE,23,3547241,"G",9,9,"Detroit Pistons","Killian Hayes",2,29,35,29,12,43.2
1,0,3,0,0,4,3,0,0,"13",2,2,6,5,0,1,3277397,"2023-11-10T00:00:00.000Z",9,FALSE,23,24,"F",9,9,"Detroit Pistons","Marvin Bagley III",0,11,12,7,6,12.5
0,0,0,0,0,0,0,0,0,"00",0,0,0,0,0,0,3277397,"2023-11-10T00:00:00.000Z",9,FALSE,23,56677729,"G",9,9,"Detroit Pistons","Malcolm Cazalon",0,0,0,0,0,0
1,0,4,2,1,2,1,8,7,"17",0,2,10,4,0,0,3277397,"2023-11-10T00:00:00.000Z",9,FALSE,23,44477024,"G",9,9,"Detroit Pistons","Stanley Umude",0,14,15,11,5,16.3
10,1,6,7,2,19,9,9,9,"39",0,3,29,6,4,0,3277397,"2023-11-10T00:00:00.000Z",9,FALSE,23,3547254,"G",23,23,"Philadelphia 76ers","Tyrese Maxey",5,35,45,39,16,66.2
0,0,0,0,0,0,0,0,0,"00",0,0,0,0,0,0,3277397,"2023-11-10T00:00:00.000Z",9,FALSE,23,28,"C",23,23,"Philadelphia 76ers","Mo Bamba",0,0,0,0,0,0
3,0,2,2,1,2,1,0,0,"27",1,4,3,3,1,0,3277397,"2023-11-10T00:00:00.000Z",9,FALSE,23,33,"F-G",23,23,"Philadelphia 76ers","Nicolas Batum",1,6,9,6,6,14.1
1,0,0,0,0,1,0,0,0,"05",0,0,0,0,0,0,3277397,"2023-11-10T00:00:00.000Z",9,FALSE,23,45,"G",23,23,"Philadelphia 76ers","Patrick Beverley",0,0,1,1,1,1.5
0,0,0,3,1,3,1,0,0,"14",0,0,3,0,4,0,3277397,"2023-11-10T00:00:00.000Z",9,FALSE,23,108,"F",23,23,"Philadelphia 76ers","Robert Covington",4,3,3,3,0,15
0,0,0,0,0,0,0,0,0,"00",0,0,0,0,0,0,3277397,"2023-11-10T00:00:00.000Z",9,FALSE,23,2175,"",23,23,"Philadelphia 76ers","Danuel House Jr.",0,0,0,0,0,0
0,0,1,0,0,0,0,0,0,"06",0,2,0,1,0,0,3277397,"2023-11-10T00:00:00.000Z",9,FALSE,23,328,"F",23,23,"Philadelphia 76ers","Marcus Morris",0,1,1,0,1,1.2
0,0,4,0,0,2,1,0,0,"12",0,3,2,4,0,0,3277397,"2023-11-10T00:00:00.000Z",9,FALSE,23,3547270,"F",23,23,"Philadelphia 76ers","Paul Reed",0,6,6,2,4,6.8
0,0,0,0,0,0,0,0,0,"00",0,0,0,0,0,0,3277397,"2023-11-10T00:00:00.000Z",9,FALSE,23,38017682,"G",9,9,"Detroit Pistons","Jaden Ivey",0,0,0,0,0,0
0,0,0,0,0,0,0,0,0,"00",0,0,0,0,0,0,3277397,"2023-11-10T00:00:00.000Z",9,FALSE,23,259,"F",9,9,"Detroit Pistons","Kevin Knox",0,0,0,0,0,0
0,0,0,2,1,3,2,0,0,"07",0,1,5,0,0,1,3277397,"2023-11-10T00:00:00.000Z",9,FALSE,23,42097199,"G",9,9,"Detroit Pistons","Jared Rhoden",0,5,5,5,0,4
4,0,3,7,1,13,3,2,2,"35",0,4,9,3,0,0,3277397,"2023-11-10T00:00:00.000Z",9,FALSE,23,56677792,"G",9,9,"Detroit Pistons","Marcus Sasser",0,12,16,13,7,18.6
0,0,1,0,0,3,3,0,0,"06",2,1,6,3,0,0,3277397,"2023-11-10T00:00:00.000Z",9,FALSE,23,3547240,"C",9,9,"Detroit Pistons","James Wiseman",0,9,9,6,3,9.6
0,0,0,0,0,0,0,0,0,"00",0,0,0,0,0,0,3277397,"2023-11-10T00:00:00.000Z",9,FALSE,23,54,"F",9,9,"Detroit Pistons","Bojan Bogdanovic",0,0,0,0,0,0
0,0,0,0,0,0,0,0,0,"00",0,0,0,0,0,0,3277397,"2023-11-10T00:00:00.000Z",9,FALSE,23,77,"G",9,9,"Detroit Pistons","Alec Burks",0,0,0,0,0,0
0,0,0,0,0,0,0,0,0,"00",0,0,0,0,0,0,3277397,"2023-11-10T00:00:00.000Z",9,FALSE,23,197,"F-G",9,9,"Detroit Pistons","Joe Harris",0,0,0,0,0,0
0,0,0,0,0,0,0,0,0,"00",0,0,0,0,0,0,3277397,"2023-11-10T00:00:00.000Z",9,FALSE,23,17896071,"F",9,9,"Detroit Pistons","Isaiah Livers",0,0,0,0,0,0
0,0,0,0,0,0,0,0,0,"00",0,0,0,0,0,0,3277397,"2023-11-10T00:00:00.000Z",9,FALSE,23,330,"G",9,9,"Detroit Pistons","Monte Morris",0,0,0,0,0,0
1,0,6,3,0,9,3,3,2,"26",2,3,8,8,2,0,3277397,"2023-11-10T00:00:00.000Z",9,FALSE,23,360,"F",23,23,"Philadelphia 76ers","Kelly Oubre Jr.",2,16,17,9,9,25.1
2,1,4,3,2,15,8,6,6,"38",1,1,24,5,0,3,3277397,"2023-11-10T00:00:00.000Z",9,FALSE,23,200,"F",23,23,"Philadelphia 76ers","Tobias Harris",1,29,31,26,7,33
0,0,0,0,0,0,0,0,0,"00",0,0,0,0,0,0,3277397,"2023-11-10T00:00:00.000Z",9,FALSE,23,17554001,"G",23,23,"Philadelphia 76ers","Javonte Smart",0,0,0,0,0,0
0,0,0,0,0,0,0,0,0,"00",0,0,0,0,0,0,3277397,"2023-11-10T00:00:00.000Z",9,FALSE,23,56677788,"G",23,23,"Philadelphia 76ers","Terquavion Smith",0,0,0,0,0,0
3,2,9,4,1,21,8,19,16,"36",7,3,33,16,0,5,3277397,"2023-11-10T00:00:00.000Z",9,FALSE,23,145,"F-C",23,23,"Philadelphia 76ers","Joel Embiid",2,49,52,36,19,57.7
2,1,2,6,2,9,3,4,2,"30",0,3,10,2,3,0,3277397,"2023-11-10T00:00:00.000Z",9,FALSE,23,313,"G",23,23,"Philadelphia 76ers","De'Anthony Melton",4,12,14,12,4,27.4
0,0,0,0,0,1,0,0,0,"02",0,0,0,0,0,0,3277397,"2023-11-10T00:00:00.000Z",9,FALSE,23,260,"G-F",23,23,"Philadelphia 76ers","Furkan Korkmaz",0,0,0,0,0,0
0,0,0,0,0,0,0,0,0,"00",0,0,0,0,0,0,3277397,"2023-11-10T00:00:00.000Z",9,FALSE,23,3547294,"F",23,23,"Philadelphia 76ers","Kenyon Martin Jr.",0,0,0,0,0,0
0,0,0,0,0,1,1,0,0,"05",0,1,2,0,0,0,3277397,"2023-11-10T00:00:00.000Z",9,FALSE,23,17896025,"G",23,23,"Philadelphia 76ers","Jaden Springer",0,2,2,2,0,2
0,0,0,0,0,0,0,0,0,"00",0,0,0,0,0,0,3277397,"2023-11-10T00:00:00.000Z",9,FALSE,23,56913527,"G",23,23,"Philadelphia 76ers","Ricky Council IV",0,0,0,0,0,0
5,1,5,4,1,9,5,0,0,"31",1,2,11,6,1,3,3277398,"2023-11-10T00:00:00.000Z",30,FALSE,4,3547242,"F",30,30,"Washington Wizards","Deni Avdija",2,17,22,16,11,28.7
1,0,5,5,2,17,7,1,1,"29",1,1,17,6,0,3,3277398,"2023-11-10T00:00:00.000Z",30,FALSE,4,265,"F",30,30,"Washington Wizards","Kyle Kuzma",0,23,24,18,7,22.7
1,4,5,0,0,7,4,3,2,"30",4,4,10,9,2,2,3277398,"2023-11-10T00:00:00.000Z",30,FALSE,4,666577,"F",30,30,"Washington Wizards","Daniel Gafford",6,19,20,11,10,38.3
6,0,2,5,1,14,6,1,1,"31",0,4,14,2,0,3,3277398,"2023-11-10T00:00:00.000Z",30,FALSE,4,666848,"G",30,30,"Washington Wizards","Jordan Poole",0,16,22,20,8,22.4
4,1,4,4,2,12,6,3,2,"34",0,2,16,4,0,0,3277398,"2023-11-10T00:00:00.000Z",30,FALSE,4,249,"G",30,30,"Washington Wizards","Tyus Jones",1,20,24,20,8,29.8
0,0,0,0,0,0,0,0,0,"00",0,0,0,0,0,0,3277398,"2023-11-10T00:00:00.000Z",30,FALSE,4,38017704,"F",30,30,"Washington Wizards","Patrick Baldwin Jr.",0,0,0,0,0,0
1,0,2,4,2,4,2,4,4,"20",0,1,10,2,0,2,3277398,"2023-11-10T00:00:00.000Z",30,FALSE,4,56677844,"G",30,30,"Washington Wizards","Bilal Coulibaly",0,12,13,11,3,11.9
0,0,0,0,0,0,0,0,0,"00",0,0,0,0,0,0,3277398,"2023-11-10T00:00:00.000Z",30,FALSE,4,38017687,"G",30,30,"Washington Wizards","Johnny Davis",0,0,0,0,0,0
4,0,0,4,1,6,3,2,2,"18",1,1,9,1,0,1,3277398,"2023-11-10T00:00:00.000Z",30,FALSE,4,167,"F",30,30,"Washington Wizards","Danilo Gallinari",0,10,14,13,5,15.2
0,0,0,0,0,0,0,0,0,"00",0,0,0,0,0,0,3277398,"2023-11-10T00:00:00.000Z",30,FALSE,4,3547302,"F",30,30,"Washington Wizards","Anthony Gill",0,0,0,0,0,0
0,0,4,3,3,6,5,2,2,"16",0,2,15,4,0,0,3277398,"2023-11-10T00:00:00.000Z",30,FALSE,4,17896045,"F",30,30,"Washington Wizards","Corey Kispert",0,19,19,15,4,19.8
0,0,0,0,0,0,0,0,0,"00",0,0,0,0,0,0,3277398,"2023-11-10T00:00:00.000Z",30,FALSE,4,337,"F-C",30,30,"Washington Wizards","Mike Muscala",0,0,0,0,0,0
0,0,0,0,0,0,0,0,0,"00",0,0,0,0,0,0,3277398,"2023-11-10T00:00:00.000Z",30,FALSE,4,38017712,"G",30,30,"Washington Wizards","Ryan Rollins",0,0,0,0,0,0
0,0,0,7,2,10,4,1,1,"17",0,3,11,0,0,1,3277398,"2023-11-10T00:00:00.000Z",30,FALSE,4,414,"G",30,30,"Washington Wizards","Landry Shamet",0,11,11,11,0,10
6,0,2,2,0,3,1,3,2,"14",0,3,4,2,1,0,3277398,"2023-11-10T00:00:00.000Z",30,FALSE,4,487,"G",30,30,"Washington Wizards","Delon Wright",1,6,12,10,8,18.4
0,0,0,0,0,0,0,0,0,"00",0,0,0,0,0,0,3277398,"2023-11-10T00:00:00.000Z",30,FALSE,4,18677954,"G",30,30,"Washington Wizards","Jared Butler",0,0,0,0,0,0
0,0,0,0,0,0,0,0,0,"00",0,0,0,0,0,0,3277398,"2023-11-10T00:00:00.000Z",30,FALSE,4,38124126,"F",30,30,"Washington Wizards","John Butler Jr.",0,0,0,0,0,0
0,0,0,0,0,0,0,0,0,"00",0,0,0,0,0,0,3277398,"2023-11-10T00:00:00.000Z",30,FALSE,4,17896106,"F",30,30,"Washington Wizards","Eugene Omoruyi",0,0,0,0,0,0
9,1,5,4,1,20,10,8,6,"36",0,0,27,5,4,0,3277398,"2023-11-10T00:00:00.000Z",30,FALSE,4,204,"F",4,4,"Charlotte Hornets","Gordon Hayward",5,32,41,36,14,61.5
4,0,7,6,0,15,5,2,1,"38",3,0,11,10,1,2,3277398,"2023-11-10T00:00:00.000Z",30,FALSE,4,666950,"F",4,4,"Charlotte Hornets","P.J. Washington",1,21,25,15,14,30
3,0,9,0,0,18,10,2,1,"30",12,0,21,21,0,0,3277398,"2023-11-10T00:00:00.000Z",30,FALSE,4,38017698,"C",4,4,"Charlotte Hornets","Mark Williams",0,42,45,24,24,50.7
2,2,1,6,0,16,5,2,2,"31",2,5,12,3,2,1,3277398,"2023-11-10T00:00:00.000Z",30,FALSE,4,56677823,"F",4,4,"Charlotte Hornets","Brandon Miller",4,15,17,14,5,29.6
6,0,3,8,4,19,9,4,3,"38",3,5,25,6,2,2,3277398,"2023-11-10T00:00:00.000Z",30,FALSE,4,3547239,"G",4,4,"Charlotte Hornets","LaMelo Ball",2,31,37,31,12,45.2
0,0,0,0,0,0,0,0,0,"00",0,0,0,0,0,0,3277398,"2023-11-10T00:00:00.000Z",30,FALSE,4,56677848,"G",4,4,"Charlotte Hornets","Amari Bailey",0,0,0,0,0,0
0,0,0,0,0,0,0,0,0,"00",0,0,0,0,0,0,3277398,"2023-11-10T00:00:00.000Z",30,FALSE,4,56677846,"G",4,4,"Charlotte Hornets","Nick Smith Jr.",0,0,0,0,0,0
2,0,4,2,1,7,3,2,0,"20",1,1,7,5,0,0,3277398,"2023-11-10T00:00:00.000Z",30,FALSE,4,18678001,"F",4,4,"Charlotte Hornets","JT Thor",0,12,14,9,7,16
0,0,0,0,0,0,0,0,0,"00",0,0,0,0,0,0,3277398,"2023-11-10T00:00:00.000Z",30,FALSE,4,17896037,"G",4,4,"Charlotte Hornets","James Bouknight",0,0,0,0,0,0
0,0,0,0,0,0,0,0,0,"00",0,0,0,0,0,0,3277398,"2023-11-10T00:00:00.000Z",30,FALSE,4,62,"F",4,4,"Charlotte Hornets","Miles Bridges",0,0,0,0,0,0
0,0,0,0,0,0,0,0,0,"00",0,0,0,0,0,0,3277398,"2023-11-10T00:00:00.000Z",30,FALSE,4,666748,"F",4,4,"Charlotte Hornets","Cody Martin",0,0,0,0,0,0
0,0,0,0,0,0,0,0,0,"00",0,0,0,0,0,0,3277398,"2023-11-10T00:00:00.000Z",30,FALSE,4,347,"G",4,4,"Charlotte Hornets","Frank Ntilikina",0,0,0,0,0,0
0,0,0,0,0,0,0,0,0,"00",0,0,0,0,0,0,3277398,"2023-11-10T00:00:00.000Z",30,FALSE,4,56677866,"F",4,4,"Charlotte Hornets","Leaky Black",0,0,0,0,0,0
4,0,4,1,0,5,2,0,0,"16",1,1,4,5,1,2,3277398,"2023-11-10T00:00:00.000Z",30,FALSE,4,3547253,"G",4,4,"Charlotte Hornets","Theo Maledon",1,9,13,8,9,17
1,0,2,1,0,2,1,0,0,"13",1,3,2,3,0,1,3277398,"2023-11-10T00:00:00.000Z",30,FALSE,4,38017708,"G",4,4,"Charlotte Hornets","Bryce McGowens",0,5,6,3,4,6.1
0,1,4,0,0,5,5,8,5,"18",2,4,15,6,0,1,3277398,"2023-11-10T00:00:00.000Z",30,FALSE,4,3547282,"C",4,4,"Charlotte Hornets","Nick Richards",1,21,21,15,6,24.2
0,0,0,0,0,0,0,0,0,"00",0,0,0,0,0,0,3277398,"2023-11-10T00:00:00.000Z",30,FALSE,4,422,"G",4,4,"Charlotte Hornets","Ish Smith",0,0,0,0,0,0
0,0,0,0,0,0,0,0,0,"00",0,0,0,0,0,0,3277398,"2023-11-10T00:00:00.000Z",30,FALSE,4,403,"G",4,4,"Charlotte Hornets","Terry Rozier",0,0,0,0,0,0
5,0,3,9,5,19,10,5,3,"29",0,0,28,3,1,3,3277399,"2023-11-10T00:00:00.000Z",2,FALSE,3,70,"G",2,2,"Boston Celtics","Jaylen Brown",1,31,36,33,8,39.1
3,0,9,11,4,17,6,9,7,"33",1,1,23,10,0,2,3277399,"2023-11-10T00:00:00.000Z",2,FALSE,3,434,"F",2,2,"Boston Celtics","Jayson Tatum",0,33,36,26,13,37.5
2,1,2,2,0,4,2,5,5,"25",0,2,9,2,0,0,3277399,"2023-11-10T00:00:00.000Z",2,FALSE,3,378,"F-C",2,2,"Boston Celtics","Kristaps Porzingis",1,11,13,11,4,17.4
9,0,9,5,1,14,6,0,0,"33",3,2,13,12,2,0,3277399,"2023-11-10T00:00:00.000Z",2,FALSE,3,214,"G",2,2,"Boston Celtics","Jrue Holiday",2,25,34,22,21,46.9
5,1,4,5,2,10,4,2,1,"27",0,2,11,4,0,0,3277399,"2023-11-10T00:00:00.000Z",2,FALSE,3,473,"G",2,2,"Boston Celtics","Derrick White",1,15,20,16,9,26.3
0,0,2,2,0,3,0,4,2,"08",1,2,2,3,1,0,3277399,"2023-11-10T00:00:00.000Z",2,FALSE,3,666468,"F",2,2,"Boston Celtics","Oshae Brissett",1,5,5,2,3,8.6
1,0,1,10,5,10,5,0,0,"25",1,1,15,2,0,0,3277399,"2023-11-10T00:00:00.000Z",2,FALSE,3,17896060,"F",2,2,"Boston Celtics","Sam Hauser",0,17,18,16,3,18.9
1,1,3,0,0,5,3,1,1,"18",6,1,7,9,0,0,3277399,"2023-11-10T00:00:00.000Z",2,FALSE,3,261,"F-C",2,2,"Boston Celtics","Luke Kornet",1,16,17,8,10,22.3
1,0,5,6,1,11,4,3,3,"28",0,2,12,5,0,2,3277399,"2023-11-10T00:00:00.000Z",2,FALSE,3,61,"F",3,3,"Brooklyn Nets","Mikal Bridges",0,17,18,13,6,17.5
0,0,3,3,0,5,0,0,0,"19",1,0,0,4,0,1,3277399,"2023-11-10T00:00:00.000Z",2,FALSE,3,9051997,"G",3,3,"Brooklyn Nets","Armoni Brooks",0,4,4,0,4,3.8
0,0,0,0,0,0,0,0,0,"00",0,0,0,0,0,0,3277399,"2023-11-10T00:00:00.000Z",2,FALSE,3,219,"C-F",2,2,"Boston Celtics","Al Horford",0,0,0,0,0,0
0,0,0,0,0,0,0,0,0,"00",0,0,0,0,0,0,3277399,"2023-11-10T00:00:00.000Z",2,FALSE,3,3547295,"F-C",2,2,"Boston Celtics","Nathan Knight",0,0,0,0,0,0
0,0,0,0,0,0,0,0,0,"00",0,0,0,0,0,0,3277399,"2023-11-10T00:00:00.000Z",2,FALSE,3,17553967,"C",2,2,"Boston Celtics","Neemias Queta",0,0,0,0,0,0
0,0,0,0,0,0,0,0,0,"00",0,0,0,0,0,0,3277399,"2023-11-10T00:00:00.000Z",2,FALSE,3,56677864,"G",2,2,"Boston Celtics","Jordan Walsh",0,0,0,0,0,0
0,0,3,6,3,13,4,0,0,"25",2,3,11,5,0,1,3277399,"2023-11-10T00:00:00.000Z",2,FALSE,3,666679,"F",3,3,"Brooklyn Nets","Cameron Johnson",0,16,16,11,5,16
4,0,3,3,1,3,1,0,0,"27",0,3,3,3,0,1,3277399,"2023-11-10T00:00:00.000Z",2,FALSE,3,351,"F",3,3,"Brooklyn Nets","Royce O'Neale",0,6,10,7,7,11.6
2,1,1,5,3,6,3,0,0,"28",2,4,9,3,0,0,3277399,"2023-11-10T00:00:00.000Z",2,FALSE,3,158,"F",3,3,"Brooklyn Nets","Dorian Finney-Smith",1,12,14,11,5,18.6
0,0,1,1,1,3,3,0,0,"06",0,1,7,1,0,1,3277399,"2023-11-10T00:00:00.000Z",2,FALSE,3,174,"F-C",3,3,"Brooklyn Nets","Harry Giles III",0,8,8,7,1,7.2
1,0,3,1,0,4,1,4,3,"13",0,2,5,3,0,2,3277399,"2023-11-10T00:00:00.000Z",2,FALSE,3,17896038,"C",3,3,"Brooklyn Nets","Day'Ron Sharpe",0,8,9,6,4,8.1
0,0,0,0,0,0,0,0,0,"00",0,0,0,0,0,0,3277399,"2023-11-10T00:00:00.000Z",2,FALSE,3,417,"G-F",3,3,"Brooklyn Nets","Ben Simmons",0,0,0,0,0,0
7,0,3,1,0,10,5,4,4,"27",1,4,14,4,0,0,3277399,"2023-11-10T00:00:00.000Z",2,FALSE,3,421,"G",3,3,"Brooklyn Nets","Dennis Smith Jr.",0,18,25,21,11,29.3
4,1,7,4,3,12,8,1,1,"20",0,0,20,7,0,0,3277399,"2023-11-10T00:00:00.000Z",2,FALSE,3,464,"G",3,3,"Brooklyn Nets","Lonnie Walker IV",1,27,31,24,11,37.4
3,1,4,1,0,11,6,2,2,"27",3,4,14,7,0,0,3277399,"2023-11-10T00:00:00.000Z",2,FALSE,3,17896058,"F",3,3,"Brooklyn Nets","Trendon Watford",1,21,24,17,10,29.9
0,0,0,0,0,1,0,0,0,"03",1,0,0,1,0,0,3277399,"2023-11-10T00:00:00.000Z",2,FALSE,3,17896094,"G",2,2,"Boston Celtics","Dalano Banton",0,1,1,0,1,1.2
0,0,0,0,0,0,0,0,0,"00",0,0,0,0,0,0,3277399,"2023-11-10T00:00:00.000Z",2,FALSE,3,3547279,"F",2,2,"Boston Celtics","Lamar Stevens",0,0,0,0,0,0
0,0,0,0,0,0,0,0,0,"00",0,0,0,0,0,0,3277399,"2023-11-10T00:00:00.000Z",2,FALSE,3,38017707,"G",2,2,"Boston Celtics","JD Davison",0,0,0,0,0,0
4,0,4,6,3,7,3,4,3,"20",0,2,12,4,0,2,3277399,"2023-11-10T00:00:00.000Z",2,FALSE,3,130,"G",3,3,"Brooklyn Nets","Spencer Dinwiddie",0,16,20,16,8,20.8
0,0,0,0,0,0,0,0,0,"00",0,0,0,0,0,0,3277399,"2023-11-10T00:00:00.000Z",2,FALSE,3,666508,"F-C",3,3,"Brooklyn Nets","Nicolas Claxton",0,0,0,0,0,0
0,0,0,0,0,0,0,0,0,"00",0,0,0,0,0,0,3277399,"2023-11-10T00:00:00.000Z",2,FALSE,3,56677843,"F",3,3,"Brooklyn Nets","Noah Clowney",0,0,0,0,0,0
0,0,0,0,0,0,0,0,0,"00",0,0,0,0,0,0,3277399,"2023-11-10T00:00:00.000Z",2,FALSE,3,17896041,"G",3,3,"Brooklyn Nets","Keon Johnson",0,0,0,0,0,0
0,0,0,0,0,0,0,0,0,"00",0,0,0,0,0,0,3277399,"2023-11-10T00:00:00.000Z",2,FALSE,3,17896048,"G",3,3,"Brooklyn Nets","Cam Thomas",0,0,0,0,0,0
0,0,0,0,0,0,0,0,0,"00",0,0,0,0,0,0,3277399,"2023-11-10T00:00:00.000Z",2,FALSE,3,56677841,"F",3,3,"Brooklyn Nets","Dariq Whitehead",0,0,0,0,0,0
0,0,0,0,0,0,0,0,0,"00",0,0,0,0,0,0,3277399,"2023-11-10T00:00:00.000Z",2,FALSE,3,56677722,"F",3,3,"Brooklyn Nets","Jalen Wilson",0,0,0,0,0,0
3,0,1,7,2,10,5,2,1,"30",4,1,13,5,1,0,3277399,"2023-11-10T00:00:00.000Z",2,FALSE,3,3547276,"G",2,2,"Boston Celtics","Payton Pritchard",1,18,21,16,8,26.5
0,0,1,1,0,1,0,0,0,"09",0,1,0,1,0,2,3277399,"2023-11-10T00:00:00.000Z",2,FALSE,3,338,"G",2,2,"Boston Celtics","Svi Mykhailiuk",0,1,1,0,1,-0.8
2,1,2,1,1,7,3,5,3,"21",0,5,10,2,2,0,3277400,"2023-11-10T00:00:00.000Z",11,FALSE,19,66,"G-F",11,11,"Houston Rockets","Dillon Brooks",3,12,14,12,4,24.4
2,0,6,4,1,8,2,1,1,"23",1,3,6,7,0,2,3277400,"2023-11-10T00:00:00.000Z",11,FALSE,19,38017684,"F",11,11,"Houston Rockets","Jabari Smith Jr.",0,13,15,8,9,15.4
3,1,4,2,0,15,11,5,2,"34",4,3,24,8,2,4,3277400,"2023-11-10T00:00:00.000Z",11,FALSE,19,17896062,"F-C",11,11,"Houston Rockets","Alperen Sengun",3,32,35,27,11,43.1
1,0,4,8,2,18,7,10,9,"35",0,1,25,4,0,1,3277400,"2023-11-10T00:00:00.000Z",11,FALSE,19,17895966,"G",11,11,"Houston Rockets","Jalen Green",0,29,30,26,5,30.3
8,1,2,9,4,15,7,2,2,"40",1,2,20,3,1,1,3277400,"2023-11-10T00:00:00.000Z",11,FALSE,19,458,"G",11,11,"Houston Rockets","Fred VanVleet",2,23,31,28,11,40.6
0,2,7,2,0,8,1,0,0,"19",1,3,2,8,0,0,3277400,"2023-11-10T00:00:00.000Z",11,FALSE,19,38017695,"F",11,11,"Houston Rockets","Tari Eason",2,10,10,2,8,17.6
2,0,0,3,1,5,1,2,2,"14",0,0,5,0,1,0,3277400,"2023-11-10T00:00:00.000Z",11,FALSE,19,213,"G",11,11,"Houston Rockets","Aaron Holiday",1,5,7,7,2,11
0,0,2,0,0,2,0,0,0,"07",1,0,0,3,0,0,3277400,"2023-11-10T00:00:00.000Z",11,FALSE,19,19465326,"C",11,11,"Houston Rockets","Jock Landale",0,3,3,0,3,3.6
2,0,3,4,1,7,3,0,0,"24",0,4,7,3,3,0,3277400,"2023-11-10T00:00:00.000Z",11,FALSE,19,3547301,"F",11,11,"Houston Rockets","Jae'Sean Tate",3,10,12,9,5,22.6
0,0,0,0,0,0,0,0,0,"00",0,0,0,0,0,0,3277400,"2023-11-10T00:00:00.000Z",11,FALSE,19,18677986,"F",19,19,"New Orleans Pelicans","Trey Murphy III",0,0,0,0,0,0
0,0,0,0,0,0,0,0,0,"00",0,0,0,0,0,0,3277400,"2023-11-10T00:00:00.000Z",11,FALSE,19,3547260,"G",19,19,"New Orleans Pelicans","Kira Lewis Jr.",0,0,0,0,0,0
0,0,0,0,0,0,0,0,0,"00",0,0,0,0,0,0,3277400,"2023-11-10T00:00:00.000Z",11,FALSE,19,3547293,"F",19,19,"New Orleans Pelicans","Naji Marshall",0,0,0,0,0,0
1,0,4,0,0,0,0,2,1,"15",1,1,1,5,0,1,3277400,"2023-11-10T00:00:00.000Z",11,FALSE,19,340,"F",19,19,"New Orleans Pelicans","Larry Nance Jr.",0,6,7,2,6,7.5
0,0,0,1,1,2,2,0,0,"09",0,1,5,0,0,0,3277400,"2023-11-10T00:00:00.000Z",11,FALSE,19,17896021,"F",19,19,"New Orleans Pelicans","Jeremiah Robinson-Earl",0,5,5,5,0,5
0,0,2,1,0,1,0,0,0,"16",0,2,0,2,1,1,3277400,"2023-11-10T00:00:00.000Z",11,FALSE,19,17896017,"F",19,19,"New Orleans Pelicans","Matt Ryan",1,2,2,0,2,4.4
0,0,1,0,0,3,0,0,0,"12",0,0,0,1,1,0,3277400,"2023-11-10T00:00:00.000Z",11,FALSE,19,38017726,"G",19,19,"New Orleans Pelicans","Dereon Seabron",1,1,1,0,1,4.2
0,0,1,0,0,0,0,1,1,"05",0,1,1,1,1,0,3277400,"2023-11-10T00:00:00.000Z",11,FALSE,19,491,"C",19,19,"New Orleans Pelicans","Cody Zeller",1,2,2,1,1,5.2
0,0,0,0,0,0,0,0,0,"00",0,0,0,0,0,0,3277400,"2023-11-10T00:00:00.000Z",11,FALSE,19,17896097,"G",19,19,"New Orleans Pelicans","Jose Alvarado",0,0,0,0,0,0
0,0,0,0,0,0,0,0,0,"00",0,0,0,0,0,0,3277400,"2023-11-10T00:00:00.000Z",11,FALSE,19,17896024,"F",19,19,"New Orleans Pelicans","Herbert Jones",0,0,0,0,0,0
0,0,0,0,0,0,0,0,0,"00",0,0,0,0,0,0,3277400,"2023-11-10T00:00:00.000Z",11,FALSE,19,38017663,"F",19,19,"New Orleans Pelicans","E.J. Liddell",0,0,0,0,0,0
0,0,0,0,0,0,0,0,0,"00",0,0,0,0,0,0,3277400,"2023-11-10T00:00:00.000Z",11,FALSE,19,303,"G",19,19,"New Orleans Pelicans","CJ McCollum",0,0,0,0,0,0
0,0,3,2,0,3,1,3,3,"23",1,1,5,4,0,1,3277400,"2023-11-10T00:00:00.000Z",11,FALSE,19,188,"F",11,11,"Houston Rockets","Jeff Green",0,9,9,5,4,8.8
0,0,0,0,0,0,0,0,0,"00",0,0,0,0,0,0,3277400,"2023-11-10T00:00:00.000Z",11,FALSE,19,75,"G-F",11,11,"Houston Rockets","Reggie Bullock",0,0,0,0,0,0
0,0,0,0,0,0,0,0,0,"00",0,0,0,0,0,0,3277400,"2023-11-10T00:00:00.000Z",11,FALSE,19,296,"C",11,11,"Houston Rockets","Boban Marjanovic",0,0,0,0,0,0
0,0,0,0,0,0,0,0,0,"00",0,0,0,0,0,0,3277400,"2023-11-10T00:00:00.000Z",11,FALSE,19,47738533,"G",11,11,"Houston Rockets","Jeenathan Williams",0,0,0,0,0,0
0,0,0,0,0,0,0,0,0,"00",0,0,0,0,0,0,3277400,"2023-11-10T00:00:00.000Z",11,FALSE,19,3547281,"G-F",11,11,"Houston Rockets","Nate Hinton",0,0,0,0,0,0
0,0,0,0,0,0,0,0,0,"00",0,0,0,0,0,0,3277400,"2023-11-10T00:00:00.000Z",11,FALSE,19,357,"G",11,11,"Houston Rockets","Victor Oladipo",0,0,0,0,0,0
0,0,0,0,0,0,0,0,0,"00",0,0,0,0,0,0,3277400,"2023-11-10T00:00:00.000Z",11,FALSE,19,56677809,"F",11,11,"Houston Rockets","Jermaine Samuels Jr.",0,0,0,0,0,0
0,0,0,0,0,0,0,0,0,"00",0,0,0,0,0,0,3277400,"2023-11-10T00:00:00.000Z",11,FALSE,19,56677825,"G-F",11,11,"Houston Rockets","Amen Thompson",0,0,0,0,0,0
1,1,6,0,0,16,8,11,8,"34",2,5,24,8,0,5,3277400,"2023-11-10T00:00:00.000Z",11,FALSE,19,666969,"F",19,19,"New Orleans Pelicans","Zion Williamson",1,32,33,25,9,33.1
2,4,6,1,1,12,7,1,0,"29",3,6,15,9,0,2,3277400,"2023-11-10T00:00:00.000Z",11,FALSE,19,455,"C",19,19,"New Orleans Pelicans","Jonas Valanciunas",4,24,26,17,11,38.8
2,0,8,3,0,6,2,6,6,"41",2,2,10,10,1,2,3277400,"2023-11-10T00:00:00.000Z",11,FALSE,19,38017677,"G",19,19,"New Orleans Pelicans","Dyson Daniels",1,20,22,12,12,26
1,0,7,8,3,11,4,4,3,"41",0,6,14,7,2,3,3277400,"2023-11-10T00:00:00.000Z",11,FALSE,19,56677837,"G",19,19,"New Orleans Pelicans","Jordan Hawkins",2,21,22,15,8,26.9
0,0,0,0,0,0,0,0,0,"00",0,0,0,0,0,0,3277400,"2023-11-10T00:00:00.000Z",11,FALSE,19,56677831,"F",11,11,"Houston Rockets","Cam Whitmore",0,0,0,0,0,0
5,1,6,11,3,24,11,9,6,"38",0,2,31,6,0,4,3277400,"2023-11-10T00:00:00.000Z",11,FALSE,19,227,"F",19,19,"New Orleans Pelicans","Brandon Ingram",1,37,42,36,11,44.7
8,2,4,13,7,28,14,3,2,"38",0,3,37,4,1,3,3277401,"2023-11-10T00:00:00.000Z",15,FALSE,29,3547287,"G",15,15,"Memphis Grizzlies","Desmond Bane",3,41,49,45,12,59.8
2,0,2,2,0,13,7,0,0,"23",2,2,14,4,0,2,3277401,"2023-11-10T00:00:00.000Z",15,FALSE,29,231,"F-C",15,15,"Memphis Grizzlies","Jaren Jackson Jr.",0,18,20,16,6,19.8
0,0,6,0,0,10,5,6,5,"34",8,4,15,14,1,0,3277401,"2023-11-10T00:00:00.000Z",15,FALSE,29,48,"C",15,15,"Memphis Grizzlies","Bismack Biyombo",1,29,29,15,14,34.8
2,1,1,4,0,9,3,2,2,"25",0,6,8,1,0,1,3277401,"2023-11-10T00:00:00.000Z",15,FALSE,29,420,"G",15,15,"Memphis Grizzlies","Marcus Smart",1,9,11,10,3,14.2
8,0,2,9,4,10,5,0,0,"34",3,2,14,5,1,2,3277401,"2023-11-10T00:00:00.000Z",15,FALSE,29,48248287,"G",15,15,"Memphis Grizzlies","Jacob Gilyard",1,19,27,22,13,33
0,0,2,1,1,3,2,2,1,"13",0,1,6,2,0,0,3277401,"2023-11-10T00:00:00.000Z",15,FALSE,29,17896067,"F",15,15,"Memphis Grizzlies","Santi Aldama",0,8,8,6,2,8.4
1,1,1,9,4,11,5,0,0,"21",0,1,14,1,0,0,3277401,"2023-11-10T00:00:00.000Z",15,FALSE,29,254,"G",15,15,"Memphis Grizzlies","Luke Kennard",1,15,16,15,2,19.7
2,0,1,4,2,6,2,0,0,"21",0,0,6,1,2,0,3277401,"2023-11-10T00:00:00.000Z",15,FALSE,29,666703,"G-F",15,15,"Memphis Grizzlies","John Konchar",2,7,9,8,3,16.2
0,1,2,1,0,2,0,0,0,"12",0,3,0,2,0,1,3277401,"2023-11-10T00:00:00.000Z",15,FALSE,29,38017732,"F",15,15,"Memphis Grizzlies","Kenneth Lofton Jr.",1,2,2,0,2,4.4
0,0,2,5,1,9,3,0,0,"19",1,1,7,3,0,2,3277401,"2023-11-10T00:00:00.000Z",15,FALSE,29,38017729,"F",15,15,"Memphis Grizzlies","David Roddy",0,10,10,7,3,8.6
0,0,0,0,0,0,0,0,0,"00",0,0,0,0,0,0,3277401,"2023-11-10T00:00:00.000Z",15,FALSE,29,38017731,"G",15,15,"Memphis Grizzlies","Vince Williams Jr.",0,0,0,0,0,0
0,0,0,0,0,0,0,0,0,"00",0,0,0,0,0,0,3277401,"2023-11-10T00:00:00.000Z",15,FALSE,29,3,"C",15,15,"Memphis Grizzlies","Steven Adams",0,0,0,0,0,0
0,0,0,0,0,0,0,0,0,"00",0,0,0,0,0,0,3277401,"2023-11-10T00:00:00.000Z",15,FALSE,29,666505,"F",15,15,"Memphis Grizzlies","Brandon Clarke",0,0,0,0,0,0
0,0,0,0,0,0,0,0,0,"00",0,0,0,0,0,0,3277401,"2023-11-10T00:00:00.000Z",15,FALSE,29,56677830,"F",15,15,"Memphis Grizzlies","GG Jackson",0,0,0,0,0,0
0,0,0,0,0,0,0,0,0,"00",0,0,0,0,0,0,3277401,"2023-11-10T00:00:00.000Z",15,FALSE,29,38017728,"F",15,15,"Memphis Grizzlies","Jake LaRavia",0,0,0,0,0,0
0,0,0,0,0,0,0,0,0,"00",0,0,0,0,0,0,3277401,"2023-11-10T00:00:00.000Z",15,FALSE,29,666786,"G",15,15,"Memphis Grizzlies","Ja Morant",0,0,0,0,0,0
0,0,0,0,0,0,0,0,0,"00",0,0,0,0,0,0,3277401,"2023-11-10T00:00:00.000Z",15,FALSE,29,401,"G",15,15,"Memphis Grizzlies","Derrick Rose",0,0,0,0,0,0
0,0,0,0,0,0,0,0,0,"00",0,0,0,0,0,0,3277401,"2023-11-10T00:00:00.000Z",15,FALSE,29,3547285,"F",15,15,"Memphis Grizzlies","Xavier Tillman",0,0,0,0,0,0
0,0,0,0,0,0,0,0,0,"00",0,0,0,0,0,0,3277401,"2023-11-10T00:00:00.000Z",15,FALSE,29,17896027,"G-F",15,15,"Memphis Grizzlies","Ziaire Williams",0,0,0,0,0,0
1,2,5,5,3,8,6,0,0,"30",1,3,15,6,1,1,3277401,"2023-11-10T00:00:00.000Z",15,FALSE,29,38017620,"G",29,29,"Utah Jazz","Ochai Agbaji",3,21,22,16,7,31.7
0,4,3,3,3,6,5,7,5,"38",0,2,18,3,0,3,3277401,"2023-11-10T00:00:00.000Z",15,FALSE,29,101,"F-C",29,29,"Utah Jazz","John Collins",4,21,21,18,3,30.6
1,2,7,9,4,13,8,6,6,"37",0,3,26,7,2,3,3277401,"2023-11-10T00:00:00.000Z",15,FALSE,29,297,"F",29,29,"Utah Jazz","Lauri Markkanen",4,33,34,27,8,44.9
11,1,3,6,1,12,2,2,2,"30",0,1,7,3,0,2,3277401,"2023-11-10T00:00:00.000Z",15,FALSE,29,56677834,"G",29,29,"Utah Jazz","Keyonte George",1,10,21,18,14,28.1
4,1,2,5,2,16,9,6,6,"36",2,1,26,4,2,3,3277401,"2023-11-10T00:00:00.000Z",15,FALSE,29,100,"G",29,29,"Utah Jazz","Jordan Clarkson",3,30,34,30,8,42.8
1,0,1,2,2,3,2,0,0,"12",1,2,6,2,2,1,3277401,"2023-11-10T00:00:00.000Z",15,FALSE,29,38017739,"F",29,29,"Utah Jazz","Simone Fontecchio",2,8,9,7,3,14.9
2,1,2,5,3,7,4,2,2,"18",1,2,13,3,1,1,3277401,"2023-11-10T00:00:00.000Z",15,FALSE,29,666650,"G",29,29,"Utah Jazz","Talen Horton-Tucker",2,16,18,15,5,24.6
2,1,6,0,0,3,2,2,2,"21",2,3,6,8,1,2,3277401,"2023-11-10T00:00:00.000Z",15,FALSE,29,358,"F",29,29,"Utah Jazz","Kelly Olynyk",2,14,16,8,10,22.6
6,0,1,2,0,8,3,4,4,"18",1,0,10,2,1,3,3277401,"2023-11-10T00:00:00.000Z",15,FALSE,29,413,"G",29,29,"Utah Jazz","Collin Sexton",1,12,18,16,8,21.4
0,0,0,0,0,0,0,0,0,"00",0,0,0,0,0,0,3277401,"2023-11-10T00:00:00.000Z",15,FALSE,29,139,"G",29,29,"Utah Jazz","Kris Dunn",0,0,0,0,0,0
0,0,0,0,0,0,0,0,0,"00",0,0,0,0,0,0,3277401,"2023-11-10T00:00:00.000Z",15,FALSE,29,666881,"F",29,29,"Utah Jazz","Luka Samanic",0,0,0,0,0,0
0,0,0,0,0,0,0,0,0,"00",0,0,0,0,0,0,3277401,"2023-11-10T00:00:00.000Z",15,FALSE,29,11891374,"C",29,29,"Utah Jazz","Omer Yurtseven",0,0,0,0,0,0
0,0,0,0,0,0,0,0,0,"00",0,0,0,0,0,0,3277401,"2023-11-10T00:00:00.000Z",15,FALSE,29,17896023,"G",29,29,"Utah Jazz","Josh Christopher",0,0,0,0,0,0
0,0,0,0,0,0,0,0,0,"00",0,0,0,0,0,0,3277401,"2023-11-10T00:00:00.000Z",15,FALSE,29,56677824,"F",29,29,"Utah Jazz","Taylor Hendricks",0,0,0,0,0,0
0,0,0,0,0,0,0,0,0,"00",0,0,0,0,0,0,3277401,"2023-11-10T00:00:00.000Z",15,FALSE,29,38017630,"G",29,29,"Utah Jazz","Johnny Juzang",0,0,0,0,0,0
0,0,0,0,0,0,0,0,0,"00",0,0,0,0,0,0,3277401,"2023-11-10T00:00:00.000Z",15,FALSE,29,38017705,"C",29,29,"Utah Jazz","Walker Kessler",0,0,0,0,0,0
0,0,0,0,0,0,0,0,0,"00",0,0,0,0,0,0,3277401,"2023-11-10T00:00:00.000Z",15,FALSE,29,19465584,"F",29,29,"Utah Jazz","Micah Potter",0,0,0,0,0,0
0,0,0,0,0,0,0,0,0,"00",0,0,0,0,0,0,3277401,"2023-11-10T00:00:00.000Z",15,FALSE,29,56677842,"F",29,29,"Utah Jazz","Brice Sensabaugh",0,0,0,0,0,0
1,0,5,3,0,10,2,4,2,"33",0,2,6,5,0,1,3277402,"2023-11-10T00:00:00.000Z",27,FALSE,18,666682,"F",27,27,"San Antonio Spurs","Keldon Johnson",0,11,12,7,6,12.5
4,4,8,7,3,21,12,4,2,"35",1,5,29,9,1,3,3277402,"2023-11-10T00:00:00.000Z",27,FALSE,18,56677822,"F-C",27,27,"San Antonio Spurs","Victor Wembanyama",5,38,42,33,13,57.8
5,1,1,2,1,6,5,0,0,"24",1,5,11,2,0,1,3277402,"2023-11-10T00:00:00.000Z",27,FALSE,18,102,"F-C",27,27,"San Antonio Spurs","Zach Collins",1,13,18,16,7,22.9
4,0,3,11,6,16,8,9,7,"35",0,1,29,3,1,1,3277402,"2023-11-10T00:00:00.000Z",27,FALSE,18,3547246,"G-F",27,27,"San Antonio Spurs","Devin Vassell",1,32,36,33,7,40.6
5,0,4,1,1,11,6,2,1,"30",3,3,14,7,3,6,3277402,"2023-11-10T00:00:00.000Z",27,FALSE,18,38017699,"F",27,27,"San Antonio Spurs","Jeremy Sochan",3,21,26,19,12,32.9
0,0,0,0,0,0,0,0,0,"00",0,0,0,0,0,0,3277402,"2023-11-10T00:00:00.000Z",27,FALSE,18,38017730,"F",27,27,"San Antonio Spurs","Dominick Barlow",0,0,0,0,0,0
2,2,4,1,0,3,1,0,0,"11",2,1,2,6,0,0,3277402,"2023-11-10T00:00:00.000Z",27,FALSE,18,17895854,"G",27,27,"San Antonio Spurs","Charles Bassey",2,8,10,4,8,18.2
1,0,2,4,0,11,3,0,0,"16",0,0,6,2,2,0,3277402,"2023-11-10T00:00:00.000Z",27,FALSE,18,38017692,"F",27,27,"San Antonio Spurs","Malaki Branham",2,8,9,7,3,15.9
1,0,0,3,1,4,1,0,0,"14",0,2,3,0,0,0,3277402,"2023-11-10T00:00:00.000Z",27,FALSE,18,305,"F",27,27,"San Antonio Spurs","Doug McDermott",0,3,4,4,1,4.5
2,0,0,1,0,2,1,0,0,"16",0,1,2,0,1,0,3277402,"2023-11-10T00:00:00.000Z",27,FALSE,18,359,"F",27,27,"San Antonio Spurs","Cedi Osman",1,2,4,4,2,8
0,0,0,0,0,0,0,0,0,"00",0,0,0,0,0,0,3277402,"2023-11-10T00:00:00.000Z",27,FALSE,18,38017693,"G",27,27,"San Antonio Spurs","Blake Wesley",0,0,0,0,0,0
0,0,0,0,0,0,0,0,0,"00",0,0,0,0,0,0,3277402,"2023-11-10T00:00:00.000Z",27,FALSE,18,56677865,"C",27,27,"San Antonio Spurs","Charles Bediako",0,0,0,0,0,0
0,0,0,0,0,0,0,0,0,"00",0,0,0,0,0,0,3277402,"2023-11-10T00:00:00.000Z",27,FALSE,18,56677817,"G",27,27,"San Antonio Spurs","Sidy Cissoko",0,0,0,0,0,0
0,0,0,0,0,0,0,0,0,"00",0,0,0,0,0,0,3277402,"2023-11-10T00:00:00.000Z",27,FALSE,18,56677870,"G",27,27,"San Antonio Spurs","Sir'Jabari Rice",0,0,0,0,0,0
0,0,0,0,0,0,0,0,0,"00",0,0,0,0,0,0,3277402,"2023-11-10T00:00:00.000Z",27,FALSE,18,38017649,"F",27,27,"San Antonio Spurs","Julian Champagnie",0,0,0,0,0,0
0,0,0,0,0,0,0,0,0,"00",0,0,0,0,0,0,3277402,"2023-11-10T00:00:00.000Z",27,FALSE,18,180,"G",27,27,"San Antonio Spurs","Devonte' Graham",0,0,0,0,0,0
4,1,4,1,0,8,4,0,0,"26",0,1,8,4,1,2,3277402,"2023-11-10T00:00:00.000Z",27,FALSE,18,3547274,"G",27,27,"San Antonio Spurs","Tre Jones",2,12,16,12,8,22.8
0,0,0,0,0,0,0,0,0,"00",0,0,0,0,0,0,3277402,"2023-11-10T00:00:00.000Z",27,FALSE,18,17896059,"F",27,27,"San Antonio Spurs","Sandro Mamukelashvili",0,0,0,0,0,0
0,0,3,2,0,11,5,0,0,"26",2,6,10,5,2,0,3277402,"2023-11-10T00:00:00.000Z",27,FALSE,18,3547259,"F",18,18,"Minnesota Timberwolves","Jaden McDaniels",2,15,15,10,5,22
2,0,11,7,3,21,11,4,4,"34",1,1,29,12,0,3,3277402,"2023-11-10T00:00:00.000Z",27,FALSE,18,447,"C",18,18,"Minnesota Timberwolves","Karl-Anthony Towns",0,41,43,31,14,43.4
1,0,6,0,0,10,5,1,1,"34",4,3,11,10,1,1,3277402,"2023-11-10T00:00:00.000Z",27,FALSE,18,176,"C",18,18,"Minnesota Timberwolves","Rudy Gobert",1,21,22,12,11,26.5
5,1,5,8,2,21,9,11,8,"37",2,1,28,7,2,4,3277402,"2023-11-10T00:00:00.000Z",27,FALSE,18,3547238,"G",18,18,"Minnesota Timberwolves","Anthony Edwards",3,35,40,33,12,48.9
6,0,1,3,1,7,3,4,4,"31",2,3,11,3,0,4,3277402,"2023-11-10T00:00:00.000Z",27,FALSE,18,104,"G",18,18,"Minnesota Timberwolves","Mike Conley",0,14,20,17,9,19.6
4,1,3,1,1,4,3,2,2,"19",0,0,9,3,0,0,3277402,"2023-11-10T00:00:00.000Z",27,FALSE,18,666400,"G",18,18,"Minnesota Timberwolves","Nickeil Alexander-Walker",1,12,16,13,7,21.6
4,0,5,0,0,2,2,4,2,"26",0,1,6,5,1,4,3277402,"2023-11-10T00:00:00.000Z",27,FALSE,18,12,"F",18,18,"Minnesota Timberwolves","Kyle Anderson",1,11,15,10,9,17
0,0,0,0,0,0,0,0,0,"00",0,0,0,0,0,0,3277402,"2023-11-10T00:00:00.000Z",27,FALSE,18,68,"F",18,18,"Minnesota Timberwolves","Troy Brown Jr.",0,0,0,0,0,0
1,0,2,3,2,4,2,1,0,"15",1,3,6,3,0,2,3277402,"2023-11-10T00:00:00.000Z",27,FALSE,18,320,"G",18,18,"Minnesota Timberwolves","Shake Milton",0,9,10,7,4,9.1
0,0,0,0,0,0,0,0,0,"00",0,0,0,0,0,0,3277402,"2023-11-10T00:00:00.000Z",27,FALSE,18,38017715,"F",18,18,"Minnesota Timberwolves","Josh Minott",0,0,0,0,0,0
0,0,0,0,0,0,0,0,0,"00",0,0,0,0,0,0,3277402,"2023-11-10T00:00:00.000Z",27,FALSE,18,17895968,"F",18,18,"Minnesota Timberwolves","Daishen Nix",0,0,0,0,0,0
0,2,2,3,1,7,3,0,0,"18",1,1,7,3,0,0,3277402,"2023-11-10T00:00:00.000Z",27,FALSE,18,667378,"F-C",18,18,"Minnesota Timberwolves","Naz Reid",2,10,10,7,3,16.6
0,0,0,0,0,0,0,0,0,"00",0,0,0,0,0,0,3277402,"2023-11-10T00:00:00.000Z",27,FALSE,18,56677851,"G",18,18,"Minnesota Timberwolves","Jaylen Clark",0,0,0,0,0,0
0,0,0,0,0,0,0,0,0,"00",0,0,0,0,0,0,3277402,"2023-11-10T00:00:00.000Z",27,FALSE,18,17896056,"C",18,18,"Minnesota Timberwolves","Luka Garza",0,0,0,0,0,0
0,0,0,0,0,0,0,0,0,"00",0,0,0,0,0,0,3277402,"2023-11-10T00:00:00.000Z",27,FALSE,18,666767,"G",18,18,"Minnesota Timberwolves","Jordan McLaughlin",0,0,0,0,0,0
0,0,0,0,0,0,0,0,0,"00",0,0,0,0,0,0,3277402,"2023-11-10T00:00:00.000Z",27,FALSE,18,56677782,"F",18,18,"Minnesota Timberwolves","Leonard Miller",0,0,0,0,0,0
0,0,0,0,0,0,0,0,0,"00",0,0,0,0,0,0,3277402,"2023-11-10T00:00:00.000Z",27,FALSE,18,38017700,"G",18,18,"Minnesota Timberwolves","Wendell Moore Jr.",0,0,0,0,0,0
3,0,6,4,1,10,4,2,2,"29",4,1,11,10,3,0,3277403,"2023-11-10T00:00:00.000Z",7,FALSE,13,247,"F-G",7,7,"Dallas Mavericks","Derrick Jones Jr.",3,21,24,14,13,36.5
1,0,2,1,0,2,1,0,0,"16",0,4,2,2,0,1,3277403,"2023-11-10T00:00:00.000Z",7,FALSE,13,666965,"F",7,7,"Dallas Mavericks","Grant Williams",0,4,5,3,3,4.9
1,1,2,0,0,8,3,0,0,"26",2,6,6,4,0,1,3277403,"2023-11-10T00:00:00.000Z",7,FALSE,13,56677840,"C",7,7,"Dallas Mavericks","Dereck Lively II",1,10,11,7,5,14.3
3,0,3,9,5,19,8,6,6,"28",3,1,27,6,2,2,3277403,"2023-11-10T00:00:00.000Z",7,FALSE,13,228,"G",7,7,"Dallas Mavericks","Kyrie Irving",2,33,36,30,9,42.7
6,0,6,9,6,21,17,4,4,"32",0,1,44,6,1,1,3277403,"2023-11-10T00:00:00.000Z",7,FALSE,13,132,"F-G",7,7,"Dallas Mavericks","Luka Doncic",1,50,56,50,12,62.2
0,0,0,2,1,2,1,3,2,"07",0,0,5,0,0,0,3277403,"2023-11-10T00:00:00.000Z",7,FALSE,13,114,"G",7,7,"Dallas Mavericks","Seth Curry",0,5,5,5,0,5
6,0,1,3,2,7,3,0,0,"18",1,3,8,2,0,0,3277403,"2023-11-10T00:00:00.000Z",7,FALSE,13,151,"G",7,7,"Dallas Mavericks","Dante Exum",0,10,16,14,8,19.4
3,0,0,4,1,4,1,0,0,"18",0,2,3,0,0,0,3277403,"2023-11-10T00:00:00.000Z",7,FALSE,13,3547258,"G",7,7,"Dallas Mavericks","Josh Green",0,3,6,6,3,7.5
3,0,3,8,2,13,6,3,3,"27",0,0,17,3,0,0,3277403,"2023-11-10T00:00:00.000Z",7,FALSE,13,191,"G",7,7,"Dallas Mavericks","Tim Hardaway Jr.",0,20,23,20,6,25.1
0,0,2,2,1,8,5,1,0,"12",0,1,11,2,0,2,3277403,"2023-11-10T00:00:00.000Z",7,FALSE,13,38017679,"G",7,7,"Dallas Mavericks","Jaden Hardy",0,13,13,11,2,11.4
0,0,0,0,0,0,0,0,0,"00",0,0,0,0,0,0,3277403,"2023-11-10T00:00:00.000Z",7,FALSE,13,217,"F-C",7,7,"Dallas Mavericks","Richaun Holmes",0,0,0,0,0,0
0,0,0,0,0,0,0,0,0,"00",0,0,0,0,0,0,3277403,"2023-11-10T00:00:00.000Z",7,FALSE,13,329,"F",7,7,"Dallas Mavericks","Markieff Morris",0,0,0,0,0,0
4,0,1,0,0,3,2,5,5,"22",4,3,9,5,1,1,3277403,"2023-11-10T00:00:00.000Z",7,FALSE,13,379,"F-C",7,7,"Dallas Mavericks","Dwight Powell",1,14,18,13,9,23
0,0,0,0,0,1,0,2,1,"05",1,1,1,1,0,0,3277403,"2023-11-10T00:00:00.000Z",7,FALSE,13,56677859,"F",7,7,"Dallas Mavericks","Olivier-Maxence Prosper",0,2,2,1,1,2.2
0,0,0,0,0,0,0,0,0,"00",0,0,0,0,0,0,3277403,"2023-11-10T00:00:00.000Z",7,FALSE,13,17896028,"F",7,7,"Dallas Mavericks","Greg Brown III",0,0,0,0,0,0
0,0,0,0,0,0,0,0,0,"00",0,0,0,0,0,0,3277403,"2023-11-10T00:00:00.000Z",7,FALSE,13,56677873,"G",7,7,"Dallas Mavericks","Dexter Dennis",0,0,0,0,0,0
0,0,0,0,0,0,0,0,0,"00",0,0,0,0,0,0,3277403,"2023-11-10T00:00:00.000Z",7,FALSE,13,257,"F",7,7,"Dallas Mavericks","Maxi Kleber",0,0,0,0,0,0
0,0,0,0,0,0,0,0,0,"00",0,0,0,0,0,0,3277403,"2023-11-10T00:00:00.000Z",7,FALSE,13,17554004,"G",7,7,"Dallas Mavericks","AJ Lawson",0,0,0,0,0,0
2,0,3,7,1,12,3,1,1,"23",0,3,8,3,1,2,3277403,"2023-11-10T00:00:00.000Z",7,FALSE,13,172,"F",13,13,"LA Clippers","Paul George",1,11,13,10,5,15.6
4,0,2,4,2,15,8,8,8,"29",1,2,26,3,0,2,3277403,"2023-11-10T00:00:00.000Z",7,FALSE,13,274,"F",13,13,"LA Clippers","Kawhi Leonard",0,29,33,30,7,33.6
1,2,3,0,0,9,5,4,2,"22",5,3,12,8,0,1,3277403,"2023-11-10T00:00:00.000Z",7,FALSE,13,493,"C",13,13,"LA Clippers","Ivica Zubac",2,20,21,13,9,28.1
0,0,0,0,0,0,0,0,0,"00",0,0,0,0,0,0,3277403,"2023-11-10T00:00:00.000Z",7,FALSE,13,17896051,"G",13,13,"LA Clippers","Joshua Primo",0,0,0,0,0,0
3,0,5,3,2,6,3,6,6,"29",0,0,14,5,2,2,3277403,"2023-11-10T00:00:00.000Z",7,FALSE,13,192,"G",13,13,"LA Clippers","James Harden",2,19,22,17,8,28.5
2,0,3,1,0,11,5,5,4,"20",2,1,14,5,3,2,3277403,"2023-11-10T00:00:00.000Z",7,FALSE,13,472,"G",13,13,"LA Clippers","Russell Westbrook",3,19,21,16,7,30
6,0,3,5,1,9,5,6,6,"29",1,5,17,4,1,2,3277403,"2023-11-10T00:00:00.000Z",7,FALSE,13,17896031,"G",13,13,"LA Clippers","Nah'Shon Hyland",1,21,27,23,10,31.8
3,0,3,3,1,8,5,0,0,"29",3,4,11,6,0,0,3277403,"2023-11-10T00:00:00.000Z",7,FALSE,13,666743,"G",13,13,"LA Clippers","Terance Mann",0,17,20,14,9,22.7
0,0,1,1,0,1,0,0,0,"06",0,2,0,1,0,0,3277403,"2023-11-10T00:00:00.000Z",7,FALSE,13,450,"F",13,13,"LA Clippers","PJ Tucker",0,1,1,0,1,1.2
0,0,0,0,0,1,0,0,0,"11",0,1,0,0,0,2,3277403,"2023-11-10T00:00:00.000Z",7,FALSE,13,380,"F-G",13,13,"LA Clippers","Norman Powell",0,0,0,0,0,-2
0,1,3,0,0,6,4,4,3,"16",7,3,11,10,0,0,3277403,"2023-11-10T00:00:00.000Z",7,FALSE,13,38017725,"F",13,13,"LA Clippers","Moussa Diabate",1,21,21,11,10,26
0,0,0,1,1,4,3,0,0,"13",0,2,7,0,0,1,3277403,"2023-11-10T00:00:00.000Z",7,FALSE,13,56677849,"F",13,13,"LA Clippers","Kobe Brown",0,7,7,7,0,6
0,0,2,2,0,6,2,2,2,"13",0,1,6,2,0,0,3277403,"2023-11-10T00:00:00.000Z",7,FALSE,13,666511,"G",13,13,"LA Clippers","Amir Coffey",0,8,8,6,2,8.4
0,0,0,0,0,0,0,0,0,"00",0,0,0,0,0,0,3277403,"2023-11-10T00:00:00.000Z",7,FALSE,13,17896022,"G",13,13,"LA Clippers","Brandon Boston Jr.",0,0,0,0,0,0
0,0,0,0,0,0,0,0,0,"00",0,0,0,0,0,0,3277403,"2023-11-10T00:00:00.000Z",7,FALSE,13,56677856,"G",13,13,"LA Clippers","Jordan Miller",0,0,0,0,0,0
0,0,0,0,0,0,0,0,0,"00",0,0,0,0,0,0,3277403,"2023-11-10T00:00:00.000Z",7,FALSE,13,371,"F-C",13,13,"LA Clippers","Mason Plumlee",0,0,0,0,0,0
4,1,7,0,0,14,5,8,8,"36",4,3,18,11,0,1,3277404,"2023-11-10T00:00:00.000Z",24,FALSE,14,117,"F-C",14,14,"Los Angeles Lakers","Anthony Davis",1,29,33,22,15,39.2
0,2,1,4,0,8,3,2,1,"33",0,4,7,1,0,0,3277404,"2023-11-10T00:00:00.000Z",24,FALSE,14,383,"F",14,14,"Los Angeles Lakers","Taurean Prince",2,8,8,7,1,14.2
9,1,3,3,0,12,6,9,7,"29",0,4,19,3,0,1,3277404,"2023-11-10T00:00:00.000Z",24,FALSE,14,405,"G",14,14,"Los Angeles Lakers","D'Angelo Russell",1,22,31,28,12,38.1
0,0,0,0,0,0,0,0,0,"00",0,0,0,0,0,0,3277404,"2023-11-10T00:00:00.000Z",24,FALSE,14,38017697,"G",14,14,"Los Angeles Lakers","Max Christie",0,0,0,0,0,0
1,1,3,3,1,6,3,1,0,"20",0,3,7,3,4,1,3277404,"2023-11-10T00:00:00.000Z",24,FALSE,14,666609,"F",14,14,"Los Angeles Lakers","Rui Hachimura",5,10,11,8,4,26.1
0,0,1,0,0,1,1,0,0,"05",0,1,2,1,0,1,3277404,"2023-11-10T00:00:00.000Z",24,FALSE,14,666626,"C",14,14,"Los Angeles Lakers","Jaxson Hayes",0,3,3,2,1,2.2
0,0,0,0,0,0,0,0,0,"00",0,0,0,0,0,0,3277404,"2023-11-10T00:00:00.000Z",24,FALSE,14,56677835,"G",14,14,"Los Angeles Lakers","Jalen Hood-Schifino",0,0,0,0,0,0
0,0,0,0,0,0,0,0,0,"00",0,0,0,0,0,0,3277404,"2023-11-10T00:00:00.000Z",24,FALSE,14,56677836,"F",14,14,"Los Angeles Lakers","Maxwell Lewis",0,0,0,0,0,0
7,0,1,4,2,11,6,1,1,"35",0,1,15,1,1,2,3277404,"2023-11-10T00:00:00.000Z",24,FALSE,14,17553995,"G",14,14,"Los Angeles Lakers","Austin Reaves",1,16,23,22,8,27.7
0,1,6,1,1,5,2,0,0,"18",3,0,5,9,0,1,3277404,"2023-11-10T00:00:00.000Z",24,FALSE,14,486,"F",14,14,"Los Angeles Lakers","Christian Wood",1,14,14,5,9,17.8
0,0,0,0,0,0,0,0,0,"00",0,0,0,0,0,0,3277404,"2023-11-10T00:00:00.000Z",24,FALSE,14,56677738,"C",14,14,"Los Angeles Lakers","Colin Castleton",0,0,0,0,0,0
5,0,8,6,4,27,13,10,8,"38",1,4,38,9,0,4,3277404,"2023-11-10T00:00:00.000Z",24,FALSE,14,140,"F",24,24,"Phoenix Suns","Kevin Durant",0,47,52,43,14,52.3
0,0,3,6,1,11,4,2,2,"30",2,0,11,5,2,0,3277404,"2023-11-10T00:00:00.000Z",24,FALSE,14,32,"F",24,24,"Phoenix Suns","Keita Bates-Diop",2,16,16,11,5,23
7,0,6,3,2,8,4,7,4,"33",3,3,14,9,1,2,3277404,"2023-11-10T00:00:00.000Z",24,FALSE,14,349,"C",24,24,"Phoenix Suns","Jusuf Nurkic",1,23,30,21,16,36.3
4,0,7,4,1,8,4,0,0,"32",2,6,9,9,1,2,3277404,"2023-11-10T00:00:00.000Z",24,FALSE,14,8,"G",24,24,"Phoenix Suns","Grayson Allen",1,18,22,13,13,26.8
2,0,2,4,2,17,9,6,4,"31",2,4,24,4,2,2,3277404,"2023-11-10T00:00:00.000Z",24,FALSE,14,37,"G",24,24,"Phoenix Suns","Bradley Beal",2,28,30,26,6,35.8
0,0,0,0,0,0,0,0,0,"00",0,0,0,0,0,0,3277404,"2023-11-10T00:00:00.000Z",24,FALSE,14,3547095,"C-F",24,24,"Phoenix Suns","Udoka Azubuike",0,0,0,0,0,0
0,0,0,0,0,0,0,0,0,"00",0,0,0,0,0,0,3277404,"2023-11-10T00:00:00.000Z",24,FALSE,14,666451,"C",24,24,"Phoenix Suns","Bol Bol",0,0,0,0,0,0
1,1,3,0,0,3,1,0,0,"14",2,2,2,5,0,2,3277404,"2023-11-10T00:00:00.000Z",24,FALSE,14,147,"F",24,24,"Phoenix Suns","Drew Eubanks",1,7,8,3,6,10.5
2,0,1,4,3,9,5,0,0,"28",1,0,13,2,3,1,3277404,"2023-11-10T00:00:00.000Z",24,FALSE,14,178,"G",24,24,"Phoenix Suns","Eric Gordon",3,15,17,15,4,26.4
0,0,0,0,0,0,0,0,0,"00",0,0,0,0,0,0,3277404,"2023-11-10T00:00:00.000Z",24,FALSE,14,3547298,"G",24,24,"Phoenix Suns","Saben Lee",0,0,0,0,0,0
0,0,0,0,0,0,0,0,0,"00",0,0,0,0,0,0,3277404,"2023-11-10T00:00:00.000Z",24,FALSE,14,666729,"F",24,24,"Phoenix Suns","Nassir Little",0,0,0,0,0,0
0,0,0,0,0,0,0,0,0,"00",0,0,0,0,0,0,3277404,"2023-11-10T00:00:00.000Z",24,FALSE,14,314,"F",24,24,"Phoenix Suns","Chimezie Metu",0,0,0,0,0,0
1,0,4,4,0,4,0,2,2,"13",2,0,2,6,0,0,3277404,"2023-11-10T00:00:00.000Z",24,FALSE,14,356,"G",24,24,"Phoenix Suns","Josh Okogie",0,8,9,3,7,10.7
0,0,0,3,1,4,1,0,0,"14",1,5,3,1,0,0,3277404,"2023-11-10T00:00:00.000Z",24,FALSE,14,470,"G",24,24,"Phoenix Suns","Yuta Watanabe",0,4,4,3,1,4.2
0,0,0,0,0,0,0,0,0,"00",0,0,0,0,0,0,3277404,"2023-11-10T00:00:00.000Z",24,FALSE,14,57,"G",24,24,"Phoenix Suns","Devin Booker",0,0,0,0,0,0
0,0,0,0,0,0,0,0,0,"00",0,0,0,0,0,0,3277404,"2023-11-10T00:00:00.000Z",24,FALSE,14,272,"G",24,24,"Phoenix Suns","Damion Lee",0,0,0,0,0,0
0,0,2,8,5,10,5,2,2,"28",1,3,17,3,3,0,3277404,"2023-11-10T00:00:00.000Z",24,FALSE,14,666860,"F-G",14,14,"Los Angeles Lakers","Cameron Reddish",3,20,20,17,3,29.6
6,1,10,4,3,17,11,11,7,"36",1,1,32,11,1,4,3277404,"2023-11-10T00:00:00.000Z",24,FALSE,14,237,"F",14,14,"Los Angeles Lakers","LeBron James",2,43,49,38,17,56.2
0,0,1,3,1,3,1,0,0,"07",1,0,3,2,0,0,3277404,"2023-11-10T00:00:00.000Z",24,FALSE,14,18678058,"",24,24,"Phoenix Suns","Jordan Goodwin",0,5,5,3,2,5.4
0,0,0,0,0,0,0,0,0,"00",0,0,0,0,0,0,3277404,"2023-11-10T00:00:00.000Z",24,FALSE,14,56677867,"F",14,14,"Los Angeles Lakers","Alex Fudge",0,0,0,0,0,0
0,0,0,0,0,0,0,0,0,"00",0,0,0,0,0,0,3277404,"2023-11-10T00:00:00.000Z",24,FALSE,14,56677868,"G",14,14,"Los Angeles Lakers","D'Moi Hodge",0,0,0,0,0,0
0,0,0,0,0,0,0,0,0,"00",0,0,0,0,0,0,3277404,"2023-11-10T00:00:00.000Z",24,FALSE,14,457,"F",14,14,"Los Angeles Lakers","Jarred Vanderbilt",0,0,0,0,0,0
0,0,0,0,0,0,0,0,0,"00",0,0,0,0,0,0,3277404,"2023-11-10T00:00:00.000Z",24,FALSE,14,1603383,"G",14,14,"Los Angeles Lakers","Gabe Vincent",0,0,0,0,0,0
6,2,7,2,0,25,14,6,5,"38",0,1,33,7,2,2,3277405,"2023-11-10T00:00:00.000Z",26,FALSE,21,175,"G",21,21,"Oklahoma City Thunder","Shai Gilgeous-Alexander",4,40,46,39,13,60.4
5,0,3,1,0,10,6,1,1,"27",1,1,13,4,0,4,3277405,"2023-11-10T00:00:00.000Z",26,FALSE,21,17896065,"G",21,21,"Oklahoma City Thunder","Josh Giddey",0,17,22,18,9,21.3
0,0,0,0,0,0,0,0,0,"00",0,0,0,0,0,0,3277405,"2023-11-10T00:00:00.000Z",26,FALSE,21,17896036,"G",21,21,"Oklahoma City Thunder","Tre Mann",0,0,0,0,0,0
0,0,0,0,0,0,0,0,0,"00",0,0,0,0,0,0,3277405,"2023-11-10T00:00:00.000Z",26,FALSE,21,4197029,"G",21,21,"Oklahoma City Thunder","Vasilije Micic",0,0,0,0,0,0
0,0,0,0,0,0,0,0,0,"00",0,0,0,0,0,0,3277405,"2023-11-10T00:00:00.000Z",26,FALSE,21,3547271,"C",21,21,"Oklahoma City Thunder","Aleksej Pokusevski",0,0,0,0,0,0
2,1,2,5,2,7,3,0,0,"24",1,1,8,3,0,0,3277405,"2023-11-10T00:00:00.000Z",26,FALSE,21,56677833,"G",21,21,"Oklahoma City Thunder","Cason Wallace",1,11,13,10,5,17.6
2,0,0,2,0,2,0,0,0,"19",0,1,0,0,0,0,3277405,"2023-11-10T00:00:00.000Z",26,FALSE,21,27924547,"F",21,21,"Oklahoma City Thunder","Lindy Waters III",0,0,2,2,2,3
0,0,0,0,0,0,0,0,0,"00",0,0,0,0,0,0,3277405,"2023-11-10T00:00:00.000Z",26,FALSE,21,17896078,"G",21,21,"Oklahoma City Thunder","Aaron Wiggins",0,0,0,0,0,0
2,0,4,2,0,2,0,2,1,"18",0,3,1,4,1,0,3277405,"2023-11-10T00:00:00.000Z",26,FALSE,21,38017706,"F",21,21,"Oklahoma City Thunder","Jaylin Williams",1,5,7,3,6,11.8
0,0,0,0,0,0,0,0,0,"00",0,0,0,0,0,0,3277405,"2023-11-10T00:00:00.000Z",26,FALSE,21,56677853,"F",21,21,"Oklahoma City Thunder","Keyontae Johnson",0,0,0,0,0,0
0,0,0,0,0,0,0,0,0,"00",0,0,0,0,0,0,3277405,"2023-11-10T00:00:00.000Z",26,FALSE,21,24572055,"C",21,21,"Oklahoma City Thunder","Olivier Sarr",0,0,0,0,0,0
0,0,0,0,0,0,0,0,0,"00",0,0,0,0,0,0,3277405,"2023-11-10T00:00:00.000Z",26,FALSE,21,480,"G-F",21,21,"Oklahoma City Thunder","Kenrich Williams",0,0,0,0,0,0
1,0,2,4,0,8,1,2,2,"26",2,1,4,4,0,1,3277405,"2023-11-10T00:00:00.000Z",26,FALSE,21,30,"F",26,26,"Sacramento Kings","Harrison Barnes",0,8,9,5,5,9.3
1,1,7,10,3,17,8,5,5,"40",4,1,24,11,3,3,3277405,"2023-11-10T00:00:00.000Z",26,FALSE,21,38017688,"F",26,26,"Sacramento Kings","Keegan Murray",4,35,36,25,12,47.7
13,2,7,0,0,15,7,6,3,"38",6,5,17,13,1,5,3277405,"2023-11-10T00:00:00.000Z",26,FALSE,21,406,"F",26,26,"Sacramento Kings","Domantas Sabonis",3,30,43,30,26,56.1
2,1,9,10,4,19,11,2,2,"34",0,4,28,9,3,2,3277405,"2023-11-10T00:00:00.000Z",26,FALSE,21,221,"G",26,26,"Sacramento Kings","Kevin Huerter",4,37,39,30,11,51.8
2,3,3,7,1,8,2,4,3,"31",1,3,8,4,0,1,3277405,"2023-11-10T00:00:00.000Z",26,FALSE,21,38017714,"G",26,26,"Sacramento Kings","Keon Ellis",3,12,14,10,6,23.8
0,0,1,2,0,2,0,0,0,"05",0,2,0,1,1,1,3277405,"2023-11-10T00:00:00.000Z",26,FALSE,21,17896030,"G",26,26,"Sacramento Kings","Chris Duarte",1,1,1,0,1,3.2
0,0,0,0,0,0,0,0,0,"03",0,0,0,0,0,0,3277405,"2023-11-10T00:00:00.000Z",26,FALSE,21,17896044,"F",26,26,"Sacramento Kings","Kessler Edwards",0,0,0,0,0,0
0,0,0,0,0,0,0,0,0,"00",0,0,0,0,0,0,3277405,"2023-11-10T00:00:00.000Z",26,FALSE,21,17895990,"G",26,26,"Sacramento Kings","Jordan Ford",0,0,0,0,0,0
0,0,0,0,0,0,0,0,0,"00",0,0,0,0,0,0,3277405,"2023-11-10T00:00:00.000Z",26,FALSE,21,56677845,"G",26,26,"Sacramento Kings","Colby Jones",0,0,0,0,0,0
0,2,3,0,0,1,1,2,1,"10",3,1,3,6,0,2,3277405,"2023-11-10T00:00:00.000Z",26,FALSE,21,273,"C",26,26,"Sacramento Kings","Alex Len",2,9,9,3,6,14.2
0,0,0,0,0,0,0,0,0,"00",0,0,0,0,0,0,3277405,"2023-11-10T00:00:00.000Z",26,FALSE,21,306,"C",26,26,"Sacramento Kings","JaVale McGee",0,0,0,0,0,0
1,0,1,6,1,6,1,0,0,"16",0,1,3,1,0,0,3277405,"2023-11-10T00:00:00.000Z",26,FALSE,21,17553994,"G",26,26,"Sacramento Kings","Davion Mitchell",0,4,5,4,2,5.7
8,0,2,5,2,12,5,0,0,"29",0,3,12,2,1,2,3277405,"2023-11-10T00:00:00.000Z",26,FALSE,21,324,"G",26,26,"Sacramento Kings","Malik Monk",1,14,22,20,10,27.4
0,0,1,3,2,3,2,0,0,"08",0,1,6,1,1,0,3277405,"2023-11-10T00:00:00.000Z",26,FALSE,21,4197162,"F",26,26,"Sacramento Kings","Aleksandar Vezenkov",1,7,7,6,1,10.2
0,0,0,0,0,0,0,0,0,"00",0,0,0,0,0,0,3277405,"2023-11-10T00:00:00.000Z",26,FALSE,21,161,"G",26,26,"Sacramento Kings","De'Aaron Fox",0,0,0,0,0,0
0,0,0,0,0,0,0,0,0,"00",0,0,0,0,0,0,3277405,"2023-11-10T00:00:00.000Z",26,FALSE,21,290,"F",26,26,"Sacramento Kings","Trey Lyles",0,0,0,0,0,0
0,0,0,0,0,0,0,0,0,"00",0,0,0,0,0,0,3277405,"2023-11-10T00:00:00.000Z",26,FALSE,21,17895941,"C",26,26,"Sacramento Kings","Filip Petrusev",0,0,0,0,0,0
0,0,0,0,0,0,0,0,0,"00",0,0,0,0,0,0,3277405,"2023-11-10T00:00:00.000Z",26,FALSE,21,56677862,"F",26,26,"Sacramento Kings","Jalen Slawson",0,0,0,0,0,0
2,1,4,3,2,5,2,2,2,"25",2,4,8,6,3,2,3277405,"2023-11-10T00:00:00.000Z",26,FALSE,21,666541,"G",21,21,"Oklahoma City Thunder","Luguentz Dort",4,14,16,10,8,28.2
1,0,5,3,0,14,6,2,2,"31",0,1,14,5,1,3,3277405,"2023-11-10T00:00:00.000Z",26,FALSE,21,38017703,"G-F",21,21,"Oklahoma City Thunder","Jalen Williams",1,19,20,15,6,21.5
1,1,6,3,0,12,5,3,2,"30",1,2,12,7,1,4,3277405,"2023-11-10T00:00:00.000Z",26,FALSE,21,38017685,"C-F",21,21,"Oklahoma City Thunder","Chet Holmgren",2,19,20,13,8,23.9
0,0,0,0,0,0,0,0,0,"00",0,0,0,0,0,0,3277405,"2023-11-10T00:00:00.000Z",26,FALSE,21,44,"F",21,21,"Oklahoma City Thunder","Davis Bertans",0,0,0,0,0,0
1,0,1,1,0,1,0,0,0,"08",0,1,0,1,0,0,3277405,"2023-11-10T00:00:00.000Z",26,FALSE,21,38017716,"F",21,21,"Oklahoma City Thunder","Ousmane Dieng",0,1,2,1,2,2.7
0,0,1,8,3,9,3,0,0,"20",0,0,9,1,1,1,3277405,"2023-11-10T00:00:00.000Z",26,FALSE,21,3547272,"G",21,21,"Oklahoma City Thunder","Isaiah Joe",1,10,10,9,1,12.2
3,0,6,6,2,16,8,7,6,"38",0,2,24,6,1,3,1037721,"2023-11-11T00:00:00.000Z",22,FALSE,17,17896026,"F",22,22,"Orlando Magic","Franz Wagner",1,30,33,27,9,35.7
5,0,9,5,2,22,10,5,4,"38",3,2,26,12,1,3,1037721,"2023-11-11T00:00:00.000Z",22,FALSE,17,38017683,"F",22,22,"Orlando Magic","Paolo Banchero",1,38,43,31,17,47.9
2,0,4,0,0,5,1,0,0,"21",5,2,2,9,2,1,1037721,"2023-11-11T00:00:00.000Z",22,FALSE,17,666442,"C",22,22,"Orlando Magic","Goga Bitadze",2,11,13,4,11,20.8
2,0,2,4,2,11,5,10,8,"39",0,0,20,2,1,1,1037721,"2023-11-11T00:00:00.000Z",22,FALSE,17,17896073,"G",22,22,"Orlando Magic","Jalen Suggs",1,22,24,22,4,27.4
0,0,0,0,0,0,0,0,0,"00",0,0,0,0,0,0,1037721,"2023-11-11T00:00:00.000Z",22,FALSE,17,165,"G",22,22,"Orlando Magic","Markelle Fultz",0,0,0,0,0,0
3,0,0,1,0,3,1,0,0,"28",0,2,2,0,0,1,1037721,"2023-11-11T00:00:00.000Z",22,FALSE,17,56677827,"G",22,22,"Orlando Magic","Anthony Black",0,2,5,5,3,5.5
0,0,0,0,0,0,0,0,0,"00",0,0,0,0,0,0,1037721,"2023-11-11T00:00:00.000Z",22,FALSE,17,38017724,"G",22,22,"Orlando Magic","Caleb Houstan",0,0,0,0,0,0
0,0,0,0,0,0,0,0,0,"00",0,0,0,0,0,0,1037721,"2023-11-11T00:00:00.000Z",22,FALSE,17,56677839,"G",22,22,"Orlando Magic","Jett Howard",0,0,0,0,0,0
5,0,2,4,1,5,1,2,2,"24",1,1,5,3,0,0,1037721,"2023-11-11T00:00:00.000Z",22,FALSE,17,226,"F",22,22,"Orlando Magic","Joe Ingles",0,8,13,10,8,16.1
0,1,2,4,2,10,3,2,2,"17",3,4,10,5,2,0,1037721,"2023-11-11T00:00:00.000Z",22,FALSE,17,229,"F",22,22,"Orlando Magic","Jonathan Isaac",3,15,15,10,5,25
0,0,0,0,0,0,0,0,0,"00",0,0,0,0,0,0,1037721,"2023-11-11T00:00:00.000Z",22,FALSE,17,666818,"F",22,22,"Orlando Magic","Chuma Okeke",0,0,0,0,0,0
1,0,1,1,1,9,7,5,4,"21",3,2,19,4,1,1,1037721,"2023-11-11T00:00:00.000Z",22,FALSE,17,462,"C",22,22,"Orlando Magic","Moritz Wagner",1,23,24,20,5,27.3
0,0,0,0,0,0,0,0,0,"00",0,0,0,0,0,0,1037721,"2023-11-11T00:00:00.000Z",22,FALSE,17,85,"F",22,22,"Orlando Magic","Wendell Carter Jr.",0,0,0,0,0,0
0,0,0,0,0,0,0,0,0,"00",0,0,0,0,0,0,1037721,"2023-11-11T00:00:00.000Z",22,FALSE,17,196,"G",22,22,"Orlando Magic","Gary Harris",0,0,0,0,0,0
0,0,0,0,0,0,0,0,0,"00",0,0,0,0,0,0,1037721,"2023-11-11T00:00:00.000Z",22,FALSE,17,38017607,"G",22,22,"Orlando Magic","Kevon Harris",0,0,0,0,0,0
0,0,0,0,0,0,0,0,0,"00",0,0,0,0,0,0,1037721,"2023-11-11T00:00:00.000Z",22,FALSE,17,17553983,"G",22,22,"Orlando Magic","Trevelin Queen",0,0,0,0,0,0
0,0,0,0,0,0,0,0,0,"00",0,0,0,0,0,0,1037721,"2023-11-11T00:00:00.000Z",22,FALSE,17,666885,"F",22,22,"Orlando Magic","Admiral Schofield",0,0,0,0,0,0
7,1,0,4,2,8,4,0,0,"19",0,1,10,0,0,1,1037721,"2023-11-11T00:00:00.000Z",22,FALSE,17,315,"F",17,17,"Milwaukee Bucks","Khris Middleton",1,10,17,17,7,22.5
7,2,8,1,0,22,15,12,5,"37",2,4,35,10,4,6,1037721,"2023-11-11T00:00:00.000Z",22,FALSE,17,15,"F",17,17,"Milwaukee Bucks","Giannis Antetokounmpo",6,45,52,42,17,69.5
1,2,3,5,2,7,3,2,1,"21",0,1,9,3,1,1,1037721,"2023-11-11T00:00:00.000Z",22,FALSE,17,283,"C",17,17,"Milwaukee Bucks","Brook Lopez",3,12,13,10,4,22.1
1,0,2,3,0,4,0,0,0,"20",0,3,0,2,0,1,1037721,"2023-11-11T00:00:00.000Z",22,FALSE,17,38,"G",17,17,"Milwaukee Bucks","Malik Beasley",0,2,3,1,3,2.9
2,0,0,3,2,8,6,0,0,"25",0,3,14,0,2,2,1037721,"2023-11-11T00:00:00.000Z",22,FALSE,17,368,"G",17,17,"Milwaukee Bucks","Cameron Payne",2,14,16,16,2,21
2,1,0,0,0,0,0,0,0,"10",0,2,0,0,0,1,1037721,"2023-11-11T00:00:00.000Z",22,FALSE,17,2148,"",17,17,"Milwaukee Bucks","Thanasis Antetokounmpo",1,0,2,2,2,5
0,0,3,2,0,7,2,3,1,"20",1,2,5,4,0,3,1037721,"2023-11-11T00:00:00.000Z",22,FALSE,17,38017676,"F",17,17,"Milwaukee Bucks","MarJon Beauchamp",0,9,9,5,4,6.8
1,0,3,1,0,3,1,2,1,"16",0,2,3,3,0,0,1037721,"2023-11-11T00:00:00.000Z",22,FALSE,17,105,"G",17,17,"Milwaukee Bucks","Pat Connaughton",0,6,7,4,4,8.1
0,0,2,1,0,1,0,2,1,"17",0,0,1,2,0,0,1037721,"2023-11-11T00:00:00.000Z",22,FALSE,17,112,"F",17,17,"Milwaukee Bucks","Jae Crowder",0,3,3,1,2,3.4
3,0,2,3,1,3,1,0,0,"09",0,0,3,2,0,0,1037721,"2023-11-11T00:00:00.000Z",22,FALSE,17,38017733,"G",17,17,"Milwaukee Bucks","A.J. Green",0,5,8,6,5,9.9
0,0,2,1,0,3,2,0,0,"14",1,2,4,3,0,2,1037721,"2023-11-11T00:00:00.000Z",22,FALSE,17,56677852,"G",17,17,"Milwaukee Bucks","Andre Jackson Jr.",0,7,7,4,3,5.6
0,0,0,0,0,0,0,0,0,"04",0,0,0,0,0,0,1037721,"2023-11-11T00:00:00.000Z",22,FALSE,17,56677854,"F",17,17,"Milwaukee Bucks","Chris Livingston",0,0,0,0,0,0
0,0,0,0,0,0,0,0,0,"00",0,0,0,0,0,0,1037721,"2023-11-11T00:00:00.000Z",22,FALSE,17,284,"C",17,17,"Milwaukee Bucks","Robin Lopez",0,0,0,0,0,0
1,0,6,5,2,11,4,4,3,"28",1,4,13,7,2,2,1037721,"2023-11-11T00:00:00.000Z",22,FALSE,17,377,"F",17,17,"Milwaukee Bucks","Bobby Portis",2,20,21,14,8,26.9
0,0,0,0,0,0,0,0,0,"00",0,0,0,0,0,0,1037721,"2023-11-11T00:00:00.000Z",22,FALSE,17,666960,"G",17,17,"Milwaukee Bucks","Lindell Wigginton",0,0,0,0,0,0
0,0,0,0,0,0,0,0,0,"00",0,0,0,0,0,0,1037721,"2023-11-11T00:00:00.000Z",22,FALSE,17,666453,"C",17,17,"Milwaukee Bucks","Marques Bolden",0,0,0,0,0,0
0,0,0,0,0,0,0,0,0,"00",0,0,0,0,0,0,1037721,"2023-11-11T00:00:00.000Z",22,FALSE,17,278,"G",17,17,"Milwaukee Bucks","Damian Lillard",0,0,0,0,0,0
0,0,0,0,0,0,0,0,0,"00",0,0,0,0,0,0,1037721,"2023-11-11T00:00:00.000Z",22,FALSE,17,38017691,"G",17,17,"Milwaukee Bucks","TyTy Washington Jr.",0,0,0,0,0,0
3,0,2,1,0,3,0,4,4,"14",0,2,4,2,1,3,1037721,"2023-11-11T00:00:00.000Z",22,FALSE,17,3547251,"G",22,22,"Orlando Magic","Cole Anthony",1,6,9,7,5,10.9
2,0,4,8,3,20,12,3,2,"32",1,1,29,5,0,2,1037722,"2023-11-11T00:00:00.000Z",2,FALSE,28,70,"G",2,2,"Boston Celtics","Jaylen Brown",0,34,36,31,7,36
4,1,5,9,3,18,10,6,4,"34",0,2,27,5,0,1,1037722,"2023-11-11T00:00:00.000Z",2,FALSE,28,434,"F",2,2,"Boston Celtics","Jayson Tatum",1,32,36,31,9,41
3,0,7,7,3,14,9,1,0,"28",0,1,21,7,0,3,1037722,"2023-11-11T00:00:00.000Z",2,FALSE,28,378,"F-C",2,2,"Boston Celtics","Kristaps Porzingis",0,28,31,24,10,30.9
5,1,4,3,0,5,2,1,0,"25",0,2,4,4,0,0,1037722,"2023-11-11T00:00:00.000Z",2,FALSE,28,473,"G",2,2,"Boston Celtics","Derrick White",1,8,13,9,9,19.3
7,2,3,2,0,9,4,0,0,"30",0,2,8,3,1,4,1037722,"2023-11-11T00:00:00.000Z",2,FALSE,28,214,"G",2,2,"Boston Celtics","Jrue Holiday",3,11,18,15,10,27.1
0,0,0,1,0,1,0,0,0,"06",0,0,0,0,0,0,1037722,"2023-11-11T00:00:00.000Z",2,FALSE,28,17896094,"G",2,2,"Boston Celtics","Dalano Banton",0,0,0,0,0,0
0,0,0,0,0,0,0,0,0,"05",0,0,0,0,0,0,1037722,"2023-11-11T00:00:00.000Z",2,FALSE,28,666468,"F",2,2,"Boston Celtics","Oshae Brissett",0,0,0,0,0,0
0,0,4,6,4,6,4,0,0,"18",0,2,12,4,0,0,1037722,"2023-11-11T00:00:00.000Z",2,FALSE,28,17896060,"F",2,2,"Boston Celtics","Sam Hauser",0,16,16,12,4,16.8
4,1,4,9,2,15,4,0,0,"29",1,1,10,5,1,1,1037722,"2023-11-11T00:00:00.000Z",2,FALSE,28,17896055,"G-F",28,28,"Toronto Raptors","Scottie Barnes",2,15,19,14,9,27
4,0,1,3,1,7,3,7,7,"25",0,3,14,1,1,1,1037722,"2023-11-11T00:00:00.000Z",2,FALSE,28,409,"G",28,28,"Toronto Raptors","Dennis Schroder",1,15,19,18,5,23.2
5,0,5,2,0,5,1,0,0,"18",0,1,2,5,0,0,1037722,"2023-11-11T00:00:00.000Z",2,FALSE,28,3547249,"F",28,28,"Toronto Raptors","Precious Achiuwa",0,7,12,7,10,15.5
4,0,6,3,1,5,3,0,0,"24",1,2,7,7,0,0,1037722,"2023-11-11T00:00:00.000Z",2,FALSE,28,219,"C-F",2,2,"Boston Celtics","Al Horford",0,14,18,11,11,21.4
1,0,5,0,0,1,1,0,0,"09",0,1,2,5,0,0,1037722,"2023-11-11T00:00:00.000Z",2,FALSE,28,261,"F-C",2,2,"Boston Celtics","Luke Kornet",0,7,8,3,6,9.5
0,0,0,2,0,2,0,0,0,"05",0,0,0,0,0,1,1037722,"2023-11-11T00:00:00.000Z",2,FALSE,28,338,"G",2,2,"Boston Celtics","Svi Mykhailiuk",0,0,0,0,0,-1
4,0,3,3,1,5,2,2,2,"24",3,1,7,6,0,1,1037722,"2023-11-11T00:00:00.000Z",2,FALSE,28,3547276,"G",2,2,"Boston Celtics","Payton Pritchard",0,13,17,11,10,19.2
0,0,0,0,0,0,0,0,0,"00",0,0,0,0,0,0,1037722,"2023-11-11T00:00:00.000Z",2,FALSE,28,3547279,"F",2,2,"Boston Celtics","Lamar Stevens",0,0,0,0,0,0
0,0,0,0,0,0,0,0,0,"00",0,0,0,0,0,0,1037722,"2023-11-11T00:00:00.000Z",2,FALSE,28,38017707,"G",2,2,"Boston Celtics","JD Davison",0,0,0,0,0,0
0,0,0,0,0,0,0,0,0,"00",0,0,0,0,0,0,1037722,"2023-11-11T00:00:00.000Z",2,FALSE,28,3547295,"F-C",2,2,"Boston Celtics","Nathan Knight",0,0,0,0,0,0
0,0,0,0,0,0,0,0,0,"00",0,0,0,0,0,0,1037722,"2023-11-11T00:00:00.000Z",2,FALSE,28,17553967,"C",2,2,"Boston Celtics","Neemias Queta",0,0,0,0,0,0
0,0,0,0,0,0,0,0,0,"00",0,0,0,0,0,0,1037722,"2023-11-11T00:00:00.000Z",2,FALSE,28,56677864,"G",2,2,"Boston Celtics","Jordan Walsh",0,0,0,0,0,0
2,0,2,8,2,13,3,0,0,"28",1,0,8,3,1,0,1037722,"2023-11-11T00:00:00.000Z",2,FALSE,28,18,"F",28,28,"Toronto Raptors","OG Anunoby",1,11,13,10,5,17.6
3,0,5,4,0,17,6,6,5,"28",2,0,17,7,3,3,1037722,"2023-11-11T00:00:00.000Z",2,FALSE,28,416,"F",28,28,"Toronto Raptors","Pascal Siakam",3,24,27,20,10,35.9
2,0,1,0,0,10,6,0,0,"21",2,3,12,3,0,1,1037722,"2023-11-11T00:00:00.000Z",2,FALSE,28,373,"C",28,28,"Toronto Raptors","Jakob Poeltl",0,15,17,14,5,17.6
1,0,5,3,2,4,2,0,0,"22",0,2,6,5,0,0,1037722,"2023-11-11T00:00:00.000Z",2,FALSE,28,58,"F",28,28,"Toronto Raptors","Chris Boucher",0,11,12,7,6,13.5
1,0,1,2,0,4,1,2,2,"15",0,1,4,1,0,1,1037722,"2023-11-11T00:00:00.000Z",2,FALSE,28,56677828,"G",28,28,"Toronto Raptors","Gradey Dick",0,5,6,5,2,5.7
1,0,1,4,2,7,5,1,0,"23",0,0,12,1,0,1,1037722,"2023-11-11T00:00:00.000Z",2,FALSE,28,3547275,"G",28,28,"Toronto Raptors","Malachi Flynn",0,13,14,13,2,13.7
0,0,1,0,0,2,0,0,0,"09",0,2,0,1,0,0,1037722,"2023-11-11T00:00:00.000Z",2,FALSE,28,666762,"F",28,28,"Toronto Raptors","Jalen McDaniels",0,1,1,0,1,1.2
0,0,3,2,1,2,1,0,0,"14",0,1,3,3,1,0,1037722,"2023-11-11T00:00:00.000Z",2,FALSE,28,376,"F",28,28,"Toronto Raptors","Otto Porter Jr.",1,6,6,3,3,9.6
0,0,1,0,0,2,1,0,0,"04",0,0,2,1,1,0,1037722,"2023-11-11T00:00:00.000Z",2,FALSE,28,436,"G-F",28,28,"Toronto Raptors","Garrett Temple",1,3,3,2,1,6.2
2,0,0,0,0,3,2,0,0,"04",1,0,4,1,0,0,1037722,"2023-11-11T00:00:00.000Z",2,FALSE,28,489,"F",28,28,"Toronto Raptors","Thaddeus Young",0,5,7,6,3,8.2
0,0,0,0,0,0,0,0,0,"00",0,0,0,0,0,0,1037722,"2023-11-11T00:00:00.000Z",2,FALSE,28,56677805,"G",28,28,"Toronto Raptors","Javon Freeman-Liberty",0,0,0,0,0,0
0,0,0,0,0,0,0,0,0,"00",0,0,0,0,0,0,1037722,"2023-11-11T00:00:00.000Z",2,FALSE,28,38017717,"F",28,28,"Toronto Raptors","Ron Harper Jr.",0,0,0,0,0,0
0,0,0,0,0,0,0,0,0,"00",0,0,0,0,0,0,1037722,"2023-11-11T00:00:00.000Z",2,FALSE,28,38017710,"C",28,28,"Toronto Raptors","Christian Koloko",0,0,0,0,0,0
0,0,0,0,0,0,0,0,0,"00",0,0,0,0,0,0,1037722,"2023-11-11T00:00:00.000Z",2,FALSE,28,56677869,"G",28,28,"Toronto Raptors","Markquis Nowell",0,0,0,0,0,0
0,0,0,0,0,0,0,0,0,"00",0,0,0,0,0,0,1037722,"2023-11-11T00:00:00.000Z",2,FALSE,28,3089,"",28,28,"Toronto Raptors","Gary Trent Jr.",0,0,0,0,0,0
2,1,5,4,0,11,4,2,2,"36",0,4,10,5,1,3,1037723,"2023-11-11T00:00:00.000Z",1,FALSE,16,666656,"F",1,1,"Atlanta Hawks","De'Andre Hunter",2,15,17,12,7,22
2,0,4,3,1,8,4,0,0,"22",0,2,9,4,0,3,1037723,"2023-11-11T00:00:00.000Z",1,FALSE,16,17896040,"F",1,1,"Atlanta Hawks","Jalen Johnson",0,13,15,11,6,13.8
0,2,5,0,0,6,4,0,0,"24",7,3,8,12,1,0,1037723,"2023-11-11T00:00:00.000Z",1,FALSE,16,83,"C",1,1,"Atlanta Hawks","Clint Capela",3,20,20,8,12,31.4
5,1,5,9,5,16,9,1,0,"36",0,1,23,5,3,3,1037723,"2023-11-11T00:00:00.000Z",1,FALSE,16,334,"G",1,1,"Atlanta Hawks","Dejounte Murray",4,28,33,28,10,45.5
11,0,2,9,3,19,7,11,10,"38",0,0,27,2,1,5,1037723,"2023-11-11T00:00:00.000Z",1,FALSE,16,490,"G",1,1,"Atlanta Hawks","Trae Young",1,29,40,38,13,43.9
0,0,5,7,2,9,3,0,0,"24",3,0,8,8,0,4,1037723,"2023-11-11T00:00:00.000Z",1,FALSE,16,3547256,"F",1,1,"Atlanta Hawks","Saddiq Bey",0,16,16,8,8,13.6
1,0,3,12,5,13,5,0,0,"29",0,4,15,3,0,2,1037723,"2023-11-11T00:00:00.000Z",1,FALSE,16,53,"G",1,1,"Atlanta Hawks","Bogdan Bogdanovic",0,18,19,16,4,18.1
0,0,0,0,0,0,0,0,0,"00",0,0,0,0,0,0,1037723,"2023-11-11T00:00:00.000Z",1,FALSE,16,666564,"F",1,1,"Atlanta Hawks","Bruno Fernando",0,0,0,0,0,0
0,0,0,0,0,0,0,0,0,"00",0,0,0,0,0,0,1037723,"2023-11-11T00:00:00.000Z",1,FALSE,16,3547297,"G",1,1,"Atlanta Hawks","Trent Forrest",0,0,0,0,0,0
0,0,0,0,0,0,0,0,0,"00",0,0,0,0,0,0,1037723,"2023-11-11T00:00:00.000Z",1,FALSE,16,38017689,"F",1,1,"Atlanta Hawks","AJ Griffin",0,0,0,0,0,0
0,0,0,0,0,0,0,0,0,"00",0,0,0,0,0,0,1037723,"2023-11-11T00:00:00.000Z",1,FALSE,16,666754,"G",1,1,"Atlanta Hawks","Garrison Mathews",0,0,0,0,0,0
0,0,1,2,2,2,2,2,1,"07",1,3,7,2,0,1,1037723,"2023-11-11T00:00:00.000Z",1,FALSE,16,301,"G-F",1,1,"Atlanta Hawks","Wesley Matthews",0,9,9,7,2,8.4
0,0,0,0,0,0,0,0,0,"00",0,0,0,0,0,0,1037723,"2023-11-11T00:00:00.000Z",1,FALSE,16,319,"G",1,1,"Atlanta Hawks","Patty Mills",0,0,0,0,0,0
2,2,3,0,0,3,0,2,2,"24",4,2,2,7,0,0,1037723,"2023-11-11T00:00:00.000Z",1,FALSE,16,3547244,"F-C",1,1,"Atlanta Hawks","Onyeka Okongwu",2,9,11,4,9,19.4
0,0,0,0,0,0,0,0,0,"00",0,0,0,0,0,0,1037723,"2023-11-11T00:00:00.000Z",1,FALSE,16,56677838,"G",1,1,"Atlanta Hawks","Kobe Bufkin",0,0,0,0,0,0
0,0,0,0,0,0,0,0,0,"00",0,0,0,0,0,0,1037723,"2023-11-11T00:00:00.000Z",1,FALSE,16,56677806,"F",1,1,"Atlanta Hawks","Mouhamed Gueye",0,0,0,0,0,0
0,0,0,0,0,0,0,0,0,"00",0,0,0,0,0,0,1037723,"2023-11-11T00:00:00.000Z",1,FALSE,16,56677855,"G",1,1,"Atlanta Hawks","Seth Lundy",0,0,0,0,0,0
0,0,0,0,0,0,0,0,0,"00",0,0,0,0,0,0,1037723,"2023-11-11T00:00:00.000Z",1,FALSE,16,56677875,"F",1,1,"Atlanta Hawks","Miles Norris",0,0,0,0,0,0
4,0,2,7,2,17,8,2,2,"38",1,3,20,3,1,3,1037723,"2023-11-11T00:00:00.000Z",1,FALSE,16,56677785,"G",16,16,"Miami Heat","Jaime Jaquez Jr.",1,23,27,24,7,29.6
5,1,5,5,0,13,3,7,5,"34",1,2,11,6,2,1,1037723,"2023-11-11T00:00:00.000Z",1,FALSE,16,3092,"",16,16,"Miami Heat","Haywood Highsmith",3,17,22,16,11,33.7
4,2,12,0,0,12,9,8,8,"39",4,2,26,16,2,3,1037723,"2023-11-11T00:00:00.000Z",1,FALSE,16,4,"C-F",16,16,"Miami Heat","Bam Adebayo",4,42,46,30,20,60.2
2,0,3,10,1,15,5,0,0,"30",0,3,11,3,1,1,1037723,"2023-11-11T00:00:00.000Z",1,FALSE,16,397,"F",16,16,"Miami Heat","Duncan Robinson",1,14,16,13,5,19.6
4,0,3,6,4,8,4,5,5,"33",0,1,17,3,1,3,1037723,"2023-11-11T00:00:00.000Z",1,FALSE,16,286,"G",16,16,"Miami Heat","Kyle Lowry",1,20,24,21,7,26.6
0,0,0,0,0,0,0,0,0,"01",0,0,0,0,0,0,1037723,"2023-11-11T00:00:00.000Z",1,FALSE,16,38017734,"F",16,16,"Miami Heat","Jamal Cain",0,0,0,0,0,0
2,0,4,3,1,4,2,2,2,"14",0,0,7,4,0,1,1037723,"2023-11-11T00:00:00.000Z",1,FALSE,16,285,"F-C",16,16,"Miami Heat","Kevin Love",0,11,13,9,6,13.8
0,0,2,4,3,7,6,1,1,"23",0,0,16,2,0,1,1037723,"2023-11-11T00:00:00.000Z",1,FALSE,16,391,"G-F",16,16,"Miami Heat","Josh Richardson",0,18,18,16,2,17.4
2,1,1,3,1,8,4,0,0,"28",1,3,9,2,3,2,1037723,"2023-11-11T00:00:00.000Z",1,FALSE,16,19465585,"G",16,16,"Miami Heat","Dru Smith",4,11,13,11,4,24.4
0,0,0,0,0,0,0,0,0,"00",0,0,0,0,0,0,1037723,"2023-11-11T00:00:00.000Z",1,FALSE,16,74,"C",16,16,"Miami Heat","Thomas Bryant",0,0,0,0,0,0
0,0,0,0,0,0,0,0,0,"00",0,0,0,0,0,0,1037723,"2023-11-11T00:00:00.000Z",1,FALSE,16,38017696,"F",16,16,"Miami Heat","Nikola Jovic",0,0,0,0,0,0
0,0,0,0,0,0,0,0,0,"00",0,0,0,0,0,0,1037723,"2023-11-11T00:00:00.000Z",1,FALSE,16,39398582,"C",16,16,"Miami Heat","Orlando Robinson",0,0,0,0,0,0
0,0,0,0,0,0,0,0,0,"00",0,0,0,0,0,0,1037723,"2023-11-11T00:00:00.000Z",1,FALSE,16,38017736,"F",16,16,"Miami Heat","Cole Swider",0,0,0,0,0,0
0,0,0,0,0,0,0,0,0,"00",0,0,0,0,0,0,1037723,"2023-11-11T00:00:00.000Z",1,FALSE,16,79,"G-F",16,16,"Miami Heat","Jimmy Butler",0,0,0,0,0,0
0,0,0,0,0,0,0,0,0,"00",0,0,0,0,0,0,1037723,"2023-11-11T00:00:00.000Z",1,FALSE,16,3547257,"G",16,16,"Miami Heat","R.J. Hampton",0,0,0,0,0,0
0,0,0,0,0,0,0,0,0,"00",0,0,0,0,0,0,1037723,"2023-11-11T00:00:00.000Z",1,FALSE,16,666633,"G",16,16,"Miami Heat","Tyler Herro",0,0,0,0,0,0
0,0,0,0,0,0,0,0,0,"00",0,0,0,0,0,0,1037723,"2023-11-11T00:00:00.000Z",1,FALSE,16,666747,"F",16,16,"Miami Heat","Caleb Martin",0,0,0,0,0,0
3,0,2,4,1,12,6,2,0,"29",3,2,13,5,0,3,1037724,"2023-11-11T00:00:00.000Z",10,FALSE,6,475,"F-G",10,10,"Golden State Warriors","Andrew Wiggins",0,18,21,16,8,20.5
4,0,3,3,2,4,3,0,0,"18",2,3,8,5,0,1,1037724,"2023-11-11T00:00:00.000Z",10,FALSE,6,185,"F",10,10,"Golden State Warriors","Draymond Green",0,13,17,12,9,19
2,0,10,0,0,2,1,0,0,"24",3,5,2,13,0,1,1037724,"2023-11-11T00:00:00.000Z",10,FALSE,6,282,"F",10,10,"Golden State Warriors","Kevon Looney",0,15,17,4,15,19.6
1,1,4,5,2,16,5,2,2,"28",1,3,14,5,0,3,1037724,"2023-11-11T00:00:00.000Z",10,FALSE,6,443,"G",10,10,"Golden State Warriors","Klay Thompson",1,19,20,15,6,21.5
2,1,2,14,4,24,9,8,8,"33",1,1,30,3,1,4,1037724,"2023-11-11T00:00:00.000Z",10,FALSE,6,115,"G",10,10,"Golden State Warriors","Stephen Curry",2,33,35,32,5,38.6
0,0,0,0,0,1,0,2,1,"06",1,1,1,1,0,0,1037724,"2023-11-11T00:00:00.000Z",10,FALSE,6,56677799,"F",10,10,"Golden State Warriors","Trayce Jackson-Davis",0,2,2,1,1,2.2
1,0,0,2,1,2,1,0,0,"02",0,1,3,0,0,2,1037724,"2023-11-11T00:00:00.000Z",10,FALSE,6,251,"G",10,10,"Golden State Warriors","Cory Joseph",0,3,4,4,1,2.5
0,0,3,1,0,7,2,11,8,"21",0,4,12,3,0,0,1037724,"2023-11-11T00:00:00.000Z",10,FALSE,6,17553979,"F",10,10,"Golden State Warriors","Jonathan Kuminga",0,15,15,12,3,15.6
1,0,4,3,2,4,2,2,2,"18",1,3,8,5,0,1,1037724,"2023-11-11T00:00:00.000Z",10,FALSE,6,17553992,"G",10,10,"Golden State Warriors","Moses Moody",0,13,14,9,6,14.5
9,0,3,2,1,7,4,0,0,"26",0,2,9,3,3,3,1037724,"2023-11-11T00:00:00.000Z",10,FALSE,6,367,"G",10,10,"Golden State Warriors","Chris Paul",3,12,21,18,12,32.1
0,0,3,1,0,4,1,2,1,"11",2,0,3,5,0,1,1037724,"2023-11-11T00:00:00.000Z",10,FALSE,6,2189,"",10,10,"Golden State Warriors","Gary Payton II",0,8,8,3,5,8
2,0,1,0,0,2,1,0,0,"08",1,1,2,2,1,1,1037724,"2023-11-11T00:00:00.000Z",10,FALSE,6,56677858,"G",10,10,"Golden State Warriors","Brandin Podziemski",1,4,6,4,4,9.4
1,1,5,3,0,5,2,1,1,"16",0,3,5,5,0,0,1037724,"2023-11-11T00:00:00.000Z",10,FALSE,6,407,"F",10,10,"Golden State Warriors","Dario Saric",1,10,11,6,6,15.5
0,0,0,0,0,0,0,0,0,"00",0,0,0,0,0,0,1037724,"2023-11-11T00:00:00.000Z",10,FALSE,6,17896070,"F",10,10,"Golden State Warriors","Usman Garuba",0,0,0,0,0,0
0,0,0,0,0,0,0,0,0,"00",0,0,0,0,0,0,1037724,"2023-11-11T00:00:00.000Z",10,FALSE,6,45658838,"G",10,10,"Golden State Warriors","Lester Quinones",0,0,0,0,0,0
0,0,0,0,0,0,0,0,0,"00",0,0,0,0,0,0,1037724,"2023-11-11T00:00:00.000Z",10,FALSE,6,398,"G",10,10,"Golden State Warriors","Jerome Robinson",0,0,0,0,0,0
0,0,0,0,0,0,0,0,0,"00",0,0,0,0,0,0,1037724,"2023-11-11T00:00:00.000Z",10,FALSE,6,57875092,"F",10,10,"Golden State Warriors","Gui Santos",0,0,0,0,0,0
4,0,7,3,2,9,6,2,2,"33",1,2,16,8,1,0,1037724,"2023-11-11T00:00:00.000Z",10,FALSE,6,666908,"G",6,6,"Cleveland Cavaliers","Max Strus",1,24,28,20,12,34.6
2,1,4,1,0,10,6,7,7,"31",1,4,19,5,1,2,1037724,"2023-11-11T00:00:00.000Z",10,FALSE,6,17896076,"F-C",6,6,"Cleveland Cavaliers","Evan Mobley",2,24,26,21,7,32
4,0,2,0,0,6,2,9,8,"28",3,4,12,5,0,1,1037724,"2023-11-11T00:00:00.000Z",10,FALSE,6,9,"C",6,6,"Cleveland Cavaliers","Jarrett Allen",0,17,21,16,9,23
4,0,4,5,3,13,6,6,4,"36",2,2,19,6,5,4,1037724,"2023-11-11T00:00:00.000Z",10,FALSE,6,666581,"G",6,6,"Cleveland Cavaliers","Darius Garland",5,25,29,23,10,43.2
5,1,6,6,2,22,7,6,5,"36",1,4,21,7,2,2,1037724,"2023-11-11T00:00:00.000Z",10,FALSE,6,322,"G",6,6,"Cleveland Cavaliers","Donovan Mitchell",3,28,33,26,12,43.9
1,0,1,4,0,4,0,0,0,"19",1,1,0,2,0,1,1037724,"2023-11-11T00:00:00.000Z",10,FALSE,6,344,"F",6,6,"Cleveland Cavaliers","Georges Niang",0,2,3,1,3,2.9
0,0,0,0,0,0,0,6,1,"01",0,0,1,0,0,0,1037724,"2023-11-11T00:00:00.000Z",10,FALSE,6,56677872,"G",6,6,"Cleveland Cavaliers","Craig Porter",0,1,1,1,0,1
0,0,0,0,0,0,0,0,0,"01",0,0,0,0,0,0,1037724,"2023-11-11T00:00:00.000Z",10,FALSE,6,444,"C-F",6,6,"Cleveland Cavaliers","Tristan Thompson",0,0,0,0,0,0
0,0,7,4,2,4,2,2,2,"17",0,6,8,7,0,0,1037724,"2023-11-11T00:00:00.000Z",10,FALSE,6,666940,"F",6,6,"Cleveland Cavaliers","Dean Wade",0,15,15,8,7,16.4
0,0,0,0,0,0,0,0,0,"00",0,0,0,0,0,0,1037724,"2023-11-11T00:00:00.000Z",10,FALSE,6,666676,"G",6,6,"Cleveland Cavaliers","Ty Jerome",0,0,0,0,0,0
0,0,0,0,0,0,0,0,0,"01",0,0,0,0,0,0,1037724,"2023-11-11T00:00:00.000Z",10,FALSE,6,56677847,"F",6,6,"Cleveland Cavaliers","Emoni Bates",0,0,0,0,0,0
0,0,0,0,0,0,0,0,0,"01",0,0,0,0,0,0,1037724,"2023-11-11T00:00:00.000Z",10,FALSE,6,248,"C",6,6,"Cleveland Cavaliers","Damian Jones",0,0,0,0,0,0
3,1,3,7,2,18,8,5,4,"36",2,1,22,5,4,0,1037724,"2023-11-11T00:00:00.000Z",10,FALSE,6,277,"G",6,6,"Cleveland Cavaliers","Caris LeVert",5,27,30,25,8,47.5
0,0,0,0,0,0,0,0,0,"00",0,0,0,0,0,0,1037724,"2023-11-11T00:00:00.000Z",10,FALSE,6,3547299,"G",6,6,"Cleveland Cavaliers","Sam Merrill",0,0,0,0,0,0
0,0,0,0,0,0,0,0,0,"00",0,0,0,0,0,0,1037724,"2023-11-11T00:00:00.000Z",10,FALSE,6,38017662,"F",6,6,"Cleveland Cavaliers","Isaiah Mobley",0,0,0,0,0,0
0,0,0,0,0,0,0,0,0,"00",0,0,0,0,0,0,1037724,"2023-11-11T00:00:00.000Z",10,FALSE,6,3547247,"F-G",6,6,"Cleveland Cavaliers","Isaac Okoro",0,0,0,0,0,0
0,0,0,0,0,0,0,0,0,"00",0,0,0,0,0,0,1037724,"2023-11-11T00:00:00.000Z",10,FALSE,6,404,"G",6,6,"Cleveland Cavaliers","Ricky Rubio",0,0,0,0,0,0
2,1,4,6,4,16,9,3,2,"31",0,1,24,4,1,1,1037725,"2023-11-12T00:00:00.000Z",20,FALSE,4,666423,"F-G",20,20,"New York Knicks","RJ Barrett",2,28,30,26,6,36.8
5,0,4,4,1,16,8,8,6,"27",1,1,23,5,3,3,1037725,"2023-11-12T00:00:00.000Z",20,FALSE,4,387,"F",20,20,"New York Knicks","Julius Randle",3,28,33,28,10,42.5
0,0,4,0,0,7,5,2,0,"24",5,2,10,9,1,0,1037725,"2023-11-12T00:00:00.000Z",20,FALSE,4,399,"C",20,20,"New York Knicks","Mitchell Robinson",1,19,19,10,9,23.8
1,0,1,4,2,12,7,4,4,"27",0,2,20,1,1,1,1037725,"2023-11-12T00:00:00.000Z",20,FALSE,4,73,"G",20,20,"New York Knicks","Jalen Brunson",1,21,22,21,2,24.7
1,0,1,5,2,5,2,0,0,"23",0,1,6,1,1,0,1037725,"2023-11-12T00:00:00.000Z",20,FALSE,4,17895858,"G",20,20,"New York Knicks","Quentin Grimes",1,7,8,7,2,11.7
0,0,0,1,0,1,0,0,0,"03",0,0,0,0,0,0,1037725,"2023-11-12T00:00:00.000Z",20,FALSE,4,19,"G",20,20,"New York Knicks","Ryan Arcidiacono",0,0,0,0,0,0
2,1,0,6,1,8,3,3,2,"23",1,2,9,1,0,1,1037725,"2023-11-12T00:00:00.000Z",20,FALSE,4,131,"G",20,20,"New York Knicks","Donte DiVincenzo",1,10,12,11,3,15.2
0,0,0,0,0,0,0,0,0,"00",0,0,0,0,0,0,1037725,"2023-11-12T00:00:00.000Z",20,FALSE,4,160,"G-F",20,20,"New York Knicks","Evan Fournier",0,0,0,0,0,0
2,0,3,2,0,6,3,0,0,"27",1,1,6,4,0,0,1037725,"2023-11-12T00:00:00.000Z",20,FALSE,4,202,"G",20,20,"New York Knicks","Josh Hart",0,10,12,8,6,13.8
1,2,4,0,0,3,2,4,2,"17",2,6,6,6,1,2,1037725,"2023-11-12T00:00:00.000Z",20,FALSE,4,201,"F-C",20,20,"New York Knicks","Isaiah Hartenstein",3,12,13,7,7,21.7
1,0,0,0,0,1,1,0,0,"03",0,0,2,0,0,0,1037725,"2023-11-12T00:00:00.000Z",20,FALSE,4,666675,"F",20,20,"New York Knicks","DaQuan Jeffries",0,2,3,3,1,3.5
1,0,1,2,1,2,1,0,0,"03",0,0,3,1,0,0,1037725,"2023-11-12T00:00:00.000Z",20,FALSE,4,17896033,"G",20,20,"New York Knicks","Miles McBride",0,4,5,4,2,5.7
9,0,5,6,4,9,5,3,3,"26",0,1,17,5,0,1,1037725,"2023-11-12T00:00:00.000Z",20,FALSE,4,3547269,"G",20,20,"New York Knicks","Immanuel Quickley",0,22,31,26,14,35.5
0,0,3,0,0,1,1,3,1,"06",0,1,3,3,0,0,1037725,"2023-11-12T00:00:00.000Z",20,FALSE,4,17896063,"F",20,20,"New York Knicks","Jericho Sims",0,6,6,3,3,6.6
0,0,0,0,0,0,0,0,0,"00",0,0,0,0,0,0,1037725,"2023-11-12T00:00:00.000Z",20,FALSE,4,666971,"G-F",20,20,"New York Knicks","Dylan Windler",0,0,0,0,0,0
0,0,0,0,0,0,0,0,0,"00",0,0,0,0,0,0,1037725,"2023-11-12T00:00:00.000Z",20,FALSE,4,666474,"G",20,20,"New York Knicks","Charles Brown",0,0,0,0,0,0
0,0,0,0,0,0,0,0,0,"00",0,0,0,0,0,0,1037725,"2023-11-12T00:00:00.000Z",20,FALSE,4,56677795,"F",20,20,"New York Knicks","Jacob Toppin",0,0,0,0,0,0
0,0,0,0,0,0,0,0,0,"00",0,0,0,0,0,0,1037725,"2023-11-12T00:00:00.000Z",20,FALSE,4,17896089,"G",20,20,"New York Knicks","Duane Washington Jr.",0,0,0,0,0,0
2,0,1,1,0,9,3,0,0,"29",0,3,6,1,0,2,1037725,"2023-11-12T00:00:00.000Z",20,FALSE,4,204,"F",4,4,"Charlotte Hornets","Gordon Hayward",0,7,9,8,3,8.2
3,1,1,5,1,8,1,2,1,"22",1,4,4,2,0,2,1037725,"2023-11-12T00:00:00.000Z",20,FALSE,4,666950,"F",4,4,"Charlotte Hornets","P.J. Washington",1,6,9,7,5,11.9
2,0,2,0,0,5,4,2,2,"23",2,3,10,4,2,1,1037725,"2023-11-12T00:00:00.000Z",20,FALSE,4,38017698,"C",4,4,"Charlotte Hornets","Mark Williams",2,14,16,12,6,22.8
6,1,4,8,4,20,13,2,2,"33",3,2,32,7,1,2,1037725,"2023-11-12T00:00:00.000Z",20,FALSE,4,3547239,"G",4,4,"Charlotte Hornets","LaMelo Ball",2,39,45,38,13,53.4
0,0,2,2,1,6,5,1,0,"10",1,0,11,3,0,0,1037725,"2023-11-12T00:00:00.000Z",20,FALSE,4,56677823,"F",4,4,"Charlotte Hornets","Brandon Miller",0,14,14,11,3,14.6
0,0,0,0,0,3,1,0,0,"03",2,0,2,2,0,0,1037725,"2023-11-12T00:00:00.000Z",20,FALSE,4,56677848,"G",4,4,"Charlotte Hornets","Amari Bailey",0,4,4,2,2,4.4
0,1,2,1,1,2,2,0,0,"06",0,1,5,2,0,0,1037725,"2023-11-12T00:00:00.000Z",20,FALSE,4,56677866,"F",4,4,"Charlotte Hornets","Leaky Black",1,7,7,5,2,10.4
4,0,0,7,2,12,2,0,0,"25",2,3,6,2,0,2,1037725,"2023-11-12T00:00:00.000Z",20,FALSE,4,3547253,"G",4,4,"Charlotte Hornets","Theo Maledon",0,8,12,10,6,12.4
0,0,0,2,0,4,1,0,0,"19",0,0,2,0,0,0,1037725,"2023-11-12T00:00:00.000Z",20,FALSE,4,38017708,"G",4,4,"Charlotte Hornets","Bryce McGowens",0,2,2,2,0,2
0,0,3,0,0,9,7,2,2,"22",1,4,16,4,0,2,1037725,"2023-11-12T00:00:00.000Z",20,FALSE,4,3547282,"C",4,4,"Charlotte Hornets","Nick Richards",0,20,20,16,4,18.8
2,0,4,0,0,4,2,0,0,"17",1,1,4,5,2,0,1037725,"2023-11-12T00:00:00.000Z",20,FALSE,4,422,"G",4,4,"Charlotte Hornets","Ish Smith",2,9,11,6,7,19
2,0,0,4,1,6,1,0,0,"08",0,0,3,0,0,0,1037725,"2023-11-12T00:00:00.000Z",20,FALSE,4,56677846,"G",4,4,"Charlotte Hornets","Nick Smith Jr.",0,3,5,5,2,6
0,1,2,5,2,6,2,2,0,"23",2,4,6,4,0,1,1037725,"2023-11-12T00:00:00.000Z",20,FALSE,4,18678001,"F",4,4,"Charlotte Hornets","JT Thor",1,10,10,6,4,12.8
0,0,0,0,0,0,0,0,0,"00",0,0,0,0,0,0,1037725,"2023-11-12T00:00:00.000Z",20,FALSE,4,17896037,"G",4,4,"Charlotte Hornets","James Bouknight",0,0,0,0,0,0
0,0,0,0,0,0,0,0,0,"00",0,0,0,0,0,0,1037725,"2023-11-12T00:00:00.000Z",20,FALSE,4,62,"F",4,4,"Charlotte Hornets","Miles Bridges",0,0,0,0,0,0
0,0,0,0,0,0,0,0,0,"00",0,0,0,0,0,0,1037725,"2023-11-12T00:00:00.000Z",20,FALSE,4,666748,"F",4,4,"Charlotte Hornets","Cody Martin",0,0,0,0,0,0
0,0,0,0,0,0,0,0,0,"00",0,0,0,0,0,0,1037725,"2023-11-12T00:00:00.000Z",20,FALSE,4,347,"G",4,4,"Charlotte Hornets","Frank Ntilikina",0,0,0,0,0,0
0,0,0,0,0,0,0,0,0,"00",0,0,0,0,0,0,1037725,"2023-11-12T00:00:00.000Z",20,FALSE,4,403,"G",4,4,"Charlotte Hornets","Terry Rozier",0,0,0,0,0,0
1,0,5,11,2,16,5,2,2,"35",1,0,14,6,0,3,1037726,"2023-11-12T00:00:00.000Z",3,FALSE,30,666679,"F",3,3,"Brooklyn Nets","Cameron Johnson",0,20,21,15,7,19.7
0,0,1,6,2,7,2,0,0,"20",2,5,6,3,0,2,1037726,"2023-11-12T00:00:00.000Z",3,FALSE,30,158,"F",3,3,"Brooklyn Nets","Dorian Finney-Smith",0,9,9,6,3,7.6
2,4,9,0,0,7,5,0,0,"28",4,2,10,13,0,0,1037726,"2023-11-12T00:00:00.000Z",3,FALSE,30,666508,"F-C",3,3,"Brooklyn Nets","Nicolas Claxton",4,23,25,12,15,40.6
2,0,9,14,2,29,11,5,3,"34",4,0,27,13,1,4,1037726,"2023-11-12T00:00:00.000Z",3,FALSE,30,61,"F",3,3,"Brooklyn Nets","Mikal Bridges",1,40,42,29,15,44.6
3,1,4,5,0,10,3,7,6,"31",0,2,12,4,2,0,1037726,"2023-11-12T00:00:00.000Z",3,FALSE,30,130,"G",3,3,"Brooklyn Nets","Spencer Dinwiddie",3,16,19,15,7,30.3
0,0,0,0,0,0,0,0,0,"00",0,0,0,0,0,0,1037726,"2023-11-12T00:00:00.000Z",3,FALSE,30,9051997,"G",3,3,"Brooklyn Nets","Armoni Brooks",0,0,0,0,0,0
0,0,0,0,0,0,0,0,0,"00",0,0,0,0,0,0,1037726,"2023-11-12T00:00:00.000Z",3,FALSE,30,174,"F-C",3,3,"Brooklyn Nets","Harry Giles III",0,0,0,0,0,0
4,0,5,7,3,8,3,2,1,"31",1,4,10,6,2,2,1037726,"2023-11-12T00:00:00.000Z",3,FALSE,30,351,"F",3,3,"Brooklyn Nets","Royce O'Neale",2,16,20,14,10,27.2
1,1,5,1,0,6,3,2,2,"19",7,1,8,12,1,1,1037726,"2023-11-12T00:00:00.000Z",3,FALSE,30,17896038,"C",3,3,"Brooklyn Nets","Day'Ron Sharpe",2,20,21,9,13,28.9
6,0,3,2,2,4,2,2,2,"19",1,1,8,4,0,4,1037726,"2023-11-12T00:00:00.000Z",3,FALSE,30,421,"G",3,3,"Brooklyn Nets","Dennis Smith Jr.",0,12,18,14,10,17.8
2,0,2,3,1,8,2,0,0,"14",0,1,5,2,0,1,1037726,"2023-11-12T00:00:00.000Z",3,FALSE,30,464,"G",3,3,"Brooklyn Nets","Lonnie Walker IV",0,7,9,7,4,9.4
1,0,3,0,0,3,1,0,0,"09",0,2,2,3,0,1,1037726,"2023-11-12T00:00:00.000Z",3,FALSE,30,17896058,"F",3,3,"Brooklyn Nets","Trendon Watford",0,5,6,3,4,6.1
0,0,0,0,0,0,0,0,0,"00",0,0,0,0,0,0,1037726,"2023-11-12T00:00:00.000Z",3,FALSE,30,56677843,"F",3,3,"Brooklyn Nets","Noah Clowney",0,0,0,0,0,0
0,0,0,0,0,0,0,0,0,"00",0,0,0,0,0,0,1037726,"2023-11-12T00:00:00.000Z",3,FALSE,30,17896041,"G",3,3,"Brooklyn Nets","Keon Johnson",0,0,0,0,0,0
0,0,0,0,0,0,0,0,0,"00",0,0,0,0,0,0,1037726,"2023-11-12T00:00:00.000Z",3,FALSE,30,417,"G-F",3,3,"Brooklyn Nets","Ben Simmons",0,0,0,0,0,0
0,0,0,0,0,0,0,0,0,"00",0,0,0,0,0,0,1037726,"2023-11-12T00:00:00.000Z",3,FALSE,30,56677841,"F",3,3,"Brooklyn Nets","Dariq Whitehead",0,0,0,0,0,0
0,0,0,0,0,0,0,0,0,"00",0,0,0,0,0,0,1037726,"2023-11-12T00:00:00.000Z",3,FALSE,30,56677722,"F",3,3,"Brooklyn Nets","Jalen Wilson",0,0,0,0,0,0
3,0,7,8,1,18,6,2,1,"38",2,2,14,9,3,2,1037726,"2023-11-12T00:00:00.000Z",3,FALSE,30,3547242,"F",30,30,"Washington Wizards","Deni Avdija",3,23,26,17,12,36.3
3,2,4,5,0,16,4,10,7,"31",0,2,15,4,1,1,1037726,"2023-11-12T00:00:00.000Z",3,FALSE,30,265,"F",30,30,"Washington Wizards","Kyle Kuzma",3,19,22,18,7,32.3
0,0,3,0,0,3,2,2,1,"16",2,1,5,5,2,1,1037726,"2023-11-12T00:00:00.000Z",3,FALSE,30,666577,"F",30,30,"Washington Wizards","Daniel Gafford",2,10,10,5,5,16
2,1,5,8,2,12,5,1,0,"32",0,6,12,5,0,3,1037726,"2023-11-12T00:00:00.000Z",3,FALSE,30,666848,"G",30,30,"Washington Wizards","Jordan Poole",1,17,19,14,7,21
1,0,1,1,0,5,0,0,0,"23",0,1,0,1,2,1,1037726,"2023-11-12T00:00:00.000Z",3,FALSE,30,249,"G",30,30,"Washington Wizards","Tyus Jones",2,1,2,1,2,7.7
0,0,0,0,0,0,0,0,0,"00",0,0,0,0,0,0,1037726,"2023-11-12T00:00:00.000Z",3,FALSE,30,38017704,"F",30,30,"Washington Wizards","Patrick Baldwin Jr.",0,0,0,0,0,0
0,0,0,0,0,0,0,0,0,"00",0,0,0,0,0,0,1037726,"2023-11-12T00:00:00.000Z",3,FALSE,30,18677954,"G",30,30,"Washington Wizards","Jared Butler",0,0,0,0,0,0
3,0,6,7,4,12,8,1,0,"34",1,0,20,7,4,2,1037726,"2023-11-12T00:00:00.000Z",3,FALSE,30,56677844,"G",30,30,"Washington Wizards","Bilal Coulibaly",4,27,30,23,10,42.9
0,0,0,0,0,0,0,0,0,"00",0,0,0,0,0,0,1037726,"2023-11-12T00:00:00.000Z",3,FALSE,30,38017687,"G",30,30,"Washington Wizards","Johnny Davis",0,0,0,0,0,0
3,0,3,3,1,7,3,5,5,"20",0,1,12,3,1,0,1037726,"2023-11-12T00:00:00.000Z",3,FALSE,30,167,"F",30,30,"Washington Wizards","Danilo Gallinari",1,15,18,15,6,23.1
0,0,0,0,0,0,0,0,0,"00",0,0,0,0,0,0,1037726,"2023-11-12T00:00:00.000Z",3,FALSE,30,3547302,"F",30,30,"Washington Wizards","Anthony Gill",0,0,0,0,0,0
4,0,2,5,0,8,2,4,4,"26",1,1,8,3,1,1,1037726,"2023-11-12T00:00:00.000Z",3,FALSE,30,17896045,"F",30,30,"Washington Wizards","Corey Kispert",1,11,15,12,7,19.6
0,0,0,0,0,0,0,0,0,"00",0,0,0,0,0,0,1037726,"2023-11-12T00:00:00.000Z",3,FALSE,30,337,"F-C",30,30,"Washington Wizards","Mike Muscala",0,0,0,0,0,0
0,0,0,0,0,0,0,0,0,"00",0,0,0,0,0,0,1037726,"2023-11-12T00:00:00.000Z",3,FALSE,30,38017712,"G",30,30,"Washington Wizards","Ryan Rollins",0,0,0,0,0,0
1,0,4,4,2,7,3,0,0,"20",1,1,8,5,0,1,1037726,"2023-11-12T00:00:00.000Z",3,FALSE,30,414,"G",30,30,"Washington Wizards","Landry Shamet",0,13,14,9,6,14.5
0,0,0,0,0,0,0,0,0,"00",0,0,0,0,0,0,1037726,"2023-11-12T00:00:00.000Z",3,FALSE,30,38124126,"F",30,30,"Washington Wizards","John Butler Jr.",0,0,0,0,0,0
0,0,0,0,0,0,0,0,0,"00",0,0,0,0,0,0,1037726,"2023-11-12T00:00:00.000Z",3,FALSE,30,17896106,"F",30,30,"Washington Wizards","Eugene Omoruyi",0,0,0,0,0,0
0,0,0,0,0,0,0,0,0,"00",0,0,0,0,0,0,1037726,"2023-11-12T00:00:00.000Z",3,FALSE,30,487,"G",30,30,"Washington Wizards","Delon Wright",0,0,0,0,0,0
0,0,0,0,0,0,0,0,0,"00",0,0,0,0,0,0,1037726,"2023-11-12T00:00:00.000Z",3,FALSE,30,17896048,"G",3,3,"Brooklyn Nets","Cam Thomas",0,0,0,0,0,0
7,0,6,7,3,16,8,9,7,"37",1,5,26,7,2,7,1037727,"2023-11-12T00:00:00.000Z",13,FALSE,15,172,"F",13,13,"LA Clippers","Paul George",2,33,40,33,14,43.9
3,2,4,4,1,16,6,2,1,"37",1,3,14,5,1,0,1037727,"2023-11-12T00:00:00.000Z",13,FALSE,15,274,"F",13,13,"LA Clippers","Kawhi Leonard",3,19,22,17,8,33.5
1,0,6,0,0,4,2,2,2,"23",0,3,6,6,1,1,1037727,"2023-11-12T00:00:00.000Z",13,FALSE,15,493,"C",13,13,"LA Clippers","Ivica Zubac",1,12,13,7,7,16.7
3,1,2,7,1,12,4,2,2,"29",2,0,11,4,1,1,1037727,"2023-11-12T00:00:00.000Z",13,FALSE,15,192,"G",13,13,"LA Clippers","James Harden",2,15,18,14,7,25.3
5,0,8,4,1,13,5,2,1,"31",1,3,12,9,3,4,1037727,"2023-11-12T00:00:00.000Z",13,FALSE,15,472,"G",13,13,"LA Clippers","Russell Westbrook",3,21,26,17,14,35.3
0,0,0,0,0,0,0,0,0,"00",0,0,0,0,0,0,1037727,"2023-11-12T00:00:00.000Z",13,FALSE,15,56677849,"F",13,13,"LA Clippers","Kobe Brown",0,0,0,0,0,0
0,0,0,0,0,0,0,0,0,"00",0,0,0,0,0,0,1037727,"2023-11-12T00:00:00.000Z",13,FALSE,15,666511,"G",13,13,"LA Clippers","Amir Coffey",0,0,0,0,0,0
0,0,2,0,0,2,1,0,0,"12",1,1,2,3,0,0,1037727,"2023-11-12T00:00:00.000Z",13,FALSE,15,38017725,"F",13,13,"LA Clippers","Moussa Diabate",0,5,5,2,3,5.6
0,0,0,0,0,0,0,0,0,"00",0,0,0,0,0,0,1037727,"2023-11-12T00:00:00.000Z",13,FALSE,15,17896031,"G",13,13,"LA Clippers","Nah'Shon Hyland",0,0,0,0,0,0
3,0,2,3,1,7,3,0,0,"27",1,2,7,3,0,1,1037727,"2023-11-12T00:00:00.000Z",13,FALSE,15,666743,"G",13,13,"LA Clippers","Terance Mann",0,10,13,10,6,14.1
3,0,2,7,4,13,7,6,2,"31",0,5,20,2,0,0,1037727,"2023-11-12T00:00:00.000Z",13,FALSE,15,380,"F-G",13,13,"LA Clippers","Norman Powell",0,22,25,23,5,26.9
1,0,1,2,1,2,1,0,0,"13",1,1,3,2,1,0,1037727,"2023-11-12T00:00:00.000Z",13,FALSE,15,450,"F",13,13,"LA Clippers","PJ Tucker",1,5,6,4,3,9.9
0,0,0,0,0,0,0,0,0,"00",0,0,0,0,0,0,1037727,"2023-11-12T00:00:00.000Z",13,FALSE,15,17896022,"G",13,13,"LA Clippers","Brandon Boston Jr.",0,0,0,0,0,0
0,0,0,0,0,0,0,0,0,"00",0,0,0,0,0,0,1037727,"2023-11-12T00:00:00.000Z",13,FALSE,15,56677856,"G",13,13,"LA Clippers","Jordan Miller",0,0,0,0,0,0
0,0,0,0,0,0,0,0,0,"00",0,0,0,0,0,0,1037727,"2023-11-12T00:00:00.000Z",13,FALSE,15,371,"F-C",13,13,"LA Clippers","Mason Plumlee",0,0,0,0,0,0
0,0,0,0,0,0,0,0,0,"00",0,0,0,0,0,0,1037727,"2023-11-12T00:00:00.000Z",13,FALSE,15,17896051,"G",13,13,"LA Clippers","Joshua Primo",0,0,0,0,0,0
6,1,3,11,3,24,10,6,4,"35",1,4,27,4,0,4,1037727,"2023-11-12T00:00:00.000Z",13,FALSE,15,3547287,"G",15,15,"Memphis Grizzlies","Desmond Bane",1,31,37,33,10,39.8
1,1,4,3,0,15,3,6,6,"29",0,4,12,4,1,3,1037727,"2023-11-12T00:00:00.000Z",13,FALSE,15,231,"F-C",15,15,"Memphis Grizzlies","Jaren Jackson Jr.",2,16,17,13,5,21.3
3,2,8,0,0,6,5,7,3,"36",4,3,13,12,1,1,1037727,"2023-11-12T00:00:00.000Z",13,FALSE,15,48,"C",15,15,"Memphis Grizzlies","Bismack Biyombo",3,25,28,16,15,39.9
7,0,3,7,3,12,5,4,4,"36",0,3,17,3,0,5,1037727,"2023-11-12T00:00:00.000Z",13,FALSE,15,420,"G",15,15,"Memphis Grizzlies","Marcus Smart",0,20,27,24,10,26.1
0,1,2,1,0,7,4,0,0,"21",4,1,8,6,1,0,1037727,"2023-11-12T00:00:00.000Z",13,FALSE,15,38017729,"F",15,15,"Memphis Grizzlies","David Roddy",2,14,14,8,6,21.2
0,0,0,0,0,0,0,0,0,"00",0,0,0,0,0,0,1037727,"2023-11-12T00:00:00.000Z",13,FALSE,15,38017731,"G",15,15,"Memphis Grizzlies","Vince Williams Jr.",0,0,0,0,0,0
3,0,4,6,2,6,2,0,0,"24",1,3,6,5,3,0,1037727,"2023-11-12T00:00:00.000Z",13,FALSE,15,48248287,"G",15,15,"Memphis Grizzlies","Jacob Gilyard",3,11,14,9,8,25.5
2,1,3,4,1,8,4,0,0,"21",0,1,9,3,0,2,1037727,"2023-11-12T00:00:00.000Z",13,FALSE,15,17896067,"F",15,15,"Memphis Grizzlies","Santi Aldama",1,12,14,11,5,16.6
2,0,1,5,4,5,4,1,1,"24",0,1,13,1,1,0,1037727,"2023-11-12T00:00:00.000Z",13,FALSE,15,254,"G",15,15,"Memphis Grizzlies","Luke Kennard",1,14,16,15,3,20.2
0,0,2,1,0,1,0,0,0,"05",0,2,0,2,0,1,1037727,"2023-11-12T00:00:00.000Z",13,FALSE,15,666703,"G-F",15,15,"Memphis Grizzlies","John Konchar",0,2,2,0,2,1.4
0,0,0,0,0,0,0,0,0,"00",0,0,0,0,0,0,1037727,"2023-11-12T00:00:00.000Z",13,FALSE,15,38017732,"F",15,15,"Memphis Grizzlies","Kenneth Lofton Jr.",0,0,0,0,0,0
1,0,0,3,0,4,0,0,0,"09",1,1,0,1,0,0,1037727,"2023-11-12T00:00:00.000Z",13,FALSE,15,17896027,"G-F",15,15,"Memphis Grizzlies","Ziaire Williams",0,1,2,1,2,2.7
0,0,0,0,0,0,0,0,0,"00",0,0,0,0,0,0,1037727,"2023-11-12T00:00:00.000Z",13,FALSE,15,3,"C",15,15,"Memphis Grizzlies","Steven Adams",0,0,0,0,0,0
0,0,0,0,0,0,0,0,0,"00",0,0,0,0,0,0,1037727,"2023-11-12T00:00:00.000Z",13,FALSE,15,666505,"F",15,15,"Memphis Grizzlies","Brandon Clarke",0,0,0,0,0,0
0,0,0,0,0,0,0,0,0,"00",0,0,0,0,0,0,1037727,"2023-11-12T00:00:00.000Z",13,FALSE,15,56677830,"F",15,15,"Memphis Grizzlies","GG Jackson",0,0,0,0,0,0
0,0,0,0,0,0,0,0,0,"00",0,0,0,0,0,0,1037727,"2023-11-12T00:00:00.000Z",13,FALSE,15,38017728,"F",15,15,"Memphis Grizzlies","Jake LaRavia",0,0,0,0,0,0
0,0,0,0,0,0,0,0,0,"00",0,0,0,0,0,0,1037727,"2023-11-12T00:00:00.000Z",13,FALSE,15,666786,"G",15,15,"Memphis Grizzlies","Ja Morant",0,0,0,0,0,0
0,0,0,0,0,0,0,0,0,"00",0,0,0,0,0,0,1037727,"2023-11-12T00:00:00.000Z",13,FALSE,15,401,"G",15,15,"Memphis Grizzlies","Derrick Rose",0,0,0,0,0,0
0,0,0,0,0,0,0,0,0,"00",0,0,0,0,0,0,1037727,"2023-11-12T00:00:00.000Z",13,FALSE,15,3547285,"F",15,15,"Memphis Grizzlies","Xavier Tillman",0,0,0,0,0,0
0,3,5,5,3,5,3,0,0,"33",2,2,9,7,1,1,1037728,"2023-11-12T00:00:00.000Z",23,FALSE,12,33,"F-G",23,23,"Philadelphia 76ers","Nicolas Batum",4,16,16,9,7,28.4
4,0,5,3,0,20,9,0,0,"36",4,2,18,9,0,1,1037728,"2023-11-12T00:00:00.000Z",23,FALSE,12,200,"F",23,23,"Philadelphia 76ers","Tobias Harris",0,27,31,22,13,33.8
7,1,5,4,1,26,12,14,12,"33",8,2,37,13,1,3,1037728,"2023-11-12T00:00:00.000Z",23,FALSE,12,145,"F-C",23,23,"Philadelphia 76ers","Joel Embiid",2,50,57,44,20,66.1
6,0,3,3,1,7,4,1,1,"30",1,1,10,4,0,2,1037728,"2023-11-12T00:00:00.000Z",23,FALSE,12,313,"G",23,23,"Philadelphia 76ers","De'Anthony Melton",0,14,20,16,10,21.8
5,3,4,11,7,32,20,3,3,"39",3,2,50,7,0,2,1037728,"2023-11-12T00:00:00.000Z",23,FALSE,12,3547254,"G",23,23,"Philadelphia 76ers","Tyrese Maxey",3,57,62,55,12,72.9
0,0,0,0,0,0,0,0,0,"00",0,0,0,0,0,0,1037728,"2023-11-12T00:00:00.000Z",23,FALSE,12,28,"C",23,23,"Philadelphia 76ers","Mo Bamba",0,0,0,0,0,0
1,0,1,4,1,4,1,0,0,"17",1,3,3,2,1,0,1037728,"2023-11-12T00:00:00.000Z",23,FALSE,12,45,"G",23,23,"Philadelphia 76ers","Patrick Beverley",1,5,6,4,3,9.9
2,0,3,2,0,5,1,0,0,"16",2,1,2,5,0,0,1037728,"2023-11-12T00:00:00.000Z",23,FALSE,12,108,"F",23,23,"Philadelphia 76ers","Robert Covington",0,7,9,4,7,11
0,0,1,1,1,1,1,2,1,"16",0,0,4,1,0,1,1037728,"2023-11-12T00:00:00.000Z",23,FALSE,12,2175,"",23,23,"Philadelphia 76ers","Danuel House Jr.",0,5,5,4,1,4.2
0,0,0,0,0,1,0,0,0,"05",0,0,0,0,1,1,1037728,"2023-11-12T00:00:00.000Z",23,FALSE,12,260,"G-F",23,23,"Philadelphia 76ers","Furkan Korkmaz",1,0,0,0,0,2
3,0,4,0,0,4,2,0,0,"15",2,2,4,6,1,0,1037728,"2023-11-12T00:00:00.000Z",23,FALSE,12,3547270,"F",23,23,"Philadelphia 76ers","Paul Reed",1,10,13,7,9,18.7
0,0,0,0,0,0,0,0,0,"00",0,0,0,0,0,0,1037728,"2023-11-12T00:00:00.000Z",23,FALSE,12,360,"F",23,23,"Philadelphia 76ers","Kelly Oubre Jr.",0,0,0,0,0,0
0,0,0,0,0,0,0,0,0,"00",0,0,0,0,0,0,1037728,"2023-11-12T00:00:00.000Z",23,FALSE,12,17554001,"G",23,23,"Philadelphia 76ers","Javonte Smart",0,0,0,0,0,0
0,0,0,0,0,0,0,0,0,"00",0,0,0,0,0,0,1037728,"2023-11-12T00:00:00.000Z",23,FALSE,12,56677788,"G",23,23,"Philadelphia 76ers","Terquavion Smith",0,0,0,0,0,0
1,1,4,3,0,11,4,3,1,"26",1,1,9,5,0,1,1037728,"2023-11-12T00:00:00.000Z",23,FALSE,12,38017686,"G-F",12,12,"Indiana Pacers","Bennedict Mathurin",1,14,15,10,6,18.5
0,0,0,0,0,0,0,0,0,"00",0,0,0,0,0,0,1037728,"2023-11-12T00:00:00.000Z",23,FALSE,12,3547294,"F",23,23,"Philadelphia 76ers","Kenyon Martin Jr.",0,0,0,0,0,0
0,0,0,0,0,0,0,0,0,"00",0,0,0,0,0,0,1037728,"2023-11-12T00:00:00.000Z",23,FALSE,12,328,"F",23,23,"Philadelphia 76ers","Marcus Morris",0,0,0,0,0,0
0,0,0,0,0,0,0,0,0,"00",0,0,0,0,0,0,1037728,"2023-11-12T00:00:00.000Z",23,FALSE,12,17896025,"G",23,23,"Philadelphia 76ers","Jaden Springer",0,0,0,0,0,0
0,0,0,0,0,0,0,0,0,"00",0,0,0,0,0,0,1037728,"2023-11-12T00:00:00.000Z",23,FALSE,12,56913527,"G",23,23,"Philadelphia 76ers","Ricky Council IV",0,0,0,0,0,0
0,0,0,0,0,0,0,0,0,"00",0,0,0,0,0,0,1037728,"2023-11-12T00:00:00.000Z",23,FALSE,12,56677778,"F-C",12,12,"Indiana Pacers","Oscar Tshiebwe",0,0,0,0,0,0
0,0,0,0,0,0,0,0,0,"00",0,0,0,0,0,0,1037728,"2023-11-12T00:00:00.000Z",23,FALSE,12,56677794,"G",12,12,"Indiana Pacers","Isaiah Wong",0,0,0,0,0,0
0,0,0,0,0,0,0,0,0,"00",0,0,0,0,0,0,1037728,"2023-11-12T00:00:00.000Z",23,FALSE,12,56677861,"G",12,12,"Indiana Pacers","Ben Sheppard",0,0,0,0,0,0
0,0,0,0,0,0,0,0,0,"00",0,0,0,0,0,0,1037728,"2023-11-12T00:00:00.000Z",23,FALSE,12,439,"F",13,12,"Indiana Pacers","Daniel Theis",0,0,0,0,0,0
0,0,0,0,0,0,0,0,0,"00",0,0,0,0,0,0,1037728,"2023-11-12T00:00:00.000Z",23,FALSE,12,56677832,"F",12,12,"Indiana Pacers","Jarace Walker",0,0,0,0,0,0
0,0,0,0,0,0,0,0,0,"00",0,0,0,0,0,0,1037728,"2023-11-12T00:00:00.000Z",23,FALSE,12,38017701,"G",12,12,"Indiana Pacers","Kendall Brown",0,0,0,0,0,0
1,0,1,3,2,7,6,0,0,"21",0,2,14,1,0,0,1037728,"2023-11-12T00:00:00.000Z",23,FALSE,12,3547243,"F",12,12,"Indiana Pacers","Obi Toppin",0,15,16,15,2,16.7
0,3,3,9,4,17,7,4,4,"29",2,4,22,5,1,3,1037728,"2023-11-12T00:00:00.000Z",23,FALSE,12,452,"C-F",12,12,"Indiana Pacers","Myles Turner",4,27,27,22,5,37
3,2,2,1,0,5,3,4,3,"31",2,1,9,4,0,0,1037728,"2023-11-12T00:00:00.000Z",23,FALSE,12,69,"G",12,12,"Indiana Pacers","Bruce Brown",2,13,16,12,7,24.3
17,1,1,6,3,14,9,4,4,"36",0,0,25,1,2,0,1037728,"2023-11-12T00:00:00.000Z",23,FALSE,12,3547245,"G",12,12,"Indiana Pacers","Tyrese Haliburton",3,26,43,42,18,60.7
3,1,3,8,4,13,6,0,0,"21",1,0,16,4,1,0,1037728,"2023-11-12T00:00:00.000Z",23,FALSE,12,210,"G",12,12,"Indiana Pacers","Buddy Hield",2,20,23,19,7,31.3
3,0,3,5,2,6,3,0,0,"26",1,3,8,4,1,0,1037728,"2023-11-12T00:00:00.000Z",23,FALSE,12,3547250,"G-F",12,12,"Indiana Pacers","Aaron Nesmith",1,12,15,11,7,20.3
1,0,5,2,1,7,4,2,2,"19",1,2,11,6,0,2,1037728,"2023-11-12T00:00:00.000Z",23,FALSE,12,3547264,"F-C",12,12,"Indiana Pacers","Jalen Smith",0,17,18,12,7,17.7
1,0,0,2,0,4,2,0,0,"14",0,0,4,0,0,3,1037728,"2023-11-12T00:00:00.000Z",23,FALSE,12,38017507,"G-F",12,12,"Indiana Pacers","Andrew Nembhard",0,4,5,5,1,2.5
1,1,2,0,0,6,3,2,2,"17",0,1,8,2,3,1,1037728,"2023-11-12T00:00:00.000Z",23,FALSE,12,304,"G",12,12,"Indiana Pacers","T.J. McConnell",4,10,11,9,3,22.9
0,0,0,0,0,0,0,0,0,"00",0,0,0,0,0,0,1037728,"2023-11-12T00:00:00.000Z",23,FALSE,12,17896035,"F",12,12,"Indiana Pacers","Isaiah Jackson",0,0,0,0,0,0
0,0,0,0,0,0,0,0,0,"00",0,0,0,0,0,0,1037728,"2023-11-12T00:00:00.000Z",23,FALSE,12,3547207,"F",12,12,"Indiana Pacers","Jordan Nwora",0,0,0,0,0,0
1,4,0,3,2,19,11,5,5,"37",1,1,29,1,0,0,1037729,"2023-11-12T00:00:00.000Z",5,FALSE,9,125,"G",5,5,"Chicago Bulls","DeMar DeRozan",4,30,31,30,2,43.7
1,0,7,4,1,6,1,0,0,"31",3,3,3,10,1,0,1037729,"2023-11-12T00:00:00.000Z",5,FALSE,9,110,"F",5,5,"Chicago Bulls","Torrey Craig",1,13,14,4,11,19.5
4,1,10,7,3,17,8,2,2,"33",2,2,21,12,2,1,1037729,"2023-11-12T00:00:00.000Z",5,FALSE,9,460,"C",5,5,"Chicago Bulls","Nikola Vucevic",3,33,37,25,16,49.4
2,0,3,6,1,14,6,6,6,"34",0,1,19,3,1,0,1037729,"2023-11-12T00:00:00.000Z",5,FALSE,9,268,"G",5,5,"Chicago Bulls","Zach LaVine",1,22,24,21,5,28.6
7,0,0,6,3,14,6,2,1,"32",0,6,16,0,1,1,1037729,"2023-11-12T00:00:00.000Z",5,FALSE,9,666956,"G",5,5,"Chicago Bulls","Coby White",1,16,23,23,7,28.5
2,0,0,2,1,4,1,0,0,"12",0,2,3,0,0,2,1037729,"2023-11-12T00:00:00.000Z",5,FALSE,9,87,"G",5,5,"Chicago Bulls","Jevon Carter",0,3,5,5,2,4
3,0,1,1,0,7,6,2,1,"27",0,3,13,1,4,0,1037729,"2023-11-12T00:00:00.000Z",5,FALSE,9,17895983,"G",5,5,"Chicago Bulls","Ayo Dosunmu",4,14,17,16,4,30.7
1,0,8,0,0,8,5,2,1,"15",5,2,11,13,2,1,1037729,"2023-11-12T00:00:00.000Z",5,FALSE,9,137,"C",5,5,"Chicago Bulls","Andre Drummond",2,24,25,12,14,33.1
0,0,0,0,0,0,0,0,0,"00",0,0,0,0,0,0,1037729,"2023-11-12T00:00:00.000Z",5,FALSE,9,56677857,"F",5,5,"Chicago Bulls","Julian Phillips",0,0,0,0,0,0
0,0,0,0,0,0,0,0,0,"00",0,0,0,0,0,0,1037729,"2023-11-12T00:00:00.000Z",5,FALSE,9,17896116,"G",5,5,"Chicago Bulls","Terry Taylor",0,0,0,0,0,0
0,1,0,1,0,2,0,6,4,"19",0,1,4,0,1,1,1037729,"2023-11-12T00:00:00.000Z",5,FALSE,9,3547248,"F",5,5,"Chicago Bulls","Patrick Williams",2,4,4,4,0,9
0,0,0,0,0,0,0,0,0,"00",0,0,0,0,0,0,1037729,"2023-11-12T00:00:00.000Z",5,FALSE,9,27,"G",5,5,"Chicago Bulls","Lonzo Ball",0,0,0,0,0,0
0,0,0,0,0,0,0,0,0,"00",0,0,0,0,0,0,1037729,"2023-11-12T00:00:00.000Z",5,FALSE,9,56677874,"F",5,5,"Chicago Bulls","Onuralp Bitim",0,0,0,0,0,0
5,2,3,5,0,15,4,2,2,"38",0,4,10,3,0,1,1037729,"2023-11-12T00:00:00.000Z",5,FALSE,9,17896075,"G-F",9,9,"Detroit Pistons","Cade Cunningham",2,13,18,15,8,26.1
3,0,3,3,1,8,3,0,0,"25",0,1,7,3,0,0,1037729,"2023-11-12T00:00:00.000Z",5,FALSE,9,3547241,"G",9,9,"Detroit Pistons","Killian Hayes",0,10,13,10,6,15.1
4,0,2,6,2,7,3,9,8,"21",1,2,16,3,0,0,1037729,"2023-11-12T00:00:00.000Z",5,FALSE,9,77,"G",9,9,"Detroit Pistons","Alec Burks",0,19,23,20,7,25.6
0,0,0,0,0,0,0,0,0,"00",0,0,0,0,0,0,1037729,"2023-11-12T00:00:00.000Z",5,FALSE,9,38017694,"C",9,9,"Detroit Pistons","Jalen Duren",0,0,0,0,0,0
0,0,0,0,0,0,0,0,0,"00",0,0,0,0,0,0,1037729,"2023-11-12T00:00:00.000Z",5,FALSE,9,197,"F-G",9,9,"Detroit Pistons","Joe Harris",0,0,0,0,0,0
2,0,0,2,0,4,2,2,2,"12",0,1,6,0,1,1,1037729,"2023-11-12T00:00:00.000Z",5,FALSE,9,38017682,"G",9,9,"Detroit Pistons","Jaden Ivey",1,6,8,8,2,11
1,0,3,5,4,8,7,0,0,"24",0,2,18,3,1,1,1037729,"2023-11-12T00:00:00.000Z",5,FALSE,9,259,"F",9,9,"Detroit Pistons","Kevin Knox",1,21,22,19,4,25.1
6,0,3,3,1,6,2,0,0,"20",0,1,5,3,1,2,1037729,"2023-11-12T00:00:00.000Z",5,FALSE,9,56677792,"G",9,9,"Detroit Pistons","Marcus Sasser",1,8,14,11,9,18.6
0,0,0,0,0,0,0,0,0,"00",0,0,0,0,0,0,1037729,"2023-11-12T00:00:00.000Z",5,FALSE,9,44477024,"G",9,9,"Detroit Pistons","Stanley Umude",0,0,0,0,0,0
0,2,1,1,0,6,3,0,0,"14",1,3,6,2,1,2,1037729,"2023-11-12T00:00:00.000Z",5,FALSE,9,3547240,"C",9,9,"Detroit Pistons","James Wiseman",3,8,8,6,2,15.4
0,0,0,0,0,0,0,0,0,"00",0,0,0,0,0,0,1037729,"2023-11-12T00:00:00.000Z",5,FALSE,9,54,"F",9,9,"Detroit Pistons","Bojan Bogdanovic",0,0,0,0,0,0
0,0,0,0,0,0,0,0,0,"00",0,0,0,0,0,0,1037729,"2023-11-12T00:00:00.000Z",5,FALSE,9,56677729,"G",9,9,"Detroit Pistons","Malcolm Cazalon",0,0,0,0,0,0
0,0,0,0,0,0,0,0,0,"00",0,0,0,0,0,0,1037729,"2023-11-12T00:00:00.000Z",5,FALSE,9,17896071,"F",9,9,"Detroit Pistons","Isaiah Livers",0,0,0,0,0,0
0,0,0,0,0,0,0,0,0,"00",0,0,0,0,0,0,1037729,"2023-11-12T00:00:00.000Z",5,FALSE,9,330,"G",9,9,"Detroit Pistons","Monte Morris",0,0,0,0,0,0
0,0,0,0,0,0,0,0,0,"00",0,0,0,0,0,0,1037729,"2023-11-12T00:00:00.000Z",5,FALSE,9,42097199,"G",9,9,"Detroit Pistons","Jared Rhoden",0,0,0,0,0,0
0,0,0,0,0,0,0,0,0,"00",0,0,0,0,0,0,1037729,"2023-11-12T00:00:00.000Z",5,FALSE,9,89,"G",5,5,"Chicago Bulls","Alex Caruso",0,0,0,0,0,0
0,0,0,0,0,0,0,0,0,"00",0,0,0,0,0,0,1037729,"2023-11-12T00:00:00.000Z",5,FALSE,9,45969255,"F",5,5,"Chicago Bulls","Justin Lewis",0,0,0,0,0,0
0,0,0,0,0,0,0,0,0,"00",0,0,0,0,0,0,1037729,"2023-11-12T00:00:00.000Z",5,FALSE,9,56677860,"F",5,5,"Chicago Bulls","Adama Sanogo",0,0,0,0,0,0
0,0,0,0,0,0,0,0,0,"00",0,0,0,0,0,0,1037729,"2023-11-12T00:00:00.000Z",5,FALSE,9,38017719,"F",5,5,"Chicago Bulls","Dalen Terry",0,0,0,0,0,0
2,1,10,1,0,9,2,7,5,"32",6,1,9,16,0,3,1037729,"2023-11-12T00:00:00.000Z",5,FALSE,9,56677826,"G-F",9,9,"Detroit Pistons","Ausar Thompson",1,25,27,11,18,31.2
2,0,5,5,3,13,6,4,2,"31",5,3,17,10,0,3,1037729,"2023-11-12T00:00:00.000Z",5,FALSE,9,3547267,"F-C",9,9,"Detroit Pistons","Isaiah Stewart",0,27,29,19,12,29
1,1,3,1,0,12,6,2,2,"23",3,1,14,6,0,3,1037729,"2023-11-12T00:00:00.000Z",5,FALSE,9,24,"F",9,9,"Detroit Pistons","Marvin Bagley III",1,20,21,15,7,22.7
2,0,4,3,1,6,3,4,3,"29",0,4,10,4,0,3,1037730,"2023-11-12T00:00:00.000Z",11,FALSE,8,66,"G-F",11,11,"Houston Rockets","Dillon Brooks",0,14,16,12,6,14.8
0,1,5,2,0,7,4,0,0,"20",2,1,8,7,0,1,1037730,"2023-11-12T00:00:00.000Z",11,FALSE,8,38017684,"F",11,11,"Houston Rockets","Jabari Smith Jr.",1,15,15,8,7,18.4
5,2,4,2,0,18,9,6,5,"35",4,2,23,8,1,3,1037730,"2023-11-12T00:00:00.000Z",11,FALSE,8,17896062,"F-C",11,11,"Houston Rockets","Alperen Sengun",3,31,36,28,13,46.1
5,0,8,4,1,13,1,6,6,"35",0,1,9,8,1,0,1037730,"2023-11-12T00:00:00.000Z",11,FALSE,8,17895966,"G",11,11,"Houston Rockets","Jalen Green",1,17,22,14,13,29.1
4,0,2,9,3,21,9,7,5,"41",0,2,26,2,0,2,1037730,"2023-11-12T00:00:00.000Z",11,FALSE,8,458,"G",11,11,"Houston Rockets","Fred VanVleet",0,28,32,30,6,32.4
2,0,2,5,1,8,2,0,0,"17",0,1,5,2,0,0,1037730,"2023-11-12T00:00:00.000Z",11,FALSE,8,213,"G",11,11,"Houston Rockets","Aaron Holiday",0,7,9,7,4,10.4
0,0,3,0,0,3,1,2,1,"20",3,2,3,6,3,0,1037730,"2023-11-12T00:00:00.000Z",11,FALSE,8,3547301,"F",11,11,"Houston Rockets","Jae'Sean Tate",3,9,9,3,6,19.2
1,0,0,2,0,2,0,0,0,"08",0,2,0,0,0,0,1037730,"2023-11-12T00:00:00.000Z",11,FALSE,8,56677776,"G",8,8,"Denver Nuggets","Julian Strawther",0,0,1,1,1,1.5
0,0,0,0,0,0,0,0,0,"00",0,0,0,0,0,0,1037730,"2023-11-12T00:00:00.000Z",11,FALSE,8,215,"F-G",8,8,"Denver Nuggets","Justin Holiday",0,0,0,0,0,0
0,0,0,0,0,0,0,0,0,"00",0,0,0,0,0,0,1037730,"2023-11-12T00:00:00.000Z",11,FALSE,8,250,"C",8,8,"Denver Nuggets","DeAndre Jordan",0,0,0,0,0,0
0,0,0,0,0,0,0,0,0,"00",0,0,0,0,0,0,1037730,"2023-11-12T00:00:00.000Z",11,FALSE,8,17896007,"G",8,8,"Denver Nuggets","Braxton Key",0,0,0,0,0,0
0,0,2,1,0,4,1,0,0,"11",2,0,2,4,0,0,1037730,"2023-11-12T00:00:00.000Z",11,FALSE,8,3547268,"F-C",8,8,"Denver Nuggets","Zeke Nnaji",0,6,6,2,4,6.8
0,0,0,0,0,0,0,0,0,"00",0,0,0,0,0,0,1037730,"2023-11-12T00:00:00.000Z",11,FALSE,8,56677582,"G",8,8,"Denver Nuggets","Jalen Pickett",0,0,0,0,0,0
1,1,0,0,0,2,0,0,0,"07",0,2,0,0,0,0,1037730,"2023-11-12T00:00:00.000Z",11,FALSE,8,38017721,"G",8,8,"Denver Nuggets","Peyton Watson",1,0,1,1,1,4.5
0,0,0,0,0,0,0,0,0,"00",0,0,0,0,0,0,1037730,"2023-11-12T00:00:00.000Z",11,FALSE,8,666489,"F",8,8,"Denver Nuggets","Vlatko Cancar",0,0,0,0,0,0
0,0,0,0,0,0,0,0,0,"00",0,0,0,0,0,0,1037730,"2023-11-12T00:00:00.000Z",11,FALSE,8,17896103,"F-C",8,8,"Denver Nuggets","Jay Huff",0,0,0,0,0,0
0,0,0,0,0,0,0,0,0,"00",0,0,0,0,0,0,1037730,"2023-11-12T00:00:00.000Z",11,FALSE,8,335,"G",8,8,"Denver Nuggets","Jamal Murray",0,0,0,0,0,0
0,0,0,0,0,0,0,0,0,"00",0,0,0,0,0,0,1037730,"2023-11-12T00:00:00.000Z",11,FALSE,8,56677871,"F",8,8,"Denver Nuggets","Hunter Tyson",0,0,0,0,0,0
11,1,15,6,2,26,13,8,8,"38",6,3,36,21,0,3,1037730,"2023-11-12T00:00:00.000Z",11,FALSE,8,246,"C",8,8,"Denver Nuggets","Nikola Jokic",1,57,68,47,32,77.7
1,0,0,2,1,5,2,0,0,"38",0,3,5,0,1,1,1037730,"2023-11-12T00:00:00.000Z",11,FALSE,8,81,"G",8,8,"Denver Nuggets","Kentavious Caldwell-Pope",1,5,6,6,1,8.5
0,0,0,0,0,0,0,0,0,"02",1,1,0,1,0,0,1037730,"2023-11-12T00:00:00.000Z",11,FALSE,8,19465326,"C",11,11,"Houston Rockets","Jock Landale",0,1,1,0,1,1.2
2,0,2,3,2,4,3,0,0,"16",1,1,8,3,1,0,1037730,"2023-11-12T00:00:00.000Z",11,FALSE,8,38017695,"F",11,11,"Houston Rockets","Tari Eason",1,11,13,10,5,17.6
0,1,3,4,2,7,5,4,3,"25",1,1,15,4,1,0,1037730,"2023-11-12T00:00:00.000Z",11,FALSE,8,188,"F",11,11,"Houston Rockets","Jeff Green",2,19,19,15,4,25.8
0,0,0,0,0,0,0,0,0,"00",0,0,0,0,0,0,1037730,"2023-11-12T00:00:00.000Z",11,FALSE,8,75,"G-F",11,11,"Houston Rockets","Reggie Bullock",0,0,0,0,0,0
0,0,0,0,0,0,0,0,0,"00",0,0,0,0,0,0,1037730,"2023-11-12T00:00:00.000Z",11,FALSE,8,296,"C",11,11,"Houston Rockets","Boban Marjanovic",0,0,0,0,0,0
0,0,0,0,0,0,0,0,0,"00",0,0,0,0,0,0,1037730,"2023-11-12T00:00:00.000Z",11,FALSE,8,47738533,"G",11,11,"Houston Rockets","Jeenathan Williams",0,0,0,0,0,0
0,0,0,0,0,0,0,0,0,"00",0,0,0,0,0,0,1037730,"2023-11-12T00:00:00.000Z",11,FALSE,8,3547281,"G-F",11,11,"Houston Rockets","Nate Hinton",0,0,0,0,0,0
0,0,0,0,0,0,0,0,0,"00",0,0,0,0,0,0,1037730,"2023-11-12T00:00:00.000Z",11,FALSE,8,357,"G",11,11,"Houston Rockets","Victor Oladipo",0,0,0,0,0,0
0,0,0,0,0,0,0,0,0,"00",0,0,0,0,0,0,1037730,"2023-11-12T00:00:00.000Z",11,FALSE,8,56677809,"F",11,11,"Houston Rockets","Jermaine Samuels Jr.",0,0,0,0,0,0
0,0,0,0,0,0,0,0,0,"00",0,0,0,0,0,0,1037730,"2023-11-12T00:00:00.000Z",11,FALSE,8,56677825,"G-F",11,11,"Houston Rockets","Amen Thompson",0,0,0,0,0,0
0,0,0,0,0,0,0,0,0,"00",0,0,0,0,0,0,1037730,"2023-11-12T00:00:00.000Z",11,FALSE,8,56677831,"F",11,11,"Houston Rockets","Cam Whitmore",0,0,0,0,0,0
0,1,8,10,3,19,11,0,0,"38",2,3,25,10,0,2,1037730,"2023-11-12T00:00:00.000Z",11,FALSE,8,375,"F",8,8,"Denver Nuggets","Michael Porter Jr.",1,35,35,25,10,38
5,2,7,2,1,10,6,6,3,"38",1,2,16,8,0,2,1037730,"2023-11-12T00:00:00.000Z",11,FALSE,8,177,"F",8,8,"Denver Nuggets","Aaron Gordon",2,24,29,21,13,37.1
3,0,1,2,0,9,3,0,0,"20",1,2,6,2,2,1,1037730,"2023-11-12T00:00:00.000Z",11,FALSE,8,38017727,"G",8,8,"Denver Nuggets","Collin Gillespie",2,8,11,9,5,17.9
0,0,0,2,0,2,0,0,0,"14",0,1,0,0,0,1,1037730,"2023-11-12T00:00:00.000Z",11,FALSE,8,38017709,"G",8,8,"Denver Nuggets","Christian Braun",0,0,0,0,0,-1
2,0,4,5,2,12,6,0,0,"28",0,2,14,4,0,1,1037730,"2023-11-12T00:00:00.000Z",11,FALSE,8,236,"G",8,8,"Denver Nuggets","Reggie Jackson",0,18,20,16,6,20.8
5,0,5,3,1,17,9,4,1,"31",0,2,20,5,0,1,1037731,"2023-11-12T00:00:00.000Z",19,FALSE,7,227,"F",19,19,"New Orleans Pelicans","Brandon Ingram",0,25,30,25,10,32.5
4,0,1,0,0,11,7,8,4,"27",1,3,18,2,1,6,1037731,"2023-11-12T00:00:00.000Z",19,FALSE,7,666969,"F",19,19,"New Orleans Pelicans","Zion Williamson",1,20,24,22,6,23.4
3,2,8,5,3,11,6,0,0,"21",2,0,15,10,0,0,1037731,"2023-11-12T00:00:00.000Z",19,FALSE,7,455,"C",19,19,"New Orleans Pelicans","Jonas Valanciunas",2,25,28,18,13,37.5
2,0,2,9,2,13,3,2,2,"27",0,1,10,2,0,2,1037731,"2023-11-12T00:00:00.000Z",19,FALSE,7,56677837,"G",19,19,"New Orleans Pelicans","Jordan Hawkins",0,12,14,12,4,13.4
4,0,7,6,3,12,7,0,0,"31",2,3,17,9,0,3,1037731,"2023-11-12T00:00:00.000Z",19,FALSE,7,38017677,"G",19,19,"New Orleans Pelicans","Dyson Daniels",0,26,30,21,13,30.8
4,0,0,0,0,5,2,1,1,"08",1,0,5,1,0,1,1037731,"2023-11-12T00:00:00.000Z",19,FALSE,7,3547260,"G",19,19,"New Orleans Pelicans","Kira Lewis Jr.",0,6,10,9,5,11.2
2,0,1,1,1,3,2,3,3,"14",1,2,8,2,0,2,1037731,"2023-11-12T00:00:00.000Z",19,FALSE,7,3547293,"F",19,19,"New Orleans Pelicans","Naji Marshall",0,10,12,10,4,11.4
0,0,2,1,0,2,0,0,0,"07",1,1,0,3,0,1,1037731,"2023-11-12T00:00:00.000Z",19,FALSE,7,340,"F",19,19,"New Orleans Pelicans","Larry Nance Jr.",0,3,3,0,3,2.6
1,0,5,5,3,8,4,0,0,"26",1,2,11,6,1,1,1037731,"2023-11-12T00:00:00.000Z",19,FALSE,7,17896021,"F",19,19,"New Orleans Pelicans","Jeremiah Robinson-Earl",1,17,18,12,7,21.7
2,0,3,6,4,7,5,0,0,"27",3,3,14,6,0,0,1037731,"2023-11-12T00:00:00.000Z",19,FALSE,7,17896017,"F",19,19,"New Orleans Pelicans","Matt Ryan",0,20,22,16,8,24.2
2,1,3,0,0,1,1,2,1,"08",0,2,3,3,0,0,1037731,"2023-11-12T00:00:00.000Z",19,FALSE,7,38017726,"G",19,19,"New Orleans Pelicans","Dereon Seabron",1,6,8,5,5,12.6
2,0,4,0,0,2,1,2,1,"13",1,1,3,5,0,1,1037731,"2023-11-12T00:00:00.000Z",19,FALSE,7,491,"C",19,19,"New Orleans Pelicans","Cody Zeller",0,8,10,5,7,11
0,0,0,0,0,0,0,0,0,"00",0,0,0,0,0,0,1037731,"2023-11-12T00:00:00.000Z",19,FALSE,7,17896097,"G",19,19,"New Orleans Pelicans","Jose Alvarado",0,0,0,0,0,0
0,0,0,0,0,0,0,0,0,"00",0,0,0,0,0,0,1037731,"2023-11-12T00:00:00.000Z",19,FALSE,7,17896024,"F",19,19,"New Orleans Pelicans","Herbert Jones",0,0,0,0,0,0
0,0,0,0,0,0,0,0,0,"00",0,0,0,0,0,0,1037731,"2023-11-12T00:00:00.000Z",19,FALSE,7,38017663,"F",19,19,"New Orleans Pelicans","E.J. Liddell",0,0,0,0,0,0
0,0,0,0,0,0,0,0,0,"00",0,0,0,0,0,0,1037731,"2023-11-12T00:00:00.000Z",19,FALSE,7,303,"G",19,19,"New Orleans Pelicans","CJ McCollum",0,0,0,0,0,0
0,0,0,0,0,0,0,0,0,"00",0,0,0,0,0,0,1037731,"2023-11-12T00:00:00.000Z",19,FALSE,7,18677986,"F",19,19,"New Orleans Pelicans","Trey Murphy III",0,0,0,0,0,0
2,0,1,6,2,6,2,2,1,"22",0,0,7,1,0,1,1037731,"2023-11-12T00:00:00.000Z",19,FALSE,7,247,"F-G",7,7,"Dallas Mavericks","Derrick Jones Jr.",0,8,10,9,3,10.2
1,2,1,2,0,4,0,0,0,"21",1,1,0,2,1,0,1037731,"2023-11-12T00:00:00.000Z",19,FALSE,7,666965,"F",7,7,"Dallas Mavericks","Grant Williams",3,2,3,1,3,12.9
0,2,1,0,0,5,4,4,2,"26",1,5,10,2,1,1,1037731,"2023-11-12T00:00:00.000Z",19,FALSE,7,56677840,"C",7,7,"Dallas Mavericks","Dereck Lively II",3,12,12,10,2,20.4
7,1,5,10,7,20,13,2,2,"29",1,1,35,6,0,1,1037731,"2023-11-12T00:00:00.000Z",19,FALSE,7,228,"G",7,7,"Dallas Mavericks","Kyrie Irving",1,41,48,42,13,54.7
9,0,4,9,4,18,11,5,4,"28",0,0,30,4,1,2,1037731,"2023-11-12T00:00:00.000Z",19,FALSE,7,132,"F-G",7,7,"Dallas Mavericks","Luka Doncic",1,34,43,39,13,49.3
2,0,9,10,3,14,4,4,4,"28",0,1,15,9,0,0,1037731,"2023-11-12T00:00:00.000Z",19,FALSE,7,191,"G",7,7,"Dallas Mavericks","Tim Hardaway Jr.",0,24,26,17,11,28.8
2,0,7,0,0,4,3,2,1,"18",3,4,7,10,1,0,1037731,"2023-11-12T00:00:00.000Z",19,FALSE,7,379,"F-C",7,7,"Dallas Mavericks","Dwight Powell",1,17,19,9,12,25
3,0,2,7,3,11,5,0,0,"28",0,1,13,2,2,1,1037731,"2023-11-12T00:00:00.000Z",19,FALSE,7,3547258,"G",7,7,"Dallas Mavericks","Josh Green",2,15,18,16,5,24.9
1,1,1,0,0,6,3,0,0,"13",0,2,6,1,1,0,1037731,"2023-11-12T00:00:00.000Z",19,FALSE,7,151,"G",7,7,"Dallas Mavericks","Dante Exum",2,7,8,7,2,14.7
0,0,0,1,0,2,0,0,0,"06",1,0,0,1,0,0,1037731,"2023-11-12T00:00:00.000Z",19,FALSE,7,114,"G",7,7,"Dallas Mavericks","Seth Curry",0,1,1,0,1,1.2
2,0,1,4,1,6,3,0,0,"07",1,1,7,2,0,0,1037731,"2023-11-12T00:00:00.000Z",19,FALSE,7,38017679,"G",7,7,"Dallas Mavericks","Jaden Hardy",0,9,11,9,4,12.4
0,0,1,0,0,1,1,0,0,"04",0,1,2,1,0,0,1037731,"2023-11-12T00:00:00.000Z",19,FALSE,7,217,"F-C",7,7,"Dallas Mavericks","Richaun Holmes",0,3,3,2,1,3.2
0,0,1,2,0,2,0,0,0,"04",0,0,0,1,0,0,1037731,"2023-11-12T00:00:00.000Z",19,FALSE,7,329,"F",7,7,"Dallas Mavericks","Markieff Morris",0,1,1,0,1,1.2
0,0,0,2,0,3,1,2,2,"06",0,2,4,0,0,0,1037731,"2023-11-12T00:00:00.000Z",19,FALSE,7,56677859,"F",7,7,"Dallas Mavericks","Olivier-Maxence Prosper",0,4,4,4,0,4
0,0,0,0,0,0,0,0,0,"00",0,0,0,0,0,0,1037731,"2023-11-12T00:00:00.000Z",19,FALSE,7,17896028,"F",7,7,"Dallas Mavericks","Greg Brown III",0,0,0,0,0,0
0,0,0,0,0,0,0,0,0,"00",0,0,0,0,0,0,1037731,"2023-11-12T00:00:00.000Z",19,FALSE,7,56677873,"G",7,7,"Dallas Mavericks","Dexter Dennis",0,0,0,0,0,0
0,0,0,0,0,0,0,0,0,"00",0,0,0,0,0,0,1037731,"2023-11-12T00:00:00.000Z",19,FALSE,7,257,"F",7,7,"Dallas Mavericks","Maxi Kleber",0,0,0,0,0,0
0,0,0,0,0,0,0,0,0,"00",0,0,0,0,0,0,1037731,"2023-11-12T00:00:00.000Z",19,FALSE,7,17554004,"G",7,7,"Dallas Mavericks","AJ Lawson",0,0,0,0,0,0
0,0,0,0,0,0,0,0,0,"00",0,0,0,0,0,0,1037732,"2023-11-12T00:00:00.000Z",27,FALSE,16,56677870,"G",27,27,"San Antonio Spurs","Sir'Jabari Rice",0,0,0,0,0,0
4,1,4,3,1,14,5,9,8,"37",2,1,19,6,0,2,1037732,"2023-11-12T00:00:00.000Z",27,FALSE,16,79,"G-F",16,16,"Miami Heat","Jimmy Butler",1,25,29,23,10,33.2
1,0,3,3,0,4,0,0,0,"26",1,3,0,4,0,0,1037732,"2023-11-12T00:00:00.000Z",27,FALSE,16,3092,"",16,16,"Miami Heat","Haywood Highsmith",0,4,5,1,5,6.3
6,0,7,0,0,20,10,5,4,"34",4,0,24,11,3,0,1037732,"2023-11-12T00:00:00.000Z",27,FALSE,16,4,"C-F",16,16,"Miami Heat","Bam Adebayo",3,35,41,30,17,55.2
4,1,4,7,4,16,8,6,6,"39",1,1,26,5,0,0,1037732,"2023-11-12T00:00:00.000Z",27,FALSE,16,397,"F",16,16,"Miami Heat","Duncan Robinson",1,31,35,30,9,41
4,0,3,4,2,7,4,2,2,"26",0,2,12,3,1,0,1037732,"2023-11-12T00:00:00.000Z",27,FALSE,16,391,"G-F",16,16,"Miami Heat","Josh Richardson",1,15,19,16,7,24.6
3,1,5,2,1,10,4,2,2,"32",1,1,11,6,4,1,1037732,"2023-11-12T00:00:00.000Z",27,FALSE,16,56677785,"G",16,16,"Miami Heat","Jaime Jaquez Jr.",5,17,20,14,9,36.7
0,0,2,7,2,8,3,4,4,"14",0,2,12,2,0,0,1037732,"2023-11-12T00:00:00.000Z",27,FALSE,16,285,"F-C",16,16,"Miami Heat","Kevin Love",0,14,14,12,2,14.4
6,1,12,10,3,18,8,1,1,"37",0,2,20,12,1,1,1037732,"2023-11-12T00:00:00.000Z",27,FALSE,16,666682,"F",27,27,"San Antonio Spurs","Keldon Johnson",2,32,38,26,18,48.4
7,1,10,9,2,22,8,0,0,"35",1,3,18,11,1,7,1037732,"2023-11-12T00:00:00.000Z",27,FALSE,16,56677822,"F-C",27,27,"San Antonio Spurs","Victor Wembanyama",2,29,36,25,18,40.7
2,1,3,4,1,14,6,6,5,"33",2,4,18,5,0,3,1037732,"2023-11-12T00:00:00.000Z",27,FALSE,16,102,"F-C",27,27,"San Antonio Spurs","Zach Collins",1,23,25,20,7,27
4,0,5,9,4,12,5,0,0,"33",2,0,14,7,0,1,1037732,"2023-11-12T00:00:00.000Z",27,FALSE,16,3547246,"G-F",27,27,"San Antonio Spurs","Devin Vassell",0,21,25,18,11,27.4
3,2,4,3,2,9,6,2,2,"34",1,4,16,5,0,3,1037732,"2023-11-12T00:00:00.000Z",27,FALSE,16,38017699,"F",27,27,"San Antonio Spurs","Jeremy Sochan",2,21,24,19,8,29.5
1,0,2,0,0,2,1,2,1,"06",3,2,3,5,1,1,1037732,"2023-11-12T00:00:00.000Z",27,FALSE,16,17895854,"G",27,27,"San Antonio Spurs","Charles Bassey",1,8,9,4,6,12.5
7,0,1,5,4,7,4,1,1,"21",0,2,13,1,0,1,1037732,"2023-11-12T00:00:00.000Z",27,FALSE,16,38017692,"F",27,27,"San Antonio Spurs","Malaki Branham",0,14,21,20,8,23.7
0,1,0,1,1,3,1,0,0,"20",1,2,3,1,0,0,1037732,"2023-11-12T00:00:00.000Z",27,FALSE,16,359,"F",27,27,"San Antonio Spurs","Cedi Osman",1,4,4,3,1,7.2
0,0,0,0,0,0,0,0,0,"00",0,0,0,0,0,0,1037732,"2023-11-12T00:00:00.000Z",27,FALSE,16,286,"G",16,16,"Miami Heat","Kyle Lowry",0,0,0,0,0,0
0,0,0,0,0,0,0,0,0,"00",0,0,0,0,0,0,1037732,"2023-11-12T00:00:00.000Z",27,FALSE,16,666747,"F",16,16,"Miami Heat","Caleb Martin",0,0,0,0,0,0
3,0,2,5,2,9,4,2,2,"27",2,2,12,4,0,1,1037732,"2023-11-12T00:00:00.000Z",27,FALSE,16,19465585,"G",16,16,"Miami Heat","Dru Smith",0,16,19,15,7,20.3
1,0,0,0,0,1,1,0,0,"05",0,0,2,0,0,0,1037732,"2023-11-12T00:00:00.000Z",27,FALSE,16,74,"C",16,16,"Miami Heat","Thomas Bryant",0,2,3,3,1,3.5
0,0,0,0,0,0,0,0,0,"00",0,0,0,0,0,0,1037732,"2023-11-12T00:00:00.000Z",27,FALSE,16,38017696,"F",16,16,"Miami Heat","Nikola Jovic",0,0,0,0,0,0
0,0,0,0,0,0,0,0,0,"00",0,0,0,0,0,0,1037732,"2023-11-12T00:00:00.000Z",27,FALSE,16,39398582,"C",16,16,"Miami Heat","Orlando Robinson",0,0,0,0,0,0
0,0,0,0,0,0,0,0,0,"00",0,0,0,0,0,0,1037732,"2023-11-12T00:00:00.000Z",27,FALSE,16,38017736,"F",16,16,"Miami Heat","Cole Swider",0,0,0,0,0,0
0,0,0,0,0,0,0,0,0,"00",0,0,0,0,0,0,1037732,"2023-11-12T00:00:00.000Z",27,FALSE,16,38017734,"F",16,16,"Miami Heat","Jamal Cain",0,0,0,0,0,0
0,0,0,0,0,0,0,0,0,"00",0,0,0,0,0,0,1037732,"2023-11-12T00:00:00.000Z",27,FALSE,16,56677817,"G",27,27,"San Antonio Spurs","Sidy Cissoko",0,0,0,0,0,0
0,0,0,0,0,0,0,0,0,"00",0,0,0,0,0,0,1037732,"2023-11-12T00:00:00.000Z",27,FALSE,16,3547274,"G",27,27,"San Antonio Spurs","Tre Jones",0,0,0,0,0,0
5,0,2,3,2,4,3,0,0,"21",1,2,8,3,0,0,1037732,"2023-11-12T00:00:00.000Z",27,FALSE,16,305,"F",27,27,"San Antonio Spurs","Doug McDermott",0,11,16,13,8,19.1
0,0,0,0,0,0,0,0,0,"00",0,0,0,0,0,0,1037732,"2023-11-12T00:00:00.000Z",27,FALSE,16,38017649,"F",27,27,"San Antonio Spurs","Julian Champagnie",0,0,0,0,0,0
0,0,0,0,0,0,0,0,0,"00",0,0,0,0,0,0,1037732,"2023-11-12T00:00:00.000Z",27,FALSE,16,180,"G",27,27,"San Antonio Spurs","Devonte' Graham",0,0,0,0,0,0
0,0,0,0,0,0,0,0,0,"00",0,0,0,0,0,0,1037732,"2023-11-12T00:00:00.000Z",27,FALSE,16,17896059,"F",27,27,"San Antonio Spurs","Sandro Mamukelashvili",0,0,0,0,0,0
0,0,0,0,0,0,0,0,0,"00",0,0,0,0,0,0,1037732,"2023-11-12T00:00:00.000Z",27,FALSE,16,38017693,"G",27,27,"San Antonio Spurs","Blake Wesley",0,0,0,0,0,0
0,0,0,0,0,0,0,0,0,"00",0,0,0,0,0,0,1037732,"2023-11-12T00:00:00.000Z",27,FALSE,16,38017730,"F",27,27,"San Antonio Spurs","Dominick Barlow",0,0,0,0,0,0
0,0,0,0,0,0,0,0,0,"00",0,0,0,0,0,0,1037732,"2023-11-12T00:00:00.000Z",27,FALSE,16,56677865,"C",27,27,"San Antonio Spurs","Charles Bediako",0,0,0,0,0,0
0,0,0,0,0,0,0,0,0,"00",0,0,0,0,0,0,1037732,"2023-11-12T00:00:00.000Z",27,FALSE,16,3547257,"G",16,16,"Miami Heat","R.J. Hampton",0,0,0,0,0,0
0,0,0,0,0,0,0,0,0,"00",0,0,0,0,0,0,1037732,"2023-11-12T00:00:00.000Z",27,FALSE,16,666633,"G",16,16,"Miami Heat","Tyler Herro",0,0,0,0,0,0
0,0,0,0,0,0,0,0,0,"00",0,0,0,0,0,0,1037733,"2023-11-12T00:00:00.000Z",24,FALSE,21,57,"G",24,24,"Phoenix Suns","Devin Booker",0,0,0,0,0,0
0,0,0,0,0,0,0,0,0,"00",0,0,0,0,0,0,1037733,"2023-11-12T00:00:00.000Z",24,FALSE,21,178,"G",24,24,"Phoenix Suns","Eric Gordon",0,0,0,0,0,0
0,0,0,0,0,0,0,0,0,"00",0,0,0,0,0,0,1037733,"2023-11-12T00:00:00.000Z",24,FALSE,21,272,"G",24,24,"Phoenix Suns","Damion Lee",0,0,0,0,0,0
1,1,4,5,0,10,3,4,3,"33",2,5,9,6,3,0,1037733,"2023-11-12T00:00:00.000Z",24,FALSE,21,666541,"G",21,21,"Oklahoma City Thunder","Luguentz Dort",4,15,16,10,7,29.7
1,0,1,4,3,16,11,8,6,"38",0,4,31,1,2,1,1037733,"2023-11-12T00:00:00.000Z",24,FALSE,21,38017703,"G-F",21,21,"Oklahoma City Thunder","Jalen Williams",2,32,33,32,2,38.7
4,2,6,6,3,10,5,5,5,"33",0,3,18,6,0,0,1037733,"2023-11-12T00:00:00.000Z",24,FALSE,21,38017685,"C-F",21,21,"Oklahoma City Thunder","Chet Holmgren",2,24,28,22,10,37.2
10,2,3,1,0,12,5,0,0,"32",3,1,10,6,1,4,1037733,"2023-11-12T00:00:00.000Z",24,FALSE,21,17896065,"G",21,21,"Oklahoma City Thunder","Josh Giddey",3,16,26,20,16,37.2
0,0,0,1,0,1,0,0,0,"01",0,0,0,0,0,0,1037733,"2023-11-12T00:00:00.000Z",24,FALSE,21,314,"F",24,24,"Phoenix Suns","Chimezie Metu",0,0,0,0,0,0
2,0,0,2,2,2,2,0,0,"17",0,1,6,0,0,0,1037733,"2023-11-12T00:00:00.000Z",24,FALSE,21,470,"G",24,24,"Phoenix Suns","Yuta Watanabe",0,6,8,8,2,9
1,1,1,2,0,3,0,8,8,"21",1,1,8,2,0,1,1037733,"2023-11-12T00:00:00.000Z",24,FALSE,21,356,"G",24,24,"Phoenix Suns","Josh Okogie",1,10,11,9,3,13.9
4,2,9,5,3,18,7,11,11,"36",0,1,28,9,1,3,1037733,"2023-11-12T00:00:00.000Z",24,FALSE,21,140,"F",24,24,"Phoenix Suns","Kevin Durant",3,37,41,32,13,50.8
1,2,5,3,0,6,1,2,1,"26",3,3,3,8,2,2,1037733,"2023-11-12T00:00:00.000Z",24,FALSE,21,349,"C",24,24,"Phoenix Suns","Jusuf Nurkic",4,11,12,4,9,24.1
1,1,4,3,1,8,2,2,2,"32",2,2,7,6,0,2,1037733,"2023-11-12T00:00:00.000Z",24,FALSE,21,8,"G",24,24,"Phoenix Suns","Grayson Allen",1,13,14,8,7,16.7
5,0,7,5,0,18,6,6,3,"30",1,5,15,8,0,5,1037733,"2023-11-12T00:00:00.000Z",24,FALSE,21,37,"G",24,24,"Phoenix Suns","Bradley Beal",0,23,28,20,13,27.1
0,0,0,0,0,0,0,0,0,"00",0,0,0,0,0,0,1037733,"2023-11-12T00:00:00.000Z",24,FALSE,21,3547095,"C-F",24,24,"Phoenix Suns","Udoka Azubuike",0,0,0,0,0,0
2,0,4,1,0,9,3,0,0,"27",4,3,6,8,0,1,1037733,"2023-11-12T00:00:00.000Z",24,FALSE,21,32,"F",24,24,"Phoenix Suns","Keita Bates-Diop",0,14,16,8,10,17.6
0,0,0,0,0,0,0,0,0,"00",0,0,0,0,0,0,1037733,"2023-11-12T00:00:00.000Z",24,FALSE,21,666451,"C",24,24,"Phoenix Suns","Bol Bol",0,0,0,0,0,0
1,0,1,0,0,9,7,2,1,"21",4,1,15,5,0,2,1037733,"2023-11-12T00:00:00.000Z",24,FALSE,21,147,"F",24,24,"Phoenix Suns","Drew Eubanks",0,20,21,16,6,20.5
3,1,4,7,3,10,4,0,0,"29",2,2,11,6,1,1,1037733,"2023-11-12T00:00:00.000Z",24,FALSE,21,18678058,"",24,24,"Phoenix Suns","Jordan Goodwin",2,17,20,14,9,27.7
0,0,0,0,0,0,0,0,0,"00",0,0,0,0,0,0,1037733,"2023-11-12T00:00:00.000Z",24,FALSE,21,3547298,"G",24,24,"Phoenix Suns","Saben Lee",0,0,0,0,0,0
0,0,0,0,0,0,0,0,0,"00",0,0,0,0,0,0,1037733,"2023-11-12T00:00:00.000Z",24,FALSE,21,666729,"F",24,24,"Phoenix Suns","Nassir Little",0,0,0,0,0,0
4,1,7,5,2,22,13,8,7,"37",0,3,35,7,1,1,1037733,"2023-11-12T00:00:00.000Z",24,FALSE,21,175,"G",21,21,"Oklahoma City Thunder","Shai Gilgeous-Alexander",2,42,46,39,11,54.4
0,0,0,0,0,0,0,0,0,"03",0,0,0,0,0,0,1037733,"2023-11-12T00:00:00.000Z",24,FALSE,21,44,"F",21,21,"Oklahoma City Thunder","Davis Bertans",0,0,0,0,0,0
0,0,0,1,0,1,0,0,0,"06",0,0,0,0,0,0,1037733,"2023-11-12T00:00:00.000Z",24,FALSE,21,38017716,"F",21,21,"Oklahoma City Thunder","Ousmane Dieng",0,0,0,0,0,0
1,1,1,2,1,3,1,0,0,"16",0,1,3,1,1,0,1037733,"2023-11-12T00:00:00.000Z",24,FALSE,21,3547272,"G",21,21,"Oklahoma City Thunder","Isaiah Joe",2,4,5,4,2,11.7
0,0,0,0,0,0,0,0,0,"00",0,0,0,0,0,0,1037733,"2023-11-12T00:00:00.000Z",24,FALSE,21,17896036,"G",21,21,"Oklahoma City Thunder","Tre Mann",0,0,0,0,0,0
0,0,0,0,0,0,0,0,0,"00",0,0,0,0,0,0,1037733,"2023-11-12T00:00:00.000Z",24,FALSE,21,4197029,"G",21,21,"Oklahoma City Thunder","Vasilije Micic",0,0,0,0,0,0
0,0,0,0,0,0,0,0,0,"00",0,0,0,0,0,0,1037733,"2023-11-12T00:00:00.000Z",24,FALSE,21,3547271,"C",21,21,"Oklahoma City Thunder","Aleksej Pokusevski",0,0,0,0,0,0
0,1,3,3,1,3,1,0,0,"13",1,0,3,4,0,1,1037733,"2023-11-12T00:00:00.000Z",24,FALSE,21,38017706,"F",21,21,"Oklahoma City Thunder","Jaylin Williams",1,7,7,3,4,9.8
1,0,0,0,0,1,0,0,0,"17",0,3,0,0,0,0,1037733,"2023-11-12T00:00:00.000Z",24,FALSE,21,56677833,"G",21,21,"Oklahoma City Thunder","Cason Wallace",0,0,1,1,1,1.5
1,0,2,0,0,4,1,0,0,"12",0,1,2,2,1,0,1037733,"2023-11-12T00:00:00.000Z",24,FALSE,21,17896078,"G",21,21,"Oklahoma City Thunder","Aaron Wiggins",1,4,5,3,3,8.9
0,0,0,0,0,0,0,0,0,"00",0,0,0,0,0,0,1037733,"2023-11-12T00:00:00.000Z",24,FALSE,21,56677853,"F",21,21,"Oklahoma City Thunder","Keyontae Johnson",0,0,0,0,0,0
0,0,0,0,0,0,0,0,0,"00",0,0,0,0,0,0,1037733,"2023-11-12T00:00:00.000Z",24,FALSE,21,24572055,"C",21,21,"Oklahoma City Thunder","Olivier Sarr",0,0,0,0,0,0
0,0,0,0,0,0,0,0,0,"00",0,0,0,0,0,0,1037733,"2023-11-12T00:00:00.000Z",24,FALSE,21,27924547,"F",21,21,"Oklahoma City Thunder","Lindy Waters III",0,0,0,0,0,0
0,0,0,0,0,0,0,0,0,"00",0,0,0,0,0,0,1037733,"2023-11-12T00:00:00.000Z",24,FALSE,21,480,"G-F",21,21,"Oklahoma City Thunder","Kenrich Williams",0,0,0,0,0,0
7,0,7,3,1,7,3,2,2,"24",2,5,9,9,1,2,1037734,"2023-11-12T00:00:00.000Z",10,FALSE,18,185,"F",10,10,"Golden State Warriors","Draymond Green",1,18,25,16,16,31.3
2,0,2,2,0,7,3,2,0,"26",2,4,6,4,1,1,1037734,"2023-11-12T00:00:00.000Z",10,FALSE,18,475,"F-G",10,10,"Golden State Warriors","Andrew Wiggins",1,10,12,8,6,15.8
0,0,1,0,0,3,1,0,0,"19",5,3,2,6,1,0,1037734,"2023-11-12T00:00:00.000Z",10,FALSE,18,282,"F",10,10,"Golden State Warriors","Kevon Looney",1,8,8,2,6,12.2
3,0,5,10,3,16,5,3,3,"33",0,1,16,5,1,1,1037734,"2023-11-12T00:00:00.000Z",10,FALSE,18,443,"G",10,10,"Golden State Warriors","Klay Thompson",1,21,24,19,8,28.5
3,0,4,13,5,25,11,12,11,"36",1,2,38,5,1,5,1037734,"2023-11-12T00:00:00.000Z",10,FALSE,18,115,"G",10,10,"Golden State Warriors","Stephen Curry",1,43,46,41,8,46.5
1,0,0,0,0,1,1,0,0,"01",0,0,2,0,0,0,1037734,"2023-11-12T00:00:00.000Z",10,FALSE,18,56677799,"F",10,10,"Golden State Warriors","Trayce Jackson-Davis",0,2,3,3,1,3.5
0,0,0,0,0,0,0,0,0,"00",0,0,0,0,0,0,1037734,"2023-11-12T00:00:00.000Z",10,FALSE,18,251,"G",10,10,"Golden State Warriors","Cory Joseph",0,0,0,0,0,0
5,0,1,2,0,3,0,2,2,"22",0,4,2,1,0,2,1037734,"2023-11-12T00:00:00.000Z",10,FALSE,18,367,"G",10,10,"Golden State Warriors","Chris Paul",0,3,8,7,6,8.7
2,0,2,0,0,2,2,0,0,"14",2,2,4,4,0,1,1037734,"2023-11-12T00:00:00.000Z",10,FALSE,18,2189,"",10,10,"Golden State Warriors","Gary Payton II",0,8,10,6,6,10.8
0,0,0,2,2,5,3,0,0,"01",1,0,8,1,1,0,1037734,"2023-11-12T00:00:00.000Z",10,FALSE,18,56677858,"G",10,10,"Golden State Warriors","Brandin Podziemski",1,9,9,8,1,12.2
1,0,7,4,1,10,5,0,0,"27",3,4,11,10,1,1,1037734,"2023-11-12T00:00:00.000Z",10,FALSE,18,407,"F",10,10,"Golden State Warriors","Dario Saric",1,21,22,12,11,26.5
0,0,0,0,0,0,0,0,0,"00",0,0,0,0,0,0,1037734,"2023-11-12T00:00:00.000Z",10,FALSE,18,17896070,"F",10,10,"Golden State Warriors","Usman Garuba",0,0,0,0,0,0
0,0,0,0,0,0,0,0,0,"00",0,0,0,0,0,0,1037734,"2023-11-12T00:00:00.000Z",10,FALSE,18,45658838,"G",10,10,"Golden State Warriors","Lester Quinones",0,0,0,0,0,0
0,0,0,0,0,0,0,0,0,"00",0,0,0,0,0,0,1037734,"2023-11-12T00:00:00.000Z",10,FALSE,18,398,"G",10,10,"Golden State Warriors","Jerome Robinson",0,0,0,0,0,0
0,0,0,0,0,0,0,0,0,"00",0,0,0,0,0,0,1037734,"2023-11-12T00:00:00.000Z",10,FALSE,18,57875092,"F",10,10,"Golden State Warriors","Gui Santos",0,0,0,0,0,0
0,0,1,3,0,11,2,7,6,"24",2,2,10,3,2,0,1037734,"2023-11-12T00:00:00.000Z",10,FALSE,18,17553979,"F",10,10,"Golden State Warriors","Jonathan Kuminga",2,13,13,10,3,19.6
0,0,2,4,0,6,1,0,0,"13",1,1,2,3,0,1,1037734,"2023-11-12T00:00:00.000Z",10,FALSE,18,17553992,"G",10,10,"Golden State Warriors","Moses Moody",0,5,5,2,3,4.6
1,0,0,2,1,8,6,0,0,"35",0,5,13,0,0,0,1037734,"2023-11-12T00:00:00.000Z",10,FALSE,18,3547259,"F",18,18,"Minnesota Timberwolves","Jaden McDaniels",0,13,14,14,1,14.5
3,1,12,3,2,14,8,3,3,"37",2,1,21,14,2,1,1037734,"2023-11-12T00:00:00.000Z",10,FALSE,18,447,"C",18,18,"Minnesota Timberwolves","Karl-Anthony Towns",3,35,38,24,17,50.3
3,5,6,0,0,7,4,8,2,"35",4,3,10,10,1,2,1037734,"2023-11-12T00:00:00.000Z",10,FALSE,18,176,"C",18,18,"Minnesota Timberwolves","Rudy Gobert",6,20,23,13,13,42.5
7,0,5,9,1,27,11,10,10,"38",1,0,33,6,2,4,1037734,"2023-11-12T00:00:00.000Z",10,FALSE,18,3547238,"G",18,18,"Minnesota Timberwolves","Anthony Edwards",2,39,46,40,13,52.7
9,0,4,5,1,7,3,1,1,"31",1,4,8,5,0,1,1037734,"2023-11-12T00:00:00.000Z",10,FALSE,18,104,"G",18,18,"Minnesota Timberwolves","Mike Conley",0,13,22,17,14,26.5
1,0,2,3,2,6,4,0,0,"17",0,2,10,2,2,0,1037734,"2023-11-12T00:00:00.000Z",10,FALSE,18,666400,"G",18,18,"Minnesota Timberwolves","Nickeil Alexander-Walker",2,12,13,11,3,19.9
1,0,4,0,0,4,4,2,0,"17",0,1,8,4,1,3,1037734,"2023-11-12T00:00:00.000Z",10,FALSE,18,12,"F",18,18,"Minnesota Timberwolves","Kyle Anderson",1,12,13,9,5,14.3
0,0,0,0,0,0,0,2,2,"01",0,0,2,0,0,0,1037734,"2023-11-12T00:00:00.000Z",10,FALSE,18,68,"F",18,18,"Minnesota Timberwolves","Troy Brown Jr.",0,2,2,2,0,2
2,0,5,5,2,8,3,2,2,"19",1,2,10,6,0,2,1037734,"2023-11-12T00:00:00.000Z",10,FALSE,18,667378,"F-C",18,18,"Minnesota Timberwolves","Naz Reid",0,16,18,12,8,18.2
0,0,0,0,0,0,0,0,0,"00",0,0,0,0,0,0,1037734,"2023-11-12T00:00:00.000Z",10,FALSE,18,17896056,"C",18,18,"Minnesota Timberwolves","Luka Garza",0,0,0,0,0,0
0,0,0,0,0,1,0,2,1,"10",0,1,1,0,0,1,1037734,"2023-11-12T00:00:00.000Z",10,FALSE,18,320,"G",18,18,"Minnesota Timberwolves","Shake Milton",0,1,1,1,0,0
0,0,0,0,0,0,0,0,0,"00",0,0,0,0,0,0,1037734,"2023-11-12T00:00:00.000Z",10,FALSE,18,38017715,"F",18,18,"Minnesota Timberwolves","Josh Minott",0,0,0,0,0,0
0,0,0,0,0,0,0,0,0,"00",0,0,0,0,0,0,1037734,"2023-11-12T00:00:00.000Z",10,FALSE,18,17895968,"F",18,18,"Minnesota Timberwolves","Daishen Nix",0,0,0,0,0,0
0,0,0,0,0,0,0,0,0,"00",0,0,0,0,0,0,1037734,"2023-11-12T00:00:00.000Z",10,FALSE,18,56677851,"G",18,18,"Minnesota Timberwolves","Jaylen Clark",0,0,0,0,0,0
0,0,0,0,0,0,0,0,0,"00",0,0,0,0,0,0,1037734,"2023-11-12T00:00:00.000Z",10,FALSE,18,666767,"G",18,18,"Minnesota Timberwolves","Jordan McLaughlin",0,0,0,0,0,0
0,0,0,0,0,0,0,0,0,"00",0,0,0,0,0,0,1037734,"2023-11-12T00:00:00.000Z",10,FALSE,18,56677782,"F",18,18,"Minnesota Timberwolves","Leonard Miller",0,0,0,0,0,0
0,0,0,0,0,0,0,0,0,"00",0,0,0,0,0,0,1037734,"2023-11-12T00:00:00.000Z",10,FALSE,18,38017700,"G",18,18,"Minnesota Timberwolves","Wendell Moore Jr.",0,0,0,0,0,0
2,1,6,3,1,10,7,3,3,"38",1,1,18,7,3,1,1037735,"2023-11-12T00:00:00.000Z",14,FALSE,25,666860,"F-G",14,14,"Los Angeles Lakers","Cameron Reddish",4,25,27,20,9,40.4
2,0,4,3,1,10,6,6,6,"33",1,1,19,5,2,1,1037735,"2023-11-12T00:00:00.000Z",14,FALSE,25,666609,"F",14,14,"Los Angeles Lakers","Rui Hachimura",2,24,26,21,7,33
6,3,11,1,0,20,10,12,10,"41",2,0,30,13,0,1,1037735,"2023-11-12T00:00:00.000Z",14,FALSE,25,117,"F-C",14,14,"Los Angeles Lakers","Anthony Davis",3,43,49,36,19,62.6
1,0,3,3,0,9,5,1,1,"33",0,2,11,3,1,1,1037735,"2023-11-12T00:00:00.000Z",14,FALSE,25,383,"F",14,14,"Los Angeles Lakers","Taurean Prince",1,14,15,12,4,18.1
11,0,4,3,0,14,5,2,1,"32",1,2,11,5,1,1,1037735,"2023-11-12T00:00:00.000Z",14,FALSE,25,405,"G",14,14,"Los Angeles Lakers","D'Angelo Russell",1,16,27,22,16,35.5
0,0,2,0,0,1,0,0,0,"13",1,0,0,3,1,1,1037735,"2023-11-12T00:00:00.000Z",14,FALSE,25,38017697,"G",14,14,"Los Angeles Lakers","Max Christie",1,3,3,0,3,5.6
0,0,0,0,0,0,0,0,0,"00",0,0,0,0,0,0,1037735,"2023-11-12T00:00:00.000Z",14,FALSE,25,56677867,"F",14,14,"Los Angeles Lakers","Alex Fudge",0,0,0,0,0,0
1,0,0,0,0,4,1,2,0,"07",0,3,2,0,0,1,1037735,"2023-11-12T00:00:00.000Z",14,FALSE,25,666626,"C",14,14,"Los Angeles Lakers","Jaxson Hayes",0,2,3,3,1,2.5
0,0,0,0,0,0,0,0,0,"00",0,0,0,0,0,0,1037735,"2023-11-12T00:00:00.000Z",14,FALSE,25,56677868,"G",14,14,"Los Angeles Lakers","D'Moi Hodge",0,0,0,0,0,0
0,0,0,0,0,0,0,0,0,"00",0,0,0,0,0,0,1037735,"2023-11-12T00:00:00.000Z",14,FALSE,25,56677836,"F",14,14,"Los Angeles Lakers","Maxwell Lewis",0,0,0,0,0,0
4,0,4,4,2,12,6,4,4,"28",0,0,18,4,0,1,1037735,"2023-11-12T00:00:00.000Z",14,FALSE,25,17553995,"G",14,14,"Los Angeles Lakers","Austin Reaves",0,22,26,22,8,27.8
4,0,3,6,3,15,7,2,2,"42",0,4,19,3,0,7,1037735,"2023-11-12T00:00:00.000Z",14,FALSE,25,38017690,"G",25,25,"Portland Trail Blazers","Shaedon Sharpe",0,22,26,23,7,21.6
12,0,4,4,0,13,7,2,1,"33",0,2,15,4,0,1,1037735,"2023-11-12T00:00:00.000Z",14,FALSE,25,3547289,"G",25,25,"Portland Trail Blazers","Skylar Mays",0,19,31,27,16,36.8
3,0,3,1,0,6,3,0,0,"12",1,0,6,4,0,1,1037735,"2023-11-12T00:00:00.000Z",14,FALSE,25,44477062,"G",25,25,"Portland Trail Blazers","Jamaree Bouyea",0,10,13,9,7,14.3
0,0,0,0,0,0,0,0,0,"00",0,0,0,0,0,0,1037735,"2023-11-12T00:00:00.000Z",14,FALSE,25,666476,"C",25,25,"Portland Trail Blazers","Moses Brown",0,0,0,0,0,0
2,1,2,2,0,3,1,0,0,"23",4,5,2,6,0,2,1037735,"2023-11-12T00:00:00.000Z",14,FALSE,25,56677850,"F",25,25,"Portland Trail Blazers","Toumani Camara",1,8,10,4,8,13.2
0,0,0,0,0,0,0,0,0,"00",0,0,0,0,0,0,1037735,"2023-11-12T00:00:00.000Z",14,FALSE,25,47957121,"F",25,25,"Portland Trail Blazers","Justin Minaya",0,0,0,0,0,0
0,0,0,0,0,0,0,0,0,"03",0,1,0,0,0,0,1037735,"2023-11-12T00:00:00.000Z",14,FALSE,25,56677791,"F",25,25,"Portland Trail Blazers","Kris Murray",0,0,0,0,0,0
1,1,5,6,3,17,8,5,4,"41",0,3,23,5,0,2,1037735,"2023-11-12T00:00:00.000Z",14,FALSE,25,182,"F",25,25,"Portland Trail Blazers","Jerami Grant",1,28,29,24,6,31.5
0,2,7,0,0,10,6,0,0,"34",0,2,12,7,0,2,1037735,"2023-11-12T00:00:00.000Z",14,FALSE,25,22,"C",25,25,"Portland Trail Blazers","Deandre Ayton",2,19,19,12,7,24.4
0,0,0,2,0,4,1,7,5,"15",1,2,7,1,0,1,1037735,"2023-11-12T00:00:00.000Z",14,FALSE,25,486,"F",14,14,"Los Angeles Lakers","Christian Wood",0,8,8,7,1,7.2
0,0,0,0,0,0,0,0,0,"00",0,0,0,0,0,0,1037735,"2023-11-12T00:00:00.000Z",14,FALSE,25,56677738,"C",14,14,"Los Angeles Lakers","Colin Castleton",0,0,0,0,0,0
0,0,0,0,0,0,0,0,0,"00",0,0,0,0,0,0,1037735,"2023-11-12T00:00:00.000Z",14,FALSE,25,56677835,"G",14,14,"Los Angeles Lakers","Jalen Hood-Schifino",0,0,0,0,0,0
0,0,0,0,0,0,0,0,0,"00",0,0,0,0,0,0,1037735,"2023-11-12T00:00:00.000Z",14,FALSE,25,237,"F",14,14,"Los Angeles Lakers","LeBron James",0,0,0,0,0,0
0,0,0,0,0,0,0,0,0,"00",0,0,0,0,0,0,1037735,"2023-11-12T00:00:00.000Z",14,FALSE,25,457,"F",14,14,"Los Angeles Lakers","Jarred Vanderbilt",0,0,0,0,0,0
0,0,0,0,0,0,0,0,0,"00",0,0,0,0,0,0,1037735,"2023-11-12T00:00:00.000Z",14,FALSE,25,1603383,"G",14,14,"Los Angeles Lakers","Gabe Vincent",0,0,0,0,0,0
3,2,2,8,4,9,5,0,0,"20",0,2,14,2,1,0,1037735,"2023-11-12T00:00:00.000Z",14,FALSE,25,666923,"G-F",25,25,"Portland Trail Blazers","Matisse Thybulle",3,16,19,17,5,29.9
3,1,3,8,3,10,4,0,0,"14",0,3,11,3,0,0,1037735,"2023-11-12T00:00:00.000Z",14,FALSE,25,56783340,"C",25,25,"Portland Trail Blazers","Duop Reath",1,14,17,14,6,22.1
0,0,0,0,0,0,0,0,0,"00",0,0,0,0,0,0,1037735,"2023-11-12T00:00:00.000Z",14,FALSE,25,56677829,"G-F",25,25,"Portland Trail Blazers","Rayan Rupert",0,0,0,0,0,0
0,0,0,0,0,0,0,0,0,"00",0,0,0,0,0,0,1037735,"2023-11-12T00:00:00.000Z",14,FALSE,25,17896120,"F",25,25,"Portland Trail Blazers","Ish Wainright",0,0,0,0,0,0
1,1,4,2,0,7,4,0,0,"18",0,3,8,4,1,0,1037735,"2023-11-12T00:00:00.000Z",14,FALSE,25,38017711,"F",25,25,"Portland Trail Blazers","Jabari Walker",2,12,13,9,5,20.3
0,0,0,0,0,0,0,0,0,"00",0,0,0,0,0,0,1037735,"2023-11-12T00:00:00.000Z",14,FALSE,25,65,"G",25,25,"Portland Trail Blazers","Malcolm Brogdon",0,0,0,0,0,0
0,0,0,0,0,0,0,0,0,"00",0,0,0,0,0,0,1037735,"2023-11-12T00:00:00.000Z",14,FALSE,25,56677747,"G",25,25,"Portland Trail Blazers","Scoot Henderson",0,0,0,0,0,0
0,0,0,0,0,0,0,0,0,"00",0,0,0,0,0,0,1037735,"2023-11-12T00:00:00.000Z",14,FALSE,25,419,"G",25,25,"Portland Trail Blazers","Anfernee Simons",0,0,0,0,0,0
0,0,0,0,0,0,0,0,0,"00",0,0,0,0,0,0,1037735,"2023-11-12T00:00:00.000Z",14,FALSE,25,476,"C-F",25,25,"Portland Trail Blazers","Robert Williams III",0,0,0,0,0,0
6,1,4,9,2,18,7,6,6,"37",1,3,22,5,1,3,1037736,"2023-11-13T00:00:00.000Z",2,FALSE,20,70,"G",2,2,"Boston Celtics","Jaylen Brown",2,27,33,28,11,40
7,0,5,12,5,23,13,5,4,"40",1,5,35,6,1,3,1037736,"2023-11-13T00:00:00.000Z",2,FALSE,20,434,"F",2,2,"Boston Celtics","Jayson Tatum",1,41,48,42,13,52.7
3,1,5,6,3,11,7,4,4,"33",1,5,21,6,0,1,1037736,"2023-11-13T00:00:00.000Z",2,FALSE,20,378,"F-C",2,2,"Boston Celtics","Kristaps Porzingis",1,27,30,24,9,34.7
4,1,1,3,1,7,1,0,0,"31",1,2,3,2,1,1,1037736,"2023-11-13T00:00:00.000Z",2,FALSE,20,473,"G",2,2,"Boston Celtics","Derrick White",2,5,9,7,6,16.4
2,0,3,5,3,9,5,1,1,"37",4,2,14,7,0,2,1037736,"2023-11-13T00:00:00.000Z",2,FALSE,20,214,"G",2,2,"Boston Celtics","Jrue Holiday",0,21,23,16,9,23.4
0,0,0,0,0,0,0,0,0,"00",0,0,0,0,0,0,1037736,"2023-11-13T00:00:00.000Z",2,FALSE,20,17896094,"G",2,2,"Boston Celtics","Dalano Banton",0,0,0,0,0,0
0,0,0,0,0,0,0,0,0,"00",0,0,0,0,0,0,1037736,"2023-11-13T00:00:00.000Z",2,FALSE,20,666468,"F",2,2,"Boston Celtics","Oshae Brissett",0,0,0,0,0,0
2,0,4,6,4,6,4,0,0,"21",0,0,12,4,0,0,1037736,"2023-11-13T00:00:00.000Z",2,FALSE,20,17896060,"F",2,2,"Boston Celtics","Sam Hauser",0,16,18,14,6,19.8
0,0,4,1,0,2,1,0,0,"22",0,2,2,4,0,1,1037736,"2023-11-13T00:00:00.000Z",2,FALSE,20,219,"C-F",2,2,"Boston Celtics","Al Horford",0,6,6,2,4,5.8
0,0,0,0,0,0,0,0,0,"00",0,0,0,0,0,0,1037736,"2023-11-13T00:00:00.000Z",2,FALSE,20,261,"F-C",2,2,"Boston Celtics","Luke Kornet",0,0,0,0,0,0
0,0,0,0,0,0,0,0,0,"00",0,0,0,0,0,0,1037736,"2023-11-13T00:00:00.000Z",2,FALSE,20,338,"G",2,2,"Boston Celtics","Svi Mykhailiuk",0,0,0,0,0,0
3,0,3,1,1,3,2,0,0,"19",0,3,5,3,0,0,1037736,"2023-11-13T00:00:00.000Z",2,FALSE,20,3547276,"G",2,2,"Boston Celtics","Payton Pritchard",0,8,11,8,6,13.1
0,0,0,0,0,0,0,0,0,"00",0,0,0,0,0,0,1037736,"2023-11-13T00:00:00.000Z",2,FALSE,20,3547279,"F",2,2,"Boston Celtics","Lamar Stevens",0,0,0,0,0,0
0,0,0,0,0,0,0,0,0,"00",0,0,0,0,0,0,1037736,"2023-11-13T00:00:00.000Z",2,FALSE,20,38017707,"G",2,2,"Boston Celtics","JD Davison",0,0,0,0,0,0
0,0,0,0,0,0,0,0,0,"00",0,0,0,0,0,0,1037736,"2023-11-13T00:00:00.000Z",2,FALSE,20,3547295,"F-C",2,2,"Boston Celtics","Nathan Knight",0,0,0,0,0,0
0,0,0,0,0,0,0,0,0,"00",0,0,0,0,0,0,1037736,"2023-11-13T00:00:00.000Z",2,FALSE,20,17553967,"C",2,2,"Boston Celtics","Neemias Queta",0,0,0,0,0,0
0,0,0,0,0,0,0,0,0,"00",0,0,0,0,0,0,1037736,"2023-11-13T00:00:00.000Z",2,FALSE,20,56677864,"G",2,2,"Boston Celtics","Jordan Walsh",0,0,0,0,0,0
3,0,7,6,3,12,6,2,1,"43",2,4,16,9,1,2,1037736,"2023-11-13T00:00:00.000Z",2,FALSE,20,202,"G",20,20,"New York Knicks","Josh Hart",1,25,28,19,12,32.3
5,0,6,8,2,19,7,11,9,"38",3,4,25,9,0,3,1037736,"2023-11-13T00:00:00.000Z",2,FALSE,20,387,"F",20,20,"New York Knicks","Julius Randle",0,34,39,30,14,40.3
1,2,3,0,0,2,2,2,0,"33",3,2,4,6,1,1,1037736,"2023-11-13T00:00:00.000Z",2,FALSE,20,399,"C",20,20,"New York Knicks","Mitchell Robinson",3,10,11,5,7,20.7
1,0,0,6,4,6,4,0,0,"28",0,2,12,0,0,0,1037736,"2023-11-13T00:00:00.000Z",2,FALSE,20,17895858,"G",20,20,"New York Knicks","Quentin Grimes",0,12,13,13,1,13.5
4,0,3,7,3,21,10,5,3,"39",0,0,26,3,1,2,1037736,"2023-11-13T00:00:00.000Z",2,FALSE,20,73,"G",20,20,"New York Knicks","Jalen Brunson",1,29,33,30,7,36.6
0,0,0,0,0,0,0,0,0,"00",0,0,0,0,0,0,1037736,"2023-11-13T00:00:00.000Z",2,FALSE,20,19,"G",20,20,"New York Knicks","Ryan Arcidiacono",0,0,0,0,0,0
1,0,0,4,1,6,2,0,0,"16",1,1,5,1,0,0,1037736,"2023-11-13T00:00:00.000Z",2,FALSE,20,131,"G",20,20,"New York Knicks","Donte DiVincenzo",0,6,7,6,2,7.7
1,0,0,1,1,2,1,0,0,"15",3,0,3,3,1,0,1037736,"2023-11-13T00:00:00.000Z",2,FALSE,20,201,"F-C",20,20,"New York Knicks","Isaiah Hartenstein",1,6,7,4,4,11.1
1,0,6,2,1,10,1,4,4,"26",0,3,7,6,1,0,1037736,"2023-11-13T00:00:00.000Z",2,FALSE,20,3547269,"G",20,20,"New York Knicks","Immanuel Quickley",1,13,14,8,7,18.7
0,0,0,0,0,0,0,0,0,"00",0,0,0,0,0,0,1037736,"2023-11-13T00:00:00.000Z",2,FALSE,20,56677795,"F",20,20,"New York Knicks","Jacob Toppin",0,0,0,0,0,0
0,0,0,0,0,0,0,0,0,"00",0,0,0,0,0,0,1037736,"2023-11-13T00:00:00.000Z",2,FALSE,20,17896089,"G",20,20,"New York Knicks","Duane Washington Jr.",0,0,0,0,0,0
0,0,0,0,0,0,0,0,0,"00",0,0,0,0,0,0,1037736,"2023-11-13T00:00:00.000Z",2,FALSE,20,666971,"G-F",20,20,"New York Knicks","Dylan Windler",0,0,0,0,0,0
0,0,0,0,0,0,0,0,0,"00",0,0,0,0,0,0,1037736,"2023-11-13T00:00:00.000Z",2,FALSE,20,666474,"G",20,20,"New York Knicks","Charles Brown",0,0,0,0,0,0
0,0,0,0,0,0,0,0,0,"00",0,0,0,0,0,0,1037736,"2023-11-13T00:00:00.000Z",2,FALSE,20,160,"G-F",20,20,"New York Knicks","Evan Fournier",0,0,0,0,0,0
0,0,0,0,0,0,0,0,0,"00",0,0,0,0,0,0,1037736,"2023-11-13T00:00:00.000Z",2,FALSE,20,666423,"F-G",20,20,"New York Knicks","RJ Barrett",0,0,0,0,0,0
0,0,0,0,0,0,0,0,0,"00",0,0,0,0,0,0,1037736,"2023-11-13T00:00:00.000Z",2,FALSE,20,666675,"F",20,20,"New York Knicks","DaQuan Jeffries",0,0,0,0,0,0
0,0,0,1,0,1,0,0,0,"01",0,0,0,0,0,0,1037736,"2023-11-13T00:00:00.000Z",2,FALSE,20,17896033,"G",20,20,"New York Knicks","Miles McBride",0,0,0,0,0,0
0,0,0,0,0,0,0,0,0,"01",0,0,0,0,0,0,1037736,"2023-11-13T00:00:00.000Z",2,FALSE,20,17896063,"F",20,20,"New York Knicks","Jericho Sims",0,0,0,0,0,0
0,1,0,1,0,6,2,1,1,"14",2,0,5,2,1,0,1037737,"2023-11-13T00:00:00.000Z",28,FALSE,30,376,"F",28,28,"Toronto Raptors","Otto Porter Jr.",2,7,7,5,2,13.4
7,0,9,4,0,24,15,14,9,"38",2,1,39,11,3,6,1037737,"2023-11-13T00:00:00.000Z",28,FALSE,30,416,"F",28,28,"Toronto Raptors","Pascal Siakam",3,50,57,46,18,65.7
5,0,3,0,0,8,6,3,1,"24",3,1,13,6,0,1,1037737,"2023-11-13T00:00:00.000Z",28,FALSE,30,373,"C",28,28,"Toronto Raptors","Jakob Poeltl",0,19,24,18,11,26.7
4,0,6,2,0,17,8,4,3,"38",3,3,19,9,5,1,1037737,"2023-11-13T00:00:00.000Z",28,FALSE,30,17896055,"G-F",28,28,"Toronto Raptors","Scottie Barnes",5,28,32,23,13,49.8
6,0,3,4,0,12,1,2,2,"35",0,2,4,3,0,3,1037737,"2023-11-13T00:00:00.000Z",28,FALSE,30,409,"G",28,28,"Toronto Raptors","Dennis Schroder",0,7,13,10,9,13.6
1,0,3,1,0,8,5,0,0,"19",1,1,10,4,1,2,1037737,"2023-11-13T00:00:00.000Z",28,FALSE,30,3547249,"F",28,28,"Toronto Raptors","Precious Achiuwa",1,14,15,11,5,17.3
2,3,5,2,1,5,3,0,0,"20",1,1,7,6,0,0,1037737,"2023-11-13T00:00:00.000Z",28,FALSE,30,58,"F",28,28,"Toronto Raptors","Chris Boucher",3,13,15,9,8,26.2
2,0,1,3,2,4,3,0,0,"24",3,2,8,4,0,2,1037737,"2023-11-13T00:00:00.000Z",28,FALSE,30,56677828,"G",28,28,"Toronto Raptors","Gradey Dick",0,12,14,10,6,13.8
1,0,2,4,1,5,2,1,1,"23",0,2,6,2,1,1,1037737,"2023-11-13T00:00:00.000Z",28,FALSE,30,3547275,"G",28,28,"Toronto Raptors","Malachi Flynn",1,8,9,7,3,11.9
0,0,0,0,0,1,0,0,0,"05",0,0,0,0,0,0,1037737,"2023-11-13T00:00:00.000Z",28,FALSE,30,666762,"F",28,28,"Toronto Raptors","Jalen McDaniels",0,0,0,0,0,0
3,3,8,0,0,7,6,2,2,"26",1,2,14,9,1,2,1037737,"2023-11-13T00:00:00.000Z",28,FALSE,30,666577,"F",30,30,"Washington Wizards","Daniel Gafford",4,23,26,17,12,39.3
6,1,2,6,2,16,6,0,0,"35",2,5,14,4,3,4,1037737,"2023-11-13T00:00:00.000Z",28,FALSE,30,666848,"G",30,30,"Washington Wizards","Jordan Poole",4,18,24,20,10,35.8
8,0,3,5,2,11,4,0,0,"31",0,1,10,3,0,0,1037737,"2023-11-13T00:00:00.000Z",28,FALSE,30,249,"G",30,30,"Washington Wizards","Tyus Jones",0,13,21,18,11,25.6
0,0,0,0,0,0,0,0,0,"00",0,0,0,0,0,0,1037737,"2023-11-13T00:00:00.000Z",28,FALSE,30,38017704,"F",30,30,"Washington Wizards","Patrick Baldwin Jr.",0,0,0,0,0,0
0,0,0,0,0,0,0,0,0,"00",0,0,0,0,0,0,1037737,"2023-11-13T00:00:00.000Z",28,FALSE,30,18677954,"G",30,30,"Washington Wizards","Jared Butler",0,0,0,0,0,0
3,1,6,1,1,7,4,3,1,"33",1,4,10,7,3,0,1037737,"2023-11-13T00:00:00.000Z",28,FALSE,30,56677844,"G",30,30,"Washington Wizards","Bilal Coulibaly",4,17,20,13,10,34.9
0,0,0,0,0,0,0,0,0,"00",0,0,0,0,0,0,1037737,"2023-11-13T00:00:00.000Z",28,FALSE,30,38017687,"G",30,30,"Washington Wizards","Johnny Davis",0,0,0,0,0,0
0,0,0,0,0,0,0,0,0,"00",0,0,0,0,0,0,1037737,"2023-11-13T00:00:00.000Z",28,FALSE,30,3547302,"F",30,30,"Washington Wizards","Anthony Gill",0,0,0,0,0,0
3,0,1,5,2,7,3,2,2,"24",1,2,10,2,2,2,1037737,"2023-11-13T00:00:00.000Z",28,FALSE,30,17896045,"F",30,30,"Washington Wizards","Corey Kispert",2,12,15,13,5,20.9
0,0,1,0,0,2,1,2,2,"07",1,0,4,2,0,3,1037737,"2023-11-13T00:00:00.000Z",28,FALSE,30,337,"F-C",30,30,"Washington Wizards","Mike Muscala",0,6,6,4,2,3.4
0,0,0,0,0,0,0,0,0,"00",0,0,0,0,0,0,1037737,"2023-11-13T00:00:00.000Z",28,FALSE,30,17896106,"F",30,30,"Washington Wizards","Eugene Omoruyi",0,0,0,0,0,0
0,0,0,0,0,0,0,0,0,"00",0,0,0,0,0,0,1037737,"2023-11-13T00:00:00.000Z",28,FALSE,30,38017712,"G",30,30,"Washington Wizards","Ryan Rollins",0,0,0,0,0,0
0,0,0,1,0,2,1,0,0,"16",0,1,2,0,2,1,1037737,"2023-11-13T00:00:00.000Z",28,FALSE,30,414,"G",30,30,"Washington Wizards","Landry Shamet",2,2,2,2,0,7
0,0,0,0,0,0,0,0,0,"00",0,0,0,0,0,0,1037737,"2023-11-13T00:00:00.000Z",28,FALSE,30,38124126,"F",30,30,"Washington Wizards","John Butler Jr.",0,0,0,0,0,0
0,0,0,0,0,0,0,0,0,"00",0,0,0,0,0,0,1037737,"2023-11-13T00:00:00.000Z",28,FALSE,30,167,"F",30,30,"Washington Wizards","Danilo Gallinari",0,0,0,0,0,0
0,0,0,0,0,0,0,0,0,"00",0,0,0,0,0,0,1037737,"2023-11-13T00:00:00.000Z",28,FALSE,30,487,"G",30,30,"Washington Wizards","Delon Wright",0,0,0,0,0,0
0,0,0,0,0,0,0,0,0,"00",0,0,0,0,0,0,1037737,"2023-11-13T00:00:00.000Z",28,FALSE,30,38017717,"F",28,28,"Toronto Raptors","Ron Harper Jr.",0,0,0,0,0,0
0,0,0,0,0,0,0,0,0,"00",0,0,0,0,0,0,1037737,"2023-11-13T00:00:00.000Z",28,FALSE,30,38017710,"C",28,28,"Toronto Raptors","Christian Koloko",0,0,0,0,0,0
0,0,0,0,0,0,0,0,0,"00",0,0,0,0,0,0,1037737,"2023-11-13T00:00:00.000Z",28,FALSE,30,3089,"",28,28,"Toronto Raptors","Gary Trent Jr.",0,0,0,0,0,0
6,0,7,1,1,7,4,0,0,"30",1,2,9,8,0,4,1037737,"2023-11-13T00:00:00.000Z",28,FALSE,30,3547242,"F",30,30,"Washington Wizards","Deni Avdija",0,17,23,15,14,23.6
3,0,2,7,4,25,14,3,2,"38",1,5,34,3,0,6,1037737,"2023-11-13T00:00:00.000Z",28,FALSE,30,265,"F",30,30,"Washington Wizards","Kyle Kuzma",0,37,40,37,6,36.1
0,0,0,0,0,0,0,0,0,"00",0,0,0,0,0,0,1037737,"2023-11-13T00:00:00.000Z",28,FALSE,30,56677869,"G",28,28,"Toronto Raptors","Markquis Nowell",0,0,0,0,0,0
0,0,0,0,0,0,0,0,0,"00",0,0,0,0,0,0,1037737,"2023-11-13T00:00:00.000Z",28,FALSE,30,436,"G-F",28,28,"Toronto Raptors","Garrett Temple",0,0,0,0,0,0
0,0,0,0,0,0,0,0,0,"00",0,0,0,0,0,0,1037737,"2023-11-13T00:00:00.000Z",28,FALSE,30,489,"F",28,28,"Toronto Raptors","Thaddeus Young",0,0,0,0,0,0
0,0,0,0,0,0,0,0,0,"00",0,0,0,0,0,0,1037737,"2023-11-13T00:00:00.000Z",28,FALSE,30,18,"F",28,28,"Toronto Raptors","OG Anunoby",0,0,0,0,0,0
0,0,0,0,0,0,0,0,0,"00",0,0,0,0,0,0,1037737,"2023-11-13T00:00:00.000Z",28,FALSE,30,56677805,"G",28,28,"Toronto Raptors","Javon Freeman-Liberty",0,0,0,0,0,0
2,0,5,5,1,10,6,0,0,"19",1,2,13,6,1,2,1037738,"2023-11-13T00:00:00.000Z",17,FALSE,5,315,"F",17,17,"Milwaukee Bucks","Khris Middleton",1,19,21,15,8,24.2
2,0,8,3,1,22,13,14,8,"35",3,4,35,11,0,3,1037738,"2023-11-13T00:00:00.000Z",17,FALSE,5,15,"F",17,17,"Milwaukee Bucks","Giannis Antetokounmpo",0,46,48,37,13,48.2
0,3,5,6,2,8,4,3,1,"29",0,3,11,5,0,2,1037738,"2023-11-13T00:00:00.000Z",17,FALSE,5,283,"C",17,17,"Milwaukee Bucks","Brook Lopez",3,16,16,11,5,24
0,0,1,6,3,6,3,0,0,"21",1,3,9,2,0,0,1037738,"2023-11-13T00:00:00.000Z",17,FALSE,5,38,"G",17,17,"Milwaukee Bucks","Malik Beasley",0,11,11,9,2,11.4
5,0,1,9,1,17,3,5,5,"32",2,0,12,3,0,5,1037738,"2023-11-13T00:00:00.000Z",17,FALSE,5,278,"G",17,17,"Milwaukee Bucks","Damian Lillard",0,15,20,17,8,18.1
0,0,0,0,0,0,0,0,0,"00",0,0,0,0,0,0,1037738,"2023-11-13T00:00:00.000Z",17,FALSE,5,2148,"",17,17,"Milwaukee Bucks","Thanasis Antetokounmpo",0,0,0,0,0,0
2,1,4,4,2,7,3,0,0,"20",1,1,8,5,1,1,1037738,"2023-11-13T00:00:00.000Z",17,FALSE,5,38017676,"F",17,17,"Milwaukee Bucks","MarJon Beauchamp",2,13,15,10,7,22
5,0,7,3,1,3,1,3,3,"29",1,4,6,8,1,0,1037738,"2023-11-13T00:00:00.000Z",17,FALSE,5,105,"G",17,17,"Milwaukee Bucks","Pat Connaughton",1,14,19,11,13,26.1
0,0,0,0,0,0,0,0,0,"00",0,0,0,0,0,0,1037738,"2023-11-13T00:00:00.000Z",17,FALSE,5,38017733,"G",17,17,"Milwaukee Bucks","A.J. Green",0,0,0,0,0,0
0,0,1,3,1,4,2,0,0,"13",2,1,5,3,0,0,1037738,"2023-11-13T00:00:00.000Z",17,FALSE,5,56677852,"G",17,17,"Milwaukee Bucks","Andre Jackson Jr.",0,8,8,5,3,8.6
0,0,0,0,0,0,0,0,0,"00",0,0,0,0,0,0,1037738,"2023-11-13T00:00:00.000Z",17,FALSE,5,284,"C",17,17,"Milwaukee Bucks","Robin Lopez",0,0,0,0,0,0
5,0,0,2,0,2,0,0,0,"17",0,2,0,0,0,2,1037738,"2023-11-13T00:00:00.000Z",17,FALSE,5,368,"G",17,17,"Milwaukee Bucks","Cameron Payne",0,0,5,5,5,5.5
2,1,8,6,3,10,7,2,2,"25",2,3,19,10,0,0,1037738,"2023-11-13T00:00:00.000Z",17,FALSE,5,377,"F",17,17,"Milwaukee Bucks","Bobby Portis",1,29,31,21,12,37
0,0,0,0,0,0,0,0,0,"00",0,0,0,0,0,0,1037738,"2023-11-13T00:00:00.000Z",17,FALSE,5,38017691,"G",17,17,"Milwaukee Bucks","TyTy Washington Jr.",0,0,0,0,0,0
0,0,0,0,0,0,0,0,0,"00",0,0,0,0,0,0,1037738,"2023-11-13T00:00:00.000Z",17,FALSE,5,666960,"G",17,17,"Milwaukee Bucks","Lindell Wigginton",0,0,0,0,0,0
0,0,0,0,0,0,0,0,0,"00",0,0,0,0,0,0,1037738,"2023-11-13T00:00:00.000Z",17,FALSE,5,666453,"C",17,17,"Milwaukee Bucks","Marques Bolden",0,0,0,0,0,0
0,0,0,0,0,0,0,0,0,"00",0,0,0,0,0,0,1037738,"2023-11-13T00:00:00.000Z",17,FALSE,5,112,"F",17,17,"Milwaukee Bucks","Jae Crowder",0,0,0,0,0,0
0,0,0,0,0,0,0,0,0,"00",0,0,0,0,0,0,1037738,"2023-11-13T00:00:00.000Z",17,FALSE,5,56677854,"F",17,17,"Milwaukee Bucks","Chris Livingston",0,0,0,0,0,0
7,1,2,3,0,14,3,5,5,"37",2,3,11,4,0,1,1037738,"2023-11-13T00:00:00.000Z",17,FALSE,5,125,"G",5,5,"Chicago Bulls","DeMar DeRozan",1,15,22,18,11,28.3
2,0,5,4,1,8,3,1,1,"23",7,2,8,12,0,0,1037738,"2023-11-13T00:00:00.000Z",17,FALSE,5,110,"F",5,5,"Chicago Bulls","Torrey Craig",0,20,22,10,14,25.4
5,1,6,7,2,24,11,3,2,"36",6,5,26,12,1,1,1037738,"2023-11-13T00:00:00.000Z",17,FALSE,5,460,"C",5,5,"Chicago Bulls","Nikola Vucevic",2,38,43,31,17,52.9
5,1,7,10,2,19,5,8,8,"39",1,1,20,8,1,1,1037738,"2023-11-13T00:00:00.000Z",17,FALSE,5,268,"G",5,5,"Chicago Bulls","Zach LaVine",2,28,33,25,13,42.1
1,0,3,8,3,14,6,2,1,"26",0,3,16,3,2,1,1037738,"2023-11-13T00:00:00.000Z",17,FALSE,5,666956,"G",5,5,"Chicago Bulls","Coby White",2,19,20,17,4,26.1
1,1,0,4,2,5,2,0,0,"14",0,2,6,0,1,0,1037738,"2023-11-13T00:00:00.000Z",17,FALSE,5,87,"G",5,5,"Chicago Bulls","Jevon Carter",2,6,7,7,1,13.5
0,0,0,0,0,0,0,0,0,"00",0,0,0,0,0,0,1037738,"2023-11-13T00:00:00.000Z",17,FALSE,5,89,"G",5,5,"Chicago Bulls","Alex Caruso",0,0,0,0,0,0
1,0,1,2,1,4,2,0,0,"26",1,4,5,2,1,1,1037738,"2023-11-13T00:00:00.000Z",17,FALSE,5,17895983,"G",5,5,"Chicago Bulls","Ayo Dosunmu",1,7,8,6,3,10.9
0,0,2,0,0,5,2,0,0,"12",1,2,4,3,1,1,1037738,"2023-11-13T00:00:00.000Z",17,FALSE,5,137,"C",5,5,"Chicago Bulls","Andre Drummond",1,7,7,4,3,9.6
0,0,0,0,0,0,0,0,0,"00",0,0,0,0,0,0,1037738,"2023-11-13T00:00:00.000Z",17,FALSE,5,56677857,"F",5,5,"Chicago Bulls","Julian Phillips",0,0,0,0,0,0
0,0,0,0,0,0,0,0,0,"00",0,0,0,0,0,0,1037738,"2023-11-13T00:00:00.000Z",17,FALSE,5,17896116,"G",5,5,"Chicago Bulls","Terry Taylor",0,0,0,0,0,0
2,3,3,4,3,7,4,2,2,"27",0,3,13,3,2,0,1037738,"2023-11-13T00:00:00.000Z",17,FALSE,5,3547248,"F",5,5,"Chicago Bulls","Patrick Williams",5,16,18,15,5,34.6
0,0,0,0,0,0,0,0,0,"00",0,0,0,0,0,0,1037738,"2023-11-13T00:00:00.000Z",17,FALSE,5,27,"G",5,5,"Chicago Bulls","Lonzo Ball",0,0,0,0,0,0
0,0,0,0,0,0,0,0,0,"00",0,0,0,0,0,0,1037738,"2023-11-13T00:00:00.000Z",17,FALSE,5,56677874,"F",5,5,"Chicago Bulls","Onuralp Bitim",0,0,0,0,0,0
0,0,0,0,0,0,0,0,0,"00",0,0,0,0,0,0,1037738,"2023-11-13T00:00:00.000Z",17,FALSE,5,45969255,"F",5,5,"Chicago Bulls","Justin Lewis",0,0,0,0,0,0
0,0,0,0,0,0,0,0,0,"00",0,0,0,0,0,0,1037738,"2023-11-13T00:00:00.000Z",17,FALSE,5,56677860,"F",5,5,"Chicago Bulls","Adama Sanogo",0,0,0,0,0,0
0,0,0,0,0,0,0,0,0,"00",0,0,0,0,0,0,1037738,"2023-11-13T00:00:00.000Z",17,FALSE,5,38017719,"F",5,5,"Chicago Bulls","Dalen Terry",0,0,0,0,0,0
3,0,3,2,0,4,2,0,0,"22",2,0,4,5,0,1,1037739,"2023-11-13T00:00:00.000Z",26,FALSE,6,30,"F",26,26,"Sacramento Kings","Harrison Barnes",0,9,12,7,8,13.5
1,0,6,8,5,13,9,2,2,"38",2,0,25,8,1,0,1037739,"2023-11-13T00:00:00.000Z",26,FALSE,6,38017688,"F",26,26,"Sacramento Kings","Keegan Murray",1,33,34,26,9,39.1
10,2,9,2,1,10,8,11,6,"35",0,4,23,9,0,3,1037739,"2023-11-13T00:00:00.000Z",26,FALSE,6,406,"F",26,26,"Sacramento Kings","Domantas Sabonis",2,32,42,33,19,51.8
2,0,1,9,6,11,7,0,0,"29",1,4,20,2,0,0,1037739,"2023-11-13T00:00:00.000Z",26,FALSE,6,221,"G",26,26,"Sacramento Kings","Kevin Huerter",0,22,24,22,4,25.4
6,0,1,6,2,20,11,7,4,"36",1,2,28,2,1,1,1037739,"2023-11-13T00:00:00.000Z",26,FALSE,6,161,"G",26,26,"Sacramento Kings","De'Aaron Fox",1,30,36,34,8,41.4
0,0,0,2,0,3,1,0,0,"09",0,4,2,0,0,1,1037739,"2023-11-13T00:00:00.000Z",26,FALSE,6,17896030,"G",26,26,"Sacramento Kings","Chris Duarte",0,2,2,2,0,1
0,0,0,0,0,0,0,0,0,"01",0,0,0,0,0,0,1037739,"2023-11-13T00:00:00.000Z",26,FALSE,6,17896044,"F",26,26,"Sacramento Kings","Kessler Edwards",0,0,0,0,0,0
2,1,0,2,0,3,1,0,0,"12",0,1,2,0,0,2,1037739,"2023-11-13T00:00:00.000Z",26,FALSE,6,38017714,"G",26,26,"Sacramento Kings","Keon Ellis",1,2,4,4,2,6
0,0,0,1,0,1,0,0,0,"01",0,0,0,0,0,0,1037739,"2023-11-13T00:00:00.000Z",26,FALSE,6,17895990,"G",26,26,"Sacramento Kings","Jordan Ford",0,0,0,0,0,0
0,0,0,0,0,0,0,0,0,"01",0,0,0,0,0,0,1037739,"2023-11-13T00:00:00.000Z",26,FALSE,6,56677845,"G",26,26,"Sacramento Kings","Colby Jones",0,0,0,0,0,0
3,0,0,0,0,2,1,0,0,"06",0,0,2,0,0,0,1037739,"2023-11-13T00:00:00.000Z",26,FALSE,6,273,"C",26,26,"Sacramento Kings","Alex Len",0,2,5,5,3,6.5
1,0,3,0,0,2,1,0,0,"07",1,1,2,4,0,0,1037739,"2023-11-13T00:00:00.000Z",26,FALSE,6,306,"C",26,26,"Sacramento Kings","JaVale McGee",0,6,7,3,5,8.3
0,0,0,0,0,0,0,0,0,"00",0,0,0,0,0,0,1037739,"2023-11-13T00:00:00.000Z",26,FALSE,6,17553994,"G",26,26,"Sacramento Kings","Davion Mitchell",0,0,0,0,0,0
4,1,4,5,3,8,4,2,2,"26",1,2,13,5,1,2,1037739,"2023-11-13T00:00:00.000Z",26,FALSE,6,324,"G",26,26,"Sacramento Kings","Malik Monk",2,18,22,17,9,29
0,0,2,5,3,6,4,0,0,"17",0,1,11,2,0,0,1037739,"2023-11-13T00:00:00.000Z",26,FALSE,6,4197162,"F",26,26,"Sacramento Kings","Aleksandar Vezenkov",0,13,13,11,2,13.4
0,0,0,0,0,0,0,0,0,"00",0,0,0,0,0,0,1037739,"2023-11-13T00:00:00.000Z",26,FALSE,6,290,"F",26,26,"Sacramento Kings","Trey Lyles",0,0,0,0,0,0
0,0,0,0,0,0,0,0,0,"00",0,0,0,0,0,0,1037739,"2023-11-13T00:00:00.000Z",26,FALSE,6,17895941,"C",26,26,"Sacramento Kings","Filip Petrusev",0,0,0,0,0,0
0,0,0,0,0,0,0,0,0,"00",0,0,0,0,0,0,1037739,"2023-11-13T00:00:00.000Z",26,FALSE,6,56677862,"F",26,26,"Sacramento Kings","Jalen Slawson",0,0,0,0,0,0
3,0,3,9,5,12,7,0,0,"34",2,3,19,5,1,1,1037739,"2023-11-13T00:00:00.000Z",26,FALSE,6,666908,"G",6,6,"Cleveland Cavaliers","Max Strus",1,24,27,22,8,31.5
2,0,5,0,0,13,8,0,0,"30",6,4,16,11,1,3,1037739,"2023-11-13T00:00:00.000Z",26,FALSE,6,17896076,"F-C",6,6,"Cleveland Cavaliers","Evan Mobley",1,27,29,18,13,32.2
1,0,5,0,0,6,5,3,2,"22",4,2,12,9,0,2,1037739,"2023-11-13T00:00:00.000Z",26,FALSE,6,9,"C",6,6,"Cleveland Cavaliers","Jarrett Allen",0,21,22,13,10,22.3
5,1,2,9,4,21,7,4,4,"38",0,0,22,2,1,2,1037739,"2023-11-13T00:00:00.000Z",26,FALSE,6,322,"G",6,6,"Cleveland Cavaliers","Donovan Mitchell",2,24,29,27,7,35.9
6,0,3,8,3,14,5,4,3,"34",0,1,16,3,0,1,1037739,"2023-11-13T00:00:00.000Z",26,FALSE,6,666581,"G",6,6,"Cleveland Cavaliers","Darius Garland",0,19,25,22,9,27.6
0,0,0,0,0,0,0,0,0,"00",0,0,0,0,0,0,1037739,"2023-11-13T00:00:00.000Z",26,FALSE,6,248,"C",6,6,"Cleveland Cavaliers","Damian Jones",0,0,0,0,0,0
1,0,2,3,2,13,7,6,5,"28",1,3,21,3,0,2,1037739,"2023-11-13T00:00:00.000Z",26,FALSE,6,277,"G",6,6,"Cleveland Cavaliers","Caris LeVert",0,24,25,22,4,24.1
0,0,0,1,0,1,0,0,0,"03",0,0,0,0,0,0,1037739,"2023-11-13T00:00:00.000Z",26,FALSE,6,3547299,"G",6,6,"Cleveland Cavaliers","Sam Merrill",0,0,0,0,0,0
1,0,1,4,2,7,5,0,0,"22",0,1,12,1,0,0,1037739,"2023-11-13T00:00:00.000Z",26,FALSE,6,344,"F",6,6,"Cleveland Cavaliers","Georges Niang",0,13,14,13,2,14.7
3,0,3,0,0,1,0,0,0,"03",0,1,0,3,0,0,1037739,"2023-11-13T00:00:00.000Z",26,FALSE,6,56677872,"G",6,6,"Cleveland Cavaliers","Craig Porter",0,3,6,3,6,8.1
0,0,1,0,0,1,1,0,0,"13",0,2,2,1,0,0,1037739,"2023-11-13T00:00:00.000Z",26,FALSE,6,444,"C-F",6,6,"Cleveland Cavaliers","Tristan Thompson",0,3,3,2,1,3.2
1,0,0,1,0,1,0,0,0,"13",0,1,0,0,0,0,1037739,"2023-11-13T00:00:00.000Z",26,FALSE,6,666940,"F",6,6,"Cleveland Cavaliers","Dean Wade",0,0,1,1,1,1.5
0,0,0,0,0,0,0,0,0,"00",0,0,0,0,0,0,1037739,"2023-11-13T00:00:00.000Z",26,FALSE,6,56677847,"F",6,6,"Cleveland Cavaliers","Emoni Bates",0,0,0,0,0,0
0,0,0,0,0,0,0,0,0,"00",0,0,0,0,0,0,1037739,"2023-11-13T00:00:00.000Z",26,FALSE,6,666676,"G",6,6,"Cleveland Cavaliers","Ty Jerome",0,0,0,0,0,0
0,0,0,0,0,0,0,0,0,"00",0,0,0,0,0,0,1037739,"2023-11-13T00:00:00.000Z",26,FALSE,6,38017662,"F",6,6,"Cleveland Cavaliers","Isaiah Mobley",0,0,0,0,0,0
0,0,0,0,0,0,0,0,0,"00",0,0,0,0,0,0,1037739,"2023-11-13T00:00:00.000Z",26,FALSE,6,3547247,"F-G",6,6,"Cleveland Cavaliers","Isaac Okoro",0,0,0,0,0,0
0,0,0,0,0,0,0,0,0,"00",0,0,0,0,0,0,1037739,"2023-11-13T00:00:00.000Z",26,FALSE,6,404,"G",6,6,"Cleveland Cavaliers","Ricky Rubio",0,0,0,0,0,0
0,0,0,0,0,0,0,0,0,"00",0,0,0,0,0,0,3277433,"2023-11-14T00:00:00.000Z",10,FALSE,18,17896056,"C",18,18,"Minnesota Timberwolves","Luka Garza",0,0,0,0,0,0
0,0,0,0,0,0,0,0,0,"00",0,0,0,0,0,0,3277433,"2023-11-14T00:00:00.000Z",10,FALSE,18,666767,"G",18,18,"Minnesota Timberwolves","Jordan McLaughlin",0,0,0,0,0,0
0,0,0,0,0,0,0,0,0,"00",0,0,0,0,0,0,3277433,"2023-11-14T00:00:00.000Z",10,FALSE,18,56677782,"F",18,18,"Minnesota Timberwolves","Leonard Miller",0,0,0,0,0,0
0,0,0,0,0,0,0,0,0,"00",0,0,0,0,0,0,3277433,"2023-11-14T00:00:00.000Z",10,FALSE,18,38017700,"G",18,18,"Minnesota Timberwolves","Wendell Moore Jr.",0,0,0,0,0,0
0,1,5,7,1,15,4,0,0,"27",2,5,9,7,3,4,3277433,"2023-11-14T00:00:00.000Z",10,FALSE,18,475,"F-G",10,10,"Golden State Warriors","Andrew Wiggins",4,16,16,9,7,25.4
0,0,2,0,0,0,0,0,0,"02",0,1,0,2,0,1,3277433,"2023-11-14T00:00:00.000Z",10,FALSE,18,185,"F",10,10,"Golden State Warriors","Draymond Green",0,2,2,0,2,1.4
4,0,3,11,3,15,6,6,6,"32",1,4,21,4,2,2,3277433,"2023-11-14T00:00:00.000Z",10,FALSE,18,407,"F",10,10,"Golden State Warriors","Dario Saric",2,25,29,25,8,35.8
0,0,0,1,0,1,0,0,0,"02",0,0,0,0,0,0,3277433,"2023-11-14T00:00:00.000Z",10,FALSE,18,443,"G",10,10,"Golden State Warriors","Klay Thompson",0,0,0,0,0,0
4,1,5,3,2,14,6,1,1,"36",0,0,15,5,3,4,3277433,"2023-11-14T00:00:00.000Z",10,FALSE,18,367,"G",10,10,"Golden State Warriors","Chris Paul",4,20,24,19,9,35
3,0,2,0,0,1,0,2,2,"12",0,2,2,2,0,2,3277433,"2023-11-14T00:00:00.000Z",10,FALSE,18,56677799,"F",10,10,"Golden State Warriors","Trayce Jackson-Davis",0,4,7,5,5,6.9
4,0,0,3,2,6,2,1,0,"13",0,1,6,0,0,2,3277433,"2023-11-14T00:00:00.000Z",10,FALSE,18,251,"G",10,10,"Golden State Warriors","Cory Joseph",0,6,10,10,4,10
1,0,1,1,0,3,2,2,1,"16",1,2,5,2,0,1,3277433,"2023-11-14T00:00:00.000Z",10,FALSE,18,17553979,"F",10,10,"Golden State Warriors","Jonathan Kuminga",0,7,8,6,3,7.9
3,0,6,0,0,4,1,0,0,"31",6,2,2,12,1,0,3277433,"2023-11-14T00:00:00.000Z",10,FALSE,18,282,"F",10,10,"Golden State Warriors","Kevon Looney",1,14,17,5,15,23.9
2,0,1,2,1,6,4,2,2,"14",1,0,11,2,1,0,3277433,"2023-11-14T00:00:00.000Z",10,FALSE,18,17553992,"G",10,10,"Golden State Warriors","Moses Moody",1,13,15,13,4,19.4
2,0,2,3,1,5,3,0,0,"16",1,1,7,3,0,0,3277433,"2023-11-14T00:00:00.000Z",10,FALSE,18,2189,"",10,10,"Golden State Warriors","Gary Payton II",0,10,12,9,5,13.6
5,0,6,8,3,18,9,2,2,"39",1,4,23,7,1,3,3277433,"2023-11-14T00:00:00.000Z",10,FALSE,18,56677858,"G",10,10,"Golden State Warriors","Brandin Podziemski",1,30,35,28,12,38.9
0,0,0,0,0,0,0,0,0,"00",0,0,0,0,0,0,3277433,"2023-11-14T00:00:00.000Z",10,FALSE,18,57875092,"F",10,10,"Golden State Warriors","Gui Santos",0,0,0,0,0,0
0,0,0,0,0,0,0,0,0,"00",0,0,0,0,0,0,3277433,"2023-11-14T00:00:00.000Z",10,FALSE,18,115,"G",10,10,"Golden State Warriors","Stephen Curry",0,0,0,0,0,0
0,0,0,0,0,0,0,0,0,"00",0,0,0,0,0,0,3277433,"2023-11-14T00:00:00.000Z",10,FALSE,18,17896070,"F",10,10,"Golden State Warriors","Usman Garuba",0,0,0,0,0,0
0,0,0,0,0,0,0,0,0,"00",0,0,0,0,0,0,3277433,"2023-11-14T00:00:00.000Z",10,FALSE,18,45658838,"G",10,10,"Golden State Warriors","Lester Quinones",0,0,0,0,0,0
0,0,0,0,0,0,0,0,0,"00",0,0,0,0,0,0,3277433,"2023-11-14T00:00:00.000Z",10,FALSE,18,398,"G",10,10,"Golden State Warriors","Jerome Robinson",0,0,0,0,0,0
4,0,4,6,3,16,7,5,3,"36",0,1,20,4,3,5,3277433,"2023-11-14T00:00:00.000Z",10,FALSE,18,3547238,"G",18,18,"Minnesota Timberwolves","Anthony Edwards",3,24,28,24,8,34.8
2,0,10,12,5,26,12,4,4,"42",1,1,33,11,2,5,3277433,"2023-11-14T00:00:00.000Z",10,FALSE,18,447,"C",18,18,"Minnesota Timberwolves","Karl-Anthony Towns",2,44,46,35,13,50.2
2,3,7,0,0,8,2,6,5,"35",6,4,9,13,0,2,3277433,"2023-11-14T00:00:00.000Z",10,FALSE,18,176,"C",18,18,"Minnesota Timberwolves","Rudy Gobert",3,22,24,11,15,34.6
0,0,0,1,0,1,0,0,0,"02",0,0,0,0,0,0,3277433,"2023-11-14T00:00:00.000Z",10,FALSE,18,3547259,"F",18,18,"Minnesota Timberwolves","Jaden McDaniels",0,0,0,0,0,0
8,0,2,4,3,6,4,2,2,"31",0,1,13,2,2,1,3277433,"2023-11-14T00:00:00.000Z",10,FALSE,18,104,"G",18,18,"Minnesota Timberwolves","Mike Conley",2,15,23,21,10,32.4
1,1,0,4,1,5,2,0,0,"25",0,1,5,0,1,2,3277433,"2023-11-14T00:00:00.000Z",10,FALSE,18,666400,"G",18,18,"Minnesota Timberwolves","Nickeil Alexander-Walker",2,5,6,6,1,10.5
3,1,3,2,0,9,3,2,2,"27",1,4,8,4,0,2,3277433,"2023-11-14T00:00:00.000Z",10,FALSE,18,12,"F",18,18,"Minnesota Timberwolves","Kyle Anderson",1,12,15,11,7,18.3
1,0,1,1,0,1,0,0,0,"10",1,0,0,2,1,0,3277433,"2023-11-14T00:00:00.000Z",10,FALSE,18,68,"F",18,18,"Minnesota Timberwolves","Troy Brown Jr.",1,2,3,1,3,6.9
3,0,4,1,0,4,2,2,2,"16",0,3,6,4,0,1,3277433,"2023-11-14T00:00:00.000Z",10,FALSE,18,320,"G",18,18,"Minnesota Timberwolves","Shake Milton",0,10,13,9,7,14.3
0,0,0,0,0,0,0,0,0,"00",0,0,0,0,0,0,3277433,"2023-11-14T00:00:00.000Z",10,FALSE,18,38017715,"F",18,18,"Minnesota Timberwolves","Josh Minott",0,0,0,0,0,0
0,0,0,0,0,0,0,0,0,"00",0,0,0,0,0,0,3277433,"2023-11-14T00:00:00.000Z",10,FALSE,18,17895968,"F",18,18,"Minnesota Timberwolves","Daishen Nix",0,0,0,0,0,0
0,0,2,3,2,5,4,0,0,"16",0,4,10,2,0,1,3277433,"2023-11-14T00:00:00.000Z",10,FALSE,18,667378,"F-C",18,18,"Minnesota Timberwolves","Naz Reid",0,12,12,10,2,11.4
0,0,0,0,0,0,0,0,0,"00",0,0,0,0,0,0,3277433,"2023-11-14T00:00:00.000Z",10,FALSE,18,56677851,"G",18,18,"Minnesota Timberwolves","Jaylen Clark",0,0,0,0,0,0
2,0,1,5,3,7,3,2,1,"25",0,2,10,1,0,0,3277434,"2023-11-14T00:00:00.000Z",14,FALSE,15,666860,"F-G",14,14,"Los Angeles Lakers","Cameron Reddish",0,11,13,12,3,14.2
6,0,9,6,3,11,6,2,1,"23",0,1,16,9,1,4,3277434,"2023-11-14T00:00:00.000Z",14,FALSE,15,237,"F",14,14,"Los Angeles Lakers","LeBron James",1,25,31,22,15,34.8
5,6,7,0,0,11,7,6,5,"27",4,1,19,11,0,2,3277434,"2023-11-14T00:00:00.000Z",14,FALSE,15,117,"F-C",14,14,"Los Angeles Lakers","Anthony Davis",6,30,35,24,16,55.7
1,0,3,5,2,6,3,0,0,"29",0,3,8,3,1,0,3277434,"2023-11-14T00:00:00.000Z",14,FALSE,15,383,"F",14,14,"Los Angeles Lakers","Taurean Prince",1,11,12,9,4,16.1
5,0,3,8,6,12,8,3,2,"27",0,0,24,3,0,0,3277434,"2023-11-14T00:00:00.000Z",14,FALSE,15,405,"G",14,14,"Los Angeles Lakers","D'Angelo Russell",0,27,32,29,8,35.1
1,0,1,1,1,2,2,0,0,"08",0,0,5,1,1,1,3277434,"2023-11-14T00:00:00.000Z",14,FALSE,15,38017697,"G",14,14,"Los Angeles Lakers","Max Christie",1,6,7,6,2,9.7
0,0,3,3,3,10,8,4,4,"24",0,2,23,3,0,5,3277434,"2023-11-14T00:00:00.000Z",14,FALSE,15,666609,"F",14,14,"Los Angeles Lakers","Rui Hachimura",0,26,26,23,3,21.6
1,3,0,0,0,4,4,4,3,"21",1,2,11,1,1,0,3277434,"2023-11-14T00:00:00.000Z",14,FALSE,15,666626,"C",14,14,"Los Angeles Lakers","Jaxson Hayes",4,12,13,12,2,25.7
0,0,0,0,0,0,0,0,0,"00",0,0,0,0,0,0,3277434,"2023-11-14T00:00:00.000Z",14,FALSE,15,56677835,"G",14,14,"Los Angeles Lakers","Jalen Hood-Schifino",0,0,0,0,0,0
7,0,10,4,4,9,5,3,2,"29",2,0,16,12,0,3,3277434,"2023-11-14T00:00:00.000Z",14,FALSE,15,17553995,"G",14,14,"Los Angeles Lakers","Austin Reaves",0,28,35,23,19,37.9
2,1,7,3,0,8,1,0,0,"22",3,2,2,10,0,3,3277434,"2023-11-14T00:00:00.000Z",14,FALSE,15,486,"F",14,14,"Los Angeles Lakers","Christian Wood",1,12,14,4,12,17
0,0,0,0,0,0,0,0,0,"00",0,0,0,0,0,0,3277434,"2023-11-14T00:00:00.000Z",14,FALSE,15,56677738,"C",14,14,"Los Angeles Lakers","Colin Castleton",0,0,0,0,0,0
0,0,0,0,0,0,0,0,0,"00",0,0,0,0,0,0,3277434,"2023-11-14T00:00:00.000Z",14,FALSE,15,56677867,"F",14,14,"Los Angeles Lakers","Alex Fudge",0,0,0,0,0,0
0,0,0,0,0,0,0,0,0,"00",0,0,0,0,0,0,3277434,"2023-11-14T00:00:00.000Z",14,FALSE,15,56677868,"G",14,14,"Los Angeles Lakers","D'Moi Hodge",0,0,0,0,0,0
0,0,0,0,0,0,0,0,0,"00",0,0,0,0,0,0,3277434,"2023-11-14T00:00:00.000Z",14,FALSE,15,457,"F",14,14,"Los Angeles Lakers","Jarred Vanderbilt",0,0,0,0,0,0
0,0,0,0,0,0,0,0,0,"00",0,0,0,0,0,0,3277434,"2023-11-14T00:00:00.000Z",14,FALSE,15,1603383,"G",14,14,"Los Angeles Lakers","Gabe Vincent",0,0,0,0,0,0
5,0,1,6,2,10,5,3,3,"27",0,1,15,1,0,2,3277434,"2023-11-14T00:00:00.000Z",14,FALSE,15,3547287,"G",15,15,"Memphis Grizzlies","Desmond Bane",0,16,21,20,6,21.7
0,0,0,0,0,1,0,0,0,"05",0,0,0,0,0,0,3277434,"2023-11-14T00:00:00.000Z",14,FALSE,15,56677836,"F",14,14,"Los Angeles Lakers","Maxwell Lewis",0,0,0,0,0,0
2,1,0,6,2,16,3,0,0,"22",2,2,8,2,0,1,3277434,"2023-11-14T00:00:00.000Z",14,FALSE,15,231,"F-C",15,15,"Memphis Grizzlies","Jaren Jackson Jr.",1,10,12,10,4,15.4
4,1,2,0,0,5,0,0,0,"23",6,3,0,8,0,0,3277434,"2023-11-14T00:00:00.000Z",14,FALSE,15,48,"C",15,15,"Memphis Grizzlies","Bismack Biyombo",1,8,12,4,12,18.6
1,1,1,2,1,3,1,0,0,"09",0,0,3,1,1,0,3277434,"2023-11-14T00:00:00.000Z",14,FALSE,15,420,"G",15,15,"Memphis Grizzlies","Marcus Smart",2,4,5,4,2,11.7
1,0,2,5,3,5,3,0,0,"21",1,2,9,3,2,1,3277434,"2023-11-14T00:00:00.000Z",14,FALSE,15,48248287,"G",15,15,"Memphis Grizzlies","Jacob Gilyard",2,12,13,10,4,19.1
4,2,5,8,3,15,9,5,3,"25",0,0,24,5,0,3,3277434,"2023-11-14T00:00:00.000Z",14,FALSE,15,17896067,"F",15,15,"Memphis Grizzlies","Santi Aldama",2,29,33,28,9,39
0,0,2,3,0,5,0,0,0,"06",1,0,0,3,0,0,3277434,"2023-11-14T00:00:00.000Z",14,FALSE,15,254,"G",15,15,"Memphis Grizzlies","Luke Kennard",0,3,3,0,3,3.6
6,0,2,3,2,4,2,0,0,"18",1,1,6,3,1,0,3277434,"2023-11-14T00:00:00.000Z",14,FALSE,15,666703,"G-F",15,15,"Memphis Grizzlies","John Konchar",1,9,15,12,9,21.6
3,2,2,8,2,17,6,4,3,"31",1,2,17,3,2,0,3277434,"2023-11-14T00:00:00.000Z",14,FALSE,15,38017729,"F",15,15,"Memphis Grizzlies","David Roddy",4,20,23,20,6,37.1
2,0,1,3,3,7,6,0,0,"22",1,1,15,2,1,1,3277434,"2023-11-14T00:00:00.000Z",14,FALSE,15,3547285,"F",15,15,"Memphis Grizzlies","Xavier Tillman",1,17,19,17,4,22.4
0,1,1,7,2,16,4,0,0,"26",0,3,10,1,1,1,3277434,"2023-11-14T00:00:00.000Z",14,FALSE,15,17896027,"G-F",15,15,"Memphis Grizzlies","Ziaire Williams",2,11,11,10,1,16.2
0,0,0,0,0,0,0,0,0,"00",0,0,0,0,0,0,3277434,"2023-11-14T00:00:00.000Z",14,FALSE,15,666786,"G",15,15,"Memphis Grizzlies","Ja Morant",0,0,0,0,0,0
0,0,0,0,0,0,0,0,0,"00",0,0,0,0,0,0,3277434,"2023-11-14T00:00:00.000Z",14,FALSE,15,401,"G",15,15,"Memphis Grizzlies","Derrick Rose",0,0,0,0,0,0
0,0,0,1,0,2,0,0,0,"05",0,0,0,0,0,0,3277434,"2023-11-14T00:00:00.000Z",14,FALSE,15,38017732,"F",15,15,"Memphis Grizzlies","Kenneth Lofton Jr.",0,0,0,0,0,0
0,0,1,1,0,1,0,0,0,"05",0,0,0,1,0,0,3277434,"2023-11-14T00:00:00.000Z",14,FALSE,15,38017731,"G",15,15,"Memphis Grizzlies","Vince Williams Jr.",0,1,1,0,1,1.2
0,0,0,0,0,0,0,0,0,"00",0,0,0,0,0,0,3277434,"2023-11-14T00:00:00.000Z",14,FALSE,15,3,"C",15,15,"Memphis Grizzlies","Steven Adams",0,0,0,0,0,0
0,0,0,0,0,0,0,0,0,"00",0,0,0,0,0,0,3277434,"2023-11-14T00:00:00.000Z",14,FALSE,15,666505,"F",15,15,"Memphis Grizzlies","Brandon Clarke",0,0,0,0,0,0
0,0,0,0,0,0,0,0,0,"00",0,0,0,0,0,0,3277434,"2023-11-14T00:00:00.000Z",14,FALSE,15,56677830,"F",15,15,"Memphis Grizzlies","GG Jackson",0,0,0,0,0,0
0,0,0,0,0,0,0,0,0,"00",0,0,0,0,0,0,3277434,"2023-11-14T00:00:00.000Z",14,FALSE,15,38017728,"F",15,15,"Memphis Grizzlies","Jake LaRavia",0,0,0,0,0,0
1,0,4,11,6,23,12,2,2,"36",2,1,32,6,0,1,3277425,"2023-11-14T00:00:00.000Z",4,FALSE,16,666950,"F",4,4,"Charlotte Hornets","P.J. Washington",0,38,39,33,7,39.7
1,0,1,2,1,6,2,0,0,"28",3,1,5,4,0,0,3277425,"2023-11-14T00:00:00.000Z",4,FALSE,16,18678001,"F",4,4,"Charlotte Hornets","JT Thor",0,9,10,6,5,11.3
0,0,3,0,0,5,5,4,1,"23",4,2,11,7,1,0,3277425,"2023-11-14T00:00:00.000Z",4,FALSE,16,38017698,"C",4,4,"Charlotte Hornets","Mark Williams",1,18,18,11,7,22.4
3,0,3,2,0,5,0,2,2,"23",0,1,2,3,0,2,3277425,"2023-11-14T00:00:00.000Z",4,FALSE,16,3547253,"G",4,4,"Charlotte Hornets","Theo Maledon",0,5,8,5,6,8.1
11,0,4,10,4,26,9,6,6,"39",2,5,28,6,3,8,3277425,"2023-11-14T00:00:00.000Z",4,FALSE,16,3547239,"G",4,4,"Charlotte Hornets","LaMelo Ball",3,34,45,39,17,52.7
0,0,0,0,0,0,0,0,0,"00",0,0,0,0,0,0,3277425,"2023-11-14T00:00:00.000Z",4,FALSE,16,56677848,"G",4,4,"Charlotte Hornets","Amari Bailey",0,0,0,0,0,0
0,0,0,1,0,2,0,0,0,"03",0,0,0,0,0,0,3277425,"2023-11-14T00:00:00.000Z",4,FALSE,16,56677866,"F",4,4,"Charlotte Hornets","Leaky Black",0,0,0,0,0,0
1,0,4,5,3,7,4,2,1,"29",0,4,12,4,1,1,3277425,"2023-11-14T00:00:00.000Z",4,FALSE,16,38017708,"G",4,4,"Charlotte Hornets","Bryce McGowens",1,16,17,13,5,20.3
1,0,3,5,0,5,0,4,3,"14",0,1,3,3,0,0,3277425,"2023-11-14T00:00:00.000Z",4,FALSE,16,285,"F-C",16,16,"Miami Heat","Kevin Love",0,6,7,4,4,8.1
6,1,4,6,0,10,2,2,2,"33",1,2,6,5,1,1,3277425,"2023-11-14T00:00:00.000Z",4,FALSE,16,391,"G-F",16,16,"Miami Heat","Josh Richardson",2,11,17,12,11,26
0,0,0,0,0,0,0,0,0,"00",0,0,0,0,0,0,3277425,"2023-11-14T00:00:00.000Z",4,FALSE,16,39398582,"C",16,16,"Miami Heat","Orlando Robinson",0,0,0,0,0,0
0,0,0,0,0,0,0,0,0,"03",0,2,0,0,0,0,3277425,"2023-11-14T00:00:00.000Z",4,FALSE,16,19465585,"G",16,16,"Miami Heat","Dru Smith",0,0,0,0,0,0
0,0,0,0,0,0,0,0,0,"00",0,0,0,0,0,0,3277425,"2023-11-14T00:00:00.000Z",4,FALSE,16,38017734,"F",16,16,"Miami Heat","Jamal Cain",0,0,0,0,0,0
0,0,0,0,0,0,0,0,0,"00",0,0,0,0,0,0,3277425,"2023-11-14T00:00:00.000Z",4,FALSE,16,3547257,"G",16,16,"Miami Heat","R.J. Hampton",0,0,0,0,0,0
0,0,0,0,0,0,0,0,0,"00",0,0,0,0,0,0,3277425,"2023-11-14T00:00:00.000Z",4,FALSE,16,666633,"G",16,16,"Miami Heat","Tyler Herro",0,0,0,0,0,0
3,0,1,0,0,3,1,0,0,"19",1,1,2,2,0,3,3277425,"2023-11-14T00:00:00.000Z",4,FALSE,16,422,"G",4,4,"Charlotte Hornets","Ish Smith",0,4,7,5,5,5.9
0,0,2,1,1,2,1,0,0,"15",0,1,3,2,0,0,3277425,"2023-11-14T00:00:00.000Z",4,FALSE,16,56677846,"G",4,4,"Charlotte Hornets","Nick Smith Jr.",0,5,5,3,2,5.4
0,0,0,0,0,0,0,0,0,"00",0,0,0,0,0,0,3277425,"2023-11-14T00:00:00.000Z",4,FALSE,16,17896037,"G",4,4,"Charlotte Hornets","James Bouknight",0,0,0,0,0,0
0,0,0,0,0,0,0,0,0,"00",0,0,0,0,0,0,3277425,"2023-11-14T00:00:00.000Z",4,FALSE,16,62,"F",4,4,"Charlotte Hornets","Miles Bridges",0,0,0,0,0,0
0,0,0,0,0,0,0,0,0,"00",0,0,0,0,0,0,3277425,"2023-11-14T00:00:00.000Z",4,FALSE,16,204,"F",4,4,"Charlotte Hornets","Gordon Hayward",0,0,0,0,0,0
0,0,0,0,0,0,0,0,0,"00",0,0,0,0,0,0,3277425,"2023-11-14T00:00:00.000Z",4,FALSE,16,666748,"F",4,4,"Charlotte Hornets","Cody Martin",0,0,0,0,0,0
0,0,0,0,0,0,0,0,0,"00",0,0,0,0,0,0,3277425,"2023-11-14T00:00:00.000Z",4,FALSE,16,56677823,"F",4,4,"Charlotte Hornets","Brandon Miller",0,0,0,0,0,0
0,0,0,0,0,0,0,0,0,"00",0,0,0,0,0,0,3277425,"2023-11-14T00:00:00.000Z",4,FALSE,16,347,"G",4,4,"Charlotte Hornets","Frank Ntilikina",0,0,0,0,0,0
0,0,0,0,0,0,0,0,0,"00",0,0,0,0,0,0,3277425,"2023-11-14T00:00:00.000Z",4,FALSE,16,403,"G",4,4,"Charlotte Hornets","Terry Rozier",0,0,0,0,0,0
5,0,1,1,1,14,10,14,11,"34",3,1,32,4,2,3,3277425,"2023-11-14T00:00:00.000Z",4,FALSE,16,79,"G-F",16,16,"Miami Heat","Jimmy Butler",2,36,41,37,9,47.3
2,2,3,5,2,8,5,0,0,"33",1,1,12,4,5,0,3277425,"2023-11-14T00:00:00.000Z",4,FALSE,16,3092,"",16,16,"Miami Heat","Haywood Highsmith",7,16,18,14,6,40.8
0,0,0,0,0,3,1,0,0,"03",1,0,2,1,0,0,3277425,"2023-11-14T00:00:00.000Z",4,FALSE,16,74,"C",16,16,"Miami Heat","Thomas Bryant",0,3,3,2,1,3.2
1,0,1,3,1,13,8,0,0,"33",4,3,17,5,0,1,3277425,"2023-11-14T00:00:00.000Z",4,FALSE,16,56677785,"G",16,16,"Miami Heat","Jaime Jaquez Jr.",0,22,23,18,6,23.5
0,0,0,0,0,0,0,0,0,"00",0,0,0,0,0,0,3277425,"2023-11-14T00:00:00.000Z",4,FALSE,16,38017696,"F",16,16,"Miami Heat","Nikola Jovic",0,0,0,0,0,0
0,0,0,0,0,0,0,0,0,"00",0,0,0,0,0,0,3277425,"2023-11-14T00:00:00.000Z",4,FALSE,16,666747,"F",16,16,"Miami Heat","Caleb Martin",0,0,0,0,0,0
0,0,0,0,0,0,0,0,0,"00",0,0,0,0,0,0,3277425,"2023-11-14T00:00:00.000Z",4,FALSE,16,38017736,"F",16,16,"Miami Heat","Cole Swider",0,0,0,0,0,0
4,1,11,0,0,16,8,6,5,"36",0,3,21,11,3,1,3277425,"2023-11-14T00:00:00.000Z",4,FALSE,16,4,"C-F",16,16,"Miami Heat","Bam Adebayo",4,32,36,25,15,51.2
5,1,8,10,4,13,6,2,2,"36",0,2,18,8,1,1,3277425,"2023-11-14T00:00:00.000Z",4,FALSE,16,397,"F",16,16,"Miami Heat","Duncan Robinson",2,26,31,23,13,40.1
2,0,1,1,0,1,0,0,0,"15",0,4,0,1,0,0,3277425,"2023-11-14T00:00:00.000Z",4,FALSE,16,286,"G",16,16,"Miami Heat","Kyle Lowry",0,1,3,2,3,4.2
1,0,10,0,0,2,2,6,6,"25",1,5,10,11,1,3,3277425,"2023-11-14T00:00:00.000Z",4,FALSE,16,3547282,"C",4,4,"Charlotte Hornets","Nick Richards",1,21,22,11,12,24.7
5,2,7,1,0,12,9,6,3,"35",1,3,21,8,3,2,3277426,"2023-11-14T00:00:00.000Z",9,FALSE,1,56677826,"G-F",9,9,"Detroit Pistons","Ausar Thompson",5,29,34,26,13,51.1
0,1,1,5,1,9,4,1,1,"19",0,1,10,1,0,0,3277426,"2023-11-14T00:00:00.000Z",9,FALSE,1,3547267,"F-C",9,9,"Detroit Pistons","Isaiah Stewart",1,11,11,10,1,14.2
1,1,4,0,0,12,9,4,4,"30",6,2,22,10,0,4,3277426,"2023-11-14T00:00:00.000Z",9,FALSE,1,24,"F",9,9,"Detroit Pistons","Marvin Bagley III",1,32,33,23,11,34.5
12,0,3,3,1,14,4,0,0,"38",1,3,9,4,3,6,3277426,"2023-11-14T00:00:00.000Z",9,FALSE,1,17896075,"G-F",9,9,"Detroit Pistons","Cade Cunningham",3,13,25,21,16,34.8
5,2,3,3,1,8,3,2,1,"23",0,2,8,3,1,1,3277426,"2023-11-14T00:00:00.000Z",9,FALSE,1,3547241,"G",9,9,"Detroit Pistons","Killian Hayes",3,11,16,13,8,27.1
5,0,1,9,4,12,4,4,4,"23",1,3,16,2,1,1,3277426,"2023-11-14T00:00:00.000Z",9,FALSE,1,77,"G",9,9,"Detroit Pistons","Alec Burks",1,18,23,21,7,27.9
0,0,0,0,0,0,0,0,0,"00",0,0,0,0,0,0,3277426,"2023-11-14T00:00:00.000Z",9,FALSE,1,38017694,"C",9,9,"Detroit Pistons","Jalen Duren",0,0,0,0,0,0
0,0,0,0,0,0,0,0,0,"00",0,0,0,0,0,0,3277426,"2023-11-14T00:00:00.000Z",9,FALSE,1,197,"F-G",9,9,"Detroit Pistons","Joe Harris",0,0,0,0,0,0
5,0,2,2,1,7,4,4,2,"21",3,1,11,5,1,1,3277426,"2023-11-14T00:00:00.000Z",9,FALSE,1,38017682,"G",9,9,"Detroit Pistons","Jaden Ivey",1,16,21,16,10,26.5
1,0,3,4,2,8,5,0,0,"29",1,3,12,4,0,2,3277426,"2023-11-14T00:00:00.000Z",9,FALSE,1,259,"F",9,9,"Detroit Pistons","Kevin Knox",0,16,17,13,5,16.3
0,0,0,0,0,0,0,0,0,"00",0,0,0,0,0,0,3277426,"2023-11-14T00:00:00.000Z",9,FALSE,1,17896071,"F",9,9,"Detroit Pistons","Isaiah Livers",0,0,0,0,0,0
1,0,1,2,0,2,0,0,0,"08",0,0,0,1,0,0,3277426,"2023-11-14T00:00:00.000Z",9,FALSE,1,56677792,"G",9,9,"Detroit Pistons","Marcus Sasser",0,1,2,1,2,2.7
1,0,3,0,0,6,5,2,1,"14",1,2,11,4,0,0,3277426,"2023-11-14T00:00:00.000Z",9,FALSE,1,3547240,"C",9,9,"Detroit Pistons","James Wiseman",0,15,16,12,5,17.3
0,0,0,0,0,0,0,0,0,"00",0,0,0,0,0,0,3277426,"2023-11-14T00:00:00.000Z",9,FALSE,1,54,"F",9,9,"Detroit Pistons","Bojan Bogdanovic",0,0,0,0,0,0
0,0,0,0,0,0,0,0,0,"00",0,0,0,0,0,0,3277426,"2023-11-14T00:00:00.000Z",9,FALSE,1,56677729,"G",9,9,"Detroit Pistons","Malcolm Cazalon",0,0,0,0,0,0
0,0,0,0,0,0,0,0,0,"00",0,0,0,0,0,0,3277426,"2023-11-14T00:00:00.000Z",9,FALSE,1,330,"G",9,9,"Detroit Pistons","Monte Morris",0,0,0,0,0,0
0,0,0,0,0,0,0,0,0,"00",0,0,0,0,0,0,3277426,"2023-11-14T00:00:00.000Z",9,FALSE,1,42097199,"G",9,9,"Detroit Pistons","Jared Rhoden",0,0,0,0,0,0
0,0,0,0,0,0,0,0,0,"00",0,0,0,0,0,0,3277426,"2023-11-14T00:00:00.000Z",9,FALSE,1,44477024,"G",9,9,"Detroit Pistons","Stanley Umude",0,0,0,0,0,0
5,0,3,5,2,14,6,3,2,"35",2,3,16,5,1,1,3277426,"2023-11-14T00:00:00.000Z",9,FALSE,1,666656,"F",1,1,"Atlanta Hawks","De'Andre Hunter",1,21,26,21,10,31.5
1,1,4,2,2,9,6,2,2,"36",1,2,16,5,1,2,3277426,"2023-11-14T00:00:00.000Z",9,FALSE,1,17896040,"F",1,1,"Atlanta Hawks","Jalen Johnson",2,21,22,17,6,27.5
1,3,5,0,0,4,3,2,2,"27",2,5,8,7,2,3,3277426,"2023-11-14T00:00:00.000Z",9,FALSE,1,83,"C",1,1,"Atlanta Hawks","Clint Capela",5,15,16,9,8,29.9
3,1,3,11,3,17,7,0,0,"34",0,0,17,3,0,3,3277426,"2023-11-14T00:00:00.000Z",9,FALSE,1,53,"G",1,1,"Atlanta Hawks","Bogdan Bogdanovic",1,20,23,20,6,25.1
2,1,4,7,2,13,6,6,5,"27",1,0,19,5,2,1,3277426,"2023-11-14T00:00:00.000Z",9,FALSE,1,3547256,"F",1,1,"Atlanta Hawks","Saddiq Bey",3,24,26,21,7,36
0,0,0,0,0,0,0,0,0,"00",0,0,0,0,0,0,3277426,"2023-11-14T00:00:00.000Z",9,FALSE,1,666564,"F",1,1,"Atlanta Hawks","Bruno Fernando",0,0,0,0,0,0
4,0,0,0,0,1,0,2,2,"13",1,0,2,1,0,0,3277426,"2023-11-14T00:00:00.000Z",9,FALSE,1,3547297,"G",1,1,"Atlanta Hawks","Trent Forrest",0,3,7,6,5,9.2
0,0,0,3,1,3,1,2,2,"08",0,2,5,0,0,0,3277426,"2023-11-14T00:00:00.000Z",9,FALSE,1,38017689,"F",1,1,"Atlanta Hawks","AJ Griffin",0,5,5,5,0,5
0,0,1,1,1,1,1,0,0,"02",0,0,3,1,0,0,3277426,"2023-11-14T00:00:00.000Z",9,FALSE,1,666754,"G",1,1,"Atlanta Hawks","Garrison Mathews",0,4,4,3,1,4.2
0,0,0,0,0,0,0,0,0,"00",0,0,0,0,0,0,3277426,"2023-11-14T00:00:00.000Z",9,FALSE,1,301,"G-F",1,1,"Atlanta Hawks","Wesley Matthews",0,0,0,0,0,0
0,0,0,0,0,0,0,0,0,"00",0,0,0,0,0,0,3277426,"2023-11-14T00:00:00.000Z",9,FALSE,1,319,"G",1,1,"Atlanta Hawks","Patty Mills",0,0,0,0,0,0
2,1,6,0,0,4,4,0,0,"21",3,5,8,9,0,2,3277426,"2023-11-14T00:00:00.000Z",9,FALSE,1,3547244,"F-C",1,1,"Atlanta Hawks","Onyeka Okongwu",1,17,19,10,11,22.8
0,0,0,0,0,0,0,0,0,"00",0,0,0,0,0,0,3277426,"2023-11-14T00:00:00.000Z",9,FALSE,1,56677838,"G",1,1,"Atlanta Hawks","Kobe Bufkin",0,0,0,0,0,0
0,0,0,0,0,0,0,0,0,"00",0,0,0,0,0,0,3277426,"2023-11-14T00:00:00.000Z",9,FALSE,1,56677806,"F",1,1,"Atlanta Hawks","Mouhamed Gueye",0,0,0,0,0,0
0,0,0,0,0,0,0,0,0,"00",0,0,0,0,0,0,3277426,"2023-11-14T00:00:00.000Z",9,FALSE,1,56677855,"G",1,1,"Atlanta Hawks","Seth Lundy",0,0,0,0,0,0
0,0,0,0,0,0,0,0,0,"00",0,0,0,0,0,0,3277426,"2023-11-14T00:00:00.000Z",9,FALSE,1,56677875,"F",1,1,"Atlanta Hawks","Miles Norris",0,0,0,0,0,0
0,0,0,0,0,0,0,0,0,"00",0,0,0,0,0,0,3277426,"2023-11-14T00:00:00.000Z",9,FALSE,1,490,"G",1,1,"Atlanta Hawks","Trae Young",0,0,0,0,0,0
9,0,5,4,1,21,11,9,9,"37",0,2,32,5,3,2,3277426,"2023-11-14T00:00:00.000Z",9,FALSE,1,334,"G",1,1,"Atlanta Hawks","Dejounte Murray",3,37,46,41,14,58.5
3,0,3,6,4,13,8,10,10,"35",1,5,30,4,1,2,3277427,"2023-11-14T00:00:00.000Z",23,FALSE,12,313,"G",23,23,"Philadelphia 76ers","De'Anthony Melton",1,34,37,33,7,40.3
5,1,4,5,2,23,9,7,7,"38",0,2,27,4,0,4,3277427,"2023-11-14T00:00:00.000Z",23,FALSE,12,3547254,"G",23,23,"Philadelphia 76ers","Tyrese Maxey",1,31,36,32,9,38.3
0,0,0,0,0,0,0,0,0,"00",0,0,0,0,0,0,3277427,"2023-11-14T00:00:00.000Z",23,FALSE,12,28,"C",23,23,"Philadelphia 76ers","Mo Bamba",0,0,0,0,0,0
2,0,5,2,0,3,1,0,0,"27",0,5,2,5,0,0,3277427,"2023-11-14T00:00:00.000Z",23,FALSE,12,45,"G",23,23,"Philadelphia 76ers","Patrick Beverley",0,7,9,4,7,11
0,0,1,0,0,0,0,0,0,"18",0,3,0,1,0,2,3277427,"2023-11-14T00:00:00.000Z",23,FALSE,12,2175,"",23,23,"Philadelphia 76ers","Danuel House Jr.",0,1,1,0,1,-0.8
0,0,0,0,0,0,0,0,0,"02",0,0,0,0,0,1,3277427,"2023-11-14T00:00:00.000Z",23,FALSE,12,260,"G-F",23,23,"Philadelphia 76ers","Furkan Korkmaz",0,0,0,0,0,-1
1,1,1,2,0,3,1,0,0,"16",0,2,2,1,0,0,3277427,"2023-11-14T00:00:00.000Z",23,FALSE,12,108,"F",23,23,"Philadelphia 76ers","Robert Covington",1,3,4,3,2,7.7
3,0,7,1,0,17,11,1,0,"37",0,3,22,7,1,1,3277427,"2023-11-14T00:00:00.000Z",23,FALSE,12,200,"F",23,23,"Philadelphia 76ers","Tobias Harris",1,29,32,25,10,36.9
6,0,9,4,0,22,11,17,17,"38",3,4,39,12,3,5,3277427,"2023-11-14T00:00:00.000Z",23,FALSE,12,145,"F-C",23,23,"Philadelphia 76ers","Joel Embiid",3,51,57,45,18,66.4
3,0,5,2,0,11,5,4,4,"36",0,4,14,5,1,0,3277427,"2023-11-14T00:00:00.000Z",23,FALSE,12,69,"G",12,12,"Indiana Pacers","Bruce Brown",1,19,22,17,8,27.5
15,1,6,12,7,18,11,5,4,"38",1,1,33,7,2,0,3277427,"2023-11-14T00:00:00.000Z",23,FALSE,12,3547245,"G",12,12,"Indiana Pacers","Tyrese Haliburton",3,40,55,48,22,72.9
1,0,2,3,0,5,1,0,0,"29",0,2,2,2,1,5,3277427,"2023-11-14T00:00:00.000Z",23,FALSE,12,210,"G",12,12,"Indiana Pacers","Buddy Hield",1,4,5,3,3,3.9
2,1,4,0,0,4,1,8,5,"17",5,4,7,9,0,1,3277427,"2023-11-14T00:00:00.000Z",23,FALSE,12,17896035,"F",12,12,"Indiana Pacers","Isaiah Jackson",1,16,18,9,11,22.8
3,0,2,2,0,8,5,1,1,"13",1,3,11,3,0,1,3277427,"2023-11-14T00:00:00.000Z",23,FALSE,12,304,"G",12,12,"Indiana Pacers","T.J. McConnell",0,14,17,14,6,18.1
1,0,0,1,1,2,2,1,0,"03",0,2,5,0,0,0,3277427,"2023-11-14T00:00:00.000Z",23,FALSE,12,3547264,"F-C",12,12,"Indiana Pacers","Jalen Smith",0,5,6,6,1,6.5
0,0,0,0,0,0,0,0,0,"01",0,0,0,0,0,0,3277427,"2023-11-14T00:00:00.000Z",23,FALSE,12,3547294,"F",23,23,"Philadelphia 76ers","Kenyon Martin Jr.",0,0,0,0,0,0
1,0,3,2,0,4,1,0,0,"18",0,1,2,3,0,0,3277427,"2023-11-14T00:00:00.000Z",23,FALSE,12,328,"F",23,23,"Philadelphia 76ers","Marcus Morris",0,5,6,3,4,7.1
1,1,0,0,0,1,1,0,0,"10",1,1,2,1,0,1,3277427,"2023-11-14T00:00:00.000Z",23,FALSE,12,3547270,"F",23,23,"Philadelphia 76ers","Paul Reed",1,3,4,3,2,6.7
0,0,0,0,0,0,0,0,0,"00",0,0,0,0,0,0,3277427,"2023-11-14T00:00:00.000Z",23,FALSE,12,17896025,"G",23,23,"Philadelphia 76ers","Jaden Springer",0,0,0,0,0,0
0,0,0,0,0,0,0,0,0,"00",0,0,0,0,0,0,3277427,"2023-11-14T00:00:00.000Z",23,FALSE,12,33,"F-G",23,23,"Philadelphia 76ers","Nicolas Batum",0,0,0,0,0,0
0,0,0,0,0,0,0,0,0,"00",0,0,0,0,0,0,3277427,"2023-11-14T00:00:00.000Z",23,FALSE,12,56913527,"G",23,23,"Philadelphia 76ers","Ricky Council IV",0,0,0,0,0,0
0,0,0,0,0,0,0,0,0,"00",0,0,0,0,0,0,3277427,"2023-11-14T00:00:00.000Z",23,FALSE,12,360,"F",23,23,"Philadelphia 76ers","Kelly Oubre Jr.",0,0,0,0,0,0
0,0,0,0,0,0,0,0,0,"00",0,0,0,0,0,0,3277427,"2023-11-14T00:00:00.000Z",23,FALSE,12,17554001,"G",23,23,"Philadelphia 76ers","Javonte Smart",0,0,0,0,0,0
0,0,0,0,0,0,0,0,0,"00",0,0,0,0,0,0,3277427,"2023-11-14T00:00:00.000Z",23,FALSE,12,56677788,"G",23,23,"Philadelphia 76ers","Terquavion Smith",0,0,0,0,0,0
0,0,0,4,2,8,3,0,0,"16",0,0,8,0,0,2,3277427,"2023-11-14T00:00:00.000Z",23,FALSE,12,38017686,"G-F",12,12,"Indiana Pacers","Bennedict Mathurin",0,8,8,8,0,6
1,1,5,3,1,15,12,4,2,"37",1,1,27,6,0,0,3277427,"2023-11-14T00:00:00.000Z",23,FALSE,12,3547243,"F",12,12,"Indiana Pacers","Obi Toppin",1,33,34,28,7,38.7
0,1,2,4,1,11,5,8,6,"19",1,6,17,3,1,1,3277427,"2023-11-14T00:00:00.000Z",23,FALSE,12,452,"C-F",12,12,"Indiana Pacers","Myles Turner",2,20,20,17,3,25.6
2,1,4,5,1,8,2,2,1,"22",0,4,6,4,1,1,3277427,"2023-11-14T00:00:00.000Z",23,FALSE,12,3547250,"G-F",12,12,"Indiana Pacers","Aaron Nesmith",2,10,12,8,6,18.8
4,0,1,1,0,3,1,0,0,"10",1,1,2,2,1,0,3277427,"2023-11-14T00:00:00.000Z",23,FALSE,12,38017507,"G-F",12,12,"Indiana Pacers","Andrew Nembhard",1,4,8,6,6,13.4
0,0,0,0,0,0,0,0,0,"00",0,0,0,0,0,0,3277427,"2023-11-14T00:00:00.000Z",23,FALSE,12,3547207,"F",12,12,"Indiana Pacers","Jordan Nwora",0,0,0,0,0,0
0,0,0,0,0,0,0,0,0,"00",0,0,0,0,0,0,3277427,"2023-11-14T00:00:00.000Z",23,FALSE,12,56677861,"G",12,12,"Indiana Pacers","Ben Sheppard",0,0,0,0,0,0
0,0,0,0,0,0,0,0,0,"00",0,0,0,0,0,0,3277427,"2023-11-14T00:00:00.000Z",23,FALSE,12,56677832,"F",12,12,"Indiana Pacers","Jarace Walker",0,0,0,0,0,0
0,0,0,0,0,0,0,0,0,"00",0,0,0,0,0,0,3277427,"2023-11-14T00:00:00.000Z",23,FALSE,12,38017701,"G",12,12,"Indiana Pacers","Kendall Brown",0,0,0,0,0,0
0,0,0,0,0,0,0,0,0,"00",0,0,0,0,0,0,3277427,"2023-11-14T00:00:00.000Z",23,FALSE,12,439,"F",13,12,"Indiana Pacers","Daniel Theis",0,0,0,0,0,0
0,0,0,0,0,0,0,0,0,"00",0,0,0,0,0,0,3277427,"2023-11-14T00:00:00.000Z",23,FALSE,12,56677778,"F-C",12,12,"Indiana Pacers","Oscar Tshiebwe",0,0,0,0,0,0
0,0,0,0,0,0,0,0,0,"00",0,0,0,0,0,0,3277427,"2023-11-14T00:00:00.000Z",23,FALSE,12,56677794,"G",12,12,"Indiana Pacers","Isaiah Wong",0,0,0,0,0,0
2,0,4,7,3,11,7,4,3,"29",1,1,20,5,3,1,3277428,"2023-11-14T00:00:00.000Z",3,FALSE,22,666679,"F",3,3,"Brooklyn Nets","Cameron Johnson",3,25,27,22,7,37
0,0,2,4,1,5,2,0,0,"24",2,1,5,4,1,0,3277428,"2023-11-14T00:00:00.000Z",3,FALSE,22,158,"F",3,3,"Brooklyn Nets","Dorian Finney-Smith",1,9,9,5,4,12.8
0,2,4,0,0,5,3,2,2,"21",2,4,8,6,1,1,3277428,"2023-11-14T00:00:00.000Z",3,FALSE,22,666508,"F-C",3,3,"Brooklyn Nets","Nicolas Claxton",3,14,14,8,6,23.2
4,0,4,5,3,17,9,1,0,"32",1,2,21,5,4,6,3277428,"2023-11-14T00:00:00.000Z",3,FALSE,22,61,"F",3,3,"Brooklyn Nets","Mikal Bridges",4,26,30,25,9,39
9,0,4,10,5,18,10,6,4,"37",1,3,29,5,0,1,3277428,"2023-11-14T00:00:00.000Z",3,FALSE,22,130,"G",3,3,"Brooklyn Nets","Spencer Dinwiddie",0,34,43,38,14,47.5
0,0,0,0,0,0,0,0,0,"00",0,0,0,0,0,0,3277428,"2023-11-14T00:00:00.000Z",3,FALSE,22,174,"F-C",3,3,"Brooklyn Nets","Harry Giles III",0,0,0,0,0,0
1,0,4,6,4,6,4,2,1,"34",0,4,13,4,0,1,3277428,"2023-11-14T00:00:00.000Z",3,FALSE,22,351,"F",3,3,"Brooklyn Nets","Royce O'Neale",0,17,18,14,5,18.3
0,1,5,0,0,7,4,5,3,"24",5,6,11,10,0,2,3277428,"2023-11-14T00:00:00.000Z",3,FALSE,22,17896038,"C",3,3,"Brooklyn Nets","Day'Ron Sharpe",1,21,21,11,10,24
5,0,2,1,0,7,3,0,0,"19",1,3,6,3,2,1,3277428,"2023-11-14T00:00:00.000Z",3,FALSE,22,421,"G",3,3,"Brooklyn Nets","Dennis Smith Jr.",2,9,14,11,8,22.1
0,0,0,0,0,0,0,0,0,"00",0,0,0,0,0,0,3277428,"2023-11-14T00:00:00.000Z",3,FALSE,22,17896048,"G",3,3,"Brooklyn Nets","Cam Thomas",0,0,0,0,0,0
1,0,2,6,3,9,4,0,0,"20",0,0,11,2,2,2,3277428,"2023-11-14T00:00:00.000Z",3,FALSE,22,464,"G",3,3,"Brooklyn Nets","Lonnie Walker IV",2,13,14,12,3,18.9
0,0,0,0,0,0,0,0,0,"00",0,0,0,0,0,0,3277428,"2023-11-14T00:00:00.000Z",3,FALSE,22,17896058,"F",3,3,"Brooklyn Nets","Trendon Watford",0,0,0,0,0,0
0,0,0,0,0,0,0,0,0,"00",0,0,0,0,0,0,3277428,"2023-11-14T00:00:00.000Z",3,FALSE,22,9051997,"G",3,3,"Brooklyn Nets","Armoni Brooks",0,0,0,0,0,0
0,0,0,0,0,0,0,0,0,"00",0,0,0,0,0,0,3277428,"2023-11-14T00:00:00.000Z",3,FALSE,22,56677843,"F",3,3,"Brooklyn Nets","Noah Clowney",0,0,0,0,0,0
1,0,0,3,0,4,1,0,0,"19",0,2,2,0,0,1,3277428,"2023-11-14T00:00:00.000Z",3,FALSE,22,56677827,"G",22,22,"Orlando Magic","Anthony Black",0,2,3,3,1,2.5
2,0,3,8,2,10,2,4,4,"28",3,0,10,6,0,4,3277428,"2023-11-14T00:00:00.000Z",3,FALSE,22,3547251,"G",22,22,"Orlando Magic","Cole Anthony",0,16,18,12,8,16.2
0,0,0,1,1,1,1,0,0,"05",0,1,3,0,0,0,3277428,"2023-11-14T00:00:00.000Z",3,FALSE,22,38017724,"G",22,22,"Orlando Magic","Caleb Houstan",0,3,3,3,0,3
0,0,0,4,0,4,0,0,0,"04",0,0,0,0,0,0,3277428,"2023-11-14T00:00:00.000Z",3,FALSE,22,56677839,"G",22,22,"Orlando Magic","Jett Howard",0,0,0,0,0,0
4,1,2,3,3,4,4,0,0,"21",1,1,11,3,1,1,3277428,"2023-11-14T00:00:00.000Z",3,FALSE,22,226,"F",22,22,"Orlando Magic","Joe Ingles",2,14,18,15,7,25.6
1,1,3,4,1,4,1,0,0,"12",0,1,3,3,2,2,3277428,"2023-11-14T00:00:00.000Z",3,FALSE,22,229,"F",22,22,"Orlando Magic","Jonathan Isaac",3,6,7,4,4,15.1
0,0,0,0,0,0,0,0,0,"02",0,0,0,0,0,0,3277428,"2023-11-14T00:00:00.000Z",3,FALSE,22,666818,"F",22,22,"Orlando Magic","Chuma Okeke",0,0,0,0,0,0
1,0,2,1,0,7,6,2,2,"25",1,4,14,3,2,0,3277428,"2023-11-14T00:00:00.000Z",3,FALSE,22,666442,"C",22,22,"Orlando Magic","Goga Bitadze",2,17,18,15,4,25.1
2,1,2,7,2,13,4,0,0,"32",0,2,10,2,2,3,3277428,"2023-11-14T00:00:00.000Z",3,FALSE,22,17896073,"G",22,22,"Orlando Magic","Jalen Suggs",3,12,14,12,4,21.4
0,0,0,0,0,0,0,0,0,"00",0,0,0,0,0,0,3277428,"2023-11-14T00:00:00.000Z",3,FALSE,22,17896041,"G",3,3,"Brooklyn Nets","Keon Johnson",0,0,0,0,0,0
0,0,0,0,0,0,0,0,0,"00",0,0,0,0,0,0,3277428,"2023-11-14T00:00:00.000Z",3,FALSE,22,417,"G-F",3,3,"Brooklyn Nets","Ben Simmons",0,0,0,0,0,0
0,0,0,0,0,0,0,0,0,"00",0,0,0,0,0,0,3277428,"2023-11-14T00:00:00.000Z",3,FALSE,22,56677841,"F",3,3,"Brooklyn Nets","Dariq Whitehead",0,0,0,0,0,0
0,0,0,0,0,0,0,0,0,"00",0,0,0,0,0,0,3277428,"2023-11-14T00:00:00.000Z",3,FALSE,22,56677722,"F",3,3,"Brooklyn Nets","Jalen Wilson",0,0,0,0,0,0
5,0,5,8,3,16,8,3,2,"36",3,2,21,8,0,0,3277428,"2023-11-14T00:00:00.000Z",3,FALSE,22,17896026,"F",22,22,"Orlando Magic","Franz Wagner",0,29,34,26,13,38.1
3,1,6,7,4,15,6,6,3,"35",0,0,19,6,2,2,3277428,"2023-11-14T00:00:00.000Z",3,FALSE,22,38017683,"F",22,22,"Orlando Magic","Paolo Banchero",3,25,28,22,9,37.7
4,0,5,0,0,4,3,6,5,"21",1,3,11,6,0,1,3277428,"2023-11-14T00:00:00.000Z",3,FALSE,22,462,"C",22,22,"Orlando Magic","Moritz Wagner",0,17,21,15,10,23.2
0,0,0,0,0,0,0,0,0,"00",0,0,0,0,0,0,3277428,"2023-11-14T00:00:00.000Z",3,FALSE,22,85,"F",22,22,"Orlando Magic","Wendell Carter Jr.",0,0,0,0,0,0
0,0,0,0,0,0,0,0,0,"00",0,0,0,0,0,0,3277428,"2023-11-14T00:00:00.000Z",3,FALSE,22,165,"G",22,22,"Orlando Magic","Markelle Fultz",0,0,0,0,0,0
0,0,0,0,0,0,0,0,0,"00",0,0,0,0,0,0,3277428,"2023-11-14T00:00:00.000Z",3,FALSE,22,196,"G",22,22,"Orlando Magic","Gary Harris",0,0,0,0,0,0
0,0,0,0,0,0,0,0,0,"00",0,0,0,0,0,0,3277428,"2023-11-14T00:00:00.000Z",3,FALSE,22,38017607,"G",22,22,"Orlando Magic","Kevon Harris",0,0,0,0,0,0
0,0,0,0,0,0,0,0,0,"00",0,0,0,0,0,0,3277428,"2023-11-14T00:00:00.000Z",3,FALSE,22,17553983,"G",22,22,"Orlando Magic","Trevelin Queen",0,0,0,0,0,0
0,0,0,0,0,0,0,0,0,"00",0,0,0,0,0,0,3277428,"2023-11-14T00:00:00.000Z",3,FALSE,22,666885,"F",22,22,"Orlando Magic","Admiral Schofield",0,0,0,0,0,0
0,1,2,3,1,6,2,2,1,"24",1,2,6,3,1,0,3277429,"2023-11-14T00:00:00.000Z",21,FALSE,27,666541,"G",21,21,"Oklahoma City Thunder","Luguentz Dort",2,9,9,6,3,15.6
3,0,2,3,1,9,5,0,0,"23",0,3,11,2,0,3,3277429,"2023-11-14T00:00:00.000Z",21,FALSE,27,38017703,"G-F",21,21,"Oklahoma City Thunder","Jalen Williams",0,13,16,14,5,14.9
3,1,7,5,1,10,3,2,2,"30",0,2,9,7,2,2,3277429,"2023-11-14T00:00:00.000Z",21,FALSE,27,38017685,"C-F",21,21,"Oklahoma City Thunder","Chet Holmgren",3,16,19,12,10,28.9
7,2,6,2,0,11,7,5,4,"25",1,0,18,7,0,3,3277429,"2023-11-14T00:00:00.000Z",21,FALSE,27,17896065,"G",21,21,"Oklahoma City Thunder","Josh Giddey",2,25,32,25,14,39.9
5,0,5,4,1,16,10,7,7,"28",1,2,28,6,7,2,3277429,"2023-11-14T00:00:00.000Z",21,FALSE,27,175,"G",21,21,"Oklahoma City Thunder","Shai Gilgeous-Alexander",7,34,39,33,11,61.7
0,0,0,0,0,0,0,0,0,"00",0,0,0,0,0,0,3277429,"2023-11-14T00:00:00.000Z",21,FALSE,27,44,"F",21,21,"Oklahoma City Thunder","Davis Bertans",0,0,0,0,0,0
1,0,2,3,2,5,3,0,0,"14",0,1,8,2,2,0,3277429,"2023-11-14T00:00:00.000Z",21,FALSE,27,3547272,"G",21,21,"Oklahoma City Thunder","Isaiah Joe",2,10,11,9,3,17.9
2,0,2,3,1,4,2,0,0,"08",0,0,5,2,1,1,3277429,"2023-11-14T00:00:00.000Z",21,FALSE,27,17896036,"G",21,21,"Oklahoma City Thunder","Tre Mann",1,7,9,7,4,12.4
4,0,1,3,2,4,2,4,2,"19",0,1,8,1,1,2,3277429,"2023-11-14T00:00:00.000Z",21,FALSE,27,4197029,"G",21,21,"Oklahoma City Thunder","Vasilije Micic",1,9,13,12,5,16.2
1,0,1,1,0,1,0,0,0,"05",0,0,0,1,0,0,3277429,"2023-11-14T00:00:00.000Z",21,FALSE,27,3547271,"C",21,21,"Oklahoma City Thunder","Aleksej Pokusevski",0,1,2,1,2,2.7
3,2,4,1,1,5,4,0,0,"21",1,1,9,5,2,1,3277429,"2023-11-14T00:00:00.000Z",21,FALSE,27,56677833,"G",21,21,"Oklahoma City Thunder","Cason Wallace",4,14,17,12,8,30.5
1,0,5,0,0,5,3,0,0,"17",2,1,6,7,0,0,3277429,"2023-11-14T00:00:00.000Z",21,FALSE,27,17895854,"G",27,27,"San Antonio Spurs","Charles Bassey",0,13,14,7,8,15.9
0,0,0,3,2,3,2,0,0,"05",0,0,6,0,0,0,3277429,"2023-11-14T00:00:00.000Z",21,FALSE,27,27924547,"F",21,21,"Oklahoma City Thunder","Lindy Waters III",0,6,6,6,0,6
1,0,0,1,1,1,1,0,0,"05",0,0,3,0,1,0,3277429,"2023-11-14T00:00:00.000Z",21,FALSE,27,17896078,"G",21,21,"Oklahoma City Thunder","Aaron Wiggins",1,3,4,4,1,7.5
2,0,4,4,1,7,1,0,0,"18",0,2,3,4,2,0,3277429,"2023-11-14T00:00:00.000Z",21,FALSE,27,38017706,"F",21,21,"Oklahoma City Thunder","Jaylin Williams",2,7,9,5,6,16.8
2,0,0,3,1,7,4,0,0,"15",0,3,9,0,0,1,3277429,"2023-11-14T00:00:00.000Z",21,FALSE,27,480,"G-F",21,21,"Oklahoma City Thunder","Kenrich Williams",0,9,11,11,2,11
0,0,0,0,0,0,0,0,0,"00",0,0,0,0,0,0,3277429,"2023-11-14T00:00:00.000Z",21,FALSE,27,38017716,"F",21,21,"Oklahoma City Thunder","Ousmane Dieng",0,0,0,0,0,0
0,0,0,0,0,0,0,0,0,"00",0,0,0,0,0,0,3277429,"2023-11-14T00:00:00.000Z",21,FALSE,27,56677853,"F",21,21,"Oklahoma City Thunder","Keyontae Johnson",0,0,0,0,0,0
0,0,0,0,0,0,0,0,0,"00",0,0,0,0,0,0,3277429,"2023-11-14T00:00:00.000Z",21,FALSE,27,24572055,"C",21,21,"Oklahoma City Thunder","Olivier Sarr",0,0,0,0,0,0
3,3,2,7,3,14,4,2,2,"31",1,0,13,3,4,2,3277429,"2023-11-14T00:00:00.000Z",21,FALSE,27,38017649,"F",27,27,"San Antonio Spurs","Julian Champagnie",7,16,19,16,6,40.1
2,2,11,3,0,15,4,0,0,"28",3,2,8,14,0,5,3277429,"2023-11-14T00:00:00.000Z",21,FALSE,27,56677822,"F-C",27,27,"San Antonio Spurs","Victor Wembanyama",2,22,24,10,16,28.8
0,0,1,0,0,0,0,0,0,"05",0,0,0,1,0,0,3277429,"2023-11-14T00:00:00.000Z",21,FALSE,27,38017730,"F",27,27,"San Antonio Spurs","Dominick Barlow",0,1,1,0,1,1.2
0,0,1,4,0,13,5,2,1,"26",1,2,11,2,1,3,3277429,"2023-11-14T00:00:00.000Z",21,FALSE,27,38017692,"F",27,27,"San Antonio Spurs","Malaki Branham",1,13,13,11,2,13.4
7,0,1,2,0,3,1,3,2,"17",0,2,4,1,0,2,3277429,"2023-11-14T00:00:00.000Z",21,FALSE,27,180,"G",27,27,"San Antonio Spurs","Devonte' Graham",0,5,12,11,8,13.7
0,0,0,0,0,0,0,0,0,"00",0,0,0,0,0,0,3277429,"2023-11-14T00:00:00.000Z",21,FALSE,27,17896059,"F",27,27,"San Antonio Spurs","Sandro Mamukelashvili",0,0,0,0,0,0
1,0,1,2,1,4,2,0,0,"18",0,0,5,1,0,4,3277429,"2023-11-14T00:00:00.000Z",21,FALSE,27,305,"F",27,27,"San Antonio Spurs","Doug McDermott",0,6,7,6,2,3.7
0,0,0,5,2,5,2,0,0,"14",0,0,6,0,0,0,3277429,"2023-11-14T00:00:00.000Z",21,FALSE,27,359,"F",27,27,"San Antonio Spurs","Cedi Osman",0,6,6,6,0,6
0,0,0,0,0,0,0,0,0,"00",0,0,0,0,0,0,3277429,"2023-11-14T00:00:00.000Z",21,FALSE,27,56677865,"C",27,27,"San Antonio Spurs","Charles Bediako",0,0,0,0,0,0
0,0,0,0,0,0,0,0,0,"00",0,0,0,0,0,0,3277429,"2023-11-14T00:00:00.000Z",21,FALSE,27,56677817,"G",27,27,"San Antonio Spurs","Sidy Cissoko",0,0,0,0,0,0
0,0,0,0,0,0,0,0,0,"00",0,0,0,0,0,0,3277429,"2023-11-14T00:00:00.000Z",21,FALSE,27,666682,"F",27,27,"San Antonio Spurs","Keldon Johnson",0,0,0,0,0,0
0,0,0,0,0,0,0,0,0,"00",0,0,0,0,0,0,3277429,"2023-11-14T00:00:00.000Z",21,FALSE,27,3547274,"G",27,27,"San Antonio Spurs","Tre Jones",0,0,0,0,0,0
0,0,0,0,0,0,0,0,0,"00",0,0,0,0,0,0,3277429,"2023-11-14T00:00:00.000Z",21,FALSE,27,56677870,"G",27,27,"San Antonio Spurs","Sir'Jabari Rice",0,0,0,0,0,0
0,0,0,0,0,0,0,0,0,"00",0,0,0,0,0,0,3277429,"2023-11-14T00:00:00.000Z",21,FALSE,27,38017693,"G",27,27,"San Antonio Spurs","Blake Wesley",0,0,0,0,0,0
1,0,3,4,1,11,6,0,0,"31",5,3,13,8,0,4,3277429,"2023-11-14T00:00:00.000Z",21,FALSE,27,102,"F-C",27,27,"San Antonio Spurs","Zach Collins",0,21,22,14,9,20.1
5,0,2,1,1,11,4,0,0,"28",1,2,9,3,0,3,3277429,"2023-11-14T00:00:00.000Z",21,FALSE,27,38017699,"F",27,27,"San Antonio Spurs","Jeremy Sochan",0,12,17,14,8,17.1
4,1,3,2,1,12,5,2,1,"25",0,1,12,3,2,1,3277429,"2023-11-14T00:00:00.000Z",21,FALSE,27,3547246,"G-F",27,27,"San Antonio Spurs","Devin Vassell",3,15,19,16,7,29.6
7,0,8,5,1,20,11,2,2,"36",1,0,25,9,2,2,3277430,"2023-11-14T00:00:00.000Z",19,FALSE,7,227,"F",19,19,"New Orleans Pelicans","Brandon Ingram",2,34,41,32,16,50.3
5,0,4,0,0,15,8,7,3,"27",3,3,19,7,2,2,3277430,"2023-11-14T00:00:00.000Z",19,FALSE,7,666969,"F",19,19,"New Orleans Pelicans","Zion Williamson",2,26,31,24,12,38.9
4,2,3,2,0,5,3,0,0,"22",0,1,6,3,1,0,3277430,"2023-11-14T00:00:00.000Z",19,FALSE,7,455,"C",19,19,"New Orleans Pelicans","Jonas Valanciunas",3,9,13,10,7,24.6
4,2,3,4,2,8,6,6,5,"31",1,5,19,4,5,2,3277430,"2023-11-14T00:00:00.000Z",19,FALSE,7,17896024,"F",19,19,"New Orleans Pelicans","Herbert Jones",7,23,27,23,8,48.8
6,0,1,5,2,10,4,0,0,"29",1,4,10,2,3,1,3277430,"2023-11-14T00:00:00.000Z",19,FALSE,7,38017677,"G",19,19,"New Orleans Pelicans","Dyson Daniels",3,12,18,16,8,29.4
3,0,4,12,5,17,8,4,4,"33",2,3,25,6,0,0,3277430,"2023-11-14T00:00:00.000Z",19,FALSE,7,56677837,"G",19,19,"New Orleans Pelicans","Jordan Hawkins",0,31,34,28,9,36.7
0,0,0,0,0,1,1,0,0,"02",0,0,2,0,0,0,3277430,"2023-11-14T00:00:00.000Z",19,FALSE,7,3547260,"G",19,19,"New Orleans Pelicans","Kira Lewis Jr.",0,2,2,2,0,2
2,2,2,4,1,9,5,5,5,"20",2,2,16,4,1,1,3277430,"2023-11-14T00:00:00.000Z",19,FALSE,7,3547293,"F",19,19,"New Orleans Pelicans","Naji Marshall",3,20,22,18,6,31.8
2,0,1,1,1,1,1,0,0,"13",1,2,3,2,1,3,3277430,"2023-11-14T00:00:00.000Z",19,FALSE,7,17896021,"F",19,19,"New Orleans Pelicans","Jeremiah Robinson-Earl",1,5,7,5,4,8.4
0,0,2,5,2,7,2,0,0,"20",0,0,6,2,1,0,3277430,"2023-11-14T00:00:00.000Z",19,FALSE,7,17896017,"F",19,19,"New Orleans Pelicans","Matt Ryan",1,8,8,6,2,11.4
0,0,0,0,0,0,0,0,0,"02",0,0,0,0,1,0,3277430,"2023-11-14T00:00:00.000Z",19,FALSE,7,38017726,"G",19,19,"New Orleans Pelicans","Dereon Seabron",1,0,0,0,0,3
0,0,2,0,0,1,0,2,0,"05",1,0,0,3,0,1,3277430,"2023-11-14T00:00:00.000Z",19,FALSE,7,491,"C",19,19,"New Orleans Pelicans","Cody Zeller",0,3,3,0,3,2.6
0,0,0,0,0,0,0,0,0,"00",0,0,0,0,0,0,3277430,"2023-11-14T00:00:00.000Z",19,FALSE,7,17896097,"G",19,19,"New Orleans Pelicans","Jose Alvarado",0,0,0,0,0,0
0,0,0,0,0,0,0,0,0,"00",0,0,0,0,0,0,3277430,"2023-11-14T00:00:00.000Z",19,FALSE,7,38017663,"F",19,19,"New Orleans Pelicans","E.J. Liddell",0,0,0,0,0,0
0,0,0,0,0,0,0,0,0,"00",0,0,0,0,0,0,3277430,"2023-11-14T00:00:00.000Z",19,FALSE,7,303,"G",19,19,"New Orleans Pelicans","CJ McCollum",0,0,0,0,0,0
0,0,0,0,0,0,0,0,0,"00",0,0,0,0,0,0,3277430,"2023-11-14T00:00:00.000Z",19,FALSE,7,18677986,"F",19,19,"New Orleans Pelicans","Trey Murphy III",0,0,0,0,0,0
0,0,0,0,0,0,0,0,0,"00",0,0,0,0,0,0,3277430,"2023-11-14T00:00:00.000Z",19,FALSE,7,340,"F",19,19,"New Orleans Pelicans","Larry Nance Jr.",0,0,0,0,0,0
2,1,1,3,1,4,2,2,2,"19",2,1,7,3,0,1,3277430,"2023-11-14T00:00:00.000Z",19,FALSE,7,247,"F-G",7,7,"Dallas Mavericks","Derrick Jones Jr.",1,10,12,9,5,15.6
0,1,1,4,3,6,3,2,1,"24",0,0,10,1,0,2,3277430,"2023-11-14T00:00:00.000Z",19,FALSE,7,666965,"F",7,7,"Dallas Mavericks","Grant Williams",1,11,11,10,1,12.2
2,0,6,1,0,2,1,2,2,"21",3,2,4,9,0,0,3277430,"2023-11-14T00:00:00.000Z",19,FALSE,7,56677840,"C",7,7,"Dallas Mavericks","Dereck Lively II",0,13,15,6,11,17.8
6,0,1,7,3,13,6,4,2,"26",1,1,17,2,0,1,3277430,"2023-11-14T00:00:00.000Z",19,FALSE,7,228,"G",7,7,"Dallas Mavericks","Kyrie Irving",0,19,25,23,8,27.4
2,0,1,5,3,16,5,5,3,"26",1,0,16,2,0,8,3277430,"2023-11-14T00:00:00.000Z",19,FALSE,7,132,"F-G",7,7,"Dallas Mavericks","Luka Doncic",0,18,20,18,4,13.4
1,0,0,9,3,11,5,4,4,"21",0,2,17,0,0,1,3277430,"2023-11-14T00:00:00.000Z",19,FALSE,7,191,"G",7,7,"Dallas Mavericks","Tim Hardaway Jr.",0,17,18,18,1,17.5
2,0,0,2,0,6,4,1,1,"12",1,2,9,1,0,1,3277430,"2023-11-14T00:00:00.000Z",19,FALSE,7,151,"G",7,7,"Dallas Mavericks","Dante Exum",0,10,12,11,3,12.2
3,0,2,3,0,12,4,1,1,"18",0,3,9,2,1,1,3277430,"2023-11-14T00:00:00.000Z",19,FALSE,7,38017679,"G",7,7,"Dallas Mavericks","Jaden Hardy",1,11,14,12,5,17.9
2,0,3,4,0,4,0,3,3,"13",0,1,3,3,3,1,3277430,"2023-11-14T00:00:00.000Z",19,FALSE,7,114,"G",7,7,"Dallas Mavericks","Seth Curry",3,6,8,5,5,17.6
0,0,4,0,0,6,3,0,0,"12",3,2,6,7,0,1,3277430,"2023-11-14T00:00:00.000Z",19,FALSE,7,217,"F-C",7,7,"Dallas Mavericks","Richaun Holmes",0,13,13,6,7,13.4
0,0,0,0,0,0,0,0,0,"00",0,0,0,0,0,0,3277430,"2023-11-14T00:00:00.000Z",19,FALSE,7,329,"F",7,7,"Dallas Mavericks","Markieff Morris",0,0,0,0,0,0
0,0,2,2,1,3,2,2,1,"09",1,0,6,3,0,0,3277430,"2023-11-14T00:00:00.000Z",19,FALSE,7,56677859,"F",7,7,"Dallas Mavericks","Olivier-Maxence Prosper",0,9,9,6,3,9.6
0,0,0,0,0,0,0,0,0,"00",0,0,0,0,0,0,3277430,"2023-11-14T00:00:00.000Z",19,FALSE,7,17896028,"F",7,7,"Dallas Mavericks","Greg Brown III",0,0,0,0,0,0
1,1,4,0,0,4,2,0,0,"11",3,1,4,7,0,1,3277430,"2023-11-14T00:00:00.000Z",19,FALSE,7,379,"F-C",7,7,"Dallas Mavericks","Dwight Powell",1,11,12,5,8,15.9
4,0,4,2,0,3,1,0,0,"28",1,1,2,5,0,2,3277430,"2023-11-14T00:00:00.000Z",19,FALSE,7,3547258,"G",7,7,"Dallas Mavericks","Josh Green",0,7,11,6,9,12
0,0,0,0,0,0,0,0,0,"00",0,0,0,0,0,0,3277430,"2023-11-14T00:00:00.000Z",19,FALSE,7,56677873,"G",7,7,"Dallas Mavericks","Dexter Dennis",0,0,0,0,0,0
0,0,0,0,0,0,0,0,0,"00",0,0,0,0,0,0,3277430,"2023-11-14T00:00:00.000Z",19,FALSE,7,257,"F",7,7,"Dallas Mavericks","Maxi Kleber",0,0,0,0,0,0
0,0,0,0,0,0,0,0,0,"00",0,0,0,0,0,0,3277430,"2023-11-14T00:00:00.000Z",19,FALSE,7,17554004,"G",7,7,"Dallas Mavericks","AJ Lawson",0,0,0,0,0,0
1,1,4,2,0,7,2,2,2,"26",4,1,6,8,2,0,3277431,"2023-11-14T00:00:00.000Z",29,FALSE,25,38017620,"G",29,29,"Utah Jazz","Ochai Agbaji",3,14,15,7,9,26.1
2,3,6,5,2,16,6,0,0,"32",4,3,14,10,1,1,3277431,"2023-11-14T00:00:00.000Z",29,FALSE,25,101,"F-C",29,29,"Utah Jazz","John Collins",4,24,26,16,12,40
0,1,8,9,2,18,8,4,3,"31",1,1,21,9,1,0,3277431,"2023-11-14T00:00:00.000Z",29,FALSE,25,297,"F",29,29,"Utah Jazz","Lauri Markkanen",2,30,30,21,9,37.8
3,0,1,9,4,19,13,0,0,"33",0,2,30,1,2,1,3277431,"2023-11-14T00:00:00.000Z",29,FALSE,25,100,"G",29,29,"Utah Jazz","Jordan Clarkson",2,31,34,33,4,40.7
7,0,4,7,2,9,4,5,5,"26",0,2,15,4,1,2,3277431,"2023-11-14T00:00:00.000Z",29,FALSE,25,56677834,"G",29,29,"Utah Jazz","Keyonte George",1,19,26,22,11,31.3
3,0,2,1,0,5,2,0,0,"21",1,3,4,3,1,2,3277431,"2023-11-14T00:00:00.000Z",29,FALSE,25,666650,"G",29,29,"Utah Jazz","Talen Horton-Tucker",1,7,10,7,6,13.1
3,0,6,3,2,8,4,2,2,"24",6,1,12,12,1,3,3277431,"2023-11-14T00:00:00.000Z",29,FALSE,25,358,"F",29,29,"Utah Jazz","Kelly Olynyk",1,24,27,15,15,30.9
7,1,4,5,1,11,5,2,2,"28",0,3,13,4,2,2,3277431,"2023-11-14T00:00:00.000Z",29,FALSE,25,413,"G",29,29,"Utah Jazz","Collin Sexton",3,17,24,20,11,35.3
10,2,5,1,0,8,3,0,0,"31",0,1,6,5,0,2,3277431,"2023-11-14T00:00:00.000Z",29,FALSE,25,3547289,"G",25,25,"Portland Trail Blazers","Skylar Mays",2,11,21,16,15,31
0,0,1,2,0,5,0,0,0,"17",0,2,0,1,0,4,3277431,"2023-11-14T00:00:00.000Z",29,FALSE,25,44477062,"G",25,25,"Portland Trail Blazers","Jamaree Bouyea",0,1,1,0,1,-2.8
0,0,0,0,0,0,0,0,0,"00",0,0,0,0,0,0,3277431,"2023-11-14T00:00:00.000Z",29,FALSE,25,666476,"C",25,25,"Portland Trail Blazers","Moses Brown",0,0,0,0,0,0
0,0,0,0,0,0,0,0,0,"03",1,0,0,1,0,0,3277431,"2023-11-14T00:00:00.000Z",29,FALSE,25,47957121,"F",25,25,"Portland Trail Blazers","Justin Minaya",0,1,1,0,1,1.2
0,0,0,0,0,0,0,0,0,"03",0,0,0,0,0,0,3277431,"2023-11-14T00:00:00.000Z",29,FALSE,25,56677791,"F",25,25,"Portland Trail Blazers","Kris Murray",0,0,0,0,0,0
0,0,0,3,0,4,0,0,0,"10",1,1,0,1,0,2,3277431,"2023-11-14T00:00:00.000Z",29,FALSE,25,56783340,"C",25,25,"Portland Trail Blazers","Duop Reath",0,1,1,0,1,-0.8
1,0,2,5,2,5,2,0,0,"22",0,1,6,2,0,0,3277431,"2023-11-14T00:00:00.000Z",29,FALSE,25,666923,"G-F",25,25,"Portland Trail Blazers","Matisse Thybulle",0,8,9,7,3,9.9
0,1,6,3,2,7,5,0,0,"21",2,0,12,8,2,0,3277431,"2023-11-14T00:00:00.000Z",29,FALSE,25,38017711,"F",25,25,"Portland Trail Blazers","Jabari Walker",3,20,20,12,8,30.6
0,0,0,0,0,0,0,0,0,"00",0,0,0,0,0,0,3277431,"2023-11-14T00:00:00.000Z",29,FALSE,25,38017705,"C",29,29,"Utah Jazz","Walker Kessler",0,0,0,0,0,0
0,0,0,0,0,0,0,0,0,"00",0,0,0,0,0,0,3277431,"2023-11-14T00:00:00.000Z",29,FALSE,25,19465584,"F",29,29,"Utah Jazz","Micah Potter",0,0,0,0,0,0
0,0,0,0,0,0,0,0,0,"00",0,0,0,0,0,0,3277431,"2023-11-14T00:00:00.000Z",29,FALSE,25,56677842,"F",29,29,"Utah Jazz","Brice Sensabaugh",0,0,0,0,0,0
1,1,2,6,3,17,10,4,3,"27",0,3,26,2,0,2,3277431,"2023-11-14T00:00:00.000Z",29,FALSE,25,182,"F",25,25,"Portland Trail Blazers","Jerami Grant",1,28,29,27,3,30.9
1,2,3,4,2,6,3,2,1,"26",2,2,9,5,0,2,3277431,"2023-11-14T00:00:00.000Z",29,FALSE,25,56677850,"F",25,25,"Portland Trail Blazers","Toumani Camara",2,14,15,10,6,20.5
0,0,0,0,0,0,0,0,0,"00",0,0,0,0,0,0,3277431,"2023-11-14T00:00:00.000Z",29,FALSE,25,56677824,"F",29,29,"Utah Jazz","Taylor Hendricks",0,0,0,0,0,0
0,0,0,0,0,0,0,0,0,"00",0,0,0,0,0,0,3277431,"2023-11-14T00:00:00.000Z",29,FALSE,25,38017630,"G",29,29,"Utah Jazz","Johnny Juzang",0,0,0,0,0,0
0,0,1,2,0,2,0,0,0,"16",0,2,0,1,0,0,3277431,"2023-11-14T00:00:00.000Z",29,FALSE,25,38017739,"F",29,29,"Utah Jazz","Simone Fontecchio",0,1,1,0,1,1.2
0,0,0,0,0,2,0,2,1,"02",0,0,1,0,0,0,3277431,"2023-11-14T00:00:00.000Z",29,FALSE,25,56677829,"G-F",25,25,"Portland Trail Blazers","Rayan Rupert",0,1,1,1,0,1
0,0,0,1,0,1,0,0,0,"03",0,1,0,0,1,0,3277431,"2023-11-14T00:00:00.000Z",29,FALSE,25,17896120,"F",25,25,"Portland Trail Blazers","Ish Wainright",1,0,0,0,0,3
0,0,0,0,0,0,0,0,0,"00",0,0,0,0,0,0,3277431,"2023-11-14T00:00:00.000Z",29,FALSE,25,65,"G",25,25,"Portland Trail Blazers","Malcolm Brogdon",0,0,0,0,0,0
0,0,0,0,0,0,0,0,0,"00",0,0,0,0,0,0,3277431,"2023-11-14T00:00:00.000Z",29,FALSE,25,56677747,"G",25,25,"Portland Trail Blazers","Scoot Henderson",0,0,0,0,0,0
0,0,0,0,0,0,0,0,0,"00",0,0,0,0,0,0,3277431,"2023-11-14T00:00:00.000Z",29,FALSE,25,419,"G",25,25,"Portland Trail Blazers","Anfernee Simons",0,0,0,0,0,0
0,0,0,0,0,0,0,0,0,"00",0,0,0,0,0,0,3277431,"2023-11-14T00:00:00.000Z",29,FALSE,25,476,"C-F",25,25,"Portland Trail Blazers","Robert Williams III",0,0,0,0,0,0
0,0,0,0,0,0,0,0,0,"01",0,0,0,0,0,1,3277431,"2023-11-14T00:00:00.000Z",29,FALSE,25,139,"G",29,29,"Utah Jazz","Kris Dunn",0,0,0,0,0,-1
0,0,0,0,0,0,0,0,0,"01",0,0,0,0,0,0,3277431,"2023-11-14T00:00:00.000Z",29,FALSE,25,666881,"F",29,29,"Utah Jazz","Luka Samanic",0,0,0,0,0,0
0,0,0,0,0,0,0,0,0,"01",0,0,0,0,0,0,3277431,"2023-11-14T00:00:00.000Z",29,FALSE,25,11891374,"C",29,29,"Utah Jazz","Omer Yurtseven",0,0,0,0,0,0
0,0,0,0,0,0,0,0,0,"00",0,0,0,0,0,0,3277431,"2023-11-14T00:00:00.000Z",29,FALSE,25,17896023,"G",29,29,"Utah Jazz","Josh Christopher",0,0,0,0,0,0
7,0,6,10,2,16,4,10,7,"41",2,3,17,8,2,3,3277431,"2023-11-14T00:00:00.000Z",29,FALSE,25,38017690,"G",25,25,"Portland Trail Blazers","Shaedon Sharpe",2,25,32,24,15,40.1
3,0,5,0,0,17,10,2,2,"34",5,1,22,10,0,2,3277431,"2023-11-14T00:00:00.000Z",29,FALSE,25,22,"C",25,25,"Portland Trail Blazers","Deandre Ayton",0,32,35,25,13,36.5
0,1,4,8,2,11,4,2,0,"34",1,3,10,5,1,2,3277432,"2023-11-14T00:00:00.000Z",8,FALSE,13,375,"F",8,8,"Denver Nuggets","Michael Porter Jr.",2,15,15,10,5,20
5,0,4,2,1,12,8,3,3,"39",1,1,20,5,0,3,3277432,"2023-11-14T00:00:00.000Z",8,FALSE,13,177,"F",8,8,"Denver Nuggets","Aaron Gordon",0,25,30,25,10,30.5
9,0,13,7,2,23,8,14,14,"36",3,2,32,16,1,4,3277432,"2023-11-14T00:00:00.000Z",8,FALSE,13,246,"C",8,8,"Denver Nuggets","Nikola Jokic",1,48,57,41,25,63.7
4,0,1,3,2,3,2,5,3,"39",0,3,9,1,1,1,3277432,"2023-11-14T00:00:00.000Z",8,FALSE,13,81,"G",8,8,"Denver Nuggets","Kentavious Caldwell-Pope",1,10,14,13,5,18.2
0,0,0,0,0,0,0,0,0,"00",0,0,0,0,0,0,3277432,"2023-11-14T00:00:00.000Z",8,FALSE,13,17896031,"G",13,13,"LA Clippers","Nah'Shon Hyland",0,0,0,0,0,0
5,0,2,0,0,1,0,0,0,"28",4,3,0,6,0,1,3277432,"2023-11-14T00:00:00.000Z",8,FALSE,13,666743,"G",13,13,"LA Clippers","Terance Mann",0,6,11,5,11,13.7
1,0,1,3,2,7,4,5,4,"26",0,5,14,1,0,0,3277432,"2023-11-14T00:00:00.000Z",8,FALSE,13,380,"F-G",13,13,"LA Clippers","Norman Powell",0,15,16,15,2,16.7
0,0,3,3,2,3,2,0,0,"21",2,1,6,5,0,1,3277432,"2023-11-14T00:00:00.000Z",8,FALSE,13,450,"F",13,13,"LA Clippers","PJ Tucker",0,11,11,6,5,11
0,0,0,0,0,0,0,0,0,"00",0,0,0,0,0,0,3277432,"2023-11-14T00:00:00.000Z",8,FALSE,13,17896022,"G",13,13,"LA Clippers","Brandon Boston Jr.",0,0,0,0,0,0
0,0,0,0,0,0,0,0,0,"00",0,0,0,0,0,0,3277432,"2023-11-14T00:00:00.000Z",8,FALSE,13,56677856,"G",13,13,"LA Clippers","Jordan Miller",0,0,0,0,0,0
0,0,0,0,0,0,0,0,0,"00",0,0,0,0,0,0,3277432,"2023-11-14T00:00:00.000Z",8,FALSE,13,371,"F-C",13,13,"LA Clippers","Mason Plumlee",0,0,0,0,0,0
0,0,0,0,0,0,0,0,0,"00",0,0,0,0,0,0,3277432,"2023-11-14T00:00:00.000Z",8,FALSE,13,17896051,"G",13,13,"LA Clippers","Joshua Primo",0,0,0,0,0,0
4,1,3,1,0,11,7,6,4,"30",0,3,18,3,0,2,3277432,"2023-11-14T00:00:00.000Z",8,FALSE,13,236,"G",8,8,"Denver Nuggets","Reggie Jackson",1,21,25,22,7,28.6
1,0,1,0,0,6,5,0,0,"20",0,3,10,1,0,0,3277432,"2023-11-14T00:00:00.000Z",8,FALSE,13,38017709,"G",8,8,"Denver Nuggets","Christian Braun",0,11,12,11,2,12.7
0,0,0,0,0,0,0,0,0,"00",0,0,0,0,0,0,3277432,"2023-11-14T00:00:00.000Z",8,FALSE,13,38017727,"G",8,8,"Denver Nuggets","Collin Gillespie",0,0,0,0,0,0
0,0,2,0,0,2,1,2,1,"12",1,1,3,3,0,0,3277432,"2023-11-14T00:00:00.000Z",8,FALSE,13,3547268,"F-C",8,8,"Denver Nuggets","Zeke Nnaji",0,6,6,3,3,6.6
2,0,2,2,1,3,2,0,0,"17",0,2,5,2,1,2,3277432,"2023-11-14T00:00:00.000Z",8,FALSE,13,56677582,"G",8,8,"Denver Nuggets","Jalen Pickett",1,7,9,7,4,11.4
0,0,0,0,0,2,2,0,0,"11",0,1,4,0,0,0,3277432,"2023-11-14T00:00:00.000Z",8,FALSE,13,38017721,"G",8,8,"Denver Nuggets","Peyton Watson",0,4,4,4,0,4
0,0,0,0,0,0,0,0,0,"00",0,0,0,0,0,0,3277432,"2023-11-14T00:00:00.000Z",8,FALSE,13,17896103,"F-C",8,8,"Denver Nuggets","Jay Huff",0,0,0,0,0,0
0,0,0,0,0,0,0,0,0,"00",0,0,0,0,0,0,3277432,"2023-11-14T00:00:00.000Z",8,FALSE,13,335,"G",8,8,"Denver Nuggets","Jamal Murray",0,0,0,0,0,0
0,0,0,0,0,0,0,0,0,"00",0,0,0,0,0,0,3277432,"2023-11-14T00:00:00.000Z",8,FALSE,13,56677871,"F",8,8,"Denver Nuggets","Hunter Tyson",0,0,0,0,0,0
3,0,7,11,4,26,13,5,5,"40",0,4,35,7,3,1,3277432,"2023-11-14T00:00:00.000Z",8,FALSE,13,172,"F",13,13,"LA Clippers","Paul George",3,42,45,38,10,55.9
2,0,2,3,2,14,5,4,3,"38",0,1,15,2,5,3,3277432,"2023-11-14T00:00:00.000Z",8,FALSE,13,274,"F",13,13,"LA Clippers","Kawhi Leonard",5,17,19,17,4,32.4
3,1,6,0,0,8,2,6,5,"26",7,4,9,13,0,0,3277432,"2023-11-14T00:00:00.000Z",8,FALSE,13,493,"C",13,13,"LA Clippers","Ivica Zubac",1,22,25,12,16,32.1
4,0,2,8,3,15,7,4,4,"36",0,3,21,2,0,1,3277432,"2023-11-14T00:00:00.000Z",8,FALSE,13,192,"G",13,13,"LA Clippers","James Harden",0,23,27,25,6,28.4
0,0,0,0,0,0,0,0,0,"00",0,0,0,0,0,0,3277432,"2023-11-14T00:00:00.000Z",8,FALSE,13,56677849,"F",13,13,"LA Clippers","Kobe Brown",0,0,0,0,0,0
0,0,0,0,0,0,0,0,0,"00",0,0,0,0,0,0,3277432,"2023-11-14T00:00:00.000Z",8,FALSE,13,666511,"G",13,13,"LA Clippers","Amir Coffey",0,0,0,0,0,0
0,0,0,0,0,0,0,0,0,"00",0,0,0,0,0,0,3277432,"2023-11-14T00:00:00.000Z",8,FALSE,13,38017725,"F",13,13,"LA Clippers","Moussa Diabate",0,0,0,0,0,0
3,0,5,1,0,12,4,0,0,"25",1,3,8,6,2,3,3277432,"2023-11-14T00:00:00.000Z",8,FALSE,13,472,"G",13,13,"LA Clippers","Russell Westbrook",2,14,17,11,9,22.7
1,0,0,0,0,0,0,0,0,"02",0,0,0,0,0,0,3277432,"2023-11-14T00:00:00.000Z",8,FALSE,13,215,"F-G",8,8,"Denver Nuggets","Justin Holiday",0,0,1,1,1,1.5
0,0,0,0,0,0,0,0,0,"00",0,0,0,0,0,0,3277432,"2023-11-14T00:00:00.000Z",8,FALSE,13,250,"C",8,8,"Denver Nuggets","DeAndre Jordan",0,0,0,0,0,0
0,0,0,0,0,0,0,0,0,"00",0,0,0,0,0,0,3277432,"2023-11-14T00:00:00.000Z",8,FALSE,13,17896007,"G",8,8,"Denver Nuggets","Braxton Key",0,0,0,0,0,0
0,0,0,0,0,0,0,0,0,"00",0,0,0,0,0,0,3277432,"2023-11-14T00:00:00.000Z",8,FALSE,13,56677776,"G",8,8,"Denver Nuggets","Julian Strawther",0,0,0,0,0,0
0,0,0,0,0,0,0,0,0,"00",0,0,0,0,0,0,3277432,"2023-11-14T00:00:00.000Z",8,FALSE,13,666489,"F",8,8,"Denver Nuggets","Vlatko Cancar",0,0,0,0,0,0
4,0,2,4,3,6,5,2,2,"24",1,4,15,3,3,0,1037750,"2023-11-15T00:00:00.000Z",30,FALSE,7,3547242,"F",30,30,"Washington Wizards","Deni Avdija",3,18,22,19,7,33.6
3,0,4,6,2,18,6,10,8,"30",2,1,22,6,0,2,1037750,"2023-11-15T00:00:00.000Z",30,FALSE,7,265,"F",30,30,"Washington Wizards","Kyle Kuzma",0,28,31,25,9,31.7
2,0,7,0,0,6,5,1,0,"24",2,1,10,9,0,0,1037750,"2023-11-15T00:00:00.000Z",30,FALSE,7,666577,"F",30,30,"Washington Wizards","Daniel Gafford",0,19,21,12,11,23.8
3,0,4,7,2,17,6,2,2,"32",1,4,16,5,1,5,1037750,"2023-11-15T00:00:00.000Z",30,FALSE,7,666848,"G",30,30,"Washington Wizards","Jordan Poole",1,21,24,19,8,24.5
2,0,3,1,0,7,6,0,0,"22",0,1,12,3,0,0,1037750,"2023-11-15T00:00:00.000Z",30,FALSE,7,249,"G",30,30,"Washington Wizards","Tyus Jones",0,15,17,14,5,18.6
0,0,1,0,0,0,0,0,0,"02",0,1,0,1,0,0,1037750,"2023-11-15T00:00:00.000Z",30,FALSE,7,38017704,"F",30,30,"Washington Wizards","Patrick Baldwin Jr.",0,1,1,0,1,1.2
0,0,0,0,0,0,0,0,0,"00",0,0,0,0,0,0,1037750,"2023-11-15T00:00:00.000Z",30,FALSE,7,18677954,"G",30,30,"Washington Wizards","Jared Butler",0,0,0,0,0,0
3,1,8,2,2,5,4,0,0,"28",0,3,10,8,0,0,1037750,"2023-11-15T00:00:00.000Z",30,FALSE,7,56677844,"G",30,30,"Washington Wizards","Bilal Coulibaly",1,18,21,13,11,27.1
1,1,1,0,0,3,2,0,0,"06",0,1,4,1,1,0,1037750,"2023-11-15T00:00:00.000Z",30,FALSE,7,38017687,"G",30,30,"Washington Wizards","Johnny Davis",2,5,6,5,2,12.7
1,0,4,2,0,6,3,4,4,"18",2,0,10,6,0,2,1037750,"2023-11-15T00:00:00.000Z",30,FALSE,7,167,"F",30,30,"Washington Wizards","Danilo Gallinari",0,16,17,11,7,16.7
0,0,1,0,0,0,0,0,0,"05",0,1,0,1,1,3,1037750,"2023-11-15T00:00:00.000Z",30,FALSE,7,3547302,"F",30,30,"Washington Wizards","Anthony Gill",1,1,1,0,1,1.2
4,0,1,7,3,8,3,4,3,"26",0,3,12,1,0,0,1037750,"2023-11-15T00:00:00.000Z",30,FALSE,7,17896045,"F",30,30,"Washington Wizards","Corey Kispert",0,13,17,16,5,19.2
0,0,0,0,0,0,0,0,0,"00",0,0,0,0,0,0,1037750,"2023-11-15T00:00:00.000Z",30,FALSE,7,337,"F-C",30,30,"Washington Wizards","Mike Muscala",0,0,0,0,0,0
0,0,0,0,0,1,1,0,0,"02",0,0,2,0,0,0,1037750,"2023-11-15T00:00:00.000Z",30,FALSE,7,38017712,"G",30,30,"Washington Wizards","Ryan Rollins",0,2,2,2,0,2
1,0,3,4,0,4,0,0,0,"37",1,1,0,4,1,0,1037750,"2023-11-15T00:00:00.000Z",30,FALSE,7,3547258,"G",7,7,"Dallas Mavericks","Josh Green",1,4,5,1,5,9.3
10,0,6,11,4,18,7,12,8,"32",1,2,26,7,0,3,1037750,"2023-11-15T00:00:00.000Z",30,FALSE,7,132,"F-G",7,7,"Dallas Mavericks","Luka Doncic",0,33,43,36,17,46.4
2,0,2,2,2,6,6,1,1,"20",0,1,15,2,1,0,1037750,"2023-11-15T00:00:00.000Z",30,FALSE,7,114,"G",7,7,"Dallas Mavericks","Seth Curry",1,17,19,17,4,23.4
3,0,7,1,0,6,2,2,1,"19",0,3,5,7,0,0,1037750,"2023-11-15T00:00:00.000Z",30,FALSE,7,151,"G",7,7,"Dallas Mavericks","Dante Exum",0,12,15,8,10,17.9
3,0,4,11,7,20,11,5,2,"27",0,1,31,4,0,1,1037750,"2023-11-15T00:00:00.000Z",30,FALSE,7,191,"G",7,7,"Dallas Mavericks","Tim Hardaway Jr.",0,35,38,34,7,39.3
2,0,1,0,0,1,1,0,0,"07",0,1,2,1,0,0,1037750,"2023-11-15T00:00:00.000Z",30,FALSE,7,379,"F-C",7,7,"Dallas Mavericks","Dwight Powell",0,3,5,4,3,6.2
1,0,2,7,0,12,2,0,0,"21",0,2,4,2,0,0,1037750,"2023-11-15T00:00:00.000Z",30,FALSE,7,414,"G",30,30,"Washington Wizards","Landry Shamet",0,6,7,5,3,7.9
0,0,0,0,0,0,0,0,0,"00",0,0,0,0,0,0,1037750,"2023-11-15T00:00:00.000Z",30,FALSE,7,38124126,"F",30,30,"Washington Wizards","John Butler Jr.",0,0,0,0,0,0
0,0,0,0,0,0,0,0,0,"00",0,0,0,0,0,0,1037750,"2023-11-15T00:00:00.000Z",30,FALSE,7,17896106,"F",30,30,"Washington Wizards","Eugene Omoruyi",0,0,0,0,0,0
0,0,0,0,0,0,0,0,0,"00",0,0,0,0,0,0,1037750,"2023-11-15T00:00:00.000Z",30,FALSE,7,487,"G",30,30,"Washington Wizards","Delon Wright",0,0,0,0,0,0
1,2,6,5,2,11,8,3,2,"26",1,4,20,7,1,2,1037750,"2023-11-15T00:00:00.000Z",30,FALSE,7,247,"F-G",7,7,"Dallas Mavericks","Derrick Jones Jr.",3,27,28,21,8,36.9
7,0,1,7,2,13,4,0,0,"35",2,1,10,3,1,1,1037750,"2023-11-15T00:00:00.000Z",30,FALSE,7,666965,"F",7,7,"Dallas Mavericks","Grant Williams",1,13,20,17,10,26.1
2,2,5,0,0,8,7,3,3,"24",4,2,17,9,1,1,1037750,"2023-11-15T00:00:00.000Z",30,FALSE,7,56677840,"C",7,7,"Dallas Mavericks","Dereck Lively II",3,26,28,19,11,38.8
0,0,0,0,0,2,1,1,0,"04",0,0,2,0,1,1,1037750,"2023-11-15T00:00:00.000Z",30,FALSE,7,38017679,"G",7,7,"Dallas Mavericks","Jaden Hardy",1,2,2,2,0,4
0,0,0,0,0,1,0,0,0,"02",0,0,0,0,0,1,1037750,"2023-11-15T00:00:00.000Z",30,FALSE,7,217,"F-C",7,7,"Dallas Mavericks","Richaun Holmes",0,0,0,0,0,-1
0,0,0,0,0,0,0,0,0,"00",0,0,0,0,0,0,1037750,"2023-11-15T00:00:00.000Z",30,FALSE,7,329,"F",7,7,"Dallas Mavericks","Markieff Morris",0,0,0,0,0,0
1,0,2,1,0,2,1,2,0,"07",0,0,2,2,0,0,1037750,"2023-11-15T00:00:00.000Z",30,FALSE,7,56677859,"F",7,7,"Dallas Mavericks","Olivier-Maxence Prosper",0,4,5,3,3,5.9
0,0,0,0,0,0,0,0,0,"00",0,0,0,0,0,0,1037750,"2023-11-15T00:00:00.000Z",30,FALSE,7,17896028,"F",7,7,"Dallas Mavericks","Greg Brown III",0,0,0,0,0,0
0,0,0,0,0,0,0,0,0,"00",0,0,0,0,0,0,1037750,"2023-11-15T00:00:00.000Z",30,FALSE,7,56677873,"G",7,7,"Dallas Mavericks","Dexter Dennis",0,0,0,0,0,0
0,0,0,0,0,0,0,0,0,"00",0,0,0,0,0,0,1037750,"2023-11-15T00:00:00.000Z",30,FALSE,7,228,"G",7,7,"Dallas Mavericks","Kyrie Irving",0,0,0,0,0,0
0,0,0,0,0,0,0,0,0,"00",0,0,0,0,0,0,1037750,"2023-11-15T00:00:00.000Z",30,FALSE,7,257,"F",7,7,"Dallas Mavericks","Maxi Kleber",0,0,0,0,0,0
0,0,0,0,0,0,0,0,0,"00",0,0,0,0,0,0,1037750,"2023-11-15T00:00:00.000Z",30,FALSE,7,17554004,"G",7,7,"Dallas Mavericks","AJ Lawson",0,0,0,0,0,0
1,0,1,3,1,7,2,0,0,"26",1,3,5,2,0,1,1037751,"2023-11-15T00:00:00.000Z",1,FALSE,20,666656,"F",1,1,"Atlanta Hawks","De'Andre Hunter",0,7,8,6,3,7.9
0,2,5,4,4,9,7,0,0,"31",0,1,18,5,0,3,1037751,"2023-11-15T00:00:00.000Z",1,FALSE,20,17896040,"F",1,1,"Atlanta Hawks","Jalen Johnson",2,23,23,18,5,27
1,2,3,0,0,5,4,2,0,"26",0,2,8,3,2,0,1037751,"2023-11-15T00:00:00.000Z",1,FALSE,20,83,"C",1,1,"Atlanta Hawks","Clint Capela",4,11,12,9,4,25.1
2,0,5,3,0,12,6,3,1,"33",0,1,13,5,1,1,1037751,"2023-11-15T00:00:00.000Z",1,FALSE,20,334,"G",1,1,"Atlanta Hawks","Dejounte Murray",1,18,20,15,7,24
17,0,1,4,0,12,4,9,7,"35",0,0,15,1,2,3,1037751,"2023-11-15T00:00:00.000Z",1,FALSE,20,490,"G",1,1,"Atlanta Hawks","Trae Young",2,16,33,32,18,44.7
2,0,1,5,2,10,7,0,0,"28",1,3,16,2,2,2,1037751,"2023-11-15T00:00:00.000Z",1,FALSE,20,3547256,"F",1,1,"Atlanta Hawks","Saddiq Bey",2,18,20,18,4,25.4
3,1,2,11,4,15,8,8,8,"29",1,4,28,3,2,1,1037751,"2023-11-15T00:00:00.000Z",1,FALSE,20,53,"G",1,1,"Atlanta Hawks","Bogdan Bogdanovic",3,31,34,31,6,44.1
0,0,0,0,0,0,0,0,0,"00",0,0,0,0,0,0,1037751,"2023-11-15T00:00:00.000Z",1,FALSE,20,666564,"F",1,1,"Atlanta Hawks","Bruno Fernando",0,0,0,0,0,0
0,0,0,0,0,0,0,0,0,"00",0,0,0,0,0,0,1037751,"2023-11-15T00:00:00.000Z",1,FALSE,20,3547297,"G",1,1,"Atlanta Hawks","Trent Forrest",0,0,0,0,0,0
0,0,0,0,0,0,0,0,0,"00",0,0,0,0,0,0,1037751,"2023-11-15T00:00:00.000Z",1,FALSE,20,38017689,"F",1,1,"Atlanta Hawks","AJ Griffin",0,0,0,0,0,0
0,0,0,0,0,0,0,0,0,"00",0,0,0,0,0,0,1037751,"2023-11-15T00:00:00.000Z",1,FALSE,20,666754,"G",1,1,"Atlanta Hawks","Garrison Mathews",0,0,0,0,0,0
1,0,2,1,1,1,1,0,0,"10",1,2,3,3,1,0,1037751,"2023-11-15T00:00:00.000Z",1,FALSE,20,301,"G-F",1,1,"Atlanta Hawks","Wesley Matthews",1,6,7,4,4,11.1
0,0,0,0,0,0,0,0,0,"00",0,0,0,0,0,0,1037751,"2023-11-15T00:00:00.000Z",1,FALSE,20,319,"G",1,1,"Atlanta Hawks","Patty Mills",0,0,0,0,0,0
1,1,4,0,0,4,2,4,4,"22",2,4,8,6,1,4,1037751,"2023-11-15T00:00:00.000Z",1,FALSE,20,3547244,"F-C",1,1,"Atlanta Hawks","Onyeka Okongwu",2,14,15,9,7,18.7
0,0,0,0,0,0,0,0,0,"00",0,0,0,0,0,0,1037751,"2023-11-15T00:00:00.000Z",1,FALSE,20,56677838,"G",1,1,"Atlanta Hawks","Kobe Bufkin",0,0,0,0,0,0
0,0,0,0,0,0,0,0,0,"00",0,0,0,0,0,0,1037751,"2023-11-15T00:00:00.000Z",1,FALSE,20,56677806,"F",1,1,"Atlanta Hawks","Mouhamed Gueye",0,0,0,0,0,0
0,0,0,0,0,0,0,0,0,"00",0,0,0,0,0,0,1037751,"2023-11-15T00:00:00.000Z",1,FALSE,20,56677855,"G",1,1,"Atlanta Hawks","Seth Lundy",0,0,0,0,0,0
0,0,0,0,0,0,0,0,0,"00",0,0,0,0,0,0,1037751,"2023-11-15T00:00:00.000Z",1,FALSE,20,56677875,"F",1,1,"Atlanta Hawks","Miles Norris",0,0,0,0,0,0
5,1,6,5,1,10,4,0,0,"33",2,4,9,8,0,2,1037751,"2023-11-15T00:00:00.000Z",1,FALSE,20,202,"G",20,20,"New York Knicks","Josh Hart",1,17,22,14,13,27.1
8,0,8,5,3,24,12,2,2,"39",2,4,29,10,1,1,1037751,"2023-11-15T00:00:00.000Z",1,FALSE,20,387,"F",20,20,"New York Knicks","Julius Randle",1,39,47,37,18,55
0,1,9,0,0,3,3,0,0,"31",6,0,6,15,3,1,1037751,"2023-11-15T00:00:00.000Z",1,FALSE,20,399,"C",20,20,"New York Knicks","Mitchell Robinson",4,21,21,6,15,35
1,0,1,7,3,10,4,0,0,"28",0,3,11,1,1,3,1037751,"2023-11-15T00:00:00.000Z",1,FALSE,20,17895858,"G",20,20,"New York Knicks","Quentin Grimes",1,12,13,12,2,13.7
8,0,0,10,6,19,8,2,2,"41",0,2,24,0,0,3,1037751,"2023-11-15T00:00:00.000Z",1,FALSE,20,73,"G",20,20,"New York Knicks","Jalen Brunson",0,24,32,32,8,33
0,0,0,0,0,0,0,0,0,"00",0,0,0,0,0,0,1037751,"2023-11-15T00:00:00.000Z",1,FALSE,20,19,"G",20,20,"New York Knicks","Ryan Arcidiacono",0,0,0,0,0,0
3,0,3,2,0,8,3,0,0,"22",1,1,6,4,2,4,1037751,"2023-11-15T00:00:00.000Z",1,FALSE,20,131,"G",20,20,"New York Knicks","Donte DiVincenzo",2,10,13,9,7,17.3
0,0,0,0,0,0,0,0,0,"00",0,0,0,0,0,0,1037751,"2023-11-15T00:00:00.000Z",1,FALSE,20,160,"G-F",20,20,"New York Knicks","Evan Fournier",0,0,0,0,0,0
0,0,1,0,0,9,5,1,1,"17",3,2,11,4,1,0,1037751,"2023-11-15T00:00:00.000Z",1,FALSE,20,201,"F-C",20,20,"New York Knicks","Isaiah Hartenstein",1,15,15,11,4,18.8
0,0,0,0,0,0,0,0,0,"00",0,0,0,0,0,0,1037751,"2023-11-15T00:00:00.000Z",1,FALSE,20,666675,"F",20,20,"New York Knicks","DaQuan Jeffries",0,0,0,0,0,0
0,0,0,0,0,0,0,0,0,"01",0,1,0,0,0,0,1037751,"2023-11-15T00:00:00.000Z",1,FALSE,20,17896033,"G",20,20,"New York Knicks","Miles McBride",0,0,0,0,0,0
4,0,0,5,3,11,6,6,5,"28",0,3,20,0,1,2,1037751,"2023-11-15T00:00:00.000Z",1,FALSE,20,3547269,"G",20,20,"New York Knicks","Immanuel Quickley",1,20,24,24,4,27
0,0,0,0,0,0,0,0,0,"00",0,0,0,0,0,0,1037751,"2023-11-15T00:00:00.000Z",1,FALSE,20,17896063,"F",20,20,"New York Knicks","Jericho Sims",0,0,0,0,0,0
0,0,0,0,0,0,0,0,0,"00",0,0,0,0,0,0,1037751,"2023-11-15T00:00:00.000Z",1,FALSE,20,666423,"F-G",20,20,"New York Knicks","RJ Barrett",0,0,0,0,0,0
0,0,0,0,0,0,0,0,0,"00",0,0,0,0,0,0,1037751,"2023-11-15T00:00:00.000Z",1,FALSE,20,666474,"G",20,20,"New York Knicks","Charles Brown",0,0,0,0,0,0
0,0,0,0,0,0,0,0,0,"00",0,0,0,0,0,0,1037751,"2023-11-15T00:00:00.000Z",1,FALSE,20,56677795,"F",20,20,"New York Knicks","Jacob Toppin",0,0,0,0,0,0
0,0,0,0,0,0,0,0,0,"00",0,0,0,0,0,0,1037751,"2023-11-15T00:00:00.000Z",1,FALSE,20,17896089,"G",20,20,"New York Knicks","Duane Washington Jr.",0,0,0,0,0,0
0,0,0,0,0,0,0,0,0,"00",0,0,0,0,0,0,1037751,"2023-11-15T00:00:00.000Z",1,FALSE,20,666971,"G-F",20,20,"New York Knicks","Dylan Windler",0,0,0,0,0,0
0,0,3,5,0,13,6,4,4,"37",3,1,16,6,2,0,1037752,"2023-11-15T00:00:00.000Z",23,FALSE,2,108,"F",23,23,"Philadelphia 76ers","Robert Covington",2,22,22,16,6,29.2
3,0,7,2,1,12,6,3,3,"38",0,0,16,7,0,1,1037752,"2023-11-15T00:00:00.000Z",23,FALSE,2,200,"F",23,23,"Philadelphia 76ers","Tobias Harris",0,23,26,19,10,27.9
7,0,6,2,0,16,8,4,4,"34",3,3,20,9,1,2,1037752,"2023-11-15T00:00:00.000Z",23,FALSE,2,145,"F-C",23,23,"Philadelphia 76ers","Joel Embiid",1,29,36,27,16,42.3
1,0,6,6,5,10,5,2,1,"34",1,3,16,7,0,0,1037752,"2023-11-15T00:00:00.000Z",23,FALSE,2,313,"G",23,23,"Philadelphia 76ers","De'Anthony Melton",0,23,24,17,8,25.9
4,0,3,7,3,15,6,5,5,"39",0,3,20,3,0,2,1037752,"2023-11-15T00:00:00.000Z",23,FALSE,2,3547254,"G",23,23,"Philadelphia 76ers","Tyrese Maxey",0,23,27,24,7,27.6
0,0,0,0,0,0,0,0,0,"00",0,0,0,0,0,0,1037752,"2023-11-15T00:00:00.000Z",23,FALSE,2,28,"C",23,23,"Philadelphia 76ers","Mo Bamba",0,0,0,0,0,0
1,0,1,2,0,4,0,2,0,"10",0,1,0,1,0,0,1037752,"2023-11-15T00:00:00.000Z",23,FALSE,2,45,"G",23,23,"Philadelphia 76ers","Patrick Beverley",0,1,2,1,2,2.7
0,0,0,1,0,1,0,0,0,"03",0,0,0,0,0,0,1037752,"2023-11-15T00:00:00.000Z",23,FALSE,2,2175,"",23,23,"Philadelphia 76ers","Danuel House Jr.",0,0,0,0,0,0
0,0,0,1,0,1,0,0,0,"03",0,0,0,0,0,0,1037752,"2023-11-15T00:00:00.000Z",23,FALSE,2,260,"G-F",23,23,"Philadelphia 76ers","Furkan Korkmaz",0,0,0,0,0,0
0,0,0,0,0,0,0,0,0,"00",0,0,0,0,0,0,1037752,"2023-11-15T00:00:00.000Z",23,FALSE,2,3547294,"F",23,23,"Philadelphia 76ers","Kenyon Martin Jr.",0,0,0,0,0,0
0,0,0,2,0,3,0,0,0,"08",0,0,0,0,0,1,1037752,"2023-11-15T00:00:00.000Z",23,FALSE,2,328,"F",23,23,"Philadelphia 76ers","Marcus Morris",0,0,0,0,0,-1
2,1,3,1,1,5,4,2,1,"14",3,1,10,6,0,1,1037752,"2023-11-15T00:00:00.000Z",23,FALSE,2,3547270,"F",23,23,"Philadelphia 76ers","Paul Reed",1,16,18,12,8,22.2
0,0,2,1,1,5,4,0,0,"20",0,2,9,2,2,2,1037752,"2023-11-15T00:00:00.000Z",23,FALSE,2,17896025,"G",23,23,"Philadelphia 76ers","Jaden Springer",2,11,11,9,2,15.4
0,0,0,0,0,0,0,0,0,"00",0,0,0,0,0,0,1037752,"2023-11-15T00:00:00.000Z",23,FALSE,2,33,"F-G",23,23,"Philadelphia 76ers","Nicolas Batum",0,0,0,0,0,0
0,0,0,0,0,0,0,0,0,"00",0,0,0,0,0,0,1037752,"2023-11-15T00:00:00.000Z",23,FALSE,2,56913527,"G",23,23,"Philadelphia 76ers","Ricky Council IV",0,0,0,0,0,0
0,0,0,0,0,0,0,0,0,"00",0,0,0,0,0,0,1037752,"2023-11-15T00:00:00.000Z",23,FALSE,2,360,"F",23,23,"Philadelphia 76ers","Kelly Oubre Jr.",0,0,0,0,0,0
0,0,0,0,0,0,0,0,0,"00",0,0,0,0,0,0,1037752,"2023-11-15T00:00:00.000Z",23,FALSE,2,17554001,"G",23,23,"Philadelphia 76ers","Javonte Smart",0,0,0,0,0,0
0,0,0,0,0,0,0,0,0,"00",0,0,0,0,0,0,1037752,"2023-11-15T00:00:00.000Z",23,FALSE,2,3547279,"F",2,2,"Boston Celtics","Lamar Stevens",0,0,0,0,0,0
0,0,0,0,0,0,0,0,0,"00",0,0,0,0,0,0,1037752,"2023-11-15T00:00:00.000Z",23,FALSE,2,70,"G",2,2,"Boston Celtics","Jaylen Brown",0,0,0,0,0,0
0,0,0,0,0,0,0,0,0,"00",0,0,0,0,0,0,1037752,"2023-11-15T00:00:00.000Z",23,FALSE,2,38017707,"G",2,2,"Boston Celtics","JD Davison",0,0,0,0,0,0
0,0,0,0,0,0,0,0,0,"00",0,0,0,0,0,0,1037752,"2023-11-15T00:00:00.000Z",23,FALSE,2,3547295,"F-C",2,2,"Boston Celtics","Nathan Knight",0,0,0,0,0,0
0,0,0,0,0,0,0,0,0,"00",0,0,0,0,0,0,1037752,"2023-11-15T00:00:00.000Z",23,FALSE,2,378,"F-C",2,2,"Boston Celtics","Kristaps Porzingis",0,0,0,0,0,0
0,0,0,0,0,0,0,0,0,"00",0,0,0,0,0,0,1037752,"2023-11-15T00:00:00.000Z",23,FALSE,2,56677864,"G",2,2,"Boston Celtics","Jordan Walsh",0,0,0,0,0,0
0,0,0,0,0,0,0,0,0,"00",0,0,0,0,0,0,1037752,"2023-11-15T00:00:00.000Z",23,FALSE,2,56677788,"G",23,23,"Philadelphia 76ers","Terquavion Smith",0,0,0,0,0,0
2,1,1,8,2,9,3,0,0,"35",1,2,8,2,0,0,1037752,"2023-11-15T00:00:00.000Z",23,FALSE,2,17896060,"F",2,2,"Boston Celtics","Sam Hauser",1,10,12,10,4,16.4
6,0,6,10,4,23,10,6,5,"39",2,1,29,8,2,3,1037752,"2023-11-15T00:00:00.000Z",23,FALSE,2,434,"F",2,2,"Boston Celtics","Jayson Tatum",2,37,43,35,14,50.6
3,5,7,8,4,9,5,0,0,"29",1,2,14,8,0,0,1037752,"2023-11-15T00:00:00.000Z",23,FALSE,2,219,"C-F",2,2,"Boston Celtics","Al Horford",5,22,25,17,11,43.1
5,0,3,8,4,12,7,10,9,"36",0,3,27,3,1,2,1037752,"2023-11-15T00:00:00.000Z",23,FALSE,2,473,"G",2,2,"Boston Celtics","Derrick White",1,30,35,32,8,39.1
3,2,8,9,2,18,8,1,0,"36",2,0,18,10,1,1,1037752,"2023-11-15T00:00:00.000Z",23,FALSE,2,214,"G",2,2,"Boston Celtics","Jrue Holiday",3,28,31,21,13,42.5
3,0,1,3,1,5,2,0,0,"23",1,0,5,2,0,0,1037752,"2023-11-15T00:00:00.000Z",23,FALSE,2,3547276,"G",2,2,"Boston Celtics","Payton Pritchard",0,7,10,8,5,11.9
0,0,4,1,0,4,1,0,0,"08",1,2,2,5,1,0,1037752,"2023-11-15T00:00:00.000Z",23,FALSE,2,17896094,"G",2,2,"Boston Celtics","Dalano Banton",1,7,7,2,5,11
1,0,3,0,0,4,4,2,1,"19",3,2,9,6,1,2,1037752,"2023-11-15T00:00:00.000Z",23,FALSE,2,261,"F-C",2,2,"Boston Celtics","Luke Kornet",1,15,16,10,7,18.7
0,0,0,3,1,4,2,0,0,"15",1,3,5,1,1,1,1037752,"2023-11-15T00:00:00.000Z",23,FALSE,2,338,"G",2,2,"Boston Celtics","Svi Mykhailiuk",1,6,6,5,1,8.2
0,0,0,0,0,0,0,0,0,"00",0,0,0,0,0,0,1037752,"2023-11-15T00:00:00.000Z",23,FALSE,2,666468,"F",2,2,"Boston Celtics","Oshae Brissett",0,0,0,0,0,0
0,0,0,0,0,0,0,0,0,"00",0,0,0,0,0,0,1037752,"2023-11-15T00:00:00.000Z",23,FALSE,2,17553967,"C",2,2,"Boston Celtics","Neemias Queta",0,0,0,0,0,0
2,0,0,6,1,10,2,6,6,"26",0,4,11,0,1,1,1037753,"2023-11-15T00:00:00.000Z",28,FALSE,17,56677828,"G",28,28,"Toronto Raptors","Gradey Dick",1,11,13,13,2,16
5,1,5,2,0,9,4,5,3,"29",2,1,11,7,0,4,1037753,"2023-11-15T00:00:00.000Z",28,FALSE,17,416,"F",28,28,"Toronto Raptors","Pascal Siakam",1,18,23,16,12,25.9
1,2,4,0,0,10,6,2,1,"27",7,4,13,11,4,0,1037753,"2023-11-15T00:00:00.000Z",28,FALSE,17,373,"C",28,28,"Toronto Raptors","Jakob Poeltl",6,24,25,14,12,45.7
7,0,4,3,3,19,11,5,4,"31",5,2,29,9,1,3,1037753,"2023-11-15T00:00:00.000Z",28,FALSE,17,17896055,"G-F",28,28,"Toronto Raptors","Scottie Barnes",1,38,45,36,16,50.3
5,0,3,4,1,9,2,4,4,"23",0,3,9,3,2,2,1037753,"2023-11-15T00:00:00.000Z",28,FALSE,17,409,"G",28,28,"Toronto Raptors","Dennis Schroder",2,12,17,14,8,24.1
0,2,1,2,1,7,4,2,2,"17",3,3,11,4,0,1,1037753,"2023-11-15T00:00:00.000Z",28,FALSE,17,3547249,"F",28,28,"Toronto Raptors","Precious Achiuwa",2,15,15,11,4,20.8
0,1,4,3,1,8,2,4,4,"20",5,1,9,9,0,1,1037753,"2023-11-15T00:00:00.000Z",28,FALSE,17,58,"F",28,28,"Toronto Raptors","Chris Boucher",1,18,18,9,9,21.8
5,1,1,8,0,11,3,1,1,"27",2,1,7,3,0,0,1037753,"2023-11-15T00:00:00.000Z",28,FALSE,17,3547275,"G",28,28,"Toronto Raptors","Malachi Flynn",1,10,15,12,8,21.1
1,1,4,4,1,10,3,0,0,"18",0,0,7,4,1,1,1037753,"2023-11-15T00:00:00.000Z",28,FALSE,17,666762,"F",28,28,"Toronto Raptors","Jalen McDaniels",2,11,12,8,5,18.3
2,0,0,0,0,1,0,2,2,"03",2,0,2,2,1,0,1037753,"2023-11-15T00:00:00.000Z",28,FALSE,17,56677869,"G",28,28,"Toronto Raptors","Markquis Nowell",1,4,6,4,4,10.4
0,0,1,0,0,0,0,0,0,"11",0,0,0,1,0,0,1037753,"2023-11-15T00:00:00.000Z",28,FALSE,17,376,"F",28,28,"Toronto Raptors","Otto Porter Jr.",0,1,1,0,1,1.2
0,0,1,1,1,1,1,0,0,"04",0,0,3,1,0,0,1037753,"2023-11-15T00:00:00.000Z",28,FALSE,17,436,"G-F",28,28,"Toronto Raptors","Garrett Temple",0,4,4,3,1,4.2
0,0,1,0,0,1,0,0,0,"04",0,0,0,1,0,1,1037753,"2023-11-15T00:00:00.000Z",28,FALSE,17,489,"F",28,28,"Toronto Raptors","Thaddeus Young",0,1,1,0,1,0.2
0,0,0,0,0,0,0,0,0,"00",0,0,0,0,0,0,1037753,"2023-11-15T00:00:00.000Z",28,FALSE,17,18,"F",28,28,"Toronto Raptors","OG Anunoby",0,0,0,0,0,0
0,0,0,0,0,0,0,0,0,"00",0,0,0,0,0,0,1037753,"2023-11-15T00:00:00.000Z",28,FALSE,17,56677805,"G",28,28,"Toronto Raptors","Javon Freeman-Liberty",0,0,0,0,0,0
0,0,4,11,8,14,11,0,0,"31",0,2,30,4,1,0,1037753,"2023-11-15T00:00:00.000Z",28,FALSE,17,38,"G",17,17,"Milwaukee Bucks","Malik Beasley",1,34,34,30,4,37.8
13,0,4,10,4,18,9,16,15,"31",0,1,37,4,2,4,1037753,"2023-11-15T00:00:00.000Z",28,FALSE,17,278,"G",17,17,"Milwaukee Bucks","Damian Lillard",2,41,54,50,17,63.3
0,0,0,0,0,5,1,0,0,"15",2,3,2,2,0,0,1037753,"2023-11-15T00:00:00.000Z",28,FALSE,17,2148,"",17,17,"Milwaukee Bucks","Thanasis Antetokounmpo",0,4,4,2,2,4.4
1,0,0,0,0,3,2,0,0,"10",0,2,4,0,1,0,1037753,"2023-11-15T00:00:00.000Z",28,FALSE,17,38017676,"F",17,17,"Milwaukee Bucks","MarJon Beauchamp",1,4,5,5,1,8.5
0,0,6,3,1,3,1,0,0,"23",1,2,3,7,0,1,1037753,"2023-11-15T00:00:00.000Z",28,FALSE,17,105,"G",17,17,"Milwaukee Bucks","Pat Connaughton",0,10,10,3,7,10.4
0,0,0,1,0,1,0,0,0,"07",0,0,0,0,0,0,1037753,"2023-11-15T00:00:00.000Z",28,FALSE,17,38017733,"G",17,17,"Milwaukee Bucks","A.J. Green",0,0,0,0,0,0
0,0,0,0,0,0,0,0,0,"02",0,0,0,0,0,0,1037753,"2023-11-15T00:00:00.000Z",28,FALSE,17,284,"C",17,17,"Milwaukee Bucks","Robin Lopez",0,0,0,0,0,0
2,0,1,4,3,8,4,2,2,"16",0,2,13,1,0,0,1037753,"2023-11-15T00:00:00.000Z",28,FALSE,17,368,"G",17,17,"Milwaukee Bucks","Cameron Payne",0,14,16,15,3,17.2
0,2,6,3,2,11,7,2,2,"31",1,5,18,7,0,0,1037753,"2023-11-15T00:00:00.000Z",28,FALSE,17,377,"F",17,17,"Milwaukee Bucks","Bobby Portis",2,25,25,18,7,32.4
0,0,1,1,0,1,0,0,0,"02",0,0,0,1,1,1,1037753,"2023-11-15T00:00:00.000Z",28,FALSE,17,38017691,"G",17,17,"Milwaukee Bucks","TyTy Washington Jr.",1,1,1,0,1,3.2
0,0,0,1,0,1,0,0,0,"02",0,1,0,0,0,1,1037753,"2023-11-15T00:00:00.000Z",28,FALSE,17,666960,"G",17,17,"Milwaukee Bucks","Lindell Wigginton",0,0,0,0,0,-1
0,0,0,0,0,0,0,0,0,"00",0,0,0,0,0,0,1037753,"2023-11-15T00:00:00.000Z",28,FALSE,17,15,"F",17,17,"Milwaukee Bucks","Giannis Antetokounmpo",0,0,0,0,0,0
0,0,0,0,0,0,0,0,0,"00",0,0,0,0,0,0,1037753,"2023-11-15T00:00:00.000Z",28,FALSE,17,666453,"C",17,17,"Milwaukee Bucks","Marques Bolden",0,0,0,0,0,0
0,0,0,0,0,0,0,0,0,"00",0,0,0,0,0,0,1037753,"2023-11-15T00:00:00.000Z",28,FALSE,17,112,"F",17,17,"Milwaukee Bucks","Jae Crowder",0,0,0,0,0,0
0,0,0,0,0,0,0,0,0,"00",0,0,0,0,0,0,1037753,"2023-11-15T00:00:00.000Z",28,FALSE,17,56677854,"F",17,17,"Milwaukee Bucks","Chris Livingston",0,0,0,0,0,0
0,0,0,0,0,0,0,0,0,"00",0,0,0,0,0,0,1037753,"2023-11-15T00:00:00.000Z",28,FALSE,17,38017717,"F",28,28,"Toronto Raptors","Ron Harper Jr.",0,0,0,0,0,0
0,0,0,0,0,0,0,0,0,"00",0,0,0,0,0,0,1037753,"2023-11-15T00:00:00.000Z",28,FALSE,17,38017710,"C",28,28,"Toronto Raptors","Christian Koloko",0,0,0,0,0,0
0,0,0,0,0,0,0,0,0,"00",0,0,0,0,0,0,1037753,"2023-11-15T00:00:00.000Z",28,FALSE,17,3089,"",28,28,"Toronto Raptors","Gary Trent Jr.",0,0,0,0,0,0
4,0,4,2,1,9,5,0,0,"20",1,3,11,5,2,4,1037753,"2023-11-15T00:00:00.000Z",28,FALSE,17,315,"F",17,17,"Milwaukee Bucks","Khris Middleton",2,16,20,15,9,25
1,0,0,0,0,1,0,0,0,"17",2,2,0,2,0,2,1037753,"2023-11-15T00:00:00.000Z",28,FALSE,17,56677852,"G",17,17,"Milwaukee Bucks","Andre Jackson Jr.",0,2,3,1,3,1.9
4,7,6,3,1,10,4,1,1,"33",2,2,10,8,1,0,1037753,"2023-11-15T00:00:00.000Z",28,FALSE,17,283,"C",17,17,"Milwaukee Bucks","Brook Lopez",8,18,22,14,12,49.6
0,0,4,2,0,7,4,3,3,"28",3,1,11,7,1,2,1037754,"2023-11-15T00:00:00.000Z",5,FALSE,22,110,"F",5,5,"Chicago Bulls","Torrey Craig",1,18,18,11,7,20.4
2,2,8,2,0,7,2,6,5,"32",1,2,9,9,1,1,1037754,"2023-11-15T00:00:00.000Z",5,FALSE,22,3547248,"F",5,5,"Chicago Bulls","Patrick Williams",3,18,20,11,11,30.8
3,1,6,4,0,18,8,1,1,"36",3,4,17,9,0,5,1037754,"2023-11-15T00:00:00.000Z",5,FALSE,22,460,"C",5,5,"Chicago Bulls","Nikola Vucevic",1,26,29,20,12,30.3
3,0,6,7,4,16,6,4,3,"36",0,2,19,6,1,3,1037754,"2023-11-15T00:00:00.000Z",5,FALSE,22,268,"G",5,5,"Chicago Bulls","Zach LaVine",1,25,28,22,9,30.7
1,0,1,5,1,10,2,0,0,"33",0,4,5,1,1,3,1037754,"2023-11-15T00:00:00.000Z",5,FALSE,22,666956,"G",5,5,"Chicago Bulls","Coby White",1,6,7,6,2,7.7
1,0,0,5,1,7,1,0,0,"16",0,2,3,0,2,0,1037754,"2023-11-15T00:00:00.000Z",5,FALSE,22,87,"G",5,5,"Chicago Bulls","Jevon Carter",2,3,4,4,1,10.5
3,1,4,4,2,7,5,4,4,"24",1,5,16,5,0,2,1037754,"2023-11-15T00:00:00.000Z",5,FALSE,22,89,"G",5,5,"Chicago Bulls","Alex Caruso",1,21,24,19,8,27.5
2,0,1,3,1,4,2,0,0,"19",1,1,5,2,0,1,1037754,"2023-11-15T00:00:00.000Z",5,FALSE,22,17895983,"G",5,5,"Chicago Bulls","Ayo Dosunmu",0,7,9,7,4,9.4
1,0,9,0,0,5,3,4,3,"12",5,3,9,14,1,2,1037754,"2023-11-15T00:00:00.000Z",5,FALSE,22,137,"C",5,5,"Chicago Bulls","Andre Drummond",1,23,24,10,15,28.3
0,0,0,1,0,2,0,0,0,"04",0,1,0,0,0,0,1037754,"2023-11-15T00:00:00.000Z",5,FALSE,22,56677857,"F",5,5,"Chicago Bulls","Julian Phillips",0,0,0,0,0,0
0,0,0,0,0,0,0,0,0,"00",0,0,0,0,0,0,1037754,"2023-11-15T00:00:00.000Z",5,FALSE,22,27,"G",5,5,"Chicago Bulls","Lonzo Ball",0,0,0,0,0,0
0,0,0,0,0,0,0,0,0,"00",0,0,0,0,0,0,1037754,"2023-11-15T00:00:00.000Z",5,FALSE,22,125,"G",5,5,"Chicago Bulls","DeMar DeRozan",0,0,0,0,0,0
0,0,0,0,0,0,0,0,0,"00",0,0,0,0,0,0,1037754,"2023-11-15T00:00:00.000Z",5,FALSE,22,45969255,"F",5,5,"Chicago Bulls","Justin Lewis",0,0,0,0,0,0
0,0,0,0,0,0,0,0,0,"00",0,0,0,0,0,0,1037754,"2023-11-15T00:00:00.000Z",5,FALSE,22,56677860,"F",5,5,"Chicago Bulls","Adama Sanogo",0,0,0,0,0,0
0,0,0,0,0,0,0,0,0,"00",0,0,0,0,0,0,1037754,"2023-11-15T00:00:00.000Z",5,FALSE,22,38017719,"F",5,5,"Chicago Bulls","Dalen Terry",0,0,0,0,0,0
3,0,2,4,0,16,5,3,3,"30",0,0,13,2,0,1,1037754,"2023-11-15T00:00:00.000Z",5,FALSE,22,17896026,"F",22,22,"Orlando Magic","Franz Wagner",0,15,18,16,5,18.9
3,0,8,4,2,12,4,10,7,"33",1,0,17,9,1,1,1037754,"2023-11-15T00:00:00.000Z",5,FALSE,22,38017683,"F",22,22,"Orlando Magic","Paolo Banchero",1,26,29,20,12,34.3
2,0,5,0,0,10,6,4,3,"26",6,5,15,11,2,0,1037754,"2023-11-15T00:00:00.000Z",5,FALSE,22,666442,"C",22,22,"Orlando Magic","Goga Bitadze",2,26,28,17,13,37.2
5,0,2,7,2,8,2,4,4,"26",0,4,10,2,3,4,1037754,"2023-11-15T00:00:00.000Z",5,FALSE,22,17896073,"G",22,22,"Orlando Magic","Jalen Suggs",3,12,17,15,7,24.9
2,0,2,2,0,8,3,2,1,"27",2,3,7,4,0,2,1037754,"2023-11-15T00:00:00.000Z",5,FALSE,22,56677827,"G",22,22,"Orlando Magic","Anthony Black",0,11,13,9,6,12.8
1,0,2,3,1,3,1,0,0,"18",0,1,3,2,0,0,1037754,"2023-11-15T00:00:00.000Z",5,FALSE,22,226,"F",22,22,"Orlando Magic","Joe Ingles",0,5,6,4,3,6.9
0,0,0,0,0,0,0,0,0,"00",0,0,0,0,0,0,1037754,"2023-11-15T00:00:00.000Z",5,FALSE,22,56677874,"F",5,5,"Chicago Bulls","Onuralp Bitim",0,0,0,0,0,0
0,0,0,0,0,0,0,0,0,"00",0,0,0,0,0,0,1037754,"2023-11-15T00:00:00.000Z",5,FALSE,22,17896116,"G",5,5,"Chicago Bulls","Terry Taylor",0,0,0,0,0,0
0,0,0,3,1,4,2,2,1,"21",0,0,6,0,2,0,1037754,"2023-11-15T00:00:00.000Z",5,FALSE,22,196,"G",22,22,"Orlando Magic","Gary Harris",2,6,6,6,0,12
1,0,3,1,0,6,2,1,1,"20",1,3,5,4,1,1,1037754,"2023-11-15T00:00:00.000Z",5,FALSE,22,462,"C",22,22,"Orlando Magic","Moritz Wagner",1,9,10,6,5,13.3
3,0,4,3,2,11,6,2,2,"22",1,5,16,5,1,3,1037754,"2023-11-15T00:00:00.000Z",5,FALSE,22,3547251,"G",22,22,"Orlando Magic","Cole Anthony",1,21,24,19,8,26.5
0,2,6,1,0,4,1,2,2,"17",1,0,4,7,2,1,1037754,"2023-11-15T00:00:00.000Z",5,FALSE,22,229,"F",22,22,"Orlando Magic","Jonathan Isaac",4,11,11,4,7,23.4
0,0,0,0,0,0,0,0,0,"00",0,0,0,0,0,0,1037754,"2023-11-15T00:00:00.000Z",5,FALSE,22,38017724,"G",22,22,"Orlando Magic","Caleb Houstan",0,0,0,0,0,0
0,0,0,0,0,0,0,0,0,"00",0,0,0,0,0,0,1037754,"2023-11-15T00:00:00.000Z",5,FALSE,22,56677839,"G",22,22,"Orlando Magic","Jett Howard",0,0,0,0,0,0
0,0,0,0,0,0,0,0,0,"00",0,0,0,0,0,0,1037754,"2023-11-15T00:00:00.000Z",5,FALSE,22,666818,"F",22,22,"Orlando Magic","Chuma Okeke",0,0,0,0,0,0
0,0,0,0,0,0,0,0,0,"00",0,0,0,0,0,0,1037754,"2023-11-15T00:00:00.000Z",5,FALSE,22,666885,"F",22,22,"Orlando Magic","Admiral Schofield",0,0,0,0,0,0
0,0,0,0,0,0,0,0,0,"00",0,0,0,0,0,0,1037754,"2023-11-15T00:00:00.000Z",5,FALSE,22,85,"F",22,22,"Orlando Magic","Wendell Carter Jr.",0,0,0,0,0,0
0,0,0,0,0,0,0,0,0,"00",0,0,0,0,0,0,1037754,"2023-11-15T00:00:00.000Z",5,FALSE,22,165,"G",22,22,"Orlando Magic","Markelle Fultz",0,0,0,0,0,0
0,0,0,0,0,0,0,0,0,"00",0,0,0,0,0,0,1037754,"2023-11-15T00:00:00.000Z",5,FALSE,22,38017607,"G",22,22,"Orlando Magic","Kevon Harris",0,0,0,0,0,0
0,0,0,0,0,0,0,0,0,"00",0,0,0,0,0,0,1037754,"2023-11-15T00:00:00.000Z",5,FALSE,22,17553983,"G",22,22,"Orlando Magic","Trevelin Queen",0,0,0,0,0,0
2,0,6,4,0,17,10,5,5,"31",1,3,25,7,0,1,1037755,"2023-11-15T00:00:00.000Z",24,FALSE,18,447,"C",18,18,"Minnesota Timberwolves","Karl-Anthony Towns",0,32,34,27,9,35.4
2,2,4,0,0,5,2,0,0,"25",4,2,4,8,1,2,1037755,"2023-11-15T00:00:00.000Z",24,FALSE,18,176,"C",18,18,"Minnesota Timberwolves","Rudy Gobert",3,12,14,6,10,23.6
4,1,3,3,1,16,4,4,4,"30",1,0,13,4,1,1,1037755,"2023-11-15T00:00:00.000Z",24,FALSE,18,3547238,"G",18,18,"Minnesota Timberwolves","Anthony Edwards",2,17,21,17,8,28.8
3,0,1,3,1,8,5,3,3,"22",1,0,14,2,0,0,1037755,"2023-11-15T00:00:00.000Z",24,FALSE,18,104,"G",18,18,"Minnesota Timberwolves","Mike Conley",0,16,19,17,5,20.9
0,1,0,5,2,6,3,0,0,"23",0,1,8,0,0,0,1037755,"2023-11-15T00:00:00.000Z",24,FALSE,18,666400,"G",18,18,"Minnesota Timberwolves","Nickeil Alexander-Walker",1,8,8,8,0,11
3,1,1,0,0,5,2,2,2,"21",1,0,6,2,2,1,1037755,"2023-11-15T00:00:00.000Z",24,FALSE,18,12,"F",18,18,"Minnesota Timberwolves","Kyle Anderson",3,8,11,9,5,20.9
1,0,3,2,0,3,0,4,4,"14",1,1,4,4,1,0,1037755,"2023-11-15T00:00:00.000Z",24,FALSE,18,68,"F",18,18,"Minnesota Timberwolves","Troy Brown Jr.",1,8,9,5,5,13.3
0,0,0,1,0,4,1,4,3,"04",2,0,5,2,0,0,1037755,"2023-11-15T00:00:00.000Z",24,FALSE,18,17896056,"C",18,18,"Minnesota Timberwolves","Luka Garza",0,7,7,5,2,7.4
0,0,3,2,0,8,4,0,0,"23",1,3,8,4,0,0,1037755,"2023-11-15T00:00:00.000Z",24,FALSE,18,320,"G",18,18,"Minnesota Timberwolves","Shake Milton",0,12,12,8,4,12.8
0,0,0,2,0,3,1,1,0,"05",1,0,2,1,0,0,1037755,"2023-11-15T00:00:00.000Z",24,FALSE,18,38017715,"F",18,18,"Minnesota Timberwolves","Josh Minott",0,3,3,2,1,3.2
0,0,2,2,1,7,4,4,4,"19",2,0,13,4,1,0,1037755,"2023-11-15T00:00:00.000Z",24,FALSE,18,667378,"F-C",18,18,"Minnesota Timberwolves","Naz Reid",1,17,17,13,4,20.8
0,0,0,0,0,0,0,0,0,"00",0,0,0,0,0,0,1037755,"2023-11-15T00:00:00.000Z",24,FALSE,18,56677851,"G",18,18,"Minnesota Timberwolves","Jaylen Clark",0,0,0,0,0,0
0,0,0,0,0,0,0,0,0,"00",0,0,0,0,0,0,1037755,"2023-11-15T00:00:00.000Z",24,FALSE,18,666767,"G",18,18,"Minnesota Timberwolves","Jordan McLaughlin",0,0,0,0,0,0
0,0,0,0,0,0,0,0,0,"00",0,0,0,0,0,0,1037755,"2023-11-15T00:00:00.000Z",24,FALSE,18,56677782,"F",18,18,"Minnesota Timberwolves","Leonard Miller",0,0,0,0,0,0
0,0,0,0,0,0,0,0,0,"00",0,0,0,0,0,0,1037755,"2023-11-15T00:00:00.000Z",24,FALSE,18,38017700,"G",18,18,"Minnesota Timberwolves","Wendell Moore Jr.",0,0,0,0,0,0
0,0,0,0,0,0,0,0,0,"00",0,0,0,0,0,0,1037755,"2023-11-15T00:00:00.000Z",24,FALSE,18,17895968,"F",18,18,"Minnesota Timberwolves","Daishen Nix",0,0,0,0,0,0
3,0,1,6,3,9,6,0,0,"29",0,2,15,1,0,1,1037755,"2023-11-15T00:00:00.000Z",24,FALSE,18,178,"G",24,24,"Phoenix Suns","Eric Gordon",0,16,19,18,4,19.7
6,1,6,2,2,15,11,7,7,"35",0,3,31,6,0,2,1037755,"2023-11-15T00:00:00.000Z",24,FALSE,18,140,"F",24,24,"Phoenix Suns","Kevin Durant",1,37,43,37,12,48.2
4,0,4,1,1,3,1,0,0,"24",1,3,3,5,0,0,1037755,"2023-11-15T00:00:00.000Z",24,FALSE,18,349,"C",24,24,"Phoenix Suns","Jusuf Nurkic",0,8,12,7,9,15
2,1,3,5,3,9,5,1,1,"28",0,1,14,3,0,2,1037755,"2023-11-15T00:00:00.000Z",24,FALSE,18,8,"G",24,24,"Phoenix Suns","Grayson Allen",1,17,19,16,5,21.6
5,0,3,7,2,22,12,5,5,"26",1,2,31,4,0,2,1037755,"2023-11-15T00:00:00.000Z",24,FALSE,18,57,"G",24,24,"Phoenix Suns","Devin Booker",0,35,40,36,9,41.3
1,0,0,3,3,5,4,2,1,"19",0,1,12,0,0,0,1037755,"2023-11-15T00:00:00.000Z",24,FALSE,18,356,"G",24,24,"Phoenix Suns","Josh Okogie",0,12,13,13,1,13.5
3,0,2,1,1,9,6,0,0,"20",2,2,13,4,0,1,1037755,"2023-11-15T00:00:00.000Z",24,FALSE,18,147,"F",24,24,"Phoenix Suns","Drew Eubanks",0,17,20,16,7,21.3
3,0,2,4,1,6,1,0,0,"23",0,1,3,2,0,0,1037755,"2023-11-15T00:00:00.000Z",24,FALSE,18,470,"G",24,24,"Phoenix Suns","Yuta Watanabe",0,5,8,6,5,9.9
1,0,1,0,0,1,1,0,0,"13",1,1,2,2,0,0,1037755,"2023-11-15T00:00:00.000Z",24,FALSE,18,32,"F",24,24,"Phoenix Suns","Keita Bates-Diop",0,4,5,3,3,5.9
3,1,3,1,1,1,1,0,0,"16",0,2,3,3,1,0,1037755,"2023-11-15T00:00:00.000Z",24,FALSE,18,18678058,"",24,24,"Phoenix Suns","Jordan Goodwin",2,6,9,6,6,17.1
0,0,0,0,0,0,0,0,0,"00",0,0,0,0,0,0,1037755,"2023-11-15T00:00:00.000Z",24,FALSE,18,3547095,"C-F",24,24,"Phoenix Suns","Udoka Azubuike",0,0,0,0,0,0
0,0,0,0,0,0,0,0,0,"00",0,0,0,0,0,0,1037755,"2023-11-15T00:00:00.000Z",24,FALSE,18,666451,"C",24,24,"Phoenix Suns","Bol Bol",0,0,0,0,0,0
0,0,0,0,0,0,0,0,0,"00",0,0,0,0,0,0,1037755,"2023-11-15T00:00:00.000Z",24,FALSE,18,3547298,"G",24,24,"Phoenix Suns","Saben Lee",0,0,0,0,0,0
0,0,0,0,0,1,1,0,0,"03",0,1,2,0,0,0,1037755,"2023-11-15T00:00:00.000Z",24,FALSE,18,666729,"F",24,24,"Phoenix Suns","Nassir Little",0,2,2,2,0,2
0,0,2,1,0,4,2,0,0,"04",0,2,4,2,0,1,1037755,"2023-11-15T00:00:00.000Z",24,FALSE,18,314,"F",24,24,"Phoenix Suns","Chimezie Metu",0,6,6,4,2,5.4
0,0,0,0,0,0,0,0,0,"00",0,0,0,0,0,0,1037755,"2023-11-15T00:00:00.000Z",24,FALSE,18,37,"G",24,24,"Phoenix Suns","Bradley Beal",0,0,0,0,0,0
0,0,0,0,0,0,0,0,0,"00",0,0,0,0,0,0,1037755,"2023-11-15T00:00:00.000Z",24,FALSE,18,272,"G",24,24,"Phoenix Suns","Damion Lee",0,0,0,0,0,0
3,0,1,3,0,10,6,1,1,"23",1,4,13,2,2,1,1037755,"2023-11-15T00:00:00.000Z",24,FALSE,18,3547259,"F",18,18,"Minnesota Timberwolves","Jaden McDaniels",2,15,18,16,5,24.9
0,0,2,5,2,14,7,0,0,"32",0,1,16,2,5,1,1037756,"2023-11-15T00:00:00.000Z",14,FALSE,26,666860,"F-G",14,14,"Los Angeles Lakers","Cameron Reddish",5,18,18,16,2,32.4
11,1,8,7,3,15,9,8,7,"35",2,1,28,10,4,6,1037756,"2023-11-15T00:00:00.000Z",14,FALSE,26,237,"F",14,14,"Los Angeles Lakers","LeBron James",5,38,49,39,21,65.5
1,4,9,1,0,9,3,3,3,"35",0,4,9,9,0,5,1037756,"2023-11-15T00:00:00.000Z",14,FALSE,26,117,"F-C",14,14,"Los Angeles Lakers","Anthony Davis",4,18,19,10,10,28.3
0,0,2,4,1,7,3,0,0,"26",0,2,7,2,1,0,1037756,"2023-11-15T00:00:00.000Z",14,FALSE,26,383,"F",14,14,"Los Angeles Lakers","Taurean Prince",1,9,9,7,2,12.4
5,1,2,6,4,20,12,0,0,"35",3,3,28,5,0,2,1037756,"2023-11-15T00:00:00.000Z",14,FALSE,26,405,"G",14,14,"Los Angeles Lakers","D'Angelo Russell",1,33,38,33,10,42.5
0,0,1,0,0,1,0,0,0,"01",0,0,0,1,0,1,1037756,"2023-11-15T00:00:00.000Z",14,FALSE,26,38017697,"G",14,14,"Los Angeles Lakers","Max Christie",0,1,1,0,1,0.2
0,0,0,1,1,5,2,0,0,"18",0,0,5,0,0,0,1037756,"2023-11-15T00:00:00.000Z",14,FALSE,26,666609,"F",14,14,"Los Angeles Lakers","Rui Hachimura",0,5,5,5,0,5
0,0,1,0,0,0,0,4,3,"13",0,4,3,1,1,2,1037756,"2023-11-15T00:00:00.000Z",14,FALSE,26,666626,"C",14,14,"Los Angeles Lakers","Jaxson Hayes",1,4,4,3,1,5.2
0,0,0,0,0,0,0,0,0,"01",0,0,0,0,0,0,1037756,"2023-11-15T00:00:00.000Z",14,FALSE,26,56677868,"G",14,14,"Los Angeles Lakers","D'Moi Hodge",0,0,0,0,0,0
0,0,0,0,0,0,0,0,0,"01",0,0,0,0,0,1,1037756,"2023-11-15T00:00:00.000Z",14,FALSE,26,56677836,"F",14,14,"Los Angeles Lakers","Maxwell Lewis",0,0,0,0,0,-1
0,0,0,0,0,0,0,0,0,"00",0,0,0,0,0,0,1037756,"2023-11-15T00:00:00.000Z",14,FALSE,26,273,"C",26,26,"Sacramento Kings","Alex Len",0,0,0,0,0,0
0,0,0,0,0,0,0,0,0,"00",0,0,0,0,0,0,1037756,"2023-11-15T00:00:00.000Z",14,FALSE,26,290,"F",26,26,"Sacramento Kings","Trey Lyles",0,0,0,0,0,0
0,0,0,0,0,0,0,0,0,"00",0,0,0,0,0,0,1037756,"2023-11-15T00:00:00.000Z",14,FALSE,26,56677738,"C",14,14,"Los Angeles Lakers","Colin Castleton",0,0,0,0,0,0
0,0,0,0,0,0,0,0,0,"00",0,0,0,0,0,0,1037756,"2023-11-15T00:00:00.000Z",14,FALSE,26,56677867,"F",14,14,"Los Angeles Lakers","Alex Fudge",0,0,0,0,0,0
0,0,0,0,0,0,0,0,0,"00",0,0,0,0,0,0,1037756,"2023-11-15T00:00:00.000Z",14,FALSE,26,56677835,"G",14,14,"Los Angeles Lakers","Jalen Hood-Schifino",0,0,0,0,0,0
0,0,0,0,0,0,0,0,0,"00",0,0,0,0,0,0,1037756,"2023-11-15T00:00:00.000Z",14,FALSE,26,457,"F",14,14,"Los Angeles Lakers","Jarred Vanderbilt",0,0,0,0,0,0
0,0,0,0,0,0,0,0,0,"00",0,0,0,0,0,0,1037756,"2023-11-15T00:00:00.000Z",14,FALSE,26,1603383,"G",14,14,"Los Angeles Lakers","Gabe Vincent",0,0,0,0,0,0
2,0,1,6,3,10,5,0,0,"38",0,3,13,1,4,2,1037756,"2023-11-15T00:00:00.000Z",14,FALSE,26,30,"F",26,26,"Sacramento Kings","Harrison Barnes",4,14,16,15,3,27.2
2,0,6,7,2,9,3,2,1,"31",0,2,9,6,2,1,1037756,"2023-11-15T00:00:00.000Z",14,FALSE,26,38017688,"F",26,26,"Sacramento Kings","Keegan Murray",2,15,17,11,8,24.2
7,1,11,1,1,19,13,2,2,"39",5,3,29,16,3,4,1037756,"2023-11-15T00:00:00.000Z",14,FALSE,26,406,"F",26,26,"Sacramento Kings","Domantas Sabonis",4,45,52,36,23,66.7
1,0,0,0,0,2,2,0,0,"04",0,1,4,0,0,0,1037756,"2023-11-15T00:00:00.000Z",14,FALSE,26,17896030,"G",26,26,"Sacramento Kings","Chris Duarte",0,4,5,5,1,5.5
0,0,0,0,0,0,0,0,0,"01",0,0,0,0,0,0,1037756,"2023-11-15T00:00:00.000Z",14,FALSE,26,17896044,"F",26,26,"Sacramento Kings","Kessler Edwards",0,0,0,0,0,0
0,0,0,0,0,0,0,0,0,"00",0,0,0,0,0,0,1037756,"2023-11-15T00:00:00.000Z",14,FALSE,26,17553994,"G",26,26,"Sacramento Kings","Davion Mitchell",0,0,0,0,0,0
0,0,0,0,0,0,0,0,0,"01",0,0,0,0,0,0,1037756,"2023-11-15T00:00:00.000Z",14,FALSE,26,17895941,"C",26,26,"Sacramento Kings","Filip Petrusev",0,0,0,0,0,0
0,0,0,0,0,0,0,0,0,"01",0,0,0,0,0,0,1037756,"2023-11-15T00:00:00.000Z",14,FALSE,26,56677862,"F",26,26,"Sacramento Kings","Jalen Slawson",0,0,0,0,0,0
0,0,0,3,0,4,1,2,2,"12",0,0,4,0,2,0,1037756,"2023-11-15T00:00:00.000Z",14,FALSE,26,4197162,"F",26,26,"Sacramento Kings","Aleksandar Vezenkov",2,4,4,4,0,10
0,0,0,0,0,0,0,0,0,"00",0,0,0,0,0,0,1037756,"2023-11-15T00:00:00.000Z",14,FALSE,26,17895990,"G",26,26,"Sacramento Kings","Jordan Ford",0,0,0,0,0,0
0,0,0,0,0,0,0,0,0,"00",0,0,0,0,0,0,1037756,"2023-11-15T00:00:00.000Z",14,FALSE,26,56677845,"G",26,26,"Sacramento Kings","Colby Jones",0,0,0,0,0,0
8,0,9,5,0,10,4,2,1,"34",2,1,9,11,1,4,1037756,"2023-11-15T00:00:00.000Z",14,FALSE,26,17553995,"G",14,14,"Los Angeles Lakers","Austin Reaves",1,20,28,17,19,33.2
0,0,2,0,0,2,2,2,1,"09",0,1,5,2,0,1,1037756,"2023-11-15T00:00:00.000Z",14,FALSE,26,486,"F",14,14,"Los Angeles Lakers","Christian Wood",0,7,7,5,2,6.4
7,0,4,11,6,16,10,2,2,"37",0,2,28,4,2,0,1037756,"2023-11-15T00:00:00.000Z",14,FALSE,26,221,"G",26,26,"Sacramento Kings","Kevin Huerter",2,32,39,35,11,49.3
5,0,2,9,3,22,10,7,5,"38",3,3,28,5,4,3,1037756,"2023-11-15T00:00:00.000Z",14,FALSE,26,161,"G",26,26,"Sacramento Kings","De'Aaron Fox",4,33,38,33,10,50.5
5,0,5,5,1,8,1,0,0,"20",0,1,3,5,1,3,1037756,"2023-11-15T00:00:00.000Z",14,FALSE,26,324,"G",26,26,"Sacramento Kings","Malik Monk",1,8,13,8,10,16.5
1,0,1,2,0,3,0,0,0,"09",1,2,0,2,0,0,1037756,"2023-11-15T00:00:00.000Z",14,FALSE,26,38017714,"G",26,26,"Sacramento Kings","Keon Ellis",0,2,3,1,3,3.9
1,0,4,0,0,3,3,2,1,"09",2,3,7,6,2,2,1037756,"2023-11-15T00:00:00.000Z",14,FALSE,26,306,"C",26,26,"Sacramento Kings","JaVale McGee",2,13,14,8,7,19.7
2,0,3,6,1,17,7,2,2,"32",0,2,17,3,2,3,1037757,"2023-11-15T00:00:00.000Z",25,FALSE,6,182,"F",25,25,"Portland Trail Blazers","Jerami Grant",2,20,22,19,5,26.6
3,0,1,3,0,4,0,0,0,"22",0,1,0,1,2,1,1037757,"2023-11-15T00:00:00.000Z",25,FALSE,6,56677850,"F",25,25,"Portland Trail Blazers","Toumani Camara",2,1,4,3,4,10.7
0,0,4,0,0,10,3,0,0,"26",2,3,6,6,0,2,1037757,"2023-11-15T00:00:00.000Z",25,FALSE,6,22,"C",25,25,"Portland Trail Blazers","Deandre Ayton",0,12,12,6,6,11.2
5,0,4,5,1,12,2,7,6,"27",3,3,11,7,0,0,1037757,"2023-11-15T00:00:00.000Z",25,FALSE,6,38017690,"G",25,25,"Portland Trail Blazers","Shaedon Sharpe",0,18,23,16,12,26.9
4,0,1,4,2,13,4,3,3,"31",0,4,13,1,1,2,1037757,"2023-11-15T00:00:00.000Z",25,FALSE,6,3547289,"G",25,25,"Portland Trail Blazers","Skylar Mays",1,14,18,17,5,21.2
0,0,2,3,0,6,1,0,0,"09",0,1,2,2,0,0,1037757,"2023-11-15T00:00:00.000Z",25,FALSE,6,44477062,"G",25,25,"Portland Trail Blazers","Jamaree Bouyea",0,4,4,2,2,4.4
0,0,0,0,0,0,0,0,0,"00",0,0,0,0,0,0,1037757,"2023-11-15T00:00:00.000Z",25,FALSE,6,666476,"C",25,25,"Portland Trail Blazers","Moses Brown",0,0,0,0,0,0
0,0,0,0,0,0,0,0,0,"02",0,0,0,0,0,0,1037757,"2023-11-15T00:00:00.000Z",25,FALSE,6,47957121,"F",25,25,"Portland Trail Blazers","Justin Minaya",0,0,0,0,0,0
3,0,2,3,1,5,2,0,0,"17",0,1,5,2,1,0,1037757,"2023-11-15T00:00:00.000Z",25,FALSE,6,56677791,"F",25,25,"Portland Trail Blazers","Kris Murray",1,7,10,8,5,14.9
3,0,0,5,2,10,6,2,2,"20",2,2,16,2,0,1,1037757,"2023-11-15T00:00:00.000Z",25,FALSE,6,56783340,"C",25,25,"Portland Trail Blazers","Duop Reath",0,18,21,19,5,21.9
0,0,0,0,0,0,0,0,0,"03",0,0,0,0,0,0,1037757,"2023-11-15T00:00:00.000Z",25,FALSE,6,17896120,"F",25,25,"Portland Trail Blazers","Ish Wainright",0,0,0,0,0,0
1,2,2,4,3,7,4,2,1,"23",1,2,12,3,0,2,1037757,"2023-11-15T00:00:00.000Z",25,FALSE,6,38017711,"F",25,25,"Portland Trail Blazers","Jabari Walker",2,15,16,13,4,21.1
0,0,0,0,0,0,0,0,0,"00",0,0,0,0,0,0,1037757,"2023-11-15T00:00:00.000Z",25,FALSE,6,65,"G",25,25,"Portland Trail Blazers","Malcolm Brogdon",0,0,0,0,0,0
0,0,0,0,0,0,0,0,0,"00",0,0,0,0,0,0,1037757,"2023-11-15T00:00:00.000Z",25,FALSE,6,56677747,"G",25,25,"Portland Trail Blazers","Scoot Henderson",0,0,0,0,0,0
0,0,0,0,0,0,0,0,0,"00",0,0,0,0,0,0,1037757,"2023-11-15T00:00:00.000Z",25,FALSE,6,419,"G",25,25,"Portland Trail Blazers","Anfernee Simons",0,0,0,0,0,0
0,0,0,0,0,0,0,0,0,"00",0,0,0,0,0,0,1037757,"2023-11-15T00:00:00.000Z",25,FALSE,6,476,"C-F",25,25,"Portland Trail Blazers","Robert Williams III",0,0,0,0,0,0
2,1,2,3,0,3,0,0,0,"33",1,1,0,3,0,0,1037757,"2023-11-15T00:00:00.000Z",25,FALSE,6,666940,"F",6,6,"Cleveland Cavaliers","Dean Wade",1,3,5,2,5,9.6
0,0,0,1,0,1,0,0,0,"02",0,1,0,0,0,1,1037757,"2023-11-15T00:00:00.000Z",25,FALSE,6,56677829,"G-F",25,25,"Portland Trail Blazers","Rayan Rupert",0,0,0,0,0,-1
3,1,3,4,3,6,5,0,0,"26",0,1,13,3,3,0,1037757,"2023-11-15T00:00:00.000Z",25,FALSE,6,666923,"G-F",25,25,"Portland Trail Blazers","Matisse Thybulle",4,16,19,16,6,33.1
3,3,9,1,0,11,8,8,5,"35",3,1,21,12,1,1,1037757,"2023-11-15T00:00:00.000Z",25,FALSE,6,17896076,"F-C",6,6,"Cleveland Cavaliers","Evan Mobley",4,33,36,24,15,50.9
1,3,8,0,0,3,3,6,5,"29",1,3,11,9,0,3,1037757,"2023-11-15T00:00:00.000Z",25,FALSE,6,9,"C",6,6,"Cleveland Cavaliers","Jarrett Allen",3,20,21,12,10,29.3
7,0,2,7,1,12,5,3,3,"37",1,3,14,3,1,5,1037757,"2023-11-15T00:00:00.000Z",25,FALSE,6,666908,"G",6,6,"Cleveland Cavaliers","Max Strus",1,17,24,21,10,26.1
4,0,6,8,5,20,13,4,3,"36",0,4,34,6,1,3,1037757,"2023-11-15T00:00:00.000Z",25,FALSE,6,322,"G",6,6,"Cleveland Cavaliers","Donovan Mitchell",1,40,44,38,10,47.2
6,1,7,7,1,17,8,0,0,"33",1,2,17,8,2,1,1037757,"2023-11-15T00:00:00.000Z",25,FALSE,6,277,"G",6,6,"Cleveland Cavaliers","Caris LeVert",3,25,31,23,14,43.6
0,1,2,4,2,6,3,0,0,"22",0,1,8,2,0,2,1037757,"2023-11-15T00:00:00.000Z",25,FALSE,6,344,"F",6,6,"Cleveland Cavaliers","Georges Niang",1,10,10,8,2,11.4
0,0,2,0,0,3,2,0,0,"09",0,1,4,2,0,2,1037757,"2023-11-15T00:00:00.000Z",25,FALSE,6,56677872,"G",6,6,"Cleveland Cavaliers","Craig Porter",0,6,6,4,2,4.4
0,0,0,0,0,0,0,0,0,"00",0,0,0,0,0,0,1037757,"2023-11-15T00:00:00.000Z",25,FALSE,6,666676,"G",6,6,"Cleveland Cavaliers","Ty Jerome",0,0,0,0,0,0
0,0,0,0,0,0,0,0,0,"00",0,0,0,0,0,0,1037757,"2023-11-15T00:00:00.000Z",25,FALSE,6,38017662,"F",6,6,"Cleveland Cavaliers","Isaiah Mobley",0,0,0,0,0,0
0,0,0,0,0,0,0,0,0,"00",0,0,0,0,0,0,1037757,"2023-11-15T00:00:00.000Z",25,FALSE,6,3547247,"F-G",6,6,"Cleveland Cavaliers","Isaac Okoro",0,0,0,0,0,0
0,0,0,0,0,0,0,0,0,"00",0,0,0,0,0,0,1037757,"2023-11-15T00:00:00.000Z",25,FALSE,6,404,"G",6,6,"Cleveland Cavaliers","Ricky Rubio",0,0,0,0,0,0
0,0,1,0,0,0,0,0,0,"01",0,0,0,1,0,0,1037757,"2023-11-15T00:00:00.000Z",25,FALSE,6,56677847,"F",6,6,"Cleveland Cavaliers","Emoni Bates",0,1,1,0,1,1.2
0,0,0,0,0,0,0,0,0,"01",0,0,0,0,0,0,1037757,"2023-11-15T00:00:00.000Z",25,FALSE,6,248,"C",6,6,"Cleveland Cavaliers","Damian Jones",0,0,0,0,0,0
0,0,0,0,0,0,0,0,0,"02",0,0,0,0,0,0,1037757,"2023-11-15T00:00:00.000Z",25,FALSE,6,3547299,"G",6,6,"Cleveland Cavaliers","Sam Merrill",0,0,0,0,0,0
0,0,1,0,0,0,0,0,0,"02",0,0,0,1,0,0,1037757,"2023-11-15T00:00:00.000Z",25,FALSE,6,444,"C-F",6,6,"Cleveland Cavaliers","Tristan Thompson",0,1,1,0,1,1.2
0,0,0,0,0,0,0,0,0,"00",0,0,0,0,0,0,1037757,"2023-11-15T00:00:00.000Z",25,FALSE,6,666581,"G",6,6,"Cleveland Cavaliers","Darius Garland",0,0,0,0,0,0
3,3,3,5,2,19,12,11,10,"35",2,0,36,5,1,4,1037758,"2023-11-16T00:00:00.000Z",16,FALSE,3,79,"G-F",16,16,"Miami Heat","Jimmy Butler",4,41,44,39,8,54.5
0,0,1,3,0,5,2,2,2,"23",0,3,6,1,0,1,1037758,"2023-11-16T00:00:00.000Z",16,FALSE,3,3092,"",16,16,"Miami Heat","Haywood Highsmith",0,7,7,6,1,6.2
4,1,5,0,0,15,8,4,4,"33",2,2,20,7,2,2,1037758,"2023-11-16T00:00:00.000Z",16,FALSE,3,4,"C-F",16,16,"Miami Heat","Bam Adebayo",3,27,31,24,11,41.4
2,0,0,10,6,14,8,4,4,"38",0,3,26,0,0,0,1037758,"2023-11-16T00:00:00.000Z",16,FALSE,3,397,"F",16,16,"Miami Heat","Duncan Robinson",0,26,28,28,2,29
3,0,2,1,1,4,1,0,0,"24",1,3,3,3,3,0,1037758,"2023-11-16T00:00:00.000Z",16,FALSE,3,286,"G",16,16,"Miami Heat","Kyle Lowry",3,6,9,6,6,20.1
0,0,0,0,0,0,0,0,0,"00",0,0,0,0,0,0,1037758,"2023-11-16T00:00:00.000Z",16,FALSE,3,74,"C",16,16,"Miami Heat","Thomas Bryant",0,0,0,0,0,0
5,0,4,5,2,9,4,0,0,"33",0,3,10,4,0,1,1037758,"2023-11-16T00:00:00.000Z",16,FALSE,3,56677785,"G",16,16,"Miami Heat","Jaime Jaquez Jr.",0,14,19,15,9,21.3
0,0,0,0,0,0,0,0,0,"00",0,0,0,0,0,0,1037758,"2023-11-16T00:00:00.000Z",16,FALSE,3,38017696,"F",16,16,"Miami Heat","Nikola Jovic",0,0,0,0,0,0
4,0,8,3,1,4,2,2,2,"16",1,2,7,9,0,0,1037758,"2023-11-16T00:00:00.000Z",16,FALSE,3,285,"F-C",16,16,"Miami Heat","Kevin Love",0,16,20,11,13,23.8
0,0,0,0,0,0,0,0,0,"00",0,0,0,0,0,0,1037758,"2023-11-16T00:00:00.000Z",16,FALSE,3,3547257,"G",16,16,"Miami Heat","R.J. Hampton",0,0,0,0,0,0
0,0,0,0,0,0,0,0,0,"00",0,0,0,0,0,0,1037758,"2023-11-16T00:00:00.000Z",16,FALSE,3,666633,"G",16,16,"Miami Heat","Tyler Herro",0,0,0,0,0,0
0,0,0,0,0,0,0,0,0,"00",0,0,0,0,0,0,1037758,"2023-11-16T00:00:00.000Z",16,FALSE,3,38017736,"F",16,16,"Miami Heat","Cole Swider",0,0,0,0,0,0
3,0,4,6,3,10,5,3,3,"27",0,5,16,4,1,1,1037758,"2023-11-16T00:00:00.000Z",16,FALSE,3,666679,"F",3,3,"Brooklyn Nets","Cameron Johnson",1,20,23,19,7,27.3
0,0,0,0,0,0,0,0,0,"00",0,0,0,0,0,0,1037758,"2023-11-16T00:00:00.000Z",16,FALSE,3,174,"F-C",3,3,"Brooklyn Nets","Harry Giles III",0,0,0,0,0,0
5,0,2,2,1,6,2,0,0,"16",0,2,5,2,0,0,1037758,"2023-11-16T00:00:00.000Z",16,FALSE,3,421,"G",3,3,"Brooklyn Nets","Dennis Smith Jr.",0,7,12,10,7,14.9
0,0,0,0,0,0,0,0,0,"00",0,0,0,0,0,0,1037758,"2023-11-16T00:00:00.000Z",16,FALSE,3,17896048,"G",3,3,"Brooklyn Nets","Cam Thomas",0,0,0,0,0,0
2,0,0,3,2,4,2,0,0,"12",1,2,6,1,0,1,1037758,"2023-11-16T00:00:00.000Z",16,FALSE,3,666747,"F",16,16,"Miami Heat","Caleb Martin",0,7,9,8,3,9.2
3,0,2,5,1,7,3,1,1,"26",0,2,8,2,2,0,1037758,"2023-11-16T00:00:00.000Z",16,FALSE,3,391,"G-F",16,16,"Miami Heat","Josh Richardson",2,10,13,11,5,20.9
0,0,0,0,0,0,0,0,0,"00",0,0,0,0,0,0,1037758,"2023-11-16T00:00:00.000Z",16,FALSE,3,39398582,"C",16,16,"Miami Heat","Orlando Robinson",0,0,0,0,0,0
0,0,0,0,0,0,0,0,0,"00",0,0,0,0,0,0,1037758,"2023-11-16T00:00:00.000Z",16,FALSE,3,19465585,"G",16,16,"Miami Heat","Dru Smith",0,0,0,0,0,0
0,0,0,0,0,0,0,0,0,"00",0,0,0,0,0,0,1037758,"2023-11-16T00:00:00.000Z",16,FALSE,3,38017734,"F",16,16,"Miami Heat","Jamal Cain",0,0,0,0,0,0
1,0,2,7,2,18,9,4,3,"26",1,2,23,3,1,2,1037758,"2023-11-16T00:00:00.000Z",16,FALSE,3,464,"G",3,3,"Brooklyn Nets","Lonnie Walker IV",1,26,27,24,4,29.1
1,0,0,0,0,3,2,0,0,"10",2,1,4,2,0,0,1037758,"2023-11-16T00:00:00.000Z",16,FALSE,3,17896058,"F",3,3,"Brooklyn Nets","Trendon Watford",0,6,7,5,3,7.9
0,0,0,0,0,0,0,0,0,"00",0,0,0,0,0,0,1037758,"2023-11-16T00:00:00.000Z",16,FALSE,3,9051997,"G",3,3,"Brooklyn Nets","Armoni Brooks",0,0,0,0,0,0
0,0,0,0,0,0,0,0,0,"00",0,0,0,0,0,0,1037758,"2023-11-16T00:00:00.000Z",16,FALSE,3,56677843,"F",3,3,"Brooklyn Nets","Noah Clowney",0,0,0,0,0,0
0,0,0,0,0,0,0,0,0,"00",0,0,0,0,0,0,1037758,"2023-11-16T00:00:00.000Z",16,FALSE,3,17896041,"G",3,3,"Brooklyn Nets","Keon Johnson",0,0,0,0,0,0
0,0,0,0,0,0,0,0,0,"00",0,0,0,0,0,0,1037758,"2023-11-16T00:00:00.000Z",16,FALSE,3,417,"G-F",3,3,"Brooklyn Nets","Ben Simmons",0,0,0,0,0,0
0,0,0,0,0,0,0,0,0,"00",0,0,0,0,0,0,1037758,"2023-11-16T00:00:00.000Z",16,FALSE,3,56677841,"F",3,3,"Brooklyn Nets","Dariq Whitehead",0,0,0,0,0,0
0,0,0,0,0,0,0,0,0,"00",0,0,0,0,0,0,1037758,"2023-11-16T00:00:00.000Z",16,FALSE,3,56677722,"F",3,3,"Brooklyn Nets","Jalen Wilson",0,0,0,0,0,0
5,0,6,6,2,15,6,10,9,"35",1,2,23,7,0,3,1037758,"2023-11-16T00:00:00.000Z",16,FALSE,3,61,"F",3,3,"Brooklyn Nets","Mikal Bridges",0,30,35,28,12,35.9
7,0,3,7,2,9,2,6,4,"33",2,1,10,5,0,2,1037758,"2023-11-16T00:00:00.000Z",16,FALSE,3,130,"G",3,3,"Brooklyn Nets","Spencer Dinwiddie",0,15,22,17,12,24.5
0,0,3,0,0,6,1,0,0,"15",2,0,2,5,0,1,1037758,"2023-11-16T00:00:00.000Z",16,FALSE,3,17896038,"C",3,3,"Brooklyn Nets","Day'Ron Sharpe",0,7,7,2,5,7
4,0,0,4,1,5,2,0,0,"20",0,2,5,0,1,1,1037758,"2023-11-16T00:00:00.000Z",16,FALSE,3,351,"F",3,3,"Brooklyn Nets","Royce O'Neale",1,5,9,9,4,13
1,0,5,4,3,6,4,0,0,"32",1,3,11,6,1,3,1037758,"2023-11-16T00:00:00.000Z",16,FALSE,3,158,"F",3,3,"Brooklyn Nets","Dorian Finney-Smith",1,17,18,12,7,19.7
2,3,5,0,0,7,7,4,2,"26",1,2,16,6,1,1,1037758,"2023-11-16T00:00:00.000Z",16,FALSE,3,666508,"F-C",3,3,"Brooklyn Nets","Nicolas Claxton",4,22,24,18,8,37.2
2,0,2,4,0,13,6,0,0,"26",4,2,12,6,0,5,1037759,"2023-11-16T00:00:00.000Z",10,FALSE,21,475,"F-G",10,10,"Golden State Warriors","Andrew Wiggins",0,18,20,14,8,17.2
2,1,6,4,1,13,8,5,4,"27",0,0,21,6,0,4,1037759,"2023-11-16T00:00:00.000Z",10,FALSE,21,17553979,"F",10,10,"Golden State Warriors","Jonathan Kuminga",1,27,29,23,8,30.2
4,0,2,3,2,10,4,2,2,"24",1,4,12,3,1,1,1037759,"2023-11-16T00:00:00.000Z",10,FALSE,21,407,"F",10,10,"Golden State Warriors","Dario Saric",1,15,19,16,7,23.6
3,0,2,6,1,10,1,2,2,"27",0,1,5,2,1,2,1037759,"2023-11-16T00:00:00.000Z",10,FALSE,21,443,"G",10,10,"Golden State Warriors","Klay Thompson",1,7,10,8,5,12.9
8,0,3,6,4,8,4,3,3,"28",0,1,15,3,1,1,1037759,"2023-11-16T00:00:00.000Z",10,FALSE,21,367,"G",10,10,"Golden State Warriors","Chris Paul",1,18,26,23,11,32.6
0,0,0,0,0,0,0,0,0,"00",0,0,0,0,0,0,1037759,"2023-11-16T00:00:00.000Z",10,FALSE,21,185,"F",10,10,"Golden State Warriors","Draymond Green",0,0,0,0,0,0
0,1,0,0,0,0,0,0,0,"05",0,0,0,0,0,0,1037759,"2023-11-16T00:00:00.000Z",10,FALSE,21,56677799,"F",10,10,"Golden State Warriors","Trayce Jackson-Davis",1,0,0,0,0,3
2,1,1,5,1,7,1,0,0,"20",1,0,3,2,0,0,1037759,"2023-11-16T00:00:00.000Z",10,FALSE,21,251,"G",10,10,"Golden State Warriors","Cory Joseph",1,5,7,5,4,11.4
0,0,0,0,0,0,0,0,0,"00",0,0,0,0,0,0,1037759,"2023-11-16T00:00:00.000Z",10,FALSE,21,115,"G",10,10,"Golden State Warriors","Stephen Curry",0,0,0,0,0,0
0,0,0,0,0,0,0,0,0,"00",0,0,0,0,0,0,1037759,"2023-11-16T00:00:00.000Z",10,FALSE,21,17896070,"F",10,10,"Golden State Warriors","Usman Garuba",0,0,0,0,0,0
0,0,0,0,0,0,0,0,0,"00",0,0,0,0,0,0,1037759,"2023-11-16T00:00:00.000Z",10,FALSE,21,398,"G",10,10,"Golden State Warriors","Jerome Robinson",0,0,0,0,0,0
0,0,2,3,1,5,2,0,0,"24",0,2,5,2,1,1,1037759,"2023-11-16T00:00:00.000Z",10,FALSE,21,666541,"G",21,21,"Oklahoma City Thunder","Luguentz Dort",1,7,7,5,2,9.4
5,0,3,3,2,13,6,2,2,"29",0,3,16,3,2,2,1037759,"2023-11-16T00:00:00.000Z",10,FALSE,21,38017703,"G-F",21,21,"Oklahoma City Thunder","Jalen Williams",2,19,24,21,8,31.1
1,0,4,0,0,9,6,2,1,"19",7,3,13,11,1,1,1037759,"2023-11-16T00:00:00.000Z",10,FALSE,21,282,"F",10,10,"Golden State Warriors","Kevon Looney",1,24,25,14,12,29.7
1,1,2,4,2,11,5,1,0,"23",2,1,12,4,0,1,1037759,"2023-11-16T00:00:00.000Z",10,FALSE,21,17553992,"G",10,10,"Golden State Warriors","Moses Moody",1,16,17,13,5,20.3
0,0,0,1,0,4,0,2,1,"08",1,1,1,1,1,0,1037759,"2023-11-16T00:00:00.000Z",10,FALSE,21,2189,"",10,10,"Golden State Warriors","Gary Payton II",1,2,2,1,1,5.2
3,0,6,4,3,7,4,2,2,"25",2,5,13,8,0,1,1037759,"2023-11-16T00:00:00.000Z",10,FALSE,21,56677858,"G",10,10,"Golden State Warriors","Brandin Podziemski",0,21,24,16,11,26.1
0,0,0,2,0,3,0,0,0,"04",0,1,0,0,0,0,1037759,"2023-11-16T00:00:00.000Z",10,FALSE,21,45658838,"G",10,10,"Golden State Warriors","Lester Quinones",0,0,0,0,0,0
0,0,1,1,0,3,1,0,0,"04",2,0,2,3,0,0,1037759,"2023-11-16T00:00:00.000Z",10,FALSE,21,57875092,"F",10,10,"Golden State Warriors","Gui Santos",0,5,5,2,3,5.6
2,2,9,2,0,7,4,5,5,"27",1,2,13,10,0,4,1037759,"2023-11-16T00:00:00.000Z",10,FALSE,21,38017685,"C-F",21,21,"Oklahoma City Thunder","Chet Holmgren",2,23,25,15,12,30
1,0,4,3,3,14,8,0,0,"26",2,1,19,6,2,3,1037759,"2023-11-16T00:00:00.000Z",10,FALSE,21,17896065,"G",21,21,"Oklahoma City Thunder","Josh Giddey",2,25,26,20,7,30.7
7,1,1,7,3,21,6,9,9,"29",1,4,24,2,2,2,1037759,"2023-11-16T00:00:00.000Z",10,FALSE,21,175,"G",21,21,"Oklahoma City Thunder","Shai Gilgeous-Alexander",3,26,33,31,9,43.9
0,0,0,0,0,0,0,0,0,"00",0,0,0,0,0,0,1037759,"2023-11-16T00:00:00.000Z",10,FALSE,21,44,"F",21,21,"Oklahoma City Thunder","Davis Bertans",0,0,0,0,0,0
0,0,5,7,7,7,7,3,2,"25",0,1,23,5,2,0,1037759,"2023-11-16T00:00:00.000Z",10,FALSE,21,3547272,"G",21,21,"Oklahoma City Thunder","Isaiah Joe",2,28,28,23,5,35
0,0,0,0,0,0,0,0,0,"00",0,0,0,0,0,0,1037759,"2023-11-16T00:00:00.000Z",10,FALSE,21,17896036,"G",21,21,"Oklahoma City Thunder","Tre Mann",0,0,0,0,0,0
7,0,3,3,1,5,1,2,2,"21",0,3,5,3,0,0,1037759,"2023-11-16T00:00:00.000Z",10,FALSE,21,4197029,"G",21,21,"Oklahoma City Thunder","Vasilije Micic",0,8,15,12,10,19.1
0,0,0,0,0,0,0,0,0,"00",0,0,0,0,0,0,1037759,"2023-11-16T00:00:00.000Z",10,FALSE,21,3547271,"C",21,21,"Oklahoma City Thunder","Aleksej Pokusevski",0,0,0,0,0,0
4,0,1,2,2,7,4,0,0,"26",1,1,10,2,1,0,1037759,"2023-11-16T00:00:00.000Z",10,FALSE,21,56677833,"G",21,21,"Oklahoma City Thunder","Cason Wallace",1,12,16,14,6,21.4
1,0,2,1,0,3,2,2,1,"11",0,0,5,2,0,0,1037759,"2023-11-16T00:00:00.000Z",10,FALSE,21,17896078,"G",21,21,"Oklahoma City Thunder","Aaron Wiggins",0,7,8,6,3,8.9
1,0,2,1,0,2,1,0,0,"04",0,0,2,2,0,0,1037759,"2023-11-16T00:00:00.000Z",10,FALSE,21,38017706,"F",21,21,"Oklahoma City Thunder","Jaylin Williams",0,4,5,3,3,5.9
3,0,3,0,0,3,3,0,0,"18",2,3,6,5,0,0,1037759,"2023-11-16T00:00:00.000Z",10,FALSE,21,480,"G-F",21,21,"Oklahoma City Thunder","Kenrich Williams",0,11,14,9,8,16.5
0,0,0,0,0,0,0,0,0,"00",0,0,0,0,0,0,1037759,"2023-11-16T00:00:00.000Z",10,FALSE,21,38017716,"F",21,21,"Oklahoma City Thunder","Ousmane Dieng",0,0,0,0,0,0
0,0,0,0,0,0,0,0,0,"00",0,0,0,0,0,0,1037759,"2023-11-16T00:00:00.000Z",10,FALSE,21,56677853,"F",21,21,"Oklahoma City Thunder","Keyontae Johnson",0,0,0,0,0,0
0,0,0,0,0,0,0,0,0,"00",0,0,0,0,0,0,1037759,"2023-11-16T00:00:00.000Z",10,FALSE,21,24572055,"C",21,21,"Oklahoma City Thunder","Olivier Sarr",0,0,0,0,0,0
0,0,0,0,0,0,0,0,0,"00",0,0,0,0,0,0,1037759,"2023-11-16T00:00:00.000Z",10,FALSE,21,27924547,"F",21,21,"Oklahoma City Thunder","Lindy Waters III",0,0,0,0,0,0
2,1,4,4,2,11,7,2,2,"32",0,4,18,4,1,3,3277446,"2023-11-17T00:00:00.000Z",30,FALSE,20,3547242,"F",30,30,"Washington Wizards","Deni Avdija",2,22,24,20,6,28.8
5,0,4,8,3,21,8,0,0,"32",0,3,19,4,0,2,3277446,"2023-11-17T00:00:00.000Z",30,FALSE,20,265,"F",30,30,"Washington Wizards","Kyle Kuzma",0,23,28,24,9,29.3
0,0,3,0,0,8,4,2,2,"28",4,4,10,7,1,1,3277446,"2023-11-17T00:00:00.000Z",30,FALSE,20,666577,"F",30,30,"Washington Wizards","Daniel Gafford",1,17,17,10,7,20.4
5,0,3,2,1,7,4,2,2,"30",0,0,11,3,1,1,3277446,"2023-11-17T00:00:00.000Z",30,FALSE,20,249,"G",30,30,"Washington Wizards","Tyus Jones",1,14,19,16,8,24.1
4,0,1,6,0,11,2,4,4,"29",0,2,8,1,0,5,3277446,"2023-11-17T00:00:00.000Z",30,FALSE,20,666848,"G",30,30,"Washington Wizards","Jordan Poole",0,9,13,12,5,10.2
0,0,0,0,0,0,0,0,0,"02",0,0,0,0,0,0,3277446,"2023-11-17T00:00:00.000Z",30,FALSE,20,18677954,"G",30,30,"Washington Wizards","Jared Butler",0,0,0,0,0,0
4,1,3,3,0,7,2,3,2,"31",0,1,6,3,0,2,3277446,"2023-11-17T00:00:00.000Z",30,FALSE,20,56677844,"G",30,30,"Washington Wizards","Bilal Coulibaly",1,9,13,10,7,16.6
0,0,0,0,0,0,0,0,0,"02",0,0,0,0,0,0,3277446,"2023-11-17T00:00:00.000Z",30,FALSE,20,38017687,"G",30,30,"Washington Wizards","Johnny Davis",0,0,0,0,0,0
1,2,5,3,1,7,3,0,0,"17",1,3,7,6,0,0,3277446,"2023-11-17T00:00:00.000Z",30,FALSE,20,167,"F",30,30,"Washington Wizards","Danilo Gallinari",2,13,14,8,7,21.7
1,0,1,0,0,0,0,2,2,"02",0,0,2,1,0,0,3277446,"2023-11-17T00:00:00.000Z",30,FALSE,20,3547302,"F",30,30,"Washington Wizards","Anthony Gill",0,3,4,3,2,4.7
1,0,1,3,1,5,3,1,1,"26",2,1,8,3,1,0,3277446,"2023-11-17T00:00:00.000Z",30,FALSE,20,17896045,"F",30,30,"Washington Wizards","Corey Kispert",1,11,12,9,4,16.1
0,0,0,0,0,0,0,0,0,"00",0,0,0,0,0,0,3277446,"2023-11-17T00:00:00.000Z",30,FALSE,20,337,"F-C",30,30,"Washington Wizards","Mike Muscala",0,0,0,0,0,0
0,0,0,1,1,2,2,0,0,"02",0,0,5,0,0,0,3277446,"2023-11-17T00:00:00.000Z",30,FALSE,20,17896106,"F",30,30,"Washington Wizards","Eugene Omoruyi",0,5,5,5,0,5
2,0,0,2,1,3,2,0,0,"07",0,0,5,0,0,0,3277446,"2023-11-17T00:00:00.000Z",30,FALSE,20,414,"G",30,30,"Washington Wizards","Landry Shamet",0,5,7,7,2,8
0,0,0,0,0,0,0,0,0,"00",0,0,0,0,0,0,3277446,"2023-11-17T00:00:00.000Z",30,FALSE,20,38017704,"F",30,30,"Washington Wizards","Patrick Baldwin Jr.",0,0,0,0,0,0
0,0,0,0,0,0,0,0,0,"00",0,0,0,0,0,0,3277446,"2023-11-17T00:00:00.000Z",30,FALSE,20,38124126,"F",30,30,"Washington Wizards","John Butler Jr.",0,0,0,0,0,0
0,0,0,0,0,0,0,0,0,"00",0,0,0,0,0,0,3277446,"2023-11-17T00:00:00.000Z",30,FALSE,20,38017712,"G",30,30,"Washington Wizards","Ryan Rollins",0,0,0,0,0,0
0,0,0,0,0,0,0,0,0,"00",0,0,0,0,0,0,3277446,"2023-11-17T00:00:00.000Z",30,FALSE,20,487,"G",30,30,"Washington Wizards","Delon Wright",0,0,0,0,0,0
2,2,4,2,1,7,4,0,0,"32",1,1,9,5,0,1,3277446,"2023-11-17T00:00:00.000Z",30,FALSE,20,202,"G",20,20,"New York Knicks","Josh Hart",2,14,16,11,7,23
8,2,6,5,1,18,9,6,3,"35",1,3,22,7,1,6,3277446,"2023-11-17T00:00:00.000Z",30,FALSE,20,387,"F",20,20,"New York Knicks","Julius Randle",3,29,37,30,15,45.4
1,1,5,0,0,4,3,1,0,"27",3,1,6,8,0,0,3277446,"2023-11-17T00:00:00.000Z",30,FALSE,20,399,"C",20,20,"New York Knicks","Mitchell Robinson",1,14,15,7,9,20.1
1,0,2,8,4,9,5,0,0,"25",2,1,14,4,0,1,3277446,"2023-11-17T00:00:00.000Z",30,FALSE,20,131,"G",20,20,"New York Knicks","Donte DiVincenzo",0,18,19,15,5,19.3
7,0,4,10,6,23,10,6,6,"34",3,2,32,7,0,0,3277446,"2023-11-17T00:00:00.000Z",30,FALSE,20,73,"G",20,20,"New York Knicks","Jalen Brunson",0,39,46,39,14,50.9
0,0,0,0,0,0,0,0,0,"01",0,0,0,0,0,0,3277446,"2023-11-17T00:00:00.000Z",30,FALSE,20,19,"G",20,20,"New York Knicks","Ryan Arcidiacono",0,0,0,0,0,0
1,0,1,4,0,6,1,0,0,"16",0,2,2,1,1,0,3277446,"2023-11-17T00:00:00.000Z",30,FALSE,20,160,"G-F",20,20,"New York Knicks","Evan Fournier",1,3,4,3,2,7.7
2,1,5,0,0,3,1,2,1,"20",3,4,3,8,1,1,3277446,"2023-11-17T00:00:00.000Z",30,FALSE,20,201,"F-C",20,20,"New York Knicks","Isaiah Hartenstein",2,11,13,5,10,20.6
0,0,0,0,0,0,0,0,0,"02",0,0,0,0,0,0,3277446,"2023-11-17T00:00:00.000Z",30,FALSE,20,666675,"F",20,20,"New York Knicks","DaQuan Jeffries",0,0,0,0,0,0
0,0,0,2,1,3,2,0,0,"14",1,2,5,1,1,0,3277446,"2023-11-17T00:00:00.000Z",30,FALSE,20,17896033,"G",20,20,"New York Knicks","Miles McBride",1,6,6,5,1,9.2
4,0,6,7,3,18,10,5,4,"33",0,5,27,6,1,1,3277446,"2023-11-17T00:00:00.000Z",30,FALSE,20,3547269,"G",20,20,"New York Knicks","Immanuel Quickley",1,33,37,31,10,42.2
0,0,1,0,0,0,0,0,0,"01",0,0,0,1,0,0,3277446,"2023-11-17T00:00:00.000Z",30,FALSE,20,17896063,"F",20,20,"New York Knicks","Jericho Sims",0,1,1,0,1,1.2
0,0,0,0,0,0,0,0,0,"00",0,0,0,0,0,0,3277446,"2023-11-17T00:00:00.000Z",30,FALSE,20,666423,"F-G",20,20,"New York Knicks","RJ Barrett",0,0,0,0,0,0
0,0,0,0,0,0,0,0,0,"00",0,0,0,0,0,0,3277446,"2023-11-17T00:00:00.000Z",30,FALSE,20,666474,"G",20,20,"New York Knicks","Charles Brown",0,0,0,0,0,0
0,0,0,0,0,0,0,0,0,"00",0,0,0,0,0,0,3277446,"2023-11-17T00:00:00.000Z",30,FALSE,20,17895858,"G",20,20,"New York Knicks","Quentin Grimes",0,0,0,0,0,0
0,0,0,0,0,0,0,0,0,"00",0,0,0,0,0,0,3277446,"2023-11-17T00:00:00.000Z",30,FALSE,20,56677795,"F",20,20,"New York Knicks","Jacob Toppin",0,0,0,0,0,0
0,0,0,0,0,0,0,0,0,"00",0,0,0,0,0,0,3277446,"2023-11-17T00:00:00.000Z",30,FALSE,20,17896089,"G",20,20,"New York Knicks","Duane Washington Jr.",0,0,0,0,0,0
0,0,0,0,0,0,0,0,0,"00",0,0,0,0,0,0,3277446,"2023-11-17T00:00:00.000Z",30,FALSE,20,666971,"G-F",20,20,"New York Knicks","Dylan Windler",0,0,0,0,0,0
0,0,1,2,1,7,4,0,0,"18",0,1,9,1,0,0,3277447,"2023-11-17T00:00:00.000Z",1,FALSE,23,666656,"F",1,1,"Atlanta Hawks","De'Andre Hunter",0,10,10,9,1,10.2
2,3,9,2,0,12,7,4,4,"36",1,2,18,10,1,0,3277447,"2023-11-17T00:00:00.000Z",1,FALSE,23,17896040,"F",1,1,"Atlanta Hawks","Jalen Johnson",4,28,30,20,12,45
2,1,3,0,0,11,7,5,3,"29",8,3,17,11,0,0,3277447,"2023-11-17T00:00:00.000Z",1,FALSE,23,83,"C",1,1,"Atlanta Hawks","Clint Capela",1,28,30,19,13,36.2
3,0,1,7,3,16,5,0,0,"35",0,2,13,1,2,3,3277447,"2023-11-17T00:00:00.000Z",1,FALSE,23,334,"G",1,1,"Atlanta Hawks","Dejounte Murray",2,14,17,16,4,21.7
13,0,2,6,2,14,5,10,10,"37",0,3,22,2,1,4,3277447,"2023-11-17T00:00:00.000Z",1,FALSE,23,490,"G",1,1,"Atlanta Hawks","Trae Young",1,24,37,35,15,42.9
1,0,4,4,2,9,6,4,3,"31",3,1,17,7,1,2,3277447,"2023-11-17T00:00:00.000Z",1,FALSE,23,3547256,"F",1,1,"Atlanta Hawks","Saddiq Bey",1,24,25,18,8,27.9
3,0,2,8,3,12,4,3,2,"24",0,3,13,2,3,3,3277447,"2023-11-17T00:00:00.000Z",1,FALSE,23,53,"G",1,1,"Atlanta Hawks","Bogdan Bogdanovic",3,15,18,16,5,25.9
0,0,0,0,0,0,0,0,0,"00",0,0,0,0,0,0,3277447,"2023-11-17T00:00:00.000Z",1,FALSE,23,666564,"F",1,1,"Atlanta Hawks","Bruno Fernando",0,0,0,0,0,0
0,0,0,0,0,0,0,0,0,"00",0,0,0,0,0,0,3277447,"2023-11-17T00:00:00.000Z",1,FALSE,23,3547297,"G",1,1,"Atlanta Hawks","Trent Forrest",0,0,0,0,0,0
0,0,0,0,0,0,0,0,0,"00",0,0,0,0,0,0,3277447,"2023-11-17T00:00:00.000Z",1,FALSE,23,38017689,"F",1,1,"Atlanta Hawks","AJ Griffin",0,0,0,0,0,0
0,0,0,0,0,0,0,0,0,"00",0,0,0,0,0,0,3277447,"2023-11-17T00:00:00.000Z",1,FALSE,23,666754,"G",1,1,"Atlanta Hawks","Garrison Mathews",0,0,0,0,0,0
0,0,0,2,0,2,0,4,2,"11",0,2,2,0,0,0,3277447,"2023-11-17T00:00:00.000Z",1,FALSE,23,301,"G-F",1,1,"Atlanta Hawks","Wesley Matthews",0,2,2,2,0,2
0,0,0,0,0,0,0,0,0,"00",0,0,0,0,0,0,3277447,"2023-11-17T00:00:00.000Z",1,FALSE,23,319,"G",1,1,"Atlanta Hawks","Patty Mills",0,0,0,0,0,0
0,0,3,2,1,6,2,0,0,"19",2,3,5,5,0,1,3277447,"2023-11-17T00:00:00.000Z",1,FALSE,23,3547244,"F-C",1,1,"Atlanta Hawks","Onyeka Okongwu",0,10,10,5,5,10
0,0,0,0,0,0,0,0,0,"00",0,0,0,0,0,0,3277447,"2023-11-17T00:00:00.000Z",1,FALSE,23,56677838,"G",1,1,"Atlanta Hawks","Kobe Bufkin",0,0,0,0,0,0
0,0,0,0,0,0,0,0,0,"00",0,0,0,0,0,0,3277447,"2023-11-17T00:00:00.000Z",1,FALSE,23,56677806,"F",1,1,"Atlanta Hawks","Mouhamed Gueye",0,0,0,0,0,0
0,0,0,0,0,0,0,0,0,"00",0,0,0,0,0,0,3277447,"2023-11-17T00:00:00.000Z",1,FALSE,23,56677855,"G",1,1,"Atlanta Hawks","Seth Lundy",0,0,0,0,0,0
0,0,0,0,0,0,0,0,0,"00",0,0,0,0,0,0,3277447,"2023-11-17T00:00:00.000Z",1,FALSE,23,56677875,"F",1,1,"Atlanta Hawks","Miles Norris",0,0,0,0,0,0
3,1,3,2,2,4,2,0,0,"21",4,4,6,7,1,1,3277447,"2023-11-17T00:00:00.000Z",1,FALSE,23,108,"F",23,23,"Philadelphia 76ers","Robert Covington",2,13,16,9,10,23.9
3,0,9,5,3,20,12,2,2,"38",1,1,29,10,1,1,3277447,"2023-11-17T00:00:00.000Z",1,FALSE,23,200,"F",23,23,"Philadelphia 76ers","Tobias Harris",1,39,42,32,13,47.5
8,1,5,3,1,19,10,11,11,"37",2,3,32,7,2,4,3277447,"2023-11-17T00:00:00.000Z",1,FALSE,23,145,"F-C",23,23,"Philadelphia 76ers","Joel Embiid",3,39,47,40,15,57.4
5,1,3,7,3,13,5,2,1,"36",1,2,14,4,1,3,3277447,"2023-11-17T00:00:00.000Z",1,FALSE,23,313,"G",23,23,"Philadelphia 76ers","De'Anthony Melton",2,18,23,19,9,29.3
8,0,4,6,3,13,5,6,6,"40",0,1,19,4,2,2,3277447,"2023-11-17T00:00:00.000Z",1,FALSE,23,3547254,"G",23,23,"Philadelphia 76ers","Tyrese Maxey",2,23,31,27,12,39.8
0,0,0,0,0,0,0,0,0,"00",0,0,0,0,0,0,3277447,"2023-11-17T00:00:00.000Z",1,FALSE,23,28,"C",23,23,"Philadelphia 76ers","Mo Bamba",0,0,0,0,0,0
1,0,2,1,0,1,0,2,2,"14",0,3,2,2,0,0,3277447,"2023-11-17T00:00:00.000Z",1,FALSE,23,45,"G",23,23,"Philadelphia 76ers","Patrick Beverley",0,4,5,3,3,5.9
1,0,2,4,1,8,5,3,3,"18",1,1,14,3,0,1,3277447,"2023-11-17T00:00:00.000Z",1,FALSE,23,2175,"",23,23,"Philadelphia 76ers","Danuel House Jr.",0,17,18,15,4,18.1
0,0,0,0,0,0,0,0,0,"00",0,0,0,0,0,0,3277447,"2023-11-17T00:00:00.000Z",1,FALSE,23,260,"G-F",23,23,"Philadelphia 76ers","Furkan Korkmaz",0,0,0,0,0,0
0,0,0,0,0,0,0,0,0,"00",0,0,0,0,0,0,3277447,"2023-11-17T00:00:00.000Z",1,FALSE,23,3547294,"F",23,23,"Philadelphia 76ers","Kenyon Martin Jr.",0,0,0,0,0,0
0,0,1,0,0,0,0,0,0,"02",0,1,0,1,0,0,3277447,"2023-11-17T00:00:00.000Z",1,FALSE,23,328,"F",23,23,"Philadelphia 76ers","Marcus Morris",0,1,1,0,1,1.2
0,0,1,0,0,3,1,0,0,"12",1,1,2,2,0,0,3277447,"2023-11-17T00:00:00.000Z",1,FALSE,23,3547270,"F",23,23,"Philadelphia 76ers","Paul Reed",0,4,4,2,2,4.4
2,2,0,2,0,7,3,2,2,"22",3,3,8,3,2,3,3277447,"2023-11-17T00:00:00.000Z",1,FALSE,23,17896025,"G",23,23,"Philadelphia 76ers","Jaden Springer",4,11,13,10,5,23.6
0,0,0,0,0,0,0,0,0,"00",0,0,0,0,0,0,3277447,"2023-11-17T00:00:00.000Z",1,FALSE,23,33,"F-G",23,23,"Philadelphia 76ers","Nicolas Batum",0,0,0,0,0,0
0,0,0,0,0,0,0,0,0,"00",0,0,0,0,0,0,3277447,"2023-11-17T00:00:00.000Z",1,FALSE,23,56913527,"G",23,23,"Philadelphia 76ers","Ricky Council IV",0,0,0,0,0,0
0,0,0,0,0,0,0,0,0,"00",0,0,0,0,0,0,3277447,"2023-11-17T00:00:00.000Z",1,FALSE,23,360,"F",23,23,"Philadelphia 76ers","Kelly Oubre Jr.",0,0,0,0,0,0
0,0,0,0,0,0,0,0,0,"00",0,0,0,0,0,0,3277447,"2023-11-17T00:00:00.000Z",1,FALSE,23,17554001,"G",23,23,"Philadelphia 76ers","Javonte Smart",0,0,0,0,0,0
0,0,0,0,0,0,0,0,0,"00",0,0,0,0,0,0,3277447,"2023-11-17T00:00:00.000Z",1,FALSE,23,56677788,"G",23,23,"Philadelphia 76ers","Terquavion Smith",0,0,0,0,0,0
3,0,4,1,1,20,10,4,2,"36",0,1,23,4,1,3,3277451,"2023-11-17T00:00:00.000Z",5,FALSE,22,125,"G",5,5,"Chicago Bulls","DeMar DeRozan",1,27,30,26,7,32.3
0,2,1,5,4,6,5,4,4,"23",0,4,18,1,2,1,3277451,"2023-11-17T00:00:00.000Z",5,FALSE,22,89,"G",5,5,"Chicago Bulls","Alex Caruso",4,19,19,18,1,30.2
6,0,7,3,0,16,4,2,2,"30",3,4,10,10,0,1,3277451,"2023-11-17T00:00:00.000Z",5,FALSE,22,460,"C",5,5,"Chicago Bulls","Nikola Vucevic",0,20,26,16,16,30
3,0,6,11,4,20,12,7,6,"41",0,4,34,6,2,3,3277451,"2023-11-17T00:00:00.000Z",5,FALSE,22,268,"G",5,5,"Chicago Bulls","Zach LaVine",2,40,43,37,9,48.7
4,0,1,3,0,6,2,1,0,"30",0,2,4,1,0,2,3277451,"2023-11-17T00:00:00.000Z",5,FALSE,22,666956,"G",5,5,"Chicago Bulls","Coby White",0,5,9,8,5,9.2
1,0,1,0,0,0,0,0,0,"10",0,0,0,1,0,0,3277451,"2023-11-17T00:00:00.000Z",5,FALSE,22,87,"G",5,5,"Chicago Bulls","Jevon Carter",0,1,2,1,2,2.7
0,0,1,3,1,3,1,0,0,"26",0,3,3,1,1,1,3277451,"2023-11-17T00:00:00.000Z",5,FALSE,22,110,"F",5,5,"Chicago Bulls","Torrey Craig",1,4,4,3,1,6.2
1,0,2,1,0,3,0,0,0,"13",0,1,0,2,0,0,3277451,"2023-11-17T00:00:00.000Z",5,FALSE,22,17895983,"G",5,5,"Chicago Bulls","Ayo Dosunmu",0,2,3,1,3,3.9
0,1,4,1,0,2,1,4,3,"18",2,1,5,6,3,2,3277451,"2023-11-17T00:00:00.000Z",5,FALSE,22,137,"C",5,5,"Chicago Bulls","Andre Drummond",4,11,11,5,6,22.2
0,0,0,0,0,0,0,0,0,"00",0,0,0,0,0,0,3277451,"2023-11-17T00:00:00.000Z",5,FALSE,22,56677857,"F",5,5,"Chicago Bulls","Julian Phillips",0,0,0,0,0,0
0,0,0,0,0,0,0,0,0,"00",0,0,0,0,0,0,3277451,"2023-11-17T00:00:00.000Z",5,FALSE,22,17896116,"G",5,5,"Chicago Bulls","Terry Taylor",0,0,0,0,0,0
1,0,2,1,0,3,0,0,0,"13",0,1,0,2,1,3,3277451,"2023-11-17T00:00:00.000Z",5,FALSE,22,3547248,"F",5,5,"Chicago Bulls","Patrick Williams",1,2,3,1,3,3.9
0,0,0,0,0,0,0,0,0,"00",0,0,0,0,0,0,3277451,"2023-11-17T00:00:00.000Z",5,FALSE,22,27,"G",5,5,"Chicago Bulls","Lonzo Ball",0,0,0,0,0,0
0,0,0,0,0,0,0,0,0,"00",0,0,0,0,0,0,3277451,"2023-11-17T00:00:00.000Z",5,FALSE,22,56677874,"F",5,5,"Chicago Bulls","Onuralp Bitim",0,0,0,0,0,0
0,0,0,0,0,0,0,0,0,"00",0,0,0,0,0,0,3277451,"2023-11-17T00:00:00.000Z",5,FALSE,22,45969255,"F",5,5,"Chicago Bulls","Justin Lewis",0,0,0,0,0,0
0,0,0,0,0,0,0,0,0,"00",0,0,0,0,0,0,3277451,"2023-11-17T00:00:00.000Z",5,FALSE,22,56677860,"F",5,5,"Chicago Bulls","Adama Sanogo",0,0,0,0,0,0
0,0,0,0,0,0,0,0,0,"00",0,0,0,0,0,0,3277451,"2023-11-17T00:00:00.000Z",5,FALSE,22,38017719,"F",5,5,"Chicago Bulls","Dalen Terry",0,0,0,0,0,0
2,0,4,8,2,18,9,2,1,"35",0,2,21,4,2,2,3277451,"2023-11-17T00:00:00.000Z",5,FALSE,22,17896026,"F",22,22,"Orlando Magic","Franz Wagner",2,25,27,23,6,32.8
0,0,0,0,0,0,0,0,0,"00",0,0,0,0,0,0,3277451,"2023-11-17T00:00:00.000Z",5,FALSE,22,17553983,"G",22,22,"Orlando Magic","Trevelin Queen",0,0,0,0,0,0
0,0,0,0,0,0,0,0,0,"00",0,0,0,0,0,0,3277451,"2023-11-17T00:00:00.000Z",5,FALSE,22,56677839,"G",22,22,"Orlando Magic","Jett Howard",0,0,0,0,0,0
0,0,0,0,0,0,0,0,0,"00",0,0,0,0,0,0,3277451,"2023-11-17T00:00:00.000Z",5,FALSE,22,17896073,"G",22,22,"Orlando Magic","Jalen Suggs",0,0,0,0,0,0
0,0,0,0,0,0,0,0,0,"00",0,0,0,0,0,0,3277451,"2023-11-17T00:00:00.000Z",5,FALSE,22,85,"F",22,22,"Orlando Magic","Wendell Carter Jr.",0,0,0,0,0,0
0,0,0,0,0,0,0,0,0,"00",0,0,0,0,0,0,3277451,"2023-11-17T00:00:00.000Z",5,FALSE,22,165,"G",22,22,"Orlando Magic","Markelle Fultz",0,0,0,0,0,0
0,0,0,0,0,0,0,0,0,"00",0,0,0,0,0,0,3277451,"2023-11-17T00:00:00.000Z",5,FALSE,22,38017607,"G",22,22,"Orlando Magic","Kevon Harris",0,0,0,0,0,0
4,1,5,1,0,14,6,4,1,"32",3,3,13,8,0,7,3277451,"2023-11-17T00:00:00.000Z",5,FALSE,22,38017683,"F",22,22,"Orlando Magic","Paolo Banchero",1,21,25,17,12,24.6
0,2,4,0,0,1,0,4,2,"21",0,4,2,4,1,1,3277451,"2023-11-17T00:00:00.000Z",5,FALSE,22,666442,"C",22,22,"Orlando Magic","Goga Bitadze",3,6,6,2,4,14.8
2,2,4,7,3,10,5,2,2,"29",2,3,15,6,1,0,3277451,"2023-11-17T00:00:00.000Z",5,FALSE,22,196,"G",22,22,"Orlando Magic","Gary Harris",3,21,23,17,8,34.2
0,0,0,0,0,2,1,1,0,"11",0,0,2,0,0,3,3277451,"2023-11-17T00:00:00.000Z",5,FALSE,22,56677827,"G",22,22,"Orlando Magic","Anthony Black",0,2,2,2,0,-1
5,0,1,7,2,8,3,0,0,"26",0,1,8,1,1,1,3277451,"2023-11-17T00:00:00.000Z",5,FALSE,22,226,"F",22,22,"Orlando Magic","Joe Ingles",1,9,14,13,6,18.7
7,0,6,5,1,12,3,4,4,"37",2,4,11,8,1,2,3277451,"2023-11-17T00:00:00.000Z",5,FALSE,22,3547251,"G",22,22,"Orlando Magic","Cole Anthony",1,19,26,18,15,32.1
1,1,6,4,2,8,6,4,4,"20",3,2,18,9,1,1,3277451,"2023-11-17T00:00:00.000Z",5,FALSE,22,229,"F",22,22,"Orlando Magic","Jonathan Isaac",2,27,28,19,10,35.3
3,1,4,1,0,5,4,2,2,"23",0,3,10,4,0,0,3277451,"2023-11-17T00:00:00.000Z",5,FALSE,22,462,"C",22,22,"Orlando Magic","Moritz Wagner",1,14,17,13,7,22.3
0,0,2,1,1,1,1,0,0,"06",0,0,3,2,0,0,3277451,"2023-11-17T00:00:00.000Z",5,FALSE,22,38017724,"G",22,22,"Orlando Magic","Caleb Houstan",0,5,5,3,2,5.4
0,0,0,0,0,0,0,0,0,"00",0,0,0,0,0,0,3277451,"2023-11-17T00:00:00.000Z",5,FALSE,22,666818,"F",22,22,"Orlando Magic","Chuma Okeke",0,0,0,0,0,0
0,0,0,0,0,0,0,0,0,"00",0,0,0,0,0,0,3277451,"2023-11-17T00:00:00.000Z",5,FALSE,22,666885,"F",22,22,"Orlando Magic","Admiral Schofield",0,0,0,0,0,0
8,0,2,4,2,19,9,1,1,"38",1,3,21,3,1,2,3277452,"2023-11-17T00:00:00.000Z",19,FALSE,8,227,"F",19,19,"New Orleans Pelicans","Brandon Ingram",1,24,32,29,11,37.6
6,2,4,1,1,17,10,11,5,"33",0,3,26,4,0,4,3277452,"2023-11-17T00:00:00.000Z",19,FALSE,8,666969,"F",19,19,"New Orleans Pelicans","Zion Williamson",2,30,36,32,10,41.8
3,1,6,3,1,18,10,3,1,"34",2,4,22,8,0,0,3277452,"2023-11-17T00:00:00.000Z",19,FALSE,8,455,"C",19,19,"New Orleans Pelicans","Jonas Valanciunas",1,30,33,25,11,39.1
4,1,5,1,0,8,3,2,2,"37",0,2,8,5,3,1,3277452,"2023-11-17T00:00:00.000Z",19,FALSE,8,17896024,"F",19,19,"New Orleans Pelicans","Herbert Jones",4,13,17,12,9,31
7,0,7,1,0,6,4,3,2,"33",1,1,10,8,3,0,3277452,"2023-11-17T00:00:00.000Z",19,FALSE,8,38017677,"G",19,19,"New Orleans Pelicans","Dyson Daniels",3,18,25,17,15,39.1
0,0,0,0,0,0,0,0,0,"00",0,0,0,0,0,0,3277452,"2023-11-17T00:00:00.000Z",19,FALSE,8,17896097,"G",19,19,"New Orleans Pelicans","Jose Alvarado",0,0,0,0,0,0
4,0,5,3,1,7,3,0,0,"26",0,0,7,5,0,0,3277452,"2023-11-17T00:00:00.000Z",19,FALSE,8,56677837,"G",19,19,"New Orleans Pelicans","Jordan Hawkins",0,12,16,11,9,19
0,0,0,0,0,0,0,0,0,"00",0,0,0,0,0,0,3277452,"2023-11-17T00:00:00.000Z",19,FALSE,8,3547260,"G",19,19,"New Orleans Pelicans","Kira Lewis Jr.",0,0,0,0,0,0
1,0,5,5,4,6,4,0,0,"18",0,0,12,5,1,2,3277452,"2023-11-17T00:00:00.000Z",19,FALSE,8,3547293,"F",19,19,"New Orleans Pelicans","Naji Marshall",1,17,18,13,6,20.5
0,0,0,0,0,0,0,0,0,"01",0,0,0,0,0,0,3277452,"2023-11-17T00:00:00.000Z",19,FALSE,8,17896021,"F",19,19,"New Orleans Pelicans","Jeremiah Robinson-Earl",0,0,0,0,0,0
0,0,0,5,3,7,3,1,0,"19",0,0,9,0,0,0,3277452,"2023-11-17T00:00:00.000Z",19,FALSE,8,17896017,"F",19,19,"New Orleans Pelicans","Matt Ryan",0,9,9,9,0,9
0,0,0,0,0,0,0,0,0,"00",0,0,0,0,0,0,3277452,"2023-11-17T00:00:00.000Z",19,FALSE,8,250,"C",8,8,"Denver Nuggets","DeAndre Jordan",0,0,0,0,0,0
0,0,0,0,0,0,0,0,0,"00",0,0,0,0,0,0,3277452,"2023-11-17T00:00:00.000Z",19,FALSE,8,17896007,"G",8,8,"Denver Nuggets","Braxton Key",0,0,0,0,0,0
3,0,7,5,3,19,11,1,0,"30",2,1,25,9,0,0,3277452,"2023-11-17T00:00:00.000Z",19,FALSE,8,38017709,"G",8,8,"Denver Nuggets","Christian Braun",0,34,37,28,12,40.3
0,0,0,0,0,0,0,0,0,"00",0,0,0,0,0,0,3277452,"2023-11-17T00:00:00.000Z",19,FALSE,8,38017727,"G",8,8,"Denver Nuggets","Collin Gillespie",0,0,0,0,0,0
0,0,0,0,0,0,0,0,0,"00",0,0,0,0,0,0,3277452,"2023-11-17T00:00:00.000Z",19,FALSE,8,215,"F-G",8,8,"Denver Nuggets","Justin Holiday",0,0,0,0,0,0
0,0,0,0,0,1,0,0,0,"04",0,2,0,0,0,2,3277452,"2023-11-17T00:00:00.000Z",19,FALSE,8,3547268,"F-C",8,8,"Denver Nuggets","Zeke Nnaji",0,0,0,0,0,-2
1,0,1,2,0,2,0,0,0,"10",0,2,0,1,0,1,3277452,"2023-11-17T00:00:00.000Z",19,FALSE,8,56677582,"G",8,8,"Denver Nuggets","Jalen Pickett",0,1,2,1,2,1.7
1,0,0,3,0,4,1,0,0,"09",0,2,2,0,1,0,3277452,"2023-11-17T00:00:00.000Z",19,FALSE,8,56677776,"G",8,8,"Denver Nuggets","Julian Strawther",1,2,3,3,1,6.5
1,0,1,1,0,3,1,2,1,"11",2,2,3,3,0,2,3277452,"2023-11-17T00:00:00.000Z",19,FALSE,8,38017721,"G",8,8,"Denver Nuggets","Peyton Watson",0,6,7,4,4,6.1
0,1,1,0,0,0,0,0,0,"01",0,0,0,1,0,0,3277452,"2023-11-17T00:00:00.000Z",19,FALSE,8,491,"C",19,19,"New Orleans Pelicans","Cody Zeller",1,1,1,0,1,4.2
0,0,0,0,0,0,0,0,0,"00",0,0,0,0,0,0,3277452,"2023-11-17T00:00:00.000Z",19,FALSE,8,38017663,"F",19,19,"New Orleans Pelicans","E.J. Liddell",0,0,0,0,0,0
0,0,0,0,0,0,0,0,0,"00",0,0,0,0,0,0,3277452,"2023-11-17T00:00:00.000Z",19,FALSE,8,303,"G",19,19,"New Orleans Pelicans","CJ McCollum",0,0,0,0,0,0
0,0,0,0,0,0,0,0,0,"00",0,0,0,0,0,0,3277452,"2023-11-17T00:00:00.000Z",19,FALSE,8,18677986,"F",19,19,"New Orleans Pelicans","Trey Murphy III",0,0,0,0,0,0
0,0,0,0,0,0,0,0,0,"00",0,0,0,0,0,0,3277452,"2023-11-17T00:00:00.000Z",19,FALSE,8,340,"F",19,19,"New Orleans Pelicans","Larry Nance Jr.",0,0,0,0,0,0
0,0,0,0,0,0,0,0,0,"00",0,0,0,0,0,0,3277452,"2023-11-17T00:00:00.000Z",19,FALSE,8,38017726,"G",19,19,"New Orleans Pelicans","Dereon Seabron",0,0,0,0,0,0
0,0,8,6,2,14,8,1,0,"33",3,3,18,11,0,0,3277452,"2023-11-17T00:00:00.000Z",19,FALSE,8,375,"F",8,8,"Denver Nuggets","Michael Porter Jr.",0,29,29,18,11,31.2
2,0,7,4,0,14,7,3,0,"39",1,4,14,8,2,0,3277452,"2023-11-17T00:00:00.000Z",19,FALSE,8,177,"F",8,8,"Denver Nuggets","Aaron Gordon",2,22,24,16,10,32.6
18,1,14,8,1,20,10,5,5,"36",2,2,26,16,0,4,3277452,"2023-11-17T00:00:00.000Z",19,FALSE,8,246,"C",8,8,"Denver Nuggets","Nikola Jokic",1,42,60,44,34,71.2
8,2,1,4,2,7,3,0,0,"35",0,0,8,1,1,0,3277452,"2023-11-17T00:00:00.000Z",19,FALSE,8,81,"G",8,8,"Denver Nuggets","Kentavious Caldwell-Pope",3,9,17,16,9,30.2
3,0,1,7,2,12,6,0,0,"33",1,2,14,2,0,4,3277452,"2023-11-17T00:00:00.000Z",19,FALSE,8,236,"G",8,8,"Denver Nuggets","Reggie Jackson",0,16,19,17,5,16.9
0,0,0,0,0,0,0,0,0,"00",0,0,0,0,0,0,3277452,"2023-11-17T00:00:00.000Z",19,FALSE,8,666489,"F",8,8,"Denver Nuggets","Vlatko Cancar",0,0,0,0,0,0
0,0,0,0,0,0,0,0,0,"00",0,0,0,0,0,0,3277452,"2023-11-17T00:00:00.000Z",19,FALSE,8,17896103,"F-C",8,8,"Denver Nuggets","Jay Huff",0,0,0,0,0,0
0,0,0,0,0,0,0,0,0,"00",0,0,0,0,0,0,3277452,"2023-11-17T00:00:00.000Z",19,FALSE,8,335,"G",8,8,"Denver Nuggets","Jamal Murray",0,0,0,0,0,0
0,0,0,0,0,0,0,0,0,"00",0,0,0,0,0,0,3277452,"2023-11-17T00:00:00.000Z",19,FALSE,8,56677871,"F",8,8,"Denver Nuggets","Hunter Tyson",0,0,0,0,0,0
0,0,0,0,0,0,0,0,0,"00",0,0,0,0,0,0,3277453,"2023-11-17T00:00:00.000Z",29,FALSE,24,666451,"C",24,24,"Phoenix Suns","Bol Bol",0,0,0,0,0,0
0,0,4,1,1,5,5,0,0,"21",0,2,11,4,0,0,3277453,"2023-11-17T00:00:00.000Z",29,FALSE,24,147,"F",24,24,"Phoenix Suns","Drew Eubanks",0,15,15,11,4,15.8
4,0,2,4,1,6,1,0,0,"14",0,2,3,2,1,0,3277453,"2023-11-17T00:00:00.000Z",29,FALSE,24,18678058,"",24,24,"Phoenix Suns","Jordan Goodwin",1,5,9,7,6,14.4
0,0,0,0,0,0,0,0,0,"00",0,0,0,0,0,0,3277453,"2023-11-17T00:00:00.000Z",29,FALSE,24,3547298,"G",24,24,"Phoenix Suns","Saben Lee",0,0,0,0,0,0
1,0,1,2,1,3,2,0,0,"11",0,0,5,1,0,0,3277453,"2023-11-17T00:00:00.000Z",29,FALSE,24,666729,"F",24,24,"Phoenix Suns","Nassir Little",0,6,7,6,2,7.7
0,0,0,0,0,0,0,0,0,"00",0,0,0,0,0,0,3277453,"2023-11-17T00:00:00.000Z",29,FALSE,24,314,"F",24,24,"Phoenix Suns","Chimezie Metu",0,0,0,0,0,0
0,0,0,0,0,1,0,2,1,"13",1,2,1,1,0,1,3277453,"2023-11-17T00:00:00.000Z",29,FALSE,24,356,"G",24,24,"Phoenix Suns","Josh Okogie",0,2,2,1,1,1.2
0,0,1,2,1,3,1,0,0,"10",1,1,3,2,0,0,3277453,"2023-11-17T00:00:00.000Z",29,FALSE,24,470,"G",24,24,"Phoenix Suns","Yuta Watanabe",0,5,5,3,2,5.4
0,0,0,0,0,0,0,0,0,"00",0,0,0,0,0,0,3277453,"2023-11-17T00:00:00.000Z",29,FALSE,24,37,"G",24,24,"Phoenix Suns","Bradley Beal",0,0,0,0,0,0
0,0,0,0,0,0,0,0,0,"00",0,0,0,0,0,0,3277453,"2023-11-17T00:00:00.000Z",29,FALSE,24,272,"G",24,24,"Phoenix Suns","Damion Lee",0,0,0,0,0,0
0,3,3,2,2,4,3,0,0,"25",2,3,8,5,0,0,3277453,"2023-11-17T00:00:00.000Z",29,FALSE,24,38017620,"G",29,29,"Utah Jazz","Ochai Agbaji",3,13,13,8,5,23
1,2,10,2,1,10,5,6,4,"35",4,6,15,14,0,0,3277453,"2023-11-17T00:00:00.000Z",29,FALSE,24,101,"F-C",29,29,"Utah Jazz","John Collins",2,29,30,16,15,39.3
0,2,2,4,1,12,5,12,10,"40",0,1,21,2,1,0,3277453,"2023-11-17T00:00:00.000Z",29,FALSE,24,297,"F",29,29,"Utah Jazz","Lauri Markkanen",3,23,23,21,2,32.4
5,0,2,10,5,26,14,4,4,"36",1,0,37,3,1,0,3277453,"2023-11-17T00:00:00.000Z",29,FALSE,24,100,"G",29,29,"Utah Jazz","Jordan Clarkson",1,40,45,42,8,51.1
6,0,3,6,3,11,5,3,2,"29",0,2,15,3,1,3,3277453,"2023-11-17T00:00:00.000Z",29,FALSE,24,56677834,"G",29,29,"Utah Jazz","Keyonte George",1,18,24,21,9,27.6
0,0,0,0,0,0,0,0,0,"01",0,0,0,0,0,0,3277453,"2023-11-17T00:00:00.000Z",29,FALSE,24,139,"G",29,29,"Utah Jazz","Kris Dunn",0,0,0,0,0,0
0,0,1,4,2,5,3,0,0,"15",0,2,8,1,0,1,3277453,"2023-11-17T00:00:00.000Z",29,FALSE,24,38017739,"F",29,29,"Utah Jazz","Simone Fontecchio",0,9,9,8,1,8.2
0,0,0,0,0,0,0,0,0,"00",0,0,0,0,0,0,3277453,"2023-11-17T00:00:00.000Z",29,FALSE,24,56677824,"F",29,29,"Utah Jazz","Taylor Hendricks",0,0,0,0,0,0
4,2,2,2,0,8,3,2,2,"20",2,3,8,4,0,0,3277453,"2023-11-17T00:00:00.000Z",29,FALSE,24,413,"G",29,29,"Utah Jazz","Collin Sexton",2,12,16,12,8,24.8
0,0,0,0,0,0,0,0,0,"00",0,0,0,0,0,0,3277453,"2023-11-17T00:00:00.000Z",29,FALSE,24,11891374,"C",29,29,"Utah Jazz","Omer Yurtseven",0,0,0,0,0,0
0,0,0,0,0,0,0,0,0,"00",0,0,0,0,0,0,3277453,"2023-11-17T00:00:00.000Z",29,FALSE,24,17896023,"G",29,29,"Utah Jazz","Josh Christopher",0,0,0,0,0,0
0,0,0,0,0,0,0,0,0,"00",0,0,0,0,0,0,3277453,"2023-11-17T00:00:00.000Z",29,FALSE,24,38017630,"G",29,29,"Utah Jazz","Johnny Juzang",0,0,0,0,0,0
0,0,0,0,0,0,0,0,0,"00",0,0,0,0,0,0,3277453,"2023-11-17T00:00:00.000Z",29,FALSE,24,38017705,"C",29,29,"Utah Jazz","Walker Kessler",0,0,0,0,0,0
0,0,0,0,0,0,0,0,0,"00",0,0,0,0,0,0,3277453,"2023-11-17T00:00:00.000Z",29,FALSE,24,19465584,"F",29,29,"Utah Jazz","Micah Potter",0,0,0,0,0,0
1,1,2,8,4,12,5,0,0,"33",0,2,14,2,1,1,3277453,"2023-11-17T00:00:00.000Z",29,FALSE,24,178,"G",24,24,"Phoenix Suns","Eric Gordon",2,16,17,15,3,22.9
9,0,9,8,6,22,15,2,2,"33",0,1,38,9,0,1,3277453,"2023-11-17T00:00:00.000Z",29,FALSE,24,140,"F",24,24,"Phoenix Suns","Kevin Durant",0,47,56,47,18,61.3
4,0,5,1,0,7,4,7,7,"23",2,4,15,7,1,4,3277453,"2023-11-17T00:00:00.000Z",29,FALSE,24,349,"C",24,24,"Phoenix Suns","Jusuf Nurkic",1,22,26,19,11,28.4
1,0,1,4,2,8,3,2,2,"30",0,1,10,1,0,0,3277453,"2023-11-17T00:00:00.000Z",29,FALSE,24,8,"G",24,24,"Phoenix Suns","Grayson Allen",0,11,12,11,2,12.7
15,0,4,3,2,15,7,10,8,"32",0,3,24,4,0,1,3277453,"2023-11-17T00:00:00.000Z",29,FALSE,24,57,"G",24,24,"Phoenix Suns","Devin Booker",0,28,43,39,19,50.3
0,0,0,0,0,0,0,0,0,"00",0,0,0,0,0,0,3277453,"2023-11-17T00:00:00.000Z",29,FALSE,24,3547095,"C-F",24,24,"Phoenix Suns","Udoka Azubuike",0,0,0,0,0,0
0,3,2,0,0,4,2,3,3,"20",1,4,7,3,2,0,3277453,"2023-11-17T00:00:00.000Z",29,FALSE,24,32,"F",24,24,"Phoenix Suns","Keita Bates-Diop",5,10,10,7,3,25.6
4,1,3,4,1,5,2,4,4,"19",0,4,9,3,0,3,3277453,"2023-11-17T00:00:00.000Z",29,FALSE,24,666650,"G",29,29,"Utah Jazz","Talen Horton-Tucker",1,12,16,13,7,18.6
7,0,3,2,1,4,3,0,0,"20",1,2,7,4,0,1,3277453,"2023-11-17T00:00:00.000Z",29,FALSE,24,358,"F",29,29,"Utah Jazz","Kelly Olynyk",0,11,18,14,11,21.3
0,0,0,0,0,0,0,0,0,"00",0,0,0,0,0,0,3277453,"2023-11-17T00:00:00.000Z",29,FALSE,24,666881,"F",29,29,"Utah Jazz","Luka Samanic",0,0,0,0,0,0
0,0,0,0,0,0,0,0,0,"00",0,0,0,0,0,0,3277453,"2023-11-17T00:00:00.000Z",29,FALSE,24,56677842,"F",29,29,"Utah Jazz","Brice Sensabaugh",0,0,0,0,0,0
0,0,0,0,0,0,0,0,0,"00",0,0,0,0,0,0,3277454,"2023-11-17T00:00:00.000Z",25,FALSE,14,56677868,"G",14,14,"Los Angeles Lakers","D'Moi Hodge",0,0,0,0,0,0
0,0,0,0,0,0,0,0,0,"00",0,0,0,0,0,0,3277454,"2023-11-17T00:00:00.000Z",25,FALSE,14,457,"F",14,14,"Los Angeles Lakers","Jarred Vanderbilt",0,0,0,0,0,0
0,1,4,6,1,8,3,5,3,"36",2,3,10,6,2,1,3277454,"2023-11-17T00:00:00.000Z",25,FALSE,14,56677850,"F",25,25,"Portland Trail Blazers","Toumani Camara",3,16,16,10,6,25.2
3,0,4,9,4,20,8,4,4,"40",0,0,24,4,1,1,3277454,"2023-11-17T00:00:00.000Z",25,FALSE,14,182,"F",25,25,"Portland Trail Blazers","Jerami Grant",1,28,31,27,7,35.3
2,0,5,0,0,14,8,2,1,"38",7,4,17,12,2,4,3277454,"2023-11-17T00:00:00.000Z",25,FALSE,14,22,"C",25,25,"Portland Trail Blazers","Deandre Ayton",2,29,31,19,14,36.4
2,1,7,5,1,17,7,2,2,"38",2,4,17,9,1,10,3277454,"2023-11-17T00:00:00.000Z",25,FALSE,14,38017690,"G",25,25,"Portland Trail Blazers","Shaedon Sharpe",2,26,28,19,11,26.8
8,0,2,7,3,14,6,0,0,"25",3,3,15,5,2,0,3277454,"2023-11-17T00:00:00.000Z",25,FALSE,14,3547289,"G",25,25,"Portland Trail Blazers","Skylar Mays",2,20,28,23,13,39
0,0,0,0,0,0,0,0,0,"01",0,0,0,0,0,0,3277454,"2023-11-17T00:00:00.000Z",25,FALSE,14,44477062,"G",25,25,"Portland Trail Blazers","Jamaree Bouyea",0,0,0,0,0,0
0,0,0,0,0,0,0,0,0,"00",0,0,0,0,0,0,3277454,"2023-11-17T00:00:00.000Z",25,FALSE,14,666476,"C",25,25,"Portland Trail Blazers","Moses Brown",0,0,0,0,0,0
0,0,0,0,0,0,0,0,0,"05",0,0,0,0,0,0,3277454,"2023-11-17T00:00:00.000Z",25,FALSE,14,47957121,"F",25,25,"Portland Trail Blazers","Justin Minaya",0,0,0,0,0,0
0,0,0,2,0,2,0,0,0,"05",1,1,0,1,1,0,3277454,"2023-11-17T00:00:00.000Z",25,FALSE,14,56677791,"F",25,25,"Portland Trail Blazers","Kris Murray",1,1,1,0,1,4.2
0,0,1,4,0,5,0,0,0,"10",1,1,0,2,0,0,3277454,"2023-11-17T00:00:00.000Z",25,FALSE,14,56783340,"C",25,25,"Portland Trail Blazers","Duop Reath",0,2,2,0,2,2.4
1,0,3,2,1,3,2,0,0,"24",1,1,5,4,2,2,3277454,"2023-11-17T00:00:00.000Z",25,FALSE,14,666923,"G-F",25,25,"Portland Trail Blazers","Matisse Thybulle",2,9,10,6,5,15.3
0,0,0,0,0,0,0,0,0,"00",0,0,0,0,0,0,3277454,"2023-11-17T00:00:00.000Z",25,FALSE,14,17896120,"F",25,25,"Portland Trail Blazers","Ish Wainright",0,0,0,0,0,0
1,0,3,2,0,6,2,5,3,"18",2,0,7,5,0,0,3277454,"2023-11-17T00:00:00.000Z",25,FALSE,14,38017711,"F",25,25,"Portland Trail Blazers","Jabari Walker",0,12,13,8,6,14.5
0,0,0,0,0,0,0,0,0,"00",0,0,0,0,0,0,3277454,"2023-11-17T00:00:00.000Z",25,FALSE,14,65,"G",25,25,"Portland Trail Blazers","Malcolm Brogdon",0,0,0,0,0,0
0,0,0,0,0,0,0,0,0,"00",0,0,0,0,0,0,3277454,"2023-11-17T00:00:00.000Z",25,FALSE,14,56677747,"G",25,25,"Portland Trail Blazers","Scoot Henderson",0,0,0,0,0,0
0,0,0,0,0,0,0,0,0,"00",0,0,0,0,0,0,3277454,"2023-11-17T00:00:00.000Z",25,FALSE,14,56677829,"G-F",25,25,"Portland Trail Blazers","Rayan Rupert",0,0,0,0,0,0
0,0,0,0,0,0,0,0,0,"00",0,0,0,0,0,0,3277454,"2023-11-17T00:00:00.000Z",25,FALSE,14,419,"G",25,25,"Portland Trail Blazers","Anfernee Simons",0,0,0,0,0,0
0,0,0,0,0,0,0,0,0,"00",0,0,0,0,0,0,3277454,"2023-11-17T00:00:00.000Z",25,FALSE,14,476,"C-F",25,25,"Portland Trail Blazers","Robert Williams III",0,0,0,0,0,0
1,1,1,2,1,4,2,4,3,"31",1,0,8,2,3,1,3277454,"2023-11-17T00:00:00.000Z",25,FALSE,14,666860,"F-G",14,14,"Los Angeles Lakers","Cameron Reddish",4,10,11,9,3,22.9
9,0,5,9,5,22,13,6,4,"34",0,3,35,5,2,3,3277454,"2023-11-17T00:00:00.000Z",25,FALSE,14,237,"F",14,14,"Los Angeles Lakers","LeBron James",2,40,49,44,14,57.5
2,5,10,1,0,19,8,1,0,"35",4,5,16,14,3,6,3277454,"2023-11-17T00:00:00.000Z",25,FALSE,14,117,"F-C",14,14,"Los Angeles Lakers","Anthony Davis",8,30,32,18,16,53.8
3,0,0,5,1,7,3,3,3,"35",1,5,10,1,2,0,3277454,"2023-11-17T00:00:00.000Z",25,FALSE,14,383,"F",14,14,"Los Angeles Lakers","Taurean Prince",2,11,14,13,4,21.7
6,0,2,7,4,10,5,1,0,"29",1,1,14,3,0,4,3277454,"2023-11-17T00:00:00.000Z",25,FALSE,14,405,"G",14,14,"Los Angeles Lakers","D'Angelo Russell",0,17,23,20,9,22.6
0,0,1,0,0,1,0,0,0,"01",0,0,0,1,0,1,3277454,"2023-11-17T00:00:00.000Z",25,FALSE,14,38017697,"G",14,14,"Los Angeles Lakers","Max Christie",0,1,1,0,1,0.2
2,0,4,2,1,5,3,0,0,"28",1,1,7,5,0,0,3277454,"2023-11-17T00:00:00.000Z",25,FALSE,14,666609,"F",14,14,"Los Angeles Lakers","Rui Hachimura",0,12,14,9,7,16
0,0,1,0,0,0,0,1,0,"08",0,0,0,1,1,0,3277454,"2023-11-17T00:00:00.000Z",25,FALSE,14,666626,"C",14,14,"Los Angeles Lakers","Jaxson Hayes",1,1,1,0,1,4.2
0,0,0,0,0,0,0,0,0,"00",0,0,0,0,0,0,3277454,"2023-11-17T00:00:00.000Z",25,FALSE,14,56677835,"G",14,14,"Los Angeles Lakers","Jalen Hood-Schifino",0,0,0,0,0,0
0,0,0,0,0,0,0,0,0,"01",0,0,0,0,0,0,3277454,"2023-11-17T00:00:00.000Z",25,FALSE,14,56677836,"F",14,14,"Los Angeles Lakers","Maxwell Lewis",0,0,0,0,0,0
4,0,1,1,0,4,1,6,5,"18",1,0,7,2,0,3,3277454,"2023-11-17T00:00:00.000Z",25,FALSE,14,17553995,"G",14,14,"Los Angeles Lakers","Austin Reaves",0,9,13,11,6,12.4
0,0,8,3,0,9,5,0,0,"20",2,1,10,10,0,0,3277454,"2023-11-17T00:00:00.000Z",25,FALSE,14,486,"F",14,14,"Los Angeles Lakers","Christian Wood",0,20,20,10,10,22
0,0,0,0,0,0,0,0,0,"00",0,0,0,0,0,0,3277454,"2023-11-17T00:00:00.000Z",25,FALSE,14,56677738,"C",14,14,"Los Angeles Lakers","Colin Castleton",0,0,0,0,0,0
0,0,0,0,0,0,0,0,0,"00",0,0,0,0,0,0,3277454,"2023-11-17T00:00:00.000Z",25,FALSE,14,56677867,"F",14,14,"Los Angeles Lakers","Alex Fudge",0,0,0,0,0,0
0,0,0,0,0,0,0,0,0,"00",0,0,0,0,0,0,3277454,"2023-11-17T00:00:00.000Z",25,FALSE,14,1603383,"G",14,14,"Los Angeles Lakers","Gabe Vincent",0,0,0,0,0,0
2,1,7,6,3,16,8,8,7,"37",1,3,26,8,5,3,3277455,"2023-11-17T00:00:00.000Z",13,FALSE,11,274,"F",13,13,"LA Clippers","Kawhi Leonard",6,34,36,28,10,53.6
3,1,7,10,4,22,8,3,3,"40",1,2,23,8,2,3,3277455,"2023-11-17T00:00:00.000Z",13,FALSE,11,172,"F",13,13,"LA Clippers","Paul George",3,31,34,26,11,43.1
2,2,4,0,0,8,6,2,0,"35",3,2,12,7,0,1,3277455,"2023-11-17T00:00:00.000Z",13,FALSE,11,493,"C",13,13,"LA Clippers","Ivica Zubac",2,19,21,14,9,28.4
3,1,5,2,0,3,0,2,1,"21",1,3,1,6,1,0,3277455,"2023-11-17T00:00:00.000Z",13,FALSE,11,666743,"G",13,13,"LA Clippers","Terance Mann",2,7,10,4,9,18.7
7,1,8,4,2,11,8,7,6,"34",1,1,24,9,0,3,3277455,"2023-11-17T00:00:00.000Z",13,FALSE,11,192,"G",13,13,"LA Clippers","James Harden",1,33,40,31,16,45.3
0,0,0,0,0,0,0,0,0,"00",0,0,0,0,0,0,3277455,"2023-11-17T00:00:00.000Z",13,FALSE,11,666511,"G",13,13,"LA Clippers","Amir Coffey",0,0,0,0,0,0
0,0,0,0,0,0,0,0,0,"00",0,0,0,0,0,0,3277455,"2023-11-17T00:00:00.000Z",13,FALSE,11,38017725,"F",13,13,"LA Clippers","Moussa Diabate",0,0,0,0,0,0
0,0,0,0,0,0,0,0,0,"00",0,0,0,0,0,0,3277455,"2023-11-17T00:00:00.000Z",13,FALSE,11,17896031,"G",13,13,"LA Clippers","Nah'Shon Hyland",0,0,0,0,0,0
3,1,2,5,2,11,3,2,2,"30",1,2,10,3,1,0,3277455,"2023-11-17T00:00:00.000Z",13,FALSE,11,380,"F-G",13,13,"LA Clippers","Norman Powell",2,13,16,13,6,24.1
0,0,3,1,0,3,1,2,0,"11",0,2,2,3,1,0,3277455,"2023-11-17T00:00:00.000Z",13,FALSE,11,439,"F",13,13,"LA Clippers","Daniel Theis",1,5,5,2,3,8.6
0,0,0,0,0,0,0,0,0,"15",0,3,0,0,0,0,3277455,"2023-11-17T00:00:00.000Z",13,FALSE,11,450,"F",13,13,"LA Clippers","PJ Tucker",0,0,0,0,0,0
2,0,3,6,2,9,2,4,2,"17",0,1,8,3,0,2,3277455,"2023-11-17T00:00:00.000Z",13,FALSE,11,472,"G",13,13,"LA Clippers","Russell Westbrook",0,11,13,10,5,12.6
0,0,0,0,0,0,0,0,0,"00",0,0,0,0,0,0,3277455,"2023-11-17T00:00:00.000Z",13,FALSE,11,17896022,"G",13,13,"LA Clippers","Brandon Boston Jr.",0,0,0,0,0,0
0,0,0,0,0,0,0,0,0,"00",0,0,0,0,0,0,3277455,"2023-11-17T00:00:00.000Z",13,FALSE,11,56677849,"F",13,13,"LA Clippers","Kobe Brown",0,0,0,0,0,0
0,0,0,0,0,0,0,0,0,"00",0,0,0,0,0,0,3277455,"2023-11-17T00:00:00.000Z",13,FALSE,11,56677856,"G",13,13,"LA Clippers","Jordan Miller",0,0,0,0,0,0
0,0,0,0,0,0,0,0,0,"00",0,0,0,0,0,0,3277455,"2023-11-17T00:00:00.000Z",13,FALSE,11,371,"F-C",13,13,"LA Clippers","Mason Plumlee",0,0,0,0,0,0
0,0,0,0,0,0,0,0,0,"00",0,0,0,0,0,0,3277455,"2023-11-17T00:00:00.000Z",13,FALSE,11,17896051,"G",13,13,"LA Clippers","Joshua Primo",0,0,0,0,0,0
0,0,0,0,0,0,0,0,0,"00",0,0,0,0,0,0,3277455,"2023-11-17T00:00:00.000Z",13,FALSE,11,75,"G-F",11,11,"Houston Rockets","Reggie Bullock",0,0,0,0,0,0
0,0,0,0,0,0,0,0,0,"00",0,0,0,0,0,0,3277455,"2023-11-17T00:00:00.000Z",13,FALSE,11,3547281,"G-F",11,11,"Houston Rockets","Nate Hinton",0,0,0,0,0,0
0,0,3,0,0,2,1,0,0,"07",0,0,2,3,0,1,3277455,"2023-11-17T00:00:00.000Z",13,FALSE,11,19465326,"C",11,11,"Houston Rockets","Jock Landale",0,5,5,2,3,4.6
0,0,0,0,0,0,0,0,0,"00",0,0,0,0,0,0,3277455,"2023-11-17T00:00:00.000Z",13,FALSE,11,296,"C",11,11,"Houston Rockets","Boban Marjanovic",0,0,0,0,0,0
0,0,0,0,0,0,0,0,0,"00",0,0,0,0,0,0,3277455,"2023-11-17T00:00:00.000Z",13,FALSE,11,56677809,"F",11,11,"Houston Rockets","Jermaine Samuels Jr.",0,0,0,0,0,0
0,2,4,1,0,9,6,2,0,"20",2,3,12,6,1,1,3277455,"2023-11-17T00:00:00.000Z",13,FALSE,11,38017695,"F",11,11,"Houston Rockets","Tari Eason",3,18,18,12,6,27.2
2,0,1,1,0,3,0,0,0,"14",1,0,0,2,0,1,3277455,"2023-11-17T00:00:00.000Z",13,FALSE,11,188,"F",11,11,"Houston Rockets","Jeff Green",0,2,4,2,4,4.4
2,0,1,2,1,3,2,0,0,"18",0,2,5,1,1,0,3277455,"2023-11-17T00:00:00.000Z",13,FALSE,11,213,"G",11,11,"Houston Rockets","Aaron Holiday",1,6,8,7,3,12.2
0,0,1,1,0,5,3,0,0,"09",3,5,6,4,0,1,3277455,"2023-11-17T00:00:00.000Z",13,FALSE,11,3547301,"F",11,11,"Houston Rockets","Jae'Sean Tate",0,10,10,6,4,9.8
1,0,3,2,0,6,2,1,0,"31",1,6,4,4,1,0,3277455,"2023-11-17T00:00:00.000Z",13,FALSE,11,66,"G-F",11,11,"Houston Rockets","Dillon Brooks",1,8,9,5,5,13.3
0,1,5,4,1,12,4,0,0,"33",2,5,9,7,1,0,3277455,"2023-11-17T00:00:00.000Z",13,FALSE,11,38017684,"F",11,11,"Houston Rockets","Jabari Smith Jr.",2,16,16,9,7,23.4
4,0,6,5,2,18,8,7,5,"34",2,4,23,8,1,6,3277455,"2023-11-17T00:00:00.000Z",13,FALSE,11,17896062,"F-C",11,11,"Houston Rockets","Alperen Sengun",1,31,35,27,12,35.6
5,1,4,6,1,16,5,10,9,"33",0,3,20,4,0,4,3277455,"2023-11-17T00:00:00.000Z",13,FALSE,11,17895966,"G",11,11,"Houston Rockets","Jalen Green",1,24,29,25,9,31.3
10,1,7,9,5,14,7,0,0,"41",1,0,19,8,1,2,3277455,"2023-11-17T00:00:00.000Z",13,FALSE,11,458,"G",11,11,"Houston Rockets","Fred VanVleet",2,27,37,29,18,47.6
0,0,0,0,0,0,0,0,0,"00",0,0,0,0,0,0,3277455,"2023-11-17T00:00:00.000Z",13,FALSE,11,47738533,"G",11,11,"Houston Rockets","Jeenathan Williams",0,0,0,0,0,0
0,0,0,0,0,0,0,0,0,"00",0,0,0,0,0,0,3277455,"2023-11-17T00:00:00.000Z",13,FALSE,11,56677831,"F",11,11,"Houston Rockets","Cam Whitmore",0,0,0,0,0,0
0,0,0,0,0,0,0,0,0,"00",0,0,0,0,0,0,3277455,"2023-11-17T00:00:00.000Z",13,FALSE,11,357,"G",11,11,"Houston Rockets","Victor Oladipo",0,0,0,0,0,0
0,0,0,0,0,0,0,0,0,"00",0,0,0,0,0,0,3277455,"2023-11-17T00:00:00.000Z",13,FALSE,11,56677825,"G-F",11,11,"Houston Rockets","Amen Thompson",0,0,0,0,0,0
0,0,4,3,0,9,1,0,0,"29",0,2,2,4,0,0,3277445,"2023-11-17T00:00:00.000Z",4,FALSE,17,204,"F",4,4,"Charlotte Hornets","Gordon Hayward",0,6,6,2,4,6.8
1,0,3,3,1,3,1,0,0,"26",0,4,3,3,0,0,3277445,"2023-11-17T00:00:00.000Z",4,FALSE,17,666950,"F",4,4,"Charlotte Hornets","P.J. Washington",0,6,7,4,4,8.1
2,1,10,0,0,7,4,4,3,"32",6,1,11,16,1,0,3277445,"2023-11-17T00:00:00.000Z",4,FALSE,17,38017698,"C",4,4,"Charlotte Hornets","Mark Williams",2,27,29,13,18,39.2
3,0,2,3,0,12,5,1,0,"27",2,2,10,4,1,1,3277445,"2023-11-17T00:00:00.000Z",4,FALSE,17,56677823,"F",4,4,"Charlotte Hornets","Brandon Miller",1,14,17,13,7,21.3
5,0,5,9,2,28,12,12,11,"35",0,2,37,5,1,6,3277445,"2023-11-17T00:00:00.000Z",4,FALSE,17,3547239,"G",4,4,"Charlotte Hornets","LaMelo Ball",1,42,47,42,10,47.5
4,0,5,5,2,13,6,3,3,"33",0,1,17,5,2,2,3277445,"2023-11-17T00:00:00.000Z",4,FALSE,17,62,"F",4,4,"Charlotte Hornets","Miles Bridges",2,22,26,21,9,33
0,0,0,0,0,0,0,0,0,"04",0,0,0,0,0,1,3277445,"2023-11-17T00:00:00.000Z",4,FALSE,17,3547253,"G",4,4,"Charlotte Hornets","Theo Maledon",0,0,0,0,0,-1
1,0,0,2,1,3,1,2,2,"10",0,0,5,0,0,0,3277445,"2023-11-17T00:00:00.000Z",4,FALSE,17,38017708,"G",4,4,"Charlotte Hornets","Bryce McGowens",0,5,6,6,1,6.5
2,1,2,0,0,7,4,0,0,"23",0,0,8,2,0,1,3277445,"2023-11-17T00:00:00.000Z",4,FALSE,17,422,"G",4,4,"Charlotte Hornets","Ish Smith",1,10,12,10,4,15.4
0,0,0,0,0,0,0,0,0,"00",0,0,0,0,0,0,3277445,"2023-11-17T00:00:00.000Z",4,FALSE,17,56677866,"F",4,4,"Charlotte Hornets","Leaky Black",0,0,0,0,0,0
0,0,0,0,0,0,0,0,0,"00",0,0,0,0,0,0,3277445,"2023-11-17T00:00:00.000Z",4,FALSE,17,17896037,"G",4,4,"Charlotte Hornets","James Bouknight",0,0,0,0,0,0
0,0,0,0,0,0,0,0,0,"00",0,0,0,0,0,0,3277445,"2023-11-17T00:00:00.000Z",4,FALSE,17,666748,"F",4,4,"Charlotte Hornets","Cody Martin",0,0,0,0,0,0
0,0,0,0,0,0,0,0,0,"00",0,0,0,0,0,0,3277445,"2023-11-17T00:00:00.000Z",4,FALSE,17,347,"G",4,4,"Charlotte Hornets","Frank Ntilikina",0,0,0,0,0,0
0,0,0,0,0,0,0,0,0,"00",0,0,0,0,0,0,3277445,"2023-11-17T00:00:00.000Z",4,FALSE,17,403,"G",4,4,"Charlotte Hornets","Terry Rozier",0,0,0,0,0,0
1,0,5,7,2,11,4,2,2,"22",1,3,12,6,1,1,3277445,"2023-11-17T00:00:00.000Z",4,FALSE,17,315,"F",17,17,"Milwaukee Bucks","Khris Middleton",1,18,19,13,7,22.7
9,0,8,0,0,10,6,7,4,"28",0,5,16,8,1,4,3277445,"2023-11-17T00:00:00.000Z",4,FALSE,17,15,"F",17,17,"Milwaukee Bucks","Giannis Antetokounmpo",1,24,33,25,17,38.1
2,6,5,2,1,8,7,0,0,"33",2,3,15,7,0,1,3277445,"2023-11-17T00:00:00.000Z",4,FALSE,17,283,"C",17,17,"Milwaukee Bucks","Brook Lopez",6,22,24,17,9,43.4
3,0,2,10,6,12,7,0,0,"30",0,4,20,2,0,0,3277445,"2023-11-17T00:00:00.000Z",4,FALSE,17,38,"G",17,17,"Milwaukee Bucks","Malik Beasley",0,22,25,23,5,26.9
5,0,5,10,5,18,9,4,4,"31",0,2,27,5,1,2,3277445,"2023-11-17T00:00:00.000Z",4,FALSE,17,278,"G",17,17,"Milwaukee Bucks","Damian Lillard",1,32,37,32,10,41.5
0,0,0,0,0,1,1,0,0,"02",0,0,2,0,0,0,3277445,"2023-11-17T00:00:00.000Z",4,FALSE,17,2148,"",17,17,"Milwaukee Bucks","Thanasis Antetokounmpo",0,2,2,2,0,2
0,0,2,0,0,0,0,0,0,"03",0,1,0,2,0,0,3277445,"2023-11-17T00:00:00.000Z",4,FALSE,17,666453,"C",17,17,"Milwaukee Bucks","Marques Bolden",0,2,2,0,2,2.4
3,0,6,6,3,9,4,0,0,"31",1,0,11,7,0,1,3277445,"2023-11-17T00:00:00.000Z",4,FALSE,17,105,"G",17,17,"Milwaukee Bucks","Pat Connaughton",0,18,21,14,10,22.9
0,0,1,3,2,3,2,0,0,"03",0,0,6,1,0,0,3277445,"2023-11-17T00:00:00.000Z",4,FALSE,17,38017733,"G",17,17,"Milwaukee Bucks","A.J. Green",0,7,7,6,1,7.2
2,0,1,2,2,2,2,0,0,"07",0,1,6,1,0,1,3277445,"2023-11-17T00:00:00.000Z",4,FALSE,17,56677852,"G",17,17,"Milwaukee Bucks","Andre Jackson Jr.",0,7,9,8,3,9.2
0,0,0,0,0,0,0,0,0,"00",0,0,0,0,0,0,3277445,"2023-11-17T00:00:00.000Z",4,FALSE,17,284,"C",17,17,"Milwaukee Bucks","Robin Lopez",0,0,0,0,0,0
5,1,3,2,0,3,1,0,0,"20",0,1,2,3,0,0,3277445,"2023-11-17T00:00:00.000Z",4,FALSE,17,368,"G",17,17,"Milwaukee Bucks","Cameron Payne",1,5,10,7,8,16.1
1,0,7,3,1,12,6,0,0,"30",0,1,13,7,1,3,3277445,"2023-11-17T00:00:00.000Z",4,FALSE,17,377,"F",17,17,"Milwaukee Bucks","Bobby Portis",1,20,21,14,8,22.9
0,0,0,0,0,0,0,0,0,"00",0,0,0,0,0,0,3277445,"2023-11-17T00:00:00.000Z",4,FALSE,17,38017691,"G",17,17,"Milwaukee Bucks","TyTy Washington Jr.",0,0,0,0,0,0
0,0,0,0,0,0,0,0,0,"00",0,0,0,0,0,0,3277445,"2023-11-17T00:00:00.000Z",4,FALSE,17,666960,"G",17,17,"Milwaukee Bucks","Lindell Wigginton",0,0,0,0,0,0
0,0,0,0,0,0,0,0,0,"00",0,0,0,0,0,0,3277445,"2023-11-17T00:00:00.000Z",4,FALSE,17,38017676,"F",17,17,"Milwaukee Bucks","MarJon Beauchamp",0,0,0,0,0,0
0,0,0,0,0,0,0,0,0,"00",0,0,0,0,0,0,3277445,"2023-11-17T00:00:00.000Z",4,FALSE,17,112,"F",17,17,"Milwaukee Bucks","Jae Crowder",0,0,0,0,0,0
0,0,0,0,0,0,0,0,0,"00",0,0,0,0,0,0,3277445,"2023-11-17T00:00:00.000Z",4,FALSE,17,56677854,"F",17,17,"Milwaukee Bucks","Chris Livingston",0,0,0,0,0,0
0,0,1,0,0,2,1,0,0,"07",0,0,2,1,0,0,3277445,"2023-11-17T00:00:00.000Z",4,FALSE,17,3547282,"C",4,4,"Charlotte Hornets","Nick Richards",0,3,3,2,1,3.2
0,1,1,1,0,6,1,0,0,"09",1,1,2,2,0,1,3277445,"2023-11-17T00:00:00.000Z",4,FALSE,17,56677846,"G",4,4,"Charlotte Hornets","Nick Smith Jr.",1,4,4,2,2,6.4
0,0,1,0,0,1,1,0,0,"05",0,1,2,1,0,0,3277445,"2023-11-17T00:00:00.000Z",4,FALSE,17,18678001,"F",4,4,"Charlotte Hornets","JT Thor",0,3,3,2,1,3.2
0,0,0,0,0,0,0,0,0,"00",0,0,0,0,0,0,3277445,"2023-11-17T00:00:00.000Z",4,FALSE,17,56677848,"G",4,4,"Charlotte Hornets","Amari Bailey",0,0,0,0,0,0
0,0,1,1,1,1,1,0,0,"22",0,1,3,1,0,0,3277448,"2023-11-17T00:00:00.000Z",6,FALSE,9,666940,"F",6,6,"Cleveland Cavaliers","Dean Wade",0,4,4,3,1,4.2
5,0,6,0,0,12,8,4,2,"35",4,4,18,10,1,2,3277448,"2023-11-17T00:00:00.000Z",6,FALSE,9,17896076,"F-C",6,6,"Cleveland Cavaliers","Evan Mobley",1,28,33,23,15,38.5
2,5,6,0,0,8,4,3,2,"32",1,1,10,7,0,2,3277448,"2023-11-17T00:00:00.000Z",6,FALSE,9,9,"C",6,6,"Cleveland Cavaliers","Jarrett Allen",5,17,19,12,9,34.4
3,1,6,8,4,15,7,0,0,"39",1,1,18,7,4,2,3277448,"2023-11-17T00:00:00.000Z",6,FALSE,9,666908,"G",6,6,"Cleveland Cavaliers","Max Strus",5,25,28,21,10,43.9
3,0,2,5,2,19,10,8,6,"33",1,1,28,3,0,5,3277448,"2023-11-17T00:00:00.000Z",6,FALSE,9,666581,"G",6,6,"Cleveland Cavaliers","Darius Garland",0,31,34,31,6,31.1
0,0,0,0,0,0,0,0,0,"01",0,0,0,0,0,0,3277448,"2023-11-17T00:00:00.000Z",6,FALSE,9,56677847,"F",6,6,"Cleveland Cavaliers","Emoni Bates",0,0,0,0,0,0
0,0,0,0,0,0,0,0,0,"01",0,0,0,0,0,0,3277448,"2023-11-17T00:00:00.000Z",6,FALSE,9,248,"C",6,6,"Cleveland Cavaliers","Damian Jones",0,0,0,0,0,0
1,0,0,6,1,14,4,2,1,"32",0,0,10,0,2,0,3277448,"2023-11-17T00:00:00.000Z",6,FALSE,9,277,"G",6,6,"Cleveland Cavaliers","Caris LeVert",2,10,11,11,1,17.5
0,0,0,0,0,0,0,0,0,"01",0,0,0,0,0,0,3277448,"2023-11-17T00:00:00.000Z",6,FALSE,9,3547299,"G",6,6,"Cleveland Cavaliers","Sam Merrill",0,0,0,0,0,0
2,0,7,1,1,4,3,2,2,"27",0,1,9,7,1,0,3277448,"2023-11-17T00:00:00.000Z",6,FALSE,9,344,"F",6,6,"Cleveland Cavaliers","Georges Niang",1,16,18,11,9,23.4
5,0,3,0,0,9,5,2,2,"16",0,0,12,3,1,0,3277448,"2023-11-17T00:00:00.000Z",6,FALSE,9,56677872,"G",6,6,"Cleveland Cavaliers","Craig Porter",1,15,20,17,8,26.1
0,0,0,0,0,0,0,0,0,"01",0,0,0,0,0,0,3277448,"2023-11-17T00:00:00.000Z",6,FALSE,9,444,"C-F",6,6,"Cleveland Cavaliers","Tristan Thompson",0,0,0,0,0,0
0,0,0,0,0,0,0,0,0,"00",0,0,0,0,0,0,3277448,"2023-11-17T00:00:00.000Z",6,FALSE,9,666676,"G",6,6,"Cleveland Cavaliers","Ty Jerome",0,0,0,0,0,0
0,0,0,0,0,0,0,0,0,"00",0,0,0,0,0,0,3277448,"2023-11-17T00:00:00.000Z",6,FALSE,9,322,"G",6,6,"Cleveland Cavaliers","Donovan Mitchell",0,0,0,0,0,0
0,0,0,0,0,0,0,0,0,"00",0,0,0,0,0,0,3277448,"2023-11-17T00:00:00.000Z",6,FALSE,9,38017662,"F",6,6,"Cleveland Cavaliers","Isaiah Mobley",0,0,0,0,0,0
0,0,0,0,0,0,0,0,0,"00",0,0,0,0,0,0,3277448,"2023-11-17T00:00:00.000Z",6,FALSE,9,3547247,"F-G",6,6,"Cleveland Cavaliers","Isaac Okoro",0,0,0,0,0,0
0,0,0,0,0,0,0,0,0,"00",0,0,0,0,0,0,3277448,"2023-11-17T00:00:00.000Z",6,FALSE,9,404,"G",6,6,"Cleveland Cavaliers","Ricky Rubio",0,0,0,0,0,0
2,0,5,1,0,8,4,3,1,"17",5,4,9,10,0,5,3277448,"2023-11-17T00:00:00.000Z",6,FALSE,9,56677826,"G-F",9,9,"Detroit Pistons","Ausar Thompson",0,19,21,11,12,19
0,1,7,4,1,10,5,0,0,"31",4,3,11,11,1,0,3277448,"2023-11-17T00:00:00.000Z",6,FALSE,9,259,"F",9,9,"Detroit Pistons","Kevin Knox",2,22,22,11,11,30.2
2,3,6,4,1,11,4,2,2,"31",4,0,11,10,1,1,3277448,"2023-11-17T00:00:00.000Z",6,FALSE,9,3547267,"F-C",9,9,"Detroit Pistons","Isaiah Stewart",4,21,23,13,12,37
8,0,4,7,2,21,9,0,0,"34",1,4,20,5,0,4,3277448,"2023-11-17T00:00:00.000Z",6,FALSE,9,17896075,"G-F",9,9,"Detroit Pistons","Cade Cunningham",0,25,33,28,13,34
2,1,0,2,0,6,2,0,0,"22",0,0,4,0,1,0,3277448,"2023-11-17T00:00:00.000Z",6,FALSE,9,3547241,"G",9,9,"Detroit Pistons","Killian Hayes",2,4,6,6,2,13
1,0,1,9,2,14,4,0,0,"24",2,3,10,3,1,0,3277448,"2023-11-17T00:00:00.000Z",6,FALSE,9,77,"G",9,9,"Detroit Pistons","Alec Burks",1,13,14,11,4,18.1
1,1,2,0,0,5,3,2,2,"16",1,0,8,3,1,1,3277448,"2023-11-17T00:00:00.000Z",6,FALSE,9,24,"F",9,9,"Detroit Pistons","Marvin Bagley III",2,11,12,9,4,18.1
0,1,5,3,2,3,2,4,4,"17",1,1,10,6,1,0,3277448,"2023-11-17T00:00:00.000Z",6,FALSE,9,44477024,"G",9,9,"Detroit Pistons","Stanley Umude",2,16,16,10,6,23.2
0,0,2,0,0,0,0,0,0,"04",0,0,0,2,0,0,3277448,"2023-11-17T00:00:00.000Z",6,FALSE,9,3547240,"C",9,9,"Detroit Pistons","James Wiseman",0,2,2,0,2,2.4
0,0,0,0,0,0,0,0,0,"00",0,0,0,0,0,0,3277448,"2023-11-17T00:00:00.000Z",6,FALSE,9,38017694,"C",9,9,"Detroit Pistons","Jalen Duren",0,0,0,0,0,0
0,0,0,0,0,0,0,0,0,"00",0,0,0,0,0,0,3277448,"2023-11-17T00:00:00.000Z",6,FALSE,9,17896071,"F",9,9,"Detroit Pistons","Isaiah Livers",0,0,0,0,0,0
3,0,1,2,1,6,4,2,2,"29",1,3,11,2,1,6,3277448,"2023-11-17T00:00:00.000Z",6,FALSE,9,38017682,"G",9,9,"Detroit Pistons","Jaden Ivey",1,13,16,14,5,14.9
0,0,0,3,0,7,2,2,2,"15",0,1,6,0,0,0,3277448,"2023-11-17T00:00:00.000Z",6,FALSE,9,56677792,"G",9,9,"Detroit Pistons","Marcus Sasser",0,6,6,6,0,6
0,0,0,0,0,0,0,0,0,"00",0,0,0,0,0,0,3277448,"2023-11-17T00:00:00.000Z",6,FALSE,9,54,"F",9,9,"Detroit Pistons","Bojan Bogdanovic",0,0,0,0,0,0
0,0,0,0,0,0,0,0,0,"00",0,0,0,0,0,0,3277448,"2023-11-17T00:00:00.000Z",6,FALSE,9,56677729,"G",9,9,"Detroit Pistons","Malcolm Cazalon",0,0,0,0,0,0
0,0,0,0,0,0,0,0,0,"00",0,0,0,0,0,0,3277448,"2023-11-17T00:00:00.000Z",6,FALSE,9,197,"F-G",9,9,"Detroit Pistons","Joe Harris",0,0,0,0,0,0
0,0,0,0,0,0,0,0,0,"00",0,0,0,0,0,0,3277448,"2023-11-17T00:00:00.000Z",6,FALSE,9,330,"G",9,9,"Detroit Pistons","Monte Morris",0,0,0,0,0,0
0,0,0,0,0,0,0,0,0,"00",0,0,0,0,0,0,3277448,"2023-11-17T00:00:00.000Z",6,FALSE,9,42097199,"G",9,9,"Detroit Pistons","Jared Rhoden",0,0,0,0,0,0
0,0,0,0,0,0,0,0,0,"00",0,0,0,0,0,0,3277449,"2023-11-17T00:00:00.000Z",28,FALSE,2,56677864,"G",2,2,"Boston Celtics","Jordan Walsh",0,0,0,0,0,0
6,1,3,6,2,13,5,3,2,"32",0,2,14,3,0,1,3277449,"2023-11-17T00:00:00.000Z",28,FALSE,2,17896055,"G-F",28,28,"Toronto Raptors","Scottie Barnes",1,17,23,20,9,28.6
5,0,5,1,0,16,11,1,1,"29",1,5,23,6,0,3,3277449,"2023-11-17T00:00:00.000Z",28,FALSE,2,416,"F",28,28,"Toronto Raptors","Pascal Siakam",0,29,34,28,11,34.7
4,0,6,0,0,5,5,2,1,"34",2,0,11,8,1,3,3277449,"2023-11-17T00:00:00.000Z",28,FALSE,2,373,"C",28,28,"Toronto Raptors","Jakob Poeltl",1,19,23,15,12,26.6
1,0,2,5,3,9,4,4,3,"31",0,0,14,2,1,0,3277449,"2023-11-17T00:00:00.000Z",28,FALSE,2,3089,"",28,28,"Toronto Raptors","Gary Trent Jr.",1,16,17,15,3,20.9
6,0,7,11,5,19,9,0,0,"35",0,2,23,7,0,2,3277449,"2023-11-17T00:00:00.000Z",28,FALSE,2,409,"G",28,28,"Toronto Raptors","Dennis Schroder",0,30,36,29,13,38.4
1,0,9,2,0,4,2,2,1,"25",0,1,5,9,2,1,3277449,"2023-11-17T00:00:00.000Z",28,FALSE,2,3547249,"F",28,28,"Toronto Raptors","Precious Achiuwa",2,14,15,6,10,22.3
0,0,0,0,0,0,0,0,0,"00",0,0,0,0,0,0,3277449,"2023-11-17T00:00:00.000Z",28,FALSE,2,18,"F",28,28,"Toronto Raptors","OG Anunoby",0,0,0,0,0,0
0,0,0,0,0,0,0,0,0,"00",0,0,0,0,0,0,3277449,"2023-11-17T00:00:00.000Z",28,FALSE,2,489,"F",28,28,"Toronto Raptors","Thaddeus Young",0,0,0,0,0,0
4,1,3,5,3,14,9,3,2,"36",0,2,23,3,1,3,3277449,"2023-11-17T00:00:00.000Z",28,FALSE,2,70,"G",2,2,"Boston Celtics","Jaylen Brown",2,26,30,27,7,35.6
2,0,6,11,1,22,8,0,0,"37",1,3,17,7,1,3,3277449,"2023-11-17T00:00:00.000Z",28,FALSE,2,434,"F",2,2,"Boston Celtics","Jayson Tatum",1,24,26,19,9,28.4
5,3,10,3,0,13,6,2,2,"35",2,3,14,12,1,2,3277449,"2023-11-17T00:00:00.000Z",28,FALSE,2,378,"F-C",2,2,"Boston Celtics","Kristaps Porzingis",4,26,31,19,17,45.9
5,0,4,8,3,10,4,2,2,"34",0,1,13,4,0,1,3277449,"2023-11-17T00:00:00.000Z",28,FALSE,2,473,"G",2,2,"Boston Celtics","Derrick White",0,17,22,18,9,24.3
5,0,6,4,2,14,5,2,2,"35",2,2,14,8,0,1,3277449,"2023-11-17T00:00:00.000Z",28,FALSE,2,214,"G",2,2,"Boston Celtics","Jrue Holiday",0,22,27,19,13,30.1
0,0,0,0,0,0,0,0,0,"00",0,0,0,0,0,0,3277449,"2023-11-17T00:00:00.000Z",28,FALSE,2,17896094,"G",2,2,"Boston Celtics","Dalano Banton",0,0,0,0,0,0
0,0,0,0,0,0,0,0,0,"00",0,0,0,0,0,0,3277449,"2023-11-17T00:00:00.000Z",28,FALSE,2,666468,"F",2,2,"Boston Celtics","Oshae Brissett",0,0,0,0,0,0
3,0,2,6,3,7,4,0,0,"23",1,0,11,3,1,0,3277449,"2023-11-17T00:00:00.000Z",28,FALSE,2,17896060,"F",2,2,"Boston Celtics","Sam Hauser",1,14,17,14,6,22.1
2,0,3,4,3,5,4,0,0,"23",1,1,11,4,0,0,3277449,"2023-11-17T00:00:00.000Z",28,FALSE,2,219,"C-F",2,2,"Boston Celtics","Al Horford",0,15,17,13,6,18.8
0,0,0,0,0,0,0,0,0,"00",0,0,0,0,0,0,3277449,"2023-11-17T00:00:00.000Z",28,FALSE,2,261,"F-C",2,2,"Boston Celtics","Luke Kornet",0,0,0,0,0,0
3,0,2,5,1,7,2,0,0,"17",1,1,5,3,1,0,3277449,"2023-11-17T00:00:00.000Z",28,FALSE,2,3547276,"G",2,2,"Boston Celtics","Payton Pritchard",1,8,11,8,6,16.1
0,0,0,0,0,0,0,0,0,"00",0,0,0,0,0,0,3277449,"2023-11-17T00:00:00.000Z",28,FALSE,2,17553967,"C",2,2,"Boston Celtics","Neemias Queta",0,0,0,0,0,0
0,0,0,0,0,0,0,0,0,"00",0,0,0,0,0,0,3277449,"2023-11-17T00:00:00.000Z",28,FALSE,2,3547279,"F",2,2,"Boston Celtics","Lamar Stevens",0,0,0,0,0,0
0,0,0,0,0,0,0,0,0,"00",0,0,0,0,0,0,3277449,"2023-11-17T00:00:00.000Z",28,FALSE,2,38017707,"G",2,2,"Boston Celtics","JD Davison",0,0,0,0,0,0
0,0,0,0,0,0,0,0,0,"00",0,0,0,0,0,0,3277449,"2023-11-17T00:00:00.000Z",28,FALSE,2,3547295,"F-C",2,2,"Boston Celtics","Nathan Knight",0,0,0,0,0,0
0,0,3,2,1,6,2,2,1,"18",1,0,6,4,0,0,3277449,"2023-11-17T00:00:00.000Z",28,FALSE,2,58,"F",28,28,"Toronto Raptors","Chris Boucher",0,10,10,6,4,10.8
1,0,1,4,0,5,0,0,0,"10",0,0,0,1,0,2,3277449,"2023-11-17T00:00:00.000Z",28,FALSE,2,56677828,"G",28,28,"Toronto Raptors","Gradey Dick",0,1,2,1,2,0.7
5,0,0,1,1,5,2,0,0,"19",1,1,5,1,0,1,3277449,"2023-11-17T00:00:00.000Z",28,FALSE,2,3547275,"G",28,28,"Toronto Raptors","Malachi Flynn",0,6,11,10,6,12.7
0,0,0,1,0,5,2,0,0,"07",0,0,4,0,0,0,3277449,"2023-11-17T00:00:00.000Z",28,FALSE,2,666762,"F",28,28,"Toronto Raptors","Jalen McDaniels",0,4,4,4,0,4
0,0,0,0,0,0,0,0,0,"00",0,0,0,0,0,0,3277449,"2023-11-17T00:00:00.000Z",28,FALSE,2,436,"G-F",28,28,"Toronto Raptors","Garrett Temple",0,0,0,0,0,0
0,0,0,0,0,0,0,0,0,"00",0,0,0,0,0,0,3277449,"2023-11-17T00:00:00.000Z",28,FALSE,2,56677805,"G",28,28,"Toronto Raptors","Javon Freeman-Liberty",0,0,0,0,0,0
0,0,0,0,0,0,0,0,0,"00",0,0,0,0,0,0,3277449,"2023-11-17T00:00:00.000Z",28,FALSE,2,38017717,"F",28,28,"Toronto Raptors","Ron Harper Jr.",0,0,0,0,0,0
0,0,0,0,0,0,0,0,0,"00",0,0,0,0,0,0,3277449,"2023-11-17T00:00:00.000Z",28,FALSE,2,38017710,"C",28,28,"Toronto Raptors","Christian Koloko",0,0,0,0,0,0
0,0,0,0,0,0,0,0,0,"00",0,0,0,0,0,0,3277449,"2023-11-17T00:00:00.000Z",28,FALSE,2,56677869,"G",28,28,"Toronto Raptors","Markquis Nowell",0,0,0,0,0,0
0,0,0,0,0,0,0,0,0,"00",0,0,0,0,0,0,3277449,"2023-11-17T00:00:00.000Z",28,FALSE,2,376,"F",28,28,"Toronto Raptors","Otto Porter Jr.",0,0,0,0,0,0
0,0,0,0,0,0,0,0,0,"00",0,0,0,0,0,0,3277449,"2023-11-17T00:00:00.000Z",28,FALSE,2,338,"G",2,2,"Boston Celtics","Svi Mykhailiuk",0,0,0,0,0,0
7,1,9,9,5,16,7,2,2,"36",0,1,21,9,1,3,3277450,"2023-11-17T00:00:00.000Z",27,FALSE,26,666682,"F",27,27,"San Antonio Spurs","Keldon Johnson",2,30,37,28,16,45.3
0,0,8,8,2,26,12,1,1,"31",1,3,27,9,2,4,3277450,"2023-11-17T00:00:00.000Z",27,FALSE,26,56677822,"F-C",27,27,"San Antonio Spurs","Victor Wembanyama",2,36,36,27,9,39.8
5,1,6,5,3,14,10,6,5,"34",2,5,28,8,3,3,3277450,"2023-11-17T00:00:00.000Z",27,FALSE,26,102,"F-C",27,27,"San Antonio Spurs","Zach Collins",4,36,41,33,13,54.1
3,1,1,4,2,5,2,4,3,"25",1,3,9,2,0,2,3277450,"2023-11-17T00:00:00.000Z",27,FALSE,26,38017649,"F",27,27,"San Antonio Spurs","Julian Champagnie",1,11,14,12,5,16.9
6,0,7,3,1,10,3,2,1,"37",1,4,8,8,1,3,3277450,"2023-11-17T00:00:00.000Z",27,FALSE,26,38017699,"F",27,27,"San Antonio Spurs","Jeremy Sochan",1,16,22,14,14,26.6
0,0,1,0,0,1,1,0,0,"02",0,0,2,1,0,0,3277450,"2023-11-17T00:00:00.000Z",27,FALSE,26,17895854,"G",27,27,"San Antonio Spurs","Charles Bassey",0,3,3,2,1,3.2
0,0,0,0,0,0,0,0,0,"00",0,0,0,0,0,0,3277450,"2023-11-17T00:00:00.000Z",27,FALSE,26,56677865,"C",27,27,"San Antonio Spurs","Charles Bediako",0,0,0,0,0,0
5,0,0,3,0,10,4,2,2,"28",0,1,10,0,0,0,3277450,"2023-11-17T00:00:00.000Z",27,FALSE,26,38017692,"F",27,27,"San Antonio Spurs","Malaki Branham",0,10,15,15,5,17.5
0,0,0,0,0,0,0,0,0,"00",0,0,0,0,0,0,3277450,"2023-11-17T00:00:00.000Z",27,FALSE,26,56677817,"G",27,27,"San Antonio Spurs","Sidy Cissoko",0,0,0,0,0,0
0,0,0,0,0,0,0,0,0,"00",0,0,0,0,0,0,3277450,"2023-11-17T00:00:00.000Z",27,FALSE,26,180,"G",27,27,"San Antonio Spurs","Devonte' Graham",0,0,0,0,0,0
2,0,2,0,0,2,1,4,4,"12",1,1,6,3,0,1,3277450,"2023-11-17T00:00:00.000Z",27,FALSE,26,17896059,"F",27,27,"San Antonio Spurs","Sandro Mamukelashvili",0,9,11,8,5,11.6
3,0,0,2,1,4,2,2,1,"16",0,1,6,0,0,0,3277450,"2023-11-17T00:00:00.000Z",27,FALSE,26,305,"F",27,27,"San Antonio Spurs","Doug McDermott",0,6,9,9,3,10.5
2,0,2,2,1,3,1,0,0,"15",0,1,3,2,0,0,3277450,"2023-11-17T00:00:00.000Z",27,FALSE,26,359,"F",27,27,"San Antonio Spurs","Cedi Osman",0,5,7,5,4,8.4
0,0,0,0,0,0,0,0,0,"00",0,0,0,0,0,0,3277450,"2023-11-17T00:00:00.000Z",27,FALSE,26,56677870,"G",27,27,"San Antonio Spurs","Sir'Jabari Rice",0,0,0,0,0,0
0,0,0,0,0,0,0,0,0,"04",0,1,0,0,0,0,3277450,"2023-11-17T00:00:00.000Z",27,FALSE,26,38017693,"G",27,27,"San Antonio Spurs","Blake Wesley",0,0,0,0,0,0
0,0,0,0,0,0,0,0,0,"00",0,0,0,0,0,0,3277450,"2023-11-17T00:00:00.000Z",27,FALSE,26,38017730,"F",27,27,"San Antonio Spurs","Dominick Barlow",0,0,0,0,0,0
0,0,0,0,0,0,0,0,0,"00",0,0,0,0,0,0,3277450,"2023-11-17T00:00:00.000Z",27,FALSE,26,3547274,"G",27,27,"San Antonio Spurs","Tre Jones",0,0,0,0,0,0
0,0,0,0,0,0,0,0,0,"00",0,0,0,0,0,0,3277450,"2023-11-17T00:00:00.000Z",27,FALSE,26,3547246,"G-F",27,27,"San Antonio Spurs","Devin Vassell",0,0,0,0,0,0
1,0,2,6,1,7,2,3,2,"26",0,2,7,2,1,1,3277450,"2023-11-17T00:00:00.000Z",27,FALSE,26,30,"F",26,26,"Sacramento Kings","Harrison Barnes",1,9,10,8,3,12.9
3,0,5,4,0,10,3,0,0,"38",1,2,6,6,1,2,3277450,"2023-11-17T00:00:00.000Z",27,FALSE,26,38017688,"F",26,26,"Sacramento Kings","Keegan Murray",1,12,15,9,9,18.7
7,1,12,3,2,13,9,8,7,"35",2,5,27,14,1,4,3277450,"2023-11-17T00:00:00.000Z",27,FALSE,26,406,"F",26,26,"Sacramento Kings","Domantas Sabonis",2,41,48,34,21,56.3
2,1,0,4,1,9,4,0,0,"25",0,2,9,0,3,0,3277450,"2023-11-17T00:00:00.000Z",27,FALSE,26,221,"G",26,26,"Sacramento Kings","Kevin Huerter",4,9,11,11,2,24
7,0,8,11,5,24,14,13,10,"41",0,2,43,8,1,1,3277450,"2023-11-17T00:00:00.000Z",27,FALSE,26,161,"G",26,26,"Sacramento Kings","De'Aaron Fox",1,51,58,50,15,65.1
8,0,3,9,6,11,7,0,0,"25",1,3,20,4,1,1,3277450,"2023-11-17T00:00:00.000Z",27,FALSE,26,324,"G",26,26,"Sacramento Kings","Malik Monk",1,24,32,28,12,38.8
0,0,0,0,0,0,0,0,0,"00",0,0,0,0,0,0,3277450,"2023-11-17T00:00:00.000Z",27,FALSE,26,17895990,"G",26,26,"Sacramento Kings","Jordan Ford",0,0,0,0,0,0
0,0,0,0,0,0,0,0,0,"00",0,0,0,0,0,0,3277450,"2023-11-17T00:00:00.000Z",27,FALSE,26,56677845,"G",26,26,"Sacramento Kings","Colby Jones",0,0,0,0,0,0
0,0,0,0,0,0,0,0,0,"00",0,0,0,0,0,0,3277450,"2023-11-17T00:00:00.000Z",27,FALSE,26,273,"C",26,26,"Sacramento Kings","Alex Len",0,0,0,0,0,0
0,0,0,0,0,0,0,0,0,"00",0,0,0,0,0,0,3277450,"2023-11-17T00:00:00.000Z",27,FALSE,26,290,"F",26,26,"Sacramento Kings","Trey Lyles",0,0,0,0,0,0
1,0,0,0,0,2,2,0,0,"08",0,1,4,0,0,1,3277450,"2023-11-17T00:00:00.000Z",27,FALSE,26,306,"C",26,26,"Sacramento Kings","JaVale McGee",0,4,5,5,1,4.5
0,0,3,3,2,4,2,0,0,"15",0,2,6,3,2,2,3277450,"2023-11-17T00:00:00.000Z",27,FALSE,26,17896030,"G",26,26,"Sacramento Kings","Chris Duarte",2,9,9,6,3,13.6
0,0,0,0,0,0,0,0,0,"00",0,0,0,0,0,0,3277450,"2023-11-17T00:00:00.000Z",27,FALSE,26,17896044,"F",26,26,"Sacramento Kings","Kessler Edwards",0,0,0,0,0,0
0,0,0,0,0,0,0,0,0,"00",0,0,0,0,0,0,3277450,"2023-11-17T00:00:00.000Z",27,FALSE,26,17553994,"G",26,26,"Sacramento Kings","Davion Mitchell",0,0,0,0,0,0
0,0,0,0,0,0,0,0,0,"00",0,0,0,0,0,0,3277450,"2023-11-17T00:00:00.000Z",27,FALSE,26,17895941,"C",26,26,"Sacramento Kings","Filip Petrusev",0,0,0,0,0,0
0,0,0,0,0,0,0,0,0,"00",0,0,0,0,0,0,3277450,"2023-11-17T00:00:00.000Z",27,FALSE,26,56677862,"F",26,26,"Sacramento Kings","Jalen Slawson",0,0,0,0,0,0
0,0,4,2,1,4,2,0,0,"17",0,3,5,4,0,0,3277450,"2023-11-17T00:00:00.000Z",27,FALSE,26,4197162,"F",26,26,"Sacramento Kings","Aleksandar Vezenkov",0,9,9,5,4,9.8
2,0,0,0,0,1,1,0,0,"10",0,0,2,0,1,1,3277450,"2023-11-17T00:00:00.000Z",27,FALSE,26,38017714,"G",26,26,"Sacramento Kings","Keon Ellis",1,2,4,4,2,7
4,0,3,2,0,7,1,2,2,"32",0,3,4,3,2,0,1037771,"2023-11-18T00:00:00.000Z",4,FALSE,20,204,"F",4,4,"Charlotte Hornets","Gordon Hayward",2,7,11,8,7,19.6
2,2,6,7,1,10,1,0,0,"33",0,4,3,6,1,6,1037771,"2023-11-18T00:00:00.000Z",4,FALSE,20,666950,"F",4,4,"Charlotte Hornets","P.J. Washington",3,9,11,5,8,16.2
4,1,6,0,0,5,3,2,1,"30",2,3,7,8,0,1,1037771,"2023-11-18T00:00:00.000Z",4,FALSE,20,38017698,"C",4,4,"Charlotte Hornets","Mark Williams",1,15,19,11,12,24.6
2,0,3,7,5,15,10,4,4,"34",0,3,29,3,0,2,1037771,"2023-11-18T00:00:00.000Z",4,FALSE,20,56677823,"F",4,4,"Charlotte Hornets","Brandon Miller",0,32,34,31,5,33.6
9,0,5,13,8,22,12,2,2,"36",0,3,34,5,1,3,1037771,"2023-11-18T00:00:00.000Z",4,FALSE,20,3547239,"G",4,4,"Charlotte Hornets","LaMelo Ball",1,39,48,43,14,53.5
3,1,4,1,1,12,8,3,2,"31",0,2,19,4,1,1,1037771,"2023-11-18T00:00:00.000Z",4,FALSE,20,62,"F",4,4,"Charlotte Hornets","Miles Bridges",2,23,26,22,7,33.3
0,0,0,0,0,0,0,0,0,"00",0,0,0,0,0,0,1037771,"2023-11-18T00:00:00.000Z",4,FALSE,20,3547253,"G",4,4,"Charlotte Hornets","Theo Maledon",0,0,0,0,0,0
1,0,1,1,0,2,0,0,0,"16",1,2,0,2,0,0,1037771,"2023-11-18T00:00:00.000Z",4,FALSE,20,38017708,"G",4,4,"Charlotte Hornets","Bryce McGowens",0,2,3,1,3,3.9
4,0,3,2,1,6,3,0,0,"17",0,1,7,3,0,0,1037771,"2023-11-18T00:00:00.000Z",4,FALSE,20,422,"G",4,4,"Charlotte Hornets","Ish Smith",0,10,14,11,7,16.6
0,0,0,0,0,0,0,0,0,"00",0,0,0,0,0,0,1037771,"2023-11-18T00:00:00.000Z",4,FALSE,20,56677846,"G",4,4,"Charlotte Hornets","Nick Smith Jr.",0,0,0,0,0,0
0,1,1,2,1,3,2,0,0,"11",1,1,5,2,0,0,1037771,"2023-11-18T00:00:00.000Z",4,FALSE,20,18678001,"F",4,4,"Charlotte Hornets","JT Thor",1,7,7,5,2,10.4
0,0,0,0,0,0,0,0,0,"00",0,0,0,0,0,0,1037771,"2023-11-18T00:00:00.000Z",4,FALSE,20,56677848,"G",4,4,"Charlotte Hornets","Amari Bailey",0,0,0,0,0,0
0,0,0,0,0,0,0,0,0,"00",0,0,0,0,0,0,1037771,"2023-11-18T00:00:00.000Z",4,FALSE,20,56677866,"F",4,4,"Charlotte Hornets","Leaky Black",0,0,0,0,0,0
0,0,0,0,0,0,0,0,0,"00",0,0,0,0,0,0,1037771,"2023-11-18T00:00:00.000Z",4,FALSE,20,17896037,"G",4,4,"Charlotte Hornets","James Bouknight",0,0,0,0,0,0
0,0,0,0,0,0,0,0,0,"00",0,0,0,0,0,0,1037771,"2023-11-18T00:00:00.000Z",4,FALSE,20,666748,"F",4,4,"Charlotte Hornets","Cody Martin",0,0,0,0,0,0
0,0,0,0,0,0,0,0,0,"00",0,0,0,0,0,0,1037771,"2023-11-18T00:00:00.000Z",4,FALSE,20,347,"G",4,4,"Charlotte Hornets","Frank Ntilikina",0,0,0,0,0,0
0,0,0,0,0,0,0,0,0,"00",0,0,0,0,0,0,1037771,"2023-11-18T00:00:00.000Z",4,FALSE,20,3547282,"C",4,4,"Charlotte Hornets","Nick Richards",0,0,0,0,0,0
0,0,0,0,0,0,0,0,0,"00",0,0,0,0,0,0,1037771,"2023-11-18T00:00:00.000Z",4,FALSE,20,403,"G",4,4,"Charlotte Hornets","Terry Rozier",0,0,0,0,0,0
3,0,3,5,1,15,5,5,4,"26",0,0,15,3,1,1,1037771,"2023-11-18T00:00:00.000Z",4,FALSE,20,666423,"F-G",20,20,"New York Knicks","RJ Barrett",1,18,21,18,6,25.1
7,0,6,5,2,17,8,7,3,"38",0,4,21,6,0,4,1037771,"2023-11-18T00:00:00.000Z",4,FALSE,20,387,"F",20,20,"New York Knicks","Julius Randle",0,27,34,28,13,34.7
1,4,3,0,0,5,2,0,0,"33",11,0,4,14,0,3,1037771,"2023-11-18T00:00:00.000Z",4,FALSE,20,399,"C",20,20,"New York Knicks","Mitchell Robinson",4,18,19,5,15,31.3
3,1,3,10,7,12,9,0,0,"28",0,1,25,3,3,0,1037771,"2023-11-18T00:00:00.000Z",4,FALSE,20,131,"G",20,20,"New York Knicks","Donte DiVincenzo",4,28,31,28,6,45.1
8,0,3,8,4,21,12,4,4,"39",0,2,32,3,0,2,1037771,"2023-11-18T00:00:00.000Z",4,FALSE,20,73,"G",20,20,"New York Knicks","Jalen Brunson",0,35,43,40,11,45.6
0,0,0,0,0,0,0,0,0,"00",0,0,0,0,0,0,1037771,"2023-11-18T00:00:00.000Z",4,FALSE,20,19,"G",20,20,"New York Knicks","Ryan Arcidiacono",0,0,0,0,0,0
4,0,6,2,1,5,3,0,0,"29",0,0,7,6,3,0,1037771,"2023-11-18T00:00:00.000Z",4,FALSE,20,202,"G",20,20,"New York Knicks","Josh Hart",3,13,17,11,10,29.2
0,0,5,0,0,2,1,2,2,"15",2,1,4,7,0,1,1037771,"2023-11-18T00:00:00.000Z",4,FALSE,20,201,"F-C",20,20,"New York Knicks","Isaiah Hartenstein",0,11,11,4,7,11.4
0,0,0,2,1,3,2,0,0,"09",0,2,5,0,0,0,1037771,"2023-11-18T00:00:00.000Z",4,FALSE,20,17896033,"G",20,20,"New York Knicks","Miles McBride",0,5,5,5,0,5
1,0,5,5,0,11,4,1,1,"23",0,3,9,5,0,1,1037771,"2023-11-18T00:00:00.000Z",4,FALSE,20,3547269,"G",20,20,"New York Knicks","Immanuel Quickley",0,14,15,10,6,15.5
0,0,0,0,0,0,0,0,0,"00",0,0,0,0,0,0,1037771,"2023-11-18T00:00:00.000Z",4,FALSE,20,56677795,"F",20,20,"New York Knicks","Jacob Toppin",0,0,0,0,0,0
0,0,0,0,0,0,0,0,0,"00",0,0,0,0,0,0,1037771,"2023-11-18T00:00:00.000Z",4,FALSE,20,17896089,"G",20,20,"New York Knicks","Duane Washington Jr.",0,0,0,0,0,0
0,0,0,0,0,0,0,0,0,"00",0,0,0,0,0,0,1037771,"2023-11-18T00:00:00.000Z",4,FALSE,20,666971,"G-F",20,20,"New York Knicks","Dylan Windler",0,0,0,0,0,0
0,0,0,0,0,0,0,0,0,"00",0,0,0,0,0,0,1037771,"2023-11-18T00:00:00.000Z",4,FALSE,20,666675,"F",20,20,"New York Knicks","DaQuan Jeffries",0,0,0,0,0,0
0,0,0,0,0,0,0,0,0,"00",0,0,0,0,0,0,1037771,"2023-11-18T00:00:00.000Z",4,FALSE,20,17896063,"F",20,20,"New York Knicks","Jericho Sims",0,0,0,0,0,0
0,0,0,0,0,0,0,0,0,"00",0,0,0,0,0,0,1037771,"2023-11-18T00:00:00.000Z",4,FALSE,20,666474,"G",20,20,"New York Knicks","Charles Brown",0,0,0,0,0,0
0,0,0,0,0,0,0,0,0,"00",0,0,0,0,0,0,1037771,"2023-11-18T00:00:00.000Z",4,FALSE,20,160,"G-F",20,20,"New York Knicks","Evan Fournier",0,0,0,0,0,0
0,0,0,0,0,0,0,0,0,"00",0,0,0,0,0,0,1037771,"2023-11-18T00:00:00.000Z",4,FALSE,20,17895858,"G",20,20,"New York Knicks","Quentin Grimes",0,0,0,0,0,0
0,0,0,0,0,0,0,0,0,"00",0,0,0,0,0,0,1037772,"2023-11-18T00:00:00.000Z",19,FALSE,18,56677851,"G",18,18,"Minnesota Timberwolves","Jaylen Clark",0,0,0,0,0,0
0,0,0,0,0,0,0,0,0,"00",0,0,0,0,0,0,1037772,"2023-11-18T00:00:00.000Z",19,FALSE,18,17896056,"C",18,18,"Minnesota Timberwolves","Luka Garza",0,0,0,0,0,0
0,0,0,0,0,0,0,0,0,"00",0,0,0,0,0,0,1037772,"2023-11-18T00:00:00.000Z",19,FALSE,18,666767,"G",18,18,"Minnesota Timberwolves","Jordan McLaughlin",0,0,0,0,0,0
0,0,0,0,0,0,0,0,0,"00",0,0,0,0,0,0,1037772,"2023-11-18T00:00:00.000Z",19,FALSE,18,56677782,"F",18,18,"Minnesota Timberwolves","Leonard Miller",0,0,0,0,0,0
0,0,0,0,0,0,0,0,0,"00",0,0,0,0,0,0,1037772,"2023-11-18T00:00:00.000Z",19,FALSE,18,38017700,"G",18,18,"Minnesota Timberwolves","Wendell Moore Jr.",0,0,0,0,0,0
0,0,0,0,0,0,0,0,0,"00",0,0,0,0,0,0,1037772,"2023-11-18T00:00:00.000Z",19,FALSE,18,38017726,"G",19,19,"New Orleans Pelicans","Dereon Seabron",0,0,0,0,0,0
1,0,2,2,1,7,5,1,1,"34",0,3,12,2,0,2,1037772,"2023-11-18T00:00:00.000Z",19,FALSE,18,3547259,"F",18,18,"Minnesota Timberwolves","Jaden McDaniels",0,14,15,13,3,13.9
9,2,4,2,2,11,10,8,7,"33",2,5,29,6,0,0,1037772,"2023-11-18T00:00:00.000Z",19,FALSE,18,447,"C",18,18,"Minnesota Timberwolves","Karl-Anthony Towns",2,35,44,38,15,55.7
1,1,9,0,0,7,5,10,7,"34",2,2,17,11,2,1,1037772,"2023-11-18T00:00:00.000Z",19,FALSE,18,176,"C",18,18,"Minnesota Timberwolves","Rudy Gobert",3,28,29,18,12,39.7
8,2,3,4,3,7,3,4,4,"28",1,6,13,4,2,0,1037772,"2023-11-18T00:00:00.000Z",19,FALSE,18,17896024,"F",19,19,"New Orleans Pelicans","Herbert Jones",4,17,25,21,12,41.8
4,0,5,6,1,24,11,9,7,"34",2,0,30,7,1,4,1037772,"2023-11-18T00:00:00.000Z",19,FALSE,18,227,"F",19,19,"New Orleans Pelicans","Brandon Ingram",1,37,41,34,11,43.4
3,3,6,1,0,15,10,6,6,"30",5,5,26,11,1,3,1037772,"2023-11-18T00:00:00.000Z",19,FALSE,18,455,"C",19,19,"New Orleans Pelicans","Jonas Valanciunas",4,37,40,29,14,52.7
4,0,1,8,3,12,6,0,0,"37",1,4,15,2,1,1,1037772,"2023-11-18T00:00:00.000Z",19,FALSE,18,56677837,"G",19,19,"New Orleans Pelicans","Jordan Hawkins",1,17,21,19,6,25.4
6,0,4,3,1,12,6,0,0,"37",1,4,13,5,1,3,1037772,"2023-11-18T00:00:00.000Z",19,FALSE,18,38017677,"G",19,19,"New Orleans Pelicans","Dyson Daniels",1,18,24,19,11,28
1,0,1,2,1,4,2,3,2,"24",0,2,7,1,1,2,1037772,"2023-11-18T00:00:00.000Z",19,FALSE,18,3547293,"F",19,19,"New Orleans Pelicans","Naji Marshall",1,8,9,8,2,10.7
0,0,0,1,0,3,2,0,0,"10",0,1,4,0,0,0,1037772,"2023-11-18T00:00:00.000Z",19,FALSE,18,17896021,"F",19,19,"New Orleans Pelicans","Jeremiah Robinson-Earl",0,4,4,4,0,4
1,0,3,4,3,5,3,1,1,"27",0,1,10,3,1,3,1037772,"2023-11-18T00:00:00.000Z",19,FALSE,18,17896017,"F",19,19,"New Orleans Pelicans","Matt Ryan",1,13,14,11,4,15.1
4,0,3,10,5,19,9,0,0,"30",0,6,23,3,0,3,1037772,"2023-11-18T00:00:00.000Z",19,FALSE,18,3547238,"G",18,18,"Minnesota Timberwolves","Anthony Edwards",0,26,30,27,7,29.6
5,0,3,5,1,8,2,0,0,"30",0,1,5,3,1,3,1037772,"2023-11-18T00:00:00.000Z",19,FALSE,18,104,"G",18,18,"Minnesota Timberwolves","Mike Conley",1,8,13,10,8,16.1
3,1,1,4,2,7,4,0,0,"18",0,2,10,1,1,2,1037772,"2023-11-18T00:00:00.000Z",19,FALSE,18,666400,"G",18,18,"Minnesota Timberwolves","Nickeil Alexander-Walker",2,11,14,13,4,19.7
5,2,4,0,0,7,4,2,1,"26",1,0,9,5,1,1,1037772,"2023-11-18T00:00:00.000Z",19,FALSE,18,12,"F",18,18,"Minnesota Timberwolves","Kyle Anderson",3,14,19,14,10,30.5
0,0,0,0,0,0,0,0,0,"00",0,0,0,0,0,0,1037772,"2023-11-18T00:00:00.000Z",19,FALSE,18,68,"F",18,18,"Minnesota Timberwolves","Troy Brown Jr.",0,0,0,0,0,0
1,0,1,2,0,6,2,4,4,"16",0,2,8,1,1,1,1037772,"2023-11-18T00:00:00.000Z",19,FALSE,18,320,"G",18,18,"Minnesota Timberwolves","Shake Milton",1,9,10,9,2,12.7
0,0,0,0,0,0,0,0,0,"00",0,0,0,0,0,0,1037772,"2023-11-18T00:00:00.000Z",19,FALSE,18,38017715,"F",18,18,"Minnesota Timberwolves","Josh Minott",0,0,0,0,0,0
0,0,0,0,0,0,0,0,0,"00",0,0,0,0,0,0,1037772,"2023-11-18T00:00:00.000Z",19,FALSE,18,17895968,"F",18,18,"Minnesota Timberwolves","Daishen Nix",0,0,0,0,0,0
0,1,1,6,2,8,2,2,2,"19",0,0,8,1,0,1,1037772,"2023-11-18T00:00:00.000Z",19,FALSE,18,667378,"F-C",18,18,"Minnesota Timberwolves","Naz Reid",1,9,9,8,1,11.2
0,0,4,0,0,4,1,0,0,"13",3,3,2,7,1,1,1037772,"2023-11-18T00:00:00.000Z",19,FALSE,18,491,"C",19,19,"New Orleans Pelicans","Cody Zeller",1,9,9,2,7,12.4
0,0,0,0,0,0,0,0,0,"00",0,0,0,0,0,0,1037772,"2023-11-18T00:00:00.000Z",19,FALSE,18,17896097,"G",19,19,"New Orleans Pelicans","Jose Alvarado",0,0,0,0,0,0
0,0,0,0,0,0,0,0,0,"00",0,0,0,0,0,0,1037772,"2023-11-18T00:00:00.000Z",19,FALSE,18,3547260,"G",19,19,"New Orleans Pelicans","Kira Lewis Jr.",0,0,0,0,0,0
0,0,0,0,0,0,0,0,0,"00",0,0,0,0,0,0,1037772,"2023-11-18T00:00:00.000Z",19,FALSE,18,666969,"F",19,19,"New Orleans Pelicans","Zion Williamson",0,0,0,0,0,0
0,0,0,0,0,0,0,0,0,"00",0,0,0,0,0,0,1037772,"2023-11-18T00:00:00.000Z",19,FALSE,18,38017663,"F",19,19,"New Orleans Pelicans","E.J. Liddell",0,0,0,0,0,0
0,0,0,0,0,0,0,0,0,"00",0,0,0,0,0,0,1037772,"2023-11-18T00:00:00.000Z",19,FALSE,18,303,"G",19,19,"New Orleans Pelicans","CJ McCollum",0,0,0,0,0,0
0,0,0,0,0,0,0,0,0,"00",0,0,0,0,0,0,1037772,"2023-11-18T00:00:00.000Z",19,FALSE,18,18677986,"F",19,19,"New Orleans Pelicans","Trey Murphy III",0,0,0,0,0,0
0,0,0,0,0,0,0,0,0,"00",0,0,0,0,0,0,1037772,"2023-11-18T00:00:00.000Z",19,FALSE,18,340,"F",19,19,"New Orleans Pelicans","Larry Nance Jr.",0,0,0,0,0,0
4,0,3,4,2,12,6,13,9,"40",1,1,23,4,1,3,1037773,"2023-11-18T00:00:00.000Z",5,FALSE,16,125,"G",5,5,"Chicago Bulls","DeMar DeRozan",1,27,31,27,8,33.8
3,1,0,4,2,8,4,2,1,"29",1,2,11,1,1,1,1037773,"2023-11-18T00:00:00.000Z",5,FALSE,16,89,"G",5,5,"Chicago Bulls","Alex Caruso",2,12,15,14,4,21.7
0,1,7,5,1,14,7,0,0,"33",1,2,15,8,1,2,1037773,"2023-11-18T00:00:00.000Z",5,FALSE,16,460,"C",5,5,"Chicago Bulls","Nikola Vucevic",2,23,23,15,8,28.6
6,1,8,7,3,10,5,0,0,"35",0,2,13,8,3,1,1037773,"2023-11-18T00:00:00.000Z",5,FALSE,16,268,"G",5,5,"Chicago Bulls","Zach LaVine",4,21,27,19,14,42.6
5,0,3,10,4,13,5,0,0,"29",0,5,14,3,1,3,1037773,"2023-11-18T00:00:00.000Z",5,FALSE,16,666956,"G",5,5,"Chicago Bulls","Coby White",1,17,22,19,8,25.1
2,0,1,4,1,6,3,0,0,"26",0,0,7,1,1,0,1037773,"2023-11-18T00:00:00.000Z",5,FALSE,16,391,"G-F",16,16,"Miami Heat","Josh Richardson",1,8,10,9,3,14.2
0,0,0,0,0,0,0,0,0,"00",0,0,0,0,0,0,1037773,"2023-11-18T00:00:00.000Z",5,FALSE,16,39398582,"C",16,16,"Miami Heat","Orlando Robinson",0,0,0,0,0,0
0,0,0,0,0,0,0,0,0,"00",0,0,0,0,0,0,1037773,"2023-11-18T00:00:00.000Z",5,FALSE,16,19465585,"G",16,16,"Miami Heat","Dru Smith",0,0,0,0,0,0
0,0,0,0,0,0,0,0,0,"00",0,0,0,0,0,0,1037773,"2023-11-18T00:00:00.000Z",5,FALSE,16,38017734,"F",16,16,"Miami Heat","Jamal Cain",0,0,0,0,0,0
0,0,0,0,0,0,0,0,0,"00",0,0,0,0,0,0,1037773,"2023-11-18T00:00:00.000Z",5,FALSE,16,3547257,"G",16,16,"Miami Heat","R.J. Hampton",0,0,0,0,0,0
0,0,0,0,0,0,0,0,0,"00",0,0,0,0,0,0,1037773,"2023-11-18T00:00:00.000Z",5,FALSE,16,666633,"G",16,16,"Miami Heat","Tyler Herro",0,0,0,0,0,0
0,0,0,0,0,0,0,0,0,"00",0,0,0,0,0,0,1037773,"2023-11-18T00:00:00.000Z",5,FALSE,16,38017696,"F",16,16,"Miami Heat","Nikola Jovic",0,0,0,0,0,0
7,0,3,5,4,9,5,4,3,"35",0,2,17,3,0,1,1037773,"2023-11-18T00:00:00.000Z",5,FALSE,16,397,"F",16,16,"Miami Heat","Duncan Robinson",0,20,27,24,10,30.1
5,0,3,7,2,10,3,0,0,"32",0,3,8,3,3,1,1037773,"2023-11-18T00:00:00.000Z",5,FALSE,16,286,"G",16,16,"Miami Heat","Kyle Lowry",3,11,16,13,8,27.1
0,0,0,0,0,0,0,0,0,"00",0,0,0,0,0,0,1037773,"2023-11-18T00:00:00.000Z",5,FALSE,16,74,"C",16,16,"Miami Heat","Thomas Bryant",0,0,0,0,0,0
0,0,2,1,1,4,2,2,1,"27",1,4,6,3,0,3,1037773,"2023-11-18T00:00:00.000Z",5,FALSE,16,56677785,"G",16,16,"Miami Heat","Jaime Jaquez Jr.",0,9,9,6,3,6.6
2,0,5,6,1,7,2,2,0,"12",1,2,5,6,0,0,1037773,"2023-11-18T00:00:00.000Z",5,FALSE,16,285,"F-C",16,16,"Miami Heat","Kevin Love",0,11,13,7,8,15.2
0,0,1,4,1,9,2,0,0,"15",1,1,5,2,1,1,1037773,"2023-11-18T00:00:00.000Z",5,FALSE,16,666747,"F",16,16,"Miami Heat","Caleb Martin",1,7,7,5,2,9.4
1,0,1,9,3,9,3,0,0,"14",0,2,9,1,0,0,1037773,"2023-11-18T00:00:00.000Z",5,FALSE,16,87,"G",5,5,"Chicago Bulls","Jevon Carter",0,10,11,10,2,11.7
2,1,4,3,1,5,3,0,0,"17",1,1,7,5,0,0,1037773,"2023-11-18T00:00:00.000Z",5,FALSE,16,110,"F",5,5,"Chicago Bulls","Torrey Craig",1,12,14,9,7,19
2,0,1,2,0,2,0,2,2,"13",0,2,2,1,0,1,1037773,"2023-11-18T00:00:00.000Z",5,FALSE,16,17895983,"G",5,5,"Chicago Bulls","Ayo Dosunmu",0,3,5,4,3,5.2
0,1,6,0,0,3,2,2,2,"15",3,3,6,9,1,1,1037773,"2023-11-18T00:00:00.000Z",5,FALSE,16,137,"C",5,5,"Chicago Bulls","Andre Drummond",2,15,15,6,9,21.8
0,0,0,0,0,0,0,0,0,"00",0,0,0,0,0,0,1037773,"2023-11-18T00:00:00.000Z",5,FALSE,16,17896116,"G",5,5,"Chicago Bulls","Terry Taylor",0,0,0,0,0,0
0,0,0,0,0,0,0,0,0,"00",0,0,0,0,0,0,1037773,"2023-11-18T00:00:00.000Z",5,FALSE,16,38017719,"F",5,5,"Chicago Bulls","Dalen Terry",0,0,0,0,0,0
1,1,1,1,0,5,1,0,0,"15",3,2,2,4,1,0,1037773,"2023-11-18T00:00:00.000Z",5,FALSE,16,3547248,"F",5,5,"Chicago Bulls","Patrick Williams",2,6,7,3,5,14.3
0,0,0,0,0,0,0,0,0,"00",0,0,0,0,0,0,1037773,"2023-11-18T00:00:00.000Z",5,FALSE,16,27,"G",5,5,"Chicago Bulls","Lonzo Ball",0,0,0,0,0,0
0,0,0,0,0,0,0,0,0,"00",0,0,0,0,0,0,1037773,"2023-11-18T00:00:00.000Z",5,FALSE,16,38017736,"F",16,16,"Miami Heat","Cole Swider",0,0,0,0,0,0
0,0,0,0,0,0,0,0,0,"00",0,0,0,0,0,0,1037773,"2023-11-18T00:00:00.000Z",5,FALSE,16,56677874,"F",5,5,"Chicago Bulls","Onuralp Bitim",0,0,0,0,0,0
0,0,0,0,0,0,0,0,0,"00",0,0,0,0,0,0,1037773,"2023-11-18T00:00:00.000Z",5,FALSE,16,45969255,"F",5,5,"Chicago Bulls","Justin Lewis",0,0,0,0,0,0
0,0,0,0,0,0,0,0,0,"00",0,0,0,0,0,0,1037773,"2023-11-18T00:00:00.000Z",5,FALSE,16,56677857,"F",5,5,"Chicago Bulls","Julian Phillips",0,0,0,0,0,0
0,0,0,0,0,0,0,0,0,"00",0,0,0,0,0,0,1037773,"2023-11-18T00:00:00.000Z",5,FALSE,16,56677860,"F",5,5,"Chicago Bulls","Adama Sanogo",0,0,0,0,0,0
2,0,3,6,2,16,8,7,7,"33",0,2,25,3,1,2,1037773,"2023-11-18T00:00:00.000Z",5,FALSE,16,79,"G-F",16,16,"Miami Heat","Jimmy Butler",1,28,30,27,5,32.6
0,0,2,3,0,4,0,0,0,"24",1,1,0,3,3,4,1037773,"2023-11-18T00:00:00.000Z",5,FALSE,16,3092,"",16,16,"Miami Heat","Haywood Highsmith",3,3,3,0,3,8.6
5,0,9,0,0,12,8,8,8,"36",1,3,24,10,0,3,1037773,"2023-11-18T00:00:00.000Z",5,FALSE,16,4,"C-F",16,16,"Miami Heat","Bam Adebayo",0,34,39,29,15,40.5
2,0,0,0,0,1,0,0,0,"12",0,1,0,0,0,0,1037774,"2023-11-18T00:00:00.000Z",17,FALSE,7,56677852,"G",17,17,"Milwaukee Bucks","Andre Jackson Jr.",0,0,2,2,2,3
7,1,12,3,1,26,18,5,3,"38",2,3,40,14,2,3,1037774,"2023-11-18T00:00:00.000Z",17,FALSE,7,15,"F",17,17,"Milwaukee Bucks","Giannis Antetokounmpo",3,54,61,47,21,73.3
0,2,3,6,1,8,3,5,5,"34",0,1,12,3,1,0,1037774,"2023-11-18T00:00:00.000Z",17,FALSE,7,283,"C",17,17,"Milwaukee Bucks","Brook Lopez",3,15,15,12,3,24.6
0,0,7,6,1,9,3,0,0,"34",0,3,7,7,1,0,1037774,"2023-11-18T00:00:00.000Z",17,FALSE,7,38,"G",17,17,"Milwaukee Bucks","Malik Beasley",1,14,14,7,7,18.4
12,0,3,11,4,18,7,10,9,"38",0,2,27,3,1,1,1037774,"2023-11-18T00:00:00.000Z",17,FALSE,7,278,"G",17,17,"Milwaukee Bucks","Damian Lillard",1,30,42,39,15,50.6
0,0,0,0,0,0,0,0,0,"00",0,0,0,0,0,0,1037774,"2023-11-18T00:00:00.000Z",17,FALSE,7,2148,"",17,17,"Milwaukee Bucks","Thanasis Antetokounmpo",0,0,0,0,0,0
3,0,2,9,4,12,6,0,0,"34",2,1,16,4,2,1,1037774,"2023-11-18T00:00:00.000Z",17,FALSE,7,105,"G",17,17,"Milwaukee Bucks","Pat Connaughton",2,20,23,19,7,30.3
1,0,0,4,2,5,3,0,0,"11",0,1,8,0,0,0,1037774,"2023-11-18T00:00:00.000Z",17,FALSE,7,38017733,"G",17,17,"Milwaukee Bucks","A.J. Green",0,8,9,9,1,9.5
2,0,2,4,3,5,4,0,0,"17",0,4,11,2,1,0,1037774,"2023-11-18T00:00:00.000Z",17,FALSE,7,368,"G",17,17,"Milwaukee Bucks","Cameron Payne",1,13,15,13,4,19.4
2,0,6,2,1,10,5,0,0,"22",1,0,11,7,0,0,1037774,"2023-11-18T00:00:00.000Z",17,FALSE,7,377,"F",17,17,"Milwaukee Bucks","Bobby Portis",0,18,20,13,9,22.4
0,0,0,0,0,0,0,0,0,"00",0,0,0,0,0,0,1037774,"2023-11-18T00:00:00.000Z",17,FALSE,7,112,"F",17,17,"Milwaukee Bucks","Jae Crowder",0,0,0,0,0,0
0,0,0,0,0,0,0,0,0,"00",0,0,0,0,0,0,1037774,"2023-11-18T00:00:00.000Z",17,FALSE,7,56677854,"F",17,17,"Milwaukee Bucks","Chris Livingston",0,0,0,0,0,0
0,0,0,0,0,0,0,0,0,"00",0,0,0,0,0,0,1037774,"2023-11-18T00:00:00.000Z",17,FALSE,7,315,"F",17,17,"Milwaukee Bucks","Khris Middleton",0,0,0,0,0,0
1,0,6,2,0,7,0,0,0,"19",2,1,0,8,0,2,1037774,"2023-11-18T00:00:00.000Z",17,FALSE,7,247,"F-G",7,7,"Dallas Mavericks","Derrick Jones Jr.",0,8,9,1,9,9.1
2,1,4,10,4,11,5,0,0,"38",3,1,14,7,0,1,1037774,"2023-11-18T00:00:00.000Z",17,FALSE,7,666965,"F",7,7,"Dallas Mavericks","Grant Williams",1,21,23,16,9,27.4
2,1,7,0,0,4,3,0,0,"24",3,5,6,10,0,3,1037774,"2023-11-18T00:00:00.000Z",17,FALSE,7,56677840,"C",7,7,"Dallas Mavericks","Dereck Lively II",1,16,18,8,12,21
6,0,3,10,3,29,16,4,4,"34",1,4,39,4,1,2,1037774,"2023-11-18T00:00:00.000Z",17,FALSE,7,228,"G",7,7,"Dallas Mavericks","Kyrie Irving",1,43,49,45,10,53.8
9,0,8,9,4,26,15,4,1,"35",1,1,35,9,0,3,1037774,"2023-11-18T00:00:00.000Z",17,FALSE,7,132,"F-G",7,7,"Dallas Mavericks","Luka Doncic",0,44,53,44,18,56.3
0,0,1,1,0,2,1,0,0,"09",0,0,2,1,0,0,1037774,"2023-11-18T00:00:00.000Z",17,FALSE,7,114,"G",7,7,"Dallas Mavericks","Seth Curry",0,3,3,2,1,3.2
1,0,1,2,0,5,3,0,0,"11",0,0,6,1,0,0,1037774,"2023-11-18T00:00:00.000Z",17,FALSE,7,151,"G",7,7,"Dallas Mavericks","Dante Exum",0,7,8,7,2,8.7
3,0,3,3,1,3,1,0,0,"20",1,1,3,4,0,0,1037774,"2023-11-18T00:00:00.000Z",17,FALSE,7,3547258,"G",7,7,"Dallas Mavericks","Josh Green",0,7,10,6,7,12.3
2,0,2,10,4,14,6,1,1,"26",0,0,17,2,0,1,1037774,"2023-11-18T00:00:00.000Z",17,FALSE,7,191,"G",7,7,"Dallas Mavericks","Tim Hardaway Jr.",0,19,21,19,4,21.4
0,0,0,0,0,0,0,0,0,"00",0,0,0,0,0,0,1037774,"2023-11-18T00:00:00.000Z",17,FALSE,7,38017679,"G",7,7,"Dallas Mavericks","Jaden Hardy",0,0,0,0,0,0
1,0,3,0,0,2,1,1,1,"24",0,3,3,3,0,0,1037774,"2023-11-18T00:00:00.000Z",17,FALSE,7,379,"F-C",7,7,"Dallas Mavericks","Dwight Powell",0,6,7,4,4,8.1
0,0,0,0,0,0,0,0,0,"00",0,0,0,0,0,0,1037774,"2023-11-18T00:00:00.000Z",17,FALSE,7,56677859,"F",7,7,"Dallas Mavericks","Olivier-Maxence Prosper",0,0,0,0,0,0
0,0,0,0,0,0,0,0,0,"00",0,0,0,0,0,0,1037774,"2023-11-18T00:00:00.000Z",17,FALSE,7,17896028,"F",7,7,"Dallas Mavericks","Greg Brown III",0,0,0,0,0,0
0,0,0,0,0,0,0,0,0,"00",0,0,0,0,0,0,1037774,"2023-11-18T00:00:00.000Z",17,FALSE,7,56677873,"G",7,7,"Dallas Mavericks","Dexter Dennis",0,0,0,0,0,0
0,0,0,0,0,0,0,0,0,"00",0,0,0,0,0,0,1037774,"2023-11-18T00:00:00.000Z",17,FALSE,7,257,"F",7,7,"Dallas Mavericks","Maxi Kleber",0,0,0,0,0,0
0,0,0,0,0,0,0,0,0,"00",0,0,0,0,0,0,1037774,"2023-11-18T00:00:00.000Z",17,FALSE,7,17554004,"G",7,7,"Dallas Mavericks","AJ Lawson",0,0,0,0,0,0
0,0,0,0,0,0,0,0,0,"00",0,0,0,0,0,0,1037774,"2023-11-18T00:00:00.000Z",17,FALSE,7,666453,"C",17,17,"Milwaukee Bucks","Marques Bolden",0,0,0,0,0,0
0,0,0,0,0,0,0,0,0,"00",0,0,0,0,0,0,1037774,"2023-11-18T00:00:00.000Z",17,FALSE,7,284,"C",17,17,"Milwaukee Bucks","Robin Lopez",0,0,0,0,0,0
0,0,0,0,0,0,0,0,0,"00",0,0,0,0,0,0,1037774,"2023-11-18T00:00:00.000Z",17,FALSE,7,38017691,"G",17,17,"Milwaukee Bucks","TyTy Washington Jr.",0,0,0,0,0,0
0,0,0,0,0,0,0,0,0,"00",0,0,0,0,0,0,1037774,"2023-11-18T00:00:00.000Z",17,FALSE,7,666960,"G",17,17,"Milwaukee Bucks","Lindell Wigginton",0,0,0,0,0,0
0,0,0,0,0,0,0,0,0,"00",0,0,0,0,0,0,1037774,"2023-11-18T00:00:00.000Z",17,FALSE,7,38017676,"F",17,17,"Milwaukee Bucks","MarJon Beauchamp",0,0,0,0,0,0
0,0,0,0,0,0,0,0,0,"00",0,0,0,0,0,0,1037774,"2023-11-18T00:00:00.000Z",17,FALSE,7,217,"F-C",7,7,"Dallas Mavericks","Richaun Holmes",0,0,0,0,0,0
0,0,0,0,0,0,0,0,0,"00",0,0,0,0,0,0,1037774,"2023-11-18T00:00:00.000Z",17,FALSE,7,329,"F",7,7,"Dallas Mavericks","Markieff Morris",0,0,0,0,0,0
3,0,0,1,0,4,1,1,0,"21",0,1,2,0,0,1,1037775,"2023-11-18T00:00:00.000Z",27,FALSE,15,3547274,"G",27,27,"San Antonio Spurs","Tre Jones",0,2,5,5,3,5.5
1,1,2,2,1,5,2,0,0,"11",0,3,5,2,0,1,1037775,"2023-11-18T00:00:00.000Z",27,FALSE,15,17896059,"F",27,27,"San Antonio Spurs","Sandro Mamukelashvili",1,7,8,6,3,10.9
2,0,0,3,1,5,2,0,0,"16",0,3,5,0,1,0,1037775,"2023-11-18T00:00:00.000Z",27,FALSE,15,305,"F",27,27,"San Antonio Spurs","Doug McDermott",1,5,7,7,2,11
1,0,3,7,3,10,4,2,2,"24",2,1,13,5,1,1,1037775,"2023-11-18T00:00:00.000Z",27,FALSE,15,359,"F",27,27,"San Antonio Spurs","Cedi Osman",1,18,19,14,6,22.5
0,0,0,0,0,0,0,0,0,"00",0,0,0,0,0,0,1037775,"2023-11-18T00:00:00.000Z",27,FALSE,15,38017693,"G",27,27,"San Antonio Spurs","Blake Wesley",0,0,0,0,0,0
0,0,0,0,0,0,0,0,0,"00",0,0,0,0,0,0,1037775,"2023-11-18T00:00:00.000Z",27,FALSE,15,56677865,"C",27,27,"San Antonio Spurs","Charles Bediako",0,0,0,0,0,0
1,0,3,7,4,14,8,3,2,"34",0,1,22,3,0,0,1037775,"2023-11-18T00:00:00.000Z",27,FALSE,15,666682,"F",27,27,"San Antonio Spurs","Keldon Johnson",0,25,26,23,4,27.1
4,8,9,6,2,17,6,6,5,"31",4,5,19,13,1,2,1037775,"2023-11-18T00:00:00.000Z",27,FALSE,15,56677822,"F-C",27,27,"San Antonio Spurs","Victor Wembanyama",9,32,36,23,17,65.6
6,0,3,3,1,8,4,8,7,"26",4,6,16,7,0,3,1037775,"2023-11-18T00:00:00.000Z",27,FALSE,15,102,"F-C",27,27,"San Antonio Spurs","Zach Collins",0,23,29,22,13,30.4
2,0,2,6,2,6,2,0,0,"20",0,0,6,2,0,1,1037775,"2023-11-18T00:00:00.000Z",27,FALSE,15,38017649,"F",27,27,"San Antonio Spurs","Julian Champagnie",0,8,10,8,4,10.4
3,0,3,2,1,8,5,6,5,"32",2,3,16,5,2,3,1037775,"2023-11-18T00:00:00.000Z",27,FALSE,15,38017699,"F",27,27,"San Antonio Spurs","Jeremy Sochan",2,21,24,19,8,29.5
0,0,1,0,0,0,0,0,0,"03",0,0,0,1,0,0,1037775,"2023-11-18T00:00:00.000Z",27,FALSE,15,38017730,"F",27,27,"San Antonio Spurs","Dominick Barlow",0,1,1,0,1,1.2
0,0,1,0,0,0,0,0,0,"04",0,3,0,1,0,1,1037775,"2023-11-18T00:00:00.000Z",27,FALSE,15,17895854,"G",27,27,"San Antonio Spurs","Charles Bassey",0,1,1,0,1,0.2
3,0,1,3,0,6,2,0,0,"18",0,2,4,1,0,2,1037775,"2023-11-18T00:00:00.000Z",27,FALSE,15,38017692,"F",27,27,"San Antonio Spurs","Malaki Branham",0,5,8,7,4,7.7
0,0,0,0,0,0,0,0,0,"00",0,0,0,0,0,0,1037775,"2023-11-18T00:00:00.000Z",27,FALSE,15,56677817,"G",27,27,"San Antonio Spurs","Sidy Cissoko",0,0,0,0,0,0
0,0,0,0,0,0,0,0,0,"00",0,0,0,0,0,0,1037775,"2023-11-18T00:00:00.000Z",27,FALSE,15,180,"G",27,27,"San Antonio Spurs","Devonte' Graham",0,0,0,0,0,0
4,0,8,0,0,9,7,1,0,"31",1,4,14,9,0,1,1037775,"2023-11-18T00:00:00.000Z",27,FALSE,15,48,"C",15,15,"Memphis Grizzlies","Bismack Biyombo",0,23,27,18,13,29.8
2,1,3,4,1,5,2,0,0,"23",0,2,5,3,1,1,1037775,"2023-11-18T00:00:00.000Z",27,FALSE,15,666703,"G-F",15,15,"Memphis Grizzlies","John Konchar",2,8,10,7,5,16.6
1,0,0,2,1,2,1,0,0,"12",0,3,3,0,0,0,1037775,"2023-11-18T00:00:00.000Z",27,FALSE,15,48248287,"G",15,15,"Memphis Grizzlies","Jacob Gilyard",0,3,4,4,1,4.5
3,1,8,5,1,15,7,3,2,"36",2,2,17,10,1,3,1037775,"2023-11-18T00:00:00.000Z",27,FALSE,15,17896067,"F",15,15,"Memphis Grizzlies","Santi Aldama",2,27,30,20,13,36.5
1,0,2,3,0,5,0,2,0,"26",2,1,0,4,2,1,1037775,"2023-11-18T00:00:00.000Z",27,FALSE,15,38017729,"F",15,15,"Memphis Grizzlies","David Roddy",2,4,5,1,5,11.3
1,0,1,1,1,4,3,3,2,"14",0,1,9,1,0,0,1037775,"2023-11-18T00:00:00.000Z",27,FALSE,15,401,"G",15,15,"Memphis Grizzlies","Derrick Rose",0,10,11,10,2,11.7
0,0,0,0,0,0,0,0,0,"00",0,0,0,0,0,0,1037775,"2023-11-18T00:00:00.000Z",27,FALSE,15,56677870,"G",27,27,"San Antonio Spurs","Sir'Jabari Rice",0,0,0,0,0,0
0,0,0,0,0,0,0,0,0,"00",0,0,0,0,0,0,1037775,"2023-11-18T00:00:00.000Z",27,FALSE,15,3547246,"G-F",27,27,"San Antonio Spurs","Devin Vassell",0,0,0,0,0,0
4,0,2,6,3,15,8,7,7,"34",3,5,26,5,1,2,1037775,"2023-11-18T00:00:00.000Z",27,FALSE,15,3547287,"G",15,15,"Memphis Grizzlies","Desmond Bane",1,31,35,30,9,39
0,1,2,8,2,20,7,12,11,"27",3,3,27,5,1,2,1037775,"2023-11-18T00:00:00.000Z",27,FALSE,15,231,"F-C",15,15,"Memphis Grizzlies","Jaren Jackson Jr.",2,32,32,27,5,37
2,0,1,1,0,3,1,0,0,"12",0,3,2,1,0,1,1037775,"2023-11-18T00:00:00.000Z",27,FALSE,15,38017732,"F",15,15,"Memphis Grizzlies","Kenneth Lofton Jr.",0,3,5,4,3,5.2
0,0,0,0,0,0,0,0,0,"00",0,0,0,0,0,0,1037775,"2023-11-18T00:00:00.000Z",27,FALSE,15,38017728,"F",15,15,"Memphis Grizzlies","Jake LaRavia",0,0,0,0,0,0
0,0,0,0,0,0,0,0,0,"00",0,0,0,0,0,0,1037775,"2023-11-18T00:00:00.000Z",27,FALSE,15,38017731,"G",15,15,"Memphis Grizzlies","Vince Williams Jr.",0,0,0,0,0,0
5,0,6,3,2,8,4,8,7,"25",1,1,17,7,1,1,1037775,"2023-11-18T00:00:00.000Z",27,FALSE,15,17896027,"G-F",15,15,"Memphis Grizzlies","Ziaire Williams",1,24,29,22,12,34.9
0,0,0,0,0,0,0,0,0,"00",0,0,0,0,0,0,1037775,"2023-11-18T00:00:00.000Z",27,FALSE,15,3,"C",15,15,"Memphis Grizzlies","Steven Adams",0,0,0,0,0,0
0,0,0,0,0,0,0,0,0,"00",0,0,0,0,0,0,1037775,"2023-11-18T00:00:00.000Z",27,FALSE,15,666505,"F",15,15,"Memphis Grizzlies","Brandon Clarke",0,0,0,0,0,0
0,0,0,0,0,0,0,0,0,"00",0,0,0,0,0,0,1037775,"2023-11-18T00:00:00.000Z",27,FALSE,15,56677830,"F",15,15,"Memphis Grizzlies","GG Jackson",0,0,0,0,0,0
0,0,0,0,0,0,0,0,0,"00",0,0,0,0,0,0,1037775,"2023-11-18T00:00:00.000Z",27,FALSE,15,254,"G",15,15,"Memphis Grizzlies","Luke Kennard",0,0,0,0,0,0
0,0,0,0,0,0,0,0,0,"00",0,0,0,0,0,0,1037775,"2023-11-18T00:00:00.000Z",27,FALSE,15,666786,"G",15,15,"Memphis Grizzlies","Ja Morant",0,0,0,0,0,0
0,0,0,0,0,0,0,0,0,"00",0,0,0,0,0,0,1037775,"2023-11-18T00:00:00.000Z",27,FALSE,15,420,"G",15,15,"Memphis Grizzlies","Marcus Smart",0,0,0,0,0,0
0,0,0,0,0,0,0,0,0,"00",0,0,0,0,0,0,1037775,"2023-11-18T00:00:00.000Z",27,FALSE,15,3547285,"F",15,15,"Memphis Grizzlies","Xavier Tillman",0,0,0,0,0,0
0,0,0,0,0,0,0,0,0,"00",0,0,0,0,0,0,1037776,"2023-11-18T00:00:00.000Z",10,FALSE,21,398,"G",10,10,"Golden State Warriors","Jerome Robinson",0,0,0,0,0,0
2,0,6,4,1,6,1,0,0,"27",1,2,3,7,0,0,1037776,"2023-11-18T00:00:00.000Z",10,FALSE,21,666541,"G",21,21,"Oklahoma City Thunder","Luguentz Dort",0,10,12,5,9,14.4
3,0,6,2,0,16,8,6,6,"41",0,2,22,6,1,1,1037776,"2023-11-18T00:00:00.000Z",10,FALSE,21,38017703,"G-F",21,21,"Oklahoma City Thunder","Jalen Williams",1,28,31,25,9,35.7
5,1,6,5,2,22,14,7,6,"37",4,2,36,10,2,4,1037776,"2023-11-18T00:00:00.000Z",10,FALSE,21,38017685,"C-F",21,21,"Oklahoma City Thunder","Chet Holmgren",3,46,51,41,15,60.5
2,2,3,2,1,10,4,2,2,"22",2,2,11,5,1,0,1037776,"2023-11-18T00:00:00.000Z",10,FALSE,21,17896065,"G",21,21,"Oklahoma City Thunder","Josh Giddey",3,16,18,13,7,29
6,2,5,3,2,29,18,2,2,"41",1,1,40,6,2,3,1037776,"2023-11-18T00:00:00.000Z",10,FALSE,21,175,"G",21,21,"Oklahoma City Thunder","Shai Gilgeous-Alexander",4,46,52,46,12,65.2
0,0,0,0,0,0,0,0,0,"00",0,0,0,0,0,0,1037776,"2023-11-18T00:00:00.000Z",10,FALSE,21,44,"F",21,21,"Oklahoma City Thunder","Davis Bertans",0,0,0,0,0,0
3,1,4,4,2,9,4,0,0,"27",0,2,10,4,1,0,1037776,"2023-11-18T00:00:00.000Z",10,FALSE,21,3547272,"G",21,21,"Oklahoma City Thunder","Isaiah Joe",2,14,17,13,7,25.3
0,0,0,0,0,0,0,0,0,"00",0,0,0,0,0,0,1037776,"2023-11-18T00:00:00.000Z",10,FALSE,21,17896036,"G",21,21,"Oklahoma City Thunder","Tre Mann",0,0,0,0,0,0
1,0,0,0,0,1,1,0,0,"08",0,0,2,0,0,0,1037776,"2023-11-18T00:00:00.000Z",10,FALSE,21,4197029,"G",21,21,"Oklahoma City Thunder","Vasilije Micic",0,2,3,3,1,3.5
0,0,0,0,0,0,0,0,0,"00",0,0,0,0,0,0,1037776,"2023-11-18T00:00:00.000Z",10,FALSE,21,3547271,"C",21,21,"Oklahoma City Thunder","Aleksej Pokusevski",0,0,0,0,0,0
2,0,1,2,0,3,1,1,1,"28",0,3,3,1,0,0,1037776,"2023-11-18T00:00:00.000Z",10,FALSE,21,56677833,"G",21,21,"Oklahoma City Thunder","Cason Wallace",0,4,6,5,3,7.2
1,0,2,0,0,0,0,0,0,"06",0,0,0,2,0,2,1037776,"2023-11-18T00:00:00.000Z",10,FALSE,21,17896078,"G",21,21,"Oklahoma City Thunder","Aaron Wiggins",0,2,3,1,3,1.9
1,0,3,1,0,3,0,2,1,"22",1,2,1,4,1,0,1037776,"2023-11-18T00:00:00.000Z",10,FALSE,21,480,"G-F",21,21,"Oklahoma City Thunder","Kenrich Williams",1,5,6,2,5,10.3
4,0,2,9,3,13,5,3,3,"36",0,4,16,2,0,4,1037776,"2023-11-18T00:00:00.000Z",10,FALSE,21,443,"G",10,10,"Golden State Warriors","Klay Thompson",0,18,22,20,6,20.4
3,1,1,8,5,19,12,4,2,"35",0,4,31,1,0,0,1037776,"2023-11-18T00:00:00.000Z",10,FALSE,21,475,"F-G",10,10,"Golden State Warriors","Andrew Wiggins",1,32,35,34,4,39.7
5,1,9,0,0,5,3,0,0,"35",5,0,6,14,1,1,1037776,"2023-11-18T00:00:00.000Z",10,FALSE,21,282,"F",10,10,"Golden State Warriors","Kevon Looney",2,20,25,11,19,35.3
11,1,3,7,4,9,4,0,0,"38",1,3,12,4,3,0,1037776,"2023-11-18T00:00:00.000Z",10,FALSE,21,367,"G",10,10,"Golden State Warriors","Chris Paul",4,16,27,23,15,45.3
3,0,6,11,5,21,8,4,4,"40",0,2,25,6,0,2,1037776,"2023-11-18T00:00:00.000Z",10,FALSE,21,115,"G",10,10,"Golden State Warriors","Stephen Curry",0,31,34,28,9,34.7
2,1,3,2,0,10,6,2,1,"20",2,2,13,5,1,3,1037776,"2023-11-18T00:00:00.000Z",10,FALSE,21,17553979,"F",10,10,"Golden State Warriors","Jonathan Kuminga",2,18,20,15,7,25
3,0,3,4,1,6,2,4,3,"25",1,0,8,4,0,3,1037776,"2023-11-18T00:00:00.000Z",10,FALSE,21,56677858,"G",10,10,"Golden State Warriors","Brandin Podziemski",0,12,15,11,7,14.3
1,0,6,2,0,9,3,0,0,"18",2,1,6,8,0,1,1037776,"2023-11-18T00:00:00.000Z",10,FALSE,21,407,"F",10,10,"Golden State Warriors","Dario Saric",0,14,15,7,9,16.1
1,0,2,3,0,4,1,4,4,"18",2,2,6,4,1,2,1037776,"2023-11-18T00:00:00.000Z",10,FALSE,21,17553992,"G",10,10,"Golden State Warriors","Moses Moody",1,10,11,7,5,13.3
0,0,0,0,0,0,0,0,0,"00",0,0,0,0,0,0,1037776,"2023-11-18T00:00:00.000Z",10,FALSE,21,185,"F",10,10,"Golden State Warriors","Draymond Green",0,0,0,0,0,0
0,0,0,0,0,0,0,0,0,"00",0,0,0,0,0,0,1037776,"2023-11-18T00:00:00.000Z",10,FALSE,21,251,"G",10,10,"Golden State Warriors","Cory Joseph",0,0,0,0,0,0
0,0,0,0,0,0,0,0,0,"00",0,0,0,0,0,0,1037776,"2023-11-18T00:00:00.000Z",10,FALSE,21,45658838,"G",10,10,"Golden State Warriors","Lester Quinones",0,0,0,0,0,0
0,0,0,0,0,0,0,0,0,"00",0,0,0,0,0,0,1037776,"2023-11-18T00:00:00.000Z",10,FALSE,21,57875092,"F",10,10,"Golden State Warriors","Gui Santos",0,0,0,0,0,0
0,0,0,0,0,0,0,0,0,"00",0,0,0,0,0,0,1037776,"2023-11-18T00:00:00.000Z",10,FALSE,21,17896070,"F",10,10,"Golden State Warriors","Usman Garuba",0,0,0,0,0,0
0,0,0,0,0,0,0,0,0,"00",0,0,0,0,0,0,1037776,"2023-11-18T00:00:00.000Z",10,FALSE,21,56677799,"F",10,10,"Golden State Warriors","Trayce Jackson-Davis",0,0,0,0,0,0
0,0,0,0,0,0,0,0,0,"00",0,0,0,0,0,0,1037776,"2023-11-18T00:00:00.000Z",10,FALSE,21,2189,"",10,10,"Golden State Warriors","Gary Payton II",0,0,0,0,0,0
0,0,2,0,0,1,1,0,0,"06",0,0,2,2,0,0,1037776,"2023-11-18T00:00:00.000Z",10,FALSE,21,38017706,"F",21,21,"Oklahoma City Thunder","Jaylin Williams",0,4,4,2,2,4.4
0,0,0,0,0,0,0,0,0,"00",0,0,0,0,0,0,1037776,"2023-11-18T00:00:00.000Z",10,FALSE,21,38017716,"F",21,21,"Oklahoma City Thunder","Ousmane Dieng",0,0,0,0,0,0
0,0,0,0,0,0,0,0,0,"00",0,0,0,0,0,0,1037776,"2023-11-18T00:00:00.000Z",10,FALSE,21,56677853,"F",21,21,"Oklahoma City Thunder","Keyontae Johnson",0,0,0,0,0,0
0,0,0,0,0,0,0,0,0,"00",0,0,0,0,0,0,1037776,"2023-11-18T00:00:00.000Z",10,FALSE,21,24572055,"C",21,21,"Oklahoma City Thunder","Olivier Sarr",0,0,0,0,0,0
0,0,0,0,0,0,0,0,0,"00",0,0,0,0,0,0,1037776,"2023-11-18T00:00:00.000Z",10,FALSE,21,27924547,"F",21,21,"Oklahoma City Thunder","Lindy Waters III",0,0,0,0,0,0
2,1,2,5,1,12,3,2,2,"28",3,2,9,5,0,2,1037777,"2023-11-19T00:00:00.000Z",3,FALSE,23,666679,"F",3,3,"Brooklyn Nets","Cameron Johnson",1,14,16,11,7,19
2,0,2,3,1,7,2,0,0,"27",1,2,5,3,0,1,1037777,"2023-11-19T00:00:00.000Z",3,FALSE,23,158,"F",3,3,"Brooklyn Nets","Dorian Finney-Smith",0,8,10,7,5,10.6
1,1,9,0,0,6,5,3,0,"23",0,3,10,9,0,2,1037777,"2023-11-19T00:00:00.000Z",3,FALSE,23,666508,"F-C",3,3,"Brooklyn Nets","Nicolas Claxton",1,19,20,11,10,23.3
3,0,1,2,2,12,8,0,0,"29",0,0,18,1,0,2,1037777,"2023-11-19T00:00:00.000Z",3,FALSE,23,61,"F",3,3,"Brooklyn Nets","Mikal Bridges",0,19,22,21,4,21.7
5,1,4,4,1,10,3,6,5,"28",0,0,12,4,0,2,1037777,"2023-11-19T00:00:00.000Z",3,FALSE,23,130,"G",3,3,"Brooklyn Nets","Spencer Dinwiddie",1,16,21,17,9,25.3
0,0,1,1,0,3,2,1,1,"06",0,1,5,1,0,0,1037777,"2023-11-19T00:00:00.000Z",3,FALSE,23,174,"F-C",3,3,"Brooklyn Nets","Harry Giles III",0,6,6,5,1,6.2
3,2,3,0,0,2,0,0,0,"25",1,1,0,4,1,1,1037777,"2023-11-19T00:00:00.000Z",3,FALSE,23,351,"F",3,3,"Brooklyn Nets","Royce O'Neale",3,4,7,3,7,17.3
2,2,6,0,0,3,3,0,0,"20",2,1,6,8,0,2,1037777,"2023-11-19T00:00:00.000Z",3,FALSE,23,17896038,"C",3,3,"Brooklyn Nets","Day'Ron Sharpe",2,14,16,8,10,22.6
0,0,0,0,0,0,0,0,0,"00",0,0,0,0,0,0,1037777,"2023-11-19T00:00:00.000Z",3,FALSE,23,421,"G",3,3,"Brooklyn Nets","Dennis Smith Jr.",0,0,0,0,0,0
0,0,0,0,0,0,0,0,0,"00",0,0,0,0,0,0,1037777,"2023-11-19T00:00:00.000Z",3,FALSE,23,17896048,"G",3,3,"Brooklyn Nets","Cam Thomas",0,0,0,0,0,0
2,0,6,11,6,17,9,2,2,"32",0,1,26,6,0,2,1037777,"2023-11-19T00:00:00.000Z",3,FALSE,23,464,"G",3,3,"Brooklyn Nets","Lonnie Walker IV",0,32,34,28,8,34.2
4,1,2,2,0,9,3,2,2,"22",2,3,8,4,1,1,1037777,"2023-11-19T00:00:00.000Z",3,FALSE,23,17896058,"F",3,3,"Brooklyn Nets","Trendon Watford",2,12,16,12,8,23.8
0,0,0,0,0,0,0,0,0,"00",0,0,0,0,0,0,1037777,"2023-11-19T00:00:00.000Z",3,FALSE,23,9051997,"G",3,3,"Brooklyn Nets","Armoni Brooks",0,0,0,0,0,0
0,0,0,0,0,0,0,0,0,"00",0,0,0,0,0,0,1037777,"2023-11-19T00:00:00.000Z",3,FALSE,23,56677843,"F",3,3,"Brooklyn Nets","Noah Clowney",0,0,0,0,0,0
0,0,0,0,0,0,0,0,0,"00",0,0,0,0,0,0,1037777,"2023-11-19T00:00:00.000Z",3,FALSE,23,17896041,"G",3,3,"Brooklyn Nets","Keon Johnson",0,0,0,0,0,0
0,0,0,0,0,0,0,0,0,"00",0,0,0,0,0,0,1037777,"2023-11-19T00:00:00.000Z",3,FALSE,23,417,"G-F",3,3,"Brooklyn Nets","Ben Simmons",0,0,0,0,0,0
0,0,0,0,0,0,0,0,0,"00",0,0,0,0,0,0,1037777,"2023-11-19T00:00:00.000Z",3,FALSE,23,56677841,"F",3,3,"Brooklyn Nets","Dariq Whitehead",0,0,0,0,0,0
0,0,0,0,0,0,0,0,0,"00",0,0,0,0,0,0,1037777,"2023-11-19T00:00:00.000Z",3,FALSE,23,56677722,"F",3,3,"Brooklyn Nets","Jalen Wilson",0,0,0,0,0,0
3,0,3,1,1,1,1,0,0,"24",0,2,3,3,0,0,1037777,"2023-11-19T00:00:00.000Z",3,FALSE,23,33,"F-G",23,23,"Philadelphia 76ers","Nicolas Batum",0,6,9,6,6,11.1
1,0,4,4,0,13,5,0,0,"32",1,0,10,5,2,0,1037777,"2023-11-19T00:00:00.000Z",3,FALSE,23,200,"F",23,23,"Philadelphia 76ers","Tobias Harris",2,15,16,11,6,23.5
9,1,10,2,1,24,11,10,9,"31",2,3,32,12,0,1,1037777,"2023-11-19T00:00:00.000Z",3,FALSE,23,145,"F-C",23,23,"Philadelphia 76ers","Joel Embiid",1,44,53,41,21,61.9
1,0,5,6,4,10,8,1,1,"27",0,3,21,5,3,1,1037777,"2023-11-19T00:00:00.000Z",3,FALSE,23,313,"G",23,23,"Philadelphia 76ers","De'Anthony Melton",3,26,27,22,6,36.5
10,0,1,11,6,20,8,3,3,"37",1,0,25,2,0,1,1037777,"2023-11-19T00:00:00.000Z",3,FALSE,23,3547254,"G",23,23,"Philadelphia 76ers","Tyrese Maxey",0,27,37,35,12,41.4
0,0,0,0,0,2,2,1,1,"03",0,0,5,0,0,0,1037777,"2023-11-19T00:00:00.000Z",3,FALSE,23,28,"C",23,23,"Philadelphia 76ers","Mo Bamba",0,5,5,5,0,5
0,0,0,2,0,3,1,1,1,"04",0,1,3,0,0,0,1037777,"2023-11-19T00:00:00.000Z",3,FALSE,23,260,"G-F",23,23,"Philadelphia 76ers","Furkan Korkmaz",0,3,3,3,0,3
0,0,1,1,1,1,1,0,0,"06",0,0,3,1,0,0,1037777,"2023-11-19T00:00:00.000Z",3,FALSE,23,328,"F",23,23,"Philadelphia 76ers","Marcus Morris",0,4,4,3,1,4.2
1,2,3,1,0,4,0,0,0,"14",1,2,0,4,0,0,1037777,"2023-11-19T00:00:00.000Z",3,FALSE,23,3547270,"F",23,23,"Philadelphia 76ers","Paul Reed",2,4,5,1,5,12.3
1,0,3,4,2,6,3,2,2,"21",2,1,10,5,1,0,1037777,"2023-11-19T00:00:00.000Z",3,FALSE,23,17896025,"G",23,23,"Philadelphia 76ers","Jaden Springer",1,15,16,11,6,20.5
0,0,0,0,0,0,0,0,0,"00",0,0,0,0,0,0,1037777,"2023-11-19T00:00:00.000Z",3,FALSE,23,56913527,"G",23,23,"Philadelphia 76ers","Ricky Council IV",0,0,0,0,0,0
0,0,0,0,0,0,0,0,0,"00",0,0,0,0,0,0,1037777,"2023-11-19T00:00:00.000Z",3,FALSE,23,360,"F",23,23,"Philadelphia 76ers","Kelly Oubre Jr.",0,0,0,0,0,0
0,0,0,0,0,0,0,0,0,"00",0,0,0,0,0,0,1037777,"2023-11-19T00:00:00.000Z",3,FALSE,23,17554001,"G",23,23,"Philadelphia 76ers","Javonte Smart",0,0,0,0,0,0
0,0,0,0,0,0,0,0,0,"00",0,0,0,0,0,0,1037777,"2023-11-19T00:00:00.000Z",3,FALSE,23,56677788,"G",23,23,"Philadelphia 76ers","Terquavion Smith",0,0,0,0,0,0
0,0,0,0,0,0,0,0,0,"04",1,1,0,1,0,0,1037777,"2023-11-19T00:00:00.000Z",3,FALSE,23,3547294,"F",23,23,"Philadelphia 76ers","Kenyon Martin Jr.",0,1,1,0,1,1.2
0,1,2,0,0,2,2,0,0,"11",0,1,4,2,1,0,1037777,"2023-11-19T00:00:00.000Z",3,FALSE,23,108,"F",23,23,"Philadelphia 76ers","Robert Covington",2,6,6,4,2,12.4
2,0,1,1,0,4,1,0,0,"12",0,1,2,1,0,1,1037777,"2023-11-19T00:00:00.000Z",3,FALSE,23,45,"G",23,23,"Philadelphia 76ers","Patrick Beverley",0,3,5,4,3,5.2
3,0,1,2,1,4,1,0,0,"14",2,3,3,3,1,0,1037777,"2023-11-19T00:00:00.000Z",3,FALSE,23,2175,"",23,23,"Philadelphia 76ers","Danuel House Jr.",1,6,9,6,6,14.1
3,0,6,3,1,12,4,5,5,"25",0,6,14,6,1,0,1037778,"2023-11-19T00:00:00.000Z",12,FALSE,22,38017686,"G-F",12,12,"Indiana Pacers","Bennedict Mathurin",1,20,23,17,9,28.7
2,0,2,3,0,8,3,0,0,"16",2,2,6,4,0,2,1037778,"2023-11-19T00:00:00.000Z",12,FALSE,22,3547243,"F",12,12,"Indiana Pacers","Obi Toppin",0,10,12,8,6,11.8
3,3,1,3,0,10,3,6,4,"23",3,2,10,4,1,1,1037778,"2023-11-19T00:00:00.000Z",12,FALSE,22,452,"C-F",12,12,"Indiana Pacers","Myles Turner",4,14,17,13,7,30.3
1,1,5,2,1,7,4,2,2,"22",0,3,11,5,0,1,1037778,"2023-11-19T00:00:00.000Z",12,FALSE,22,69,"G",12,12,"Indiana Pacers","Bruce Brown",1,16,17,12,6,20.5
3,1,2,3,1,14,4,3,3,"25",0,2,12,2,0,4,1037778,"2023-11-19T00:00:00.000Z",12,FALSE,22,3547245,"G",12,12,"Indiana Pacers","Tyrese Haliburton",1,14,17,15,5,17.9
2,0,1,4,1,4,1,0,0,"15",0,4,3,1,0,1,1037778,"2023-11-19T00:00:00.000Z",12,FALSE,22,210,"G",12,12,"Indiana Pacers","Buddy Hield",0,4,6,5,3,6.2
1,1,3,0,0,2,1,6,4,"12",1,2,6,4,3,0,1037778,"2023-11-19T00:00:00.000Z",12,FALSE,22,17896035,"F",12,12,"Indiana Pacers","Isaiah Jackson",4,10,11,7,5,24.3
5,0,3,1,0,9,5,3,1,"21",1,1,11,4,0,2,1037778,"2023-11-19T00:00:00.000Z",12,FALSE,22,304,"G",12,12,"Indiana Pacers","T.J. McConnell",0,15,20,16,9,21.3
0,0,1,0,0,2,0,0,0,"15",0,2,0,1,0,0,1037778,"2023-11-19T00:00:00.000Z",12,FALSE,22,3547250,"G-F",12,12,"Indiana Pacers","Aaron Nesmith",0,1,1,0,1,1.2
1,0,3,5,2,11,8,1,1,"23",2,3,19,5,2,1,1037778,"2023-11-19T00:00:00.000Z",12,FALSE,22,3547207,"F",12,12,"Indiana Pacers","Jordan Nwora",2,24,25,20,6,31.5
0,0,0,0,0,0,0,0,0,"00",0,0,0,0,0,0,1037778,"2023-11-19T00:00:00.000Z",12,FALSE,22,38017701,"G",12,12,"Indiana Pacers","Kendall Brown",0,0,0,0,0,0
0,0,0,0,0,0,0,0,0,"00",0,0,0,0,0,0,1037778,"2023-11-19T00:00:00.000Z",12,FALSE,22,38017507,"G-F",12,12,"Indiana Pacers","Andrew Nembhard",0,0,0,0,0,0
0,0,0,0,0,0,0,0,0,"00",0,0,0,0,0,0,1037778,"2023-11-19T00:00:00.000Z",12,FALSE,22,56677778,"F-C",12,12,"Indiana Pacers","Oscar Tshiebwe",0,0,0,0,0,0
0,0,0,0,0,0,0,0,0,"00",0,0,0,0,0,0,1037778,"2023-11-19T00:00:00.000Z",12,FALSE,22,56677794,"G",12,12,"Indiana Pacers","Isaiah Wong",0,0,0,0,0,0
1,0,6,2,0,14,6,7,7,"22",1,2,19,7,2,0,1037778,"2023-11-19T00:00:00.000Z",12,FALSE,22,17896026,"F",22,22,"Orlando Magic","Franz Wagner",2,26,27,20,8,34.9
0,2,2,0,0,14,9,7,6,"27",1,1,24,3,1,1,1037778,"2023-11-19T00:00:00.000Z",12,FALSE,22,38017683,"F",22,22,"Orlando Magic","Paolo Banchero",3,27,27,24,3,35.6
2,4,7,0,0,5,3,2,2,"22",1,2,8,8,1,0,1037778,"2023-11-19T00:00:00.000Z",12,FALSE,22,666442,"C",22,22,"Orlando Magic","Goga Bitadze",5,16,18,10,10,35.6
3,1,5,3,1,12,5,4,4,"25",0,4,15,5,0,4,1037778,"2023-11-19T00:00:00.000Z",12,FALSE,22,3547251,"G",22,22,"Orlando Magic","Cole Anthony",1,20,23,18,8,24.5
2,0,0,3,3,6,4,2,2,"22",0,1,13,0,2,0,1037778,"2023-11-19T00:00:00.000Z",12,FALSE,22,196,"G",22,22,"Orlando Magic","Gary Harris",2,13,15,15,2,22
2,0,0,1,0,1,0,0,0,"08",0,1,0,0,0,2,1037778,"2023-11-19T00:00:00.000Z",12,FALSE,22,38017724,"G",22,22,"Orlando Magic","Caleb Houstan",0,0,2,2,2,1
1,0,0,2,0,2,0,0,0,"07",0,0,0,0,0,2,1037778,"2023-11-19T00:00:00.000Z",12,FALSE,22,56677839,"G",22,22,"Orlando Magic","Jett Howard",0,0,1,1,1,-0.5
6,0,4,2,0,2,0,0,0,"18",0,1,0,4,2,2,1037778,"2023-11-19T00:00:00.000Z",12,FALSE,22,226,"F",22,22,"Orlando Magic","Joe Ingles",2,4,10,6,10,17.8
0,1,2,0,0,5,2,2,1,"14",1,1,5,3,1,0,1037778,"2023-11-19T00:00:00.000Z",12,FALSE,22,229,"F",22,22,"Orlando Magic","Jonathan Isaac",2,8,8,5,3,14.6
0,0,1,1,1,2,1,0,0,"08",0,0,3,1,0,0,1037778,"2023-11-19T00:00:00.000Z",12,FALSE,22,666818,"F",22,22,"Orlando Magic","Chuma Okeke",0,4,4,3,1,4.2
0,0,0,1,0,1,0,2,0,"05",0,1,0,0,0,1,1037778,"2023-11-19T00:00:00.000Z",12,FALSE,22,666885,"F",22,22,"Orlando Magic","Admiral Schofield",0,0,0,0,0,-1
2,0,0,1,1,10,6,4,3,"20",3,3,16,3,0,1,1037778,"2023-11-19T00:00:00.000Z",12,FALSE,22,462,"C",22,22,"Orlando Magic","Moritz Wagner",0,19,21,18,5,21.6
0,0,0,0,0,0,0,0,0,"00",0,0,0,0,0,0,1037778,"2023-11-19T00:00:00.000Z",12,FALSE,22,85,"F",22,22,"Orlando Magic","Wendell Carter Jr.",0,0,0,0,0,0
0,0,0,0,0,0,0,0,0,"00",0,0,0,0,0,0,1037778,"2023-11-19T00:00:00.000Z",12,FALSE,22,165,"G",22,22,"Orlando Magic","Markelle Fultz",0,0,0,0,0,0
0,0,0,0,0,0,0,0,0,"00",0,0,0,0,0,0,1037778,"2023-11-19T00:00:00.000Z",12,FALSE,22,38017607,"G",22,22,"Orlando Magic","Kevon Harris",0,0,0,0,0,0
0,0,0,0,0,0,0,0,0,"00",0,0,0,0,0,0,1037778,"2023-11-19T00:00:00.000Z",12,FALSE,22,17553983,"G",22,22,"Orlando Magic","Trevelin Queen",0,0,0,0,0,0
1,1,0,3,0,6,3,1,1,"14",0,2,7,0,1,1,1037778,"2023-11-19T00:00:00.000Z",12,FALSE,22,56677832,"F",12,12,"Indiana Pacers","Jarace Walker",2,7,8,8,1,13.5
0,0,2,1,1,5,4,2,1,"13",2,3,10,4,0,2,1037778,"2023-11-19T00:00:00.000Z",12,FALSE,22,3547264,"F-C",12,12,"Indiana Pacers","Jalen Smith",0,14,14,10,4,12.8
2,0,0,3,1,5,2,2,2,"16",0,0,7,0,2,1,1037778,"2023-11-19T00:00:00.000Z",12,FALSE,22,56677861,"G",12,12,"Indiana Pacers","Ben Sheppard",2,7,9,9,2,15
1,2,5,2,0,5,1,6,5,"24",0,5,7,5,0,2,1037778,"2023-11-19T00:00:00.000Z",12,FALSE,22,56677827,"G",22,22,"Orlando Magic","Anthony Black",2,12,13,8,6,18.5
1,0,2,2,1,8,6,6,5,"18",1,1,18,3,1,0,1037778,"2023-11-19T00:00:00.000Z",12,FALSE,22,17896073,"G",22,22,"Orlando Magic","Jalen Suggs",1,21,22,19,4,26.1
2,0,9,4,2,4,2,0,0,"24",1,1,6,10,2,0,1037779,"2023-11-19T00:00:00.000Z",6,FALSE,8,666940,"F",6,6,"Cleveland Cavaliers","Dean Wade",2,16,18,8,12,27
5,2,7,0,0,11,8,0,0,"32",3,3,16,10,0,2,1037779,"2023-11-19T00:00:00.000Z",6,FALSE,8,17896076,"F-C",6,6,"Cleveland Cavaliers","Evan Mobley",2,26,31,21,15,39.5
5,0,3,0,0,10,6,6,3,"29",2,3,15,5,1,2,1037779,"2023-11-19T00:00:00.000Z",6,FALSE,8,9,"C",6,6,"Cleveland Cavaliers","Jarrett Allen",1,20,25,20,10,29.5
5,1,5,6,2,7,3,4,3,"32",1,3,11,6,0,3,1037779,"2023-11-19T00:00:00.000Z",6,FALSE,8,666908,"G",6,6,"Cleveland Cavaliers","Max Strus",1,17,22,16,11,25.7
6,1,3,4,2,16,10,5,4,"33",0,0,26,3,1,4,1037779,"2023-11-19T00:00:00.000Z",6,FALSE,8,666581,"G",6,6,"Cleveland Cavaliers","Darius Garland",2,29,35,32,9,40.6
0,0,1,1,0,1,0,0,0,"04",0,0,0,1,0,0,1037779,"2023-11-19T00:00:00.000Z",6,FALSE,8,56677847,"F",6,6,"Cleveland Cavaliers","Emoni Bates",0,1,1,0,1,1.2
0,0,0,0,0,0,0,0,0,"03",0,0,0,0,0,0,1037779,"2023-11-19T00:00:00.000Z",6,FALSE,8,248,"C",6,6,"Cleveland Cavaliers","Damian Jones",0,0,0,0,0,0
0,0,0,0,0,0,0,0,0,"00",0,0,0,0,0,0,1037779,"2023-11-19T00:00:00.000Z",6,FALSE,8,277,"G",6,6,"Cleveland Cavaliers","Caris LeVert",0,0,0,0,0,0
1,0,1,9,3,10,3,0,0,"24",1,2,9,2,0,0,1037779,"2023-11-19T00:00:00.000Z",6,FALSE,8,3547299,"G",6,6,"Cleveland Cavaliers","Sam Merrill",0,11,12,10,3,12.9
2,0,3,3,2,9,4,2,2,"23",0,1,12,3,0,1,1037779,"2023-11-19T00:00:00.000Z",6,FALSE,8,344,"F",6,6,"Cleveland Cavaliers","Georges Niang",0,15,17,14,5,17.6
4,1,2,0,0,10,7,7,7,"25",2,3,21,4,2,1,1037779,"2023-11-19T00:00:00.000Z",6,FALSE,8,56677872,"G",6,6,"Cleveland Cavaliers","Craig Porter",3,25,29,25,8,39.8
0,0,2,0,0,4,2,2,1,"11",1,2,5,3,0,0,1037779,"2023-11-19T00:00:00.000Z",6,FALSE,8,444,"C-F",6,6,"Cleveland Cavaliers","Tristan Thompson",0,8,8,5,3,8.6
0,0,0,0,0,0,0,0,0,"00",0,0,0,0,0,0,1037779,"2023-11-19T00:00:00.000Z",6,FALSE,8,666676,"G",6,6,"Cleveland Cavaliers","Ty Jerome",0,0,0,0,0,0
0,0,0,0,0,0,0,0,0,"00",0,0,0,0,0,0,1037779,"2023-11-19T00:00:00.000Z",6,FALSE,8,322,"G",6,6,"Cleveland Cavaliers","Donovan Mitchell",0,0,0,0,0,0
0,0,0,0,0,0,0,0,0,"00",0,0,0,0,0,0,1037779,"2023-11-19T00:00:00.000Z",6,FALSE,8,38017662,"F",6,6,"Cleveland Cavaliers","Isaiah Mobley",0,0,0,0,0,0
0,0,0,0,0,0,0,0,0,"00",0,0,0,0,0,0,1037779,"2023-11-19T00:00:00.000Z",6,FALSE,8,3547247,"F-G",6,6,"Cleveland Cavaliers","Isaac Okoro",0,0,0,0,0,0
0,0,0,0,0,0,0,0,0,"00",0,0,0,0,0,0,1037779,"2023-11-19T00:00:00.000Z",6,FALSE,8,404,"G",6,6,"Cleveland Cavaliers","Ricky Rubio",0,0,0,0,0,0
0,0,5,9,5,15,7,2,2,"27",1,2,21,6,1,2,1037779,"2023-11-19T00:00:00.000Z",6,FALSE,8,375,"F",8,8,"Denver Nuggets","Michael Porter Jr.",1,27,27,21,6,29.2
5,2,2,2,0,11,4,6,3,"32",2,2,11,4,1,1,1037779,"2023-11-19T00:00:00.000Z",6,FALSE,8,177,"F",8,8,"Denver Nuggets","Aaron Gordon",3,15,20,16,9,31.3
7,1,9,0,0,13,8,5,2,"28",1,5,18,10,1,3,1037779,"2023-11-19T00:00:00.000Z",6,FALSE,8,246,"C",8,8,"Denver Nuggets","Nikola Jokic",2,28,35,25,17,43.5
2,1,0,5,1,9,2,4,4,"31",2,1,9,2,1,1,1037779,"2023-11-19T00:00:00.000Z",6,FALSE,8,81,"G",8,8,"Denver Nuggets","Kentavious Caldwell-Pope",2,11,13,11,4,19.4
1,0,0,1,1,5,3,0,0,"21",0,2,7,0,2,2,1037779,"2023-11-19T00:00:00.000Z",6,FALSE,8,236,"G",8,8,"Denver Nuggets","Reggie Jackson",2,7,8,8,1,12.5
0,0,2,1,1,11,6,0,0,"25",0,1,13,2,0,0,1037779,"2023-11-19T00:00:00.000Z",6,FALSE,8,38017709,"G",8,8,"Denver Nuggets","Christian Braun",0,15,15,13,2,15.4
1,0,0,0,0,0,0,0,0,"03",0,0,0,0,0,0,1037779,"2023-11-19T00:00:00.000Z",6,FALSE,8,38017727,"G",8,8,"Denver Nuggets","Collin Gillespie",0,0,1,1,1,1.5
1,0,1,3,2,3,2,0,0,"17",0,2,6,1,0,0,1037779,"2023-11-19T00:00:00.000Z",6,FALSE,8,215,"F-G",8,8,"Denver Nuggets","Justin Holiday",0,7,8,7,2,8.7
0,0,0,0,0,0,0,0,0,"00",0,0,0,0,0,0,1037779,"2023-11-19T00:00:00.000Z",6,FALSE,8,250,"C",8,8,"Denver Nuggets","DeAndre Jordan",0,0,0,0,0,0
0,0,0,0,0,0,0,0,0,"00",0,0,0,0,0,0,1037779,"2023-11-19T00:00:00.000Z",6,FALSE,8,17896007,"G",8,8,"Denver Nuggets","Braxton Key",0,0,0,0,0,0
1,0,1,1,1,4,3,2,2,"14",3,2,9,4,0,1,1037779,"2023-11-19T00:00:00.000Z",6,FALSE,8,3547268,"F-C",8,8,"Denver Nuggets","Zeke Nnaji",0,13,14,10,5,14.3
3,0,2,3,2,4,2,2,2,"19",0,0,8,2,1,1,1037779,"2023-11-19T00:00:00.000Z",6,FALSE,8,56677582,"G",8,8,"Denver Nuggets","Jalen Pickett",1,10,13,11,5,16.9
1,1,2,3,1,6,2,2,2,"20",0,4,7,2,0,0,1037779,"2023-11-19T00:00:00.000Z",6,FALSE,8,56677776,"G",8,8,"Denver Nuggets","Julian Strawther",1,9,10,8,3,13.9
1,0,0,1,0,1,0,0,0,"03",0,0,0,0,0,0,1037779,"2023-11-19T00:00:00.000Z",6,FALSE,8,56677871,"F",8,8,"Denver Nuggets","Hunter Tyson",0,0,1,1,1,1.5
0,0,0,0,0,0,0,0,0,"00",0,0,0,0,0,0,1037779,"2023-11-19T00:00:00.000Z",6,FALSE,8,38017721,"G",8,8,"Denver Nuggets","Peyton Watson",0,0,0,0,0,0
0,0,0,0,0,0,0,0,0,"00",0,0,0,0,0,0,1037779,"2023-11-19T00:00:00.000Z",6,FALSE,8,666489,"F",8,8,"Denver Nuggets","Vlatko Cancar",0,0,0,0,0,0
0,0,0,0,0,0,0,0,0,"00",0,0,0,0,0,0,1037779,"2023-11-19T00:00:00.000Z",6,FALSE,8,17896103,"F-C",8,8,"Denver Nuggets","Jay Huff",0,0,0,0,0,0
0,0,0,0,0,0,0,0,0,"00",0,0,0,0,0,0,1037779,"2023-11-19T00:00:00.000Z",6,FALSE,8,335,"G",8,8,"Denver Nuggets","Jamal Murray",0,0,0,0,0,0
0,0,0,0,0,0,0,0,0,"00",0,0,0,0,0,0,1037780,"2023-11-19T00:00:00.000Z",28,FALSE,9,197,"F-G",9,9,"Detroit Pistons","Joe Harris",0,0,0,0,0,0
0,0,0,0,0,0,0,0,0,"00",0,0,0,0,0,0,1037780,"2023-11-19T00:00:00.000Z",28,FALSE,9,330,"G",9,9,"Detroit Pistons","Monte Morris",0,0,0,0,0,0
0,0,0,0,0,0,0,0,0,"00",0,0,0,0,0,0,1037780,"2023-11-19T00:00:00.000Z",28,FALSE,9,42097199,"G",9,9,"Detroit Pistons","Jared Rhoden",0,0,0,0,0,0
3,0,4,6,1,11,2,6,4,"27",1,3,9,5,2,1,1037780,"2023-11-19T00:00:00.000Z",28,FALSE,9,18,"F",28,28,"Toronto Raptors","OG Anunoby",2,14,17,12,8,24.5
6,0,4,2,1,18,10,3,2,"29",3,1,23,7,1,0,1037780,"2023-11-19T00:00:00.000Z",28,FALSE,9,416,"F",28,28,"Toronto Raptors","Pascal Siakam",1,30,36,29,13,43.4
4,3,8,0,0,6,6,5,4,"25",2,3,16,10,1,1,1037780,"2023-11-19T00:00:00.000Z",28,FALSE,9,373,"C",28,28,"Toronto Raptors","Jakob Poeltl",4,26,30,20,14,45
9,0,5,4,3,11,7,0,0,"25",2,1,17,7,0,3,1037780,"2023-11-19T00:00:00.000Z",28,FALSE,9,17896055,"G-F",28,28,"Toronto Raptors","Scottie Barnes",0,24,33,26,16,35.9
7,0,2,4,0,15,8,2,1,"26",0,0,17,2,1,0,1037780,"2023-11-19T00:00:00.000Z",28,FALSE,9,409,"G",28,28,"Toronto Raptors","Dennis Schroder",1,19,26,24,9,32.9
3,1,1,7,2,12,6,4,4,"26",0,1,18,1,1,0,1037780,"2023-11-19T00:00:00.000Z",28,FALSE,9,3089,"",28,28,"Toronto Raptors","Gary Trent Jr.",2,19,22,21,4,29.7
0,0,3,5,1,11,2,2,1,"27",1,3,6,4,1,2,1037780,"2023-11-19T00:00:00.000Z",28,FALSE,9,259,"F",9,9,"Detroit Pistons","Kevin Knox",1,10,10,6,4,11.8
1,0,4,2,1,7,3,1,1,"21",1,1,8,5,0,0,1037780,"2023-11-19T00:00:00.000Z",28,FALSE,9,3547267,"F-C",9,9,"Detroit Pistons","Isaiah Stewart",0,13,14,9,6,15.5
4,0,3,5,3,17,7,3,1,"27",2,2,18,5,0,3,1037780,"2023-11-19T00:00:00.000Z",28,FALSE,9,17896075,"G-F",9,9,"Detroit Pistons","Cade Cunningham",0,23,27,22,9,27
4,0,3,5,0,10,3,4,3,"28",0,1,9,3,0,0,1037780,"2023-11-19T00:00:00.000Z",28,FALSE,9,38017682,"G",9,9,"Detroit Pistons","Jaden Ivey",0,12,16,13,7,18.6
3,0,1,0,0,4,3,0,0,"15",1,0,6,2,0,0,1037780,"2023-11-19T00:00:00.000Z",28,FALSE,9,24,"F",9,9,"Detroit Pistons","Marvin Bagley III",0,8,11,9,5,12.9
1,0,3,3,1,9,3,8,7,"22",1,3,14,4,0,1,1037780,"2023-11-19T00:00:00.000Z",28,FALSE,9,77,"G",9,9,"Detroit Pistons","Alec Burks",0,18,19,15,5,19.3
6,0,1,2,1,6,4,0,0,"21",0,1,9,1,1,3,1037780,"2023-11-19T00:00:00.000Z",28,FALSE,9,56677792,"G",9,9,"Detroit Pistons","Marcus Sasser",1,10,16,15,7,19.2
3,1,4,3,2,6,5,8,7,"25",0,2,19,4,0,1,1037780,"2023-11-19T00:00:00.000Z",28,FALSE,9,44477024,"G",9,9,"Detroit Pistons","Stanley Umude",1,23,26,22,7,30.3
1,1,3,0,0,8,6,5,3,"24",0,4,15,3,0,2,1037780,"2023-11-19T00:00:00.000Z",28,FALSE,9,3547240,"C",9,9,"Detroit Pistons","James Wiseman",1,18,19,16,4,21.1
0,0,0,0,0,0,0,0,0,"00",0,0,0,0,0,0,1037780,"2023-11-19T00:00:00.000Z",28,FALSE,9,38017694,"C",9,9,"Detroit Pistons","Jalen Duren",0,0,0,0,0,0
0,0,0,0,0,0,0,0,0,"00",0,0,0,0,0,0,1037780,"2023-11-19T00:00:00.000Z",28,FALSE,9,3547241,"G",9,9,"Detroit Pistons","Killian Hayes",0,0,0,0,0,0
0,0,0,0,0,0,0,0,0,"00",0,0,0,0,0,0,1037780,"2023-11-19T00:00:00.000Z",28,FALSE,9,17896071,"F",9,9,"Detroit Pistons","Isaiah Livers",0,0,0,0,0,0
0,0,0,0,0,0,0,0,0,"00",0,0,0,0,0,0,1037780,"2023-11-19T00:00:00.000Z",28,FALSE,9,54,"F",9,9,"Detroit Pistons","Bojan Bogdanovic",0,0,0,0,0,0
0,0,0,0,0,0,0,0,0,"00",0,0,0,0,0,0,1037780,"2023-11-19T00:00:00.000Z",28,FALSE,9,56677729,"G",9,9,"Detroit Pistons","Malcolm Cazalon",0,0,0,0,0,0
1,0,0,0,0,0,0,0,0,"04",0,2,0,0,0,0,1037780,"2023-11-19T00:00:00.000Z",28,FALSE,9,38017717,"F",28,28,"Toronto Raptors","Ron Harper Jr.",0,0,1,1,1,1.5
1,0,1,1,0,4,2,0,0,"08",0,1,4,1,0,1,1037780,"2023-11-19T00:00:00.000Z",28,FALSE,9,666762,"F",28,28,"Toronto Raptors","Jalen McDaniels",0,5,6,5,2,5.7
0,0,0,0,0,0,0,0,0,"00",0,0,0,0,0,0,1037780,"2023-11-19T00:00:00.000Z",28,FALSE,9,376,"F",28,28,"Toronto Raptors","Otto Porter Jr.",0,0,0,0,0,0
0,0,0,0,0,0,0,0,0,"00",0,0,0,0,0,0,1037780,"2023-11-19T00:00:00.000Z",28,FALSE,9,436,"G-F",28,28,"Toronto Raptors","Garrett Temple",0,0,0,0,0,0
0,0,0,0,0,0,0,0,0,"00",0,0,0,0,0,0,1037780,"2023-11-19T00:00:00.000Z",28,FALSE,9,56677805,"G",28,28,"Toronto Raptors","Javon Freeman-Liberty",0,0,0,0,0,0
0,0,0,0,0,0,0,0,0,"00",0,0,0,0,0,0,1037780,"2023-11-19T00:00:00.000Z",28,FALSE,9,38017710,"C",28,28,"Toronto Raptors","Christian Koloko",0,0,0,0,0,0
0,0,0,0,0,0,0,0,0,"00",0,0,0,0,0,0,1037780,"2023-11-19T00:00:00.000Z",28,FALSE,9,56677869,"G",28,28,"Toronto Raptors","Markquis Nowell",0,0,0,0,0,0
0,0,0,0,0,0,0,0,0,"00",0,0,0,0,0,0,1037780,"2023-11-19T00:00:00.000Z",28,FALSE,9,489,"F",28,28,"Toronto Raptors","Thaddeus Young",0,0,0,0,0,0
2,1,9,1,0,5,3,4,3,"30",1,6,9,10,1,5,1037780,"2023-11-19T00:00:00.000Z",28,FALSE,9,56677826,"G-F",9,9,"Detroit Pistons","Ausar Thompson",2,19,21,11,12,25
4,0,2,2,1,5,3,2,0,"21",0,4,7,2,2,1,1037780,"2023-11-19T00:00:00.000Z",28,FALSE,9,3547275,"G",28,28,"Toronto Raptors","Malachi Flynn",2,9,13,11,6,20.4
5,0,3,4,2,10,5,2,0,"19",3,1,12,6,0,0,1037780,"2023-11-19T00:00:00.000Z",28,FALSE,9,3547249,"F",28,28,"Toronto Raptors","Precious Achiuwa",0,18,23,17,11,26.7
1,1,5,4,3,7,5,3,1,"18",1,4,14,6,1,0,1037780,"2023-11-19T00:00:00.000Z",28,FALSE,9,58,"F",28,28,"Toronto Raptors","Chris Boucher",2,20,21,15,7,28.7
0,0,0,2,1,3,1,2,2,"12",0,2,5,0,1,0,1037780,"2023-11-19T00:00:00.000Z",28,FALSE,9,56677828,"G",28,28,"Toronto Raptors","Gradey Dick",1,5,5,5,0,8
0,0,2,2,1,4,2,1,1,"19",0,0,6,2,0,1,1037781,"2023-11-19T00:00:00.000Z",7,FALSE,26,247,"F-G",7,7,"Dallas Mavericks","Derrick Jones Jr.",0,8,8,6,2,7.4
2,0,1,4,1,6,3,2,0,"20",2,1,7,3,0,1,1037781,"2023-11-19T00:00:00.000Z",7,FALSE,26,666965,"F",7,7,"Dallas Mavericks","Grant Williams",0,10,12,9,5,12.6
0,1,4,0,0,6,3,0,0,"29",5,3,6,9,1,1,1037781,"2023-11-19T00:00:00.000Z",7,FALSE,26,56677840,"C",7,7,"Dallas Mavericks","Dereck Lively II",2,15,15,6,9,21.8
1,0,2,6,2,17,8,5,5,"33",0,2,23,2,0,1,1037781,"2023-11-19T00:00:00.000Z",7,FALSE,26,228,"G",7,7,"Dallas Mavericks","Kyrie Irving",0,25,26,24,3,25.9
7,0,9,7,3,19,7,10,8,"32",1,0,25,10,3,2,1037781,"2023-11-19T00:00:00.000Z",7,FALSE,26,132,"F-G",7,7,"Dallas Mavericks","Luka Doncic",3,35,42,32,17,54.5
4,0,2,1,0,5,4,0,0,"15",0,0,8,2,0,0,1037781,"2023-11-19T00:00:00.000Z",7,FALSE,26,151,"G",7,7,"Dallas Mavericks","Dante Exum",0,10,14,12,6,16.4
5,0,3,5,2,8,4,2,1,"26",1,2,11,4,2,1,1037781,"2023-11-19T00:00:00.000Z",7,FALSE,26,3547258,"G",7,7,"Dallas Mavericks","Josh Green",2,15,20,16,9,28.3
2,1,2,4,2,11,5,2,2,"28",0,3,14,2,0,0,1037781,"2023-11-19T00:00:00.000Z",7,FALSE,26,191,"G",7,7,"Dallas Mavericks","Tim Hardaway Jr.",1,16,18,16,4,22.4
0,0,0,2,1,4,1,2,1,"10",0,2,4,0,1,1,1037781,"2023-11-19T00:00:00.000Z",7,FALSE,26,38017679,"G",7,7,"Dallas Mavericks","Jaden Hardy",1,4,4,4,0,6
0,0,0,0,0,3,3,2,1,"05",2,1,7,2,0,0,1037781,"2023-11-19T00:00:00.000Z",7,FALSE,26,217,"F-C",7,7,"Dallas Mavericks","Richaun Holmes",0,9,9,7,2,9.4
1,1,0,2,0,4,1,0,0,"05",0,0,2,0,0,0,1037781,"2023-11-19T00:00:00.000Z",7,FALSE,26,329,"F",7,7,"Dallas Mavericks","Markieff Morris",1,2,3,3,1,6.5
1,0,1,0,0,0,0,0,0,"13",0,1,0,1,1,2,1037781,"2023-11-19T00:00:00.000Z",7,FALSE,26,379,"F-C",7,7,"Dallas Mavericks","Dwight Powell",1,1,2,1,2,3.7
0,0,3,1,0,1,0,0,0,"05",0,0,0,3,0,0,1037781,"2023-11-19T00:00:00.000Z",7,FALSE,26,56677859,"F",7,7,"Dallas Mavericks","Olivier-Maxence Prosper",0,3,3,0,3,3.6
0,0,0,0,0,0,0,0,0,"00",0,0,0,0,0,0,1037781,"2023-11-19T00:00:00.000Z",7,FALSE,26,17896028,"F",7,7,"Dallas Mavericks","Greg Brown III",0,0,0,0,0,0
0,0,0,0,0,0,0,0,0,"00",0,0,0,0,0,0,1037781,"2023-11-19T00:00:00.000Z",7,FALSE,26,114,"G",7,7,"Dallas Mavericks","Seth Curry",0,0,0,0,0,0
0,0,0,0,0,0,0,0,0,"00",0,0,0,0,0,0,1037781,"2023-11-19T00:00:00.000Z",7,FALSE,26,56677873,"G",7,7,"Dallas Mavericks","Dexter Dennis",0,0,0,0,0,0
0,0,0,0,0,0,0,0,0,"00",0,0,0,0,0,0,1037781,"2023-11-19T00:00:00.000Z",7,FALSE,26,257,"F",7,7,"Dallas Mavericks","Maxi Kleber",0,0,0,0,0,0
0,0,0,0,0,0,0,0,0,"00",0,0,0,0,0,0,1037781,"2023-11-19T00:00:00.000Z",7,FALSE,26,17554004,"G",7,7,"Dallas Mavericks","AJ Lawson",0,0,0,0,0,0
1,0,0,0,0,1,0,0,0,"09",1,0,0,1,0,0,1037781,"2023-11-19T00:00:00.000Z",7,FALSE,26,17896044,"F",26,26,"Sacramento Kings","Kessler Edwards",0,1,2,1,2,2.7
0,0,0,0,0,0,0,0,0,"00",0,0,0,0,0,0,1037781,"2023-11-19T00:00:00.000Z",7,FALSE,26,290,"F",26,26,"Sacramento Kings","Trey Lyles",0,0,0,0,0,0
0,0,0,1,0,1,0,0,0,"04",0,2,0,0,0,0,1037781,"2023-11-19T00:00:00.000Z",7,FALSE,26,56677845,"G",26,26,"Sacramento Kings","Colby Jones",0,0,0,0,0,0
1,1,5,0,0,4,2,2,2,"09",2,1,6,7,1,1,1037781,"2023-11-19T00:00:00.000Z",7,FALSE,26,306,"C",26,26,"Sacramento Kings","JaVale McGee",2,13,14,7,8,20.9
1,0,0,1,0,3,0,0,0,"09",0,0,0,0,0,2,1037781,"2023-11-19T00:00:00.000Z",7,FALSE,26,17553994,"G",26,26,"Sacramento Kings","Davion Mitchell",0,0,1,1,1,-0.5
0,0,0,0,0,0,0,0,0,"00",0,0,0,0,0,0,1037781,"2023-11-19T00:00:00.000Z",7,FALSE,26,17895941,"C",26,26,"Sacramento Kings","Filip Petrusev",0,0,0,0,0,0
0,0,1,0,0,0,0,0,0,"04",0,0,0,1,0,0,1037781,"2023-11-19T00:00:00.000Z",7,FALSE,26,56677862,"F",26,26,"Sacramento Kings","Jalen Slawson",0,1,1,0,1,1.2
0,0,0,0,0,0,0,0,0,"00",0,0,0,0,0,0,1037781,"2023-11-19T00:00:00.000Z",7,FALSE,26,17895990,"G",26,26,"Sacramento Kings","Jordan Ford",0,0,0,0,0,0
0,0,0,0,0,0,0,0,0,"00",0,0,0,0,0,0,1037781,"2023-11-19T00:00:00.000Z",7,FALSE,26,221,"G",26,26,"Sacramento Kings","Kevin Huerter",0,0,0,0,0,0
0,0,0,0,0,0,0,0,0,"00",0,0,0,0,0,0,1037781,"2023-11-19T00:00:00.000Z",7,FALSE,26,273,"C",26,26,"Sacramento Kings","Alex Len",0,0,0,0,0,0
6,0,2,7,1,11,4,3,3,"34",2,1,12,4,1,3,1037781,"2023-11-19T00:00:00.000Z",7,FALSE,26,30,"F",26,26,"Sacramento Kings","Harrison Barnes",1,16,22,18,10,25.8
4,0,0,7,2,13,7,1,1,"32",3,5,17,3,1,1,1037781,"2023-11-19T00:00:00.000Z",7,FALSE,26,38017688,"F",26,26,"Sacramento Kings","Keegan Murray",1,20,24,21,7,28.6
6,0,10,2,0,15,13,10,6,"35",3,2,32,13,0,1,1037781,"2023-11-19T00:00:00.000Z",7,FALSE,26,406,"F",26,26,"Sacramento Kings","Domantas Sabonis",0,45,51,38,19,55.6
4,0,8,4,3,8,5,0,0,"33",0,3,13,8,2,1,1037781,"2023-11-19T00:00:00.000Z",7,FALSE,26,17896030,"G",26,26,"Sacramento Kings","Chris Duarte",2,21,25,17,12,33.6
7,0,3,10,6,20,10,5,4,"31",1,1,30,4,3,0,1037781,"2023-11-19T00:00:00.000Z",7,FALSE,26,161,"G",26,26,"Sacramento Kings","De'Aaron Fox",3,34,41,37,11,54.3
3,1,2,6,4,9,4,0,0,"18",0,2,12,2,1,2,1037781,"2023-11-19T00:00:00.000Z",7,FALSE,26,324,"G",26,26,"Sacramento Kings","Malik Monk",2,14,17,15,5,22.9
1,1,0,2,1,5,3,0,0,"13",1,2,7,1,0,1,1037781,"2023-11-19T00:00:00.000Z",7,FALSE,26,4197162,"F",26,26,"Sacramento Kings","Aleksandar Vezenkov",1,8,9,8,2,11.7
0,0,3,0,0,0,0,0,0,"09",1,1,0,4,0,0,1037781,"2023-11-19T00:00:00.000Z",7,FALSE,26,38017714,"G",26,26,"Sacramento Kings","Keon Ellis",0,4,4,0,4,4.8
6,0,8,15,6,27,11,0,0,"39",4,2,28,12,2,1,1037782,"2023-11-19T00:00:00.000Z",15,FALSE,2,17896067,"F",15,15,"Memphis Grizzlies","Santi Aldama",2,40,46,34,18,56.4
1,1,6,3,1,12,5,7,6,"34",2,5,17,8,1,2,1037782,"2023-11-19T00:00:00.000Z",15,FALSE,2,231,"F-C",15,15,"Memphis Grizzlies","Jaren Jackson Jr.",2,25,26,18,9,32.1
0,1,1,0,0,2,1,0,0,"15",1,5,2,2,0,0,1037782,"2023-11-19T00:00:00.000Z",15,FALSE,2,48,"C",15,15,"Memphis Grizzlies","Bismack Biyombo",1,4,4,2,2,7.4
8,0,0,14,7,27,11,1,1,"37",2,2,30,2,1,2,1037782,"2023-11-19T00:00:00.000Z",15,FALSE,2,3547287,"G",15,15,"Memphis Grizzlies","Desmond Bane",1,32,40,38,10,45.4
3,1,3,0,0,3,1,0,0,"26",2,2,2,5,1,1,1037782,"2023-11-19T00:00:00.000Z",15,FALSE,2,666703,"G-F",15,15,"Memphis Grizzlies","John Konchar",2,7,10,5,8,17.5
5,0,1,2,1,2,1,0,0,"15",1,1,3,2,2,1,1037782,"2023-11-19T00:00:00.000Z",15,FALSE,2,48248287,"G",15,15,"Memphis Grizzlies","Jacob Gilyard",2,5,10,8,7,17.9
0,0,0,0,0,0,0,0,0,"00",0,0,0,0,0,0,1037782,"2023-11-19T00:00:00.000Z",15,FALSE,2,56677830,"F",15,15,"Memphis Grizzlies","GG Jackson",0,0,0,0,0,0
0,0,0,0,0,0,0,0,0,"00",0,0,0,0,0,0,1037782,"2023-11-19T00:00:00.000Z",15,FALSE,2,38017728,"F",15,15,"Memphis Grizzlies","Jake LaRavia",0,0,0,0,0,0
0,0,2,2,0,2,0,0,0,"20",0,0,0,2,0,0,1037782,"2023-11-19T00:00:00.000Z",15,FALSE,2,38017729,"F",15,15,"Memphis Grizzlies","David Roddy",0,2,2,0,2,2.4
0,2,0,3,2,4,2,0,0,"17",0,2,6,0,0,0,1037782,"2023-11-19T00:00:00.000Z",15,FALSE,2,38017731,"G",15,15,"Memphis Grizzlies","Vince Williams Jr.",2,6,6,6,0,12
4,0,5,4,0,11,3,0,0,"24",2,2,6,7,0,0,1037782,"2023-11-19T00:00:00.000Z",15,FALSE,2,17896027,"G-F",15,15,"Memphis Grizzlies","Ziaire Williams",0,13,17,10,11,20.4
0,0,0,0,0,0,0,0,0,"00",0,0,0,0,0,0,1037782,"2023-11-19T00:00:00.000Z",15,FALSE,2,3,"C",15,15,"Memphis Grizzlies","Steven Adams",0,0,0,0,0,0
0,0,0,0,0,0,0,0,0,"00",0,0,0,0,0,0,1037782,"2023-11-19T00:00:00.000Z",15,FALSE,2,666505,"F",15,15,"Memphis Grizzlies","Brandon Clarke",0,0,0,0,0,0
0,0,0,0,0,0,0,0,0,"00",0,0,0,0,0,0,1037782,"2023-11-19T00:00:00.000Z",15,FALSE,2,254,"G",15,15,"Memphis Grizzlies","Luke Kennard",0,0,0,0,0,0
0,0,0,0,0,0,0,0,0,"00",0,0,0,0,0,0,1037782,"2023-11-19T00:00:00.000Z",15,FALSE,2,666786,"G",15,15,"Memphis Grizzlies","Ja Morant",0,0,0,0,0,0
0,0,0,0,0,0,0,0,0,"00",0,0,0,0,0,0,1037782,"2023-11-19T00:00:00.000Z",15,FALSE,2,401,"G",15,15,"Memphis Grizzlies","Derrick Rose",0,0,0,0,0,0
0,0,0,0,0,0,0,0,0,"00",0,0,0,0,0,0,1037782,"2023-11-19T00:00:00.000Z",15,FALSE,2,420,"G",15,15,"Memphis Grizzlies","Marcus Smart",0,0,0,0,0,0
0,0,0,0,0,0,0,0,0,"00",0,0,0,0,0,0,1037782,"2023-11-19T00:00:00.000Z",15,FALSE,2,3547285,"F",15,15,"Memphis Grizzlies","Xavier Tillman",0,0,0,0,0,0
3,2,6,7,1,16,5,2,1,"34",0,4,12,6,2,2,1037782,"2023-11-19T00:00:00.000Z",15,FALSE,2,70,"G",2,2,"Boston Celtics","Jaylen Brown",4,18,21,15,9,33.7
5,1,7,1,1,13,7,6,5,"35",2,4,20,9,1,8,1037782,"2023-11-19T00:00:00.000Z",15,FALSE,2,434,"F",2,2,"Boston Celtics","Jayson Tatum",2,29,34,25,14,36.3
1,6,6,3,0,13,9,9,8,"33",2,4,26,8,1,2,1037782,"2023-11-19T00:00:00.000Z",15,FALSE,2,378,"F-C",2,2,"Boston Celtics","Kristaps Porzingis",7,34,35,27,9,56.1
4,1,2,5,2,9,3,2,2,"34",1,2,10,3,0,2,1037782,"2023-11-19T00:00:00.000Z",15,FALSE,2,473,"G",2,2,"Boston Celtics","Derrick White",1,13,17,14,7,20.6
4,0,4,3,1,7,2,2,2,"37",2,1,7,6,0,2,1037782,"2023-11-19T00:00:00.000Z",15,FALSE,2,214,"G",2,2,"Boston Celtics","Jrue Holiday",0,13,17,11,10,18.2
0,0,0,0,0,0,0,0,0,"00",0,0,0,0,0,0,1037782,"2023-11-19T00:00:00.000Z",15,FALSE,2,17896094,"G",2,2,"Boston Celtics","Dalano Banton",0,0,0,0,0,0
0,0,0,0,0,0,0,0,0,"00",0,0,0,0,0,0,1037782,"2023-11-19T00:00:00.000Z",15,FALSE,2,666468,"F",2,2,"Boston Celtics","Oshae Brissett",0,0,0,0,0,0
0,0,4,7,5,8,5,0,0,"22",0,0,15,4,2,0,1037782,"2023-11-19T00:00:00.000Z",15,FALSE,2,17896060,"F",2,2,"Boston Celtics","Sam Hauser",2,19,19,15,4,25.8
2,0,1,3,1,5,2,0,0,"22",2,2,5,3,0,0,1037782,"2023-11-19T00:00:00.000Z",15,FALSE,2,219,"C-F",2,2,"Boston Celtics","Al Horford",0,8,10,7,5,11.6
0,0,0,0,0,0,0,0,0,"00",0,0,0,0,0,0,1037782,"2023-11-19T00:00:00.000Z",15,FALSE,2,261,"F-C",2,2,"Boston Celtics","Luke Kornet",0,0,0,0,0,0
0,0,0,0,0,0,0,0,0,"00",0,0,0,0,0,0,1037782,"2023-11-19T00:00:00.000Z",15,FALSE,2,338,"G",2,2,"Boston Celtics","Svi Mykhailiuk",0,0,0,0,0,0
1,0,3,2,1,5,2,4,2,"15",0,0,7,3,0,1,1037782,"2023-11-19T00:00:00.000Z",15,FALSE,2,3547276,"G",2,2,"Boston Celtics","Payton Pritchard",0,10,11,8,4,11.1
0,0,2,0,0,1,0,0,0,"05",0,1,0,2,0,0,1037782,"2023-11-19T00:00:00.000Z",15,FALSE,2,17553967,"C",2,2,"Boston Celtics","Neemias Queta",0,2,2,0,2,2.4
0,0,1,0,0,0,0,0,0,"03",0,1,0,1,0,0,1037782,"2023-11-19T00:00:00.000Z",15,FALSE,2,3547279,"F",2,2,"Boston Celtics","Lamar Stevens",0,1,1,0,1,1.2
0,0,0,0,0,0,0,0,0,"00",0,0,0,0,0,0,1037782,"2023-11-19T00:00:00.000Z",15,FALSE,2,38017707,"G",2,2,"Boston Celtics","JD Davison",0,0,0,0,0,0
0,0,0,0,0,0,0,0,0,"00",0,0,0,0,0,0,1037782,"2023-11-19T00:00:00.000Z",15,FALSE,2,3547295,"F-C",2,2,"Boston Celtics","Nathan Knight",0,0,0,0,0,0
0,0,0,0,0,0,0,0,0,"00",0,0,0,0,0,0,1037782,"2023-11-19T00:00:00.000Z",15,FALSE,2,56677864,"G",2,2,"Boston Celtics","Jordan Walsh",0,0,0,0,0,0
1,0,2,1,0,5,2,2,2,"13",0,0,6,2,0,2,1037782,"2023-11-19T00:00:00.000Z",15,FALSE,2,38017732,"F",15,15,"Memphis Grizzlies","Kenneth Lofton Jr.",0,8,9,7,3,7.9
1,0,0,0,0,4,2,0,0,"17",0,1,4,0,0,0,1037783,"2023-11-19T00:00:00.000Z",29,FALSE,24,147,"F",24,24,"Phoenix Suns","Drew Eubanks",0,4,5,5,1,5.5
1,1,1,1,1,1,1,0,0,"34",2,4,3,3,1,1,1037783,"2023-11-19T00:00:00.000Z",29,FALSE,24,38017620,"G",29,29,"Utah Jazz","Ochai Agbaji",2,6,7,4,4,13.1
0,2,10,10,2,27,15,9,6,"50",7,3,38,17,2,1,1037783,"2023-11-19T00:00:00.000Z",29,FALSE,24,297,"F",29,29,"Utah Jazz","Lauri Markkanen",4,55,55,38,17,69.4
0,1,8,5,3,14,5,2,2,"43",4,2,15,12,2,1,1037783,"2023-11-19T00:00:00.000Z",29,FALSE,24,101,"F-C",29,29,"Utah Jazz","John Collins",3,27,27,15,12,37.4
5,0,4,6,1,23,8,7,5,"39",3,5,22,7,2,2,1037783,"2023-11-19T00:00:00.000Z",29,FALSE,24,100,"G",29,29,"Utah Jazz","Jordan Clarkson",2,29,34,27,12,41.9
11,0,3,5,0,12,2,4,3,"34",2,2,7,5,1,5,1037783,"2023-11-19T00:00:00.000Z",29,FALSE,24,56677834,"G",29,29,"Utah Jazz","Keyonte George",1,12,23,18,16,27.5
0,0,0,0,0,0,0,0,0,"00",0,0,0,0,0,0,1037783,"2023-11-19T00:00:00.000Z",29,FALSE,24,139,"G",29,29,"Utah Jazz","Kris Dunn",0,0,0,0,0,0
0,1,0,1,1,3,1,0,0,"18",1,1,3,1,0,1,1037783,"2023-11-19T00:00:00.000Z",29,FALSE,24,38017739,"F",29,29,"Utah Jazz","Simone Fontecchio",1,4,4,3,1,6.2
0,0,0,0,0,0,0,0,0,"00",0,0,0,0,0,0,1037783,"2023-11-19T00:00:00.000Z",29,FALSE,24,56677824,"F",29,29,"Utah Jazz","Taylor Hendricks",0,0,0,0,0,0
3,0,2,10,4,18,9,3,3,"29",2,4,25,4,2,1,1037783,"2023-11-19T00:00:00.000Z",29,FALSE,24,666650,"G",29,29,"Utah Jazz","Talen Horton-Tucker",2,29,32,28,7,39.3
5,0,2,2,0,4,1,4,4,"20",3,6,6,5,0,4,1037783,"2023-11-19T00:00:00.000Z",29,FALSE,24,358,"F",29,29,"Utah Jazz","Kelly Olynyk",0,11,16,11,10,15.5
0,0,0,0,0,0,0,0,0,"00",0,0,0,0,0,0,1037783,"2023-11-19T00:00:00.000Z",29,FALSE,24,3547095,"C-F",24,24,"Phoenix Suns","Udoka Azubuike",0,0,0,0,0,0
1,2,0,4,1,6,2,1,1,"23",1,3,6,1,1,0,1037783,"2023-11-19T00:00:00.000Z",29,FALSE,24,32,"F",24,24,"Phoenix Suns","Keita Bates-Diop",3,7,8,7,2,17.7
0,0,0,0,0,0,0,0,0,"00",0,0,0,0,0,0,1037783,"2023-11-19T00:00:00.000Z",29,FALSE,24,666451,"C",24,24,"Phoenix Suns","Bol Bol",0,0,0,0,0,0
3,0,3,0,0,0,0,0,0,"11",0,0,0,3,1,1,1037783,"2023-11-19T00:00:00.000Z",29,FALSE,24,18678058,"",24,24,"Phoenix Suns","Jordan Goodwin",1,3,6,3,6,10.1
0,0,0,0,0,0,0,0,0,"00",0,0,0,0,0,0,1037783,"2023-11-19T00:00:00.000Z",29,FALSE,24,3547298,"G",24,24,"Phoenix Suns","Saben Lee",0,0,0,0,0,0
0,0,0,0,0,0,0,0,0,"00",0,0,0,0,0,0,1037783,"2023-11-19T00:00:00.000Z",29,FALSE,24,314,"F",24,24,"Phoenix Suns","Chimezie Metu",0,0,0,0,0,0
0,0,0,0,0,0,0,0,0,"00",0,0,0,0,0,0,1037783,"2023-11-19T00:00:00.000Z",29,FALSE,24,37,"G",24,24,"Phoenix Suns","Bradley Beal",0,0,0,0,0,0
0,0,0,0,0,0,0,0,0,"00",0,0,0,0,0,0,1037783,"2023-11-19T00:00:00.000Z",29,FALSE,24,272,"G",24,24,"Phoenix Suns","Damion Lee",0,0,0,0,0,0
0,0,0,0,0,0,0,0,0,"00",0,0,0,0,0,0,1037783,"2023-11-19T00:00:00.000Z",29,FALSE,24,470,"G",24,24,"Phoenix Suns","Yuta Watanabe",0,0,0,0,0,0
0,0,0,0,0,0,0,0,0,"00",0,0,0,0,0,0,1037783,"2023-11-19T00:00:00.000Z",29,FALSE,24,666881,"F",29,29,"Utah Jazz","Luka Samanic",0,0,0,0,0,0
0,0,0,0,0,0,0,0,0,"00",0,0,0,0,0,0,1037783,"2023-11-19T00:00:00.000Z",29,FALSE,24,56677842,"F",29,29,"Utah Jazz","Brice Sensabaugh",0,0,0,0,0,0
2,0,2,6,3,13,6,3,3,"23",3,0,18,5,1,2,1037783,"2023-11-19T00:00:00.000Z",29,FALSE,24,413,"G",29,29,"Utah Jazz","Collin Sexton",1,23,25,20,7,28
0,0,0,0,0,0,0,0,0,"00",0,0,0,0,0,0,1037783,"2023-11-19T00:00:00.000Z",29,FALSE,24,11891374,"C",29,29,"Utah Jazz","Omer Yurtseven",0,0,0,0,0,0
0,0,0,0,0,0,0,0,0,"00",0,0,0,0,0,0,1037783,"2023-11-19T00:00:00.000Z",29,FALSE,24,17896023,"G",29,29,"Utah Jazz","Josh Christopher",0,0,0,0,0,0
0,0,0,0,0,0,0,0,0,"00",0,0,0,0,0,0,1037783,"2023-11-19T00:00:00.000Z",29,FALSE,24,38017630,"G",29,29,"Utah Jazz","Johnny Juzang",0,0,0,0,0,0
0,0,0,0,0,0,0,0,0,"00",0,0,0,0,0,0,1037783,"2023-11-19T00:00:00.000Z",29,FALSE,24,38017705,"C",29,29,"Utah Jazz","Walker Kessler",0,0,0,0,0,0
0,0,0,0,0,0,0,0,0,"00",0,0,0,0,0,0,1037783,"2023-11-19T00:00:00.000Z",29,FALSE,24,19465584,"F",29,29,"Utah Jazz","Micah Potter",0,0,0,0,0,0
6,2,4,12,5,16,7,2,1,"41",1,3,20,5,2,1,1037783,"2023-11-19T00:00:00.000Z",29,FALSE,24,178,"G",24,24,"Phoenix Suns","Eric Gordon",4,25,31,26,11,46
8,1,4,7,2,21,8,8,8,"40",1,5,26,5,0,3,1037783,"2023-11-19T00:00:00.000Z",29,FALSE,24,57,"G",24,24,"Phoenix Suns","Devin Booker",1,31,39,34,13,44
0,0,1,2,1,2,1,0,0,"14",2,1,3,3,3,1,1037783,"2023-11-19T00:00:00.000Z",29,FALSE,24,356,"G",24,24,"Phoenix Suns","Josh Okogie",3,6,6,3,3,14.6
2,3,1,5,2,7,4,2,0,"20",2,4,10,3,0,0,1037783,"2023-11-19T00:00:00.000Z",29,FALSE,24,666729,"F",24,24,"Phoenix Suns","Nassir Little",3,13,15,12,5,25.6
10,2,8,9,4,27,14,7,7,"46",0,2,39,8,2,7,1037783,"2023-11-19T00:00:00.000Z",29,FALSE,24,140,"F",24,24,"Phoenix Suns","Kevin Durant",4,47,57,49,18,68.6
2,2,8,0,0,11,7,4,4,"35",4,5,18,12,1,2,1037783,"2023-11-19T00:00:00.000Z",29,FALSE,24,349,"C",24,24,"Phoenix Suns","Jusuf Nurkic",3,30,32,20,14,42.4
3,1,4,6,3,8,5,2,1,"43",0,4,14,4,1,2,1037783,"2023-11-19T00:00:00.000Z",29,FALSE,24,8,"G",24,24,"Phoenix Suns","Grayson Allen",2,18,21,17,7,27.3
0,0,2,2,0,5,3,0,0,"15",0,4,6,2,0,1,1037784,"2023-11-19T00:00:00.000Z",25,FALSE,21,56677850,"F",25,25,"Portland Trail Blazers","Toumani Camara",0,8,8,6,2,7.4
1,0,0,5,1,12,4,6,5,"28",0,1,14,0,1,2,1037784,"2023-11-19T00:00:00.000Z",25,FALSE,21,182,"F",25,25,"Portland Trail Blazers","Jerami Grant",1,14,15,15,1,16.5
2,1,3,0,0,7,5,2,1,"24",2,0,11,5,1,2,1037784,"2023-11-19T00:00:00.000Z",25,FALSE,21,22,"C",25,25,"Portland Trail Blazers","Deandre Ayton",2,16,18,13,7,24
1,0,2,1,1,8,3,0,0,"24",2,3,7,4,0,1,1037784,"2023-11-19T00:00:00.000Z",25,FALSE,21,38017690,"G",25,25,"Portland Trail Blazers","Shaedon Sharpe",0,11,12,8,5,12.3
7,0,2,6,2,9,4,2,1,"26",0,0,11,2,2,3,1037784,"2023-11-19T00:00:00.000Z",25,FALSE,21,3547289,"G",25,25,"Portland Trail Blazers","Skylar Mays",2,13,20,18,9,26.9
5,0,1,2,0,4,1,0,0,"16",1,0,2,2,0,2,1037784,"2023-11-19T00:00:00.000Z",25,FALSE,21,44477062,"G",25,25,"Portland Trail Blazers","Jamaree Bouyea",0,4,9,7,7,9.9
0,0,0,0,0,1,1,0,0,"07",1,0,2,1,1,0,1037784,"2023-11-19T00:00:00.000Z",25,FALSE,21,666476,"C",25,25,"Portland Trail Blazers","Moses Brown",1,3,3,2,1,6.2
0,1,0,4,2,6,2,2,1,"13",2,0,7,2,0,0,1037784,"2023-11-19T00:00:00.000Z",25,FALSE,21,47957121,"F",25,25,"Portland Trail Blazers","Justin Minaya",1,9,9,7,2,12.4
0,0,1,2,1,4,2,4,3,"21",1,3,8,2,1,1,1037784,"2023-11-19T00:00:00.000Z",25,FALSE,21,56677791,"F",25,25,"Portland Trail Blazers","Kris Murray",1,10,10,8,2,12.4
0,0,2,2,0,6,1,2,2,"12",0,2,4,2,0,1,1037784,"2023-11-19T00:00:00.000Z",25,FALSE,21,56783340,"C",25,25,"Portland Trail Blazers","Duop Reath",0,6,6,4,2,5.4
1,0,0,3,1,5,1,2,1,"12",1,0,4,1,1,1,1037784,"2023-11-19T00:00:00.000Z",25,FALSE,21,56677829,"G-F",25,25,"Portland Trail Blazers","Rayan Rupert",1,5,6,5,2,8.7
2,0,1,2,0,3,1,0,0,"20",0,0,2,1,2,0,1037784,"2023-11-19T00:00:00.000Z",25,FALSE,21,666923,"G-F",25,25,"Portland Trail Blazers","Matisse Thybulle",2,3,5,4,3,12.2
2,0,4,5,1,15,6,1,0,"22",3,2,13,7,1,3,1037784,"2023-11-19T00:00:00.000Z",25,FALSE,21,38017711,"F",25,25,"Portland Trail Blazers","Jabari Walker",1,20,22,15,9,24.4
0,0,0,0,0,0,0,0,0,"00",0,0,0,0,0,0,1037784,"2023-11-19T00:00:00.000Z",25,FALSE,21,65,"G",25,25,"Portland Trail Blazers","Malcolm Brogdon",0,0,0,0,0,0
0,0,0,0,0,0,0,0,0,"00",0,0,0,0,0,0,1037784,"2023-11-19T00:00:00.000Z",25,FALSE,21,56677747,"G",25,25,"Portland Trail Blazers","Scoot Henderson",0,0,0,0,0,0
0,0,0,0,0,0,0,0,0,"00",0,0,0,0,0,0,1037784,"2023-11-19T00:00:00.000Z",25,FALSE,21,419,"G",25,25,"Portland Trail Blazers","Anfernee Simons",0,0,0,0,0,0
0,0,0,0,0,0,0,0,0,"00",0,0,0,0,0,0,1037784,"2023-11-19T00:00:00.000Z",25,FALSE,21,17896120,"F",25,25,"Portland Trail Blazers","Ish Wainright",0,0,0,0,0,0
0,0,0,0,0,0,0,0,0,"00",0,0,0,0,0,0,1037784,"2023-11-19T00:00:00.000Z",25,FALSE,21,476,"C-F",25,25,"Portland Trail Blazers","Robert Williams III",0,0,0,0,0,0
0,0,1,0,0,2,1,0,0,"21",0,1,2,1,1,1,1037784,"2023-11-19T00:00:00.000Z",25,FALSE,21,56677833,"G",21,21,"Oklahoma City Thunder","Cason Wallace",1,3,3,2,1,5.2
1,0,0,3,2,6,4,2,2,"22",0,1,12,0,0,0,1037784,"2023-11-19T00:00:00.000Z",25,FALSE,21,666541,"G",21,21,"Oklahoma City Thunder","Luguentz Dort",0,12,13,13,1,13.5
0,2,6,2,2,6,6,2,2,"20",0,1,16,6,0,0,1037784,"2023-11-19T00:00:00.000Z",25,FALSE,21,38017685,"C-F",21,21,"Oklahoma City Thunder","Chet Holmgren",2,22,22,16,6,29.2
5,0,4,0,0,6,3,0,0,"23",0,1,6,4,1,4,1037784,"2023-11-19T00:00:00.000Z",25,FALSE,21,17896065,"G",21,21,"Oklahoma City Thunder","Josh Giddey",1,10,15,11,9,17.3
4,0,3,1,1,13,10,7,7,"22",0,2,28,3,1,3,1037784,"2023-11-19T00:00:00.000Z",25,FALSE,21,175,"G",21,21,"Oklahoma City Thunder","Shai Gilgeous-Alexander",1,31,35,32,7,37.6
2,1,2,5,1,5,1,0,0,"11",0,0,3,2,0,0,1037784,"2023-11-19T00:00:00.000Z",25,FALSE,21,44,"F",21,21,"Oklahoma City Thunder","Davis Bertans",1,5,7,5,4,11.4
1,0,1,6,5,6,5,0,0,"14",0,0,15,1,1,1,1037784,"2023-11-19T00:00:00.000Z",25,FALSE,21,3547272,"G",21,21,"Oklahoma City Thunder","Isaiah Joe",1,16,17,16,2,19.7
2,0,3,3,1,7,3,0,0,"24",2,1,7,5,0,3,1037784,"2023-11-19T00:00:00.000Z",25,FALSE,21,17896036,"G",21,21,"Oklahoma City Thunder","Tre Mann",0,12,14,9,7,13
1,0,0,0,0,1,0,0,0,"06",0,0,0,0,0,2,1037784,"2023-11-19T00:00:00.000Z",25,FALSE,21,4197029,"G",21,21,"Oklahoma City Thunder","Vasilije Micic",0,0,1,1,1,-0.5
4,0,1,1,1,3,2,0,0,"09",2,1,5,3,0,0,1037784,"2023-11-19T00:00:00.000Z",25,FALSE,21,3547271,"C",21,21,"Oklahoma City Thunder","Aleksej Pokusevski",0,8,12,9,7,14.6
0,0,1,3,2,5,2,0,0,"10",1,4,6,2,0,0,1037784,"2023-11-19T00:00:00.000Z",25,FALSE,21,24572055,"C",21,21,"Oklahoma City Thunder","Olivier Sarr",0,8,8,6,2,8.4
1,0,3,7,4,7,4,0,0,"16",0,0,12,3,0,0,1037784,"2023-11-19T00:00:00.000Z",25,FALSE,21,27924547,"F",21,21,"Oklahoma City Thunder","Lindy Waters III",0,15,16,13,4,17.1
1,0,3,3,2,7,4,3,3,"16",2,1,13,5,3,2,1037784,"2023-11-19T00:00:00.000Z",25,FALSE,21,17896078,"G",21,21,"Oklahoma City Thunder","Aaron Wiggins",3,18,19,14,6,27.5
3,0,4,1,0,5,3,0,0,"18",3,3,6,7,1,1,1037784,"2023-11-19T00:00:00.000Z",25,FALSE,21,38017706,"F",21,21,"Oklahoma City Thunder","Jaylin Williams",1,13,16,9,10,20.9
3,0,1,1,1,2,1,0,0,"08",0,2,3,1,0,0,1037784,"2023-11-19T00:00:00.000Z",25,FALSE,21,480,"G-F",21,21,"Oklahoma City Thunder","Kenrich Williams",0,4,7,6,4,8.7
0,0,0,0,0,0,0,0,0,"00",0,0,0,0,0,0,1037784,"2023-11-19T00:00:00.000Z",25,FALSE,21,38017716,"F",21,21,"Oklahoma City Thunder","Ousmane Dieng",0,0,0,0,0,0
0,0,0,0,0,0,0,0,0,"00",0,0,0,0,0,0,1037784,"2023-11-19T00:00:00.000Z",25,FALSE,21,56677853,"F",21,21,"Oklahoma City Thunder","Keyontae Johnson",0,0,0,0,0,0
0,0,0,0,0,0,0,0,0,"00",0,0,0,0,0,0,1037784,"2023-11-19T00:00:00.000Z",25,FALSE,21,38017703,"G-F",21,21,"Oklahoma City Thunder","Jalen Williams",0,0,0,0,0,0
0,0,0,0,0,0,0,0,0,"00",0,0,0,0,0,0,1037785,"2023-11-19T00:00:00.000Z",14,FALSE,11,56677738,"C",14,14,"Los Angeles Lakers","Colin Castleton",0,0,0,0,0,0
0,0,0,0,0,0,0,0,0,"00",0,0,0,0,0,0,1037785,"2023-11-19T00:00:00.000Z",14,FALSE,11,56677867,"F",14,14,"Los Angeles Lakers","Alex Fudge",0,0,0,0,0,0
0,0,0,0,0,0,0,0,0,"00",0,0,0,0,0,0,1037785,"2023-11-19T00:00:00.000Z",14,FALSE,11,56677868,"G",14,14,"Los Angeles Lakers","D'Moi Hodge",0,0,0,0,0,0
0,0,0,0,0,0,0,0,0,"00",0,0,0,0,0,0,1037785,"2023-11-19T00:00:00.000Z",14,FALSE,11,56677836,"F",14,14,"Los Angeles Lakers","Maxwell Lewis",0,0,0,0,0,0
0,0,0,0,0,0,0,0,0,"00",0,0,0,0,0,0,1037785,"2023-11-19T00:00:00.000Z",14,FALSE,11,1603383,"G",14,14,"Los Angeles Lakers","Gabe Vincent",0,0,0,0,0,0
2,0,0,11,6,21,9,0,0,"41",1,5,24,1,4,2,1037785,"2023-11-19T00:00:00.000Z",14,FALSE,11,66,"G-F",11,11,"Houston Rockets","Dillon Brooks",4,25,27,26,3,38.2
0,0,0,0,0,0,0,0,0,"00",0,0,0,0,0,0,1037785,"2023-11-19T00:00:00.000Z",14,FALSE,11,75,"G-F",11,11,"Houston Rockets","Reggie Bullock",0,0,0,0,0,0
0,0,0,0,0,0,0,0,0,"00",0,0,0,0,0,0,1037785,"2023-11-19T00:00:00.000Z",14,FALSE,11,47738533,"G",11,11,"Houston Rockets","Jeenathan Williams",0,0,0,0,0,0
3,0,3,5,1,9,3,0,0,"39",0,2,7,3,3,1,1037785,"2023-11-19T00:00:00.000Z",14,FALSE,11,666860,"F-G",14,14,"Los Angeles Lakers","Cameron Reddish",3,10,13,10,6,23.1
8,0,5,5,2,19,14,9,7,"40",1,0,37,6,3,2,1037785,"2023-11-19T00:00:00.000Z",14,FALSE,11,237,"F",14,14,"Los Angeles Lakers","LeBron James",3,43,51,45,14,63.2
3,1,6,0,0,15,11,7,5,"33",4,6,27,10,2,4,1037785,"2023-11-19T00:00:00.000Z",14,FALSE,11,117,"F-C",14,14,"Los Angeles Lakers","Anthony Davis",3,37,40,30,13,48.5
2,0,1,4,0,11,1,1,0,"24",3,0,2,4,0,2,1037785,"2023-11-19T00:00:00.000Z",14,FALSE,11,383,"F",14,14,"Los Angeles Lakers","Taurean Prince",0,6,8,4,6,7.8
2,0,5,5,1,8,1,2,1,"24",0,1,4,5,3,3,1037785,"2023-11-19T00:00:00.000Z",14,FALSE,11,405,"G",14,14,"Los Angeles Lakers","D'Angelo Russell",3,9,11,6,7,19
2,0,3,4,0,10,4,4,3,"32",1,0,11,4,2,2,1037785,"2023-11-19T00:00:00.000Z",14,FALSE,11,666609,"F",14,14,"Los Angeles Lakers","Rui Hachimura",2,15,17,13,6,22.8
6,0,6,3,2,7,5,6,5,"25",0,0,17,6,0,2,1037785,"2023-11-19T00:00:00.000Z",14,FALSE,11,17553995,"G",14,14,"Los Angeles Lakers","Austin Reaves",0,23,29,23,12,31.2
0,0,2,3,0,4,0,0,0,"18",0,3,0,2,0,1,1037785,"2023-11-19T00:00:00.000Z",14,FALSE,11,486,"F",14,14,"Los Angeles Lakers","Christian Wood",0,2,2,0,2,1.4
0,0,0,0,0,0,0,0,0,"00",0,0,0,0,0,0,1037785,"2023-11-19T00:00:00.000Z",14,FALSE,11,56677809,"F",11,11,"Houston Rockets","Jermaine Samuels Jr.",0,0,0,0,0,0
2,0,2,0,0,3,2,0,0,"16",1,1,4,3,1,0,1037785,"2023-11-19T00:00:00.000Z",14,FALSE,11,3547301,"F",11,11,"Houston Rockets","Jae'Sean Tate",1,7,9,6,5,13.6
0,0,0,0,0,0,0,0,0,"00",0,0,0,0,0,0,1037785,"2023-11-19T00:00:00.000Z",14,FALSE,11,56677831,"F",11,11,"Houston Rockets","Cam Whitmore",0,0,0,0,0,0
0,0,0,0,0,0,0,0,0,"00",0,0,0,0,0,0,1037785,"2023-11-19T00:00:00.000Z",14,FALSE,11,357,"G",11,11,"Houston Rockets","Victor Oladipo",0,0,0,0,0,0
0,0,0,0,0,0,0,0,0,"00",0,0,0,0,0,0,1037785,"2023-11-19T00:00:00.000Z",14,FALSE,11,56677825,"G-F",11,11,"Houston Rockets","Amen Thompson",0,0,0,0,0,0
0,1,5,1,0,2,1,0,0,"17",0,2,2,5,0,0,1037785,"2023-11-19T00:00:00.000Z",14,FALSE,11,38017695,"F",11,11,"Houston Rockets","Tari Eason",1,7,7,2,5,11
0,0,2,0,0,5,5,3,3,"14",0,2,13,2,0,0,1037785,"2023-11-19T00:00:00.000Z",14,FALSE,11,188,"F",11,11,"Houston Rockets","Jeff Green",0,15,15,13,2,15.4
0,0,0,0,0,0,0,0,0,"00",0,0,0,0,0,0,1037785,"2023-11-19T00:00:00.000Z",14,FALSE,11,3547281,"G-F",11,11,"Houston Rockets","Nate Hinton",0,0,0,0,0,0
5,0,0,2,0,3,0,0,0,"15",0,4,0,0,0,1,1037785,"2023-11-19T00:00:00.000Z",14,FALSE,11,213,"G",11,11,"Houston Rockets","Aaron Holiday",0,0,5,5,5,6.5
1,0,0,0,0,0,0,0,0,"03",1,1,0,1,0,1,1037785,"2023-11-19T00:00:00.000Z",14,FALSE,11,19465326,"C",11,11,"Houston Rockets","Jock Landale",0,1,2,1,2,1.7
0,0,0,0,0,0,0,0,0,"00",0,0,0,0,0,0,1037785,"2023-11-19T00:00:00.000Z",14,FALSE,11,296,"C",11,11,"Houston Rockets","Boban Marjanovic",0,0,0,0,0,0
0,0,0,0,0,0,0,0,0,"00",0,0,0,0,0,0,1037785,"2023-11-19T00:00:00.000Z",14,FALSE,11,457,"F",14,14,"Los Angeles Lakers","Jarred Vanderbilt",0,0,0,0,0,0
0,0,1,0,0,0,0,0,0,"05",1,1,0,2,0,0,1037785,"2023-11-19T00:00:00.000Z",14,FALSE,11,666626,"C",14,14,"Los Angeles Lakers","Jaxson Hayes",0,2,2,0,2,2.4
0,0,0,0,0,0,0,0,0,"00",0,0,0,0,0,0,1037785,"2023-11-19T00:00:00.000Z",14,FALSE,11,38017697,"G",14,14,"Los Angeles Lakers","Max Christie",0,0,0,0,0,0
0,0,0,0,0,0,0,0,0,"00",0,0,0,0,0,0,1037785,"2023-11-19T00:00:00.000Z",14,FALSE,11,56677835,"G",14,14,"Los Angeles Lakers","Jalen Hood-Schifino",0,0,0,0,0,0
1,0,4,6,2,10,5,2,2,"32",1,4,14,5,1,3,1037785,"2023-11-19T00:00:00.000Z",14,FALSE,11,38017684,"F",11,11,"Houston Rockets","Jabari Smith Jr.",1,19,20,15,6,21.5
5,1,8,2,1,16,11,0,0,"31",2,4,23,10,0,4,1037785,"2023-11-19T00:00:00.000Z",14,FALSE,11,17896062,"F-C",11,11,"Houston Rockets","Alperen Sengun",1,33,38,28,15,41.5
3,1,6,5,2,10,3,3,1,"31",0,1,9,6,0,4,1037785,"2023-11-19T00:00:00.000Z",14,FALSE,11,17895966,"G",11,11,"Houston Rockets","Jalen Green",1,15,18,12,9,19.7
16,0,1,10,3,14,5,2,2,"40",0,1,15,1,1,3,1037785,"2023-11-19T00:00:00.000Z",14,FALSE,11,458,"G",11,11,"Houston Rockets","Fred VanVleet",1,16,32,31,17,40.2
4,1,2,2,1,15,6,8,7,"39",3,3,20,5,1,2,1037786,"2023-11-20T00:00:00.000Z",4,FALSE,2,204,"F",4,4,"Charlotte Hornets","Gordon Hayward",2,25,29,24,9,36
5,0,15,7,2,13,3,6,6,"45",0,1,14,15,1,1,1037786,"2023-11-20T00:00:00.000Z",4,FALSE,2,62,"F",4,4,"Charlotte Hornets","Miles Bridges",1,29,34,19,20,41.5
2,3,8,0,0,14,8,2,2,"33",8,4,18,16,1,1,1037786,"2023-11-20T00:00:00.000Z",4,FALSE,2,38017698,"C",4,4,"Charlotte Hornets","Mark Williams",4,34,36,20,18,51.2
4,1,3,4,1,12,4,0,0,"40",4,2,9,7,2,2,1037786,"2023-11-20T00:00:00.000Z",4,FALSE,2,56677823,"F",4,4,"Charlotte Hornets","Brandon Miller",3,16,20,13,11,30.4
8,1,7,11,5,27,15,1,1,"41",2,5,36,9,2,5,1037786,"2023-11-20T00:00:00.000Z",4,FALSE,2,3547239,"G",4,4,"Charlotte Hornets","LaMelo Ball",3,45,53,44,17,62.8
0,0,0,0,0,0,0,0,0,"00",0,0,0,0,0,0,1037786,"2023-11-20T00:00:00.000Z",4,FALSE,2,17896037,"G",4,4,"Charlotte Hornets","James Bouknight",0,0,0,0,0,0
0,0,0,0,0,0,0,0,0,"00",0,0,0,0,0,0,1037786,"2023-11-20T00:00:00.000Z",4,FALSE,2,3547253,"G",4,4,"Charlotte Hornets","Theo Maledon",0,0,0,0,0,0
2,0,2,6,1,6,1,0,0,"14",0,1,3,2,0,1,1037786,"2023-11-20T00:00:00.000Z",4,FALSE,2,38017708,"G",4,4,"Charlotte Hornets","Bryce McGowens",0,5,7,5,4,7.4
3,0,2,0,0,4,3,0,0,"20",0,0,6,2,0,1,1037786,"2023-11-20T00:00:00.000Z",4,FALSE,2,422,"G",4,4,"Charlotte Hornets","Ish Smith",0,8,11,9,5,11.9
0,0,0,0,0,0,0,0,0,"00",0,0,0,0,0,0,1037786,"2023-11-20T00:00:00.000Z",4,FALSE,2,56677846,"G",4,4,"Charlotte Hornets","Nick Smith Jr.",0,0,0,0,0,0
0,0,0,0,0,0,0,0,0,"05",0,1,0,0,0,0,1037786,"2023-11-20T00:00:00.000Z",4,FALSE,2,18678001,"F",4,4,"Charlotte Hornets","JT Thor",0,0,0,0,0,0
1,1,1,9,3,13,6,0,0,"28",0,1,15,1,2,0,1037786,"2023-11-20T00:00:00.000Z",4,FALSE,2,666950,"F",4,4,"Charlotte Hornets","P.J. Washington",3,16,17,16,2,26.7
0,0,0,0,0,0,0,0,0,"00",0,0,0,0,0,0,1037786,"2023-11-20T00:00:00.000Z",4,FALSE,2,56677848,"G",4,4,"Charlotte Hornets","Amari Bailey",0,0,0,0,0,0
0,0,0,0,0,0,0,0,0,"00",0,0,0,0,0,0,1037786,"2023-11-20T00:00:00.000Z",4,FALSE,2,56677866,"F",4,4,"Charlotte Hornets","Leaky Black",0,0,0,0,0,0
0,0,0,0,0,0,0,0,0,"00",0,0,0,0,0,0,1037786,"2023-11-20T00:00:00.000Z",4,FALSE,2,666748,"F",4,4,"Charlotte Hornets","Cody Martin",0,0,0,0,0,0
0,0,0,0,0,0,0,0,0,"00",0,0,0,0,0,0,1037786,"2023-11-20T00:00:00.000Z",4,FALSE,2,347,"G",4,4,"Charlotte Hornets","Frank Ntilikina",0,0,0,0,0,0
0,0,0,0,0,0,0,0,0,"00",0,0,0,0,0,0,1037786,"2023-11-20T00:00:00.000Z",4,FALSE,2,3547282,"C",4,4,"Charlotte Hornets","Nick Richards",0,0,0,0,0,0
0,0,0,0,0,0,0,0,0,"00",0,0,0,0,0,0,1037786,"2023-11-20T00:00:00.000Z",4,FALSE,2,403,"G",4,4,"Charlotte Hornets","Terry Rozier",0,0,0,0,0,0
1,0,1,9,1,9,1,0,0,"38",0,3,3,1,0,1,1037786,"2023-11-20T00:00:00.000Z",4,FALSE,2,17896060,"F",2,2,"Boston Celtics","Sam Hauser",0,4,5,4,2,4.7
6,2,13,15,7,28,15,10,8,"44",0,1,45,13,0,3,1037786,"2023-11-20T00:00:00.000Z",4,FALSE,2,434,"F",2,2,"Boston Celtics","Jayson Tatum",2,58,64,51,19,72.6
0,3,5,8,1,14,5,10,6,"34",3,2,17,8,2,0,1037786,"2023-11-20T00:00:00.000Z",4,FALSE,2,378,"F-C",2,2,"Boston Celtics","Kristaps Porzingis",5,25,25,17,8,41.6
3,0,3,5,0,17,5,4,3,"34",1,5,13,4,0,2,1037786,"2023-11-20T00:00:00.000Z",4,FALSE,2,70,"G",2,2,"Boston Celtics","Jaylen Brown",0,17,20,16,7,20.3
5,2,3,3,1,11,5,2,0,"37",3,1,11,6,1,7,1037786,"2023-11-20T00:00:00.000Z",4,FALSE,2,214,"G",2,2,"Boston Celtics","Jrue Holiday",3,17,22,16,11,27.7
0,0,0,0,0,0,0,0,0,"00",0,0,0,0,0,0,1037786,"2023-11-20T00:00:00.000Z",4,FALSE,2,17896094,"G",2,2,"Boston Celtics","Dalano Banton",0,0,0,0,0,0
1,0,5,0,0,0,0,2,1,"17",2,2,1,7,0,0,1037786,"2023-11-20T00:00:00.000Z",4,FALSE,2,666468,"F",2,2,"Boston Celtics","Oshae Brissett",0,8,9,2,8,10.9
0,0,0,0,0,0,0,0,0,"00",0,0,0,0,0,0,1037786,"2023-11-20T00:00:00.000Z",4,FALSE,2,38017707,"G",2,2,"Boston Celtics","JD Davison",0,0,0,0,0,0
0,1,3,0,0,2,2,0,0,"19",0,0,4,3,0,0,1037786,"2023-11-20T00:00:00.000Z",4,FALSE,2,261,"F-C",2,2,"Boston Celtics","Luke Kornet",1,7,7,4,3,10.6
0,0,0,2,1,2,1,0,0,"09",0,0,3,0,1,0,1037786,"2023-11-20T00:00:00.000Z",4,FALSE,2,338,"G",2,2,"Boston Celtics","Svi Mykhailiuk",1,3,3,3,0,6
3,0,4,8,5,14,8,0,0,"33",2,1,21,6,2,0,1037786,"2023-11-20T00:00:00.000Z",4,FALSE,2,3547276,"G",2,2,"Boston Celtics","Payton Pritchard",2,27,30,24,9,38.7
0,0,0,0,0,0,0,0,0,"00",0,0,0,0,0,0,1037786,"2023-11-20T00:00:00.000Z",4,FALSE,2,17553967,"C",2,2,"Boston Celtics","Neemias Queta",0,0,0,0,0,0
0,0,0,0,0,0,0,0,0,"00",0,0,0,0,0,0,1037786,"2023-11-20T00:00:00.000Z",4,FALSE,2,3547279,"F",2,2,"Boston Celtics","Lamar Stevens",0,0,0,0,0,0
0,0,0,0,0,0,0,0,0,"00",0,0,0,0,0,0,1037786,"2023-11-20T00:00:00.000Z",4,FALSE,2,56677864,"G",2,2,"Boston Celtics","Jordan Walsh",0,0,0,0,0,0
0,0,0,0,0,0,0,0,0,"00",0,0,0,0,0,0,1037786,"2023-11-20T00:00:00.000Z",4,FALSE,2,219,"C-F",2,2,"Boston Celtics","Al Horford",0,0,0,0,0,0
0,0,0,0,0,0,0,0,0,"00",0,0,0,0,0,0,1037786,"2023-11-20T00:00:00.000Z",4,FALSE,2,3547295,"F-C",2,2,"Boston Celtics","Nathan Knight",0,0,0,0,0,0
0,0,0,0,0,0,0,0,0,"00",0,0,0,0,0,0,1037786,"2023-11-20T00:00:00.000Z",4,FALSE,2,473,"G",2,2,"Boston Celtics","Derrick White",0,0,0,0,0,0
0,2,4,0,0,10,4,0,0,"24",3,5,8,7,0,0,1037787,"2023-11-20T00:00:00.000Z",9,FALSE,8,56677826,"G-F",9,9,"Detroit Pistons","Ausar Thompson",2,15,15,8,7,22.4
1,2,10,2,1,8,4,2,2,"35",1,3,11,11,0,1,1037787,"2023-11-20T00:00:00.000Z",9,FALSE,8,3547267,"F-C",9,9,"Detroit Pistons","Isaiah Stewart",2,22,23,12,12,30.7
1,0,5,0,0,13,7,5,4,"26",3,4,18,8,0,1,1037787,"2023-11-20T00:00:00.000Z",9,FALSE,8,24,"F",9,9,"Detroit Pistons","Marvin Bagley III",0,26,27,19,9,28.1
9,1,3,4,2,17,7,11,11,"38",0,2,27,3,3,5,1037787,"2023-11-20T00:00:00.000Z",9,FALSE,8,17896075,"G-F",9,9,"Detroit Pistons","Cade Cunningham",4,30,39,36,12,51.1
3,0,2,1,1,8,7,2,2,"30",1,2,17,3,1,4,1037787,"2023-11-20T00:00:00.000Z",9,FALSE,8,38017682,"G",9,9,"Detroit Pistons","Jaden Ivey",1,20,23,20,6,24.1
2,0,3,4,0,5,1,2,1,"17",0,1,3,3,1,1,1037787,"2023-11-20T00:00:00.000Z",9,FALSE,8,77,"G",9,9,"Detroit Pistons","Alec Burks",1,6,8,5,5,11.6
0,0,0,0,0,0,0,0,0,"00",0,0,0,0,0,0,1037787,"2023-11-20T00:00:00.000Z",9,FALSE,8,38017694,"C",9,9,"Detroit Pistons","Jalen Duren",0,0,0,0,0,0
0,0,0,0,0,0,0,0,0,"00",0,0,0,0,0,0,1037787,"2023-11-20T00:00:00.000Z",9,FALSE,8,17896007,"G",8,8,"Denver Nuggets","Braxton Key",0,0,0,0,0,0
0,1,0,1,1,3,2,3,2,"14",1,3,7,1,1,1,1037787,"2023-11-20T00:00:00.000Z",9,FALSE,8,3547268,"F-C",8,8,"Denver Nuggets","Zeke Nnaji",2,8,8,7,1,13.2
1,0,1,0,0,1,1,0,0,"07",1,1,2,2,1,0,1037787,"2023-11-20T00:00:00.000Z",9,FALSE,8,56677582,"G",8,8,"Denver Nuggets","Jalen Pickett",1,4,5,3,3,8.9
2,0,2,3,0,5,1,2,2,"15",0,1,4,2,0,0,1037787,"2023-11-20T00:00:00.000Z",9,FALSE,8,56677776,"G",8,8,"Denver Nuggets","Julian Strawther",0,6,8,6,4,9.4
0,0,0,0,0,0,0,0,0,"00",0,0,0,0,0,0,1037787,"2023-11-20T00:00:00.000Z",9,FALSE,8,56677871,"F",8,8,"Denver Nuggets","Hunter Tyson",0,0,0,0,0,0
2,2,1,0,0,2,1,2,2,"14",0,1,4,1,0,1,1037787,"2023-11-20T00:00:00.000Z",9,FALSE,8,38017721,"G",8,8,"Denver Nuggets","Peyton Watson",2,5,7,6,3,13.2
0,0,0,0,0,0,0,0,0,"00",0,0,0,0,0,0,1037787,"2023-11-20T00:00:00.000Z",9,FALSE,8,666489,"F",8,8,"Denver Nuggets","Vlatko Cancar",0,0,0,0,0,0
0,0,0,0,0,0,0,0,0,"00",0,0,0,0,0,0,1037787,"2023-11-20T00:00:00.000Z",9,FALSE,8,17896103,"F-C",8,8,"Denver Nuggets","Jay Huff",0,0,0,0,0,0
0,0,0,0,0,0,0,0,0,"00",0,0,0,0,0,0,1037787,"2023-11-20T00:00:00.000Z",9,FALSE,8,335,"G",8,8,"Denver Nuggets","Jamal Murray",0,0,0,0,0,0
2,0,0,1,0,2,0,0,0,"14",0,2,0,0,2,2,1037787,"2023-11-20T00:00:00.000Z",9,FALSE,8,3547241,"G",9,9,"Detroit Pistons","Killian Hayes",2,0,2,2,2,7
0,0,0,0,0,0,0,0,0,"00",0,0,0,0,0,0,1037787,"2023-11-20T00:00:00.000Z",9,FALSE,8,259,"F",9,9,"Detroit Pistons","Kevin Knox",0,0,0,0,0,0
1,0,2,3,0,7,1,4,4,"23",2,2,6,4,0,2,1037787,"2023-11-20T00:00:00.000Z",9,FALSE,8,17896071,"F",9,9,"Detroit Pistons","Isaiah Livers",0,10,11,7,5,10.3
0,0,0,1,0,2,1,0,0,"05",0,0,2,0,0,0,1037787,"2023-11-20T00:00:00.000Z",9,FALSE,8,56677792,"G",9,9,"Detroit Pistons","Marcus Sasser",0,2,2,2,0,2
2,0,1,5,3,8,4,0,0,"18",0,1,11,1,0,1,1037787,"2023-11-20T00:00:00.000Z",9,FALSE,8,44477024,"G",9,9,"Detroit Pistons","Stanley Umude",0,12,14,13,3,14.2
0,0,2,0,0,1,0,0,0,"10",1,2,0,3,0,1,1037787,"2023-11-20T00:00:00.000Z",9,FALSE,8,3547240,"C",9,9,"Detroit Pistons","James Wiseman",0,3,3,0,3,2.6
0,0,0,0,0,0,0,0,0,"00",0,0,0,0,0,0,1037787,"2023-11-20T00:00:00.000Z",9,FALSE,8,54,"F",9,9,"Detroit Pistons","Bojan Bogdanovic",0,0,0,0,0,0
0,0,0,0,0,0,0,0,0,"00",0,0,0,0,0,0,1037787,"2023-11-20T00:00:00.000Z",9,FALSE,8,56677729,"G",9,9,"Detroit Pistons","Malcolm Cazalon",0,0,0,0,0,0
0,0,0,0,0,0,0,0,0,"00",0,0,0,0,0,0,1037787,"2023-11-20T00:00:00.000Z",9,FALSE,8,197,"F-G",9,9,"Detroit Pistons","Joe Harris",0,0,0,0,0,0
0,0,0,0,0,0,0,0,0,"00",0,0,0,0,0,0,1037787,"2023-11-20T00:00:00.000Z",9,FALSE,8,330,"G",9,9,"Detroit Pistons","Monte Morris",0,0,0,0,0,0
0,0,0,0,0,0,0,0,0,"00",0,0,0,0,0,0,1037787,"2023-11-20T00:00:00.000Z",9,FALSE,8,42097199,"G",9,9,"Detroit Pistons","Jared Rhoden",0,0,0,0,0,0
2,1,9,9,4,15,5,1,0,"38",2,3,14,11,0,4,1037787,"2023-11-20T00:00:00.000Z",9,FALSE,8,375,"F",8,8,"Denver Nuggets","Michael Porter Jr.",1,25,27,16,13,29.2
7,0,4,1,0,10,4,4,3,"37",4,1,11,8,1,2,1037787,"2023-11-20T00:00:00.000Z",9,FALSE,8,177,"F",8,8,"Denver Nuggets","Aaron Gordon",1,19,26,18,15,32.1
5,1,5,4,1,8,4,0,0,"15",0,1,9,5,0,1,1037787,"2023-11-20T00:00:00.000Z",9,FALSE,8,246,"C",8,8,"Denver Nuggets","Nikola Jokic",1,14,19,14,10,24.5
3,2,2,5,2,17,8,2,2,"36",1,2,20,3,2,3,1037787,"2023-11-20T00:00:00.000Z",9,FALSE,8,81,"G",8,8,"Denver Nuggets","Kentavious Caldwell-Pope",4,23,26,23,6,37.1
6,1,3,3,1,15,9,3,2,"32",0,2,21,3,1,0,1037787,"2023-11-20T00:00:00.000Z",9,FALSE,8,236,"G",8,8,"Denver Nuggets","Reggie Jackson",2,24,30,27,9,39.6
2,1,5,2,2,10,5,4,3,"32",1,2,15,6,1,2,1037787,"2023-11-20T00:00:00.000Z",9,FALSE,8,38017709,"G",8,8,"Denver Nuggets","Christian Braun",2,21,23,17,8,29.2
0,0,0,0,0,0,0,0,0,"00",0,0,0,0,0,0,1037787,"2023-11-20T00:00:00.000Z",9,FALSE,8,38017727,"G",8,8,"Denver Nuggets","Collin Gillespie",0,0,0,0,0,0
0,0,0,0,0,0,0,0,0,"00",0,0,0,0,0,0,1037787,"2023-11-20T00:00:00.000Z",9,FALSE,8,215,"F-G",8,8,"Denver Nuggets","Justin Holiday",0,0,0,0,0,0
0,0,0,0,0,0,0,0,0,"00",0,0,0,0,0,0,1037787,"2023-11-20T00:00:00.000Z",9,FALSE,8,250,"C",8,8,"Denver Nuggets","DeAndre Jordan",0,0,0,0,0,0
2,1,3,1,0,5,3,2,1,"32",1,3,7,4,0,0,1037788,"2023-11-20T00:00:00.000Z",30,FALSE,17,3547242,"F",30,30,"Washington Wizards","Deni Avdija",1,11,13,9,6,17.8
13,1,3,5,2,15,10,0,0,"31",0,2,22,3,2,2,1037788,"2023-11-20T00:00:00.000Z",30,FALSE,17,265,"F",30,30,"Washington Wizards","Kyle Kuzma",3,25,38,35,16,52.1
2,2,4,0,0,14,7,0,0,"29",2,3,14,6,0,0,1037788,"2023-11-20T00:00:00.000Z",30,FALSE,17,666577,"F",30,30,"Washington Wizards","Daniel Gafford",2,20,22,16,8,30.2
1,0,1,9,3,26,11,5,5,"33",0,4,30,1,0,0,1037788,"2023-11-20T00:00:00.000Z",30,FALSE,17,666848,"G",30,30,"Washington Wizards","Jordan Poole",0,31,32,31,2,32.7
3,0,2,1,0,13,9,0,0,"26",0,0,18,2,0,0,1037788,"2023-11-20T00:00:00.000Z",30,FALSE,17,249,"G",30,30,"Washington Wizards","Tyus Jones",0,20,23,21,5,24.9
0,0,0,0,0,0,0,0,0,"00",0,0,0,0,0,0,1037788,"2023-11-20T00:00:00.000Z",30,FALSE,17,38017704,"F",30,30,"Washington Wizards","Patrick Baldwin Jr.",0,0,0,0,0,0
0,0,0,0,0,0,0,0,0,"01",0,0,0,0,0,0,1037788,"2023-11-20T00:00:00.000Z",30,FALSE,17,18677954,"G",30,30,"Washington Wizards","Jared Butler",0,0,0,0,0,0
0,0,0,0,0,0,0,0,0,"00",0,0,0,0,0,0,1037788,"2023-11-20T00:00:00.000Z",30,FALSE,17,38124126,"F",30,30,"Washington Wizards","John Butler Jr.",0,0,0,0,0,0
1,0,2,2,2,7,5,0,0,"25",1,3,12,3,2,1,1037788,"2023-11-20T00:00:00.000Z",30,FALSE,17,56677844,"G",30,30,"Washington Wizards","Bilal Coulibaly",2,15,16,13,4,22.1
1,0,1,0,0,0,0,0,0,"06",0,0,0,1,0,0,1037788,"2023-11-20T00:00:00.000Z",30,FALSE,17,38017687,"G",30,30,"Washington Wizards","Johnny Davis",0,1,2,1,2,2.7
3,0,1,3,0,6,2,0,0,"18",1,1,4,2,0,0,1037788,"2023-11-20T00:00:00.000Z",30,FALSE,17,167,"F",30,30,"Washington Wizards","Danilo Gallinari",0,6,9,7,5,10.9
0,0,0,0,0,0,0,0,0,"01",0,0,0,0,1,0,1037788,"2023-11-20T00:00:00.000Z",30,FALSE,17,3547302,"F",30,30,"Washington Wizards","Anthony Gill",1,0,0,0,0,3
2,0,1,4,1,9,5,2,1,"21",1,1,12,2,1,0,1037788,"2023-11-20T00:00:00.000Z",30,FALSE,17,17896045,"F",30,30,"Washington Wizards","Corey Kispert",1,14,16,14,4,20.4
0,0,0,0,0,0,0,0,0,"00",0,0,0,0,0,0,1037788,"2023-11-20T00:00:00.000Z",30,FALSE,17,337,"F-C",30,30,"Washington Wizards","Mike Muscala",0,0,0,0,0,0
0,0,0,1,0,1,0,2,2,"01",0,0,2,0,0,0,1037788,"2023-11-20T00:00:00.000Z",30,FALSE,17,17896106,"F",30,30,"Washington Wizards","Eugene Omoruyi",0,2,2,2,0,2
0,0,0,0,0,0,0,0,0,"01",0,0,0,0,0,0,1037788,"2023-11-20T00:00:00.000Z",30,FALSE,17,38017712,"G",30,30,"Washington Wizards","Ryan Rollins",0,0,0,0,0,0
2,0,3,3,2,4,3,0,0,"15",0,2,8,3,0,1,1037788,"2023-11-20T00:00:00.000Z",30,FALSE,17,414,"G",30,30,"Washington Wizards","Landry Shamet",0,11,13,10,5,13.6
0,0,0,0,0,0,0,0,0,"00",0,0,0,0,0,0,1037788,"2023-11-20T00:00:00.000Z",30,FALSE,17,487,"G",30,30,"Washington Wizards","Delon Wright",0,0,0,0,0,0
7,0,5,2,0,12,6,7,6,"23",1,3,18,6,0,4,1037788,"2023-11-20T00:00:00.000Z",30,FALSE,17,315,"F",17,17,"Milwaukee Bucks","Khris Middleton",0,24,31,25,13,31.7
8,1,7,0,0,23,20,6,2,"34",6,2,42,13,1,5,1037788,"2023-11-20T00:00:00.000Z",30,FALSE,17,15,"F",17,17,"Milwaukee Bucks","Giannis Antetokounmpo",2,55,63,50,21,70.6
1,5,5,4,1,12,7,1,1,"32",4,0,16,9,0,1,1037788,"2023-11-20T00:00:00.000Z",30,FALSE,17,283,"C",17,17,"Milwaukee Bucks","Brook Lopez",5,25,26,17,10,42.3
2,0,4,5,3,9,5,3,3,"33",1,0,16,5,0,0,1037788,"2023-11-20T00:00:00.000Z",30,FALSE,17,38,"G",17,17,"Milwaukee Bucks","Malik Beasley",0,21,23,18,7,25
7,0,4,6,3,14,5,11,9,"33",1,1,22,5,0,1,1037788,"2023-11-20T00:00:00.000Z",30,FALSE,17,278,"G",17,17,"Milwaukee Bucks","Damian Lillard",0,27,34,29,12,37.5
1,0,7,3,1,13,8,0,0,"23",1,2,17,8,1,1,1037788,"2023-11-20T00:00:00.000Z",30,FALSE,17,377,"F",17,17,"Milwaukee Bucks","Bobby Portis",1,25,26,18,9,30.1
4,0,3,2,1,2,1,0,0,"27",1,1,3,4,0,0,1037788,"2023-11-20T00:00:00.000Z",30,FALSE,17,105,"G",17,17,"Milwaukee Bucks","Pat Connaughton",0,7,11,7,8,13.8
1,0,2,3,0,4,1,0,0,"15",0,1,2,2,0,0,1037788,"2023-11-20T00:00:00.000Z",30,FALSE,17,38017733,"G",17,17,"Milwaukee Bucks","A.J. Green",0,4,5,3,3,5.9
2,0,2,4,2,5,2,0,0,"17",0,1,6,2,1,1,1037788,"2023-11-20T00:00:00.000Z",30,FALSE,17,368,"G",17,17,"Milwaukee Bucks","Cameron Payne",1,8,10,8,4,13.4
0,0,0,0,0,0,0,0,0,"01",0,0,0,0,0,0,1037788,"2023-11-20T00:00:00.000Z",30,FALSE,17,2148,"",17,17,"Milwaukee Bucks","Thanasis Antetokounmpo",0,0,0,0,0,0
0,0,0,0,0,0,0,0,0,"01",1,0,0,1,0,0,1037788,"2023-11-20T00:00:00.000Z",30,FALSE,17,56677852,"G",17,17,"Milwaukee Bucks","Andre Jackson Jr.",0,1,1,0,1,1.2
0,0,0,0,0,0,0,0,0,"01",0,2,0,0,0,0,1037788,"2023-11-20T00:00:00.000Z",30,FALSE,17,284,"C",17,17,"Milwaukee Bucks","Robin Lopez",0,0,0,0,0,0
0,0,0,0,0,0,0,0,0,"00",0,0,0,0,0,0,1037788,"2023-11-20T00:00:00.000Z",30,FALSE,17,38017676,"F",17,17,"Milwaukee Bucks","MarJon Beauchamp",0,0,0,0,0,0
0,0,0,0,0,0,0,0,0,"00",0,0,0,0,0,0,1037788,"2023-11-20T00:00:00.000Z",30,FALSE,17,38017691,"G",17,17,"Milwaukee Bucks","TyTy Washington Jr.",0,0,0,0,0,0
0,0,0,0,0,0,0,0,0,"00",0,0,0,0,0,0,1037788,"2023-11-20T00:00:00.000Z",30,FALSE,17,666960,"G",17,17,"Milwaukee Bucks","Lindell Wigginton",0,0,0,0,0,0
0,0,0,0,0,0,0,0,0,"00",0,0,0,0,0,0,1037788,"2023-11-20T00:00:00.000Z",30,FALSE,17,666453,"C",17,17,"Milwaukee Bucks","Marques Bolden",0,0,0,0,0,0
0,0,0,0,0,0,0,0,0,"00",0,0,0,0,0,0,1037788,"2023-11-20T00:00:00.000Z",30,FALSE,17,112,"F",17,17,"Milwaukee Bucks","Jae Crowder",0,0,0,0,0,0
0,0,0,0,0,0,0,0,0,"00",0,0,0,0,0,0,1037788,"2023-11-20T00:00:00.000Z",30,FALSE,17,56677854,"F",17,17,"Milwaukee Bucks","Chris Livingston",0,0,0,0,0,0
5,1,4,4,2,10,6,1,1,"34",0,1,15,4,0,0,1037789,"2023-11-20T00:00:00.000Z",5,FALSE,16,125,"G",5,5,"Chicago Bulls","DeMar DeRozan",1,19,24,20,9,30.3
3,1,2,4,2,10,4,4,3,"27",2,1,13,4,1,2,1037789,"2023-11-20T00:00:00.000Z",5,FALSE,16,89,"G",5,5,"Chicago Bulls","Alex Caruso",2,17,20,16,7,26.3
2,0,5,4,0,16,7,4,4,"32",2,4,18,7,0,2,1037789,"2023-11-20T00:00:00.000Z",5,FALSE,16,460,"C",5,5,"Chicago Bulls","Nikola Vucevic",0,25,27,20,9,27.4
5,0,3,6,2,9,5,1,1,"35",0,1,13,3,0,1,1037789,"2023-11-20T00:00:00.000Z",5,FALSE,16,268,"G",5,5,"Chicago Bulls","Zach LaVine",0,16,21,18,8,23.1
3,1,5,8,4,11,7,2,2,"34",1,2,20,6,1,2,1037789,"2023-11-20T00:00:00.000Z",5,FALSE,16,666956,"G",5,5,"Chicago Bulls","Coby White",2,26,29,23,9,35.7
1,1,0,4,0,5,0,0,0,"14",0,2,0,0,0,1,1037789,"2023-11-20T00:00:00.000Z",5,FALSE,16,87,"G",5,5,"Chicago Bulls","Jevon Carter",1,0,1,1,1,3.5
0,0,1,3,0,5,1,0,0,"16",0,1,2,1,0,0,1037789,"2023-11-20T00:00:00.000Z",5,FALSE,16,110,"F",5,5,"Chicago Bulls","Torrey Craig",0,3,3,2,1,3.2
3,0,1,1,1,4,3,0,0,"20",1,3,7,2,1,1,1037789,"2023-11-20T00:00:00.000Z",5,FALSE,16,3092,"",16,16,"Miami Heat","Haywood Highsmith",1,9,12,10,5,15.9
6,0,8,0,0,14,8,9,7,"30",3,3,23,11,1,1,1037789,"2023-11-20T00:00:00.000Z",5,FALSE,16,4,"C-F",16,16,"Miami Heat","Bam Adebayo",1,34,40,29,17,47.2
2,0,2,9,6,11,7,2,2,"30",0,3,22,2,0,0,1037789,"2023-11-20T00:00:00.000Z",5,FALSE,16,397,"F",16,16,"Miami Heat","Duncan Robinson",0,24,26,24,4,27.4
6,0,4,4,2,6,3,0,0,"27",1,1,8,5,0,1,1037789,"2023-11-20T00:00:00.000Z",5,FALSE,16,286,"G",16,16,"Miami Heat","Kyle Lowry",0,13,19,14,11,22
4,0,1,4,3,13,8,0,0,"33",2,1,19,3,2,0,1037789,"2023-11-20T00:00:00.000Z",5,FALSE,16,56677785,"G",16,16,"Miami Heat","Jaime Jaquez Jr.",2,22,26,23,7,34.6
1,0,8,5,3,6,4,0,0,"15",0,2,11,8,0,1,1037789,"2023-11-20T00:00:00.000Z",5,FALSE,16,285,"F-C",16,16,"Miami Heat","Kevin Love",0,19,20,12,9,21.1
2,0,5,3,0,6,1,0,0,"21",0,1,2,5,0,0,1037789,"2023-11-20T00:00:00.000Z",5,FALSE,16,666747,"F",16,16,"Miami Heat","Caleb Martin",0,7,9,4,7,11
1,1,2,6,2,12,4,0,0,"30",2,2,10,4,0,3,1037789,"2023-11-20T00:00:00.000Z",5,FALSE,16,391,"G-F",16,16,"Miami Heat","Josh Richardson",1,14,15,11,5,16.3
1,0,1,1,0,3,1,4,4,"12",1,2,6,2,0,0,1037789,"2023-11-20T00:00:00.000Z",5,FALSE,16,17895983,"G",5,5,"Chicago Bulls","Ayo Dosunmu",0,8,9,7,3,9.9
1,1,4,0,0,3,1,0,0,"14",0,1,2,4,0,0,1037789,"2023-11-20T00:00:00.000Z",5,FALSE,16,137,"C",5,5,"Chicago Bulls","Andre Drummond",1,6,7,3,5,11.3
0,0,1,0,0,2,1,0,0,"03",0,1,2,1,0,0,1037789,"2023-11-20T00:00:00.000Z",5,FALSE,16,56677857,"F",5,5,"Chicago Bulls","Julian Phillips",0,3,3,2,1,3.2
0,0,0,0,0,0,0,0,0,"02",0,0,0,0,0,0,1037789,"2023-11-20T00:00:00.000Z",5,FALSE,16,17896116,"G",5,5,"Chicago Bulls","Terry Taylor",0,0,0,0,0,0
0,0,0,0,0,0,0,0,0,"00",0,0,0,0,0,0,1037789,"2023-11-20T00:00:00.000Z",5,FALSE,16,38017719,"F",5,5,"Chicago Bulls","Dalen Terry",0,0,0,0,0,0
0,2,3,3,1,7,4,0,0,"17",0,0,9,3,0,2,1037789,"2023-11-20T00:00:00.000Z",5,FALSE,16,3547248,"F",5,5,"Chicago Bulls","Patrick Williams",2,12,12,9,3,16.6
0,0,0,0,0,0,0,0,0,"00",0,0,0,0,0,0,1037789,"2023-11-20T00:00:00.000Z",5,FALSE,16,27,"G",5,5,"Chicago Bulls","Lonzo Ball",0,0,0,0,0,0
0,0,0,0,0,0,0,0,0,"00",0,0,0,0,0,0,1037789,"2023-11-20T00:00:00.000Z",5,FALSE,16,56677874,"F",5,5,"Chicago Bulls","Onuralp Bitim",0,0,0,0,0,0
0,0,0,0,0,0,0,0,0,"00",0,0,0,0,0,0,1037789,"2023-11-20T00:00:00.000Z",5,FALSE,16,56677860,"F",5,5,"Chicago Bulls","Adama Sanogo",0,0,0,0,0,0
6,0,3,2,0,11,4,9,8,"29",0,2,16,3,1,1,1037789,"2023-11-20T00:00:00.000Z",5,FALSE,16,79,"G-F",16,16,"Miami Heat","Jimmy Butler",1,19,25,22,9,30.6
0,0,0,0,0,0,0,0,0,"00",0,0,0,0,0,0,1037789,"2023-11-20T00:00:00.000Z",5,FALSE,16,74,"C",16,16,"Miami Heat","Thomas Bryant",0,0,0,0,0,0
0,0,0,0,0,0,0,0,0,"02",0,1,0,0,0,0,1037789,"2023-11-20T00:00:00.000Z",5,FALSE,16,39398582,"C",16,16,"Miami Heat","Orlando Robinson",0,0,0,0,0,0
0,0,1,1,0,1,0,0,0,"03",0,0,0,1,1,0,1037789,"2023-11-20T00:00:00.000Z",5,FALSE,16,19465585,"G",16,16,"Miami Heat","Dru Smith",1,1,1,0,1,4.2
0,0,0,0,0,0,0,0,0,"00",0,0,0,0,0,0,1037789,"2023-11-20T00:00:00.000Z",5,FALSE,16,38017734,"F",16,16,"Miami Heat","Jamal Cain",0,0,0,0,0,0
0,0,0,0,0,0,0,0,0,"00",0,0,0,0,0,0,1037789,"2023-11-20T00:00:00.000Z",5,FALSE,16,3547257,"G",16,16,"Miami Heat","R.J. Hampton",0,0,0,0,0,0
0,0,0,0,0,0,0,0,0,"00",0,0,0,0,0,0,1037789,"2023-11-20T00:00:00.000Z",5,FALSE,16,666633,"G",16,16,"Miami Heat","Tyler Herro",0,0,0,0,0,0
0,0,0,0,0,0,0,0,0,"00",0,0,0,0,0,0,1037789,"2023-11-20T00:00:00.000Z",5,FALSE,16,38017696,"F",16,16,"Miami Heat","Nikola Jovic",0,0,0,0,0,0
0,0,0,0,0,0,0,0,0,"00",0,0,0,0,0,0,1037789,"2023-11-20T00:00:00.000Z",5,FALSE,16,38017736,"F",16,16,"Miami Heat","Cole Swider",0,0,0,0,0,0
0,0,0,0,0,0,0,0,0,"00",0,0,0,0,0,0,1037789,"2023-11-20T00:00:00.000Z",5,FALSE,16,45969255,"F",5,5,"Chicago Bulls","Justin Lewis",0,0,0,0,0,0
0,0,1,0,0,2,2,0,0,"05",0,0,4,1,0,1,1037790,"2023-11-20T00:00:00.000Z",18,FALSE,20,3547259,"F",18,18,"Minnesota Timberwolves","Jaden McDaniels",0,5,5,4,1,4.2
4,2,5,3,2,10,6,7,6,"36",0,6,20,5,3,3,1037790,"2023-11-20T00:00:00.000Z",18,FALSE,20,447,"C",18,18,"Minnesota Timberwolves","Karl-Anthony Towns",5,25,29,24,9,44
1,2,4,0,0,7,7,7,2,"26",3,2,16,7,0,1,1037790,"2023-11-20T00:00:00.000Z",18,FALSE,20,176,"C",18,18,"Minnesota Timberwolves","Rudy Gobert",2,23,24,17,8,30.9
5,0,8,6,1,21,9,4,4,"39",2,1,23,10,2,3,1037790,"2023-11-20T00:00:00.000Z",18,FALSE,20,3547238,"G",18,18,"Minnesota Timberwolves","Anthony Edwards",2,33,38,28,15,45.5
5,1,1,8,3,9,3,2,2,"28",0,3,11,1,0,0,1037790,"2023-11-20T00:00:00.000Z",18,FALSE,20,104,"G",18,18,"Minnesota Timberwolves","Mike Conley",1,12,17,16,6,22.7
3,0,2,6,3,8,4,0,0,"33",1,2,11,3,0,0,1037790,"2023-11-20T00:00:00.000Z",18,FALSE,20,666400,"G",18,18,"Minnesota Timberwolves","Nickeil Alexander-Walker",0,14,17,14,6,19.1
5,2,2,0,0,4,3,5,3,"23",0,2,9,2,1,1,1037790,"2023-11-20T00:00:00.000Z",18,FALSE,20,12,"F",18,18,"Minnesota Timberwolves","Kyle Anderson",3,11,16,14,7,26.9
1,0,3,6,1,8,3,3,3,"18",0,6,10,3,1,3,1037790,"2023-11-20T00:00:00.000Z",18,FALSE,20,667378,"F-C",18,18,"Minnesota Timberwolves","Naz Reid",1,13,14,11,4,15.1
1,0,5,4,3,13,4,4,3,"22",2,5,14,7,1,4,1037790,"2023-11-20T00:00:00.000Z",18,FALSE,20,666423,"F-G",20,20,"New York Knicks","RJ Barrett",1,21,22,15,8,22.9
1,0,11,6,1,16,6,12,8,"34",3,2,21,14,0,2,1037790,"2023-11-20T00:00:00.000Z",18,FALSE,20,387,"F",20,20,"New York Knicks","Julius Randle",0,35,36,22,15,37.3
0,2,4,0,0,7,5,0,0,"30",7,3,10,11,2,2,1037790,"2023-11-20T00:00:00.000Z",18,FALSE,20,399,"C",20,20,"New York Knicks","Mitchell Robinson",4,21,21,10,11,33.2
2,0,1,6,0,6,0,0,0,"25",0,2,0,1,2,0,1037790,"2023-11-20T00:00:00.000Z",18,FALSE,20,17895858,"G",20,20,"New York Knicks","Quentin Grimes",2,1,3,2,3,10.2
6,0,4,6,3,15,7,8,8,"36",0,2,25,4,0,1,1037790,"2023-11-20T00:00:00.000Z",18,FALSE,20,73,"G",20,20,"New York Knicks","Jalen Brunson",0,29,35,31,10,37.8
0,0,1,0,0,0,0,0,0,"03",0,0,0,1,0,0,1037790,"2023-11-20T00:00:00.000Z",18,FALSE,20,19,"G",20,20,"New York Knicks","Ryan Arcidiacono",0,1,1,0,1,1.2
5,0,1,6,1,8,2,2,2,"26",2,3,7,3,1,0,1037790,"2023-11-20T00:00:00.000Z",18,FALSE,20,131,"G",20,20,"New York Knicks","Donte DiVincenzo",1,10,15,12,8,21.1
1,0,1,2,0,6,2,0,0,"24",0,0,4,1,2,0,1037790,"2023-11-20T00:00:00.000Z",18,FALSE,20,202,"G",20,20,"New York Knicks","Josh Hart",2,5,6,5,2,12.7
0,1,2,0,0,3,1,0,0,"14",3,3,2,5,0,1,1037790,"2023-11-20T00:00:00.000Z",18,FALSE,20,201,"F-C",20,20,"New York Knicks","Isaiah Hartenstein",1,7,7,2,5,10
0,0,1,1,0,3,0,2,0,"03",0,0,0,1,0,0,1037790,"2023-11-20T00:00:00.000Z",18,FALSE,20,666675,"F",20,20,"New York Knicks","DaQuan Jeffries",0,1,1,0,1,1.2
0,0,0,0,0,0,0,0,0,"03",0,0,0,0,0,0,1037790,"2023-11-20T00:00:00.000Z",18,FALSE,20,17896033,"G",20,20,"New York Knicks","Miles McBride",0,0,0,0,0,0
0,0,1,7,1,14,4,6,6,"17",0,3,15,1,0,0,1037790,"2023-11-20T00:00:00.000Z",18,FALSE,20,3547269,"G",20,20,"New York Knicks","Immanuel Quickley",0,16,16,15,1,16.2
0,0,1,0,0,1,1,0,0,"03",0,0,2,1,0,0,1037790,"2023-11-20T00:00:00.000Z",18,FALSE,20,17896063,"F",20,20,"New York Knicks","Jericho Sims",0,3,3,2,1,3.2
0,0,0,0,0,0,0,0,0,"00",0,0,0,0,0,0,1037790,"2023-11-20T00:00:00.000Z",18,FALSE,20,666474,"G",20,20,"New York Knicks","Charles Brown",0,0,0,0,0,0
0,0,0,0,0,0,0,0,0,"00",0,0,0,0,0,0,1037790,"2023-11-20T00:00:00.000Z",18,FALSE,20,160,"G-F",20,20,"New York Knicks","Evan Fournier",0,0,0,0,0,0
0,0,0,0,0,0,0,0,0,"00",0,0,0,0,0,0,1037790,"2023-11-20T00:00:00.000Z",18,FALSE,20,56677795,"F",20,20,"New York Knicks","Jacob Toppin",0,0,0,0,0,0
0,0,0,0,0,0,0,0,0,"00",0,0,0,0,0,0,1037790,"2023-11-20T00:00:00.000Z",18,FALSE,20,17896089,"G",20,20,"New York Knicks","Duane Washington Jr.",0,0,0,0,0,0
0,0,0,0,0,0,0,0,0,"00",0,0,0,0,0,0,1037790,"2023-11-20T00:00:00.000Z",18,FALSE,20,666971,"G-F",20,20,"New York Knicks","Dylan Windler",0,0,0,0,0,0
4,0,5,2,0,5,2,2,2,"14",0,1,6,5,0,1,1037790,"2023-11-20T00:00:00.000Z",18,FALSE,20,320,"G",18,18,"Minnesota Timberwolves","Shake Milton",0,11,15,10,9,17
2,0,4,3,1,5,1,2,2,"17",1,2,5,5,0,0,1037790,"2023-11-20T00:00:00.000Z",18,FALSE,20,68,"F",18,18,"Minnesota Timberwolves","Troy Brown Jr.",0,10,12,7,7,14
0,0,0,0,0,0,0,0,0,"00",0,0,0,0,0,0,1037790,"2023-11-20T00:00:00.000Z",18,FALSE,20,666767,"G",18,18,"Minnesota Timberwolves","Jordan McLaughlin",0,0,0,0,0,0
0,0,2,0,0,1,1,0,0,"01",0,1,2,2,0,0,1037790,"2023-11-20T00:00:00.000Z",18,FALSE,20,38017715,"F",18,18,"Minnesota Timberwolves","Josh Minott",0,4,4,2,2,4.4
0,0,0,0,0,0,0,0,0,"00",0,0,0,0,0,0,1037790,"2023-11-20T00:00:00.000Z",18,FALSE,20,56677851,"G",18,18,"Minnesota Timberwolves","Jaylen Clark",0,0,0,0,0,0
0,0,0,0,0,0,0,0,0,"00",0,0,0,0,0,0,1037790,"2023-11-20T00:00:00.000Z",18,FALSE,20,17896056,"C",18,18,"Minnesota Timberwolves","Luka Garza",0,0,0,0,0,0
0,0,0,0,0,0,0,0,0,"00",0,0,0,0,0,0,1037790,"2023-11-20T00:00:00.000Z",18,FALSE,20,56677782,"F",18,18,"Minnesota Timberwolves","Leonard Miller",0,0,0,0,0,0
0,0,0,0,0,0,0,0,0,"00",0,0,0,0,0,0,1037790,"2023-11-20T00:00:00.000Z",18,FALSE,20,38017700,"G",18,18,"Minnesota Timberwolves","Wendell Moore Jr.",0,0,0,0,0,0
0,0,0,0,0,0,0,0,0,"00",0,0,0,0,0,0,1037790,"2023-11-20T00:00:00.000Z",18,FALSE,20,17895968,"F",18,18,"Minnesota Timberwolves","Daishen Nix",0,0,0,0,0,0
3,0,4,5,5,18,11,4,4,"26",0,0,31,4,0,1,1037791,"2023-11-20T00:00:00.000Z",19,FALSE,26,227,"F",19,19,"New Orleans Pelicans","Brandon Ingram",0,35,38,34,7,39.3
5,1,3,0,0,16,12,2,2,"30",0,2,26,3,3,1,1037791,"2023-11-20T00:00:00.000Z",19,FALSE,26,666969,"F",19,19,"New Orleans Pelicans","Zion Williamson",4,29,34,31,8,48.1
7,3,12,0,0,4,3,4,4,"21",1,3,10,13,1,0,1037791,"2023-11-20T00:00:00.000Z",19,FALSE,26,455,"C",19,19,"New Orleans Pelicans","Jonas Valanciunas",4,23,30,17,20,48.1
4,2,6,2,1,9,7,4,3,"27",1,4,18,7,1,1,1037791,"2023-11-20T00:00:00.000Z",19,FALSE,26,17896024,"F",19,19,"New Orleans Pelicans","Herbert Jones",3,25,29,22,11,40.4
5,0,2,4,1,4,1,0,0,"25",0,2,3,2,1,0,1037791,"2023-11-20T00:00:00.000Z",19,FALSE,26,38017677,"G",19,19,"New Orleans Pelicans","Dyson Daniels",1,5,10,8,7,15.9
3,0,0,3,1,5,2,0,0,"15",0,0,5,0,0,2,1037791,"2023-11-20T00:00:00.000Z",19,FALSE,26,17896097,"G",19,19,"New Orleans Pelicans","Jose Alvarado",0,5,8,8,3,7.5
2,0,4,5,2,11,3,1,1,"29",1,2,9,5,0,1,1037791,"2023-11-20T00:00:00.000Z",19,FALSE,26,56677837,"G",19,19,"New Orleans Pelicans","Jordan Hawkins",0,14,16,11,7,17
2,0,0,2,1,3,1,0,0,"06",0,1,3,0,1,0,1037791,"2023-11-20T00:00:00.000Z",19,FALSE,26,3547260,"G",19,19,"New Orleans Pelicans","Kira Lewis Jr.",1,3,5,5,2,9
0,0,4,6,3,9,4,6,5,"30",0,0,16,4,1,0,1037791,"2023-11-20T00:00:00.000Z",19,FALSE,26,30,"F",26,26,"Sacramento Kings","Harrison Barnes",1,20,20,16,4,23.8
0,1,1,2,1,4,1,2,2,"16",2,2,5,3,1,0,1037791,"2023-11-20T00:00:00.000Z",19,FALSE,26,38017688,"F",26,26,"Sacramento Kings","Keegan Murray",2,8,8,5,3,14.6
8,0,5,0,0,8,4,3,2,"31",5,4,10,10,0,5,1037791,"2023-11-20T00:00:00.000Z",19,FALSE,26,406,"F",26,26,"Sacramento Kings","Domantas Sabonis",0,20,28,18,18,29
3,0,0,8,2,10,4,0,0,"23",0,1,10,0,0,0,1037791,"2023-11-20T00:00:00.000Z",19,FALSE,26,221,"G",26,26,"Sacramento Kings","Kevin Huerter",0,10,13,13,3,14.5
0,0,2,12,2,18,5,4,2,"29",0,1,14,2,1,2,1037791,"2023-11-20T00:00:00.000Z",19,FALSE,26,161,"G",26,26,"Sacramento Kings","De'Aaron Fox",1,16,16,14,2,17.4
0,0,2,2,0,2,0,0,0,"08",0,1,0,2,0,0,1037791,"2023-11-20T00:00:00.000Z",19,FALSE,26,17896030,"G",26,26,"Sacramento Kings","Chris Duarte",0,2,2,0,2,2.4
8,0,0,2,0,2,0,2,2,"19",0,1,2,0,0,1,1037791,"2023-11-20T00:00:00.000Z",19,FALSE,26,17553994,"G",26,26,"Sacramento Kings","Davion Mitchell",0,2,10,10,8,13
5,0,0,6,2,11,3,0,0,"24",0,2,8,0,0,1,1037791,"2023-11-20T00:00:00.000Z",19,FALSE,26,324,"G",26,26,"Sacramento Kings","Malik Monk",0,8,13,13,5,14.5
4,0,6,5,1,11,5,0,0,"26",1,2,11,7,1,3,1037791,"2023-11-20T00:00:00.000Z",19,FALSE,26,3547293,"F",19,19,"New Orleans Pelicans","Naji Marshall",1,18,22,15,11,25.4
0,0,0,0,0,0,0,0,0,"00",0,0,0,0,0,0,1037791,"2023-11-20T00:00:00.000Z",19,FALSE,26,340,"F",19,19,"New Orleans Pelicans","Larry Nance Jr.",0,0,0,0,0,0
1,0,2,1,0,4,1,2,2,"12",3,1,4,5,0,0,1037791,"2023-11-20T00:00:00.000Z",19,FALSE,26,17896021,"F",19,19,"New Orleans Pelicans","Jeremiah Robinson-Earl",0,9,10,5,6,11.5
2,0,6,1,0,7,4,4,1,"23",3,2,9,9,0,1,1037791,"2023-11-20T00:00:00.000Z",19,FALSE,26,491,"C",19,19,"New Orleans Pelicans","Cody Zeller",0,18,20,11,11,21.8
0,0,0,0,0,0,0,0,0,"00",0,0,0,0,0,0,1037791,"2023-11-20T00:00:00.000Z",19,FALSE,26,38017663,"F",19,19,"New Orleans Pelicans","E.J. Liddell",0,0,0,0,0,0
0,0,0,0,0,0,0,0,0,"00",0,0,0,0,0,0,1037791,"2023-11-20T00:00:00.000Z",19,FALSE,26,303,"G",19,19,"New Orleans Pelicans","CJ McCollum",0,0,0,0,0,0
0,0,0,0,0,0,0,0,0,"00",0,0,0,0,0,0,1037791,"2023-11-20T00:00:00.000Z",19,FALSE,26,18677986,"F",19,19,"New Orleans Pelicans","Trey Murphy III",0,0,0,0,0,0
0,0,0,0,0,0,0,0,0,"00",0,0,0,0,0,0,1037791,"2023-11-20T00:00:00.000Z",19,FALSE,26,17896017,"F",19,19,"New Orleans Pelicans","Matt Ryan",0,0,0,0,0,0
0,0,0,0,0,0,0,0,0,"00",0,0,0,0,0,0,1037791,"2023-11-20T00:00:00.000Z",19,FALSE,26,38017726,"G",19,19,"New Orleans Pelicans","Dereon Seabron",0,0,0,0,0,0
2,1,3,1,0,3,2,0,0,"12",0,1,4,3,0,1,1037791,"2023-11-20T00:00:00.000Z",19,FALSE,26,56677862,"F",26,26,"Sacramento Kings","Jalen Slawson",1,7,9,6,5,12.6
0,0,0,0,0,0,0,0,0,"00",0,0,0,0,0,0,1037791,"2023-11-20T00:00:00.000Z",19,FALSE,26,4197162,"F",26,26,"Sacramento Kings","Aleksandar Vezenkov",0,0,0,0,0,0
0,0,0,0,0,0,0,0,0,"00",0,0,0,0,0,0,1037791,"2023-11-20T00:00:00.000Z",19,FALSE,26,38017714,"G",26,26,"Sacramento Kings","Keon Ellis",0,0,0,0,0,0
0,0,0,0,0,0,0,0,0,"00",0,0,0,0,0,0,1037791,"2023-11-20T00:00:00.000Z",19,FALSE,26,17895990,"G",26,26,"Sacramento Kings","Jordan Ford",0,0,0,0,0,0
0,0,0,0,0,0,0,0,0,"00",0,0,0,0,0,0,1037791,"2023-11-20T00:00:00.000Z",19,FALSE,26,273,"C",26,26,"Sacramento Kings","Alex Len",0,0,0,0,0,0
0,0,0,0,0,0,0,0,0,"00",0,0,0,0,0,0,1037791,"2023-11-20T00:00:00.000Z",19,FALSE,26,290,"F",26,26,"Sacramento Kings","Trey Lyles",0,0,0,0,0,0
1,2,5,0,0,6,4,4,2,"13",2,3,10,7,0,3,1037791,"2023-11-20T00:00:00.000Z",19,FALSE,26,306,"C",26,26,"Sacramento Kings","JaVale McGee",2,17,18,11,8,22.9
0,0,1,2,0,8,4,1,0,"14",0,2,8,1,1,0,1037791,"2023-11-20T00:00:00.000Z",19,FALSE,26,56677845,"G",26,26,"Sacramento Kings","Colby Jones",1,9,9,8,1,12.2
0,1,4,4,1,4,1,0,0,"15",0,2,3,4,0,0,1037791,"2023-11-20T00:00:00.000Z",19,FALSE,26,17896044,"F",26,26,"Sacramento Kings","Kessler Edwards",1,7,7,3,4,10.8
0,0,0,0,0,2,1,2,1,"06",0,1,3,0,0,0,1037791,"2023-11-20T00:00:00.000Z",19,FALSE,26,17895941,"C",26,26,"Sacramento Kings","Filip Petrusev",0,3,3,3,0,3
5,0,8,8,2,16,9,4,2,"32",2,2,22,10,1,1,1037792,"2023-11-20T00:00:00.000Z",27,FALSE,13,666682,"F",27,27,"San Antonio Spurs","Keldon Johnson",1,32,37,27,15,43.5
4,2,3,4,0,12,4,1,1,"26",0,1,9,3,0,2,1037792,"2023-11-20T00:00:00.000Z",27,FALSE,13,56677822,"F-C",27,27,"San Antonio Spurs","Victor Wembanyama",2,12,16,13,7,22.6
0,0,3,5,1,11,4,4,3,"28",0,1,12,3,2,2,1037792,"2023-11-20T00:00:00.000Z",27,FALSE,13,102,"F-C",27,27,"San Antonio Spurs","Zach Collins",2,15,15,12,3,19.6
1,1,3,5,1,7,2,0,0,"23",1,2,5,4,1,1,1037792,"2023-11-20T00:00:00.000Z",27,FALSE,13,38017649,"F",27,27,"San Antonio Spurs","Julian Champagnie",2,9,10,6,5,16.3
1,0,6,3,0,12,3,2,2,"29",2,1,8,8,0,1,1037792,"2023-11-20T00:00:00.000Z",27,FALSE,13,38017699,"F",27,27,"San Antonio Spurs","Jeremy Sochan",0,16,17,9,9,18.1
0,0,0,0,0,0,0,0,0,"00",0,0,0,0,0,0,1037792,"2023-11-20T00:00:00.000Z",27,FALSE,13,38017730,"F",27,27,"San Antonio Spurs","Dominick Barlow",0,0,0,0,0,0
3,4,8,0,0,3,1,0,0,"18",4,2,2,12,0,3,1037792,"2023-11-20T00:00:00.000Z",27,FALSE,13,17895854,"G",27,27,"San Antonio Spurs","Charles Bassey",4,14,17,5,15,29.9
1,0,0,3,2,6,4,0,0,"21",0,2,10,0,0,2,1037792,"2023-11-20T00:00:00.000Z",27,FALSE,13,38017692,"F",27,27,"San Antonio Spurs","Malaki Branham",0,10,11,11,1,9.5
0,0,0,0,0,0,0,0,0,"04",0,0,0,0,0,1,1037792,"2023-11-20T00:00:00.000Z",27,FALSE,13,56677817,"G",27,27,"San Antonio Spurs","Sidy Cissoko",0,0,0,0,0,-1
0,0,0,0,0,0,0,0,0,"00",0,0,0,0,0,0,1037792,"2023-11-20T00:00:00.000Z",27,FALSE,13,180,"G",27,27,"San Antonio Spurs","Devonte' Graham",0,0,0,0,0,0
5,0,0,3,1,10,4,2,2,"23",2,1,11,2,0,3,1037792,"2023-11-20T00:00:00.000Z",27,FALSE,13,3547274,"G",27,27,"San Antonio Spurs","Tre Jones",0,13,18,16,7,17.9
0,0,0,0,0,0,0,0,0,"00",0,0,0,0,0,0,1037792,"2023-11-20T00:00:00.000Z",27,FALSE,13,17896059,"F",27,27,"San Antonio Spurs","Sandro Mamukelashvili",0,0,0,0,0,0
2,0,4,1,1,10,8,2,2,"22",3,4,19,7,1,1,1037792,"2023-11-20T00:00:00.000Z",27,FALSE,13,439,"F",13,13,"LA Clippers","Daniel Theis",1,26,28,21,9,32.4
0,0,5,0,0,0,0,0,0,"16",0,2,0,5,0,0,1037792,"2023-11-20T00:00:00.000Z",27,FALSE,13,450,"F",13,13,"LA Clippers","PJ Tucker",0,5,5,0,5,6
6,0,2,1,0,11,4,4,2,"25",0,1,10,2,3,0,1037792,"2023-11-20T00:00:00.000Z",27,FALSE,13,472,"G",13,13,"LA Clippers","Russell Westbrook",3,12,18,16,8,30.4
0,0,0,0,0,0,0,0,0,"00",0,0,0,0,0,0,1037792,"2023-11-20T00:00:00.000Z",27,FALSE,13,17896022,"G",13,13,"LA Clippers","Brandon Boston Jr.",0,0,0,0,0,0
0,0,0,0,0,0,0,0,0,"00",0,0,0,0,0,0,1037792,"2023-11-20T00:00:00.000Z",27,FALSE,13,56677849,"F",13,13,"LA Clippers","Kobe Brown",0,0,0,0,0,0
0,0,0,0,0,0,0,0,0,"00",0,0,0,0,0,0,1037792,"2023-11-20T00:00:00.000Z",27,FALSE,13,56677856,"G",13,13,"LA Clippers","Jordan Miller",0,0,0,0,0,0
0,0,0,0,0,0,0,0,0,"00",0,0,0,0,0,0,1037792,"2023-11-20T00:00:00.000Z",27,FALSE,13,24417679,"G",13,13,"LA Clippers","Xavier Moon",0,0,0,0,0,0
0,0,0,0,0,0,0,0,0,"00",0,0,0,0,0,0,1037792,"2023-11-20T00:00:00.000Z",27,FALSE,13,371,"F-C",13,13,"LA Clippers","Mason Plumlee",0,0,0,0,0,0
0,0,0,0,0,0,0,0,0,"00",0,0,0,0,0,0,1037792,"2023-11-20T00:00:00.000Z",27,FALSE,13,17896051,"G",13,13,"LA Clippers","Joshua Primo",0,0,0,0,0,0
6,0,5,8,4,16,11,2,2,"32",0,1,28,5,1,2,1037792,"2023-11-20T00:00:00.000Z",27,FALSE,13,172,"F",13,13,"LA Clippers","Paul George",1,33,39,34,11,44
0,1,9,0,0,5,3,2,2,"22",2,0,8,11,0,1,1037792,"2023-11-20T00:00:00.000Z",27,FALSE,13,493,"C",13,13,"LA Clippers","Ivica Zubac",1,19,19,8,11,23.2
2,0,6,4,0,6,0,0,0,"25",0,0,0,6,3,1,1037792,"2023-11-20T00:00:00.000Z",27,FALSE,13,666743,"G",13,13,"LA Clippers","Terance Mann",3,6,8,2,8,18.2
10,0,2,8,2,12,4,3,3,"28",1,2,13,3,2,0,1037792,"2023-11-20T00:00:00.000Z",27,FALSE,13,192,"G",13,13,"LA Clippers","James Harden",2,16,26,23,13,37.6
0,0,0,0,0,1,0,0,0,"04",0,0,0,0,0,0,1037792,"2023-11-20T00:00:00.000Z",27,FALSE,13,666511,"G",13,13,"LA Clippers","Amir Coffey",0,0,0,0,0,0
0,0,0,0,0,2,1,2,1,"04",2,0,3,2,2,0,1037792,"2023-11-20T00:00:00.000Z",27,FALSE,13,38017725,"F",13,13,"LA Clippers","Moussa Diabate",2,5,5,3,2,11.4
1,0,1,2,1,3,1,0,0,"04",0,0,3,1,0,1,1037792,"2023-11-20T00:00:00.000Z",27,FALSE,13,17896031,"G",13,13,"LA Clippers","Nah'Shon Hyland",0,4,5,4,2,4.7
0,1,5,6,2,12,5,7,7,"30",0,0,19,5,2,1,1037792,"2023-11-20T00:00:00.000Z",27,FALSE,13,380,"F-G",13,13,"LA Clippers","Norman Powell",3,24,24,19,5,33
2,0,2,3,1,3,1,0,0,"14",0,1,3,2,0,0,1037792,"2023-11-20T00:00:00.000Z",27,FALSE,13,305,"F",27,27,"San Antonio Spurs","Doug McDermott",0,5,7,5,4,8.4
1,0,3,3,2,9,7,1,1,"22",1,4,17,4,0,0,1037792,"2023-11-20T00:00:00.000Z",27,FALSE,13,359,"F",27,27,"San Antonio Spurs","Cedi Osman",0,21,22,18,5,23.3
0,0,0,0,0,0,0,0,0,"00",0,0,0,0,0,0,1037792,"2023-11-20T00:00:00.000Z",27,FALSE,13,56677870,"G",27,27,"San Antonio Spurs","Sir'Jabari Rice",0,0,0,0,0,0
0,0,0,0,0,0,0,0,0,"00",0,0,0,0,0,0,1037792,"2023-11-20T00:00:00.000Z",27,FALSE,13,56677865,"C",27,27,"San Antonio Spurs","Charles Bediako",0,0,0,0,0,0
0,0,0,0,0,0,0,0,0,"00",0,0,0,0,0,0,1037792,"2023-11-20T00:00:00.000Z",27,FALSE,13,3547246,"G-F",27,27,"San Antonio Spurs","Devin Vassell",0,0,0,0,0,0
0,0,0,0,0,0,0,0,0,"00",0,0,0,0,0,0,1037792,"2023-11-20T00:00:00.000Z",27,FALSE,13,38017693,"G",27,27,"San Antonio Spurs","Blake Wesley",0,0,0,0,0,0
3,0,2,6,2,17,8,3,3,"28",2,0,21,4,1,0,1037792,"2023-11-20T00:00:00.000Z",27,FALSE,13,274,"F",13,13,"LA Clippers","Kawhi Leonard",1,25,28,24,7,33.3
3,0,3,11,5,16,7,1,1,"31",0,1,20,3,0,1,1037793,"2023-11-20T00:00:00.000Z",10,FALSE,11,443,"G",10,10,"Golden State Warriors","Klay Thompson",0,23,26,23,6,27.1
1,0,3,3,2,10,3,4,4,"30",4,2,12,7,0,0,1037793,"2023-11-20T00:00:00.000Z",10,FALSE,11,475,"F-G",10,10,"Golden State Warriors","Andrew Wiggins",0,19,20,13,8,21.9
3,0,4,0,0,4,2,4,3,"22",1,3,7,5,0,0,1037793,"2023-11-20T00:00:00.000Z",10,FALSE,11,282,"F",10,10,"Golden State Warriors","Kevon Looney",0,12,15,10,8,17.5
12,0,5,5,3,7,4,4,4,"34",1,4,15,6,2,1,1037793,"2023-11-20T00:00:00.000Z",10,FALSE,11,367,"G",10,10,"Golden State Warriors","Chris Paul",2,21,33,27,18,45.2
1,0,5,9,5,14,8,12,11,"35",0,2,32,5,0,4,1037793,"2023-11-20T00:00:00.000Z",10,FALSE,11,115,"G",10,10,"Golden State Warriors","Stephen Curry",0,37,38,33,6,35.5
0,0,0,0,0,0,0,0,0,"00",0,0,0,0,0,0,1037793,"2023-11-20T00:00:00.000Z",10,FALSE,11,185,"F",10,10,"Golden State Warriors","Draymond Green",0,0,0,0,0,0
0,0,0,0,0,0,0,0,0,"04",0,0,0,0,0,0,1037793,"2023-11-20T00:00:00.000Z",10,FALSE,11,56677799,"F",10,10,"Golden State Warriors","Trayce Jackson-Davis",0,0,0,0,0,0
0,0,0,0,0,0,0,0,0,"00",0,0,0,0,0,0,1037793,"2023-11-20T00:00:00.000Z",10,FALSE,11,251,"G",10,10,"Golden State Warriors","Cory Joseph",0,0,0,0,0,0
1,0,3,3,1,7,3,2,0,"18",0,3,7,3,0,1,1037793,"2023-11-20T00:00:00.000Z",10,FALSE,11,17553979,"F",10,10,"Golden State Warriors","Jonathan Kuminga",0,10,11,8,4,11.1
0,0,2,3,1,7,3,0,0,"22",2,2,7,4,0,0,1037793,"2023-11-20T00:00:00.000Z",10,FALSE,11,17553992,"G",10,10,"Golden State Warriors","Moses Moody",0,11,11,7,4,11.8
3,0,5,2,1,2,1,0,0,"18",0,2,3,5,0,0,1037793,"2023-11-20T00:00:00.000Z",10,FALSE,11,56677858,"G",10,10,"Golden State Warriors","Brandin Podziemski",0,8,11,6,8,13.5
0,0,0,0,0,0,0,0,0,"00",0,0,0,0,0,0,1037793,"2023-11-20T00:00:00.000Z",10,FALSE,11,57875092,"F",10,10,"Golden State Warriors","Gui Santos",0,0,0,0,0,0
2,1,5,7,3,10,5,6,5,"26",0,2,18,5,1,1,1037793,"2023-11-20T00:00:00.000Z",10,FALSE,11,407,"F",10,10,"Golden State Warriors","Dario Saric",2,23,25,20,7,32
0,0,0,0,0,0,0,0,0,"00",0,0,0,0,0,0,1037793,"2023-11-20T00:00:00.000Z",10,FALSE,11,17896070,"F",10,10,"Golden State Warriors","Usman Garuba",0,0,0,0,0,0
0,0,0,0,0,0,0,0,0,"00",0,0,0,0,0,0,1037793,"2023-11-20T00:00:00.000Z",10,FALSE,11,2189,"",10,10,"Golden State Warriors","Gary Payton II",0,0,0,0,0,0
0,0,0,0,0,0,0,0,0,"00",0,0,0,0,0,0,1037793,"2023-11-20T00:00:00.000Z",10,FALSE,11,45658838,"G",10,10,"Golden State Warriors","Lester Quinones",0,0,0,0,0,0
0,0,0,0,0,0,0,0,0,"00",0,0,0,0,0,0,1037793,"2023-11-20T00:00:00.000Z",10,FALSE,11,398,"G",10,10,"Golden State Warriors","Jerome Robinson",0,0,0,0,0,0
2,0,2,5,2,13,6,2,2,"31",2,5,16,4,0,1,1037793,"2023-11-20T00:00:00.000Z",10,FALSE,11,66,"G-F",11,11,"Houston Rockets","Dillon Brooks",0,20,22,18,6,22.8
2,2,7,5,1,12,7,2,2,"32",2,4,17,9,1,2,1037793,"2023-11-20T00:00:00.000Z",10,FALSE,11,38017684,"F",11,11,"Houston Rockets","Jabari Smith Jr.",3,26,28,19,11,37.8
5,1,6,3,2,23,13,5,2,"37",7,4,30,13,1,3,1037793,"2023-11-20T00:00:00.000Z",10,FALSE,11,17896062,"F-C",11,11,"Houston Rockets","Alperen Sengun",2,43,48,35,18,56.1
2,0,3,9,2,15,6,2,2,"24",0,3,16,3,0,1,1037793,"2023-11-20T00:00:00.000Z",10,FALSE,11,17895966,"G",11,11,"Houston Rockets","Jalen Green",0,19,21,18,5,21.6
14,0,5,8,1,13,3,3,3,"41",0,2,10,5,0,0,1037793,"2023-11-20T00:00:00.000Z",10,FALSE,11,458,"G",11,11,"Houston Rockets","Fred VanVleet",0,15,29,24,19,37
0,0,4,2,0,2,0,0,0,"08",1,0,0,5,0,0,1037793,"2023-11-20T00:00:00.000Z",10,FALSE,11,75,"G-F",11,11,"Houston Rockets","Reggie Bullock",0,5,5,0,5,6
1,0,0,3,1,4,1,2,2,"14",1,0,5,1,0,0,1037793,"2023-11-20T00:00:00.000Z",10,FALSE,11,188,"F",11,11,"Houston Rockets","Jeff Green",0,6,7,6,2,7.7
0,0,0,0,0,0,0,0,0,"00",0,0,0,0,0,0,1037793,"2023-11-20T00:00:00.000Z",10,FALSE,11,3547281,"G-F",11,11,"Houston Rockets","Nate Hinton",0,0,0,0,0,0
1,0,4,4,3,5,4,3,2,"28",0,3,13,4,4,0,1037793,"2023-11-20T00:00:00.000Z",10,FALSE,11,213,"G",11,11,"Houston Rockets","Aaron Holiday",4,17,18,14,5,31.3
0,0,1,0,0,1,0,0,0,"04",0,0,0,1,0,0,1037793,"2023-11-20T00:00:00.000Z",10,FALSE,11,19465326,"C",11,11,"Houston Rockets","Jock Landale",0,1,1,0,1,1.2
0,0,0,0,0,0,0,0,0,"00",0,0,0,0,0,0,1037793,"2023-11-20T00:00:00.000Z",10,FALSE,11,296,"C",11,11,"Houston Rockets","Boban Marjanovic",0,0,0,0,0,0
0,0,0,0,0,0,0,0,0,"00",0,0,0,0,0,0,1037793,"2023-11-20T00:00:00.000Z",10,FALSE,11,56677809,"F",11,11,"Houston Rockets","Jermaine Samuels Jr.",0,0,0,0,0,0
1,0,1,2,1,7,4,0,0,"21",2,3,9,3,0,1,1037793,"2023-11-20T00:00:00.000Z",10,FALSE,11,3547301,"F",11,11,"Houston Rockets","Jae'Sean Tate",0,12,13,10,4,13.1
0,0,0,0,0,0,0,0,0,"00",0,0,0,0,0,0,1037793,"2023-11-20T00:00:00.000Z",10,FALSE,11,56677831,"F",11,11,"Houston Rockets","Cam Whitmore",0,0,0,0,0,0
0,0,0,0,0,0,0,0,0,"00",0,0,0,0,0,0,1037793,"2023-11-20T00:00:00.000Z",10,FALSE,11,38017695,"F",11,11,"Houston Rockets","Tari Eason",0,0,0,0,0,0
0,0,0,0,0,0,0,0,0,"00",0,0,0,0,0,0,1037793,"2023-11-20T00:00:00.000Z",10,FALSE,11,357,"G",11,11,"Houston Rockets","Victor Oladipo",0,0,0,0,0,0
0,0,0,0,0,0,0,0,0,"00",0,0,0,0,0,0,1037793,"2023-11-20T00:00:00.000Z",10,FALSE,11,56677825,"G-F",11,11,"Houston Rockets","Amen Thompson",0,0,0,0,0,0
0,0,0,0,0,0,0,0,0,"00",0,0,0,0,0,0,1037793,"2023-11-20T00:00:00.000Z",10,FALSE,11,47738533,"G",11,11,"Houston Rockets","Jeenathan Williams",0,0,0,0,0,0
2,0,2,4,1,18,8,1,0,"31",2,2,17,4,3,0,3277479,"2023-11-21T00:00:00.000Z",22,FALSE,28,17896026,"F",22,22,"Orlando Magic","Franz Wagner",3,21,23,19,6,33.8
3,1,4,3,2,20,10,3,3,"32",1,2,25,5,0,3,3277479,"2023-11-21T00:00:00.000Z",22,FALSE,28,38017683,"F",22,22,"Orlando Magic","Paolo Banchero",1,30,33,28,8,35.5
6,5,4,0,0,6,2,4,1,"31",3,1,5,7,2,1,3277479,"2023-11-21T00:00:00.000Z",22,FALSE,28,666442,"C",22,22,"Orlando Magic","Goga Bitadze",7,12,18,11,13,42.4
4,0,2,4,2,10,6,4,4,"21",1,3,18,3,2,2,3277479,"2023-11-21T00:00:00.000Z",22,FALSE,28,17896073,"G",22,22,"Orlando Magic","Jalen Suggs",2,21,25,22,7,31.6
1,0,3,3,0,7,2,2,1,"23",2,3,5,5,1,0,3277479,"2023-11-21T00:00:00.000Z",22,FALSE,28,56677827,"G",22,22,"Orlando Magic","Anthony Black",1,10,11,6,6,15.5
10,0,3,4,2,10,5,3,3,"29",2,3,15,5,0,2,3277479,"2023-11-21T00:00:00.000Z",22,FALSE,28,3547251,"G",22,22,"Orlando Magic","Cole Anthony",0,20,30,25,15,34
1,0,1,5,2,7,4,0,0,"23",0,3,10,1,1,0,3277479,"2023-11-21T00:00:00.000Z",22,FALSE,28,196,"G",22,22,"Orlando Magic","Gary Harris",1,11,12,11,2,15.7
1,0,1,1,0,1,0,0,0,"04",0,0,0,1,1,0,3277479,"2023-11-21T00:00:00.000Z",22,FALSE,28,38017724,"G",22,22,"Orlando Magic","Caleb Houstan",1,1,2,1,2,5.7
1,0,1,2,1,3,2,1,1,"13",1,2,6,2,0,1,3277479,"2023-11-21T00:00:00.000Z",22,FALSE,28,226,"F",22,22,"Orlando Magic","Joe Ingles",0,8,9,7,3,8.9
0,2,2,2,0,6,4,2,1,"12",1,0,9,3,1,2,3277479,"2023-11-21T00:00:00.000Z",22,FALSE,28,229,"F",22,22,"Orlando Magic","Jonathan Isaac",3,12,12,9,3,19.6
0,0,0,0,0,0,0,0,0,"00",0,0,0,0,0,0,3277479,"2023-11-21T00:00:00.000Z",22,FALSE,28,85,"F",22,22,"Orlando Magic","Wendell Carter Jr.",0,0,0,0,0,0
0,0,0,0,0,0,0,0,0,"00",0,0,0,0,0,0,3277479,"2023-11-21T00:00:00.000Z",22,FALSE,28,165,"G",22,22,"Orlando Magic","Markelle Fultz",0,0,0,0,0,0
0,0,0,0,0,0,0,0,0,"00",0,0,0,0,0,0,3277479,"2023-11-21T00:00:00.000Z",22,FALSE,28,38017607,"G",22,22,"Orlando Magic","Kevon Harris",0,0,0,0,0,0
0,0,0,0,0,0,0,0,0,"00",0,0,0,0,0,0,3277479,"2023-11-21T00:00:00.000Z",22,FALSE,28,56677839,"G",22,22,"Orlando Magic","Jett Howard",0,0,0,0,0,0
0,0,0,0,0,0,0,0,0,"00",0,0,0,0,0,0,3277479,"2023-11-21T00:00:00.000Z",22,FALSE,28,17553983,"G",22,22,"Orlando Magic","Trevelin Queen",0,0,0,0,0,0
4,3,1,5,3,8,4,0,0,"30",0,0,11,1,0,4,3277479,"2023-11-21T00:00:00.000Z",22,FALSE,28,18,"F",28,28,"Toronto Raptors","OG Anunoby",3,12,16,15,5,23.2
8,0,2,2,0,10,5,8,6,"30",0,1,16,2,1,2,3277479,"2023-11-21T00:00:00.000Z",22,FALSE,28,416,"F",28,28,"Toronto Raptors","Pascal Siakam",1,18,26,24,10,31.4
1,1,9,0,0,7,5,0,0,"23",1,6,10,10,0,4,3277479,"2023-11-21T00:00:00.000Z",22,FALSE,28,373,"C",28,28,"Toronto Raptors","Jakob Poeltl",1,20,21,11,11,22.5
4,0,8,4,1,11,5,4,3,"30",0,1,14,8,3,5,3277479,"2023-11-21T00:00:00.000Z",22,FALSE,28,17896055,"G-F",28,28,"Toronto Raptors","Scottie Barnes",3,22,26,18,12,33.6
1,0,1,4,4,13,8,4,4,"27",0,2,24,1,0,2,3277479,"2023-11-21T00:00:00.000Z",22,FALSE,28,409,"G",28,28,"Toronto Raptors","Dennis Schroder",0,25,26,25,2,24.7
4,0,4,1,0,4,2,2,1,"15",2,3,5,6,1,3,3277479,"2023-11-21T00:00:00.000Z",22,FALSE,28,3547249,"F",28,28,"Toronto Raptors","Precious Achiuwa",1,11,15,9,10,18.2
0,1,2,3,1,4,1,0,0,"18",0,3,3,2,0,0,3277479,"2023-11-21T00:00:00.000Z",22,FALSE,28,58,"F",28,28,"Toronto Raptors","Chris Boucher",1,5,5,3,2,8.4
2,0,2,3,1,4,1,0,0,"12",0,0,3,2,0,0,3277479,"2023-11-21T00:00:00.000Z",22,FALSE,28,56677828,"G",28,28,"Toronto Raptors","Gradey Dick",0,5,7,5,4,8.4
1,1,3,2,1,4,2,2,1,"19",0,1,6,3,1,1,3277479,"2023-11-21T00:00:00.000Z",22,FALSE,28,3547275,"G",28,28,"Toronto Raptors","Malachi Flynn",2,9,10,7,4,16.1
1,0,0,1,1,1,1,2,2,"07",1,1,5,1,0,1,3277479,"2023-11-21T00:00:00.000Z",22,FALSE,28,666762,"F",28,28,"Toronto Raptors","Jalen McDaniels",0,6,7,6,2,6.7
0,0,1,1,1,2,2,0,0,"04",1,1,5,2,0,1,3277479,"2023-11-21T00:00:00.000Z",22,FALSE,28,376,"F",28,28,"Toronto Raptors","Otto Porter Jr.",0,7,7,5,2,6.4
2,0,0,0,0,1,1,0,0,"04",0,0,2,0,0,0,3277479,"2023-11-21T00:00:00.000Z",22,FALSE,28,436,"G-F",28,28,"Toronto Raptors","Garrett Temple",0,2,4,4,2,5
1,0,0,2,1,6,1,0,0,"21",0,1,3,0,0,0,3277479,"2023-11-21T00:00:00.000Z",22,FALSE,28,3089,"",28,28,"Toronto Raptors","Gary Trent Jr.",0,3,4,4,1,4.5
0,0,0,0,0,0,0,0,0,"00",0,0,0,0,0,0,3277479,"2023-11-21T00:00:00.000Z",22,FALSE,28,56677805,"G",28,28,"Toronto Raptors","Javon Freeman-Liberty",0,0,0,0,0,0
0,0,0,0,0,0,0,0,0,"00",0,0,0,0,0,0,3277479,"2023-11-21T00:00:00.000Z",22,FALSE,28,38017717,"F",28,28,"Toronto Raptors","Ron Harper Jr.",0,0,0,0,0,0
0,0,0,0,0,0,0,0,0,"00",0,0,0,0,0,0,3277479,"2023-11-21T00:00:00.000Z",22,FALSE,28,38017710,"C",28,28,"Toronto Raptors","Christian Koloko",0,0,0,0,0,0
0,0,0,0,0,0,0,0,0,"00",0,0,0,0,0,0,3277479,"2023-11-21T00:00:00.000Z",22,FALSE,28,56677869,"G",28,28,"Toronto Raptors","Markquis Nowell",0,0,0,0,0,0
0,0,0,0,0,0,0,0,0,"00",0,0,0,0,0,0,3277479,"2023-11-21T00:00:00.000Z",22,FALSE,28,489,"F",28,28,"Toronto Raptors","Thaddeus Young",0,0,0,0,0,0
0,0,0,3,2,3,2,0,0,"04",0,0,6,0,0,0,3277479,"2023-11-21T00:00:00.000Z",22,FALSE,28,666818,"F",22,22,"Orlando Magic","Chuma Okeke",0,6,6,6,0,6
0,0,0,0,0,0,0,0,0,"02",0,0,0,0,0,0,3277479,"2023-11-21T00:00:00.000Z",22,FALSE,28,666885,"F",22,22,"Orlando Magic","Admiral Schofield",0,0,0,0,0,0
2,0,2,0,0,9,5,0,0,"15",2,0,10,4,1,1,3277479,"2023-11-21T00:00:00.000Z",22,FALSE,28,462,"C",22,22,"Orlando Magic","Moritz Wagner",1,14,16,12,6,19.8
1,0,2,2,1,7,3,0,0,"27",2,2,7,4,1,3,3277480,"2023-11-21T00:00:00.000Z",1,FALSE,12,666656,"F",1,1,"Atlanta Hawks","De'Andre Hunter",1,11,12,8,5,13.3
6,1,6,2,0,12,6,5,5,"33",1,2,17,7,2,1,3277480,"2023-11-21T00:00:00.000Z",1,FALSE,12,17896040,"F",1,1,"Atlanta Hawks","Jalen Johnson",3,24,30,23,13,42.4
1,2,2,0,0,9,6,3,2,"19",3,4,14,5,0,1,3277480,"2023-11-21T00:00:00.000Z",1,FALSE,12,83,"C",1,1,"Atlanta Hawks","Clint Capela",2,19,20,15,6,26.5
5,0,2,6,4,20,11,2,2,"34",1,3,28,3,2,5,3277480,"2023-11-21T00:00:00.000Z",1,FALSE,12,334,"G",1,1,"Atlanta Hawks","Dejounte Murray",2,31,36,33,8,40.1
8,0,1,8,5,17,13,8,7,"39",0,3,38,1,3,3,3277480,"2023-11-21T00:00:00.000Z",1,FALSE,12,490,"G",1,1,"Atlanta Hawks","Trae Young",3,39,47,46,9,57.2
2,0,9,4,2,7,4,5,2,"31",2,0,12,11,0,0,3277480,"2023-11-21T00:00:00.000Z",1,FALSE,12,3547256,"F",1,1,"Atlanta Hawks","Saddiq Bey",0,23,25,14,13,28.2
0,0,2,5,2,15,10,4,4,"26",0,4,26,2,0,0,3277480,"2023-11-21T00:00:00.000Z",1,FALSE,12,53,"G",1,1,"Atlanta Hawks","Bogdan Bogdanovic",0,28,28,26,2,28.4
1,4,8,2,0,7,4,4,3,"25",1,3,11,9,0,1,3277480,"2023-11-21T00:00:00.000Z",1,FALSE,12,452,"C-F",12,12,"Indiana Pacers","Myles Turner",4,20,21,12,10,34.3
3,0,0,5,2,10,5,2,1,"30",0,4,13,0,2,2,3277480,"2023-11-21T00:00:00.000Z",1,FALSE,12,69,"G",12,12,"Indiana Pacers","Bruce Brown",2,13,16,16,3,21.5
16,1,4,15,9,18,11,7,6,"39",1,0,37,5,3,6,3277480,"2023-11-21T00:00:00.000Z",1,FALSE,12,3547245,"G",12,12,"Indiana Pacers","Tyrese Haliburton",4,42,58,53,21,73
1,4,4,0,0,1,1,0,0,"12",1,5,2,5,0,1,3277480,"2023-11-21T00:00:00.000Z",1,FALSE,12,17896035,"F",12,12,"Indiana Pacers","Isaiah Jackson",4,7,8,3,6,20.5
1,0,2,4,2,10,7,4,3,"20",0,2,19,2,0,0,3277480,"2023-11-21T00:00:00.000Z",1,FALSE,12,38017686,"G-F",12,12,"Indiana Pacers","Bennedict Mathurin",0,21,22,20,3,22.9
4,0,0,0,0,5,1,0,0,"14",0,1,2,0,0,0,3277480,"2023-11-21T00:00:00.000Z",1,FALSE,12,304,"G",12,12,"Indiana Pacers","T.J. McConnell",0,2,6,6,4,8
0,0,0,0,0,0,0,0,0,"00",0,0,0,0,0,0,3277480,"2023-11-21T00:00:00.000Z",1,FALSE,12,3547207,"F",12,12,"Indiana Pacers","Jordan Nwora",0,0,0,0,0,0
1,0,1,4,1,5,2,0,0,"05",0,0,5,1,0,0,3277480,"2023-11-21T00:00:00.000Z",1,FALSE,12,56677861,"G",12,12,"Indiana Pacers","Ben Sheppard",0,6,7,6,2,7.7
0,0,1,0,0,2,2,4,2,"05",2,0,6,3,0,0,3277480,"2023-11-21T00:00:00.000Z",1,FALSE,12,3547264,"F-C",12,12,"Indiana Pacers","Jalen Smith",0,9,9,6,3,9.6
6,1,1,6,1,16,9,2,2,"34",0,3,21,1,1,2,3277480,"2023-11-21T00:00:00.000Z",1,FALSE,12,3547243,"F",12,12,"Indiana Pacers","Obi Toppin",2,22,28,27,7,35.2
0,0,0,0,0,0,0,0,0,"00",0,0,0,0,0,0,3277480,"2023-11-21T00:00:00.000Z",1,FALSE,12,56677832,"F",12,12,"Indiana Pacers","Jarace Walker",0,0,0,0,0,0
0,0,0,0,0,0,0,0,0,"00",0,0,0,0,0,0,3277480,"2023-11-21T00:00:00.000Z",1,FALSE,12,38017701,"G",12,12,"Indiana Pacers","Kendall Brown",0,0,0,0,0,0
0,0,0,0,0,0,0,0,0,"00",0,0,0,0,0,0,3277480,"2023-11-21T00:00:00.000Z",1,FALSE,12,38017507,"G-F",12,12,"Indiana Pacers","Andrew Nembhard",0,0,0,0,0,0
0,0,0,0,0,0,0,0,0,"00",0,0,0,0,0,0,3277480,"2023-11-21T00:00:00.000Z",1,FALSE,12,56677778,"F-C",12,12,"Indiana Pacers","Oscar Tshiebwe",0,0,0,0,0,0
0,0,0,0,0,0,0,0,0,"00",0,0,0,0,0,0,3277480,"2023-11-21T00:00:00.000Z",1,FALSE,12,56677794,"G",12,12,"Indiana Pacers","Isaiah Wong",0,0,0,0,0,0
4,1,2,2,0,7,3,1,1,"22",4,2,7,6,0,1,3277480,"2023-11-21T00:00:00.000Z",1,FALSE,12,3547244,"F-C",1,1,"Atlanta Hawks","Onyeka Okongwu",1,13,17,11,10,22.2
1,0,1,2,1,2,1,0,0,"09",0,3,3,1,0,1,3277480,"2023-11-21T00:00:00.000Z",1,FALSE,12,301,"G-F",1,1,"Atlanta Hawks","Wesley Matthews",0,4,5,4,2,4.7
0,0,0,0,0,0,0,0,0,"00",0,0,0,0,0,0,3277480,"2023-11-21T00:00:00.000Z",1,FALSE,12,666564,"F",1,1,"Atlanta Hawks","Bruno Fernando",0,0,0,0,0,0
0,0,0,0,0,0,0,0,0,"00",0,0,0,0,0,0,3277480,"2023-11-21T00:00:00.000Z",1,FALSE,12,3547297,"G",1,1,"Atlanta Hawks","Trent Forrest",0,0,0,0,0,0
0,0,0,0,0,0,0,0,0,"00",0,0,0,0,0,0,3277480,"2023-11-21T00:00:00.000Z",1,FALSE,12,666754,"G",1,1,"Atlanta Hawks","Garrison Mathews",0,0,0,0,0,0
0,0,0,0,0,0,0,0,0,"00",0,0,0,0,0,0,3277480,"2023-11-21T00:00:00.000Z",1,FALSE,12,319,"G",1,1,"Atlanta Hawks","Patty Mills",0,0,0,0,0,0
0,0,0,0,0,0,0,0,0,"00",0,0,0,0,0,0,3277480,"2023-11-21T00:00:00.000Z",1,FALSE,12,56677838,"G",1,1,"Atlanta Hawks","Kobe Bufkin",0,0,0,0,0,0
0,0,0,0,0,0,0,0,0,"00",0,0,0,0,0,0,3277480,"2023-11-21T00:00:00.000Z",1,FALSE,12,38017689,"F",1,1,"Atlanta Hawks","AJ Griffin",0,0,0,0,0,0
0,0,0,0,0,0,0,0,0,"00",0,0,0,0,0,0,3277480,"2023-11-21T00:00:00.000Z",1,FALSE,12,56677806,"F",1,1,"Atlanta Hawks","Mouhamed Gueye",0,0,0,0,0,0
0,0,0,0,0,0,0,0,0,"00",0,0,0,0,0,0,3277480,"2023-11-21T00:00:00.000Z",1,FALSE,12,56677855,"G",1,1,"Atlanta Hawks","Seth Lundy",0,0,0,0,0,0
0,0,0,0,0,0,0,0,0,"00",0,0,0,0,0,0,3277480,"2023-11-21T00:00:00.000Z",1,FALSE,12,56677875,"F",1,1,"Atlanta Hawks","Miles Norris",0,0,0,0,0,0
1,1,1,6,6,11,9,0,0,"31",1,3,24,2,0,1,3277480,"2023-11-21T00:00:00.000Z",1,FALSE,12,210,"G",12,12,"Indiana Pacers","Buddy Hield",1,26,27,25,3,29.9
1,1,0,3,1,9,6,5,4,"25",1,4,17,1,1,0,3277480,"2023-11-21T00:00:00.000Z",1,FALSE,12,3547250,"G-F",12,12,"Indiana Pacers","Aaron Nesmith",2,18,19,18,2,25.7
2,0,2,5,3,13,7,6,6,"43",0,3,23,2,2,0,3277481,"2023-11-21T00:00:00.000Z",23,FALSE,6,200,"F",23,23,"Philadelphia 76ers","Tobias Harris",2,25,27,25,4,34.4
2,0,4,4,1,5,2,0,0,"27",0,5,5,4,0,2,3277481,"2023-11-21T00:00:00.000Z",23,FALSE,6,33,"F-G",23,23,"Philadelphia 76ers","Nicolas Batum",0,9,11,7,6,10.8
5,5,10,3,1,21,9,16,13,"41",3,6,32,13,2,6,3277481,"2023-11-21T00:00:00.000Z",23,FALSE,6,145,"F-C",23,23,"Philadelphia 76ers","Joel Embiid",7,45,50,37,18,70.1
3,0,2,6,1,14,5,3,2,"41",4,3,13,6,2,1,3277481,"2023-11-21T00:00:00.000Z",23,FALSE,6,313,"G",23,23,"Philadelphia 76ers","De'Anthony Melton",2,19,22,16,9,29.7
6,0,4,12,3,28,11,7,5,"47",0,2,30,4,1,1,3277481,"2023-11-21T00:00:00.000Z",23,FALSE,6,3547254,"G",23,23,"Philadelphia 76ers","Tyrese Maxey",1,34,40,36,10,45.8
0,0,0,0,0,0,0,0,0,"00",0,0,0,0,0,0,3277481,"2023-11-21T00:00:00.000Z",23,FALSE,6,28,"C",23,23,"Philadelphia 76ers","Mo Bamba",0,0,0,0,0,0
0,1,3,1,0,2,1,0,0,"21",1,3,2,4,2,1,3277481,"2023-11-21T00:00:00.000Z",23,FALSE,6,45,"G",23,23,"Philadelphia 76ers","Patrick Beverley",3,6,6,2,4,14.8
0,0,0,0,0,0,0,0,0,"00",0,0,0,0,0,0,3277481,"2023-11-21T00:00:00.000Z",23,FALSE,6,360,"F",23,23,"Philadelphia 76ers","Kelly Oubre Jr.",0,0,0,0,0,0
0,0,0,0,0,0,0,0,0,"00",0,0,0,0,0,0,3277481,"2023-11-21T00:00:00.000Z",23,FALSE,6,17554001,"G",23,23,"Philadelphia 76ers","Javonte Smart",0,0,0,0,0,0
0,0,0,0,0,0,0,0,0,"00",0,0,0,0,0,0,3277481,"2023-11-21T00:00:00.000Z",23,FALSE,6,56677788,"G",23,23,"Philadelphia 76ers","Terquavion Smith",0,0,0,0,0,0
2,0,4,4,0,4,0,0,0,"31",4,5,0,8,3,1,3277481,"2023-11-21T00:00:00.000Z",23,FALSE,6,666940,"F",6,6,"Cleveland Cavaliers","Dean Wade",3,8,10,2,10,20.6
3,1,12,0,0,10,6,6,6,"38",0,4,18,12,0,4,3277481,"2023-11-21T00:00:00.000Z",23,FALSE,6,17896076,"F-C",6,6,"Cleveland Cavaliers","Evan Mobley",1,30,33,21,15,35.9
3,0,7,0,0,20,12,2,2,"35",6,4,26,13,0,2,3277481,"2023-11-21T00:00:00.000Z",23,FALSE,6,9,"C",6,6,"Cleveland Cavaliers","Jarrett Allen",0,39,42,29,16,44.1
6,1,3,10,5,15,7,2,1,"44",2,5,20,5,2,2,3277481,"2023-11-21T00:00:00.000Z",23,FALSE,6,666908,"G",6,6,"Cleveland Cavaliers","Max Strus",3,25,31,26,11,42
8,0,4,6,2,25,10,11,10,"43",1,1,32,5,3,4,3277481,"2023-11-21T00:00:00.000Z",23,FALSE,6,666581,"G",6,6,"Cleveland Cavaliers","Darius Garland",3,37,45,40,13,55
0,0,0,0,0,0,0,0,0,"00",0,0,0,0,0,0,3277481,"2023-11-21T00:00:00.000Z",23,FALSE,6,56677847,"F",6,6,"Cleveland Cavaliers","Emoni Bates",0,0,0,0,0,0
0,0,0,0,0,0,0,0,0,"00",0,0,0,0,0,0,3277481,"2023-11-21T00:00:00.000Z",23,FALSE,6,248,"C",6,6,"Cleveland Cavaliers","Damian Jones",0,0,0,0,0,0
0,0,0,0,0,0,0,0,0,"00",0,0,0,0,0,0,3277481,"2023-11-21T00:00:00.000Z",23,FALSE,6,277,"G",6,6,"Cleveland Cavaliers","Caris LeVert",0,0,0,0,0,0
0,0,0,1,0,1,0,0,0,"06",0,0,0,0,0,0,3277481,"2023-11-21T00:00:00.000Z",23,FALSE,6,3547299,"G",6,6,"Cleveland Cavaliers","Sam Merrill",0,0,0,0,0,0
0,0,0,0,0,0,0,0,0,"00",0,0,0,0,0,0,3277481,"2023-11-21T00:00:00.000Z",23,FALSE,6,38017662,"F",6,6,"Cleveland Cavaliers","Isaiah Mobley",0,0,0,0,0,0
0,0,7,4,2,9,5,0,0,"26",0,2,12,7,0,1,3277481,"2023-11-21T00:00:00.000Z",23,FALSE,6,344,"F",6,6,"Cleveland Cavaliers","Georges Niang",0,19,19,12,7,19.4
9,1,3,0,0,9,5,2,2,"27",0,0,12,3,0,1,3277481,"2023-11-21T00:00:00.000Z",23,FALSE,6,56677872,"G",6,6,"Cleveland Cavaliers","Craig Porter",1,15,24,21,12,31.1
2,1,2,0,0,1,1,2,0,"15",1,0,2,3,1,0,3277481,"2023-11-21T00:00:00.000Z",23,FALSE,6,444,"C-F",6,6,"Cleveland Cavaliers","Tristan Thompson",2,5,7,4,5,14.6
0,0,0,0,0,0,0,0,0,"00",0,0,0,0,0,0,3277481,"2023-11-21T00:00:00.000Z",23,FALSE,6,666676,"G",6,6,"Cleveland Cavaliers","Ty Jerome",0,0,0,0,0,0
0,0,0,0,0,0,0,0,0,"00",0,0,0,0,0,0,3277481,"2023-11-21T00:00:00.000Z",23,FALSE,6,322,"G",6,6,"Cleveland Cavaliers","Donovan Mitchell",0,0,0,0,0,0
0,0,0,0,0,0,0,0,0,"00",0,0,0,0,0,0,3277481,"2023-11-21T00:00:00.000Z",23,FALSE,6,3547247,"F-G",6,6,"Cleveland Cavaliers","Isaac Okoro",0,0,0,0,0,0
0,0,0,0,0,0,0,0,0,"00",0,0,0,0,0,0,3277481,"2023-11-21T00:00:00.000Z",23,FALSE,6,404,"G",6,6,"Cleveland Cavaliers","Ricky Rubio",0,0,0,0,0,0
1,2,4,2,1,3,1,0,0,"14",3,0,3,7,2,1,3277481,"2023-11-21T00:00:00.000Z",23,FALSE,6,108,"F",23,23,"Philadelphia 76ers","Robert Covington",4,10,11,4,8,23.9
0,0,0,2,1,5,2,2,2,"12",0,0,7,0,0,1,3277481,"2023-11-21T00:00:00.000Z",23,FALSE,6,2175,"",23,23,"Philadelphia 76ers","Danuel House Jr.",0,7,7,7,0,6
0,0,0,0,0,0,0,0,0,"00",0,0,0,0,0,0,3277481,"2023-11-21T00:00:00.000Z",23,FALSE,6,260,"G-F",23,23,"Philadelphia 76ers","Furkan Korkmaz",0,0,0,0,0,0
0,0,0,0,0,0,0,0,0,"00",0,0,0,0,0,0,3277481,"2023-11-21T00:00:00.000Z",23,FALSE,6,3547294,"F",23,23,"Philadelphia 76ers","Kenyon Martin Jr.",0,0,0,0,0,0
0,0,0,0,0,0,0,0,0,"03",0,0,0,0,0,0,3277481,"2023-11-21T00:00:00.000Z",23,FALSE,6,328,"F",23,23,"Philadelphia 76ers","Marcus Morris",0,0,0,0,0,0
0,0,1,0,0,4,2,0,0,"09",2,1,4,3,1,0,3277481,"2023-11-21T00:00:00.000Z",23,FALSE,6,3547270,"F",23,23,"Philadelphia 76ers","Paul Reed",1,7,7,4,3,10.6
0,0,0,0,0,1,0,0,0,"07",1,2,0,1,0,1,3277481,"2023-11-21T00:00:00.000Z",23,FALSE,6,17896025,"G",23,23,"Philadelphia 76ers","Jaden Springer",0,1,1,0,1,0.2
0,0,0,0,0,0,0,0,0,"00",0,0,0,0,0,0,3277481,"2023-11-21T00:00:00.000Z",23,FALSE,6,56913527,"G",23,23,"Philadelphia 76ers","Ricky Council IV",0,0,0,0,0,0
4,1,2,0,0,14,9,0,0,"31",6,1,18,8,1,2,3277482,"2023-11-21T00:00:00.000Z",24,FALSE,25,22,"C",25,25,"Portland Trail Blazers","Deandre Ayton",2,26,30,22,12,37.6
0,0,2,5,0,13,3,4,4,"32",1,3,10,3,1,4,3277482,"2023-11-21T00:00:00.000Z",24,FALSE,25,38017690,"G",25,25,"Portland Trail Blazers","Shaedon Sharpe",1,13,13,10,3,12.6
5,0,0,5,4,14,6,4,3,"25",1,2,19,1,0,2,3277482,"2023-11-21T00:00:00.000Z",24,FALSE,25,65,"G",25,25,"Portland Trail Blazers","Malcolm Brogdon",0,20,25,24,6,25.7
3,0,2,3,2,5,2,0,0,"21",0,2,6,2,0,1,3277482,"2023-11-21T00:00:00.000Z",24,FALSE,25,3547289,"G",25,25,"Portland Trail Blazers","Skylar Mays",0,8,11,9,5,11.9
4,1,2,3,2,5,4,0,0,"36",0,2,10,2,1,2,3277482,"2023-11-21T00:00:00.000Z",24,FALSE,25,178,"G",24,24,"Phoenix Suns","Eric Gordon",2,12,16,14,6,22.4
9,1,4,2,2,21,13,3,3,"37",0,4,31,4,0,3,3277482,"2023-11-21T00:00:00.000Z",24,FALSE,25,140,"F",24,24,"Phoenix Suns","Kevin Durant",1,35,44,40,13,49.3
0,4,6,4,2,11,7,2,2,"29",6,4,18,12,1,3,3277482,"2023-11-21T00:00:00.000Z",24,FALSE,25,349,"C",24,24,"Phoenix Suns","Jusuf Nurkic",5,30,30,18,12,44.4
5,0,6,1,0,5,4,0,0,"35",0,1,8,6,2,1,3277482,"2023-11-21T00:00:00.000Z",24,FALSE,25,8,"G",24,24,"Phoenix Suns","Grayson Allen",2,14,19,13,11,27.7
6,1,3,3,0,20,9,10,10,"34",0,1,28,3,1,1,3277482,"2023-11-21T00:00:00.000Z",24,FALSE,25,57,"G",24,24,"Phoenix Suns","Devin Booker",2,31,37,34,9,45.6
0,0,0,0,0,4,1,5,5,"13",2,4,7,2,0,2,3277482,"2023-11-21T00:00:00.000Z",24,FALSE,25,147,"F",24,24,"Phoenix Suns","Drew Eubanks",0,9,9,7,2,7.4
0,1,3,3,1,6,4,4,4,"22",2,1,13,5,1,0,3277482,"2023-11-21T00:00:00.000Z",24,FALSE,25,666729,"F",24,24,"Phoenix Suns","Nassir Little",2,18,18,13,5,25
1,0,2,0,0,0,0,2,2,"13",1,0,2,3,1,1,3277482,"2023-11-21T00:00:00.000Z",24,FALSE,25,356,"G",24,24,"Phoenix Suns","Josh Okogie",1,5,6,3,4,9.1
0,0,0,0,0,1,0,0,0,"02",1,0,0,1,0,0,3277482,"2023-11-21T00:00:00.000Z",24,FALSE,25,666476,"C",25,25,"Portland Trail Blazers","Moses Brown",0,1,1,0,1,1.2
0,0,1,0,0,0,0,0,0,"02",0,0,0,1,0,1,3277482,"2023-11-21T00:00:00.000Z",24,FALSE,25,44477062,"G",25,25,"Portland Trail Blazers","Jamaree Bouyea",0,1,1,0,1,0.2
0,0,0,1,1,2,1,0,0,"02",0,0,3,0,0,0,3277482,"2023-11-21T00:00:00.000Z",24,FALSE,25,56677791,"F",25,25,"Portland Trail Blazers","Kris Murray",0,3,3,3,0,3
1,0,0,3,2,6,4,0,0,"13",1,1,10,1,2,0,3277482,"2023-11-21T00:00:00.000Z",24,FALSE,25,56783340,"C",25,25,"Portland Trail Blazers","Duop Reath",2,11,12,11,2,18.7
1,0,0,0,0,1,0,0,0,"02",0,0,0,0,1,0,3277482,"2023-11-21T00:00:00.000Z",24,FALSE,25,56677829,"G-F",25,25,"Portland Trail Blazers","Rayan Rupert",1,0,1,1,1,4.5
0,1,1,2,0,2,0,0,0,"22",1,1,0,2,1,0,3277482,"2023-11-21T00:00:00.000Z",24,FALSE,25,666923,"G-F",25,25,"Portland Trail Blazers","Matisse Thybulle",2,2,2,0,2,8.4
0,0,3,2,0,6,3,2,2,"14",0,5,8,3,0,1,3277482,"2023-11-21T00:00:00.000Z",24,FALSE,25,38017711,"F",25,25,"Portland Trail Blazers","Jabari Walker",0,11,11,8,3,10.6
0,0,0,0,0,0,0,0,0,"00",0,0,0,0,0,0,3277482,"2023-11-21T00:00:00.000Z",24,FALSE,25,56677747,"G",25,25,"Portland Trail Blazers","Scoot Henderson",0,0,0,0,0,0
0,0,0,0,0,0,0,0,0,"00",0,0,0,0,0,0,3277482,"2023-11-21T00:00:00.000Z",24,FALSE,25,47957121,"F",25,25,"Portland Trail Blazers","Justin Minaya",0,0,0,0,0,0
0,0,0,0,0,0,0,0,0,"00",0,0,0,0,0,0,3277482,"2023-11-21T00:00:00.000Z",24,FALSE,25,419,"G",25,25,"Portland Trail Blazers","Anfernee Simons",0,0,0,0,0,0
0,0,0,0,0,0,0,0,0,"00",0,0,0,0,0,0,3277482,"2023-11-21T00:00:00.000Z",24,FALSE,25,17896120,"F",25,25,"Portland Trail Blazers","Ish Wainright",0,0,0,0,0,0
0,0,0,0,0,0,0,0,0,"00",0,0,0,0,0,0,3277482,"2023-11-21T00:00:00.000Z",24,FALSE,25,476,"C-F",25,25,"Portland Trail Blazers","Robert Williams III",0,0,0,0,0,0
0,0,1,0,0,1,0,2,1,"10",0,0,1,1,0,0,3277482,"2023-11-21T00:00:00.000Z",24,FALSE,25,32,"F",24,24,"Phoenix Suns","Keita Bates-Diop",0,2,2,1,1,2.2
0,0,0,1,0,3,1,0,0,"05",0,0,2,0,0,0,3277482,"2023-11-21T00:00:00.000Z",24,FALSE,25,18678058,"",24,24,"Phoenix Suns","Jordan Goodwin",0,2,2,2,0,2
0,0,0,0,0,0,0,0,0,"00",0,0,0,0,0,0,3277482,"2023-11-21T00:00:00.000Z",24,FALSE,25,3547095,"C-F",24,24,"Phoenix Suns","Udoka Azubuike",0,0,0,0,0,0
0,0,0,0,0,0,0,0,0,"00",0,0,0,0,0,0,3277482,"2023-11-21T00:00:00.000Z",24,FALSE,25,666451,"C",24,24,"Phoenix Suns","Bol Bol",0,0,0,0,0,0
0,0,0,0,0,0,0,0,0,"00",0,0,0,0,0,0,3277482,"2023-11-21T00:00:00.000Z",24,FALSE,25,3547298,"G",24,24,"Phoenix Suns","Saben Lee",0,0,0,0,0,0
1,0,0,0,0,0,0,0,0,"06",0,1,0,0,1,0,3277482,"2023-11-21T00:00:00.000Z",24,FALSE,25,314,"F",24,24,"Phoenix Suns","Chimezie Metu",1,0,1,1,1,4.5
0,0,0,0,0,0,0,0,0,"00",0,0,0,0,0,0,3277482,"2023-11-21T00:00:00.000Z",24,FALSE,25,37,"G",24,24,"Phoenix Suns","Bradley Beal",0,0,0,0,0,0
0,0,0,0,0,0,0,0,0,"00",0,0,0,0,0,0,3277482,"2023-11-21T00:00:00.000Z",24,FALSE,25,272,"G",24,24,"Phoenix Suns","Damion Lee",0,0,0,0,0,0
0,0,0,0,0,0,0,0,0,"00",0,0,0,0,0,0,3277482,"2023-11-21T00:00:00.000Z",24,FALSE,25,470,"G",24,24,"Phoenix Suns","Yuta Watanabe",0,0,0,0,0,0
0,0,4,2,0,4,2,4,3,"38",0,4,7,4,1,1,3277482,"2023-11-21T00:00:00.000Z",24,FALSE,25,56677850,"F",25,25,"Portland Trail Blazers","Toumani Camara",1,11,11,7,4,13.8
6,1,3,8,5,19,8,6,5,"36",1,1,26,4,1,1,3277482,"2023-11-21T00:00:00.000Z",24,FALSE,25,182,"F",25,25,"Portland Trail Blazers","Jerami Grant",2,30,36,32,10,44.8
0,0,0,0,0,0,0,0,0,"00",0,0,0,0,0,0,3277483,"2023-11-21T00:00:00.000Z",14,FALSE,29,56677835,"G",14,14,"Los Angeles Lakers","Jalen Hood-Schifino",0,0,0,0,0,0
0,0,0,0,0,0,0,0,0,"00",0,0,0,0,0,0,3277483,"2023-11-21T00:00:00.000Z",14,FALSE,29,457,"F",14,14,"Los Angeles Lakers","Jarred Vanderbilt",0,0,0,0,0,0
2,1,7,2,1,7,6,3,3,"27",1,5,16,8,0,2,3277483,"2023-11-21T00:00:00.000Z",14,FALSE,29,486,"F",14,14,"Los Angeles Lakers","Christian Wood",1,24,26,18,10,29.6
4,1,5,5,1,8,3,0,0,"25",0,2,7,5,1,0,3277483,"2023-11-21T00:00:00.000Z",14,FALSE,29,38017697,"G",14,14,"Los Angeles Lakers","Max Christie",2,12,16,11,9,25
1,1,2,0,0,4,4,3,2,"19",0,1,10,2,0,2,3277483,"2023-11-21T00:00:00.000Z",14,FALSE,29,666626,"C",14,14,"Los Angeles Lakers","Jaxson Hayes",1,12,13,11,3,14.9
0,0,0,0,0,0,0,0,0,"00",0,0,0,0,0,0,3277483,"2023-11-21T00:00:00.000Z",14,FALSE,29,56677738,"C",14,14,"Los Angeles Lakers","Colin Castleton",0,0,0,0,0,0
0,0,0,0,0,0,0,0,0,"00",0,0,0,0,0,0,3277483,"2023-11-21T00:00:00.000Z",14,FALSE,29,56677867,"F",14,14,"Los Angeles Lakers","Alex Fudge",0,0,0,0,0,0
0,0,0,0,0,0,0,0,0,"00",0,0,0,0,0,0,3277483,"2023-11-21T00:00:00.000Z",14,FALSE,29,56677868,"G",14,14,"Los Angeles Lakers","D'Moi Hodge",0,0,0,0,0,0
0,0,0,0,0,0,0,0,0,"00",0,0,0,0,0,0,3277483,"2023-11-21T00:00:00.000Z",14,FALSE,29,56677836,"F",14,14,"Los Angeles Lakers","Maxwell Lewis",0,0,0,0,0,0
0,0,0,0,0,0,0,0,0,"00",0,0,0,0,0,0,3277483,"2023-11-21T00:00:00.000Z",14,FALSE,29,1603383,"G",14,14,"Los Angeles Lakers","Gabe Vincent",0,0,0,0,0,0
1,0,3,2,0,3,0,0,0,"09",0,1,0,3,0,1,3277483,"2023-11-21T00:00:00.000Z",14,FALSE,29,666881,"F",29,29,"Utah Jazz","Luka Samanic",0,3,4,1,4,4.1
0,0,0,0,0,0,0,0,0,"00",0,0,0,0,0,0,3277483,"2023-11-21T00:00:00.000Z",14,FALSE,29,17896023,"G",29,29,"Utah Jazz","Josh Christopher",0,0,0,0,0,0
0,0,0,0,0,0,0,0,0,"00",0,0,0,0,0,0,3277483,"2023-11-21T00:00:00.000Z",14,FALSE,29,56677824,"F",29,29,"Utah Jazz","Taylor Hendricks",0,0,0,0,0,0
0,0,0,0,0,0,0,0,0,"00",0,0,0,0,0,0,3277483,"2023-11-21T00:00:00.000Z",14,FALSE,29,38017630,"G",29,29,"Utah Jazz","Johnny Juzang",0,0,0,0,0,0
0,0,0,0,0,0,0,0,0,"00",0,0,0,0,0,0,3277483,"2023-11-21T00:00:00.000Z",14,FALSE,29,38017705,"C",29,29,"Utah Jazz","Walker Kessler",0,0,0,0,0,0
0,0,0,0,0,0,0,0,0,"00",0,0,0,0,0,0,3277483,"2023-11-21T00:00:00.000Z",14,FALSE,29,19465584,"F",29,29,"Utah Jazz","Micah Potter",0,0,0,0,0,0
0,0,0,0,0,0,0,0,0,"00",0,0,0,0,0,0,3277483,"2023-11-21T00:00:00.000Z",14,FALSE,29,56677842,"F",29,29,"Utah Jazz","Brice Sensabaugh",0,0,0,0,0,0
0,0,0,0,0,0,0,0,0,"05",0,1,0,0,0,0,3277483,"2023-11-21T00:00:00.000Z",14,FALSE,29,666860,"F-G",14,14,"Los Angeles Lakers","Cameron Reddish",0,0,0,0,0,0
9,0,6,5,3,10,6,2,2,"24",1,0,17,7,0,2,3277483,"2023-11-21T00:00:00.000Z",14,FALSE,29,237,"F",14,14,"Los Angeles Lakers","LeBron James",0,24,33,26,16,36.9
4,0,11,0,0,14,11,5,4,"29",5,1,26,16,2,2,3277483,"2023-11-21T00:00:00.000Z",14,FALSE,29,117,"F-C",14,14,"Los Angeles Lakers","Anthony Davis",2,42,46,30,20,55.2
1,1,0,4,0,8,1,3,2,"31",0,0,4,0,0,2,3277483,"2023-11-21T00:00:00.000Z",14,FALSE,29,383,"F",14,14,"Los Angeles Lakers","Taurean Prince",1,4,5,5,1,6.5
8,1,3,4,3,9,7,5,3,"26",0,2,20,3,0,0,3277483,"2023-11-21T00:00:00.000Z",14,FALSE,29,405,"G",14,14,"Los Angeles Lakers","D'Angelo Russell",1,23,31,28,11,38.6
1,0,4,5,2,13,4,2,2,"28",2,3,12,6,0,1,3277483,"2023-11-21T00:00:00.000Z",14,FALSE,29,666609,"F",14,14,"Los Angeles Lakers","Rui Hachimura",0,18,19,13,7,19.7
5,0,5,4,1,13,7,4,4,"26",0,0,19,5,3,2,3277483,"2023-11-21T00:00:00.000Z",14,FALSE,29,17553995,"G",14,14,"Los Angeles Lakers","Austin Reaves",3,24,29,24,10,39.5
2,0,0,3,0,9,3,1,1,"24",0,1,7,0,1,2,3277483,"2023-11-21T00:00:00.000Z",14,FALSE,29,100,"G",29,29,"Utah Jazz","Jordan Clarkson",1,7,9,9,2,11
2,0,2,5,1,11,3,2,2,"21",1,2,9,3,1,2,3277483,"2023-11-21T00:00:00.000Z",14,FALSE,29,56677834,"G",29,29,"Utah Jazz","Keyonte George",1,12,14,11,5,16.6
2,0,0,1,1,4,2,0,0,"08",0,1,5,0,0,2,3277483,"2023-11-21T00:00:00.000Z",14,FALSE,29,139,"G",29,29,"Utah Jazz","Kris Dunn",0,5,7,7,2,6
0,1,2,5,3,6,4,0,0,"27",2,3,11,4,0,1,3277483,"2023-11-21T00:00:00.000Z",14,FALSE,29,38017739,"F",29,29,"Utah Jazz","Simone Fontecchio",1,15,15,11,4,17.8
7,1,3,5,0,10,1,4,4,"23",0,1,6,3,2,1,3277483,"2023-11-21T00:00:00.000Z",14,FALSE,29,666650,"G",29,29,"Utah Jazz","Talen Horton-Tucker",3,9,16,13,10,28.1
5,0,3,4,0,6,1,4,2,"24",2,3,4,5,0,2,3277483,"2023-11-21T00:00:00.000Z",14,FALSE,29,358,"F",29,29,"Utah Jazz","Kelly Olynyk",0,9,14,9,10,15.5
4,0,3,3,2,11,6,0,0,"22",0,2,14,3,0,1,3277483,"2023-11-21T00:00:00.000Z",14,FALSE,29,413,"G",29,29,"Utah Jazz","Collin Sexton",0,17,21,18,7,22.6
1,0,2,1,0,11,8,3,2,"17",4,1,18,6,0,0,3277483,"2023-11-21T00:00:00.000Z",14,FALSE,29,11891374,"C",29,29,"Utah Jazz","Omer Yurtseven",0,24,25,19,7,26.7
0,0,2,3,0,5,0,0,0,"17",1,2,0,3,0,1,3277483,"2023-11-21T00:00:00.000Z",14,FALSE,29,38017620,"G",29,29,"Utah Jazz","Ochai Agbaji",0,3,3,0,3,2.6
0,0,7,7,2,10,4,0,0,"23",1,2,10,8,1,0,3277483,"2023-11-21T00:00:00.000Z",14,FALSE,29,297,"F",29,29,"Utah Jazz","Lauri Markkanen",1,18,18,10,8,22.6
1,1,2,5,2,12,6,2,1,"25",2,3,15,4,1,1,3277483,"2023-11-21T00:00:00.000Z",14,FALSE,29,101,"F-C",29,29,"Utah Jazz","John Collins",2,19,20,16,5,26.3
6,0,8,1,0,8,2,0,0,"30",1,1,4,9,0,3,1037799,"2023-11-22T00:00:00.000Z",4,FALSE,30,204,"F",4,4,"Charlotte Hornets","Gordon Hayward",0,13,19,10,15,20.8
0,0,9,7,3,19,11,10,8,"37",2,2,33,11,2,2,1037799,"2023-11-22T00:00:00.000Z",4,FALSE,30,62,"F",4,4,"Charlotte Hornets","Miles Bridges",2,44,44,33,11,50.2
0,3,9,0,0,10,4,6,3,"35",5,4,11,14,0,0,1037799,"2023-11-22T00:00:00.000Z",4,FALSE,30,38017698,"C",4,4,"Charlotte Hornets","Mark Williams",3,25,25,11,14,36.8
3,0,0,6,3,12,6,0,0,"31",0,2,15,0,1,0,1037799,"2023-11-22T00:00:00.000Z",4,FALSE,30,56677823,"F",4,4,"Charlotte Hornets","Brandon Miller",1,15,18,18,3,22.5
13,0,6,16,6,31,13,3,2,"40",2,2,34,8,1,4,1037799,"2023-11-22T00:00:00.000Z",4,FALSE,30,3547239,"G",4,4,"Charlotte Hornets","LaMelo Ball",1,42,55,47,21,62.1
0,0,0,0,0,0,0,0,0,"00",0,0,0,0,0,0,1037799,"2023-11-22T00:00:00.000Z",4,FALSE,30,17896037,"G",4,4,"Charlotte Hornets","James Bouknight",0,0,0,0,0,0
0,0,0,0,0,0,0,0,0,"00",0,0,0,0,0,0,1037799,"2023-11-22T00:00:00.000Z",4,FALSE,30,3547253,"G",4,4,"Charlotte Hornets","Theo Maledon",0,0,0,0,0,0
0,1,2,4,3,5,4,2,2,"23",1,1,13,3,1,1,1037799,"2023-11-22T00:00:00.000Z",4,FALSE,30,38017708,"G",4,4,"Charlotte Hornets","Bryce McGowens",2,16,16,13,3,21.6
4,0,0,0,0,1,0,0,0,"20",0,1,0,0,1,1,1037799,"2023-11-22T00:00:00.000Z",4,FALSE,30,422,"G",4,4,"Charlotte Hornets","Ish Smith",1,0,4,4,4,8
0,0,0,0,0,1,1,0,0,"01",0,1,2,0,0,0,1037799,"2023-11-22T00:00:00.000Z",4,FALSE,30,56677846,"G",4,4,"Charlotte Hornets","Nick Smith Jr.",0,2,2,2,0,2
1,0,4,3,1,5,2,0,0,"23",0,1,5,4,0,0,1037799,"2023-11-22T00:00:00.000Z",4,FALSE,30,18678001,"F",4,4,"Charlotte Hornets","JT Thor",0,9,10,6,5,11.3
0,0,0,0,0,0,0,0,0,"00",0,0,0,0,0,0,1037799,"2023-11-22T00:00:00.000Z",4,FALSE,30,666950,"F",4,4,"Charlotte Hornets","P.J. Washington",0,0,0,0,0,0
0,0,0,0,0,0,0,0,0,"00",0,0,0,0,0,0,1037799,"2023-11-22T00:00:00.000Z",4,FALSE,30,56677848,"G",4,4,"Charlotte Hornets","Amari Bailey",0,0,0,0,0,0
0,0,0,0,0,0,0,0,0,"00",0,0,0,0,0,0,1037799,"2023-11-22T00:00:00.000Z",4,FALSE,30,56677866,"F",4,4,"Charlotte Hornets","Leaky Black",0,0,0,0,0,0
0,0,0,0,0,0,0,0,0,"00",0,0,0,0,0,0,1037799,"2023-11-22T00:00:00.000Z",4,FALSE,30,666748,"F",4,4,"Charlotte Hornets","Cody Martin",0,0,0,0,0,0
0,0,0,0,0,0,0,0,0,"00",0,0,0,0,0,0,1037799,"2023-11-22T00:00:00.000Z",4,FALSE,30,347,"G",4,4,"Charlotte Hornets","Frank Ntilikina",0,0,0,0,0,0
0,0,0,0,0,0,0,0,0,"00",0,0,0,0,0,0,1037799,"2023-11-22T00:00:00.000Z",4,FALSE,30,3547282,"C",4,4,"Charlotte Hornets","Nick Richards",0,0,0,0,0,0
0,0,0,0,0,0,0,0,0,"00",0,0,0,0,0,0,1037799,"2023-11-22T00:00:00.000Z",4,FALSE,30,403,"G",4,4,"Charlotte Hornets","Terry Rozier",0,0,0,0,0,0
1,0,3,2,1,9,5,2,2,"28",2,0,13,5,0,1,1037799,"2023-11-22T00:00:00.000Z",4,FALSE,30,3547242,"F",30,30,"Washington Wizards","Deni Avdija",0,18,19,14,6,19.5
10,2,9,6,3,22,12,1,1,"35",0,4,28,9,1,2,1037799,"2023-11-22T00:00:00.000Z",4,FALSE,30,265,"F",30,30,"Washington Wizards","Kyle Kuzma",3,37,47,38,19,60.8
1,0,11,0,0,9,7,2,1,"34",5,4,15,16,1,2,1037799,"2023-11-22T00:00:00.000Z",4,FALSE,30,666577,"F",30,30,"Washington Wizards","Daniel Gafford",1,31,32,16,17,36.7
2,0,4,11,4,21,8,4,4,"33",2,1,24,6,2,3,1037799,"2023-11-22T00:00:00.000Z",4,FALSE,30,666848,"G",30,30,"Washington Wizards","Jordan Poole",2,30,32,26,8,37.2
7,0,1,3,1,13,6,0,0,"35",0,1,13,1,2,0,1037799,"2023-11-22T00:00:00.000Z",4,FALSE,30,249,"G",30,30,"Washington Wizards","Tyus Jones",2,14,21,20,8,30.7
0,0,0,0,0,0,0,0,0,"00",0,0,0,0,0,0,1037799,"2023-11-22T00:00:00.000Z",4,FALSE,30,38017704,"F",30,30,"Washington Wizards","Patrick Baldwin Jr.",0,0,0,0,0,0
0,0,0,0,0,0,0,0,0,"00",0,0,0,0,0,0,1037799,"2023-11-22T00:00:00.000Z",4,FALSE,30,18677954,"G",30,30,"Washington Wizards","Jared Butler",0,0,0,0,0,0
2,1,0,1,0,5,2,3,3,"19",0,4,7,0,0,1,1037799,"2023-11-22T00:00:00.000Z",4,FALSE,30,56677844,"G",30,30,"Washington Wizards","Bilal Coulibaly",1,7,9,9,2,12
0,0,0,0,0,0,0,0,0,"06",0,0,0,0,0,0,1037799,"2023-11-22T00:00:00.000Z",4,FALSE,30,38017687,"G",30,30,"Washington Wizards","Johnny Davis",0,0,0,0,0,0
1,0,5,2,0,5,0,2,1,"14",0,0,1,5,0,0,1037799,"2023-11-22T00:00:00.000Z",4,FALSE,30,167,"F",30,30,"Washington Wizards","Danilo Gallinari",0,6,7,2,6,8.5
0,0,0,0,0,0,0,0,0,"00",0,0,0,0,0,0,1037799,"2023-11-22T00:00:00.000Z",4,FALSE,30,3547302,"F",30,30,"Washington Wizards","Anthony Gill",0,0,0,0,0,0
1,0,3,4,1,7,2,1,1,"18",1,1,6,4,0,1,1037799,"2023-11-22T00:00:00.000Z",4,FALSE,30,17896045,"F",30,30,"Washington Wizards","Corey Kispert",0,10,11,7,5,11.3
0,0,0,0,0,0,0,0,0,"00",0,0,0,0,0,0,1037799,"2023-11-22T00:00:00.000Z",4,FALSE,30,337,"F-C",30,30,"Washington Wizards","Mike Muscala",0,0,0,0,0,0
0,0,0,0,0,0,0,0,0,"00",0,0,0,0,0,0,1037799,"2023-11-22T00:00:00.000Z",4,FALSE,30,17896106,"F",30,30,"Washington Wizards","Eugene Omoruyi",0,0,0,0,0,0
1,0,1,3,1,6,2,3,2,"18",1,3,7,2,0,0,1037799,"2023-11-22T00:00:00.000Z",4,FALSE,30,414,"G",30,30,"Washington Wizards","Landry Shamet",0,9,10,8,3,10.9
0,0,0,0,0,0,0,0,0,"00",0,0,0,0,0,0,1037799,"2023-11-22T00:00:00.000Z",4,FALSE,30,38124126,"F",30,30,"Washington Wizards","John Butler Jr.",0,0,0,0,0,0
0,0,0,0,0,0,0,0,0,"00",0,0,0,0,0,0,1037799,"2023-11-22T00:00:00.000Z",4,FALSE,30,38017712,"G",30,30,"Washington Wizards","Ryan Rollins",0,0,0,0,0,0
0,0,0,0,0,0,0,0,0,"00",0,0,0,0,0,0,1037799,"2023-11-22T00:00:00.000Z",4,FALSE,30,487,"G",30,30,"Washington Wizards","Delon Wright",0,0,0,0,0,0
4,2,2,4,1,18,11,4,4,"31",1,1,27,3,1,1,1037800,"2023-11-22T00:00:00.000Z",22,FALSE,8,17896026,"F",22,22,"Orlando Magic","Franz Wagner",3,30,34,31,7,44.6
4,3,2,5,4,14,8,5,3,"35",1,1,23,3,1,3,1037800,"2023-11-22T00:00:00.000Z",22,FALSE,8,38017683,"F",22,22,"Orlando Magic","Paolo Banchero",4,26,30,27,7,41.6
2,1,9,0,0,5,2,2,2,"32",3,2,6,12,0,1,1037800,"2023-11-22T00:00:00.000Z",22,FALSE,8,666442,"C",22,22,"Orlando Magic","Goga Bitadze",1,18,20,8,14,25.4
4,0,4,3,0,8,4,2,2,"29",0,5,10,4,1,2,1037800,"2023-11-22T00:00:00.000Z",22,FALSE,8,17896073,"G",22,22,"Orlando Magic","Jalen Suggs",1,14,18,14,8,21.8
1,0,1,0,0,1,0,0,0,"15",0,2,0,1,0,3,1037800,"2023-11-22T00:00:00.000Z",22,FALSE,8,56677827,"G",22,22,"Orlando Magic","Anthony Black",0,1,2,1,2,-0.3
0,0,2,4,1,11,6,8,7,"29",3,3,20,5,0,0,1037800,"2023-11-22T00:00:00.000Z",22,FALSE,8,3547251,"G",22,22,"Orlando Magic","Cole Anthony",0,25,25,20,5,26
3,0,3,6,1,7,1,2,2,"23",0,2,5,3,3,0,1037800,"2023-11-22T00:00:00.000Z",22,FALSE,8,196,"G",22,22,"Orlando Magic","Gary Harris",3,8,11,8,6,22.1
0,0,0,0,0,0,0,0,0,"00",0,0,0,0,0,0,1037800,"2023-11-22T00:00:00.000Z",22,FALSE,8,38017724,"G",22,22,"Orlando Magic","Caleb Houstan",0,0,0,0,0,0
1,0,6,2,2,7,4,3,3,"21",1,4,13,7,0,3,1037800,"2023-11-22T00:00:00.000Z",22,FALSE,8,38017709,"G",8,8,"Denver Nuggets","Christian Braun",0,20,21,14,8,19.9
0,0,0,0,0,0,0,0,0,"00",0,0,0,0,0,0,1037800,"2023-11-22T00:00:00.000Z",22,FALSE,8,38017727,"G",8,8,"Denver Nuggets","Collin Gillespie",0,0,0,0,0,0
0,0,0,0,0,0,0,0,0,"00",0,0,0,0,0,0,1037800,"2023-11-22T00:00:00.000Z",22,FALSE,8,215,"F-G",8,8,"Denver Nuggets","Justin Holiday",0,0,0,0,0,0
0,0,0,0,0,0,0,0,0,"00",0,0,0,0,0,0,1037800,"2023-11-22T00:00:00.000Z",22,FALSE,8,250,"C",8,8,"Denver Nuggets","DeAndre Jordan",0,0,0,0,0,0
0,0,0,0,0,0,0,0,0,"00",0,0,0,0,0,0,1037800,"2023-11-22T00:00:00.000Z",22,FALSE,8,17896007,"G",8,8,"Denver Nuggets","Braxton Key",0,0,0,0,0,0
2,0,0,0,0,2,1,2,1,"12",1,1,3,1,0,0,1037800,"2023-11-22T00:00:00.000Z",22,FALSE,8,3547268,"F-C",8,8,"Denver Nuggets","Zeke Nnaji",0,4,6,5,3,7.2
0,0,1,3,0,4,0,0,0,"08",0,0,0,1,0,1,1037800,"2023-11-22T00:00:00.000Z",22,FALSE,8,56677582,"G",8,8,"Denver Nuggets","Jalen Pickett",0,1,1,0,1,0.2
2,0,1,4,1,6,2,2,2,"17",1,5,7,2,0,0,1037800,"2023-11-22T00:00:00.000Z",22,FALSE,8,56677776,"G",8,8,"Denver Nuggets","Julian Strawther",0,9,11,9,4,12.4
0,0,0,0,0,0,0,0,0,"00",0,0,0,0,0,0,1037800,"2023-11-22T00:00:00.000Z",22,FALSE,8,56677871,"F",8,8,"Denver Nuggets","Hunter Tyson",0,0,0,0,0,0
0,0,0,0,0,1,1,2,0,"10",1,1,2,1,0,0,1037800,"2023-11-22T00:00:00.000Z",22,FALSE,8,38017721,"G",8,8,"Denver Nuggets","Peyton Watson",0,3,3,2,1,3.2
0,0,0,0,0,0,0,0,0,"00",0,0,0,0,0,0,1037800,"2023-11-22T00:00:00.000Z",22,FALSE,8,666489,"F",8,8,"Denver Nuggets","Vlatko Cancar",0,0,0,0,0,0
0,0,0,0,0,0,0,0,0,"00",0,0,0,0,0,0,1037800,"2023-11-22T00:00:00.000Z",22,FALSE,8,38017607,"G",22,22,"Orlando Magic","Kevon Harris",0,0,0,0,0,0
0,0,0,0,0,0,0,0,0,"00",0,0,0,0,0,0,1037800,"2023-11-22T00:00:00.000Z",22,FALSE,8,56677839,"G",22,22,"Orlando Magic","Jett Howard",0,0,0,0,0,0
0,0,0,0,0,0,0,0,0,"00",0,0,0,0,0,0,1037800,"2023-11-22T00:00:00.000Z",22,FALSE,8,17553983,"G",22,22,"Orlando Magic","Trevelin Queen",0,0,0,0,0,0
0,0,2,9,5,16,9,2,2,"31",0,4,25,2,1,0,1037800,"2023-11-22T00:00:00.000Z",22,FALSE,8,375,"F",8,8,"Denver Nuggets","Michael Porter Jr.",1,27,27,25,2,30.4
1,0,3,3,1,16,7,2,0,"37",7,3,15,10,2,2,1037800,"2023-11-22T00:00:00.000Z",22,FALSE,8,177,"F",8,8,"Denver Nuggets","Aaron Gordon",2,25,26,16,11,32.5
12,2,8,2,1,18,12,5,5,"36",5,4,30,13,3,1,1037800,"2023-11-22T00:00:00.000Z",22,FALSE,8,246,"C",8,8,"Denver Nuggets","Nikola Jokic",5,43,55,42,25,77.6
2,0,1,5,2,8,3,2,2,"34",0,2,10,1,0,2,1037800,"2023-11-22T00:00:00.000Z",22,FALSE,8,81,"G",8,8,"Denver Nuggets","Kentavious Caldwell-Pope",0,11,13,12,3,12.2
9,0,3,7,3,15,5,1,1,"34",1,1,14,4,0,1,1037800,"2023-11-22T00:00:00.000Z",22,FALSE,8,236,"G",8,8,"Denver Nuggets","Reggie Jackson",0,18,27,23,13,31.3
7,0,1,2,2,4,4,2,2,"17",0,3,12,1,1,0,1037800,"2023-11-22T00:00:00.000Z",22,FALSE,8,226,"F",22,22,"Orlando Magic","Joe Ingles",1,13,20,19,8,26.7
1,1,4,2,0,6,4,1,1,"14",2,1,9,6,1,1,1037800,"2023-11-22T00:00:00.000Z",22,FALSE,8,229,"F",22,22,"Orlando Magic","Jonathan Isaac",2,15,16,10,7,22.7
0,0,0,0,0,0,0,0,0,"00",0,0,0,0,0,0,1037800,"2023-11-22T00:00:00.000Z",22,FALSE,8,666818,"F",22,22,"Orlando Magic","Chuma Okeke",0,0,0,0,0,0
0,0,0,0,0,0,0,0,0,"00",0,0,0,0,0,0,1037800,"2023-11-22T00:00:00.000Z",22,FALSE,8,666885,"F",22,22,"Orlando Magic","Admiral Schofield",0,0,0,0,0,0
1,0,2,3,1,7,4,4,3,"15",1,1,12,3,1,1,1037800,"2023-11-22T00:00:00.000Z",22,FALSE,8,462,"C",22,22,"Orlando Magic","Moritz Wagner",1,15,16,13,4,19.1
0,0,0,0,0,0,0,0,0,"00",0,0,0,0,0,0,1037800,"2023-11-22T00:00:00.000Z",22,FALSE,8,85,"F",22,22,"Orlando Magic","Wendell Carter Jr.",0,0,0,0,0,0
0,0,0,0,0,0,0,0,0,"00",0,0,0,0,0,0,1037800,"2023-11-22T00:00:00.000Z",22,FALSE,8,165,"G",22,22,"Orlando Magic","Markelle Fultz",0,0,0,0,0,0
0,0,0,0,0,0,0,0,0,"00",0,0,0,0,0,0,1037800,"2023-11-22T00:00:00.000Z",22,FALSE,8,17896103,"F-C",8,8,"Denver Nuggets","Jay Huff",0,0,0,0,0,0
0,0,0,0,0,0,0,0,0,"00",0,0,0,0,0,0,1037800,"2023-11-22T00:00:00.000Z",22,FALSE,8,335,"G",8,8,"Denver Nuggets","Jamal Murray",0,0,0,0,0,0
0,2,8,7,2,16,8,7,7,"39",3,3,25,11,1,1,1037801,"2023-11-22T00:00:00.000Z",1,FALSE,3,666656,"F",1,1,"Atlanta Hawks","De'Andre Hunter",3,36,36,25,11,46.2
3,1,6,2,1,7,3,0,0,"40",0,3,7,6,2,5,1037801,"2023-11-22T00:00:00.000Z",1,FALSE,3,17896040,"F",1,1,"Atlanta Hawks","Jalen Johnson",3,13,16,10,9,22.7
0,3,6,0,0,8,7,0,0,"28",9,1,14,15,0,0,1037801,"2023-11-22T00:00:00.000Z",1,FALSE,3,83,"C",1,1,"Atlanta Hawks","Clint Capela",3,29,29,14,15,41
8,0,3,8,3,21,6,5,5,"39",3,4,20,6,2,1,1037801,"2023-11-22T00:00:00.000Z",1,FALSE,3,334,"G",1,1,"Atlanta Hawks","Dejounte Murray",2,26,34,28,14,44.2
9,0,2,16,8,31,12,13,11,"40",2,0,43,4,2,4,1037801,"2023-11-22T00:00:00.000Z",1,FALSE,3,490,"G",1,1,"Atlanta Hawks","Trae Young",2,47,56,52,13,63.3
1,0,2,3,1,8,4,3,3,"25",0,2,12,2,2,2,1037801,"2023-11-22T00:00:00.000Z",1,FALSE,3,3547256,"F",1,1,"Atlanta Hawks","Saddiq Bey",2,14,15,13,3,19.9
3,1,3,11,3,15,5,1,1,"26",1,4,14,4,1,1,1037801,"2023-11-22T00:00:00.000Z",1,FALSE,3,53,"G",1,1,"Atlanta Hawks","Bogdan Bogdanovic",2,18,21,17,7,28.3
0,0,0,0,0,0,0,0,0,"00",0,0,0,0,0,0,1037801,"2023-11-22T00:00:00.000Z",1,FALSE,3,666564,"F",1,1,"Atlanta Hawks","Bruno Fernando",0,0,0,0,0,0
0,0,0,0,0,0,0,0,0,"00",0,0,0,0,0,0,1037801,"2023-11-22T00:00:00.000Z",1,FALSE,3,3547297,"G",1,1,"Atlanta Hawks","Trent Forrest",0,0,0,0,0,0
0,0,0,0,0,0,0,0,0,"03",0,0,0,0,0,0,1037801,"2023-11-22T00:00:00.000Z",1,FALSE,3,38017689,"F",1,1,"Atlanta Hawks","AJ Griffin",0,0,0,0,0,0
0,0,0,0,0,0,0,0,0,"00",0,0,0,0,0,0,1037801,"2023-11-22T00:00:00.000Z",1,FALSE,3,666754,"G",1,1,"Atlanta Hawks","Garrison Mathews",0,0,0,0,0,0
0,0,0,0,0,0,0,0,0,"00",0,0,0,0,0,0,1037801,"2023-11-22T00:00:00.000Z",1,FALSE,3,301,"G-F",1,1,"Atlanta Hawks","Wesley Matthews",0,0,0,0,0,0
0,0,0,0,0,0,0,0,0,"00",0,0,0,0,0,0,1037801,"2023-11-22T00:00:00.000Z",1,FALSE,3,319,"G",1,1,"Atlanta Hawks","Patty Mills",0,0,0,0,0,0
0,1,6,2,0,10,6,0,0,"25",4,1,12,10,0,0,1037801,"2023-11-22T00:00:00.000Z",1,FALSE,3,3547244,"F-C",1,1,"Atlanta Hawks","Onyeka Okongwu",1,22,22,12,10,27
0,0,0,0,0,0,0,0,0,"00",0,0,0,0,0,0,1037801,"2023-11-22T00:00:00.000Z",1,FALSE,3,56677838,"G",1,1,"Atlanta Hawks","Kobe Bufkin",0,0,0,0,0,0
0,0,0,0,0,0,0,0,0,"00",0,0,0,0,0,0,1037801,"2023-11-22T00:00:00.000Z",1,FALSE,3,56677806,"F",1,1,"Atlanta Hawks","Mouhamed Gueye",0,0,0,0,0,0
0,0,0,0,0,0,0,0,0,"00",0,0,0,0,0,0,1037801,"2023-11-22T00:00:00.000Z",1,FALSE,3,56677855,"G",1,1,"Atlanta Hawks","Seth Lundy",0,0,0,0,0,0
0,0,0,0,0,0,0,0,0,"00",0,0,0,0,0,0,1037801,"2023-11-22T00:00:00.000Z",1,FALSE,3,56677875,"F",1,1,"Atlanta Hawks","Miles Norris",0,0,0,0,0,0
5,0,3,8,5,13,8,2,2,"38",2,1,23,5,2,2,1037801,"2023-11-22T00:00:00.000Z",1,FALSE,3,666679,"F",3,3,"Brooklyn Nets","Cameron Johnson",2,28,33,28,10,40.5
1,0,5,5,2,7,3,0,0,"38",3,3,8,8,0,1,1037801,"2023-11-22T00:00:00.000Z",1,FALSE,3,158,"F",3,3,"Brooklyn Nets","Dorian Finney-Smith",0,16,17,9,9,18.1
3,3,4,0,0,15,10,2,2,"37",7,6,22,11,1,2,1037801,"2023-11-22T00:00:00.000Z",1,FALSE,3,666508,"F-C",3,3,"Brooklyn Nets","Nicolas Claxton",4,33,36,25,14,49.7
4,0,7,6,2,31,16,12,11,"44",3,2,45,10,2,1,1037801,"2023-11-22T00:00:00.000Z",1,FALSE,3,61,"F",3,3,"Brooklyn Nets","Mikal Bridges",2,55,59,49,14,68
12,0,4,8,3,23,9,5,5,"42",2,3,26,6,0,4,1037801,"2023-11-22T00:00:00.000Z",1,FALSE,3,130,"G",3,3,"Brooklyn Nets","Spencer Dinwiddie",0,32,44,38,18,47.2
0,0,0,0,0,0,0,0,0,"00",0,0,0,0,0,0,1037801,"2023-11-22T00:00:00.000Z",1,FALSE,3,9051997,"G",3,3,"Brooklyn Nets","Armoni Brooks",0,0,0,0,0,0
0,0,0,0,0,0,0,0,0,"00",0,0,0,0,0,0,1037801,"2023-11-22T00:00:00.000Z",1,FALSE,3,174,"F-C",3,3,"Brooklyn Nets","Harry Giles III",0,0,0,0,0,0
1,1,3,2,0,3,0,2,0,"21",0,3,0,3,1,1,1037801,"2023-11-22T00:00:00.000Z",1,FALSE,3,351,"F",3,3,"Brooklyn Nets","Royce O'Neale",2,3,4,1,4,10.1
0,1,3,0,0,6,3,0,0,"14",4,2,6,7,2,1,1037801,"2023-11-22T00:00:00.000Z",1,FALSE,3,17896038,"C",3,3,"Brooklyn Nets","Day'Ron Sharpe",3,13,13,6,7,22.4
0,0,0,0,0,0,0,0,0,"00",0,0,0,0,0,0,1037801,"2023-11-22T00:00:00.000Z",1,FALSE,3,421,"G",3,3,"Brooklyn Nets","Dennis Smith Jr.",0,0,0,0,0,0
1,1,2,4,2,7,3,1,0,"16",0,1,8,2,0,1,1037801,"2023-11-22T00:00:00.000Z",1,FALSE,3,464,"G",3,3,"Brooklyn Nets","Lonnie Walker IV",1,10,11,9,3,13.9
1,0,6,2,1,8,3,0,0,"15",1,3,7,7,0,3,1037801,"2023-11-22T00:00:00.000Z",1,FALSE,3,17896058,"F",3,3,"Brooklyn Nets","Trendon Watford",0,14,15,8,8,13.9
0,0,0,0,0,0,0,0,0,"00",0,0,0,0,0,0,1037801,"2023-11-22T00:00:00.000Z",1,FALSE,3,56677843,"F",3,3,"Brooklyn Nets","Noah Clowney",0,0,0,0,0,0
0,0,0,0,0,0,0,0,0,"00",0,0,0,0,0,0,1037801,"2023-11-22T00:00:00.000Z",1,FALSE,3,17896041,"G",3,3,"Brooklyn Nets","Keon Johnson",0,0,0,0,0,0
0,0,0,0,0,0,0,0,0,"00",0,0,0,0,0,0,1037801,"2023-11-22T00:00:00.000Z",1,FALSE,3,417,"G-F",3,3,"Brooklyn Nets","Ben Simmons",0,0,0,0,0,0
0,0,0,0,0,0,0,0,0,"00",0,0,0,0,0,0,1037801,"2023-11-22T00:00:00.000Z",1,FALSE,3,17896048,"G",3,3,"Brooklyn Nets","Cam Thomas",0,0,0,0,0,0
0,0,0,0,0,0,0,0,0,"00",0,0,0,0,0,0,1037801,"2023-11-22T00:00:00.000Z",1,FALSE,3,56677841,"F",3,3,"Brooklyn Nets","Dariq Whitehead",0,0,0,0,0,0
0,0,0,0,0,0,0,0,0,"00",0,0,0,0,0,0,1037801,"2023-11-22T00:00:00.000Z",1,FALSE,3,56677722,"F",3,3,"Brooklyn Nets","Jalen Wilson",0,0,0,0,0,0
1,0,2,4,2,7,4,0,0,"21",0,0,10,2,0,2,1037802,"2023-11-22T00:00:00.000Z",2,FALSE,17,3547276,"G",2,2,"Boston Celtics","Payton Pritchard",0,12,13,11,3,11.9
0,0,0,0,0,0,0,0,0,"00",0,0,0,0,0,0,1037802,"2023-11-22T00:00:00.000Z",2,FALSE,17,3547279,"F",2,2,"Boston Celtics","Lamar Stevens",0,0,0,0,0,0
0,0,0,0,0,0,0,0,0,"00",0,0,0,0,0,0,1037802,"2023-11-22T00:00:00.000Z",2,FALSE,17,38017707,"G",2,2,"Boston Celtics","JD Davison",0,0,0,0,0,0
0,0,0,0,0,0,0,0,0,"00",0,0,0,0,0,0,1037802,"2023-11-22T00:00:00.000Z",2,FALSE,17,3547295,"F-C",2,2,"Boston Celtics","Nathan Knight",0,0,0,0,0,0
0,0,0,0,0,0,0,0,0,"00",0,0,0,0,0,0,1037802,"2023-11-22T00:00:00.000Z",2,FALSE,17,17553967,"C",2,2,"Boston Celtics","Neemias Queta",0,0,0,0,0,0
0,0,0,0,0,0,0,0,0,"00",0,0,0,0,0,0,1037802,"2023-11-22T00:00:00.000Z",2,FALSE,17,56677864,"G",2,2,"Boston Celtics","Jordan Walsh",0,0,0,0,0,0
7,0,3,5,2,14,4,2,2,"29",2,4,12,5,1,0,1037802,"2023-11-22T00:00:00.000Z",2,FALSE,17,315,"F",17,17,"Milwaukee Bucks","Khris Middleton",1,17,24,19,12,31.5
5,0,10,3,0,20,7,10,7,"36",3,4,21,13,2,3,1037802,"2023-11-22T00:00:00.000Z",2,FALSE,17,15,"F",17,17,"Milwaukee Bucks","Giannis Antetokounmpo",2,34,39,26,18,47.1
8,0,2,5,3,16,10,3,3,"35",0,1,26,2,1,1,1037802,"2023-11-22T00:00:00.000Z",2,FALSE,17,70,"G",2,2,"Boston Celtics","Jaylen Brown",1,28,36,34,10,42.4
4,1,11,9,2,17,7,9,7,"36",0,2,23,11,0,2,1037802,"2023-11-22T00:00:00.000Z",2,FALSE,17,434,"F",2,2,"Boston Celtics","Jayson Tatum",1,34,38,27,15,43.2
1,0,5,7,2,15,9,2,1,"27",1,5,21,6,0,1,1037802,"2023-11-22T00:00:00.000Z",2,FALSE,17,378,"F-C",2,2,"Boston Celtics","Kristaps Porzingis",0,27,28,22,7,28.7
5,1,4,6,3,9,5,0,0,"35",0,1,13,4,1,6,1037802,"2023-11-22T00:00:00.000Z",2,FALSE,17,473,"G",2,2,"Boston Celtics","Derrick White",2,17,22,18,9,25.3
1,1,7,5,1,8,1,2,2,"35",1,3,5,8,1,2,1037802,"2023-11-22T00:00:00.000Z",2,FALSE,17,214,"G",2,2,"Boston Celtics","Jrue Holiday",2,13,14,6,9,20.1
0,0,0,0,0,0,0,0,0,"00",0,0,0,0,0,0,1037802,"2023-11-22T00:00:00.000Z",2,FALSE,17,17896094,"G",2,2,"Boston Celtics","Dalano Banton",0,0,0,0,0,0
2,0,0,3,1,5,1,0,0,"10",0,0,3,0,0,0,1037802,"2023-11-22T00:00:00.000Z",2,FALSE,17,368,"G",17,17,"Milwaukee Bucks","Cameron Payne",0,3,5,5,2,6
0,0,6,0,0,6,2,0,0,"21",1,2,4,7,0,0,1037802,"2023-11-22T00:00:00.000Z",2,FALSE,17,377,"F",17,17,"Milwaukee Bucks","Bobby Portis",0,11,11,4,7,12.4
0,0,0,0,0,0,0,0,0,"00",0,0,0,0,0,0,1037802,"2023-11-22T00:00:00.000Z",2,FALSE,17,666453,"C",17,17,"Milwaukee Bucks","Marques Bolden",0,0,0,0,0,0
0,0,0,0,0,0,0,0,0,"00",0,0,0,0,0,0,1037802,"2023-11-22T00:00:00.000Z",2,FALSE,17,112,"F",17,17,"Milwaukee Bucks","Jae Crowder",0,0,0,0,0,0
0,0,0,0,0,0,0,0,0,"00",0,0,0,0,0,0,1037802,"2023-11-22T00:00:00.000Z",2,FALSE,17,38017691,"G",17,17,"Milwaukee Bucks","TyTy Washington Jr.",0,0,0,0,0,0
0,0,0,0,0,0,0,0,0,"00",0,0,0,0,0,0,1037802,"2023-11-22T00:00:00.000Z",2,FALSE,17,666960,"G",17,17,"Milwaukee Bucks","Lindell Wigginton",0,0,0,0,0,0
0,1,3,2,1,2,1,0,0,"20",0,0,3,3,0,1,1037802,"2023-11-22T00:00:00.000Z",2,FALSE,17,105,"G",17,17,"Milwaukee Bucks","Pat Connaughton",1,6,6,3,3,8.6
0,0,0,0,0,0,0,0,0,"00",0,0,0,0,0,0,1037802,"2023-11-22T00:00:00.000Z",2,FALSE,17,38017733,"G",17,17,"Milwaukee Bucks","A.J. Green",0,0,0,0,0,0
0,0,0,1,1,4,3,0,0,"08",1,2,7,1,0,1,1037802,"2023-11-22T00:00:00.000Z",2,FALSE,17,56677852,"G",17,17,"Milwaukee Bucks","Andre Jackson Jr.",0,8,8,7,1,7.2
0,0,0,0,0,0,0,0,0,"00",0,0,0,0,0,0,1037802,"2023-11-22T00:00:00.000Z",2,FALSE,17,56677854,"F",17,17,"Milwaukee Bucks","Chris Livingston",0,0,0,0,0,0
0,0,0,0,0,0,0,0,0,"00",0,0,0,0,0,0,1037802,"2023-11-22T00:00:00.000Z",2,FALSE,17,284,"C",17,17,"Milwaukee Bucks","Robin Lopez",0,0,0,0,0,0
1,1,2,5,2,18,12,3,2,"33",5,3,28,7,1,0,1037802,"2023-11-22T00:00:00.000Z",2,FALSE,17,283,"C",17,17,"Milwaukee Bucks","Brook Lopez",2,35,36,29,8,43.9
3,0,3,3,2,3,2,0,0,"23",0,1,6,3,2,1,1037802,"2023-11-22T00:00:00.000Z",2,FALSE,17,38,"G",17,17,"Milwaukee Bucks","Malik Beasley",2,9,12,9,6,19.1
5,0,5,10,3,24,11,2,2,"38",0,2,27,5,2,3,1037802,"2023-11-22T00:00:00.000Z",2,FALSE,17,278,"G",17,17,"Milwaukee Bucks","Damian Lillard",2,32,37,32,10,43.5
0,0,0,0,0,0,0,0,0,"00",0,0,0,0,0,0,1037802,"2023-11-22T00:00:00.000Z",2,FALSE,17,2148,"",17,17,"Milwaukee Bucks","Thanasis Antetokounmpo",0,0,0,0,0,0
0,0,2,2,1,5,2,0,0,"22",1,1,5,3,1,0,1037802,"2023-11-22T00:00:00.000Z",2,FALSE,17,38017676,"F",17,17,"Milwaukee Bucks","MarJon Beauchamp",1,8,8,5,3,11.6
1,1,1,3,2,5,4,0,0,"20",1,2,10,2,0,1,1037802,"2023-11-22T00:00:00.000Z",2,FALSE,17,17896060,"F",2,2,"Boston Celtics","Sam Hauser",1,12,13,11,3,15.9
6,1,7,3,2,7,4,1,1,"31",1,1,11,8,0,0,1037802,"2023-11-22T00:00:00.000Z",2,FALSE,17,219,"C-F",2,2,"Boston Celtics","Al Horford",1,19,25,17,14,32.6
0,0,0,0,0,0,0,0,0,"00",0,0,0,0,0,0,1037802,"2023-11-22T00:00:00.000Z",2,FALSE,17,666468,"F",2,2,"Boston Celtics","Oshae Brissett",0,0,0,0,0,0
0,0,0,0,0,0,0,0,0,"00",0,0,0,0,0,0,1037802,"2023-11-22T00:00:00.000Z",2,FALSE,17,261,"F-C",2,2,"Boston Celtics","Luke Kornet",0,0,0,0,0,0
0,0,0,0,0,0,0,0,0,"00",0,0,0,0,0,0,1037802,"2023-11-22T00:00:00.000Z",2,FALSE,17,338,"G",2,2,"Boston Celtics","Svi Mykhailiuk",0,0,0,0,0,0
3,1,3,4,2,6,2,0,0,"25",0,0,6,3,0,2,1037803,"2023-11-22T00:00:00.000Z",6,FALSE,16,666908,"G",6,6,"Cleveland Cavaliers","Max Strus",1,9,12,9,6,15.1
2,0,8,0,0,7,5,3,3,"25",2,0,13,10,0,2,1037803,"2023-11-22T00:00:00.000Z",6,FALSE,16,17896076,"F-C",6,6,"Cleveland Cavaliers","Evan Mobley",0,23,25,15,12,26
2,0,4,0,0,2,1,2,2,"23",0,2,4,4,0,3,1037803,"2023-11-22T00:00:00.000Z",6,FALSE,16,9,"C",6,6,"Cleveland Cavaliers","Jarrett Allen",0,8,10,6,6,8.8
5,2,2,5,2,12,6,3,2,"35",0,1,16,2,1,4,1037803,"2023-11-22T00:00:00.000Z",6,FALSE,16,56677872,"G",6,6,"Cleveland Cavaliers","Craig Porter",3,18,23,21,7,30.9
3,0,1,2,1,11,6,2,1,"27",0,3,14,1,1,3,1037803,"2023-11-22T00:00:00.000Z",6,FALSE,16,666581,"G",6,6,"Cleveland Cavaliers","Darius Garland",1,15,18,17,4,19.7
1,0,1,5,1,5,1,0,0,"16",0,1,3,1,1,0,1037803,"2023-11-22T00:00:00.000Z",6,FALSE,16,56677847,"F",6,6,"Cleveland Cavaliers","Emoni Bates",1,4,5,4,2,8.7
1,1,1,0,0,5,1,0,0,"12",2,0,2,3,1,1,1037803,"2023-11-22T00:00:00.000Z",6,FALSE,16,248,"C",6,6,"Cleveland Cavaliers","Damian Jones",2,5,6,3,4,12.1
3,1,2,3,2,8,4,2,2,"18",0,0,12,2,0,2,1037803,"2023-11-22T00:00:00.000Z",6,FALSE,16,277,"G",6,6,"Cleveland Cavaliers","Caris LeVert",1,14,17,15,5,19.9
1,0,1,5,3,6,3,0,0,"17",0,3,9,1,0,1,1037803,"2023-11-22T00:00:00.000Z",6,FALSE,16,3547299,"G",6,6,"Cleveland Cavaliers","Sam Merrill",0,10,11,10,2,10.7
1,0,2,5,3,9,4,0,0,"20",1,5,11,3,0,0,1037803,"2023-11-22T00:00:00.000Z",6,FALSE,16,344,"F",6,6,"Cleveland Cavaliers","Georges Niang",0,14,15,12,4,16.1
0,1,1,0,0,3,2,2,0,"13",2,1,4,3,0,0,1037803,"2023-11-22T00:00:00.000Z",6,FALSE,16,444,"C-F",6,6,"Cleveland Cavaliers","Tristan Thompson",1,7,7,4,3,10.6
0,0,0,0,0,0,0,0,0,"00",0,0,0,0,0,0,1037803,"2023-11-22T00:00:00.000Z",6,FALSE,16,322,"G",6,6,"Cleveland Cavaliers","Donovan Mitchell",0,0,0,0,0,0
0,0,0,0,0,0,0,0,0,"00",0,0,0,0,0,0,1037803,"2023-11-22T00:00:00.000Z",6,FALSE,16,3547247,"F-G",6,6,"Cleveland Cavaliers","Isaac Okoro",0,0,0,0,0,0
0,0,0,0,0,0,0,0,0,"00",0,0,0,0,0,0,1037803,"2023-11-22T00:00:00.000Z",6,FALSE,16,404,"G",6,6,"Cleveland Cavaliers","Ricky Rubio",0,0,0,0,0,0
0,0,0,0,0,0,0,0,0,"00",0,0,0,0,0,0,1037803,"2023-11-22T00:00:00.000Z",6,FALSE,16,666940,"F",6,6,"Cleveland Cavaliers","Dean Wade",0,0,0,0,0,0
9,2,3,5,1,12,3,4,3,"28",1,0,10,4,2,1,1037803,"2023-11-22T00:00:00.000Z",6,FALSE,16,79,"G-F",16,16,"Miami Heat","Jimmy Butler",4,14,23,19,13,39.3
5,2,5,3,2,6,4,0,0,"25",1,4,10,6,1,0,1037803,"2023-11-22T00:00:00.000Z",6,FALSE,16,3092,"",16,16,"Miami Heat","Haywood Highsmith",3,16,21,15,11,33.7
1,1,6,0,0,8,4,2,2,"24",1,3,10,7,1,0,1037803,"2023-11-22T00:00:00.000Z",6,FALSE,16,74,"C",16,16,"Miami Heat","Thomas Bryant",2,17,18,11,8,25.9
3,0,2,3,1,7,3,0,0,"24",0,3,7,2,0,0,1037803,"2023-11-22T00:00:00.000Z",6,FALSE,16,397,"F",16,16,"Miami Heat","Duncan Robinson",0,9,12,10,5,13.9
3,0,1,10,7,15,9,4,3,"29",0,3,28,1,0,0,1037803,"2023-11-22T00:00:00.000Z",6,FALSE,16,286,"G",16,16,"Miami Heat","Kyle Lowry",0,29,32,31,4,33.7
0,0,0,0,0,0,0,0,0,"00",0,0,0,0,0,0,1037803,"2023-11-22T00:00:00.000Z",6,FALSE,16,4,"C-F",16,16,"Miami Heat","Bam Adebayo",0,0,0,0,0,0
1,0,6,4,4,10,7,5,4,"28",2,1,22,8,1,6,1037803,"2023-11-22T00:00:00.000Z",6,FALSE,16,56677785,"G",16,16,"Miami Heat","Jaime Jaquez Jr.",1,30,31,23,9,30.1
1,0,3,5,2,12,5,2,2,"26",0,0,14,3,3,1,1037803,"2023-11-22T00:00:00.000Z",6,FALSE,16,666747,"F",16,16,"Miami Heat","Caleb Martin",3,17,18,15,4,27.1
5,0,0,4,2,9,5,2,2,"27",1,0,14,1,2,0,1037803,"2023-11-22T00:00:00.000Z",6,FALSE,16,391,"G-F",16,16,"Miami Heat","Josh Richardson",2,15,20,19,6,28.7
2,2,5,1,1,9,6,2,1,"28",4,4,14,9,1,2,1037803,"2023-11-22T00:00:00.000Z",6,FALSE,16,39398582,"C",16,16,"Miami Heat","Orlando Robinson",3,23,25,16,11,34.8
0,0,0,0,0,0,0,0,0,"01",0,1,0,0,0,0,1037803,"2023-11-22T00:00:00.000Z",6,FALSE,16,19465585,"G",16,16,"Miami Heat","Dru Smith",0,0,0,0,0,0
0,0,0,0,0,0,0,0,0,"00",0,0,0,0,0,0,1037803,"2023-11-22T00:00:00.000Z",6,FALSE,16,38017734,"F",16,16,"Miami Heat","Jamal Cain",0,0,0,0,0,0
0,0,0,0,0,0,0,0,0,"00",0,0,0,0,0,0,1037803,"2023-11-22T00:00:00.000Z",6,FALSE,16,3547257,"G",16,16,"Miami Heat","R.J. Hampton",0,0,0,0,0,0
0,0,0,0,0,0,0,0,0,"00",0,0,0,0,0,0,1037803,"2023-11-22T00:00:00.000Z",6,FALSE,16,666633,"G",16,16,"Miami Heat","Tyler Herro",0,0,0,0,0,0
0,0,0,0,0,0,0,0,0,"00",0,0,0,0,0,0,1037803,"2023-11-22T00:00:00.000Z",6,FALSE,16,38017696,"F",16,16,"Miami Heat","Nikola Jovic",0,0,0,0,0,0
0,0,0,0,0,0,0,0,0,"00",0,0,0,0,0,0,1037803,"2023-11-22T00:00:00.000Z",6,FALSE,16,285,"F-C",16,16,"Miami Heat","Kevin Love",0,0,0,0,0,0
0,0,0,0,0,0,0,0,0,"00",0,0,0,0,0,0,1037803,"2023-11-22T00:00:00.000Z",6,FALSE,16,38017736,"F",16,16,"Miami Heat","Cole Swider",0,0,0,0,0,0
3,0,1,1,0,3,1,0,0,"09",0,1,2,1,1,1,1037803,"2023-11-22T00:00:00.000Z",6,FALSE,16,38017662,"F",6,6,"Cleveland Cavaliers","Isaiah Mobley",1,3,6,5,4,9.7
0,0,0,0,0,0,0,0,0,"00",0,0,0,0,0,0,1037803,"2023-11-22T00:00:00.000Z",6,FALSE,16,666676,"G",6,6,"Cleveland Cavaliers","Ty Jerome",0,0,0,0,0,0
5,1,2,12,7,17,12,0,0,"35",0,2,31,2,2,1,1037804,"2023-11-22T00:00:00.000Z",12,FALSE,28,210,"G",12,12,"Indiana Pacers","Buddy Hield",3,33,38,36,7,48.9
1,0,3,5,2,9,6,2,2,"36",0,1,16,3,2,3,1037804,"2023-11-22T00:00:00.000Z",12,FALSE,28,3547243,"F",12,12,"Indiana Pacers","Obi Toppin",2,19,20,17,4,24.1
0,2,7,3,2,11,7,2,1,"29",1,3,17,8,1,2,1037804,"2023-11-22T00:00:00.000Z",12,FALSE,28,452,"C-F",12,12,"Indiana Pacers","Myles Turner",3,25,25,17,8,33.6
3,0,4,4,1,9,5,3,3,"35",0,4,14,4,2,3,1037804,"2023-11-22T00:00:00.000Z",12,FALSE,28,69,"G",12,12,"Indiana Pacers","Bruce Brown",2,18,21,17,7,26.3
16,1,2,10,5,22,12,5,4,"34",1,3,33,3,0,3,1037804,"2023-11-22T00:00:00.000Z",12,FALSE,28,3547245,"G",12,12,"Indiana Pacers","Tyrese Haliburton",1,36,52,49,19,60.6
0,0,0,0,0,0,0,0,0,"00",0,0,0,0,0,0,1037804,"2023-11-22T00:00:00.000Z",12,FALSE,28,17896035,"F",12,12,"Indiana Pacers","Isaiah Jackson",0,0,0,0,0,0
2,1,0,1,0,7,2,2,1,"24",0,1,5,0,1,0,1037804,"2023-11-22T00:00:00.000Z",12,FALSE,28,38017686,"G-F",12,12,"Indiana Pacers","Bennedict Mathurin",2,5,7,7,2,14
5,0,2,1,1,6,3,0,0,"14",0,5,7,2,1,0,1037804,"2023-11-22T00:00:00.000Z",12,FALSE,28,304,"G",12,12,"Indiana Pacers","T.J. McConnell",1,9,14,12,7,19.9
1,0,1,2,0,5,0,0,0,"14",3,3,0,4,1,1,1037804,"2023-11-22T00:00:00.000Z",12,FALSE,28,3547207,"F",12,12,"Indiana Pacers","Jordan Nwora",1,4,5,1,5,8.3
0,0,0,0,0,0,0,0,0,"00",0,0,0,0,0,0,1037804,"2023-11-22T00:00:00.000Z",12,FALSE,28,56677861,"G",12,12,"Indiana Pacers","Ben Sheppard",0,0,0,0,0,0
0,1,5,1,0,5,3,2,2,"19",0,2,8,5,0,1,1037804,"2023-11-22T00:00:00.000Z",12,FALSE,28,3547264,"F-C",12,12,"Indiana Pacers","Jalen Smith",1,13,13,8,5,16
0,0,0,0,0,0,0,0,0,"00",0,0,0,0,0,0,1037804,"2023-11-22T00:00:00.000Z",12,FALSE,28,56677832,"F",12,12,"Indiana Pacers","Jarace Walker",0,0,0,0,0,0
0,0,0,0,0,0,0,0,0,"00",0,0,0,0,0,0,1037804,"2023-11-22T00:00:00.000Z",12,FALSE,28,38017701,"G",12,12,"Indiana Pacers","Kendall Brown",0,0,0,0,0,0
0,0,0,0,0,0,0,0,0,"00",0,0,0,0,0,0,1037804,"2023-11-22T00:00:00.000Z",12,FALSE,28,38017507,"G-F",12,12,"Indiana Pacers","Andrew Nembhard",0,0,0,0,0,0
0,0,0,0,0,0,0,0,0,"00",0,0,0,0,0,0,1037804,"2023-11-22T00:00:00.000Z",12,FALSE,28,3547250,"G-F",12,12,"Indiana Pacers","Aaron Nesmith",0,0,0,0,0,0
0,0,0,0,0,0,0,0,0,"00",0,0,0,0,0,0,1037804,"2023-11-22T00:00:00.000Z",12,FALSE,28,38017710,"C",28,28,"Toronto Raptors","Christian Koloko",0,0,0,0,0,0
0,0,0,0,0,0,0,0,0,"00",0,0,0,0,0,0,1037804,"2023-11-22T00:00:00.000Z",12,FALSE,28,56677869,"G",28,28,"Toronto Raptors","Markquis Nowell",0,0,0,0,0,0
0,0,0,0,0,0,0,0,0,"00",0,0,0,0,0,0,1037804,"2023-11-22T00:00:00.000Z",12,FALSE,28,489,"F",28,28,"Toronto Raptors","Thaddeus Young",0,0,0,0,0,0
0,0,0,0,0,0,0,0,0,"00",0,0,0,0,0,0,1037804,"2023-11-22T00:00:00.000Z",12,FALSE,28,56677778,"F-C",12,12,"Indiana Pacers","Oscar Tshiebwe",0,0,0,0,0,0
0,0,0,0,0,0,0,0,0,"00",0,0,0,0,0,0,1037804,"2023-11-22T00:00:00.000Z",12,FALSE,28,56677794,"G",12,12,"Indiana Pacers","Isaiah Wong",0,0,0,0,0,0
4,0,8,6,2,17,7,5,4,"39",3,0,20,11,4,3,1037804,"2023-11-22T00:00:00.000Z",12,FALSE,28,17896055,"G-F",28,28,"Toronto Raptors","Scottie Barnes",4,31,35,24,15,48.2
4,1,7,3,1,24,13,11,9,"38",3,2,36,10,0,2,1037804,"2023-11-22T00:00:00.000Z",12,FALSE,28,416,"F",28,28,"Toronto Raptors","Pascal Siakam",1,46,50,40,14,55
6,1,3,0,0,4,3,0,0,"29",1,0,6,4,0,3,1037804,"2023-11-22T00:00:00.000Z",12,FALSE,28,373,"C",28,28,"Toronto Raptors","Jakob Poeltl",1,10,16,12,10,19.8
4,0,2,4,1,12,5,2,2,"36",2,3,13,4,1,2,1037804,"2023-11-22T00:00:00.000Z",12,FALSE,28,18,"F",28,28,"Toronto Raptors","OG Anunoby",1,17,21,17,8,24.8
5,0,6,5,2,16,10,4,4,"32",0,3,26,6,1,4,1037804,"2023-11-22T00:00:00.000Z",12,FALSE,28,409,"G",28,28,"Toronto Raptors","Dennis Schroder",1,32,37,31,11,39.7
0,0,0,1,0,3,1,4,4,"10",1,2,6,1,0,0,1037804,"2023-11-22T00:00:00.000Z",12,FALSE,28,58,"F",28,28,"Toronto Raptors","Chris Boucher",0,7,7,6,1,7.2
0,0,0,0,0,0,0,0,0,"00",0,0,0,0,0,0,1037804,"2023-11-22T00:00:00.000Z",12,FALSE,28,56677828,"G",28,28,"Toronto Raptors","Gradey Dick",0,0,0,0,0,0
2,1,3,3,2,8,6,0,0,"20",2,2,14,5,0,1,1037804,"2023-11-22T00:00:00.000Z",12,FALSE,28,3547275,"G",28,28,"Toronto Raptors","Malachi Flynn",1,19,21,16,7,25
0,0,0,0,0,0,0,0,0,"00",0,0,0,0,0,0,1037804,"2023-11-22T00:00:00.000Z",12,FALSE,28,666762,"F",28,28,"Toronto Raptors","Jalen McDaniels",0,0,0,0,0,0
0,0,3,1,1,1,1,0,0,"11",1,2,3,4,0,0,1037804,"2023-11-22T00:00:00.000Z",12,FALSE,28,376,"F",28,28,"Toronto Raptors","Otto Porter Jr.",0,7,7,3,4,7.8
1,0,1,4,2,5,2,4,2,"25",0,1,8,1,1,2,1037804,"2023-11-22T00:00:00.000Z",12,FALSE,28,3089,"",28,28,"Toronto Raptors","Gary Trent Jr.",1,9,10,9,2,11.7
0,0,0,0,0,0,0,0,0,"00",0,0,0,0,0,0,1037804,"2023-11-22T00:00:00.000Z",12,FALSE,28,436,"G-F",28,28,"Toronto Raptors","Garrett Temple",0,0,0,0,0,0
0,0,0,0,0,0,0,0,0,"00",0,0,0,0,0,0,1037804,"2023-11-22T00:00:00.000Z",12,FALSE,28,3547249,"F",28,28,"Toronto Raptors","Precious Achiuwa",0,0,0,0,0,0
0,0,0,0,0,0,0,0,0,"00",0,0,0,0,0,0,1037804,"2023-11-22T00:00:00.000Z",12,FALSE,28,56677805,"G",28,28,"Toronto Raptors","Javon Freeman-Liberty",0,0,0,0,0,0
0,0,0,0,0,0,0,0,0,"00",0,0,0,0,0,0,1037804,"2023-11-22T00:00:00.000Z",12,FALSE,28,38017717,"F",28,28,"Toronto Raptors","Ron Harper Jr.",0,0,0,0,0,0
0,0,0,0,0,0,0,0,0,"00",0,0,0,0,0,0,1037805,"2023-11-22T00:00:00.000Z",11,FALSE,15,357,"G",11,11,"Houston Rockets","Victor Oladipo",0,0,0,0,0,0
0,0,0,0,0,0,0,0,0,"00",0,0,0,0,0,0,1037805,"2023-11-22T00:00:00.000Z",11,FALSE,15,56677809,"F",11,11,"Houston Rockets","Jermaine Samuels Jr.",0,0,0,0,0,0
0,0,0,0,0,0,0,0,0,"00",0,0,0,0,0,0,1037805,"2023-11-22T00:00:00.000Z",11,FALSE,15,56677825,"G-F",11,11,"Houston Rockets","Amen Thompson",0,0,0,0,0,0
0,0,0,0,0,0,0,0,0,"00",0,0,0,0,0,0,1037805,"2023-11-22T00:00:00.000Z",11,FALSE,15,56677831,"F",11,11,"Houston Rockets","Cam Whitmore",0,0,0,0,0,0
0,1,2,3,1,5,2,3,3,"22",0,5,8,2,0,0,1037805,"2023-11-22T00:00:00.000Z",11,FALSE,15,17896067,"F",15,15,"Memphis Grizzlies","Santi Aldama",1,10,10,8,2,13.4
0,1,6,4,0,21,7,12,9,"37",1,4,23,7,1,2,1037805,"2023-11-22T00:00:00.000Z",11,FALSE,15,231,"F-C",15,15,"Memphis Grizzlies","Jaren Jackson Jr.",2,30,30,23,7,35.4
2,2,5,0,0,4,2,2,1,"32",0,0,5,5,1,1,1037805,"2023-11-22T00:00:00.000Z",11,FALSE,15,48,"C",15,15,"Memphis Grizzlies","Bismack Biyombo",3,10,12,7,7,22
4,0,6,6,2,12,6,10,9,"26",1,4,23,7,1,2,1037805,"2023-11-22T00:00:00.000Z",11,FALSE,15,3547287,"G",15,15,"Memphis Grizzlies","Desmond Bane",1,30,34,27,11,38.4
1,0,4,5,0,14,4,5,5,"27",1,4,13,5,1,1,1037805,"2023-11-22T00:00:00.000Z",11,FALSE,15,66,"G-F",11,11,"Houston Rockets","Dillon Brooks",1,18,19,14,6,22.5
2,1,9,4,3,10,6,4,3,"27",0,2,18,9,0,0,1037805,"2023-11-22T00:00:00.000Z",11,FALSE,15,38017684,"F",11,11,"Houston Rockets","Jabari Smith Jr.",1,27,29,20,11,34.8
3,3,6,1,1,9,4,3,2,"32",1,5,11,7,0,2,1037805,"2023-11-22T00:00:00.000Z",11,FALSE,15,17896062,"F-C",11,11,"Houston Rockets","Alperen Sengun",3,18,21,14,10,30.9
4,0,1,13,3,26,13,5,5,"30",1,0,34,2,1,1,1037805,"2023-11-22T00:00:00.000Z",11,FALSE,15,17895966,"G",11,11,"Houston Rockets","Jalen Green",1,36,40,38,6,44.4
4,0,6,8,4,12,5,3,2,"39",1,0,16,7,2,1,1037805,"2023-11-22T00:00:00.000Z",11,FALSE,15,458,"G",11,11,"Houston Rockets","Fred VanVleet",2,23,27,20,11,35.4
0,0,0,1,0,1,0,0,0,"04",0,0,0,0,0,0,1037805,"2023-11-22T00:00:00.000Z",11,FALSE,15,75,"G-F",11,11,"Houston Rockets","Reggie Bullock",0,0,0,0,0,0
2,1,4,3,2,4,2,0,0,"19",1,2,6,5,1,1,1037805,"2023-11-22T00:00:00.000Z",11,FALSE,15,38017695,"F",11,11,"Houston Rockets","Tari Eason",2,11,13,8,7,20
0,1,1,1,0,3,0,0,0,"12",0,1,0,1,0,0,1037805,"2023-11-22T00:00:00.000Z",11,FALSE,15,188,"F",11,11,"Houston Rockets","Jeff Green",1,1,1,0,1,4.2
2,0,3,4,1,6,3,0,0,"17",0,3,7,3,0,0,1037805,"2023-11-22T00:00:00.000Z",11,FALSE,15,213,"G",11,11,"Houston Rockets","Aaron Holiday",0,10,12,9,5,13.6
0,0,1,0,0,1,1,0,0,"04",0,0,2,1,0,0,1037805,"2023-11-22T00:00:00.000Z",11,FALSE,15,19465326,"C",11,11,"Houston Rockets","Jock Landale",0,3,3,2,1,3.2
4,0,8,3,0,4,1,0,0,"26",1,4,2,9,1,0,1037805,"2023-11-22T00:00:00.000Z",11,FALSE,15,3547301,"F",11,11,"Houston Rockets","Jae'Sean Tate",1,11,15,6,13,21.8
0,0,0,0,0,0,0,0,0,"00",0,0,0,0,0,0,1037805,"2023-11-22T00:00:00.000Z",11,FALSE,15,296,"C",11,11,"Houston Rockets","Boban Marjanovic",0,0,0,0,0,0
0,0,0,0,0,2,1,0,0,"03",0,1,2,0,0,0,1037805,"2023-11-22T00:00:00.000Z",11,FALSE,15,47738533,"G",11,11,"Houston Rockets","Jeenathan Williams",0,2,2,2,0,2
0,0,0,0,0,0,0,0,0,"00",0,0,0,0,0,0,1037805,"2023-11-22T00:00:00.000Z",11,FALSE,15,3547281,"G-F",11,11,"Houston Rockets","Nate Hinton",0,0,0,0,0,0
4,0,0,4,1,6,2,0,0,"24",1,1,5,1,0,0,1037805,"2023-11-22T00:00:00.000Z",11,FALSE,15,48248287,"G",15,15,"Memphis Grizzlies","Jacob Gilyard",0,6,10,9,5,12.2
1,0,6,1,0,7,2,0,0,"22",0,0,4,6,0,2,1037805,"2023-11-22T00:00:00.000Z",11,FALSE,15,38017729,"F",15,15,"Memphis Grizzlies","David Roddy",0,10,11,5,7,10.7
2,0,1,2,1,3,1,4,4,"16",0,0,7,1,0,2,1037805,"2023-11-22T00:00:00.000Z",11,FALSE,15,401,"G",15,15,"Memphis Grizzlies","Derrick Rose",0,8,10,9,3,9.2
2,2,6,4,0,7,0,0,0,"29",5,3,0,11,0,0,1037805,"2023-11-22T00:00:00.000Z",11,FALSE,15,666703,"G-F",15,15,"Memphis Grizzlies","John Konchar",2,11,13,2,13,22.2
0,0,2,5,2,10,4,3,3,"20",0,2,13,2,0,0,1037805,"2023-11-22T00:00:00.000Z",11,FALSE,15,17896027,"G-F",15,15,"Memphis Grizzlies","Ziaire Williams",0,15,15,13,2,15.4
0,0,2,1,0,3,0,0,0,"04",1,0,0,3,0,0,1037805,"2023-11-22T00:00:00.000Z",11,FALSE,15,56677830,"F",15,15,"Memphis Grizzlies","GG Jackson",0,3,3,0,3,3.6
1,0,0,1,0,4,1,1,1,"04",1,0,3,1,0,0,1037805,"2023-11-22T00:00:00.000Z",11,FALSE,15,38017732,"F",15,15,"Memphis Grizzlies","Kenneth Lofton Jr.",0,4,5,4,2,5.7
0,1,1,1,0,1,0,0,0,"04",0,0,0,1,0,0,1037805,"2023-11-22T00:00:00.000Z",11,FALSE,15,38017731,"G",15,15,"Memphis Grizzlies","Vince Williams Jr.",1,1,1,0,1,4.2
0,0,0,0,0,0,0,0,0,"00",0,0,0,0,0,0,1037805,"2023-11-22T00:00:00.000Z",11,FALSE,15,3,"C",15,15,"Memphis Grizzlies","Steven Adams",0,0,0,0,0,0
0,0,0,0,0,0,0,0,0,"00",0,0,0,0,0,0,1037805,"2023-11-22T00:00:00.000Z",11,FALSE,15,666505,"F",15,15,"Memphis Grizzlies","Brandon Clarke",0,0,0,0,0,0
0,0,0,0,0,0,0,0,0,"00",0,0,0,0,0,0,1037805,"2023-11-22T00:00:00.000Z",11,FALSE,15,666786,"G",15,15,"Memphis Grizzlies","Ja Morant",0,0,0,0,0,0
0,0,0,0,0,0,0,0,0,"00",0,0,0,0,0,0,1037805,"2023-11-22T00:00:00.000Z",11,FALSE,15,420,"G",15,15,"Memphis Grizzlies","Marcus Smart",0,0,0,0,0,0
0,0,0,0,0,0,0,0,0,"00",0,0,0,0,0,0,1037805,"2023-11-22T00:00:00.000Z",11,FALSE,15,3547285,"F",15,15,"Memphis Grizzlies","Xavier Tillman",0,0,0,0,0,0
0,0,0,0,0,0,0,0,0,"00",0,0,0,0,0,0,1037805,"2023-11-22T00:00:00.000Z",11,FALSE,15,254,"G",15,15,"Memphis Grizzlies","Luke Kennard",0,0,0,0,0,0
0,0,0,0,0,0,0,0,0,"00",0,0,0,0,0,0,1037805,"2023-11-22T00:00:00.000Z",11,FALSE,15,38017728,"F",15,15,"Memphis Grizzlies","Jake LaRavia",0,0,0,0,0,0
4,1,4,4,1,6,3,0,0,"29",2,4,7,6,0,0,1037806,"2023-11-22T00:00:00.000Z",18,FALSE,23,666400,"G",18,18,"Minnesota Timberwolves","Nickeil Alexander-Walker",1,13,17,11,10,23.2
3,2,11,2,1,19,9,5,4,"36",0,5,23,11,2,4,1037806,"2023-11-22T00:00:00.000Z",18,FALSE,23,447,"C",18,18,"Minnesota Timberwolves","Karl-Anthony Towns",4,34,37,26,14,48.7
3,3,8,0,0,8,6,2,1,"31",3,3,13,11,0,2,1037806,"2023-11-22T00:00:00.000Z",18,FALSE,23,176,"C",18,18,"Minnesota Timberwolves","Rudy Gobert",3,24,27,16,14,37.7
6,0,4,9,5,22,11,4,4,"36",2,2,31,6,2,2,1037806,"2023-11-22T00:00:00.000Z",18,FALSE,23,3547238,"G",18,18,"Minnesota Timberwolves","Anthony Edwards",2,37,43,37,12,51.2
8,0,0,2,1,5,2,0,0,"23",0,1,5,0,3,1,1037806,"2023-11-22T00:00:00.000Z",18,FALSE,23,104,"G",18,18,"Minnesota Timberwolves","Mike Conley",3,5,13,13,8,25
3,1,3,0,0,6,3,4,1,"28",1,1,7,4,0,1,1037806,"2023-11-22T00:00:00.000Z",18,FALSE,23,12,"F",18,18,"Minnesota Timberwolves","Kyle Anderson",1,11,14,10,7,18.3
0,0,0,0,0,1,0,0,0,"07",1,0,0,1,0,0,1037806,"2023-11-22T00:00:00.000Z",18,FALSE,23,68,"F",18,18,"Minnesota Timberwolves","Troy Brown Jr.",0,1,1,0,1,1.2
0,0,1,1,0,1,0,2,1,"02",0,0,1,1,0,1,1037806,"2023-11-22T00:00:00.000Z",18,FALSE,23,17896056,"C",18,18,"Minnesota Timberwolves","Luka Garza",0,2,2,1,1,1.2
0,0,3,0,0,0,0,0,0,"02",0,1,0,3,0,0,1037806,"2023-11-22T00:00:00.000Z",18,FALSE,23,56677782,"F",18,18,"Minnesota Timberwolves","Leonard Miller",0,3,3,0,3,3.6
1,0,0,3,1,7,3,6,5,"21",0,2,12,0,0,0,1037806,"2023-11-22T00:00:00.000Z",18,FALSE,23,320,"G",18,18,"Minnesota Timberwolves","Shake Milton",0,12,13,13,1,13.5
0,0,0,0,0,0,0,0,0,"02",0,1,0,0,0,0,1037806,"2023-11-22T00:00:00.000Z",18,FALSE,23,38017715,"F",18,18,"Minnesota Timberwolves","Josh Minott",0,0,0,0,0,0
0,0,0,1,0,1,0,0,0,"02",0,0,0,0,0,0,1037806,"2023-11-22T00:00:00.000Z",18,FALSE,23,38017700,"G",18,18,"Minnesota Timberwolves","Wendell Moore Jr.",0,0,0,0,0,0
0,0,3,4,1,13,6,1,0,"21",1,1,13,4,3,0,1037806,"2023-11-22T00:00:00.000Z",18,FALSE,23,667378,"F-C",18,18,"Minnesota Timberwolves","Naz Reid",3,17,17,13,4,26.8
0,0,0,0,0,0,0,0,0,"00",0,0,0,0,0,0,1037806,"2023-11-22T00:00:00.000Z",18,FALSE,23,56677851,"G",18,18,"Minnesota Timberwolves","Jaylen Clark",0,0,0,0,0,0
0,0,0,0,0,0,0,0,0,"00",0,0,0,0,0,0,1037806,"2023-11-22T00:00:00.000Z",18,FALSE,23,3547259,"F",18,18,"Minnesota Timberwolves","Jaden McDaniels",0,0,0,0,0,0
0,0,0,0,0,0,0,0,0,"00",0,0,0,0,0,0,1037806,"2023-11-22T00:00:00.000Z",18,FALSE,23,666767,"G",18,18,"Minnesota Timberwolves","Jordan McLaughlin",0,0,0,0,0,0
0,0,0,0,0,0,0,0,0,"00",0,0,0,0,0,0,1037806,"2023-11-22T00:00:00.000Z",18,FALSE,23,17895968,"F",18,18,"Minnesota Timberwolves","Daishen Nix",0,0,0,0,0,0
2,1,5,3,0,11,4,8,7,"32",1,1,15,6,0,1,1037806,"2023-11-22T00:00:00.000Z",18,FALSE,23,200,"F",23,23,"Philadelphia 76ers","Tobias Harris",1,21,23,17,8,27.2
0,1,3,4,2,4,2,0,0,"24",0,2,6,3,0,1,1037806,"2023-11-22T00:00:00.000Z",18,FALSE,23,33,"F-G",23,23,"Philadelphia 76ers","Nicolas Batum",1,9,9,6,3,11.6
2,2,2,5,3,12,6,1,1,"16",2,5,16,4,1,2,1037806,"2023-11-22T00:00:00.000Z",18,FALSE,23,328,"F",23,23,"Philadelphia 76ers","Marcus Morris",3,20,22,18,6,30.8
3,1,5,5,1,11,3,9,9,"30",1,2,16,6,0,1,1037806,"2023-11-22T00:00:00.000Z",18,FALSE,23,313,"G",23,23,"Philadelphia 76ers","De'Anthony Melton",1,22,25,19,9,29.7
8,1,3,5,0,19,7,4,2,"34",2,0,16,5,0,3,1037806,"2023-11-22T00:00:00.000Z",18,FALSE,23,3547254,"G",23,23,"Philadelphia 76ers","Tyrese Maxey",1,21,29,24,13,34
0,0,1,1,0,2,1,2,2,"06",1,0,4,2,0,0,1037806,"2023-11-22T00:00:00.000Z",18,FALSE,23,28,"C",23,23,"Philadelphia 76ers","Mo Bamba",0,6,6,4,2,6.4
2,0,2,3,0,5,1,2,1,"17",0,2,3,2,3,1,1037806,"2023-11-22T00:00:00.000Z",18,FALSE,23,2175,"",23,23,"Philadelphia 76ers","Danuel House Jr.",3,5,7,5,4,16.4
1,4,3,0,0,9,5,0,0,"26",6,4,10,9,2,1,1037806,"2023-11-22T00:00:00.000Z",18,FALSE,23,3547270,"F",23,23,"Philadelphia 76ers","Paul Reed",6,19,20,11,10,39.3
2,0,0,1,0,2,1,0,0,"16",0,2,2,0,0,2,1037806,"2023-11-22T00:00:00.000Z",18,FALSE,23,45,"G",23,23,"Philadelphia 76ers","Patrick Beverley",0,2,4,4,2,3
0,2,5,1,0,4,2,2,1,"20",1,2,5,6,0,0,1037806,"2023-11-22T00:00:00.000Z",18,FALSE,23,108,"F",23,23,"Philadelphia 76ers","Robert Covington",2,11,11,5,6,18.2
0,0,1,2,1,2,1,0,0,"05",1,0,3,2,1,0,1037806,"2023-11-22T00:00:00.000Z",18,FALSE,23,260,"G-F",23,23,"Philadelphia 76ers","Furkan Korkmaz",1,5,5,3,2,8.4
0,0,1,0,0,2,1,2,1,"06",0,2,3,1,0,0,1037806,"2023-11-22T00:00:00.000Z",18,FALSE,23,3547294,"F",23,23,"Philadelphia 76ers","Kenyon Martin Jr.",0,4,4,3,1,4.2
1,0,1,2,0,4,0,0,0,"08",2,1,0,3,1,2,1037806,"2023-11-22T00:00:00.000Z",18,FALSE,23,17896025,"G",23,23,"Philadelphia 76ers","Jaden Springer",1,3,4,1,4,6.1
0,0,0,0,0,0,0,0,0,"00",0,0,0,0,0,0,1037806,"2023-11-22T00:00:00.000Z",18,FALSE,23,56913527,"G",23,23,"Philadelphia 76ers","Ricky Council IV",0,0,0,0,0,0
0,0,0,0,0,0,0,0,0,"00",0,0,0,0,0,0,1037806,"2023-11-22T00:00:00.000Z",18,FALSE,23,145,"F-C",23,23,"Philadelphia 76ers","Joel Embiid",0,0,0,0,0,0
0,0,0,0,0,0,0,0,0,"00",0,0,0,0,0,0,1037806,"2023-11-22T00:00:00.000Z",18,FALSE,23,360,"F",23,23,"Philadelphia 76ers","Kelly Oubre Jr.",0,0,0,0,0,0
0,0,0,0,0,0,0,0,0,"00",0,0,0,0,0,0,1037806,"2023-11-22T00:00:00.000Z",18,FALSE,23,17554001,"G",23,23,"Philadelphia 76ers","Javonte Smart",0,0,0,0,0,0
0,0,0,0,0,0,0,0,0,"00",0,0,0,0,0,0,1037806,"2023-11-22T00:00:00.000Z",18,FALSE,23,56677788,"G",23,23,"Philadelphia 76ers","Terquavion Smith",0,0,0,0,0,0
3,0,4,4,1,18,9,4,4,"29",0,5,23,4,1,2,1037807,"2023-11-22T00:00:00.000Z",19,FALSE,26,227,"F",19,19,"New Orleans Pelicans","Brandon Ingram",1,27,30,26,7,33.3
6,0,4,0,0,16,10,7,5,"35",1,3,25,5,0,2,1037807,"2023-11-22T00:00:00.000Z",19,FALSE,26,666969,"F",19,19,"New Orleans Pelicans","Zion Williamson",0,30,36,31,11,38
2,0,8,0,0,9,6,4,3,"28",3,5,15,11,0,1,1037807,"2023-11-22T00:00:00.000Z",19,FALSE,26,455,"C",19,19,"New Orleans Pelicans","Jonas Valanciunas",0,26,28,17,13,30.2
3,1,5,4,0,6,1,6,5,"39",0,4,7,5,3,2,1037807,"2023-11-22T00:00:00.000Z",19,FALSE,26,17896024,"F",19,19,"New Orleans Pelicans","Herbert Jones",4,12,15,10,8,27.5
0,0,4,5,0,9,2,4,4,"29",3,2,8,7,1,0,1037807,"2023-11-22T00:00:00.000Z",19,FALSE,26,38017677,"G",19,19,"New Orleans Pelicans","Dyson Daniels",1,15,15,8,7,19.4
2,0,1,6,2,9,4,4,0,"19",0,2,10,1,3,1,1037807,"2023-11-22T00:00:00.000Z",19,FALSE,26,17896097,"G",19,19,"New Orleans Pelicans","Jose Alvarado",3,11,13,12,3,22.2
3,0,1,8,2,9,3,5,5,"21",1,3,13,2,0,0,1037807,"2023-11-22T00:00:00.000Z",19,FALSE,26,56677837,"G",19,19,"New Orleans Pelicans","Jordan Hawkins",0,15,18,16,5,19.9
0,0,0,0,0,0,0,0,0,"00",0,0,0,0,0,0,1037807,"2023-11-22T00:00:00.000Z",19,FALSE,26,3547260,"G",19,19,"New Orleans Pelicans","Kira Lewis Jr.",0,0,0,0,0,0
4,1,4,2,2,5,4,3,2,"20",2,0,12,6,1,1,1037807,"2023-11-22T00:00:00.000Z",19,FALSE,26,3547293,"F",19,19,"New Orleans Pelicans","Naji Marshall",2,18,22,16,10,30.2
0,0,8,7,3,8,4,1,1,"27",0,5,12,8,0,3,1037807,"2023-11-22T00:00:00.000Z",19,FALSE,26,290,"F",26,26,"Sacramento Kings","Trey Lyles",0,20,20,12,8,18.6
0,0,1,0,0,0,0,2,0,"05",0,0,0,1,0,2,1037807,"2023-11-22T00:00:00.000Z",19,FALSE,26,306,"C",26,26,"Sacramento Kings","JaVale McGee",0,1,1,0,1,-0.8
2,0,1,0,0,0,0,2,2,"10",0,0,2,1,0,0,1037807,"2023-11-22T00:00:00.000Z",19,FALSE,26,17553994,"G",26,26,"Sacramento Kings","Davion Mitchell",0,3,5,4,3,6.2
5,0,4,6,1,8,2,5,5,"26",0,2,10,4,2,2,1037807,"2023-11-22T00:00:00.000Z",19,FALSE,26,324,"G",26,26,"Sacramento Kings","Malik Monk",2,14,19,15,9,26.3
0,0,0,0,0,0,0,0,0,"00",0,0,0,0,0,0,1037807,"2023-11-22T00:00:00.000Z",19,FALSE,26,17895941,"C",26,26,"Sacramento Kings","Filip Petrusev",0,0,0,0,0,0
0,0,0,0,0,0,0,0,0,"00",0,0,0,0,0,0,1037807,"2023-11-22T00:00:00.000Z",19,FALSE,26,56677862,"F",26,26,"Sacramento Kings","Jalen Slawson",0,0,0,0,0,0
0,0,2,4,1,5,1,0,0,"10",0,0,3,2,0,2,1037807,"2023-11-22T00:00:00.000Z",19,FALSE,26,4197162,"F",26,26,"Sacramento Kings","Aleksandar Vezenkov",0,5,5,3,2,3.4
0,0,0,0,0,0,0,0,0,"00",0,0,0,0,0,0,1037807,"2023-11-22T00:00:00.000Z",19,FALSE,26,38017714,"G",26,26,"Sacramento Kings","Keon Ellis",0,0,0,0,0,0
0,0,0,0,0,0,0,0,0,"00",0,0,0,0,0,0,1037807,"2023-11-22T00:00:00.000Z",19,FALSE,26,17895990,"G",26,26,"Sacramento Kings","Jordan Ford",0,0,0,0,0,0
0,0,0,0,0,0,0,0,0,"00",0,0,0,0,0,0,1037807,"2023-11-22T00:00:00.000Z",19,FALSE,26,273,"C",26,26,"Sacramento Kings","Alex Len",0,0,0,0,0,0
0,0,0,0,0,0,0,0,0,"00",0,0,0,0,0,0,1037807,"2023-11-22T00:00:00.000Z",19,FALSE,26,38017688,"F",26,26,"Sacramento Kings","Keegan Murray",0,0,0,0,0,0
0,0,3,1,0,4,2,0,0,"12",1,2,4,4,1,1,1037807,"2023-11-22T00:00:00.000Z",19,FALSE,26,340,"F",19,19,"New Orleans Pelicans","Larry Nance Jr.",1,8,8,4,4,10.8
0,0,0,0,0,0,0,0,0,"00",0,0,0,0,0,0,1037807,"2023-11-22T00:00:00.000Z",19,FALSE,26,17896021,"F",19,19,"New Orleans Pelicans","Jeremiah Robinson-Earl",0,0,0,0,0,0
0,0,1,0,0,2,0,0,0,"08",2,2,0,3,0,0,1037807,"2023-11-22T00:00:00.000Z",19,FALSE,26,491,"C",19,19,"New Orleans Pelicans","Cody Zeller",0,3,3,0,3,3.6
0,0,0,0,0,0,0,0,0,"00",0,0,0,0,0,0,1037807,"2023-11-22T00:00:00.000Z",19,FALSE,26,38017663,"F",19,19,"New Orleans Pelicans","E.J. Liddell",0,0,0,0,0,0
0,0,0,0,0,0,0,0,0,"00",0,0,0,0,0,0,1037807,"2023-11-22T00:00:00.000Z",19,FALSE,26,303,"G",19,19,"New Orleans Pelicans","CJ McCollum",0,0,0,0,0,0
0,0,0,0,0,0,0,0,0,"00",0,0,0,0,0,0,1037807,"2023-11-22T00:00:00.000Z",19,FALSE,26,18677986,"F",19,19,"New Orleans Pelicans","Trey Murphy III",0,0,0,0,0,0
0,0,0,0,0,0,0,0,0,"00",0,0,0,0,0,0,1037807,"2023-11-22T00:00:00.000Z",19,FALSE,26,17896017,"F",19,19,"New Orleans Pelicans","Matt Ryan",0,0,0,0,0,0
0,0,0,0,0,0,0,0,0,"00",0,0,0,0,0,0,1037807,"2023-11-22T00:00:00.000Z",19,FALSE,26,38017726,"G",19,19,"New Orleans Pelicans","Dereon Seabron",0,0,0,0,0,0
2,0,7,7,2,10,2,2,2,"27",0,3,8,7,0,0,1037807,"2023-11-22T00:00:00.000Z",19,FALSE,26,221,"G",26,26,"Sacramento Kings","Kevin Huerter",0,15,17,10,9,19.4
0,0,1,9,4,13,6,6,6,"41",2,2,22,3,0,0,1037807,"2023-11-22T00:00:00.000Z",19,FALSE,26,30,"F",26,26,"Sacramento Kings","Harrison Barnes",0,25,25,22,3,25.6
6,1,7,0,0,11,8,10,7,"35",2,3,23,9,0,3,1037807,"2023-11-22T00:00:00.000Z",19,FALSE,26,406,"F",26,26,"Sacramento Kings","Domantas Sabonis",1,32,38,29,15,42.8
2,0,1,3,2,3,2,0,0,"20",0,5,6,1,0,1,1037807,"2023-11-22T00:00:00.000Z",19,FALSE,26,17896030,"G",26,26,"Sacramento Kings","Chris Duarte",0,7,9,8,3,9.2
5,0,2,7,2,17,9,7,6,"38",0,5,26,2,1,2,1037807,"2023-11-22T00:00:00.000Z",19,FALSE,26,161,"G",26,26,"Sacramento Kings","De'Aaron Fox",1,28,33,31,7,36.9
0,0,0,1,0,1,0,0,0,"01",0,0,0,0,0,0,1037807,"2023-11-22T00:00:00.000Z",19,FALSE,26,17896044,"F",26,26,"Sacramento Kings","Kessler Edwards",0,0,0,0,0,0
0,0,0,0,0,0,0,0,0,"00",0,0,0,0,0,0,1037807,"2023-11-22T00:00:00.000Z",19,FALSE,26,56677845,"G",26,26,"Sacramento Kings","Colby Jones",0,0,0,0,0,0
2,2,2,4,0,6,1,0,0,"27",0,6,2,2,0,2,1037808,"2023-11-22T00:00:00.000Z",21,FALSE,5,666541,"G",21,21,"Oklahoma City Thunder","Luguentz Dort",2,4,6,4,4,11.4
0,1,2,2,1,3,2,0,0,"24",1,1,5,3,0,1,1037808,"2023-11-22T00:00:00.000Z",21,FALSE,5,56677833,"G",21,21,"Oklahoma City Thunder","Cason Wallace",1,8,8,5,3,10.6
2,4,8,3,0,11,5,11,8,"32",5,3,18,13,1,2,1037808,"2023-11-22T00:00:00.000Z",21,FALSE,5,38017685,"C-F",21,21,"Oklahoma City Thunder","Chet Holmgren",5,31,33,20,15,49.6
2,0,5,3,1,13,4,2,1,"29",1,1,10,6,2,2,1037808,"2023-11-22T00:00:00.000Z",21,FALSE,5,17896065,"G",21,21,"Oklahoma City Thunder","Josh Giddey",2,16,18,12,8,24.2
12,3,4,3,1,19,11,18,17,"37",1,2,40,5,1,2,1037808,"2023-11-22T00:00:00.000Z",21,FALSE,5,175,"G",21,21,"Oklahoma City Thunder","Shai Gilgeous-Alexander",4,45,57,52,17,74
0,0,0,0,0,0,0,0,0,"00",0,0,0,0,0,0,1037808,"2023-11-22T00:00:00.000Z",21,FALSE,5,44,"F",21,21,"Oklahoma City Thunder","Davis Bertans",0,0,0,0,0,0
0,0,0,0,0,0,0,0,0,"00",0,0,0,0,0,0,1037808,"2023-11-22T00:00:00.000Z",21,FALSE,5,38017716,"F",21,21,"Oklahoma City Thunder","Ousmane Dieng",0,0,0,0,0,0
0,1,1,7,5,9,6,3,3,"27",0,0,20,1,0,0,1037808,"2023-11-22T00:00:00.000Z",21,FALSE,5,3547272,"G",21,21,"Oklahoma City Thunder","Isaiah Joe",1,21,21,20,1,24.2
0,0,0,0,0,0,0,0,0,"00",0,0,0,0,0,0,1037808,"2023-11-22T00:00:00.000Z",21,FALSE,5,17896036,"G",21,21,"Oklahoma City Thunder","Tre Mann",0,0,0,0,0,0
2,0,0,3,0,4,1,0,0,"11",0,0,2,0,0,2,1037808,"2023-11-22T00:00:00.000Z",21,FALSE,5,4197029,"G",21,21,"Oklahoma City Thunder","Vasilije Micic",0,2,4,4,2,3
0,0,0,0,0,0,0,0,0,"00",0,0,0,0,0,0,1037808,"2023-11-22T00:00:00.000Z",21,FALSE,5,3547271,"C",21,21,"Oklahoma City Thunder","Aleksej Pokusevski",0,0,0,0,0,0
1,1,1,0,0,0,0,0,0,"05",1,0,0,2,0,0,1037808,"2023-11-22T00:00:00.000Z",21,FALSE,5,27924547,"F",21,21,"Oklahoma City Thunder","Lindy Waters III",1,2,3,1,3,6.9
1,0,4,0,0,2,2,2,2,"11",0,1,6,4,0,1,1037808,"2023-11-22T00:00:00.000Z",21,FALSE,5,17896078,"G",21,21,"Oklahoma City Thunder","Aaron Wiggins",0,10,11,7,5,11.3
0,0,3,1,0,2,0,0,0,"14",1,3,0,4,0,0,1037808,"2023-11-22T00:00:00.000Z",21,FALSE,5,38017706,"F",21,21,"Oklahoma City Thunder","Jaylin Williams",0,4,4,0,4,4.8
2,0,4,3,3,6,5,2,0,"23",1,0,13,5,0,0,1037808,"2023-11-22T00:00:00.000Z",21,FALSE,5,480,"G-F",21,21,"Oklahoma City Thunder","Kenrich Williams",0,18,20,15,7,22
0,0,0,0,0,0,0,0,0,"00",0,0,0,0,0,0,1037808,"2023-11-22T00:00:00.000Z",21,FALSE,5,56677853,"F",21,21,"Oklahoma City Thunder","Keyontae Johnson",0,0,0,0,0,0
0,0,0,0,0,0,0,0,0,"00",0,0,0,0,0,0,1037808,"2023-11-22T00:00:00.000Z",21,FALSE,5,24572055,"C",21,21,"Oklahoma City Thunder","Olivier Sarr",0,0,0,0,0,0
0,0,0,0,0,0,0,0,0,"00",0,0,0,0,0,0,1037808,"2023-11-22T00:00:00.000Z",21,FALSE,5,38017703,"G-F",21,21,"Oklahoma City Thunder","Jalen Williams",0,0,0,0,0,0
6,1,1,2,0,17,6,13,13,"36",1,3,25,2,2,1,1037808,"2023-11-22T00:00:00.000Z",21,FALSE,5,125,"G",5,5,"Chicago Bulls","DeMar DeRozan",3,27,33,31,8,44.4
1,0,5,6,2,12,5,0,0,"27",1,1,12,6,1,0,1037808,"2023-11-22T00:00:00.000Z",21,FALSE,5,89,"G",5,5,"Chicago Bulls","Alex Caruso",1,18,19,13,7,23.7
3,0,7,5,2,13,6,2,2,"37",5,4,16,12,2,1,1037808,"2023-11-22T00:00:00.000Z",21,FALSE,5,460,"C",5,5,"Chicago Bulls","Nikola Vucevic",2,28,31,19,15,39.9
0,0,0,0,0,0,0,0,0,"00",0,0,0,0,0,0,1037808,"2023-11-22T00:00:00.000Z",21,FALSE,5,27,"G",5,5,"Chicago Bulls","Lonzo Ball",0,0,0,0,0,0
2,0,0,6,1,7,1,0,0,"19",0,2,3,0,0,0,1037808,"2023-11-22T00:00:00.000Z",21,FALSE,5,87,"G",5,5,"Chicago Bulls","Jevon Carter",0,3,5,5,2,6
0,0,3,3,0,3,0,0,0,"15",0,4,0,3,0,1,1037808,"2023-11-22T00:00:00.000Z",21,FALSE,5,110,"F",5,5,"Chicago Bulls","Torrey Craig",0,3,3,0,3,2.6
2,1,2,5,3,7,4,0,0,"21",0,4,11,2,1,2,1037808,"2023-11-22T00:00:00.000Z",21,FALSE,5,17895983,"G",5,5,"Chicago Bulls","Ayo Dosunmu",2,13,15,13,4,20.4
1,0,4,0,0,3,1,0,0,"11",1,2,2,5,0,0,1037808,"2023-11-22T00:00:00.000Z",21,FALSE,5,137,"C",5,5,"Chicago Bulls","Andre Drummond",0,7,8,3,6,9.5
0,0,0,0,0,0,0,0,0,"00",0,0,0,0,0,0,1037808,"2023-11-22T00:00:00.000Z",21,FALSE,5,268,"G",5,5,"Chicago Bulls","Zach LaVine",0,0,0,0,0,0
0,0,0,0,0,0,0,0,0,"00",0,0,0,0,0,0,1037808,"2023-11-22T00:00:00.000Z",21,FALSE,5,17896116,"G",5,5,"Chicago Bulls","Terry Taylor",0,0,0,0,0,0
0,0,0,0,0,0,0,0,0,"00",0,0,0,0,0,0,1037808,"2023-11-22T00:00:00.000Z",21,FALSE,5,56677874,"F",5,5,"Chicago Bulls","Onuralp Bitim",0,0,0,0,0,0
0,0,0,0,0,0,0,0,0,"00",0,0,0,0,0,0,1037808,"2023-11-22T00:00:00.000Z",21,FALSE,5,45969255,"F",5,5,"Chicago Bulls","Justin Lewis",0,0,0,0,0,0
0,0,0,0,0,0,0,0,0,"00",0,0,0,0,0,0,1037808,"2023-11-22T00:00:00.000Z",21,FALSE,5,56677857,"F",5,5,"Chicago Bulls","Julian Phillips",0,0,0,0,0,0
0,0,0,0,0,0,0,0,0,"00",0,0,0,0,0,0,1037808,"2023-11-22T00:00:00.000Z",21,FALSE,5,56677860,"F",5,5,"Chicago Bulls","Adama Sanogo",0,0,0,0,0,0
0,0,0,0,0,0,0,0,0,"00",0,0,0,0,0,0,1037808,"2023-11-22T00:00:00.000Z",21,FALSE,5,38017719,"F",5,5,"Chicago Bulls","Dalen Terry",0,0,0,0,0,0
2,0,4,5,2,9,3,2,2,"37",3,1,10,7,0,2,1037808,"2023-11-22T00:00:00.000Z",21,FALSE,5,3547248,"F",5,5,"Chicago Bulls","Patrick Williams",0,17,19,12,9,19.4
5,0,1,12,7,17,8,0,0,"37",0,5,23,1,1,3,1037808,"2023-11-22T00:00:00.000Z",21,FALSE,5,666956,"G",5,5,"Chicago Bulls","Coby White",1,24,29,28,6,31.7
6,1,1,8,2,13,5,3,3,"36",2,4,15,3,0,0,1037809,"2023-11-22T00:00:00.000Z",27,FALSE,13,666682,"F",27,27,"San Antonio Spurs","Keldon Johnson",1,18,24,21,9,30.6
3,3,13,2,1,13,7,7,7,"33",2,2,22,15,1,2,1037809,"2023-11-22T00:00:00.000Z",27,FALSE,13,56677822,"F-C",27,27,"San Antonio Spurs","Victor Wembanyama",4,37,40,25,18,54.5
3,1,7,5,2,13,6,2,2,"28",2,6,16,9,0,1,1037809,"2023-11-22T00:00:00.000Z",27,FALSE,13,102,"F-C",27,27,"San Antonio Spurs","Zach Collins",1,25,28,19,12,33.3
1,0,0,3,0,6,0,0,0,"21",1,0,0,1,0,0,1037809,"2023-11-22T00:00:00.000Z",27,FALSE,13,38017692,"F",27,27,"San Antonio Spurs","Malaki Branham",0,1,2,1,2,2.7
7,0,3,5,2,15,6,6,5,"31",2,3,19,5,0,1,1037809,"2023-11-22T00:00:00.000Z",27,FALSE,13,38017699,"F",27,27,"San Antonio Spurs","Jeremy Sochan",0,24,31,26,12,34.5
0,0,2,0,0,1,0,0,0,"09",0,1,0,2,1,0,1037809,"2023-11-22T00:00:00.000Z",27,FALSE,13,38017730,"F",27,27,"San Antonio Spurs","Dominick Barlow",1,2,2,0,2,5.4
0,0,0,0,0,0,0,0,0,"02",0,0,0,0,0,3,1037809,"2023-11-22T00:00:00.000Z",27,FALSE,13,17895854,"G",27,27,"San Antonio Spurs","Charles Bassey",0,0,0,0,0,-3
0,0,0,0,0,0,0,0,0,"00",0,0,0,0,0,0,1037809,"2023-11-22T00:00:00.000Z",27,FALSE,13,38017649,"F",27,27,"San Antonio Spurs","Julian Champagnie",0,0,0,0,0,0
0,0,0,0,0,0,0,0,0,"00",0,0,0,0,0,0,1037809,"2023-11-22T00:00:00.000Z",27,FALSE,13,180,"G",27,27,"San Antonio Spurs","Devonte' Graham",0,0,0,0,0,0
1,0,2,2,0,7,2,0,0,"20",0,1,4,2,3,1,1037809,"2023-11-22T00:00:00.000Z",27,FALSE,13,3547274,"G",27,27,"San Antonio Spurs","Tre Jones",3,6,7,5,3,15.9
0,0,0,0,0,0,0,0,0,"00",0,0,0,0,0,0,1037809,"2023-11-22T00:00:00.000Z",27,FALSE,13,17896059,"F",27,27,"San Antonio Spurs","Sandro Mamukelashvili",0,0,0,0,0,0
1,1,2,2,1,2,1,0,0,"14",0,2,3,2,0,3,1037809,"2023-11-22T00:00:00.000Z",27,FALSE,13,305,"F",27,27,"San Antonio Spurs","Doug McDermott",1,5,6,4,3,6.9
0,0,1,3,1,6,2,0,0,"19",0,3,5,1,2,0,1037809,"2023-11-22T00:00:00.000Z",27,FALSE,13,359,"F",27,27,"San Antonio Spurs","Cedi Osman",2,6,6,5,1,12.2
4,0,3,8,2,15,6,5,4,"27",1,2,18,4,1,2,1037809,"2023-11-22T00:00:00.000Z",27,FALSE,13,3547246,"G-F",27,27,"San Antonio Spurs","Devin Vassell",1,22,26,22,8,29.8
0,0,0,0,0,0,0,0,0,"00",0,0,0,0,0,0,1037809,"2023-11-22T00:00:00.000Z",27,FALSE,13,17896051,"G",13,13,"LA Clippers","Joshua Primo",0,0,0,0,0,0
0,0,0,0,0,0,0,0,0,"00",0,0,0,0,0,0,1037809,"2023-11-22T00:00:00.000Z",27,FALSE,13,38017693,"G",27,27,"San Antonio Spurs","Blake Wesley",0,0,0,0,0,0
0,0,0,0,0,0,0,0,0,"00",0,0,0,0,0,0,1037809,"2023-11-22T00:00:00.000Z",27,FALSE,13,56677865,"C",27,27,"San Antonio Spurs","Charles Bediako",0,0,0,0,0,0
0,0,0,0,0,0,0,0,0,"00",0,0,0,0,0,0,1037809,"2023-11-22T00:00:00.000Z",27,FALSE,13,56677817,"G",27,27,"San Antonio Spurs","Sidy Cissoko",0,0,0,0,0,0
0,0,0,0,0,0,0,0,0,"00",0,0,0,0,0,0,1037809,"2023-11-22T00:00:00.000Z",27,FALSE,13,56677870,"G",27,27,"San Antonio Spurs","Sir'Jabari Rice",0,0,0,0,0,0
4,0,4,6,2,17,10,4,4,"36",0,3,26,4,2,1,1037809,"2023-11-22T00:00:00.000Z",27,FALSE,13,274,"F",13,13,"LA Clippers","Kawhi Leonard",2,30,34,30,8,41.8
3,0,7,12,4,23,8,4,4,"36",1,3,24,8,2,2,1037809,"2023-11-22T00:00:00.000Z",27,FALSE,13,172,"F",13,13,"LA Clippers","Paul George",2,32,35,27,11,42.1
1,0,6,0,0,7,5,2,2,"26",2,2,12,8,0,0,1037809,"2023-11-22T00:00:00.000Z",27,FALSE,13,493,"C",13,13,"LA Clippers","Ivica Zubac",0,20,21,13,9,23.1
1,1,2,3,0,5,2,4,2,"22",0,3,6,2,2,1,1037809,"2023-11-22T00:00:00.000Z",27,FALSE,13,666743,"G",13,13,"LA Clippers","Terance Mann",3,8,9,7,3,17.9
0,0,0,0,0,0,0,0,0,"00",0,0,0,0,0,0,1037809,"2023-11-22T00:00:00.000Z",27,FALSE,13,56677849,"F",13,13,"LA Clippers","Kobe Brown",0,0,0,0,0,0
0,0,2,1,0,3,2,0,0,"10",1,0,4,3,1,0,1037809,"2023-11-22T00:00:00.000Z",27,FALSE,13,666511,"G",13,13,"LA Clippers","Amir Coffey",1,7,7,4,3,10.6
0,0,0,0,0,0,0,0,0,"00",0,0,0,0,0,0,1037809,"2023-11-22T00:00:00.000Z",27,FALSE,13,38017725,"F",13,13,"LA Clippers","Moussa Diabate",0,0,0,0,0,0
0,0,0,0,0,0,0,0,0,"00",0,0,0,0,0,0,1037809,"2023-11-22T00:00:00.000Z",27,FALSE,13,17896031,"G",13,13,"LA Clippers","Nah'Shon Hyland",0,0,0,0,0,0
0,1,1,1,1,4,2,1,0,"14",0,1,5,1,0,2,1037809,"2023-11-22T00:00:00.000Z",27,FALSE,13,380,"F-G",13,13,"LA Clippers","Norman Powell",1,6,6,5,1,7.2
4,0,6,0,0,11,4,0,0,"20",5,2,8,11,0,1,1037809,"2023-11-22T00:00:00.000Z",27,FALSE,13,439,"F",13,13,"LA Clippers","Daniel Theis",0,19,23,12,15,26.2
0,0,0,0,0,0,0,0,0,"13",1,2,0,1,0,1,1037809,"2023-11-22T00:00:00.000Z",27,FALSE,13,450,"F",13,13,"LA Clippers","PJ Tucker",0,1,1,0,1,0.2
7,0,5,1,0,8,3,2,2,"27",1,4,8,6,2,4,1037809,"2023-11-22T00:00:00.000Z",27,FALSE,13,472,"G",13,13,"LA Clippers","Russell Westbrook",2,14,21,15,13,27.7
0,0,0,0,0,0,0,0,0,"00",0,0,0,0,0,0,1037809,"2023-11-22T00:00:00.000Z",27,FALSE,13,17896022,"G",13,13,"LA Clippers","Brandon Boston Jr.",0,0,0,0,0,0
0,0,0,0,0,0,0,0,0,"00",0,0,0,0,0,0,1037809,"2023-11-22T00:00:00.000Z",27,FALSE,13,56677856,"G",13,13,"LA Clippers","Jordan Miller",0,0,0,0,0,0
0,0,0,0,0,0,0,0,0,"00",0,0,0,0,0,0,1037809,"2023-11-22T00:00:00.000Z",27,FALSE,13,24417679,"G",13,13,"LA Clippers","Xavier Moon",0,0,0,0,0,0
0,0,0,0,0,0,0,0,0,"00",0,0,0,0,0,0,1037809,"2023-11-22T00:00:00.000Z",27,FALSE,13,371,"F-C",13,13,"LA Clippers","Mason Plumlee",0,0,0,0,0,0
9,1,6,4,2,7,3,12,8,"36",0,3,16,6,1,4,1037809,"2023-11-22T00:00:00.000Z",27,FALSE,13,192,"G",13,13,"LA Clippers","James Harden",2,22,31,25,15,38.7
4,0,1,9,3,12,4,3,2,"29",0,3,13,1,3,2,1037810,"2023-11-22T00:00:00.000Z",24,FALSE,10,178,"G",24,24,"Phoenix Suns","Eric Gordon",3,14,18,17,5,27.2
2,2,8,4,3,14,7,15,15,"34",0,2,32,8,0,6,1037810,"2023-11-22T00:00:00.000Z",24,FALSE,10,140,"F",24,24,"Phoenix Suns","Kevin Durant",2,40,42,34,10,44.6
0,0,2,1,0,8,4,2,1,"17",3,4,9,5,0,0,1037810,"2023-11-22T00:00:00.000Z",24,FALSE,10,349,"C",24,24,"Phoenix Suns","Jusuf Nurkic",0,14,14,9,5,15
3,0,2,4,1,4,1,8,6,"34",1,5,9,3,1,2,1037810,"2023-11-22T00:00:00.000Z",24,FALSE,10,8,"G",24,24,"Phoenix Suns","Grayson Allen",1,12,15,12,6,18.1
10,0,5,3,2,15,5,14,13,"31",3,2,25,8,1,3,1037810,"2023-11-22T00:00:00.000Z",24,FALSE,10,57,"G",24,24,"Phoenix Suns","Devin Booker",1,33,43,35,18,49.6
0,0,0,0,0,0,0,0,0,"00",0,0,0,0,0,0,1037810,"2023-11-22T00:00:00.000Z",24,FALSE,10,3547095,"C-F",24,24,"Phoenix Suns","Udoka Azubuike",0,0,0,0,0,0
0,0,2,1,1,2,1,2,0,"12",1,1,3,3,1,1,1037810,"2023-11-22T00:00:00.000Z",24,FALSE,10,32,"F",24,24,"Phoenix Suns","Keita Bates-Diop",1,6,6,3,3,8.6
0,0,0,0,0,0,0,0,0,"00",0,0,0,0,0,0,1037810,"2023-11-22T00:00:00.000Z",24,FALSE,10,666451,"C",24,24,"Phoenix Suns","Bol Bol",0,0,0,0,0,0
0,3,5,0,0,4,2,2,2,"16",1,1,6,6,0,0,1037810,"2023-11-22T00:00:00.000Z",24,FALSE,10,147,"F",24,24,"Phoenix Suns","Drew Eubanks",3,12,12,6,6,22.2
0,0,0,0,0,0,0,0,0,"01",0,0,0,0,0,0,1037810,"2023-11-22T00:00:00.000Z",24,FALSE,10,18678058,"",24,24,"Phoenix Suns","Jordan Goodwin",0,0,0,0,0,0
0,0,0,0,0,0,0,0,0,"00",0,0,0,0,0,0,1037810,"2023-11-22T00:00:00.000Z",24,FALSE,10,3547298,"G",24,24,"Phoenix Suns","Saben Lee",0,0,0,0,0,0
3,0,4,3,0,9,4,2,2,"27",1,1,10,5,2,0,1037810,"2023-11-22T00:00:00.000Z",24,FALSE,10,666729,"F",24,24,"Phoenix Suns","Nassir Little",2,15,18,13,8,26.5
0,2,2,1,0,3,2,0,0,"12",0,2,4,2,0,0,1037810,"2023-11-22T00:00:00.000Z",24,FALSE,10,314,"F",24,24,"Phoenix Suns","Chimezie Metu",2,6,6,4,2,12.4
0,1,1,2,1,5,4,4,3,"27",1,1,12,2,1,1,1037810,"2023-11-22T00:00:00.000Z",24,FALSE,10,356,"G",24,24,"Phoenix Suns","Josh Okogie",2,14,14,12,2,19.4
0,0,0,0,0,0,0,0,0,"00",0,0,0,0,0,0,1037810,"2023-11-22T00:00:00.000Z",24,FALSE,10,37,"G",24,24,"Phoenix Suns","Bradley Beal",0,0,0,0,0,0
0,0,0,0,0,0,0,0,0,"00",0,0,0,0,0,0,1037810,"2023-11-22T00:00:00.000Z",24,FALSE,10,272,"G",24,24,"Phoenix Suns","Damion Lee",0,0,0,0,0,0
0,0,0,0,0,0,0,0,0,"00",0,0,0,0,0,0,1037810,"2023-11-22T00:00:00.000Z",24,FALSE,10,470,"G",24,24,"Phoenix Suns","Yuta Watanabe",0,0,0,0,0,0
1,1,2,10,6,17,8,1,1,"25",1,3,23,3,0,2,1037810,"2023-11-22T00:00:00.000Z",24,FALSE,10,443,"G",10,10,"Golden State Warriors","Klay Thompson",1,26,27,24,4,29.1
1,1,2,3,0,11,4,4,3,"25",2,1,11,4,0,2,1037810,"2023-11-22T00:00:00.000Z",24,FALSE,10,475,"F-G",10,10,"Golden State Warriors","Andrew Wiggins",1,15,16,12,5,18.3
2,0,5,0,0,5,3,0,0,"17",1,4,6,6,1,2,1037810,"2023-11-22T00:00:00.000Z",24,FALSE,10,282,"F",10,10,"Golden State Warriors","Kevon Looney",1,12,14,8,8,17.2
6,0,3,8,1,15,6,3,3,"28",0,2,16,3,0,2,1037810,"2023-11-22T00:00:00.000Z",24,FALSE,10,115,"G",10,10,"Golden State Warriors","Stephen Curry",0,19,25,22,9,26.6
6,0,2,1,0,2,1,4,4,"17",0,1,6,2,0,1,1037810,"2023-11-22T00:00:00.000Z",24,FALSE,10,367,"G",10,10,"Golden State Warriors","Chris Paul",0,8,14,12,8,16.4
0,0,0,0,0,0,0,0,0,"00",0,0,0,0,0,0,1037810,"2023-11-22T00:00:00.000Z",24,FALSE,10,185,"F",10,10,"Golden State Warriors","Draymond Green",0,0,0,0,0,0
0,0,2,0,0,3,2,5,2,"15",2,3,6,4,1,1,1037810,"2023-11-22T00:00:00.000Z",24,FALSE,10,56677799,"F",10,10,"Golden State Warriors","Trayce Jackson-Davis",1,10,10,6,4,12.8
4,0,0,2,0,3,1,2,1,"16",0,3,3,0,2,1,1037810,"2023-11-22T00:00:00.000Z",24,FALSE,10,251,"G",10,10,"Golden State Warriors","Cory Joseph",2,3,7,7,4,14
2,0,1,1,0,7,3,2,1,"21",0,5,7,1,1,0,1037810,"2023-11-22T00:00:00.000Z",24,FALSE,10,17553979,"F",10,10,"Golden State Warriors","Jonathan Kuminga",1,8,10,9,3,14.2
1,1,8,1,0,8,4,1,0,"23",1,5,8,9,0,1,1037810,"2023-11-22T00:00:00.000Z",24,FALSE,10,17553992,"G",10,10,"Golden State Warriors","Moses Moody",1,17,18,9,10,22.3
2,0,2,3,1,9,4,2,1,"23",2,1,10,4,3,0,1037810,"2023-11-22T00:00:00.000Z",24,FALSE,10,56677858,"G",10,10,"Golden State Warriors","Brandin Podziemski",3,14,16,12,6,26.8
0,0,1,0,0,1,1,0,0,"08",0,2,2,1,0,2,1037810,"2023-11-22T00:00:00.000Z",24,FALSE,10,57875092,"F",10,10,"Golden State Warriors","Gui Santos",0,3,3,2,1,1.2
4,0,4,3,2,9,6,5,3,"22",2,4,17,6,2,1,1037810,"2023-11-22T00:00:00.000Z",24,FALSE,10,407,"F",10,10,"Golden State Warriors","Dario Saric",2,23,27,21,10,35.2
0,0,0,0,0,0,0,0,0,"00",0,0,0,0,0,0,1037810,"2023-11-22T00:00:00.000Z",24,FALSE,10,17896070,"F",10,10,"Golden State Warriors","Usman Garuba",0,0,0,0,0,0
0,0,0,0,0,0,0,0,0,"00",0,0,0,0,0,0,1037810,"2023-11-22T00:00:00.000Z",24,FALSE,10,2189,"",10,10,"Golden State Warriors","Gary Payton II",0,0,0,0,0,0
0,0,0,0,0,0,0,0,0,"00",0,0,0,0,0,0,1037810,"2023-11-22T00:00:00.000Z",24,FALSE,10,45658838,"G",10,10,"Golden State Warriors","Lester Quinones",0,0,0,0,0,0
0,0,0,0,0,0,0,0,0,"00",0,0,0,0,0,0,1037810,"2023-11-22T00:00:00.000Z",24,FALSE,10,398,"G",10,10,"Golden State Warriors","Jerome Robinson",0,0,0,0,0,0
3,1,4,4,2,8,4,2,2,"28",3,2,12,7,0,2,1037811,"2023-11-22T00:00:00.000Z",25,FALSE,29,56677850,"F",25,25,"Portland Trail Blazers","Toumani Camara",1,19,22,15,10,25.9
4,1,2,6,5,13,10,6,5,"32",0,3,30,2,1,2,1037811,"2023-11-22T00:00:00.000Z",25,FALSE,29,182,"F",25,25,"Portland Trail Blazers","Jerami Grant",2,32,36,34,6,42.4
0,0,0,0,0,0,0,0,0,"00",0,0,0,0,0,0,1037811,"2023-11-22T00:00:00.000Z",25,FALSE,29,22,"C",25,25,"Portland Trail Blazers","Deandre Ayton",0,0,0,0,0,0
4,1,4,4,2,11,6,0,0,"31",0,4,14,4,1,1,1037811,"2023-11-22T00:00:00.000Z",25,FALSE,29,38017690,"G",25,25,"Portland Trail Blazers","Shaedon Sharpe",2,18,22,18,8,29.8
8,0,3,5,1,16,9,1,1,"24",1,0,20,4,1,0,1037811,"2023-11-22T00:00:00.000Z",25,FALSE,29,65,"G",25,25,"Portland Trail Blazers","Malcolm Brogdon",1,24,32,28,12,39.8
0,0,0,0,0,0,0,0,0,"00",0,0,0,0,0,0,1037811,"2023-11-22T00:00:00.000Z",25,FALSE,29,666476,"C",25,25,"Portland Trail Blazers","Moses Brown",0,0,0,0,0,0
7,0,2,3,0,7,1,2,1,"17",1,4,3,3,0,3,1037811,"2023-11-22T00:00:00.000Z",25,FALSE,29,56677747,"G",25,25,"Portland Trail Blazers","Scoot Henderson",0,6,13,10,10,14.1
0,0,0,0,0,1,0,0,0,"06",0,0,0,0,0,0,1037811,"2023-11-22T00:00:00.000Z",25,FALSE,29,3547289,"G",25,25,"Portland Trail Blazers","Skylar Mays",0,0,0,0,0,0
0,0,0,3,0,5,1,1,0,"17",2,0,2,2,1,0,1037811,"2023-11-22T00:00:00.000Z",25,FALSE,29,56677791,"F",25,25,"Portland Trail Blazers","Kris Murray",1,4,4,2,2,7.4
1,1,4,4,2,5,3,0,0,"20",0,2,8,4,0,1,1037811,"2023-11-22T00:00:00.000Z",25,FALSE,29,56783340,"C",25,25,"Portland Trail Blazers","Duop Reath",1,12,13,9,5,16.3
0,0,0,1,0,2,0,0,0,"06",0,0,0,0,0,0,1037811,"2023-11-22T00:00:00.000Z",25,FALSE,29,56677829,"G-F",25,25,"Portland Trail Blazers","Rayan Rupert",0,0,0,0,0,0
2,2,0,6,3,9,5,1,0,"31",1,2,13,1,3,3,1037811,"2023-11-22T00:00:00.000Z",25,FALSE,29,666923,"G-F",25,25,"Portland Trail Blazers","Matisse Thybulle",5,14,16,15,3,29.2
2,0,4,3,2,15,8,2,1,"28",6,4,19,10,2,1,1037811,"2023-11-22T00:00:00.000Z",25,FALSE,29,38017711,"F",25,25,"Portland Trail Blazers","Jabari Walker",2,29,31,21,12,39
0,0,0,0,0,0,0,0,0,"00",0,0,0,0,0,0,1037811,"2023-11-22T00:00:00.000Z",25,FALSE,29,39613724,"C",25,25,"Portland Trail Blazers","Ibou Badji",0,0,0,0,0,0
0,0,0,0,0,0,0,0,0,"00",0,0,0,0,0,0,1037811,"2023-11-22T00:00:00.000Z",25,FALSE,29,47957121,"F",25,25,"Portland Trail Blazers","Justin Minaya",0,0,0,0,0,0
0,0,0,0,0,0,0,0,0,"00",0,0,0,0,0,0,1037811,"2023-11-22T00:00:00.000Z",25,FALSE,29,419,"G",25,25,"Portland Trail Blazers","Anfernee Simons",0,0,0,0,0,0
0,0,0,0,0,0,0,0,0,"00",0,0,0,0,0,0,1037811,"2023-11-22T00:00:00.000Z",25,FALSE,29,17896120,"F",25,25,"Portland Trail Blazers","Ish Wainright",0,0,0,0,0,0
0,0,0,0,0,0,0,0,0,"00",0,0,0,0,0,0,1037811,"2023-11-22T00:00:00.000Z",25,FALSE,29,476,"C-F",25,25,"Portland Trail Blazers","Robert Williams III",0,0,0,0,0,0
5,1,6,0,0,5,5,3,3,"32",3,1,13,9,1,3,1037811,"2023-11-22T00:00:00.000Z",25,FALSE,29,358,"F",29,29,"Utah Jazz","Kelly Olynyk",2,22,27,18,14,34.3
0,0,5,6,1,18,9,6,5,"34",3,2,24,8,3,2,1037811,"2023-11-22T00:00:00.000Z",25,FALSE,29,297,"F",29,29,"Utah Jazz","Lauri Markkanen",3,32,32,24,8,40.6
1,0,5,1,0,12,6,0,0,"32",6,0,12,11,0,0,1037811,"2023-11-22T00:00:00.000Z",25,FALSE,29,101,"F-C",29,29,"Utah Jazz","John Collins",0,23,24,13,12,26.7
5,0,2,4,2,11,5,2,1,"32",0,0,13,2,0,7,1037811,"2023-11-22T00:00:00.000Z",25,FALSE,29,100,"G",29,29,"Utah Jazz","Jordan Clarkson",0,15,20,18,7,15.9
7,0,3,6,3,9,3,7,7,"34",0,2,16,3,1,0,1037811,"2023-11-22T00:00:00.000Z",25,FALSE,29,56677834,"G",29,29,"Utah Jazz","Keyonte George",1,19,26,23,10,33.1
1,1,0,1,1,4,4,0,0,"14",0,0,9,0,0,1,1037811,"2023-11-22T00:00:00.000Z",25,FALSE,29,38017620,"G",29,29,"Utah Jazz","Ochai Agbaji",1,9,10,10,1,12.5
1,1,2,0,0,1,0,2,1,"05",0,0,1,2,0,0,1037811,"2023-11-22T00:00:00.000Z",25,FALSE,29,139,"G",29,29,"Utah Jazz","Kris Dunn",1,3,4,2,3,7.9
1,0,0,6,2,7,3,0,0,"16",1,1,8,1,1,1,1037811,"2023-11-22T00:00:00.000Z",25,FALSE,29,38017739,"F",29,29,"Utah Jazz","Simone Fontecchio",1,9,10,9,2,12.7
1,0,0,2,0,4,1,4,3,"14",0,4,5,0,0,3,1037811,"2023-11-22T00:00:00.000Z",25,FALSE,29,666650,"G",29,29,"Utah Jazz","Talen Horton-Tucker",0,5,6,6,1,3.5
0,0,0,0,0,0,0,0,0,"00",0,0,0,0,0,0,1037811,"2023-11-22T00:00:00.000Z",25,FALSE,29,666881,"F",29,29,"Utah Jazz","Luka Samanic",0,0,0,0,0,0
2,0,1,3,0,5,0,2,1,"11",1,2,1,2,1,2,1037811,"2023-11-22T00:00:00.000Z",25,FALSE,29,413,"G",29,29,"Utah Jazz","Collin Sexton",1,3,5,3,4,7.4
1,0,6,2,1,3,1,0,0,"16",0,1,3,6,0,2,1037811,"2023-11-22T00:00:00.000Z",25,FALSE,29,11891374,"C",29,29,"Utah Jazz","Omer Yurtseven",0,9,10,4,7,9.7
0,0,0,0,0,0,0,0,0,"00",0,0,0,0,0,0,1037811,"2023-11-22T00:00:00.000Z",25,FALSE,29,17896023,"G",29,29,"Utah Jazz","Josh Christopher",0,0,0,0,0,0
0,0,0,0,0,0,0,0,0,"00",0,0,0,0,0,0,1037811,"2023-11-22T00:00:00.000Z",25,FALSE,29,56677824,"F",29,29,"Utah Jazz","Taylor Hendricks",0,0,0,0,0,0
0,0,0,0,0,0,0,0,0,"00",0,0,0,0,0,0,1037811,"2023-11-22T00:00:00.000Z",25,FALSE,29,38017630,"G",29,29,"Utah Jazz","Johnny Juzang",0,0,0,0,0,0
0,0,0,0,0,0,0,0,0,"00",0,0,0,0,0,0,1037811,"2023-11-22T00:00:00.000Z",25,FALSE,29,38017705,"C",29,29,"Utah Jazz","Walker Kessler",0,0,0,0,0,0
0,0,0,0,0,0,0,0,0,"00",0,0,0,0,0,0,1037811,"2023-11-22T00:00:00.000Z",25,FALSE,29,19465584,"F",29,29,"Utah Jazz","Micah Potter",0,0,0,0,0,0
0,0,0,0,0,0,0,0,0,"00",0,0,0,0,0,0,1037811,"2023-11-22T00:00:00.000Z",25,FALSE,29,56677842,"F",29,29,"Utah Jazz","Brice Sensabaugh",0,0,0,0,0,0
2,0,5,5,2,10,6,0,0,"37",1,3,14,6,0,1,1037812,"2023-11-22T00:00:00.000Z",14,FALSE,7,383,"F",14,14,"Los Angeles Lakers","Taurean Prince",0,20,22,16,8,23.2
7,0,7,9,4,19,9,7,4,"36",2,0,26,9,0,3,1037812,"2023-11-22T00:00:00.000Z",14,FALSE,7,237,"F",14,14,"Los Angeles Lakers","LeBron James",0,35,42,33,16,44.3
4,1,11,0,0,10,4,2,2,"36",2,3,10,13,1,3,1037812,"2023-11-22T00:00:00.000Z",14,FALSE,7,117,"F-C",14,14,"Los Angeles Lakers","Anthony Davis",2,23,27,14,17,34.6
0,0,2,4,1,7,3,0,0,"23",0,0,7,2,0,0,1037812,"2023-11-22T00:00:00.000Z",14,FALSE,7,38017697,"G",14,14,"Los Angeles Lakers","Max Christie",0,9,9,7,2,9.4
5,1,3,4,2,11,5,3,3,"24",0,1,15,3,0,1,1037812,"2023-11-22T00:00:00.000Z",14,FALSE,7,405,"G",14,14,"Los Angeles Lakers","D'Angelo Russell",1,18,23,20,8,28.1
0,0,0,0,0,0,0,0,0,"00",0,0,0,0,0,0,1037812,"2023-11-22T00:00:00.000Z",14,FALSE,7,56677867,"F",14,14,"Los Angeles Lakers","Alex Fudge",0,0,0,0,0,0
1,0,1,2,1,11,4,0,0,"26",2,3,9,3,0,1,1037812,"2023-11-22T00:00:00.000Z",14,FALSE,7,666609,"F",14,14,"Los Angeles Lakers","Rui Hachimura",0,12,13,10,4,13.1
0,0,3,0,0,1,1,2,0,"11",1,1,2,4,0,0,1037812,"2023-11-22T00:00:00.000Z",14,FALSE,7,666626,"C",14,14,"Los Angeles Lakers","Jaxson Hayes",0,6,6,2,4,6.8
0,0,0,0,0,0,0,0,0,"00",0,0,0,0,0,0,1037812,"2023-11-22T00:00:00.000Z",14,FALSE,7,56677835,"G",14,14,"Los Angeles Lakers","Jalen Hood-Schifino",0,0,0,0,0,0
0,0,0,0,0,0,0,0,0,"00",0,0,0,0,0,0,1037812,"2023-11-22T00:00:00.000Z",14,FALSE,7,56677836,"F",14,14,"Los Angeles Lakers","Maxwell Lewis",0,0,0,0,0,0
6,0,5,5,1,14,7,3,2,"32",1,5,17,6,0,2,1037812,"2023-11-22T00:00:00.000Z",14,FALSE,7,17553995,"G",14,14,"Los Angeles Lakers","Austin Reaves",0,23,29,23,12,31.2
1,0,5,0,0,1,0,2,1,"15",0,1,1,5,0,0,1037812,"2023-11-22T00:00:00.000Z",14,FALSE,7,486,"F",14,14,"Los Angeles Lakers","Christian Wood",0,6,7,2,6,8.5
0,0,0,0,0,0,0,0,0,"00",0,0,0,0,0,0,1037812,"2023-11-22T00:00:00.000Z",14,FALSE,7,56677738,"C",14,14,"Los Angeles Lakers","Colin Castleton",0,0,0,0,0,0
0,0,0,0,0,0,0,0,0,"00",0,0,0,0,0,0,1037812,"2023-11-22T00:00:00.000Z",14,FALSE,7,56677868,"G",14,14,"Los Angeles Lakers","D'Moi Hodge",0,0,0,0,0,0
0,0,0,0,0,0,0,0,0,"00",0,0,0,0,0,0,1037812,"2023-11-22T00:00:00.000Z",14,FALSE,7,666860,"F-G",14,14,"Los Angeles Lakers","Cameron Reddish",0,0,0,0,0,0
0,0,0,0,0,0,0,0,0,"00",0,0,0,0,0,0,1037812,"2023-11-22T00:00:00.000Z",14,FALSE,7,457,"F",14,14,"Los Angeles Lakers","Jarred Vanderbilt",0,0,0,0,0,0
0,0,0,0,0,0,0,0,0,"00",0,0,0,0,0,0,1037812,"2023-11-22T00:00:00.000Z",14,FALSE,7,1603383,"G",14,14,"Los Angeles Lakers","Gabe Vincent",0,0,0,0,0,0
0,2,1,4,2,4,2,0,0,"19",1,4,6,2,0,0,1037812,"2023-11-22T00:00:00.000Z",14,FALSE,7,247,"F-G",7,7,"Dallas Mavericks","Derrick Jones Jr.",2,8,8,6,2,14.4
2,1,2,9,2,9,2,0,0,"32",1,4,6,3,0,0,1037812,"2023-11-22T00:00:00.000Z",14,FALSE,7,666965,"F",7,7,"Dallas Mavericks","Grant Williams",1,9,11,8,5,15.6
3,0,6,0,0,3,1,0,0,"19",4,0,2,10,0,1,1037812,"2023-11-22T00:00:00.000Z",14,FALSE,7,56677840,"C",7,7,"Dallas Mavericks","Dereck Lively II",0,12,15,5,13,17.5
2,0,5,8,4,22,11,2,2,"35",1,0,28,6,2,2,1037812,"2023-11-22T00:00:00.000Z",14,FALSE,7,228,"G",7,7,"Dallas Mavericks","Kyrie Irving",2,34,36,30,8,42.2
8,0,12,12,3,26,10,8,7,"39",0,2,30,12,2,0,1037812,"2023-11-22T00:00:00.000Z",14,FALSE,7,132,"F-G",7,7,"Dallas Mavericks","Luka Doncic",2,42,50,38,20,62.4
0,0,0,0,0,0,0,0,0,"01",0,0,0,0,0,0,1037812,"2023-11-22T00:00:00.000Z",14,FALSE,7,114,"G",7,7,"Dallas Mavericks","Seth Curry",0,0,0,0,0,0
0,0,0,2,0,5,2,0,0,"09",0,2,4,0,0,0,1037812,"2023-11-22T00:00:00.000Z",14,FALSE,7,151,"G",7,7,"Dallas Mavericks","Dante Exum",0,4,4,4,0,4
1,0,3,6,3,10,6,0,0,"21",0,1,15,3,0,0,1037812,"2023-11-22T00:00:00.000Z",14,FALSE,7,3547258,"G",7,7,"Dallas Mavericks","Josh Green",0,18,19,16,4,20.1
3,0,1,8,2,10,2,2,1,"30",1,0,7,2,1,0,1037812,"2023-11-22T00:00:00.000Z",14,FALSE,7,191,"G",7,7,"Dallas Mavericks","Tim Hardaway Jr.",1,9,12,10,5,16.9
0,0,0,1,0,5,1,0,0,"07",0,0,2,0,0,0,1037812,"2023-11-22T00:00:00.000Z",14,FALSE,7,38017679,"G",7,7,"Dallas Mavericks","Jaden Hardy",0,2,2,2,0,2
1,1,7,0,0,2,1,4,2,"23",3,3,4,10,0,0,1037812,"2023-11-22T00:00:00.000Z",14,FALSE,7,217,"F-C",7,7,"Dallas Mavericks","Richaun Holmes",1,14,15,5,11,20.5
0,0,0,0,0,0,0,0,0,"00",0,0,0,0,0,0,1037812,"2023-11-22T00:00:00.000Z",14,FALSE,7,329,"F",7,7,"Dallas Mavericks","Markieff Morris",0,0,0,0,0,0
1,0,0,0,0,0,0,0,0,"05",0,2,0,0,0,1,1037812,"2023-11-22T00:00:00.000Z",14,FALSE,7,379,"F-C",7,7,"Dallas Mavericks","Dwight Powell",0,0,1,1,1,0.5
0,0,0,0,0,0,0,0,0,"00",0,0,0,0,0,0,1037812,"2023-11-22T00:00:00.000Z",14,FALSE,7,56677859,"F",7,7,"Dallas Mavericks","Olivier-Maxence Prosper",0,0,0,0,0,0
0,0,0,0,0,0,0,0,0,"00",0,0,0,0,0,0,1037812,"2023-11-22T00:00:00.000Z",14,FALSE,7,17896028,"F",7,7,"Dallas Mavericks","Greg Brown III",0,0,0,0,0,0
0,0,0,0,0,0,0,0,0,"00",0,0,0,0,0,0,1037812,"2023-11-22T00:00:00.000Z",14,FALSE,7,56677873,"G",7,7,"Dallas Mavericks","Dexter Dennis",0,0,0,0,0,0
0,0,0,0,0,0,0,0,0,"00",0,0,0,0,0,0,1037812,"2023-11-22T00:00:00.000Z",14,FALSE,7,257,"F",7,7,"Dallas Mavericks","Maxi Kleber",0,0,0,0,0,0
0,0,0,0,0,0,0,0,0,"00",0,0,0,0,0,0,1037812,"2023-11-22T00:00:00.000Z",14,FALSE,7,17554004,"G",7,7,"Dallas Mavericks","AJ Lawson",0,0,0,0,0,0
6,1,7,6,1,17,8,0,0,"35",0,2,17,7,0,3,3277498,"2023-11-24T00:00:00.000Z",22,FALSE,2,17896026,"F",22,22,"Orlando Magic","Franz Wagner",1,24,30,23,13,34.4
5,0,7,6,2,16,10,2,1,"35",1,4,23,8,0,3,3277498,"2023-11-24T00:00:00.000Z",22,FALSE,2,38017683,"F",22,22,"Orlando Magic","Paolo Banchero",0,31,36,28,13,37.1
3,1,3,0,0,5,3,0,0,"19",2,5,6,5,1,0,3277498,"2023-11-24T00:00:00.000Z",22,FALSE,2,666442,"C",22,22,"Orlando Magic","Goga Bitadze",2,11,14,9,8,22.5
1,0,4,4,3,8,3,2,1,"28",0,2,10,4,1,3,3277498,"2023-11-24T00:00:00.000Z",22,FALSE,2,17896073,"G",22,22,"Orlando Magic","Jalen Suggs",1,14,15,11,5,16.3
0,0,1,0,0,1,0,0,0,"06",0,1,0,1,0,1,3277498,"2023-11-24T00:00:00.000Z",22,FALSE,2,56677827,"G",22,22,"Orlando Magic","Anthony Black",0,1,1,0,1,0.2
6,1,2,4,2,17,6,4,2,"28",1,4,16,3,2,3,3277498,"2023-11-24T00:00:00.000Z",22,FALSE,2,3547251,"G",22,22,"Orlando Magic","Cole Anthony",3,19,25,22,9,34.6
0,0,1,3,1,3,1,1,1,"19",2,1,4,3,0,2,3277498,"2023-11-24T00:00:00.000Z",22,FALSE,2,196,"G",22,22,"Orlando Magic","Gary Harris",0,7,7,4,3,5.6
0,0,0,0,0,0,0,0,0,"00",0,0,0,0,0,0,3277498,"2023-11-24T00:00:00.000Z",22,FALSE,2,338,"G",2,2,"Boston Celtics","Svi Mykhailiuk",0,0,0,0,0,0
0,0,1,0,0,0,0,0,0,"09",1,0,0,2,1,0,3277498,"2023-11-24T00:00:00.000Z",22,FALSE,2,38017724,"G",22,22,"Orlando Magic","Caleb Houstan",1,2,2,0,2,5.4
0,0,0,0,0,0,0,0,0,"00",0,0,0,0,0,0,3277498,"2023-11-24T00:00:00.000Z",22,FALSE,2,56677839,"G",22,22,"Orlando Magic","Jett Howard",0,0,0,0,0,0
2,0,4,1,1,3,2,0,0,"21",1,1,5,5,0,2,3277498,"2023-11-24T00:00:00.000Z",22,FALSE,2,226,"F",22,22,"Orlando Magic","Joe Ingles",0,10,12,7,7,12
0,0,4,1,0,2,1,4,3,"16",3,3,5,7,0,0,3277498,"2023-11-24T00:00:00.000Z",22,FALSE,2,229,"F",22,22,"Orlando Magic","Jonathan Isaac",0,12,12,5,7,13.4
0,0,0,0,0,0,0,0,0,"00",0,0,0,0,0,0,3277498,"2023-11-24T00:00:00.000Z",22,FALSE,2,666818,"F",22,22,"Orlando Magic","Chuma Okeke",0,0,0,0,0,0
0,0,0,0,0,0,0,0,0,"00",0,0,0,0,0,0,3277498,"2023-11-24T00:00:00.000Z",22,FALSE,2,666885,"F",22,22,"Orlando Magic","Admiral Schofield",0,0,0,0,0,0
0,0,1,3,1,13,9,9,8,"24",2,5,27,3,0,1,3277498,"2023-11-24T00:00:00.000Z",22,FALSE,2,462,"C",22,22,"Orlando Magic","Moritz Wagner",0,30,30,27,3,29.6
0,0,0,0,0,0,0,0,0,"00",0,0,0,0,0,0,3277498,"2023-11-24T00:00:00.000Z",22,FALSE,2,85,"F",22,22,"Orlando Magic","Wendell Carter Jr.",0,0,0,0,0,0
0,0,0,0,0,0,0,0,0,"00",0,0,0,0,0,0,3277498,"2023-11-24T00:00:00.000Z",22,FALSE,2,165,"G",22,22,"Orlando Magic","Markelle Fultz",0,0,0,0,0,0
0,0,0,0,0,0,0,0,0,"00",0,0,0,0,0,0,3277498,"2023-11-24T00:00:00.000Z",22,FALSE,2,38017607,"G",22,22,"Orlando Magic","Kevon Harris",0,0,0,0,0,0
0,0,0,0,0,0,0,0,0,"00",0,0,0,0,0,0,3277498,"2023-11-24T00:00:00.000Z",22,FALSE,2,17553983,"G",22,22,"Orlando Magic","Trevelin Queen",0,0,0,0,0,0
3,0,5,3,0,16,7,13,12,"39",0,3,26,5,2,2,3277498,"2023-11-24T00:00:00.000Z",22,FALSE,2,434,"F",2,2,"Boston Celtics","Jayson Tatum",2,31,34,29,8,40.5
3,0,5,5,1,5,1,0,0,"33",0,4,3,5,0,1,3277498,"2023-11-24T00:00:00.000Z",22,FALSE,2,219,"C-F",2,2,"Boston Celtics","Al Horford",0,8,11,6,8,12.5
2,0,3,4,1,9,4,1,0,"22",1,3,9,4,2,2,3277498,"2023-11-24T00:00:00.000Z",22,FALSE,2,378,"F-C",2,2,"Boston Celtics","Kristaps Porzingis",2,13,15,11,6,20.8
2,1,3,8,2,22,6,7,4,"39",0,3,18,3,3,3,3277498,"2023-11-24T00:00:00.000Z",22,FALSE,2,70,"G",2,2,"Boston Celtics","Jaylen Brown",4,21,23,20,5,33.6
4,1,5,5,1,9,3,12,9,"37",0,1,16,5,1,3,3277498,"2023-11-24T00:00:00.000Z",22,FALSE,2,473,"G",2,2,"Boston Celtics","Derrick White",2,21,25,20,9,31
0,0,0,0,0,1,0,0,0,"01",0,0,0,0,0,0,3277498,"2023-11-24T00:00:00.000Z",22,FALSE,2,17896094,"G",2,2,"Boston Celtics","Dalano Banton",0,0,0,0,0,0
0,0,0,0,0,0,0,2,0,"05",0,2,0,0,0,0,3277498,"2023-11-24T00:00:00.000Z",22,FALSE,2,666468,"F",2,2,"Boston Celtics","Oshae Brissett",0,0,0,0,0,0
0,0,1,4,2,6,4,0,0,"25",1,0,10,2,0,1,3277498,"2023-11-24T00:00:00.000Z",22,FALSE,2,17896060,"F",2,2,"Boston Celtics","Sam Hauser",0,12,12,10,2,11.4
1,2,4,0,0,6,5,2,2,"25",2,2,12,6,2,1,3277498,"2023-11-24T00:00:00.000Z",22,FALSE,2,261,"F-C",2,2,"Boston Celtics","Luke Kornet",4,18,19,13,7,31.7
2,0,1,0,0,2,1,0,0,"13",0,0,2,1,0,1,3277498,"2023-11-24T00:00:00.000Z",22,FALSE,2,3547276,"G",2,2,"Boston Celtics","Payton Pritchard",0,3,5,4,3,5.2
0,0,0,0,0,0,0,0,0,"01",0,0,0,0,0,0,3277498,"2023-11-24T00:00:00.000Z",22,FALSE,2,3547279,"F",2,2,"Boston Celtics","Lamar Stevens",0,0,0,0,0,0
0,0,0,0,0,0,0,0,0,"00",0,0,0,0,0,0,3277498,"2023-11-24T00:00:00.000Z",22,FALSE,2,38017707,"G",2,2,"Boston Celtics","JD Davison",0,0,0,0,0,0
0,0,0,0,0,0,0,0,0,"00",0,0,0,0,0,0,3277498,"2023-11-24T00:00:00.000Z",22,FALSE,2,214,"G",2,2,"Boston Celtics","Jrue Holiday",0,0,0,0,0,0
0,0,0,0,0,0,0,0,0,"00",0,0,0,0,0,0,3277498,"2023-11-24T00:00:00.000Z",22,FALSE,2,3547295,"F-C",2,2,"Boston Celtics","Nathan Knight",0,0,0,0,0,0
0,0,0,0,0,0,0,0,0,"00",0,0,0,0,0,0,3277498,"2023-11-24T00:00:00.000Z",22,FALSE,2,17553967,"C",2,2,"Boston Celtics","Neemias Queta",0,0,0,0,0,0
0,0,0,0,0,0,0,0,0,"00",0,0,0,0,0,0,3277498,"2023-11-24T00:00:00.000Z",22,FALSE,2,56677864,"G",2,2,"Boston Celtics","Jordan Walsh",0,0,0,0,0,0
0,0,4,10,3,20,9,0,0,"36",1,2,21,5,0,0,3277499,"2023-11-24T00:00:00.000Z",15,FALSE,24,17896067,"F",15,15,"Memphis Grizzlies","Santi Aldama",0,26,26,21,5,27
2,0,3,4,1,13,5,4,2,"29",4,5,13,7,1,3,3277499,"2023-11-24T00:00:00.000Z",15,FALSE,24,231,"F-C",15,15,"Memphis Grizzlies","Jaren Jackson Jr.",1,20,22,15,9,24.4
1,1,3,0,0,5,3,0,0,"29",1,3,6,4,0,1,3277499,"2023-11-24T00:00:00.000Z",15,FALSE,24,48,"C",15,15,"Memphis Grizzlies","Bismack Biyombo",1,10,11,7,5,14.3
10,0,5,5,0,12,3,0,0,"34",0,3,6,5,1,3,3277499,"2023-11-24T00:00:00.000Z",15,FALSE,24,3547287,"G",15,15,"Memphis Grizzlies","Desmond Bane",1,11,21,16,15,27
5,0,0,4,1,5,2,1,1,"23",0,2,6,0,0,2,3277499,"2023-11-24T00:00:00.000Z",15,FALSE,24,48248287,"G",15,15,"Memphis Grizzlies","Jacob Gilyard",0,6,11,11,5,11.5
0,0,0,0,0,0,0,0,0,"02",0,0,0,0,0,0,3277499,"2023-11-24T00:00:00.000Z",15,FALSE,24,199,"G",15,15,"Memphis Grizzlies","Shaquille Harrison",0,0,0,0,0,0
0,0,0,1,0,1,0,0,0,"01",0,0,0,0,1,1,3277499,"2023-11-24T00:00:00.000Z",15,FALSE,24,56677830,"F",15,15,"Memphis Grizzlies","GG Jackson",1,0,0,0,0,2
1,0,3,1,0,2,0,2,1,"18",0,1,1,3,0,0,3277499,"2023-11-24T00:00:00.000Z",15,FALSE,24,666703,"G-F",15,15,"Memphis Grizzlies","John Konchar",0,4,5,2,4,6.1
0,0,0,0,0,1,1,0,0,"02",0,1,2,0,0,0,3277499,"2023-11-24T00:00:00.000Z",15,FALSE,24,38017732,"F",15,15,"Memphis Grizzlies","Kenneth Lofton Jr.",0,2,2,2,0,2
0,0,0,0,0,0,0,0,0,"02",0,0,0,0,0,0,3277499,"2023-11-24T00:00:00.000Z",15,FALSE,24,666809,"G",15,15,"Memphis Grizzlies","Jaylen Nowell",0,0,0,0,0,0
0,1,4,4,2,9,5,3,2,"27",0,0,14,4,2,2,3277499,"2023-11-24T00:00:00.000Z",15,FALSE,24,38017729,"F",15,15,"Memphis Grizzlies","David Roddy",3,18,18,14,4,25.8
1,0,2,1,1,9,8,0,0,"21",0,0,17,2,1,1,3277499,"2023-11-24T00:00:00.000Z",15,FALSE,24,401,"G",15,15,"Memphis Grizzlies","Derrick Rose",1,19,20,18,3,22.9
1,0,5,2,1,2,1,0,0,"14",0,4,3,5,0,0,3277499,"2023-11-24T00:00:00.000Z",15,FALSE,24,38017731,"G",15,15,"Memphis Grizzlies","Vince Williams Jr.",0,8,9,4,6,10.5
1,0,0,1,0,1,0,0,0,"02",0,1,0,0,0,0,3277499,"2023-11-24T00:00:00.000Z",15,FALSE,24,17896027,"G-F",15,15,"Memphis Grizzlies","Ziaire Williams",0,0,1,1,1,1.5
0,0,0,0,0,0,0,0,0,"00",0,0,0,0,0,0,3277499,"2023-11-24T00:00:00.000Z",15,FALSE,24,3,"C",15,15,"Memphis Grizzlies","Steven Adams",0,0,0,0,0,0
0,0,0,0,0,0,0,0,0,"00",0,0,0,0,0,0,3277499,"2023-11-24T00:00:00.000Z",15,FALSE,24,666505,"F",15,15,"Memphis Grizzlies","Brandon Clarke",0,0,0,0,0,0
0,0,0,0,0,0,0,0,0,"00",0,0,0,0,0,0,3277499,"2023-11-24T00:00:00.000Z",15,FALSE,24,254,"G",15,15,"Memphis Grizzlies","Luke Kennard",0,0,0,0,0,0
0,0,0,0,0,0,0,0,0,"00",0,0,0,0,0,0,3277499,"2023-11-24T00:00:00.000Z",15,FALSE,24,38017728,"F",15,15,"Memphis Grizzlies","Jake LaRavia",0,0,0,0,0,0
3,0,6,4,1,9,2,1,0,"28",1,1,5,7,1,0,3277499,"2023-11-24T00:00:00.000Z",15,FALSE,24,356,"G",24,24,"Phoenix Suns","Josh Okogie",1,12,15,8,10,20.9
0,0,0,0,0,0,0,0,0,"00",0,0,0,0,0,0,3277499,"2023-11-24T00:00:00.000Z",15,FALSE,24,666786,"G",15,15,"Memphis Grizzlies","Ja Morant",0,0,0,0,0,0
0,0,0,0,0,0,0,0,0,"00",0,0,0,0,0,0,3277499,"2023-11-24T00:00:00.000Z",15,FALSE,24,420,"G",15,15,"Memphis Grizzlies","Marcus Smart",0,0,0,0,0,0
0,0,0,0,0,0,0,0,0,"00",0,0,0,0,0,0,3277499,"2023-11-24T00:00:00.000Z",15,FALSE,24,3547285,"F",15,15,"Memphis Grizzlies","Xavier Tillman",0,0,0,0,0,0
2,0,1,11,4,15,6,4,4,"34",0,0,20,1,0,2,3277499,"2023-11-24T00:00:00.000Z",15,FALSE,24,178,"G",24,24,"Phoenix Suns","Eric Gordon",0,21,23,22,3,22.2
1,2,3,1,0,5,2,2,2,"24",1,0,6,4,1,0,3277499,"2023-11-24T00:00:00.000Z",15,FALSE,24,32,"F",24,24,"Phoenix Suns","Keita Bates-Diop",3,10,11,7,5,21.3
6,2,9,2,0,4,2,4,2,"33",1,2,6,10,2,2,3277499,"2023-11-24T00:00:00.000Z",15,FALSE,24,349,"C",24,24,"Phoenix Suns","Jusuf Nurkic",4,16,22,12,16,37
3,1,2,4,2,9,5,3,2,"37",0,2,14,2,0,1,3277499,"2023-11-24T00:00:00.000Z",15,FALSE,24,8,"G",24,24,"Phoenix Suns","Grayson Allen",1,16,19,17,5,22.9
4,1,4,4,3,21,15,9,7,"33",1,3,40,5,4,5,3277499,"2023-11-24T00:00:00.000Z",15,FALSE,24,57,"G",24,24,"Phoenix Suns","Devin Booker",5,45,49,44,9,62
1,0,2,1,0,3,1,2,1,"15",0,2,3,2,0,0,3277499,"2023-11-24T00:00:00.000Z",15,FALSE,24,314,"F",24,24,"Phoenix Suns","Chimezie Metu",0,5,6,4,3,6.9
0,0,4,1,0,1,0,2,2,"16",0,2,2,4,1,1,3277499,"2023-11-24T00:00:00.000Z",15,FALSE,24,666729,"F",24,24,"Phoenix Suns","Nassir Little",1,6,6,2,4,8.8
2,0,3,3,1,8,6,1,1,"20",2,0,14,5,1,1,3277499,"2023-11-24T00:00:00.000Z",15,FALSE,24,18678058,"",24,24,"Phoenix Suns","Jordan Goodwin",1,19,21,16,7,25
0,0,0,0,0,0,0,0,0,"00",0,0,0,0,0,0,3277499,"2023-11-24T00:00:00.000Z",15,FALSE,24,3547095,"C-F",24,24,"Phoenix Suns","Udoka Azubuike",0,0,0,0,0,0
0,0,0,0,0,0,0,0,0,"00",0,0,0,0,0,0,3277499,"2023-11-24T00:00:00.000Z",15,FALSE,24,666451,"C",24,24,"Phoenix Suns","Bol Bol",0,0,0,0,0,0
0,0,0,0,0,0,0,0,0,"00",0,0,0,0,0,0,3277499,"2023-11-24T00:00:00.000Z",15,FALSE,24,3547298,"G",24,24,"Phoenix Suns","Saben Lee",0,0,0,0,0,0
0,0,0,0,0,0,0,0,0,"00",0,0,0,0,0,0,3277499,"2023-11-24T00:00:00.000Z",15,FALSE,24,37,"G",24,24,"Phoenix Suns","Bradley Beal",0,0,0,0,0,0
0,0,0,0,0,0,0,0,0,"00",0,0,0,0,0,0,3277499,"2023-11-24T00:00:00.000Z",15,FALSE,24,140,"F",24,24,"Phoenix Suns","Kevin Durant",0,0,0,0,0,0
0,0,0,0,0,0,0,0,0,"00",0,0,0,0,0,0,3277499,"2023-11-24T00:00:00.000Z",15,FALSE,24,147,"F",24,24,"Phoenix Suns","Drew Eubanks",0,0,0,0,0,0
0,0,0,0,0,0,0,0,0,"00",0,0,0,0,0,0,3277499,"2023-11-24T00:00:00.000Z",15,FALSE,24,272,"G",24,24,"Phoenix Suns","Damion Lee",0,0,0,0,0,0
0,0,0,0,0,0,0,0,0,"00",0,0,0,0,0,0,3277499,"2023-11-24T00:00:00.000Z",15,FALSE,24,470,"G",24,24,"Phoenix Suns","Yuta Watanabe",0,0,0,0,0,0
1,0,7,5,1,14,7,3,3,"34",0,2,18,7,0,3,3277500,"2023-11-24T00:00:00.000Z",20,FALSE,16,666423,"F-G",20,20,"New York Knicks","RJ Barrett",0,25,26,19,8,24.9
7,0,8,4,1,12,5,2,2,"35",0,0,13,8,0,6,3277500,"2023-11-24T00:00:00.000Z",20,FALSE,16,387,"F",20,20,"New York Knicks","Julius Randle",0,21,28,20,15,27.1
0,0,4,0,0,4,2,4,1,"20",3,2,5,7,2,0,3277500,"2023-11-24T00:00:00.000Z",20,FALSE,16,399,"C",20,20,"New York Knicks","Mitchell Robinson",2,12,12,5,7,19.4
3,0,3,4,1,16,10,5,3,"34",0,1,24,3,0,2,3277500,"2023-11-24T00:00:00.000Z",20,FALSE,16,73,"G",20,20,"New York Knicks","Jalen Brunson",0,27,30,27,6,30.1
2,0,0,3,1,4,1,0,0,"21",0,3,3,0,1,0,3277500,"2023-11-24T00:00:00.000Z",20,FALSE,16,17895858,"G",20,20,"New York Knicks","Quentin Grimes",1,3,5,5,2,9
1,0,3,2,1,4,1,3,2,"16",1,1,5,4,1,3,3277500,"2023-11-24T00:00:00.000Z",20,FALSE,16,131,"G",20,20,"New York Knicks","Donte DiVincenzo",1,9,10,6,5,11.3
4,0,7,3,1,7,4,1,1,"26",1,1,10,8,1,1,3277500,"2023-11-24T00:00:00.000Z",20,FALSE,16,202,"G",20,20,"New York Knicks","Josh Hart",1,18,22,14,12,27.6
1,1,4,0,0,3,1,0,0,"28",1,3,2,5,2,1,3277500,"2023-11-24T00:00:00.000Z",20,FALSE,16,201,"F-C",20,20,"New York Knicks","Isaiah Hartenstein",3,7,8,3,6,17.5
2,1,4,8,4,17,8,0,0,"26",0,1,20,4,0,2,3277500,"2023-11-24T00:00:00.000Z",20,FALSE,16,3547269,"G",20,20,"New York Knicks","Immanuel Quickley",1,24,26,22,6,28.8
0,0,0,0,0,0,0,0,0,"00",0,0,0,0,0,0,3277500,"2023-11-24T00:00:00.000Z",20,FALSE,16,666971,"G-F",20,20,"New York Knicks","Dylan Windler",0,0,0,0,0,0
3,0,2,5,3,14,7,6,6,"37",0,1,23,2,1,2,3277500,"2023-11-24T00:00:00.000Z",20,FALSE,16,79,"G-F",16,16,"Miami Heat","Jimmy Butler",1,25,28,26,5,30.9
3,0,3,5,1,6,1,2,2,"24",0,1,5,3,2,2,3277500,"2023-11-24T00:00:00.000Z",20,FALSE,16,3092,"",16,16,"Miami Heat","Haywood Highsmith",2,8,11,8,6,17.1
2,0,10,1,0,16,8,6,5,"35",2,4,21,12,2,2,3277500,"2023-11-24T00:00:00.000Z",20,FALSE,16,4,"C-F",16,16,"Miami Heat","Bam Adebayo",2,33,35,23,14,42.4
2,0,5,5,2,9,4,0,0,"33",3,3,10,8,2,1,3277500,"2023-11-24T00:00:00.000Z",20,FALSE,16,286,"G",16,16,"Miami Heat","Kyle Lowry",2,18,20,12,10,27.6
2,0,1,4,2,10,5,3,3,"34",1,3,15,2,2,2,3277500,"2023-11-24T00:00:00.000Z",20,FALSE,16,391,"G-F",16,16,"Miami Heat","Josh Richardson",2,17,19,17,4,24.4
0,0,0,0,0,0,0,0,0,"00",0,0,0,0,0,0,3277500,"2023-11-24T00:00:00.000Z",20,FALSE,16,74,"C",16,16,"Miami Heat","Thomas Bryant",0,0,0,0,0,0
0,0,0,0,0,0,0,0,0,"00",0,0,0,0,0,0,3277500,"2023-11-24T00:00:00.000Z",20,FALSE,16,38017734,"F",16,16,"Miami Heat","Jamal Cain",0,0,0,0,0,0
1,0,5,6,1,7,2,2,2,"18",1,1,7,6,0,2,3277500,"2023-11-24T00:00:00.000Z",20,FALSE,16,285,"F-C",16,16,"Miami Heat","Kevin Love",0,13,14,8,7,13.7
1,0,3,3,0,5,1,0,0,"18",0,3,2,3,1,0,3277500,"2023-11-24T00:00:00.000Z",20,FALSE,16,666747,"F",16,16,"Miami Heat","Caleb Martin",1,5,6,3,4,10.1
2,0,0,2,0,3,0,0,0,"06",0,0,0,0,0,0,3277500,"2023-11-24T00:00:00.000Z",20,FALSE,16,38017736,"F",16,16,"Miami Heat","Cole Swider",0,0,2,2,2,3
0,0,0,0,0,0,0,0,0,"00",0,0,0,0,0,0,3277500,"2023-11-24T00:00:00.000Z",20,FALSE,16,3547257,"G",16,16,"Miami Heat","R.J. Hampton",0,0,0,0,0,0
0,0,0,0,0,0,0,0,0,"00",0,0,0,0,0,0,3277500,"2023-11-24T00:00:00.000Z",20,FALSE,16,666633,"G",16,16,"Miami Heat","Tyler Herro",0,0,0,0,0,0
0,0,0,0,0,0,0,0,0,"00",0,0,0,0,0,0,3277500,"2023-11-24T00:00:00.000Z",20,FALSE,16,38017696,"F",16,16,"Miami Heat","Nikola Jovic",0,0,0,0,0,0
0,0,0,0,0,0,0,0,0,"00",0,0,0,0,0,0,3277500,"2023-11-24T00:00:00.000Z",20,FALSE,16,397,"F",16,16,"Miami Heat","Duncan Robinson",0,0,0,0,0,0
0,0,0,0,0,0,0,0,0,"00",0,0,0,0,0,0,3277500,"2023-11-24T00:00:00.000Z",20,FALSE,16,39398582,"C",16,16,"Miami Heat","Orlando Robinson",0,0,0,0,0,0
0,0,0,0,0,0,0,0,0,"00",0,0,0,0,0,0,3277500,"2023-11-24T00:00:00.000Z",20,FALSE,16,19465585,"G",16,16,"Miami Heat","Dru Smith",0,0,0,0,0,0
4,0,2,6,1,17,6,2,2,"35",3,3,15,5,1,0,3277500,"2023-11-24T00:00:00.000Z",20,FALSE,16,56677785,"G",16,16,"Miami Heat","Jaime Jaquez Jr.",1,20,24,19,9,30
0,0,0,0,0,0,0,0,0,"00",0,0,0,0,0,0,3277500,"2023-11-24T00:00:00.000Z",20,FALSE,16,19,"G",20,20,"New York Knicks","Ryan Arcidiacono",0,0,0,0,0,0
0,0,0,0,0,0,0,0,0,"00",0,0,0,0,0,0,3277500,"2023-11-24T00:00:00.000Z",20,FALSE,16,160,"G-F",20,20,"New York Knicks","Evan Fournier",0,0,0,0,0,0
0,0,0,0,0,0,0,0,0,"00",0,0,0,0,0,0,3277500,"2023-11-24T00:00:00.000Z",20,FALSE,16,666675,"F",20,20,"New York Knicks","DaQuan Jeffries",0,0,0,0,0,0
0,0,0,0,0,0,0,0,0,"00",0,0,0,0,0,0,3277500,"2023-11-24T00:00:00.000Z",20,FALSE,16,17896033,"G",20,20,"New York Knicks","Miles McBride",0,0,0,0,0,0
0,0,0,0,0,0,0,0,0,"00",0,0,0,0,0,0,3277500,"2023-11-24T00:00:00.000Z",20,FALSE,16,17896063,"F",20,20,"New York Knicks","Jericho Sims",0,0,0,0,0,0
0,0,0,0,0,0,0,0,0,"00",0,0,0,0,0,0,3277500,"2023-11-24T00:00:00.000Z",20,FALSE,16,666474,"G",20,20,"New York Knicks","Charles Brown",0,0,0,0,0,0
0,0,0,0,0,0,0,0,0,"00",0,0,0,0,0,0,3277500,"2023-11-24T00:00:00.000Z",20,FALSE,16,56677795,"F",20,20,"New York Knicks","Jacob Toppin",0,0,0,0,0,0
0,0,0,0,0,0,0,0,0,"00",0,0,0,0,0,0,3277500,"2023-11-24T00:00:00.000Z",20,FALSE,16,17896089,"G",20,20,"New York Knicks","Duane Washington Jr.",0,0,0,0,0,0
6,2,5,5,2,11,5,2,1,"33",5,1,13,10,1,1,3277501,"2023-11-24T00:00:00.000Z",28,FALSE,5,17896055,"G-F",28,28,"Toronto Raptors","Scottie Barnes",3,23,29,19,16,42
8,0,3,6,1,12,6,6,5,"37",0,2,18,3,1,3,3277501,"2023-11-24T00:00:00.000Z",28,FALSE,5,416,"F",28,28,"Toronto Raptors","Pascal Siakam",1,21,29,26,11,33.6
3,1,6,0,0,8,7,5,1,"31",4,1,15,10,2,1,3277501,"2023-11-24T00:00:00.000Z",28,FALSE,5,373,"C",28,28,"Toronto Raptors","Jakob Poeltl",3,25,28,18,13,39.5
3,0,5,7,5,14,10,2,1,"34",1,2,26,6,1,2,3277501,"2023-11-24T00:00:00.000Z",28,FALSE,5,18,"F",28,28,"Toronto Raptors","OG Anunoby",1,32,35,29,9,38.7
5,0,0,9,1,16,6,4,4,"34",0,2,17,0,0,3,3277501,"2023-11-24T00:00:00.000Z",28,FALSE,5,409,"G",28,28,"Toronto Raptors","Dennis Schroder",0,17,22,22,5,21.5
4,3,4,0,0,4,3,2,2,"18",3,0,8,7,0,2,3277501,"2023-11-24T00:00:00.000Z",28,FALSE,5,3547249,"F",28,28,"Toronto Raptors","Precious Achiuwa",3,15,19,12,11,29.4
0,0,1,1,0,3,1,2,2,"10",0,1,4,1,1,0,3277501,"2023-11-24T00:00:00.000Z",28,FALSE,5,58,"F",28,28,"Toronto Raptors","Chris Boucher",1,5,5,4,1,8.2
0,0,0,1,0,2,1,2,0,"04",0,1,2,0,0,0,3277501,"2023-11-24T00:00:00.000Z",28,FALSE,5,56677857,"F",5,5,"Chicago Bulls","Julian Phillips",0,2,2,2,0,2
0,0,0,0,0,0,0,0,0,"00",0,0,0,0,0,0,3277501,"2023-11-24T00:00:00.000Z",28,FALSE,5,17896116,"G",5,5,"Chicago Bulls","Terry Taylor",0,0,0,0,0,0
0,0,0,0,0,0,0,0,0,"00",0,0,0,0,0,0,3277501,"2023-11-24T00:00:00.000Z",28,FALSE,5,38017719,"F",5,5,"Chicago Bulls","Dalen Terry",0,0,0,0,0,0
1,0,3,2,2,8,4,2,2,"22",2,0,12,5,1,0,3277501,"2023-11-24T00:00:00.000Z",28,FALSE,5,3547248,"F",5,5,"Chicago Bulls","Patrick Williams",1,17,18,13,6,22.5
0,0,0,0,0,0,0,0,0,"00",0,0,0,0,0,0,3277501,"2023-11-24T00:00:00.000Z",28,FALSE,5,27,"G",5,5,"Chicago Bulls","Lonzo Ball",0,0,0,0,0,0
0,0,0,0,0,0,0,0,0,"00",0,0,0,0,0,0,3277501,"2023-11-24T00:00:00.000Z",28,FALSE,5,56677874,"F",5,5,"Chicago Bulls","Onuralp Bitim",0,0,0,0,0,0
0,0,0,0,0,0,0,0,0,"00",0,0,0,0,0,0,3277501,"2023-11-24T00:00:00.000Z",28,FALSE,5,45969255,"F",5,5,"Chicago Bulls","Justin Lewis",0,0,0,0,0,0
0,0,0,0,0,0,0,0,0,"00",0,0,0,0,0,0,3277501,"2023-11-24T00:00:00.000Z",28,FALSE,5,56677860,"F",5,5,"Chicago Bulls","Adama Sanogo",0,0,0,0,0,0
0,0,1,0,0,0,0,2,2,"09",0,1,2,1,0,1,3277501,"2023-11-24T00:00:00.000Z",28,FALSE,5,56677828,"G",28,28,"Toronto Raptors","Gradey Dick",0,3,3,2,1,2.2
1,0,1,2,0,2,0,2,2,"14",0,1,2,1,1,1,3277501,"2023-11-24T00:00:00.000Z",28,FALSE,5,3547275,"G",28,28,"Toronto Raptors","Malachi Flynn",1,3,4,3,2,6.7
0,0,0,0,0,0,0,0,0,"00",0,0,0,0,0,0,3277501,"2023-11-24T00:00:00.000Z",28,FALSE,5,666762,"F",28,28,"Toronto Raptors","Jalen McDaniels",0,0,0,0,0,0
0,0,0,0,0,0,0,0,0,"00",0,0,0,0,0,0,3277501,"2023-11-24T00:00:00.000Z",28,FALSE,5,376,"F",28,28,"Toronto Raptors","Otto Porter Jr.",0,0,0,0,0,0
0,0,0,0,0,0,0,0,0,"00",0,0,0,0,0,0,3277501,"2023-11-24T00:00:00.000Z",28,FALSE,5,436,"G-F",28,28,"Toronto Raptors","Garrett Temple",0,0,0,0,0,0
2,0,1,9,4,13,6,0,0,"20",0,3,16,1,1,0,3277501,"2023-11-24T00:00:00.000Z",28,FALSE,5,3089,"",28,28,"Toronto Raptors","Gary Trent Jr.",1,17,19,18,3,23.2
0,0,0,0,0,0,0,0,0,"00",0,0,0,0,0,0,3277501,"2023-11-24T00:00:00.000Z",28,FALSE,5,489,"F",28,28,"Toronto Raptors","Thaddeus Young",0,0,0,0,0,0
0,0,0,0,0,0,0,0,0,"00",0,0,0,0,0,0,3277501,"2023-11-24T00:00:00.000Z",28,FALSE,5,56677805,"G",28,28,"Toronto Raptors","Javon Freeman-Liberty",0,0,0,0,0,0
0,0,0,0,0,0,0,0,0,"00",0,0,0,0,0,0,3277501,"2023-11-24T00:00:00.000Z",28,FALSE,5,38017717,"F",28,28,"Toronto Raptors","Ron Harper Jr.",0,0,0,0,0,0
0,0,0,0,0,0,0,0,0,"00",0,0,0,0,0,0,3277501,"2023-11-24T00:00:00.000Z",28,FALSE,5,38017710,"C",28,28,"Toronto Raptors","Christian Koloko",0,0,0,0,0,0
0,0,0,0,0,0,0,0,0,"00",0,0,0,0,0,0,3277501,"2023-11-24T00:00:00.000Z",28,FALSE,5,56677869,"G",28,28,"Toronto Raptors","Markquis Nowell",0,0,0,0,0,0
4,1,3,1,0,16,7,9,5,"39",0,3,19,3,1,2,3277501,"2023-11-24T00:00:00.000Z",28,FALSE,5,125,"G",5,5,"Chicago Bulls","DeMar DeRozan",2,22,26,23,7,32.6
1,0,1,2,1,3,2,2,2,"18",1,0,7,2,0,0,3277501,"2023-11-24T00:00:00.000Z",28,FALSE,5,89,"G",5,5,"Chicago Bulls","Alex Caruso",0,9,10,8,3,10.9
5,0,8,2,1,8,4,0,0,"36",0,3,9,8,1,1,3277501,"2023-11-24T00:00:00.000Z",28,FALSE,5,460,"C",5,5,"Chicago Bulls","Nikola Vucevic",1,17,22,14,13,28.1
3,0,4,8,4,23,16,0,0,"38",0,4,36,4,1,5,3277501,"2023-11-24T00:00:00.000Z",28,FALSE,5,268,"G",5,5,"Chicago Bulls","Zach LaVine",1,40,43,39,7,43.3
3,0,2,7,4,9,5,0,0,"34",1,4,14,3,0,3,3277501,"2023-11-24T00:00:00.000Z",28,FALSE,5,666956,"G",5,5,"Chicago Bulls","Coby White",0,17,20,17,6,19.1
1,0,1,1,0,2,0,0,0,"11",0,0,0,1,0,0,3277501,"2023-11-24T00:00:00.000Z",28,FALSE,5,87,"G",5,5,"Chicago Bulls","Jevon Carter",0,1,2,1,2,2.7
1,1,3,1,0,3,1,4,3,"19",2,2,5,5,0,1,3277501,"2023-11-24T00:00:00.000Z",28,FALSE,5,110,"F",5,5,"Chicago Bulls","Torrey Craig",1,10,11,6,6,14.5
1,0,1,2,0,4,1,0,0,"13",0,1,2,1,1,0,3277501,"2023-11-24T00:00:00.000Z",28,FALSE,5,17895983,"G",5,5,"Chicago Bulls","Ayo Dosunmu",1,3,4,3,2,7.7
0,0,2,0,0,4,1,0,0,"06",3,2,2,5,0,0,3277501,"2023-11-24T00:00:00.000Z",28,FALSE,5,137,"C",5,5,"Chicago Bulls","Andre Drummond",0,7,7,2,5,8
1,3,2,1,0,8,3,2,2,"19",4,4,8,6,0,1,3277502,"2023-11-24T00:00:00.000Z",12,FALSE,9,17896035,"F",12,12,"Indiana Pacers","Isaiah Jackson",3,14,15,9,7,24.7
4,0,0,3,1,13,6,1,0,"20",3,1,13,3,1,2,3277502,"2023-11-24T00:00:00.000Z",12,FALSE,9,38017507,"G-F",12,12,"Indiana Pacers","Andrew Nembhard",1,16,20,17,7,23.6
0,0,0,0,0,0,0,0,0,"00",0,0,0,0,0,0,3277502,"2023-11-24T00:00:00.000Z",12,FALSE,9,304,"G",12,12,"Indiana Pacers","T.J. McConnell",0,0,0,0,0,0
0,0,0,0,0,0,0,0,0,"00",0,0,0,0,0,0,3277502,"2023-11-24T00:00:00.000Z",12,FALSE,9,3547207,"F",12,12,"Indiana Pacers","Jordan Nwora",0,0,0,0,0,0
0,0,0,0,0,0,0,0,0,"01",0,0,0,0,0,0,3277502,"2023-11-24T00:00:00.000Z",12,FALSE,9,56677861,"G",12,12,"Indiana Pacers","Ben Sheppard",0,0,0,0,0,0
0,0,0,0,0,0,0,0,0,"00",0,0,0,0,0,0,3277502,"2023-11-24T00:00:00.000Z",12,FALSE,9,3547240,"C",9,9,"Detroit Pistons","James Wiseman",0,0,0,0,0,0
0,0,0,0,0,0,0,0,0,"00",0,0,0,0,0,0,3277502,"2023-11-24T00:00:00.000Z",12,FALSE,9,54,"F",9,9,"Detroit Pistons","Bojan Bogdanovic",0,0,0,0,0,0
0,0,0,0,0,0,0,0,0,"00",0,0,0,0,0,0,3277502,"2023-11-24T00:00:00.000Z",12,FALSE,9,56677729,"G",9,9,"Detroit Pistons","Malcolm Cazalon",0,0,0,0,0,0
0,0,0,0,0,0,0,0,0,"00",0,0,0,0,0,0,3277502,"2023-11-24T00:00:00.000Z",12,FALSE,9,197,"F-G",9,9,"Detroit Pistons","Joe Harris",0,0,0,0,0,0
0,0,0,0,0,0,0,0,0,"00",0,0,0,0,0,0,3277502,"2023-11-24T00:00:00.000Z",12,FALSE,9,330,"G",9,9,"Detroit Pistons","Monte Morris",0,0,0,0,0,0
0,0,0,0,0,0,0,0,0,"00",0,0,0,0,0,0,3277502,"2023-11-24T00:00:00.000Z",12,FALSE,9,42097199,"G",9,9,"Detroit Pistons","Jared Rhoden",0,0,0,0,0,0
0,0,4,6,3,10,6,3,3,"28",0,2,18,4,0,0,3277502,"2023-11-24T00:00:00.000Z",12,FALSE,9,210,"G",12,12,"Indiana Pacers","Buddy Hield",0,22,22,18,4,22.8
2,0,2,5,3,8,6,0,0,"24",1,1,15,3,0,0,3277502,"2023-11-24T00:00:00.000Z",12,FALSE,9,3547243,"F",12,12,"Indiana Pacers","Obi Toppin",0,18,20,17,5,21.6
2,5,5,3,1,14,8,6,6,"27",5,5,23,10,1,2,3277502,"2023-11-24T00:00:00.000Z",12,FALSE,9,452,"C-F",12,12,"Indiana Pacers","Myles Turner",6,33,35,25,12,54
5,0,4,3,0,10,3,5,4,"37",0,3,10,4,3,0,3277502,"2023-11-24T00:00:00.000Z",12,FALSE,9,69,"G",12,12,"Indiana Pacers","Bruce Brown",3,14,19,15,9,31.3
10,0,2,13,5,23,9,3,3,"32",0,0,26,2,0,1,3277502,"2023-11-24T00:00:00.000Z",12,FALSE,9,3547245,"G",12,12,"Indiana Pacers","Tyrese Haliburton",0,28,38,36,12,42.4
0,0,1,2,1,12,6,2,2,"31",1,4,15,2,1,1,3277502,"2023-11-24T00:00:00.000Z",12,FALSE,9,38017686,"G-F",12,12,"Indiana Pacers","Bennedict Mathurin",1,17,17,15,2,19.4
0,0,5,2,2,3,2,2,2,"21",1,1,8,6,1,1,3277502,"2023-11-24T00:00:00.000Z",12,FALSE,9,3547264,"F-C",12,12,"Indiana Pacers","Jalen Smith",1,14,14,8,6,17.2
0,0,0,0,0,0,0,0,0,"00",0,0,0,0,0,0,3277502,"2023-11-24T00:00:00.000Z",12,FALSE,9,56677832,"F",12,12,"Indiana Pacers","Jarace Walker",0,0,0,0,0,0
0,0,0,0,0,0,0,0,0,"00",0,0,0,0,0,0,3277502,"2023-11-24T00:00:00.000Z",12,FALSE,9,38017701,"G",12,12,"Indiana Pacers","Kendall Brown",0,0,0,0,0,0
0,0,0,0,0,0,0,0,0,"00",0,0,0,0,0,0,3277502,"2023-11-24T00:00:00.000Z",12,FALSE,9,3547250,"G-F",12,12,"Indiana Pacers","Aaron Nesmith",0,0,0,0,0,0
0,0,0,0,0,0,0,0,0,"00",0,0,0,0,0,0,3277502,"2023-11-24T00:00:00.000Z",12,FALSE,9,56677778,"F-C",12,12,"Indiana Pacers","Oscar Tshiebwe",0,0,0,0,0,0
0,0,0,0,0,0,0,0,0,"00",0,0,0,0,0,0,3277502,"2023-11-24T00:00:00.000Z",12,FALSE,9,56677794,"G",12,12,"Indiana Pacers","Isaiah Wong",0,0,0,0,0,0
3,1,5,0,0,5,4,0,0,"30",1,2,8,6,0,1,3277502,"2023-11-24T00:00:00.000Z",12,FALSE,9,56677826,"G-F",9,9,"Detroit Pistons","Ausar Thompson",1,14,17,11,9,21.7
1,1,3,0,0,8,4,2,2,"27",3,1,10,6,2,0,3277502,"2023-11-24T00:00:00.000Z",12,FALSE,9,3547267,"F-C",9,9,"Detroit Pistons","Isaiah Stewart",3,16,17,11,7,27.7
2,3,3,0,0,6,3,0,0,"14",3,1,6,6,0,1,3277502,"2023-11-24T00:00:00.000Z",12,FALSE,9,24,"F",9,9,"Detroit Pistons","Marvin Bagley III",3,12,14,8,8,24.2
3,1,0,6,1,16,9,9,6,"32",2,3,25,2,1,3,3277502,"2023-11-24T00:00:00.000Z",12,FALSE,9,38017682,"G",9,9,"Detroit Pistons","Jaden Ivey",2,27,30,28,5,34.9
5,0,3,4,2,26,10,9,9,"38",0,0,31,3,0,4,3277502,"2023-11-24T00:00:00.000Z",12,FALSE,9,17896075,"G-F",9,9,"Detroit Pistons","Cade Cunningham",0,34,39,36,8,38.1
4,1,9,1,0,10,5,4,3,"29",4,5,13,13,1,2,3277502,"2023-11-24T00:00:00.000Z",12,FALSE,9,38017694,"C",9,9,"Detroit Pistons","Jalen Duren",2,26,30,17,17,38.6
0,0,2,4,2,5,3,0,0,"26",0,2,8,2,0,0,3277502,"2023-11-24T00:00:00.000Z",12,FALSE,9,17896071,"F",9,9,"Detroit Pistons","Isaiah Livers",0,10,10,8,2,10.4
1,1,2,3,2,6,2,0,0,"14",0,1,6,2,1,2,3277502,"2023-11-24T00:00:00.000Z",12,FALSE,9,77,"G",9,9,"Detroit Pistons","Alec Burks",2,8,9,7,3,13.9
3,0,1,0,0,6,3,0,0,"17",0,0,6,1,0,0,3277502,"2023-11-24T00:00:00.000Z",12,FALSE,9,3547241,"G",9,9,"Detroit Pistons","Killian Hayes",0,7,10,9,4,11.7
0,2,1,0,0,1,0,0,0,"08",1,3,0,2,1,1,3277502,"2023-11-24T00:00:00.000Z",12,FALSE,9,44477024,"G",9,9,"Detroit Pistons","Stanley Umude",3,2,2,0,2,10.4
0,0,0,0,0,0,0,0,0,"00",0,0,0,0,0,0,3277502,"2023-11-24T00:00:00.000Z",12,FALSE,9,259,"F",9,9,"Detroit Pistons","Kevin Knox",0,0,0,0,0,0
0,0,0,0,0,1,0,0,0,"05",0,0,0,0,0,0,3277502,"2023-11-24T00:00:00.000Z",12,FALSE,9,56677792,"G",9,9,"Detroit Pistons","Marcus Sasser",0,0,0,0,0,0
2,0,1,3,2,8,2,2,2,"30",1,4,8,2,0,2,3277503,"2023-11-24T00:00:00.000Z",11,FALSE,8,66,"G-F",11,11,"Houston Rockets","Dillon Brooks",0,10,12,10,4,11.4
1,1,11,3,2,9,6,2,2,"38",3,2,16,14,1,1,3277503,"2023-11-24T00:00:00.000Z",11,FALSE,8,38017684,"F",11,11,"Houston Rockets","Jabari Smith Jr.",2,30,31,17,15,39.3
8,1,13,4,0,19,8,6,5,"43",1,4,21,14,2,5,3277503,"2023-11-24T00:00:00.000Z",11,FALSE,8,17896062,"F-C",11,11,"Houston Rockets","Alperen Sengun",3,35,43,29,22,53.8
2,0,6,8,3,18,10,3,2,"36",0,0,25,6,2,3,3277503,"2023-11-24T00:00:00.000Z",11,FALSE,8,17895966,"G",11,11,"Houston Rockets","Jalen Green",2,31,33,27,8,38.2
11,2,6,5,3,12,6,2,2,"39",0,3,17,6,1,1,3277503,"2023-11-24T00:00:00.000Z",11,FALSE,8,458,"G",11,11,"Houston Rockets","Fred VanVleet",3,23,34,28,17,48.7
0,0,0,0,0,0,0,0,0,"00",0,0,0,0,0,0,3277503,"2023-11-24T00:00:00.000Z",11,FALSE,8,75,"G-F",11,11,"Houston Rockets","Reggie Bullock",0,0,0,0,0,0
1,0,3,2,1,6,3,0,0,"16",1,2,7,4,1,0,3277503,"2023-11-24T00:00:00.000Z",11,FALSE,8,38017695,"F",11,11,"Houston Rockets","Tari Eason",1,11,12,8,5,16.3
0,3,0,2,0,2,0,0,0,"08",0,0,0,0,0,0,3277503,"2023-11-24T00:00:00.000Z",11,FALSE,8,188,"F",11,11,"Houston Rockets","Jeff Green",3,0,0,0,0,9
0,1,0,1,1,4,3,0,0,"14",0,2,7,0,1,0,3277503,"2023-11-24T00:00:00.000Z",11,FALSE,8,213,"G",11,11,"Houston Rockets","Aaron Holiday",2,7,7,7,0,13
0,0,0,0,0,0,0,0,0,"00",0,0,0,0,0,0,3277503,"2023-11-24T00:00:00.000Z",11,FALSE,8,19465326,"C",11,11,"Houston Rockets","Jock Landale",0,0,0,0,0,0
0,0,0,0,0,0,0,0,0,"00",0,0,0,0,0,0,3277503,"2023-11-24T00:00:00.000Z",11,FALSE,8,296,"C",11,11,"Houston Rockets","Boban Marjanovic",0,0,0,0,0,0
0,1,3,1,0,4,2,0,0,"16",0,4,4,3,0,1,3277503,"2023-11-24T00:00:00.000Z",11,FALSE,8,3547301,"F",11,11,"Houston Rockets","Jae'Sean Tate",1,7,7,4,3,9.6
0,0,0,0,0,0,0,0,0,"00",0,0,0,0,0,0,3277503,"2023-11-24T00:00:00.000Z",11,FALSE,8,47738533,"G",11,11,"Houston Rockets","Jeenathan Williams",0,0,0,0,0,0
0,0,0,0,0,0,0,0,0,"00",0,0,0,0,0,0,3277503,"2023-11-24T00:00:00.000Z",11,FALSE,8,3547281,"G-F",11,11,"Houston Rockets","Nate Hinton",0,0,0,0,0,0
0,0,0,0,0,0,0,0,0,"00",0,0,0,0,0,0,3277503,"2023-11-24T00:00:00.000Z",11,FALSE,8,357,"G",11,11,"Houston Rockets","Victor Oladipo",0,0,0,0,0,0
0,0,0,0,0,0,0,0,0,"00",0,0,0,0,0,0,3277503,"2023-11-24T00:00:00.000Z",11,FALSE,8,56677809,"F",11,11,"Houston Rockets","Jermaine Samuels Jr.",0,0,0,0,0,0
0,0,0,0,0,0,0,0,0,"00",0,0,0,0,0,0,3277503,"2023-11-24T00:00:00.000Z",11,FALSE,8,56677825,"G-F",11,11,"Houston Rockets","Amen Thompson",0,0,0,0,0,0
0,0,0,0,0,0,0,0,0,"00",0,0,0,0,0,0,3277503,"2023-11-24T00:00:00.000Z",11,FALSE,8,56677831,"F",11,11,"Houston Rockets","Cam Whitmore",0,0,0,0,0,0
1,2,6,8,2,14,6,0,0,"37",1,1,14,7,1,1,3277503,"2023-11-24T00:00:00.000Z",11,FALSE,8,375,"F",8,8,"Denver Nuggets","Michael Porter Jr.",3,21,22,15,8,31.9
2,0,4,4,0,12,0,4,2,"39",3,1,2,7,0,1,3277503,"2023-11-24T00:00:00.000Z",11,FALSE,8,177,"F",8,8,"Denver Nuggets","Aaron Gordon",0,9,11,4,9,12.4
8,0,13,8,3,31,14,11,7,"42",6,3,38,19,2,3,3277503,"2023-11-24T00:00:00.000Z",11,FALSE,8,246,"C",8,8,"Denver Nuggets","Nikola Jokic",2,57,65,46,27,75.8
3,0,2,5,1,15,7,5,5,"39",3,4,20,5,3,2,3277503,"2023-11-24T00:00:00.000Z",11,FALSE,8,81,"G",8,8,"Denver Nuggets","Kentavious Caldwell-Pope",3,25,28,23,8,37.5
3,1,2,2,0,8,1,0,0,"25",2,0,2,4,0,5,3277503,"2023-11-24T00:00:00.000Z",11,FALSE,8,236,"G",8,8,"Denver Nuggets","Reggie Jackson",1,6,9,5,7,9.3
0,0,3,0,0,9,3,1,1,"26",0,1,7,3,0,0,3277503,"2023-11-24T00:00:00.000Z",11,FALSE,8,38017709,"G",8,8,"Denver Nuggets","Christian Braun",0,10,10,7,3,10.6
0,0,0,0,0,0,0,0,0,"03",0,0,0,0,0,1,3277503,"2023-11-24T00:00:00.000Z",11,FALSE,8,38017727,"G",8,8,"Denver Nuggets","Collin Gillespie",0,0,0,0,0,-1
0,0,0,2,1,2,1,0,0,"13",0,2,3,0,1,0,3277503,"2023-11-24T00:00:00.000Z",11,FALSE,8,215,"F-G",8,8,"Denver Nuggets","Justin Holiday",1,3,3,3,0,6
0,0,0,0,0,0,0,0,0,"00",0,0,0,0,0,0,3277503,"2023-11-24T00:00:00.000Z",11,FALSE,8,250,"C",8,8,"Denver Nuggets","DeAndre Jordan",0,0,0,0,0,0
0,0,0,0,0,0,0,0,0,"00",0,0,0,0,0,0,3277503,"2023-11-24T00:00:00.000Z",11,FALSE,8,17896007,"G",8,8,"Denver Nuggets","Braxton Key",0,0,0,0,0,0
0,0,0,0,0,1,0,0,0,"04",0,0,0,0,0,1,3277503,"2023-11-24T00:00:00.000Z",11,FALSE,8,3547268,"F-C",8,8,"Denver Nuggets","Zeke Nnaji",0,0,0,0,0,-1
0,0,0,0,0,0,0,0,0,"00",0,0,0,0,0,0,3277503,"2023-11-24T00:00:00.000Z",11,FALSE,8,56677582,"G",8,8,"Denver Nuggets","Jalen Pickett",0,0,0,0,0,0
0,0,0,0,0,0,0,0,0,"06",0,1,0,0,0,0,3277503,"2023-11-24T00:00:00.000Z",11,FALSE,8,56677776,"G",8,8,"Denver Nuggets","Julian Strawther",0,0,0,0,0,0
0,0,0,0,0,0,0,0,0,"00",0,0,0,0,0,0,3277503,"2023-11-24T00:00:00.000Z",11,FALSE,8,56677871,"F",8,8,"Denver Nuggets","Hunter Tyson",0,0,0,0,0,0
0,1,0,1,0,3,0,0,0,"06",1,1,0,1,0,0,3277503,"2023-11-24T00:00:00.000Z",11,FALSE,8,38017721,"G",8,8,"Denver Nuggets","Peyton Watson",1,1,1,0,1,4.2
0,0,0,0,0,0,0,0,0,"00",0,0,0,0,0,0,3277503,"2023-11-24T00:00:00.000Z",11,FALSE,8,666489,"F",8,8,"Denver Nuggets","Vlatko Cancar",0,0,0,0,0,0
0,0,0,0,0,0,0,0,0,"00",0,0,0,0,0,0,3277503,"2023-11-24T00:00:00.000Z",11,FALSE,8,17896103,"F-C",8,8,"Denver Nuggets","Jay Huff",0,0,0,0,0,0
0,0,0,0,0,0,0,0,0,"00",0,0,0,0,0,0,3277503,"2023-11-24T00:00:00.000Z",11,FALSE,8,335,"G",8,8,"Denver Nuggets","Jamal Murray",0,0,0,0,0,0
5,0,1,3,1,8,3,0,0,"13",0,1,7,1,0,1,3277504,"2023-11-24T00:00:00.000Z",17,FALSE,30,315,"F",17,17,"Milwaukee Bucks","Khris Middleton",0,8,13,12,6,14.7
3,1,6,0,0,19,11,12,9,"37",3,2,31,9,3,3,3277504,"2023-11-24T00:00:00.000Z",17,FALSE,30,15,"F",17,17,"Milwaukee Bucks","Giannis Antetokounmpo",4,40,43,34,12,55.3
1,3,5,7,4,17,14,7,7,"32",0,2,39,5,2,1,3277504,"2023-11-24T00:00:00.000Z",17,FALSE,30,283,"C",17,17,"Milwaukee Bucks","Brook Lopez",5,44,45,40,6,60.5
1,1,7,4,1,8,4,0,0,"27",4,3,9,11,0,2,3277504,"2023-11-24T00:00:00.000Z",17,FALSE,30,38,"G",17,17,"Milwaukee Bucks","Malik Beasley",1,20,21,10,12,24.7
10,0,6,5,2,18,11,8,7,"37",1,1,31,7,0,1,3277504,"2023-11-24T00:00:00.000Z",17,FALSE,30,278,"G",17,17,"Milwaukee Bucks","Damian Lillard",0,38,48,41,17,53.4
0,0,0,0,0,0,0,0,0,"00",0,0,0,0,0,0,3277504,"2023-11-24T00:00:00.000Z",17,FALSE,30,2148,"",17,17,"Milwaukee Bucks","Thanasis Antetokounmpo",0,0,0,0,0,0
2,0,3,2,0,4,0,4,3,"13",0,2,3,3,0,0,3277504,"2023-11-24T00:00:00.000Z",17,FALSE,30,38017676,"F",17,17,"Milwaukee Bucks","MarJon Beauchamp",0,6,8,5,5,9.6
1,0,4,3,0,5,1,2,0,"26",0,1,2,4,1,1,3277504,"2023-11-24T00:00:00.000Z",17,FALSE,30,105,"G",17,17,"Milwaukee Bucks","Pat Connaughton",1,6,7,3,5,10.3
0,0,0,4,1,4,1,0,0,"04",0,0,3,0,0,0,3277504,"2023-11-24T00:00:00.000Z",17,FALSE,30,38017733,"G",17,17,"Milwaukee Bucks","A.J. Green",0,3,3,3,0,3
1,0,1,0,0,0,0,0,0,"09",0,4,0,1,0,0,3277504,"2023-11-24T00:00:00.000Z",17,FALSE,30,56677852,"G",17,17,"Milwaukee Bucks","Andre Jackson Jr.",0,1,2,1,2,2.7
0,0,0,0,0,0,0,0,0,"00",0,0,0,0,0,0,3277504,"2023-11-24T00:00:00.000Z",17,FALSE,30,56677854,"F",17,17,"Milwaukee Bucks","Chris Livingston",0,0,0,0,0,0
0,0,0,0,0,0,0,0,0,"00",0,0,0,0,0,0,3277504,"2023-11-24T00:00:00.000Z",17,FALSE,30,284,"C",17,17,"Milwaukee Bucks","Robin Lopez",0,0,0,0,0,0
3,0,3,2,0,4,2,0,0,"17",0,3,4,3,0,0,3277504,"2023-11-24T00:00:00.000Z",17,FALSE,30,368,"G",17,17,"Milwaukee Bucks","Cameron Payne",0,7,10,7,6,12.1
1,1,4,1,0,5,1,0,0,"25",2,3,2,6,0,0,3277504,"2023-11-24T00:00:00.000Z",17,FALSE,30,377,"F",17,17,"Milwaukee Bucks","Bobby Portis",1,8,9,3,7,13.7
0,0,0,0,0,0,0,0,0,"00",0,0,0,0,0,0,3277504,"2023-11-24T00:00:00.000Z",17,FALSE,30,666960,"G",17,17,"Milwaukee Bucks","Lindell Wigginton",0,0,0,0,0,0
0,0,0,0,0,0,0,0,0,"00",0,0,0,0,0,0,3277504,"2023-11-24T00:00:00.000Z",17,FALSE,30,666453,"C",17,17,"Milwaukee Bucks","Marques Bolden",0,0,0,0,0,0
0,0,0,0,0,0,0,0,0,"00",0,0,0,0,0,0,3277504,"2023-11-24T00:00:00.000Z",17,FALSE,30,112,"F",17,17,"Milwaukee Bucks","Jae Crowder",0,0,0,0,0,0
0,0,0,0,0,0,0,0,0,"00",0,0,0,0,0,0,3277504,"2023-11-24T00:00:00.000Z",17,FALSE,30,38017691,"G",17,17,"Milwaukee Bucks","TyTy Washington Jr.",0,0,0,0,0,0
5,0,3,0,0,6,1,0,0,"28",2,3,2,5,0,0,3277504,"2023-11-24T00:00:00.000Z",17,FALSE,30,3547242,"F",30,30,"Washington Wizards","Deni Avdija",0,7,12,7,10,15.5
4,2,3,8,3,22,9,1,1,"31",1,3,22,4,0,1,3277504,"2023-11-24T00:00:00.000Z",17,FALSE,30,265,"F",30,30,"Washington Wizards","Kyle Kuzma",2,26,30,26,8,37.8
4,2,4,0,0,6,3,3,2,"29",5,5,8,9,1,1,3277504,"2023-11-24T00:00:00.000Z",17,FALSE,30,666577,"F",30,30,"Washington Wizards","Daniel Gafford",3,17,21,12,13,32.8
7,0,4,6,1,20,9,9,7,"34",1,5,26,5,0,2,3277504,"2023-11-24T00:00:00.000Z",17,FALSE,30,666848,"G",30,30,"Washington Wizards","Jordan Poole",0,31,38,33,12,40.5
7,0,7,4,1,14,9,3,3,"31",0,0,22,7,1,0,3277504,"2023-11-24T00:00:00.000Z",17,FALSE,30,249,"G",30,30,"Washington Wizards","Tyus Jones",1,29,36,29,14,43.9
1,0,5,10,6,12,7,0,0,"33",0,3,20,5,0,3,3277504,"2023-11-24T00:00:00.000Z",17,FALSE,30,17896045,"F",30,30,"Washington Wizards","Corey Kispert",0,25,26,21,6,24.5
1,0,4,2,1,5,2,2,2,"18",0,2,7,4,0,0,3277504,"2023-11-24T00:00:00.000Z",17,FALSE,30,167,"F",30,30,"Washington Wizards","Danilo Gallinari",0,11,12,8,5,13.3
0,0,0,0,0,0,0,0,0,"00",0,0,0,0,0,0,3277504,"2023-11-24T00:00:00.000Z",17,FALSE,30,38017704,"F",30,30,"Washington Wizards","Patrick Baldwin Jr.",0,0,0,0,0,0
0,0,0,0,0,0,0,0,0,"00",0,0,0,0,0,0,3277504,"2023-11-24T00:00:00.000Z",17,FALSE,30,18677954,"G",30,30,"Washington Wizards","Jared Butler",0,0,0,0,0,0
0,0,0,0,0,0,0,0,0,"00",0,0,0,0,0,0,3277504,"2023-11-24T00:00:00.000Z",17,FALSE,30,38124126,"F",30,30,"Washington Wizards","John Butler Jr.",0,0,0,0,0,0
0,0,2,7,3,11,6,1,0,"24",0,2,15,2,1,0,3277504,"2023-11-24T00:00:00.000Z",17,FALSE,30,414,"G",30,30,"Washington Wizards","Landry Shamet",1,17,17,15,2,20.4
0,0,0,0,0,0,0,0,0,"00",0,0,0,0,0,0,3277504,"2023-11-24T00:00:00.000Z",17,FALSE,30,3547302,"F",30,30,"Washington Wizards","Anthony Gill",0,0,0,0,0,0
0,0,0,0,0,0,0,0,0,"00",0,0,0,0,0,0,3277504,"2023-11-24T00:00:00.000Z",17,FALSE,30,337,"F-C",30,30,"Washington Wizards","Mike Muscala",0,0,0,0,0,0
0,0,0,0,0,0,0,0,0,"00",0,0,0,0,0,0,3277504,"2023-11-24T00:00:00.000Z",17,FALSE,30,17896106,"F",30,30,"Washington Wizards","Eugene Omoruyi",0,0,0,0,0,0
0,0,0,0,0,0,0,0,0,"00",0,0,0,0,0,0,3277504,"2023-11-24T00:00:00.000Z",17,FALSE,30,56677844,"G",30,30,"Washington Wizards","Bilal Coulibaly",0,0,0,0,0,0
0,0,0,0,0,0,0,0,0,"00",0,0,0,0,0,0,3277504,"2023-11-24T00:00:00.000Z",17,FALSE,30,38017712,"G",30,30,"Washington Wizards","Ryan Rollins",0,0,0,0,0,0
0,0,0,0,0,0,0,0,0,"00",0,0,0,0,0,0,3277504,"2023-11-24T00:00:00.000Z",17,FALSE,30,487,"G",30,30,"Washington Wizards","Delon Wright",0,0,0,0,0,0
0,0,2,0,0,4,2,2,2,"12",3,1,6,5,0,1,3277504,"2023-11-24T00:00:00.000Z",17,FALSE,30,38017687,"G",30,30,"Washington Wizards","Johnny Davis",0,11,11,6,5,11
12,0,5,7,3,32,14,6,5,"37",2,3,36,7,1,2,3277505,"2023-11-24T00:00:00.000Z",18,FALSE,26,161,"G",26,26,"Sacramento Kings","De'Aaron Fox",1,43,55,48,19,63.4
0,0,2,6,3,14,6,2,2,"30",0,2,17,2,1,3,3277505,"2023-11-24T00:00:00.000Z",18,FALSE,26,324,"G",26,26,"Sacramento Kings","Malik Monk",1,19,19,17,2,19.4
1,0,0,1,1,2,2,0,0,"09",0,1,5,0,0,1,3277505,"2023-11-24T00:00:00.000Z",18,FALSE,26,17553994,"G",26,26,"Sacramento Kings","Davion Mitchell",0,5,6,6,1,5.5
1,0,1,3,2,7,4,0,0,"18",1,1,10,2,1,0,3277505,"2023-11-24T00:00:00.000Z",18,FALSE,26,17896044,"F",26,26,"Sacramento Kings","Kessler Edwards",1,12,13,11,3,16.9
1,0,4,0,0,2,2,0,0,"08",2,1,4,6,0,0,3277505,"2023-11-24T00:00:00.000Z",18,FALSE,26,306,"C",26,26,"Sacramento Kings","JaVale McGee",0,10,11,5,7,12.7
0,0,6,6,3,6,3,0,0,"19",1,1,9,7,0,1,3277505,"2023-11-24T00:00:00.000Z",18,FALSE,26,290,"F",26,26,"Sacramento Kings","Trey Lyles",0,16,16,9,7,16.4
0,0,0,0,0,0,0,0,0,"00",0,0,0,0,0,0,3277505,"2023-11-24T00:00:00.000Z",18,FALSE,26,56677845,"G",26,26,"Sacramento Kings","Colby Jones",0,0,0,0,0,0
0,0,0,0,0,0,0,0,0,"00",0,0,0,0,0,0,3277505,"2023-11-24T00:00:00.000Z",18,FALSE,26,17895941,"C",26,26,"Sacramento Kings","Filip Petrusev",0,0,0,0,0,0
2,1,0,7,2,8,2,0,0,"22",1,4,6,1,2,0,3277505,"2023-11-24T00:00:00.000Z",18,FALSE,26,666400,"G",18,18,"Minnesota Timberwolves","Nickeil Alexander-Walker",3,7,9,8,3,19.2
4,0,10,5,4,15,9,5,5,"38",1,3,27,11,0,4,3277505,"2023-11-24T00:00:00.000Z",18,FALSE,26,447,"C",18,18,"Minnesota Timberwolves","Karl-Anthony Towns",0,38,42,31,15,42.2
0,2,8,0,0,8,5,2,2,"36",3,5,12,11,0,3,3277505,"2023-11-24T00:00:00.000Z",18,FALSE,26,176,"C",18,18,"Minnesota Timberwolves","Rudy Gobert",2,23,23,12,11,28.2
5,2,7,9,2,21,8,18,17,"40",0,2,35,7,2,4,3277505,"2023-11-24T00:00:00.000Z",18,FALSE,26,3547238,"G",18,18,"Minnesota Timberwolves","Anthony Edwards",4,42,47,40,12,58.9
8,0,2,3,2,7,2,0,0,"30",1,1,6,3,1,1,3277505,"2023-11-24T00:00:00.000Z",18,FALSE,26,104,"G",18,18,"Minnesota Timberwolves","Mike Conley",1,9,17,14,11,23.6
4,0,1,0,0,2,1,2,2,"18",0,1,4,1,0,0,3277505,"2023-11-24T00:00:00.000Z",18,FALSE,26,12,"F",18,18,"Minnesota Timberwolves","Kyle Anderson",0,5,9,8,5,11.2
0,1,4,5,1,8,4,2,1,"25",3,1,10,7,0,0,3277505,"2023-11-24T00:00:00.000Z",18,FALSE,26,68,"F",18,18,"Minnesota Timberwolves","Troy Brown Jr.",1,17,17,10,7,21.4
0,0,0,0,0,0,0,0,0,"00",0,0,0,0,0,0,3277505,"2023-11-24T00:00:00.000Z",18,FALSE,26,56677782,"F",18,18,"Minnesota Timberwolves","Leonard Miller",0,0,0,0,0,0
1,1,1,1,0,6,1,0,0,"13",1,1,2,2,1,3,3277505,"2023-11-24T00:00:00.000Z",18,FALSE,26,320,"G",18,18,"Minnesota Timberwolves","Shake Milton",2,4,5,3,3,8.9
0,0,0,0,0,0,0,0,0,"00",0,0,0,0,0,0,3277505,"2023-11-24T00:00:00.000Z",18,FALSE,26,38017715,"F",18,18,"Minnesota Timberwolves","Josh Minott",0,0,0,0,0,0
0,0,0,0,0,0,0,0,0,"00",0,0,0,0,0,0,3277505,"2023-11-24T00:00:00.000Z",18,FALSE,26,17895968,"F",18,18,"Minnesota Timberwolves","Daishen Nix",0,0,0,0,0,0
0,1,1,3,1,7,4,0,0,"18",0,0,9,1,0,3,3277505,"2023-11-24T00:00:00.000Z",18,FALSE,26,667378,"F-C",18,18,"Minnesota Timberwolves","Naz Reid",1,10,10,9,1,10.2
0,0,0,0,0,0,0,0,0,"00",0,0,0,0,0,0,3277505,"2023-11-24T00:00:00.000Z",18,FALSE,26,56677851,"G",18,18,"Minnesota Timberwolves","Jaylen Clark",0,0,0,0,0,0
0,0,0,0,0,0,0,0,0,"00",0,0,0,0,0,0,3277505,"2023-11-24T00:00:00.000Z",18,FALSE,26,17896056,"C",18,18,"Minnesota Timberwolves","Luka Garza",0,0,0,0,0,0
0,0,0,0,0,0,0,0,0,"00",0,0,0,0,0,0,3277505,"2023-11-24T00:00:00.000Z",18,FALSE,26,3547259,"F",18,18,"Minnesota Timberwolves","Jaden McDaniels",0,0,0,0,0,0
0,0,0,0,0,0,0,0,0,"00",0,0,0,0,0,0,3277505,"2023-11-24T00:00:00.000Z",18,FALSE,26,666767,"G",18,18,"Minnesota Timberwolves","Jordan McLaughlin",0,0,0,0,0,0
0,0,0,0,0,0,0,0,0,"00",0,0,0,0,0,0,3277505,"2023-11-24T00:00:00.000Z",18,FALSE,26,38017700,"G",18,18,"Minnesota Timberwolves","Wendell Moore Jr.",0,0,0,0,0,0
0,0,0,0,0,0,0,0,0,"00",0,0,0,0,0,0,3277505,"2023-11-24T00:00:00.000Z",18,FALSE,26,4197162,"F",26,26,"Sacramento Kings","Aleksandar Vezenkov",0,0,0,0,0,0
0,0,0,0,0,0,0,0,0,"00",0,0,0,0,0,0,3277505,"2023-11-24T00:00:00.000Z",18,FALSE,26,38017714,"G",26,26,"Sacramento Kings","Keon Ellis",0,0,0,0,0,0
0,0,0,0,0,0,0,0,0,"00",0,0,0,0,0,0,3277505,"2023-11-24T00:00:00.000Z",18,FALSE,26,17895990,"G",26,26,"Sacramento Kings","Jordan Ford",0,0,0,0,0,0
0,0,0,0,0,0,0,0,0,"00",0,0,0,0,0,0,3277505,"2023-11-24T00:00:00.000Z",18,FALSE,26,273,"C",26,26,"Sacramento Kings","Alex Len",0,0,0,0,0,0
0,0,0,0,0,0,0,0,0,"00",0,0,0,0,0,0,3277505,"2023-11-24T00:00:00.000Z",18,FALSE,26,38017688,"F",26,26,"Sacramento Kings","Keegan Murray",0,0,0,0,0,0
0,0,0,0,0,0,0,0,0,"00",0,0,0,0,0,0,3277505,"2023-11-24T00:00:00.000Z",18,FALSE,26,56677862,"F",26,26,"Sacramento Kings","Jalen Slawson",0,0,0,0,0,0
3,1,1,5,2,8,4,0,0,"25",1,1,10,2,0,0,3277505,"2023-11-24T00:00:00.000Z",18,FALSE,26,221,"G",26,26,"Sacramento Kings","Kevin Huerter",1,12,15,13,5,19.9
2,0,4,4,2,11,7,2,2,"33",0,0,18,4,0,2,3277505,"2023-11-24T00:00:00.000Z",18,FALSE,26,30,"F",26,26,"Sacramento Kings","Harrison Barnes",0,22,24,20,6,23.8
5,3,6,1,1,15,7,1,0,"39",5,6,15,11,3,2,3277505,"2023-11-24T00:00:00.000Z",18,FALSE,26,406,"F",26,26,"Sacramento Kings","Domantas Sabonis",6,26,31,20,16,51.7
0,0,3,2,0,3,0,0,0,"22",2,3,0,5,1,2,3277505,"2023-11-24T00:00:00.000Z",18,FALSE,26,17896030,"G",26,26,"Sacramento Kings","Chris Duarte",1,5,5,0,5,7
4,2,7,6,1,18,8,5,5,"35",2,2,22,9,1,6,3277506,"2023-11-24T00:00:00.000Z",10,FALSE,27,56677822,"F-C",27,27,"San Antonio Spurs","Victor Wembanyama",3,31,35,26,13,41.8
6,0,5,7,0,12,2,2,2,"31",3,3,6,8,0,3,3277506,"2023-11-24T00:00:00.000Z",10,FALSE,27,102,"F-C",27,27,"San Antonio Spurs","Zach Collins",0,14,20,12,14,21.6
1,0,0,5,0,9,3,0,0,"19",0,2,6,0,1,1,3277506,"2023-11-24T00:00:00.000Z",10,FALSE,27,38017692,"F",27,27,"San Antonio Spurs","Malaki Branham",1,6,7,7,1,9.5
6,0,2,7,3,11,3,7,6,"29",1,3,15,3,1,2,3277506,"2023-11-24T00:00:00.000Z",10,FALSE,27,443,"G",10,10,"Golden State Warriors","Klay Thompson",1,18,24,21,9,28.6
0,0,4,4,2,10,4,0,0,"25",0,3,10,4,0,3,3277506,"2023-11-24T00:00:00.000Z",10,FALSE,27,475,"F-G",10,10,"Golden State Warriors","Andrew Wiggins",0,14,14,10,4,11.8
4,0,7,0,0,3,2,3,2,"24",1,3,6,8,2,2,3277506,"2023-11-24T00:00:00.000Z",10,FALSE,27,282,"F",10,10,"Golden State Warriors","Kevon Looney",2,14,18,10,12,25.6
1,0,2,1,1,4,4,2,0,"17",2,0,9,4,0,2,3277506,"2023-11-24T00:00:00.000Z",10,FALSE,27,17553992,"G",10,10,"Golden State Warriors","Moses Moody",0,13,14,10,5,13.3
6,0,3,13,7,20,11,6,6,"35",0,2,35,3,1,6,3277506,"2023-11-24T00:00:00.000Z",10,FALSE,27,115,"G",10,10,"Golden State Warriors","Stephen Curry",1,38,44,41,9,44.6
0,0,0,0,0,0,0,0,0,"00",0,0,0,0,0,0,3277506,"2023-11-24T00:00:00.000Z",10,FALSE,27,185,"F",10,10,"Golden State Warriors","Draymond Green",0,0,0,0,0,0
0,1,0,0,0,1,0,2,2,"05",0,1,2,0,0,1,3277506,"2023-11-24T00:00:00.000Z",10,FALSE,27,56677799,"F",10,10,"Golden State Warriors","Trayce Jackson-Davis",1,2,2,2,0,4
0,0,0,0,0,0,0,0,0,"00",0,0,0,0,0,0,3277506,"2023-11-24T00:00:00.000Z",10,FALSE,27,251,"G",10,10,"Golden State Warriors","Cory Joseph",0,0,0,0,0,0
2,0,1,2,1,7,5,2,1,"20",0,0,12,1,0,1,3277506,"2023-11-24T00:00:00.000Z",10,FALSE,27,17553979,"F",10,10,"Golden State Warriors","Jonathan Kuminga",0,13,15,14,3,15.2
10,0,5,3,1,6,2,0,0,"29",0,2,5,5,0,1,3277506,"2023-11-24T00:00:00.000Z",10,FALSE,27,367,"G",10,10,"Golden State Warriors","Chris Paul",0,10,20,15,15,25
0,1,3,1,0,3,2,0,0,"18",0,4,4,3,1,2,3277506,"2023-11-24T00:00:00.000Z",10,FALSE,27,2189,"",10,10,"Golden State Warriors","Gary Payton II",2,7,7,4,3,11.6
2,0,2,2,0,5,0,0,0,"12",1,0,0,3,0,1,3277506,"2023-11-24T00:00:00.000Z",10,FALSE,27,56677858,"G",10,10,"Golden State Warriors","Brandin Podziemski",0,3,5,2,5,5.6
0,0,0,0,0,0,0,0,0,"00",0,0,0,0,0,0,3277506,"2023-11-24T00:00:00.000Z",10,FALSE,27,57875092,"F",10,10,"Golden State Warriors","Gui Santos",0,0,0,0,0,0
4,0,5,7,4,11,7,2,2,"26",2,3,20,7,2,3,3277506,"2023-11-24T00:00:00.000Z",10,FALSE,27,407,"F",10,10,"Golden State Warriors","Dario Saric",2,27,31,24,11,37.4
0,0,0,0,0,0,0,0,0,"00",0,0,0,0,0,0,3277506,"2023-11-24T00:00:00.000Z",10,FALSE,27,56677870,"G",27,27,"San Antonio Spurs","Sir'Jabari Rice",0,0,0,0,0,0
0,0,0,0,0,0,0,0,0,"00",0,0,0,0,0,0,3277506,"2023-11-24T00:00:00.000Z",10,FALSE,27,38017693,"G",27,27,"San Antonio Spurs","Blake Wesley",0,0,0,0,0,0
0,0,0,0,0,0,0,0,0,"00",0,0,0,0,0,0,3277506,"2023-11-24T00:00:00.000Z",10,FALSE,27,56677865,"C",27,27,"San Antonio Spurs","Charles Bediako",0,0,0,0,0,0
0,0,0,0,0,0,0,0,0,"00",0,0,0,0,0,0,3277506,"2023-11-24T00:00:00.000Z",10,FALSE,27,56677817,"G",27,27,"San Antonio Spurs","Sidy Cissoko",0,0,0,0,0,0
4,0,3,2,1,7,3,0,0,"33",3,2,7,6,0,2,3277506,"2023-11-24T00:00:00.000Z",10,FALSE,27,38017699,"F",27,27,"San Antonio Spurs","Jeremy Sochan",0,13,17,11,10,18.2
2,1,0,0,0,0,0,0,0,"07",0,0,0,0,0,0,3277506,"2023-11-24T00:00:00.000Z",10,FALSE,27,17895854,"G",27,27,"San Antonio Spurs","Charles Bassey",1,0,2,2,2,6
0,0,0,0,0,0,0,0,0,"00",0,0,0,0,0,0,3277506,"2023-11-24T00:00:00.000Z",10,FALSE,27,38017649,"F",27,27,"San Antonio Spurs","Julian Champagnie",0,0,0,0,0,0
0,0,0,0,0,0,0,0,0,"00",0,0,0,0,0,0,3277506,"2023-11-24T00:00:00.000Z",10,FALSE,27,180,"G",27,27,"San Antonio Spurs","Devonte' Graham",0,0,0,0,0,0
2,0,5,1,1,5,3,0,0,"17",0,1,7,5,2,1,3277506,"2023-11-24T00:00:00.000Z",10,FALSE,27,3547274,"G",27,27,"San Antonio Spurs","Tre Jones",2,12,14,9,7,21
0,0,0,0,0,0,0,0,0,"00",0,0,0,0,0,0,3277506,"2023-11-24T00:00:00.000Z",10,FALSE,27,17896059,"F",27,27,"San Antonio Spurs","Sandro Mamukelashvili",0,0,0,0,0,0
4,0,0,3,1,6,3,0,0,"19",1,0,7,1,3,0,3277506,"2023-11-24T00:00:00.000Z",10,FALSE,27,305,"F",27,27,"San Antonio Spurs","Doug McDermott",3,8,12,11,5,23.2
0,0,0,6,1,11,5,0,0,"18",1,3,11,1,0,1,3277506,"2023-11-24T00:00:00.000Z",10,FALSE,27,359,"F",27,27,"San Antonio Spurs","Cedi Osman",0,12,12,11,1,11.2
1,0,3,10,4,19,10,0,0,"27",1,2,24,4,1,2,3277506,"2023-11-24T00:00:00.000Z",10,FALSE,27,3547246,"G-F",27,27,"San Antonio Spurs","Devin Vassell",1,28,29,25,5,31.3
0,0,0,0,0,0,0,0,0,"00",0,0,0,0,0,0,3277506,"2023-11-24T00:00:00.000Z",10,FALSE,27,38017730,"F",27,27,"San Antonio Spurs","Dominick Barlow",0,0,0,0,0,0
0,0,0,0,0,0,0,0,0,"00",0,0,0,0,0,0,3277506,"2023-11-24T00:00:00.000Z",10,FALSE,27,17896070,"F",10,10,"Golden State Warriors","Usman Garuba",0,0,0,0,0,0
0,0,0,0,0,0,0,0,0,"00",0,0,0,0,0,0,3277506,"2023-11-24T00:00:00.000Z",10,FALSE,27,45658838,"G",10,10,"Golden State Warriors","Lester Quinones",0,0,0,0,0,0
0,0,0,0,0,0,0,0,0,"00",0,0,0,0,0,0,3277506,"2023-11-24T00:00:00.000Z",10,FALSE,27,398,"G",10,10,"Golden State Warriors","Jerome Robinson",0,0,0,0,0,0
4,0,8,7,3,13,8,5,3,"34",4,3,22,12,2,3,3277506,"2023-11-24T00:00:00.000Z",10,FALSE,27,666682,"F",27,27,"San Antonio Spurs","Keldon Johnson",2,34,38,26,16,45.4
3,1,7,7,1,17,8,4,3,"34",1,0,20,8,1,1,3277507,"2023-11-24T00:00:00.000Z",13,FALSE,19,274,"F",13,13,"LA Clippers","Kawhi Leonard",2,28,31,23,11,39.1
2,0,7,12,4,30,14,3,2,"39",1,3,34,8,0,2,3277507,"2023-11-24T00:00:00.000Z",13,FALSE,19,172,"F",13,13,"LA Clippers","Paul George",0,42,44,36,10,44.6
0,1,2,0,0,6,5,1,1,"21",3,4,11,5,0,4,3277507,"2023-11-24T00:00:00.000Z",13,FALSE,19,493,"C",13,13,"LA Clippers","Ivica Zubac",1,16,16,11,5,16
5,1,2,1,1,4,3,0,0,"24",0,5,7,2,2,0,3277507,"2023-11-24T00:00:00.000Z",13,FALSE,19,666743,"G",13,13,"LA Clippers","Terance Mann",3,9,14,12,7,25.9
10,1,5,6,1,8,2,6,3,"37",0,3,8,5,4,3,3277507,"2023-11-24T00:00:00.000Z",13,FALSE,19,192,"G",13,13,"LA Clippers","James Harden",5,13,23,18,15,41
0,0,1,5,3,14,8,1,1,"28",0,1,20,1,3,0,3277507,"2023-11-24T00:00:00.000Z",13,FALSE,19,380,"F-G",13,13,"LA Clippers","Norman Powell",3,21,21,20,1,30.2
2,3,4,2,1,3,1,0,0,"21",0,2,3,4,0,1,3277507,"2023-11-24T00:00:00.000Z",13,FALSE,19,439,"F",13,13,"LA Clippers","Daniel Theis",3,7,9,5,6,18.8
2,1,3,2,0,8,1,2,1,"14",1,2,3,4,0,0,3277507,"2023-11-24T00:00:00.000Z",13,FALSE,19,472,"G",13,13,"LA Clippers","Russell Westbrook",1,7,9,5,6,13.8
0,0,0,0,0,0,0,0,0,"00",0,0,0,0,0,0,3277507,"2023-11-24T00:00:00.000Z",13,FALSE,19,3547260,"G",19,19,"New Orleans Pelicans","Kira Lewis Jr.",0,0,0,0,0,0
1,0,6,3,0,7,0,6,5,"27",2,1,5,8,0,0,3277507,"2023-11-24T00:00:00.000Z",13,FALSE,19,3547293,"F",19,19,"New Orleans Pelicans","Naji Marshall",0,13,14,6,9,16.1
0,3,1,1,0,4,2,0,0,"20",1,1,4,2,0,1,3277507,"2023-11-24T00:00:00.000Z",13,FALSE,19,340,"F",19,19,"New Orleans Pelicans","Larry Nance Jr.",3,6,6,4,2,14.4
0,0,0,0,0,0,0,0,0,"00",0,0,0,0,0,0,3277507,"2023-11-24T00:00:00.000Z",13,FALSE,19,17896021,"F",19,19,"New Orleans Pelicans","Jeremiah Robinson-Earl",0,0,0,0,0,0
0,0,0,0,0,0,0,0,0,"00",0,0,0,0,0,0,3277507,"2023-11-24T00:00:00.000Z",13,FALSE,19,491,"C",19,19,"New Orleans Pelicans","Cody Zeller",0,0,0,0,0,0
0,0,0,0,0,0,0,0,0,"00",0,0,0,0,0,0,3277507,"2023-11-24T00:00:00.000Z",13,FALSE,19,38017663,"F",19,19,"New Orleans Pelicans","E.J. Liddell",0,0,0,0,0,0
0,0,0,0,0,0,0,0,0,"00",0,0,0,0,0,0,3277507,"2023-11-24T00:00:00.000Z",13,FALSE,19,303,"G",19,19,"New Orleans Pelicans","CJ McCollum",0,0,0,0,0,0
0,0,0,0,0,0,0,0,0,"00",0,0,0,0,0,0,3277507,"2023-11-24T00:00:00.000Z",13,FALSE,19,18677986,"F",19,19,"New Orleans Pelicans","Trey Murphy III",0,0,0,0,0,0
0,0,0,0,0,0,0,0,0,"00",0,0,0,0,0,0,3277507,"2023-11-24T00:00:00.000Z",13,FALSE,19,56677856,"G",13,13,"LA Clippers","Jordan Miller",0,0,0,0,0,0
0,0,0,0,0,0,0,0,0,"00",0,0,0,0,0,0,3277507,"2023-11-24T00:00:00.000Z",13,FALSE,19,24417679,"G",13,13,"LA Clippers","Xavier Moon",0,0,0,0,0,0
0,0,0,0,0,0,0,0,0,"00",0,0,0,0,0,0,3277507,"2023-11-24T00:00:00.000Z",13,FALSE,19,371,"F-C",13,13,"LA Clippers","Mason Plumlee",0,0,0,0,0,0
0,0,0,0,0,0,0,0,0,"00",0,0,0,0,0,0,3277507,"2023-11-24T00:00:00.000Z",13,FALSE,19,17896051,"G",13,13,"LA Clippers","Joshua Primo",0,0,0,0,0,0
5,0,4,5,2,21,12,6,4,"35",0,3,30,4,0,3,3277507,"2023-11-24T00:00:00.000Z",13,FALSE,19,227,"F",19,19,"New Orleans Pelicans","Brandon Ingram",0,34,39,35,9,39.3
5,0,4,1,0,25,13,9,6,"34",2,2,32,6,2,5,3277507,"2023-11-24T00:00:00.000Z",13,FALSE,19,666969,"F",19,19,"New Orleans Pelicans","Zion Williamson",2,38,43,37,11,47.7
4,0,6,2,2,6,4,2,2,"28",2,4,12,8,1,1,3277507,"2023-11-24T00:00:00.000Z",13,FALSE,19,455,"C",19,19,"New Orleans Pelicans","Jonas Valanciunas",1,20,24,16,12,29.6
4,1,2,4,3,7,5,2,1,"24",2,5,14,4,1,3,3277507,"2023-11-24T00:00:00.000Z",13,FALSE,19,17896024,"F",19,19,"New Orleans Pelicans","Herbert Jones",2,18,22,18,8,27.8
5,1,6,2,1,7,3,0,0,"36",2,2,7,8,1,1,3277507,"2023-11-24T00:00:00.000Z",13,FALSE,19,38017677,"G",19,19,"New Orleans Pelicans","Dyson Daniels",2,15,20,12,13,29.1
1,0,4,2,0,6,1,2,2,"16",1,0,4,5,1,1,3277507,"2023-11-24T00:00:00.000Z",13,FALSE,19,17896097,"G",19,19,"New Orleans Pelicans","Jose Alvarado",1,9,10,5,6,13.5
1,0,4,4,2,5,3,0,0,"20",0,1,8,4,0,0,3277507,"2023-11-24T00:00:00.000Z",13,FALSE,19,56677837,"G",19,19,"New Orleans Pelicans","Jordan Hawkins",0,12,13,9,5,14.3
3,0,0,2,0,2,0,0,0,"22",2,4,0,2,1,0,3277507,"2023-11-24T00:00:00.000Z",13,FALSE,19,450,"F",13,13,"LA Clippers","PJ Tucker",1,2,5,3,5,9.9
0,0,0,0,0,0,0,0,0,"00",0,0,0,0,0,0,3277507,"2023-11-24T00:00:00.000Z",13,FALSE,19,56677849,"F",13,13,"LA Clippers","Kobe Brown",0,0,0,0,0,0
0,0,0,0,0,0,0,0,0,"00",0,0,0,0,0,0,3277507,"2023-11-24T00:00:00.000Z",13,FALSE,19,666511,"G",13,13,"LA Clippers","Amir Coffey",0,0,0,0,0,0
0,0,0,0,0,0,0,0,0,"00",0,0,0,0,0,0,3277507,"2023-11-24T00:00:00.000Z",13,FALSE,19,38017725,"F",13,13,"LA Clippers","Moussa Diabate",0,0,0,0,0,0
0,0,0,0,0,0,0,0,0,"00",0,0,0,0,0,0,3277507,"2023-11-24T00:00:00.000Z",13,FALSE,19,17896031,"G",13,13,"LA Clippers","Nah'Shon Hyland",0,0,0,0,0,0
0,0,0,0,0,0,0,0,0,"00",0,0,0,0,0,0,3277507,"2023-11-24T00:00:00.000Z",13,FALSE,19,17896022,"G",13,13,"LA Clippers","Brandon Boston Jr.",0,0,0,0,0,0
0,0,0,0,0,0,0,0,0,"00",0,0,0,0,0,0,3277507,"2023-11-24T00:00:00.000Z",13,FALSE,19,17896017,"F",19,19,"New Orleans Pelicans","Matt Ryan",0,0,0,0,0,0
0,0,0,0,0,0,0,0,0,"00",0,0,0,0,0,0,3277507,"2023-11-24T00:00:00.000Z",13,FALSE,19,38017726,"G",19,19,"New Orleans Pelicans","Dereon Seabron",0,0,0,0,0,0
5,0,9,6,2,13,8,2,1,"35",1,2,19,10,2,1,1037824,"2023-11-25T00:00:00.000Z",3,FALSE,16,666679,"F",3,3,"Brooklyn Nets","Cameron Johnson",2,29,34,24,15,43.5
3,1,3,4,2,9,7,0,0,"34",2,0,16,5,0,0,1037824,"2023-11-25T00:00:00.000Z",3,FALSE,16,158,"F",3,3,"Brooklyn Nets","Dorian Finney-Smith",1,21,24,19,8,29.5
0,3,4,0,0,7,5,4,3,"24",2,1,13,6,2,0,1037824,"2023-11-25T00:00:00.000Z",3,FALSE,16,666508,"F-C",3,3,"Brooklyn Nets","Nicolas Claxton",5,19,19,13,6,35.2
3,1,5,6,3,19,8,5,5,"33",1,2,24,6,2,3,1037824,"2023-11-25T00:00:00.000Z",3,FALSE,16,61,"F",3,3,"Brooklyn Nets","Mikal Bridges",3,30,33,27,9,41.7
11,0,2,7,2,9,4,4,4,"36",0,2,14,2,2,3,1037824,"2023-11-25T00:00:00.000Z",3,FALSE,16,130,"G",3,3,"Brooklyn Nets","Spencer Dinwiddie",2,16,27,25,13,35.9
0,0,2,2,0,3,0,0,0,"04",1,0,0,3,0,0,1037824,"2023-11-25T00:00:00.000Z",3,FALSE,16,9051997,"G",3,3,"Brooklyn Nets","Armoni Brooks",0,3,3,0,3,3.6
0,0,1,0,0,0,0,0,0,"03",0,0,0,1,0,0,1037824,"2023-11-25T00:00:00.000Z",3,FALSE,16,56677843,"F",3,3,"Brooklyn Nets","Noah Clowney",0,1,1,0,1,1.2
0,0,0,0,0,0,0,0,0,"00",0,0,0,0,0,0,1037824,"2023-11-25T00:00:00.000Z",3,FALSE,16,174,"F-C",3,3,"Brooklyn Nets","Harry Giles III",0,0,0,0,0,0
4,1,1,5,2,6,2,0,0,"29",1,4,6,2,2,1,1037824,"2023-11-25T00:00:00.000Z",3,FALSE,16,351,"F",3,3,"Brooklyn Nets","Royce O'Neale",3,8,12,10,6,22.4
1,2,4,0,0,1,0,4,4,"12",0,2,4,4,0,0,1037824,"2023-11-25T00:00:00.000Z",3,FALSE,16,17896038,"C",3,3,"Brooklyn Nets","Day'Ron Sharpe",2,8,9,5,5,16.3
0,0,1,5,2,6,2,2,2,"14",0,1,8,1,0,2,1037824,"2023-11-25T00:00:00.000Z",3,FALSE,16,464,"G",3,3,"Brooklyn Nets","Lonnie Walker IV",0,9,9,8,1,7.2
0,0,2,1,1,5,3,0,0,"13",0,4,7,2,1,1,1037824,"2023-11-25T00:00:00.000Z",3,FALSE,16,17896058,"F",3,3,"Brooklyn Nets","Trendon Watford",1,9,9,7,2,11.4
0,1,0,0,0,0,0,2,1,"03",0,0,1,0,0,0,1037824,"2023-11-25T00:00:00.000Z",3,FALSE,16,56677841,"F",3,3,"Brooklyn Nets","Dariq Whitehead",1,1,1,1,0,4
0,0,0,0,0,0,0,0,0,"00",0,0,0,0,0,0,1037824,"2023-11-25T00:00:00.000Z",3,FALSE,16,17896041,"G",3,3,"Brooklyn Nets","Keon Johnson",0,0,0,0,0,0
0,0,1,1,0,5,1,0,0,"13",0,1,2,1,1,2,1037824,"2023-11-25T00:00:00.000Z",3,FALSE,16,74,"C",16,16,"Miami Heat","Thomas Bryant",1,3,3,2,1,4.2
5,1,3,5,0,11,4,3,3,"37",2,1,11,5,1,2,1037824,"2023-11-25T00:00:00.000Z",3,FALSE,16,391,"G-F",16,16,"Miami Heat","Josh Richardson",2,16,21,16,10,28.5
4,0,2,7,2,10,3,2,1,"30",1,2,9,3,2,3,1037824,"2023-11-25T00:00:00.000Z",3,FALSE,16,286,"G",16,16,"Miami Heat","Kyle Lowry",2,12,16,13,7,21.6
0,0,0,0,0,0,0,0,0,"00",0,0,0,0,0,0,1037824,"2023-11-25T00:00:00.000Z",3,FALSE,16,79,"G-F",16,16,"Miami Heat","Jimmy Butler",0,0,0,0,0,0
0,0,3,3,1,6,3,1,0,"29",0,1,7,3,1,1,1037824,"2023-11-25T00:00:00.000Z",3,FALSE,16,38017734,"F",16,16,"Miami Heat","Jamal Cain",1,10,10,7,3,12.6
5,0,5,1,0,3,0,2,1,"17",1,5,1,6,0,2,1037824,"2023-11-25T00:00:00.000Z",3,FALSE,16,38017696,"F",16,16,"Miami Heat","Nikola Jovic",0,7,12,6,11,13.7
2,0,7,0,0,4,3,2,2,"17",3,2,8,10,0,1,1037824,"2023-11-25T00:00:00.000Z",3,FALSE,16,285,"F-C",16,16,"Miami Heat","Kevin Love",0,18,20,10,12,22
3,0,3,4,1,18,9,3,3,"31",4,2,22,7,0,2,1037824,"2023-11-25T00:00:00.000Z",3,FALSE,16,666747,"F",16,16,"Miami Heat","Caleb Martin",0,29,32,25,10,32.9
1,1,0,7,3,8,4,0,0,"20",0,1,11,0,0,1,1037824,"2023-11-25T00:00:00.000Z",3,FALSE,16,38017736,"F",16,16,"Miami Heat","Cole Swider",1,11,12,12,1,14.5
0,0,0,0,0,0,0,0,0,"00",0,0,0,0,0,0,1037824,"2023-11-25T00:00:00.000Z",3,FALSE,16,4,"C-F",16,16,"Miami Heat","Bam Adebayo",0,0,0,0,0,0
0,0,0,0,0,0,0,0,0,"00",0,0,0,0,0,0,1037824,"2023-11-25T00:00:00.000Z",3,FALSE,16,3547257,"G",16,16,"Miami Heat","R.J. Hampton",0,0,0,0,0,0
0,0,0,0,0,0,0,0,0,"00",0,0,0,0,0,0,1037824,"2023-11-25T00:00:00.000Z",3,FALSE,16,666633,"G",16,16,"Miami Heat","Tyler Herro",0,0,0,0,0,0
0,0,0,0,0,0,0,0,0,"00",0,0,0,0,0,0,1037824,"2023-11-25T00:00:00.000Z",3,FALSE,16,397,"F",16,16,"Miami Heat","Duncan Robinson",0,0,0,0,0,0
0,0,0,0,0,0,0,0,0,"00",0,0,0,0,0,0,1037824,"2023-11-25T00:00:00.000Z",3,FALSE,16,39398582,"C",16,16,"Miami Heat","Orlando Robinson",0,0,0,0,0,0
0,0,0,0,0,0,0,0,0,"00",0,0,0,0,0,0,1037824,"2023-11-25T00:00:00.000Z",3,FALSE,16,19465585,"G",16,16,"Miami Heat","Dru Smith",0,0,0,0,0,0
0,0,0,0,0,0,0,0,0,"00",0,0,0,0,0,0,1037824,"2023-11-25T00:00:00.000Z",3,FALSE,16,417,"G-F",3,3,"Brooklyn Nets","Ben Simmons",0,0,0,0,0,0
0,0,0,0,0,0,0,0,0,"00",0,0,0,0,0,0,1037824,"2023-11-25T00:00:00.000Z",3,FALSE,16,421,"G",3,3,"Brooklyn Nets","Dennis Smith Jr.",0,0,0,0,0,0
0,0,0,0,0,0,0,0,0,"00",0,0,0,0,0,0,1037824,"2023-11-25T00:00:00.000Z",3,FALSE,16,17896048,"G",3,3,"Brooklyn Nets","Cam Thomas",0,0,0,0,0,0
0,0,0,0,0,0,0,0,0,"00",0,0,0,0,0,0,1037824,"2023-11-25T00:00:00.000Z",3,FALSE,16,56677722,"F",3,3,"Brooklyn Nets","Jalen Wilson",0,0,0,0,0,0
4,0,4,3,2,15,8,0,0,"31",1,1,18,5,1,2,1037824,"2023-11-25T00:00:00.000Z",3,FALSE,16,56677785,"G",16,16,"Miami Heat","Jaime Jaquez Jr.",1,23,27,22,9,31
0,1,3,3,2,7,3,0,0,"15",1,2,8,4,0,1,1037824,"2023-11-25T00:00:00.000Z",3,FALSE,16,3092,"",16,16,"Miami Heat","Haywood Highsmith",1,12,12,8,4,14.8
2,0,5,4,1,8,3,2,2,"17",1,2,9,6,0,3,1037825,"2023-11-25T00:00:00.000Z",30,FALSE,1,3547242,"F",30,30,"Washington Wizards","Deni Avdija",0,15,17,11,8,16.2
8,0,5,5,2,10,4,2,2,"25",2,1,12,7,0,5,1037825,"2023-11-25T00:00:00.000Z",30,FALSE,1,265,"F",30,30,"Washington Wizards","Kyle Kuzma",0,19,27,20,15,27.4
0,2,3,0,0,8,6,0,0,"18",1,2,12,4,0,0,1037825,"2023-11-25T00:00:00.000Z",30,FALSE,1,666577,"F",30,30,"Washington Wizards","Daniel Gafford",2,16,16,12,4,22.8
4,0,1,3,0,6,2,0,0,"24",1,1,4,2,0,2,1037825,"2023-11-25T00:00:00.000Z",30,FALSE,1,249,"G",30,30,"Washington Wizards","Tyus Jones",0,6,10,8,6,10.4
5,1,2,4,2,8,5,1,1,"16",0,4,13,2,2,2,1037825,"2023-11-25T00:00:00.000Z",30,FALSE,1,18677954,"G",30,30,"Washington Wizards","Jared Butler",3,15,20,18,7,29.9
2,1,3,2,1,5,3,0,0,"32",0,1,7,3,1,3,1037825,"2023-11-25T00:00:00.000Z",30,FALSE,1,56677844,"G",30,30,"Washington Wizards","Bilal Coulibaly",2,10,12,9,5,16.6
2,0,3,1,0,5,2,0,0,"16",0,1,4,3,1,1,1037825,"2023-11-25T00:00:00.000Z",30,FALSE,1,38017687,"G",30,30,"Washington Wizards","Johnny Davis",1,7,9,6,5,12.6
1,0,2,1,0,6,4,2,2,"17",1,1,10,3,0,2,1037825,"2023-11-25T00:00:00.000Z",30,FALSE,1,3547302,"F",30,30,"Washington Wizards","Anthony Gill",0,13,14,11,4,13.1
2,0,1,10,1,14,3,3,3,"28",0,2,10,1,0,0,1037825,"2023-11-25T00:00:00.000Z",30,FALSE,1,17896045,"F",30,30,"Washington Wizards","Corey Kispert",0,11,13,12,3,14.2
4,2,6,2,1,3,2,0,0,"18",0,0,5,6,0,1,1037825,"2023-11-25T00:00:00.000Z",30,FALSE,1,337,"F-C",30,30,"Washington Wizards","Mike Muscala",2,11,15,9,10,23.2
1,0,1,1,0,6,4,2,2,"12",2,1,10,3,1,0,1037825,"2023-11-25T00:00:00.000Z",30,FALSE,1,17896106,"F",30,30,"Washington Wizards","Eugene Omoruyi",1,13,14,11,4,18.1
1,0,3,3,3,9,6,1,0,"21",0,3,15,3,1,2,1037825,"2023-11-25T00:00:00.000Z",30,FALSE,1,53,"G",1,1,"Atlanta Hawks","Bogdan Bogdanovic",1,18,19,16,4,21.1
0,0,0,0,0,2,2,1,1,"05",1,0,5,1,0,1,1037825,"2023-11-25T00:00:00.000Z",30,FALSE,1,666564,"F",1,1,"Atlanta Hawks","Bruno Fernando",0,6,6,5,1,5.2
2,0,0,0,0,2,1,0,0,"09",0,1,2,0,0,1,1037825,"2023-11-25T00:00:00.000Z",30,FALSE,1,3547297,"G",1,1,"Atlanta Hawks","Trent Forrest",0,2,4,4,2,4
0,0,0,3,2,3,2,0,0,"06",0,0,6,0,0,0,1037825,"2023-11-25T00:00:00.000Z",30,FALSE,1,38017689,"F",1,1,"Atlanta Hawks","AJ Griffin",0,6,6,6,0,6
1,0,1,3,2,3,2,0,0,"14",1,1,6,2,0,0,1037825,"2023-11-25T00:00:00.000Z",30,FALSE,1,666754,"G",1,1,"Atlanta Hawks","Garrison Mathews",0,8,9,7,3,9.9
1,0,0,1,0,1,0,0,0,"08",0,0,0,0,0,0,1037825,"2023-11-25T00:00:00.000Z",30,FALSE,1,301,"G-F",1,1,"Atlanta Hawks","Wesley Matthews",0,0,1,1,1,1.5
0,0,1,1,1,2,1,0,0,"05",0,0,3,1,0,0,1037825,"2023-11-25T00:00:00.000Z",30,FALSE,1,319,"G",1,1,"Atlanta Hawks","Patty Mills",0,4,4,3,1,4.2
1,1,3,1,0,6,3,4,3,"25",3,2,9,6,1,0,1037825,"2023-11-25T00:00:00.000Z",30,FALSE,1,3547244,"F-C",1,1,"Atlanta Hawks","Onyeka Okongwu",2,15,16,10,7,23.7
0,0,0,0,0,0,0,0,0,"00",0,0,0,0,0,0,1037825,"2023-11-25T00:00:00.000Z",30,FALSE,1,56677838,"G",1,1,"Atlanta Hawks","Kobe Bufkin",0,0,0,0,0,0
0,0,0,0,0,0,0,0,0,"00",0,0,0,0,0,0,1037825,"2023-11-25T00:00:00.000Z",30,FALSE,1,56677806,"F",1,1,"Atlanta Hawks","Mouhamed Gueye",0,0,0,0,0,0
0,0,0,0,0,0,0,0,0,"00",0,0,0,0,0,0,1037825,"2023-11-25T00:00:00.000Z",30,FALSE,1,56677855,"G",1,1,"Atlanta Hawks","Seth Lundy",0,0,0,0,0,0
0,0,0,0,0,0,0,0,0,"00",0,0,0,0,0,0,1037825,"2023-11-25T00:00:00.000Z",30,FALSE,1,56677875,"F",1,1,"Atlanta Hawks","Miles Norris",0,0,0,0,0,0
0,0,0,0,0,0,0,0,0,"00",0,0,0,0,0,0,1037825,"2023-11-25T00:00:00.000Z",30,FALSE,1,666848,"G",30,30,"Washington Wizards","Jordan Poole",0,0,0,0,0,0
2,0,1,5,2,9,5,0,0,"17",0,1,12,1,0,1,1037825,"2023-11-25T00:00:00.000Z",30,FALSE,1,414,"G",30,30,"Washington Wizards","Landry Shamet",0,13,15,14,3,15.2
0,0,0,0,0,0,0,0,0,"00",0,0,0,0,0,0,1037825,"2023-11-25T00:00:00.000Z",30,FALSE,1,38017704,"F",30,30,"Washington Wizards","Patrick Baldwin Jr.",0,0,0,0,0,0
0,0,0,0,0,0,0,0,0,"00",0,0,0,0,0,0,1037825,"2023-11-25T00:00:00.000Z",30,FALSE,1,38124126,"F",30,30,"Washington Wizards","John Butler Jr.",0,0,0,0,0,0
0,0,0,0,0,0,0,0,0,"00",0,0,0,0,0,0,1037825,"2023-11-25T00:00:00.000Z",30,FALSE,1,167,"F",30,30,"Washington Wizards","Danilo Gallinari",0,0,0,0,0,0
0,0,0,0,0,0,0,0,0,"00",0,0,0,0,0,0,1037825,"2023-11-25T00:00:00.000Z",30,FALSE,1,38017712,"G",30,30,"Washington Wizards","Ryan Rollins",0,0,0,0,0,0
0,0,0,0,0,0,0,0,0,"00",0,0,0,0,0,0,1037825,"2023-11-25T00:00:00.000Z",30,FALSE,1,487,"G",30,30,"Washington Wizards","Delon Wright",0,0,0,0,0,0
0,0,3,5,3,11,7,3,3,"31",1,4,20,4,2,2,1037825,"2023-11-25T00:00:00.000Z",30,FALSE,1,666656,"F",1,1,"Atlanta Hawks","De'Andre Hunter",2,24,24,20,4,28.8
1,1,0,2,1,4,3,2,1,"09",1,0,8,1,2,0,1037825,"2023-11-25T00:00:00.000Z",30,FALSE,1,17896040,"F",1,1,"Atlanta Hawks","Jalen Johnson",3,9,10,9,2,19.7
1,0,4,0,0,14,6,2,0,"18",7,2,12,11,0,0,1037825,"2023-11-25T00:00:00.000Z",30,FALSE,1,83,"C",1,1,"Atlanta Hawks","Clint Capela",0,23,24,13,12,26.7
10,0,5,6,1,14,4,2,2,"27",0,0,11,5,4,0,1037825,"2023-11-25T00:00:00.000Z",30,FALSE,1,334,"G",1,1,"Atlanta Hawks","Dejounte Murray",4,16,26,21,15,44
1,0,6,4,0,14,6,2,1,"32",3,1,13,9,1,1,1037825,"2023-11-25T00:00:00.000Z",30,FALSE,1,3547256,"F",1,1,"Atlanta Hawks","Saddiq Bey",1,22,23,14,10,27.3
10,0,6,8,5,17,9,3,3,"30",0,1,26,6,2,2,1037825,"2023-11-25T00:00:00.000Z",30,FALSE,1,490,"G",1,1,"Atlanta Hawks","Trae Young",2,32,42,36,16,52.2
6,2,4,3,1,8,3,0,0,"32",0,0,7,4,1,0,1037826,"2023-11-25T00:00:00.000Z",6,FALSE,14,383,"F",14,14,"Los Angeles Lakers","Taurean Prince",3,11,17,13,10,29.8
6,2,5,9,1,23,8,7,5,"35",1,1,22,6,2,4,1037826,"2023-11-25T00:00:00.000Z",6,FALSE,14,237,"F",14,14,"Los Angeles Lakers","LeBron James",4,28,34,28,12,46.2
3,3,8,0,0,20,13,7,6,"38",5,3,32,13,2,5,1037826,"2023-11-25T00:00:00.000Z",6,FALSE,14,117,"F-C",14,14,"Los Angeles Lakers","Anthony Davis",5,45,48,35,16,62.1
3,0,4,4,2,7,5,0,0,"33",1,3,12,5,0,1,1037826,"2023-11-25T00:00:00.000Z",6,FALSE,14,38017697,"G",14,14,"Los Angeles Lakers","Max Christie",0,17,20,15,8,21.5
5,0,5,6,2,12,4,0,0,"32",0,3,10,5,2,4,1037826,"2023-11-25T00:00:00.000Z",6,FALSE,14,405,"G",14,14,"Los Angeles Lakers","D'Angelo Russell",2,15,20,15,10,25.5
0,0,0,0,0,0,0,0,0,"00",0,0,0,0,0,0,1037826,"2023-11-25T00:00:00.000Z",6,FALSE,14,56677867,"F",14,14,"Los Angeles Lakers","Alex Fudge",0,0,0,0,0,0
1,1,3,0,0,5,5,0,0,"21",0,3,10,3,0,1,1037826,"2023-11-25T00:00:00.000Z",6,FALSE,14,666626,"C",14,14,"Los Angeles Lakers","Jaxson Hayes",1,13,14,11,4,17.1
0,0,0,0,0,0,0,0,0,"00",0,0,0,0,0,0,1037826,"2023-11-25T00:00:00.000Z",6,FALSE,14,56677868,"G",14,14,"Los Angeles Lakers","D'Moi Hodge",0,0,0,0,0,0
0,0,0,0,0,0,0,0,0,"00",0,0,0,0,0,0,1037826,"2023-11-25T00:00:00.000Z",6,FALSE,14,56677835,"G",14,14,"Los Angeles Lakers","Jalen Hood-Schifino",0,0,0,0,0,0
0,0,0,0,0,0,0,0,0,"00",0,0,0,0,0,0,1037826,"2023-11-25T00:00:00.000Z",6,FALSE,14,56677836,"F",14,14,"Los Angeles Lakers","Maxwell Lewis",0,0,0,0,0,0
2,0,4,7,3,11,5,0,0,"34",0,2,13,4,1,3,1037826,"2023-11-25T00:00:00.000Z",6,FALSE,14,666908,"G",6,6,"Cleveland Cavaliers","Max Strus",1,17,19,15,6,20.8
6,1,5,0,0,12,8,3,2,"36",1,3,18,6,4,2,1037826,"2023-11-25T00:00:00.000Z",6,FALSE,14,17896076,"F-C",6,6,"Cleveland Cavaliers","Evan Mobley",5,24,30,24,12,47.2
3,2,9,0,0,12,9,4,3,"37",5,3,21,14,3,2,1037826,"2023-11-25T00:00:00.000Z",6,FALSE,14,9,"C",6,6,"Cleveland Cavaliers","Jarrett Allen",5,35,38,24,17,55.3
6,0,5,6,2,18,4,13,12,"35",0,0,22,5,1,1,1037826,"2023-11-25T00:00:00.000Z",6,FALSE,14,322,"G",6,6,"Cleveland Cavaliers","Donovan Mitchell",1,27,33,28,11,39
3,0,1,1,0,6,2,2,2,"14",0,1,6,1,1,2,1037826,"2023-11-25T00:00:00.000Z",6,FALSE,14,666581,"G",6,6,"Cleveland Cavaliers","Darius Garland",1,7,10,9,4,12.7
0,0,0,0,0,0,0,0,0,"00",0,0,0,0,0,0,1037826,"2023-11-25T00:00:00.000Z",6,FALSE,14,248,"C",6,6,"Cleveland Cavaliers","Damian Jones",0,0,0,0,0,0
8,0,1,4,0,9,3,0,0,"26",0,2,6,1,1,0,1037826,"2023-11-25T00:00:00.000Z",6,FALSE,14,277,"G",6,6,"Cleveland Cavaliers","Caris LeVert",1,7,15,14,9,22.2
0,0,0,0,0,0,0,0,0,"00",0,0,0,0,0,0,1037826,"2023-11-25T00:00:00.000Z",6,FALSE,14,3547299,"G",6,6,"Cleveland Cavaliers","Sam Merrill",0,0,0,0,0,0
1,0,2,9,3,13,5,0,0,"23",0,2,13,2,2,1,1037826,"2023-11-25T00:00:00.000Z",6,FALSE,14,344,"F",6,6,"Cleveland Cavaliers","Georges Niang",2,15,16,14,3,21.9
0,0,0,0,0,0,0,0,0,"00",0,0,0,0,0,0,1037826,"2023-11-25T00:00:00.000Z",6,FALSE,14,56677738,"C",14,14,"Los Angeles Lakers","Colin Castleton",0,0,0,0,0,0
0,0,0,0,0,0,0,0,0,"00",0,0,0,0,0,0,1037826,"2023-11-25T00:00:00.000Z",6,FALSE,14,666609,"F",14,14,"Los Angeles Lakers","Rui Hachimura",0,0,0,0,0,0
0,0,0,0,0,0,0,0,0,"00",0,0,0,0,0,0,1037826,"2023-11-25T00:00:00.000Z",6,FALSE,14,666860,"F-G",14,14,"Los Angeles Lakers","Cameron Reddish",0,0,0,0,0,0
0,0,0,0,0,0,0,0,0,"00",0,0,0,0,0,0,1037826,"2023-11-25T00:00:00.000Z",6,FALSE,14,457,"F",14,14,"Los Angeles Lakers","Jarred Vanderbilt",0,0,0,0,0,0
0,0,0,0,0,0,0,0,0,"00",0,0,0,0,0,0,1037826,"2023-11-25T00:00:00.000Z",6,FALSE,14,1603383,"G",14,14,"Los Angeles Lakers","Gabe Vincent",0,0,0,0,0,0
0,1,2,0,0,3,2,1,1,"18",1,1,5,3,0,2,1037826,"2023-11-25T00:00:00.000Z",6,FALSE,14,3547247,"F-G",6,6,"Cleveland Cavaliers","Isaac Okoro",1,8,8,5,3,9.6
1,0,1,1,1,7,5,0,0,"17",0,2,11,1,0,1,1037826,"2023-11-25T00:00:00.000Z",6,FALSE,14,56677872,"G",6,6,"Cleveland Cavaliers","Craig Porter",0,12,13,12,2,12.7
0,0,0,0,0,0,0,0,0,"00",0,0,0,0,0,0,1037826,"2023-11-25T00:00:00.000Z",6,FALSE,14,444,"C-F",6,6,"Cleveland Cavaliers","Tristan Thompson",0,0,0,0,0,0
0,0,0,0,0,0,0,0,0,"00",0,0,0,0,0,0,1037826,"2023-11-25T00:00:00.000Z",6,FALSE,14,56677847,"F",6,6,"Cleveland Cavaliers","Emoni Bates",0,0,0,0,0,0
0,0,0,0,0,0,0,0,0,"00",0,0,0,0,0,0,1037826,"2023-11-25T00:00:00.000Z",6,FALSE,14,666676,"G",6,6,"Cleveland Cavaliers","Ty Jerome",0,0,0,0,0,0
0,0,0,0,0,0,0,0,0,"00",0,0,0,0,0,0,1037826,"2023-11-25T00:00:00.000Z",6,FALSE,14,38017662,"F",6,6,"Cleveland Cavaliers","Isaiah Mobley",0,0,0,0,0,0
0,0,0,0,0,0,0,0,0,"00",0,0,0,0,0,0,1037826,"2023-11-25T00:00:00.000Z",6,FALSE,14,404,"G",6,6,"Cleveland Cavaliers","Ricky Rubio",0,0,0,0,0,0
0,0,0,0,0,0,0,0,0,"00",0,0,0,0,0,0,1037826,"2023-11-25T00:00:00.000Z",6,FALSE,14,666940,"F",6,6,"Cleveland Cavaliers","Dean Wade",0,0,0,0,0,0
10,0,4,2,1,8,4,6,6,"32",1,1,15,5,2,2,1037826,"2023-11-25T00:00:00.000Z",6,FALSE,14,17553995,"G",14,14,"Los Angeles Lakers","Austin Reaves",2,20,30,25,15,40
0,0,2,3,2,7,5,1,1,"17",1,1,13,3,0,1,1037826,"2023-11-25T00:00:00.000Z",6,FALSE,14,486,"F",14,14,"Los Angeles Lakers","Christian Wood",0,16,16,13,3,15.6
0,1,3,7,2,8,3,2,2,"26",0,1,10,3,0,2,1037827,"2023-11-25T00:00:00.000Z",29,FALSE,19,38017739,"F",29,29,"Utah Jazz","Simone Fontecchio",1,13,13,10,3,14.6
0,0,7,2,0,11,5,2,2,"24",2,1,12,9,0,3,1037827,"2023-11-25T00:00:00.000Z",29,FALSE,19,101,"F-C",29,29,"Utah Jazz","John Collins",0,21,21,12,9,19.8
0,2,5,3,0,6,3,0,0,"27",2,0,6,7,1,0,1037827,"2023-11-25T00:00:00.000Z",29,FALSE,19,11891374,"C",29,29,"Utah Jazz","Omer Yurtseven",3,13,13,6,7,23.4
2,0,2,0,0,7,4,0,0,"19",1,3,8,3,2,2,1037827,"2023-11-25T00:00:00.000Z",29,FALSE,19,139,"G",29,29,"Utah Jazz","Kris Dunn",2,11,13,10,5,18.6
5,0,6,9,4,13,4,5,3,"27",0,2,15,6,0,5,1037827,"2023-11-25T00:00:00.000Z",29,FALSE,19,56677834,"G",29,29,"Utah Jazz","Keyonte George",0,21,26,20,11,24.7
3,0,1,7,2,8,3,1,1,"22",0,1,9,1,3,1,1037827,"2023-11-25T00:00:00.000Z",29,FALSE,19,38017620,"G",29,29,"Utah Jazz","Ochai Agbaji",3,10,13,12,4,22.7
4,0,3,3,1,5,2,0,0,"22",0,1,5,3,0,2,1037827,"2023-11-25T00:00:00.000Z",29,FALSE,19,666650,"G",29,29,"Utah Jazz","Talen Horton-Tucker",0,8,12,9,7,12.6
0,2,5,1,0,10,5,1,1,"21",6,5,11,11,1,3,1037827,"2023-11-25T00:00:00.000Z",29,FALSE,19,38017705,"C",29,29,"Utah Jazz","Walker Kessler",3,22,22,11,11,30.2
3,1,5,3,3,6,4,2,2,"24",1,0,13,6,1,3,1037827,"2023-11-25T00:00:00.000Z",29,FALSE,19,358,"F",29,29,"Utah Jazz","Kelly Olynyk",2,19,22,16,9,27.7
0,0,0,0,0,0,0,0,0,"00",0,0,0,0,0,0,1037827,"2023-11-25T00:00:00.000Z",29,FALSE,19,666881,"F",29,29,"Utah Jazz","Luka Samanic",0,0,0,0,0,0
6,0,1,8,3,13,5,4,3,"28",2,0,16,3,0,2,1037827,"2023-11-25T00:00:00.000Z",29,FALSE,19,413,"G",29,29,"Utah Jazz","Collin Sexton",0,19,25,22,9,26.6
0,0,0,0,0,0,0,0,0,"00",0,0,0,0,0,0,1037827,"2023-11-25T00:00:00.000Z",29,FALSE,19,17896023,"G",29,29,"Utah Jazz","Josh Christopher",0,0,0,0,0,0
0,0,0,0,0,0,0,0,0,"00",0,0,0,0,0,0,1037827,"2023-11-25T00:00:00.000Z",29,FALSE,19,297,"F",29,29,"Utah Jazz","Lauri Markkanen",0,0,0,0,0,0
0,0,0,0,0,0,0,0,0,"00",0,0,0,0,0,0,1037827,"2023-11-25T00:00:00.000Z",29,FALSE,19,19465584,"F",29,29,"Utah Jazz","Micah Potter",0,0,0,0,0,0
0,0,0,0,0,0,0,0,0,"00",0,0,0,0,0,0,1037827,"2023-11-25T00:00:00.000Z",29,FALSE,19,56677842,"F",29,29,"Utah Jazz","Brice Sensabaugh",0,0,0,0,0,0
1,1,0,4,1,11,6,0,0,"26",1,3,13,1,1,1,1037827,"2023-11-25T00:00:00.000Z",29,FALSE,19,17896024,"F",19,19,"New Orleans Pelicans","Herbert Jones",2,14,15,14,2,20.7
8,0,5,4,1,22,10,8,5,"37",1,4,26,6,1,1,1037827,"2023-11-25T00:00:00.000Z",29,FALSE,19,227,"F",19,19,"New Orleans Pelicans","Brandon Ingram",1,32,40,34,14,47.2
2,0,2,2,0,10,3,4,2,"26",5,2,8,7,1,1,1037827,"2023-11-25T00:00:00.000Z",29,FALSE,19,455,"C",19,19,"New Orleans Pelicans","Jonas Valanciunas",1,15,17,10,9,21.4
3,0,5,12,5,17,8,5,4,"40",1,1,25,6,1,4,1037827,"2023-11-25T00:00:00.000Z",29,FALSE,19,56677837,"G",19,19,"New Orleans Pelicans","Jordan Hawkins",1,31,34,28,9,35.7
5,1,5,6,0,14,3,1,0,"34",1,1,6,6,6,5,1037827,"2023-11-25T00:00:00.000Z",29,FALSE,19,38017677,"G",19,19,"New Orleans Pelicans","Dyson Daniels",7,12,17,11,11,36.7
3,1,3,6,3,11,5,0,0,"23",1,4,13,4,2,0,1037827,"2023-11-25T00:00:00.000Z",29,FALSE,19,17896097,"G",19,19,"New Orleans Pelicans","Jose Alvarado",3,17,20,16,7,31.3
0,0,0,0,0,0,0,0,0,"00",0,0,0,0,0,0,1037827,"2023-11-25T00:00:00.000Z",29,FALSE,19,3547260,"G",19,19,"New Orleans Pelicans","Kira Lewis Jr.",0,0,0,0,0,0
4,0,3,2,1,6,2,0,0,"21",0,1,5,3,0,0,1037827,"2023-11-25T00:00:00.000Z",29,FALSE,19,3547293,"F",19,19,"New Orleans Pelicans","Naji Marshall",0,8,12,9,7,14.6
0,0,2,0,0,0,0,0,0,"12",1,1,0,3,3,1,1037827,"2023-11-25T00:00:00.000Z",29,FALSE,19,340,"F",19,19,"New Orleans Pelicans","Larry Nance Jr.",3,3,3,0,3,11.6
0,0,0,0,0,0,0,0,0,"00",0,0,0,0,0,0,1037827,"2023-11-25T00:00:00.000Z",29,FALSE,19,100,"G",29,29,"Utah Jazz","Jordan Clarkson",0,0,0,0,0,0
0,0,0,0,0,0,0,0,0,"00",0,0,0,0,0,0,1037827,"2023-11-25T00:00:00.000Z",29,FALSE,19,56677824,"F",29,29,"Utah Jazz","Taylor Hendricks",0,0,0,0,0,0
0,0,0,0,0,0,0,0,0,"00",0,0,0,0,0,0,1037827,"2023-11-25T00:00:00.000Z",29,FALSE,19,38017630,"G",29,29,"Utah Jazz","Johnny Juzang",0,0,0,0,0,0
0,0,0,0,0,0,0,0,0,"00",0,0,0,0,0,0,1037827,"2023-11-25T00:00:00.000Z",29,FALSE,19,17896021,"F",19,19,"New Orleans Pelicans","Jeremiah Robinson-Earl",0,0,0,0,0,0
0,0,0,0,0,0,0,0,0,"00",0,0,0,0,0,0,1037827,"2023-11-25T00:00:00.000Z",29,FALSE,19,666969,"F",19,19,"New Orleans Pelicans","Zion Williamson",0,0,0,0,0,0
5,1,4,0,0,2,2,0,0,"21",2,0,4,6,0,0,1037827,"2023-11-25T00:00:00.000Z",29,FALSE,19,491,"C",19,19,"New Orleans Pelicans","Cody Zeller",1,10,15,9,11,21.7
0,0,0,0,0,0,0,0,0,"00",0,0,0,0,0,0,1037827,"2023-11-25T00:00:00.000Z",29,FALSE,19,38017663,"F",19,19,"New Orleans Pelicans","E.J. Liddell",0,0,0,0,0,0
0,0,0,0,0,0,0,0,0,"00",0,0,0,0,0,0,1037827,"2023-11-25T00:00:00.000Z",29,FALSE,19,303,"G",19,19,"New Orleans Pelicans","CJ McCollum",0,0,0,0,0,0
0,0,0,0,0,0,0,0,0,"00",0,0,0,0,0,0,1037827,"2023-11-25T00:00:00.000Z",29,FALSE,19,18677986,"F",19,19,"New Orleans Pelicans","Trey Murphy III",0,0,0,0,0,0
0,0,0,0,0,0,0,0,0,"00",0,0,0,0,0,0,1037827,"2023-11-25T00:00:00.000Z",29,FALSE,19,17896017,"F",19,19,"New Orleans Pelicans","Matt Ryan",0,0,0,0,0,0
0,0,0,0,0,0,0,0,0,"00",0,0,0,0,0,0,1037827,"2023-11-25T00:00:00.000Z",29,FALSE,19,38017726,"G",19,19,"New Orleans Pelicans","Dereon Seabron",0,0,0,0,0,0
3,2,6,5,0,12,2,4,4,"29",0,1,8,6,0,2,1037828,"2023-11-25T00:00:00.000Z",13,FALSE,7,274,"F",13,13,"LA Clippers","Kawhi Leonard",2,14,17,11,9,23.7
4,0,8,5,2,19,9,5,5,"36",1,4,25,9,0,1,1037828,"2023-11-25T00:00:00.000Z",13,FALSE,7,172,"F",13,13,"LA Clippers","Paul George",0,34,38,29,13,40.8
1,0,10,0,0,8,5,5,1,"23",4,1,11,14,0,1,1037828,"2023-11-25T00:00:00.000Z",13,FALSE,7,493,"C",13,13,"LA Clippers","Ivica Zubac",0,25,26,12,15,28.3
1,1,1,4,0,14,7,4,3,"32",2,0,17,3,0,0,1037828,"2023-11-25T00:00:00.000Z",13,FALSE,7,666743,"G",13,13,"LA Clippers","Terance Mann",1,20,21,18,4,25.1
7,2,4,6,2,8,2,2,2,"28",0,1,8,4,1,2,1037828,"2023-11-25T00:00:00.000Z",13,FALSE,7,192,"G",13,13,"LA Clippers","James Harden",3,12,19,15,11,30.3
0,0,2,1,0,2,0,0,0,"05",1,0,0,3,0,0,1037828,"2023-11-25T00:00:00.000Z",13,FALSE,7,56677849,"F",13,13,"LA Clippers","Kobe Brown",0,3,3,0,3,3.6
1,0,0,0,0,0,0,0,0,"05",1,1,0,1,0,0,1037828,"2023-11-25T00:00:00.000Z",13,FALSE,7,666511,"G",13,13,"LA Clippers","Amir Coffey",0,1,2,1,2,2.7
0,0,0,0,0,2,0,2,1,"05",2,0,1,2,1,0,1037828,"2023-11-25T00:00:00.000Z",13,FALSE,7,38017725,"F",13,13,"LA Clippers","Moussa Diabate",1,3,3,1,2,6.4
0,0,0,3,1,4,1,0,0,"04",0,0,3,0,0,2,1037828,"2023-11-25T00:00:00.000Z",13,FALSE,7,17896031,"G",13,13,"LA Clippers","Nah'Shon Hyland",0,3,3,3,0,1
1,0,3,3,3,4,4,4,4,"24",0,2,15,3,0,1,1037828,"2023-11-25T00:00:00.000Z",13,FALSE,7,380,"F-G",13,13,"LA Clippers","Norman Powell",0,18,19,16,4,19.1
0,1,1,1,0,6,2,2,1,"16",2,2,5,3,0,1,1037828,"2023-11-25T00:00:00.000Z",13,FALSE,7,439,"F",13,13,"LA Clippers","Daniel Theis",1,8,8,5,3,10.6
0,0,1,0,0,0,0,0,0,"08",0,2,0,1,0,0,1037828,"2023-11-25T00:00:00.000Z",13,FALSE,7,450,"F",13,13,"LA Clippers","PJ Tucker",0,1,1,0,1,1.2
7,0,4,1,0,9,6,3,2,"25",4,2,14,8,0,2,1037828,"2023-11-25T00:00:00.000Z",13,FALSE,7,472,"G",13,13,"LA Clippers","Russell Westbrook",0,22,29,21,15,32.1
0,0,0,0,0,0,0,0,0,"00",0,0,0,0,0,0,1037828,"2023-11-25T00:00:00.000Z",13,FALSE,7,17896022,"G",13,13,"LA Clippers","Brandon Boston Jr.",0,0,0,0,0,0
0,0,0,0,0,0,0,0,0,"00",0,0,0,0,0,0,1037828,"2023-11-25T00:00:00.000Z",13,FALSE,7,56677856,"G",13,13,"LA Clippers","Jordan Miller",0,0,0,0,0,0
0,0,0,0,0,0,0,0,0,"00",0,0,0,0,0,0,1037828,"2023-11-25T00:00:00.000Z",13,FALSE,7,24417679,"G",13,13,"LA Clippers","Xavier Moon",0,0,0,0,0,0
0,0,0,0,0,0,0,0,0,"00",0,0,0,0,0,0,1037828,"2023-11-25T00:00:00.000Z",13,FALSE,7,371,"F-C",13,13,"LA Clippers","Mason Plumlee",0,0,0,0,0,0
0,0,0,0,0,0,0,0,0,"00",0,0,0,0,0,0,1037828,"2023-11-25T00:00:00.000Z",13,FALSE,7,17896051,"G",13,13,"LA Clippers","Joshua Primo",0,0,0,0,0,0
1,1,1,3,1,5,1,2,1,"20",0,1,4,1,1,0,1037828,"2023-11-25T00:00:00.000Z",13,FALSE,7,247,"F-G",7,7,"Dallas Mavericks","Derrick Jones Jr.",2,5,6,5,2,12.7
1,0,1,2,1,3,2,0,0,"35",3,4,5,4,0,1,1037828,"2023-11-25T00:00:00.000Z",13,FALSE,7,666965,"F",7,7,"Dallas Mavericks","Grant Williams",0,9,10,6,5,10.3
1,2,3,0,0,4,0,2,0,"21",2,3,0,5,0,0,1037828,"2023-11-25T00:00:00.000Z",13,FALSE,7,217,"F-C",7,7,"Dallas Mavericks","Richaun Holmes",2,5,6,1,6,13.5
3,0,6,7,3,22,11,1,1,"32",0,3,26,6,1,1,1037828,"2023-11-25T00:00:00.000Z",13,FALSE,7,228,"G",7,7,"Dallas Mavericks","Kyrie Irving",1,32,35,29,9,39.7
4,2,3,8,1,27,12,5,5,"38",0,4,30,3,2,4,1037828,"2023-11-25T00:00:00.000Z",13,FALSE,7,132,"F-G",7,7,"Dallas Mavericks","Luka Doncic",4,33,37,34,7,47.6
3,0,2,0,0,0,0,2,2,"15",0,2,2,2,0,0,1037828,"2023-11-25T00:00:00.000Z",13,FALSE,7,379,"F-C",7,7,"Dallas Mavericks","Dwight Powell",0,4,7,5,5,8.9
0,0,3,9,2,14,5,0,0,"29",0,2,12,3,0,1,1037828,"2023-11-25T00:00:00.000Z",13,FALSE,7,191,"G",7,7,"Dallas Mavericks","Tim Hardaway Jr.",0,15,15,12,3,14.6
1,0,1,1,0,2,0,0,0,"09",0,2,0,1,0,0,1037828,"2023-11-25T00:00:00.000Z",13,FALSE,7,3547258,"G",7,7,"Dallas Mavericks","Josh Green",0,1,2,1,2,2.7
2,0,5,1,0,4,1,0,0,"18",3,1,2,8,1,1,1037828,"2023-11-25T00:00:00.000Z",13,FALSE,7,151,"G",7,7,"Dallas Mavericks","Dante Exum",1,10,12,4,10,16.6
0,0,0,4,1,5,1,0,0,"08",0,2,3,0,0,0,1037828,"2023-11-25T00:00:00.000Z",13,FALSE,7,114,"G",7,7,"Dallas Mavericks","Seth Curry",0,3,3,3,0,3
1,0,2,1,0,3,1,2,2,"08",2,0,4,4,0,1,1037828,"2023-11-25T00:00:00.000Z",13,FALSE,7,38017679,"G",7,7,"Dallas Mavericks","Jaden Hardy",0,8,9,5,5,9.3
0,0,0,2,0,2,0,0,0,"07",0,0,0,0,1,0,1037828,"2023-11-25T00:00:00.000Z",13,FALSE,7,56677859,"F",7,7,"Dallas Mavericks","Olivier-Maxence Prosper",1,0,0,0,0,3
0,0,0,0,0,0,0,0,0,"00",0,0,0,0,0,0,1037828,"2023-11-25T00:00:00.000Z",13,FALSE,7,329,"F",7,7,"Dallas Mavericks","Markieff Morris",0,0,0,0,0,0
0,0,0,0,0,0,0,0,0,"00",0,0,0,0,0,0,1037828,"2023-11-25T00:00:00.000Z",13,FALSE,7,17896028,"F",7,7,"Dallas Mavericks","Greg Brown III",0,0,0,0,0,0
0,0,0,0,0,0,0,0,0,"00",0,0,0,0,0,0,1037828,"2023-11-25T00:00:00.000Z",13,FALSE,7,56677873,"G",7,7,"Dallas Mavericks","Dexter Dennis",0,0,0,0,0,0
0,0,0,0,0,0,0,0,0,"00",0,0,0,0,0,0,1037828,"2023-11-25T00:00:00.000Z",13,FALSE,7,257,"F",7,7,"Dallas Mavericks","Maxi Kleber",0,0,0,0,0,0
0,0,0,0,0,0,0,0,0,"00",0,0,0,0,0,0,1037828,"2023-11-25T00:00:00.000Z",13,FALSE,7,17554004,"G",7,7,"Dallas Mavericks","AJ Lawson",0,0,0,0,0,0
0,0,0,0,0,0,0,0,0,"00",0,0,0,0,0,0,1037828,"2023-11-25T00:00:00.000Z",13,FALSE,7,56677840,"C",7,7,"Dallas Mavericks","Dereck Lively II",0,0,0,0,0,0
0,0,1,3,1,5,2,1,0,"24",1,3,5,2,0,1,1037823,"2023-11-25T00:00:00.000Z",21,FALSE,23,666541,"G",21,21,"Oklahoma City Thunder","Luguentz Dort",0,7,7,5,2,6.4
1,0,0,0,0,2,0,0,0,"14",1,1,0,1,0,0,1037823,"2023-11-25T00:00:00.000Z",21,FALSE,23,56677833,"G",21,21,"Oklahoma City Thunder","Cason Wallace",0,1,2,1,2,2.7
2,3,5,11,5,21,13,2,2,"31",1,3,33,6,0,1,1037823,"2023-11-25T00:00:00.000Z",21,FALSE,23,38017685,"C-F",21,21,"Oklahoma City Thunder","Chet Holmgren",3,39,41,35,8,51.2
8,0,4,1,0,12,4,2,2,"26",3,4,10,7,0,1,1037823,"2023-11-25T00:00:00.000Z",21,FALSE,23,17896065,"G",21,21,"Oklahoma City Thunder","Josh Giddey",0,17,25,18,15,29.4
5,0,3,2,1,21,10,10,10,"36",3,3,31,6,2,1,1037823,"2023-11-25T00:00:00.000Z",21,FALSE,23,175,"G",21,21,"Oklahoma City Thunder","Shai Gilgeous-Alexander",2,37,42,36,11,50.7
1,0,1,2,1,3,1,3,2,"10",0,2,5,1,0,0,1037823,"2023-11-25T00:00:00.000Z",21,FALSE,23,44,"F",21,21,"Oklahoma City Thunder","Davis Bertans",0,6,7,6,2,7.7
2,0,0,1,0,2,0,0,0,"08",1,1,0,1,0,0,1037823,"2023-11-25T00:00:00.000Z",21,FALSE,23,38017716,"F",21,21,"Oklahoma City Thunder","Ousmane Dieng",0,1,3,2,3,4.2
2,0,3,12,3,14,4,2,2,"26",0,3,13,3,0,0,1037823,"2023-11-25T00:00:00.000Z",21,FALSE,23,3547272,"G",21,21,"Oklahoma City Thunder","Isaiah Joe",0,16,18,15,5,19.6
0,0,0,0,0,0,0,0,0,"00",0,0,0,0,0,0,1037823,"2023-11-25T00:00:00.000Z",21,FALSE,23,17896036,"G",21,21,"Oklahoma City Thunder","Tre Mann",0,0,0,0,0,0
0,0,0,0,0,0,0,0,0,"00",0,0,0,0,0,0,1037823,"2023-11-25T00:00:00.000Z",21,FALSE,23,4197029,"G",21,21,"Oklahoma City Thunder","Vasilije Micic",0,0,0,0,0,0
0,0,0,0,0,0,0,0,0,"00",0,0,0,0,0,0,1037823,"2023-11-25T00:00:00.000Z",21,FALSE,23,3547271,"C",21,21,"Oklahoma City Thunder","Aleksej Pokusevski",0,0,0,0,0,0
0,0,0,0,0,0,0,0,0,"00",0,0,0,0,0,0,1037823,"2023-11-25T00:00:00.000Z",21,FALSE,23,24572055,"C",21,21,"Oklahoma City Thunder","Olivier Sarr",0,0,0,0,0,0
1,0,1,3,1,4,2,4,2,"20",2,1,7,3,0,0,1037823,"2023-11-25T00:00:00.000Z",21,FALSE,23,17896078,"G",21,21,"Oklahoma City Thunder","Aaron Wiggins",0,10,11,8,4,12.1
5,0,5,5,2,9,3,0,0,"26",1,4,8,6,0,0,1037823,"2023-11-25T00:00:00.000Z",21,FALSE,23,38017706,"F",21,21,"Oklahoma City Thunder","Jaylin Williams",0,14,19,13,11,22.7
2,0,2,3,2,5,4,2,1,"19",0,2,11,2,1,0,1037823,"2023-11-25T00:00:00.000Z",21,FALSE,23,480,"G-F",21,21,"Oklahoma City Thunder","Kenrich Williams",1,13,15,13,4,19.4
0,0,0,0,0,0,0,0,0,"00",0,0,0,0,0,0,1037823,"2023-11-25T00:00:00.000Z",21,FALSE,23,56677853,"F",21,21,"Oklahoma City Thunder","Keyontae Johnson",0,0,0,0,0,0
0,0,0,0,0,0,0,0,0,"00",0,0,0,0,0,0,1037823,"2023-11-25T00:00:00.000Z",21,FALSE,23,27924547,"F",21,21,"Oklahoma City Thunder","Lindy Waters III",0,0,0,0,0,0
0,0,0,0,0,0,0,0,0,"00",0,0,0,0,0,0,1037823,"2023-11-25T00:00:00.000Z",21,FALSE,23,38017703,"G-F",21,21,"Oklahoma City Thunder","Jalen Williams",0,0,0,0,0,0
3,2,3,6,3,7,4,4,3,"33",4,0,14,7,0,1,1037823,"2023-11-25T00:00:00.000Z",21,FALSE,23,33,"F-G",23,23,"Philadelphia 76ers","Nicolas Batum",2,21,24,17,10,31.9
6,0,5,5,1,13,6,3,3,"31",0,3,16,5,0,3,1037823,"2023-11-25T00:00:00.000Z",21,FALSE,23,200,"F",23,23,"Philadelphia 76ers","Tobias Harris",0,21,27,22,11,28
9,4,7,4,0,18,8,21,19,"37",4,5,35,11,1,4,1037823,"2023-11-25T00:00:00.000Z",21,FALSE,23,145,"F-C",23,23,"Philadelphia 76ers","Joel Embiid",5,46,55,44,20,72.7
5,1,4,8,3,12,5,2,1,"30",3,3,14,7,0,0,1037823,"2023-11-25T00:00:00.000Z",21,FALSE,23,313,"G",23,23,"Philadelphia 76ers","De'Anthony Melton",1,21,26,19,12,32.9
3,1,7,9,3,17,8,11,9,"41",1,5,28,8,0,1,1037823,"2023-11-25T00:00:00.000Z",21,FALSE,23,3547254,"G",23,23,"Philadelphia 76ers","Tyrese Maxey",1,36,39,31,11,44.1
0,0,0,0,0,0,0,0,0,"00",0,0,0,0,0,0,1037823,"2023-11-25T00:00:00.000Z",21,FALSE,23,28,"C",23,23,"Philadelphia 76ers","Mo Bamba",0,0,0,0,0,0
4,0,2,3,1,5,2,2,1,"21",2,1,6,4,0,0,1037823,"2023-11-25T00:00:00.000Z",21,FALSE,23,45,"G",23,23,"Philadelphia 76ers","Patrick Beverley",0,10,14,10,8,16.8
0,1,1,3,2,5,3,2,1,"21",0,5,9,1,1,0,1037823,"2023-11-25T00:00:00.000Z",21,FALSE,23,108,"F",23,23,"Philadelphia 76ers","Robert Covington",2,10,10,9,1,16.2
0,0,0,0,0,0,0,0,0,"00",0,0,0,0,0,0,1037823,"2023-11-25T00:00:00.000Z",21,FALSE,23,260,"G-F",23,23,"Philadelphia 76ers","Furkan Korkmaz",0,0,0,0,0,0
0,0,0,0,0,0,0,0,0,"00",0,0,0,0,0,0,1037823,"2023-11-25T00:00:00.000Z",21,FALSE,23,3547294,"F",23,23,"Philadelphia 76ers","Kenyon Martin Jr.",0,0,0,0,0,0
0,0,2,2,0,2,0,0,0,"15",1,3,0,3,0,1,1037823,"2023-11-25T00:00:00.000Z",21,FALSE,23,328,"F",23,23,"Philadelphia 76ers","Marcus Morris",0,3,3,0,3,2.6
0,0,1,1,1,4,2,0,0,"11",2,1,5,3,0,2,1037823,"2023-11-25T00:00:00.000Z",21,FALSE,23,3547270,"F",23,23,"Philadelphia 76ers","Paul Reed",0,8,8,5,3,6.6
0,0,0,0,0,0,0,0,0,"00",0,0,0,0,0,0,1037823,"2023-11-25T00:00:00.000Z",21,FALSE,23,17896025,"G",23,23,"Philadelphia 76ers","Jaden Springer",0,0,0,0,0,0
0,0,0,0,0,0,0,0,0,"00",0,0,0,0,0,0,1037823,"2023-11-25T00:00:00.000Z",21,FALSE,23,56913527,"G",23,23,"Philadelphia 76ers","Ricky Council IV",0,0,0,0,0,0
0,0,0,0,0,0,0,0,0,"00",0,0,0,0,0,0,1037823,"2023-11-25T00:00:00.000Z",21,FALSE,23,2175,"",23,23,"Philadelphia 76ers","Danuel House Jr.",0,0,0,0,0,0
0,0,0,0,0,0,0,0,0,"00",0,0,0,0,0,0,1037823,"2023-11-25T00:00:00.000Z",21,FALSE,23,360,"F",23,23,"Philadelphia 76ers","Kelly Oubre Jr.",0,0,0,0,0,0
0,0,0,0,0,0,0,0,0,"00",0,0,0,0,0,0,1037823,"2023-11-25T00:00:00.000Z",21,FALSE,23,17554001,"G",23,23,"Philadelphia 76ers","Javonte Smart",0,0,0,0,0,0
0,0,0,0,0,0,0,0,0,"00",0,0,0,0,0,0,1037823,"2023-11-25T00:00:00.000Z",21,FALSE,23,56677788,"G",23,23,"Philadelphia 76ers","Terquavion Smith",0,0,0,0,0,0
0,0,1,0,0,0,0,0,0,"12",0,0,0,1,0,0,1037829,"2023-11-26T00:00:00.000Z",17,FALSE,25,56677852,"G",17,17,"Milwaukee Bucks","Andre Jackson Jr.",0,1,1,0,1,1.2
6,3,10,1,0,21,11,18,11,"39",6,5,33,16,1,4,1037829,"2023-11-26T00:00:00.000Z",17,FALSE,25,15,"F",17,17,"Milwaukee Bucks","Giannis Antetokounmpo",4,49,55,39,22,69.2
3,4,5,6,2,11,4,0,0,"31",1,3,10,6,3,0,1037829,"2023-11-26T00:00:00.000Z",17,FALSE,25,283,"C",17,17,"Milwaukee Bucks","Brook Lopez",7,16,19,13,9,42.7
0,0,5,11,4,14,5,0,0,"36",1,1,14,6,3,2,1037829,"2023-11-26T00:00:00.000Z",17,FALSE,25,38,"G",17,17,"Milwaukee Bucks","Malik Beasley",3,20,20,14,6,28.2
4,0,4,12,4,21,7,14,13,"37",1,2,31,5,2,3,1037829,"2023-11-26T00:00:00.000Z",17,FALSE,25,278,"G",17,17,"Milwaukee Bucks","Damian Lillard",2,36,40,35,9,46
0,0,2,0,0,0,0,0,0,"04",0,0,0,2,0,0,1037829,"2023-11-26T00:00:00.000Z",17,FALSE,25,2148,"",17,17,"Milwaukee Bucks","Thanasis Antetokounmpo",0,2,2,0,2,2.4
1,1,1,0,0,0,0,0,0,"09",0,2,0,1,0,1,1037829,"2023-11-26T00:00:00.000Z",17,FALSE,25,38017676,"F",17,17,"Milwaukee Bucks","MarJon Beauchamp",1,1,2,1,2,4.7
0,0,0,0,0,0,0,0,0,"00",0,0,0,0,0,0,1037829,"2023-11-26T00:00:00.000Z",17,FALSE,25,666453,"C",17,17,"Milwaukee Bucks","Marques Bolden",0,0,0,0,0,0
1,0,2,2,1,4,2,0,0,"20",2,1,5,4,1,2,1037829,"2023-11-26T00:00:00.000Z",17,FALSE,25,105,"G",17,17,"Milwaukee Bucks","Pat Connaughton",1,9,10,6,5,12.3
0,0,0,2,0,2,0,0,0,"04",1,1,0,1,0,0,1037829,"2023-11-26T00:00:00.000Z",17,FALSE,25,38017733,"G",17,17,"Milwaukee Bucks","A.J. Green",0,1,1,0,1,1.2
0,0,0,0,0,0,0,0,0,"00",0,0,0,0,0,0,1037829,"2023-11-26T00:00:00.000Z",17,FALSE,25,56677854,"F",17,17,"Milwaukee Bucks","Chris Livingston",0,0,0,0,0,0
0,0,0,0,0,0,0,0,0,"00",0,0,0,0,0,0,1037829,"2023-11-26T00:00:00.000Z",17,FALSE,25,284,"C",17,17,"Milwaukee Bucks","Robin Lopez",0,0,0,0,0,0
3,0,2,3,1,4,1,0,0,"17",0,2,3,2,1,3,1037829,"2023-11-26T00:00:00.000Z",17,FALSE,25,368,"G",17,17,"Milwaukee Bucks","Cameron Payne",1,5,8,6,5,9.9
0,0,0,0,0,0,0,0,0,"00",0,0,0,0,0,0,1037829,"2023-11-26T00:00:00.000Z",17,FALSE,25,666476,"C",25,25,"Portland Trail Blazers","Moses Brown",0,0,0,0,0,0
1,0,3,4,3,10,5,0,0,"27",1,5,13,4,0,2,1037829,"2023-11-26T00:00:00.000Z",17,FALSE,25,56677747,"G",25,25,"Portland Trail Blazers","Scoot Henderson",0,17,18,14,5,17.3
0,0,0,0,0,0,0,0,0,"00",0,0,0,0,0,0,1037829,"2023-11-26T00:00:00.000Z",17,FALSE,25,3547289,"G",25,25,"Portland Trail Blazers","Skylar Mays",0,0,0,0,0,0
0,0,0,0,0,0,0,0,0,"00",0,0,0,0,0,0,1037829,"2023-11-26T00:00:00.000Z",17,FALSE,25,47957121,"F",25,25,"Portland Trail Blazers","Justin Minaya",0,0,0,0,0,0
1,3,2,5,2,12,5,0,0,"31",6,3,12,8,2,2,1037829,"2023-11-26T00:00:00.000Z",17,FALSE,25,377,"F",17,17,"Milwaukee Bucks","Bobby Portis",5,20,21,13,9,36.1
0,0,0,0,0,0,0,0,0,"00",0,0,0,0,0,0,1037829,"2023-11-26T00:00:00.000Z",17,FALSE,25,38017691,"G",17,17,"Milwaukee Bucks","TyTy Washington Jr.",0,0,0,0,0,0
0,0,0,0,0,0,0,0,0,"00",0,0,0,0,0,0,1037829,"2023-11-26T00:00:00.000Z",17,FALSE,25,112,"F",17,17,"Milwaukee Bucks","Jae Crowder",0,0,0,0,0,0
0,0,0,0,0,0,0,0,0,"00",0,0,0,0,0,0,1037829,"2023-11-26T00:00:00.000Z",17,FALSE,25,315,"F",17,17,"Milwaukee Bucks","Khris Middleton",0,0,0,0,0,0
0,0,0,0,0,0,0,0,0,"00",0,0,0,0,0,0,1037829,"2023-11-26T00:00:00.000Z",17,FALSE,25,666960,"G",17,17,"Milwaukee Bucks","Lindell Wigginton",0,0,0,0,0,0
2,0,1,6,3,18,7,6,5,"39",1,3,22,2,4,4,1037829,"2023-11-26T00:00:00.000Z",17,FALSE,25,182,"F",25,25,"Portland Trail Blazers","Jerami Grant",4,24,26,24,4,35.4
0,0,1,2,2,3,2,0,0,"17",2,4,6,3,0,2,1037829,"2023-11-26T00:00:00.000Z",17,FALSE,25,56677850,"F",25,25,"Portland Trail Blazers","Toumani Camara",0,9,9,6,3,7.6
2,2,9,0,0,6,5,6,4,"32",4,3,14,13,1,0,1037829,"2023-11-26T00:00:00.000Z",17,FALSE,25,22,"C",25,25,"Portland Trail Blazers","Deandre Ayton",3,27,29,16,15,41.6
3,0,5,5,1,19,7,3,2,"37",1,0,17,6,2,3,1037829,"2023-11-26T00:00:00.000Z",17,FALSE,25,38017690,"G",25,25,"Portland Trail Blazers","Shaedon Sharpe",2,23,26,20,9,31.7
0,0,0,0,0,0,0,0,0,"00",0,0,0,0,0,0,1037829,"2023-11-26T00:00:00.000Z",17,FALSE,25,56677791,"F",25,25,"Portland Trail Blazers","Kris Murray",0,0,0,0,0,0
0,0,0,4,1,5,1,0,0,"12",0,2,3,0,2,1,1037829,"2023-11-26T00:00:00.000Z",17,FALSE,25,56783340,"C",25,25,"Portland Trail Blazers","Duop Reath",2,3,3,3,0,8
1,1,1,4,1,4,1,2,2,"26",0,1,5,1,4,2,1037829,"2023-11-26T00:00:00.000Z",17,FALSE,25,666923,"G-F",25,25,"Portland Trail Blazers","Matisse Thybulle",5,6,7,6,2,20.7
0,0,3,1,0,3,2,0,0,"16",0,4,4,3,0,1,1037829,"2023-11-26T00:00:00.000Z",17,FALSE,25,38017711,"F",25,25,"Portland Trail Blazers","Jabari Walker",0,7,7,4,3,6.6
0,0,0,0,0,0,0,0,0,"00",0,0,0,0,0,0,1037829,"2023-11-26T00:00:00.000Z",17,FALSE,25,39613724,"C",25,25,"Portland Trail Blazers","Ibou Badji",0,0,0,0,0,0
0,0,0,0,0,0,0,0,0,"00",0,0,0,0,0,0,1037829,"2023-11-26T00:00:00.000Z",17,FALSE,25,56677829,"G-F",25,25,"Portland Trail Blazers","Rayan Rupert",0,0,0,0,0,0
0,0,0,0,0,0,0,0,0,"00",0,0,0,0,0,0,1037829,"2023-11-26T00:00:00.000Z",17,FALSE,25,419,"G",25,25,"Portland Trail Blazers","Anfernee Simons",0,0,0,0,0,0
0,0,0,0,0,0,0,0,0,"00",0,0,0,0,0,0,1037829,"2023-11-26T00:00:00.000Z",17,FALSE,25,17896120,"F",25,25,"Portland Trail Blazers","Ish Wainright",0,0,0,0,0,0
0,0,0,0,0,0,0,0,0,"00",0,0,0,0,0,0,1037829,"2023-11-26T00:00:00.000Z",17,FALSE,25,476,"C-F",25,25,"Portland Trail Blazers","Robert Williams III",0,0,0,0,0,0
12,1,6,6,2,23,7,3,2,"34",2,4,18,8,2,2,1037829,"2023-11-26T00:00:00.000Z",17,FALSE,25,65,"G",25,25,"Portland Trail Blazers","Malcolm Brogdon",3,26,38,30,20,52.6
3,0,6,7,2,19,9,2,1,"36",1,4,21,7,1,2,1037830,"2023-11-26T00:00:00.000Z",2,FALSE,1,70,"G",2,2,"Boston Celtics","Jaylen Brown",1,28,31,24,10,34.9
4,0,8,13,5,25,11,10,7,"39",1,2,34,9,2,6,1037830,"2023-11-26T00:00:00.000Z",2,FALSE,1,434,"F",2,2,"Boston Celtics","Jayson Tatum",2,43,47,38,13,50.8
3,2,12,5,0,8,3,0,0,"32",3,1,6,15,1,0,1037830,"2023-11-26T00:00:00.000Z",2,FALSE,1,219,"C-F",2,2,"Boston Celtics","Al Horford",3,21,24,9,18,37.5
1,0,3,1,0,5,3,2,2,"19",2,4,8,5,0,1,1037830,"2023-11-26T00:00:00.000Z",2,FALSE,1,17896094,"G",2,2,"Boston Celtics","Dalano Banton",0,13,14,9,6,14.5
11,0,2,6,0,13,5,5,5,"38",2,5,15,4,3,3,1037830,"2023-11-26T00:00:00.000Z",2,FALSE,1,473,"G",2,2,"Boston Celtics","Derrick White",3,19,30,26,15,42.3
0,0,0,0,0,0,0,0,0,"00",0,0,0,0,0,0,1037830,"2023-11-26T00:00:00.000Z",2,FALSE,1,666468,"F",2,2,"Boston Celtics","Oshae Brissett",0,0,0,0,0,0
2,0,2,9,4,9,4,0,0,"32",2,2,12,4,0,0,1037830,"2023-11-26T00:00:00.000Z",2,FALSE,1,17896060,"F",2,2,"Boston Celtics","Sam Hauser",0,16,18,14,6,19.8
0,1,1,0,0,2,2,0,0,"09",1,1,4,2,1,0,1037830,"2023-11-26T00:00:00.000Z",2,FALSE,1,261,"F-C",2,2,"Boston Celtics","Luke Kornet",2,6,6,4,2,12.4
0,0,0,0,0,0,0,0,0,"00",0,0,0,0,0,0,1037830,"2023-11-26T00:00:00.000Z",2,FALSE,1,338,"G",2,2,"Boston Celtics","Svi Mykhailiuk",0,0,0,0,0,0
0,0,2,6,2,6,2,0,0,"20",0,0,6,2,0,0,1037830,"2023-11-26T00:00:00.000Z",2,FALSE,1,3547276,"G",2,2,"Boston Celtics","Payton Pritchard",0,8,8,6,2,8.4
0,0,4,0,0,8,3,1,1,"15",6,0,7,10,1,0,1037830,"2023-11-26T00:00:00.000Z",2,FALSE,1,17553967,"C",2,2,"Boston Celtics","Neemias Queta",1,17,17,7,10,22
0,0,0,0,0,0,0,0,0,"00",0,0,0,0,0,0,1037830,"2023-11-26T00:00:00.000Z",2,FALSE,1,3547279,"F",2,2,"Boston Celtics","Lamar Stevens",0,0,0,0,0,0
0,0,0,0,0,0,0,0,0,"00",0,0,0,0,0,0,1037830,"2023-11-26T00:00:00.000Z",2,FALSE,1,56677864,"G",2,2,"Boston Celtics","Jordan Walsh",0,0,0,0,0,0
0,0,0,0,0,0,0,0,0,"00",0,0,0,0,0,0,1037830,"2023-11-26T00:00:00.000Z",2,FALSE,1,38017707,"G",2,2,"Boston Celtics","JD Davison",0,0,0,0,0,0
0,0,0,0,0,0,0,0,0,"00",0,0,0,0,0,0,1037830,"2023-11-26T00:00:00.000Z",2,FALSE,1,214,"G",2,2,"Boston Celtics","Jrue Holiday",0,0,0,0,0,0
0,0,0,0,0,0,0,0,0,"00",0,0,0,0,0,0,1037830,"2023-11-26T00:00:00.000Z",2,FALSE,1,3547295,"F-C",2,2,"Boston Celtics","Nathan Knight",0,0,0,0,0,0
0,0,0,0,0,0,0,0,0,"00",0,0,0,0,0,0,1037830,"2023-11-26T00:00:00.000Z",2,FALSE,1,378,"F-C",2,2,"Boston Celtics","Kristaps Porzingis",0,0,0,0,0,0
2,1,4,11,5,14,7,5,5,"40",0,4,24,4,1,2,1037830,"2023-11-26T00:00:00.000Z",2,FALSE,1,666656,"F",1,1,"Atlanta Hawks","De'Andre Hunter",2,28,30,26,6,35.8
1,0,5,5,1,7,3,0,0,"29",3,3,7,8,0,0,1037830,"2023-11-26T00:00:00.000Z",2,FALSE,1,3547256,"F",1,1,"Atlanta Hawks","Saddiq Bey",0,15,16,8,9,18.1
1,2,4,0,0,5,1,6,2,"21",4,0,4,8,1,1,1037830,"2023-11-26T00:00:00.000Z",2,FALSE,1,83,"C",1,1,"Atlanta Hawks","Clint Capela",3,12,13,5,9,23.1
3,0,2,6,0,13,2,2,2,"34",2,1,6,4,0,3,1037830,"2023-11-26T00:00:00.000Z",2,FALSE,1,334,"G",1,1,"Atlanta Hawks","Dejounte Murray",0,10,13,9,7,12.3
7,0,4,16,6,27,12,6,3,"37",1,3,33,5,0,5,1037830,"2023-11-26T00:00:00.000Z",2,FALSE,1,490,"G",1,1,"Atlanta Hawks","Trae Young",0,38,45,40,12,44.5
0,0,6,10,7,12,8,0,0,"32",1,3,23,7,1,4,1037830,"2023-11-26T00:00:00.000Z",2,FALSE,1,53,"G",1,1,"Atlanta Hawks","Bogdan Bogdanovic",1,30,30,23,7,30.4
0,0,0,0,0,0,0,0,0,"00",0,0,0,0,0,0,1037830,"2023-11-26T00:00:00.000Z",2,FALSE,1,666564,"F",1,1,"Atlanta Hawks","Bruno Fernando",0,0,0,0,0,0
0,0,0,0,0,0,0,0,0,"00",0,0,0,0,0,0,1037830,"2023-11-26T00:00:00.000Z",2,FALSE,1,3547297,"G",1,1,"Atlanta Hawks","Trent Forrest",0,0,0,0,0,0
1,0,4,3,0,5,0,0,0,"12",0,0,0,4,0,0,1037830,"2023-11-26T00:00:00.000Z",2,FALSE,1,38017689,"F",1,1,"Atlanta Hawks","AJ Griffin",0,4,5,1,5,6.3
0,0,0,0,0,0,0,0,0,"00",0,0,0,0,0,0,1037830,"2023-11-26T00:00:00.000Z",2,FALSE,1,666754,"G",1,1,"Atlanta Hawks","Garrison Mathews",0,0,0,0,0,0
0,0,0,2,0,3,1,0,0,"08",0,1,2,0,0,0,1037830,"2023-11-26T00:00:00.000Z",2,FALSE,1,301,"G-F",1,1,"Atlanta Hawks","Wesley Matthews",0,2,2,2,0,2
0,0,0,0,0,0,0,0,0,"00",0,0,0,0,0,0,1037830,"2023-11-26T00:00:00.000Z",2,FALSE,1,319,"G",1,1,"Atlanta Hawks","Patty Mills",0,0,0,0,0,0
0,1,3,0,0,2,2,0,0,"27",0,2,4,3,2,0,1037830,"2023-11-26T00:00:00.000Z",2,FALSE,1,3547244,"F-C",1,1,"Atlanta Hawks","Onyeka Okongwu",3,7,7,4,3,16.6
0,0,0,0,0,0,0,0,0,"00",0,0,0,0,0,0,1037830,"2023-11-26T00:00:00.000Z",2,FALSE,1,56677838,"G",1,1,"Atlanta Hawks","Kobe Bufkin",0,0,0,0,0,0
0,0,0,0,0,0,0,0,0,"00",0,0,0,0,0,0,1037830,"2023-11-26T00:00:00.000Z",2,FALSE,1,56677806,"F",1,1,"Atlanta Hawks","Mouhamed Gueye",0,0,0,0,0,0
0,0,0,0,0,0,0,0,0,"00",0,0,0,0,0,0,1037830,"2023-11-26T00:00:00.000Z",2,FALSE,1,17896040,"F",1,1,"Atlanta Hawks","Jalen Johnson",0,0,0,0,0,0
0,0,0,0,0,0,0,0,0,"00",0,0,0,0,0,0,1037830,"2023-11-26T00:00:00.000Z",2,FALSE,1,56677855,"G",1,1,"Atlanta Hawks","Seth Lundy",0,0,0,0,0,0
0,0,0,0,0,0,0,0,0,"00",0,0,0,0,0,0,1037830,"2023-11-26T00:00:00.000Z",2,FALSE,1,56677875,"F",1,1,"Atlanta Hawks","Miles Norris",0,0,0,0,0,0
1,1,2,2,0,11,3,4,3,"31",0,3,9,2,0,0,1037831,"2023-11-26T00:00:00.000Z",20,FALSE,24,666423,"F-G",20,20,"New York Knicks","RJ Barrett",1,11,12,10,3,15.9
2,0,2,4,1,21,10,8,7,"36",3,2,28,5,0,2,1037831,"2023-11-26T00:00:00.000Z",20,FALSE,24,387,"F",20,20,"New York Knicks","Julius Randle",0,33,35,30,7,35
1,1,6,0,0,2,1,4,1,"34",5,2,3,11,1,1,1037831,"2023-11-26T00:00:00.000Z",20,FALSE,24,399,"C",20,20,"New York Knicks","Mitchell Robinson",2,14,15,4,12,22.7
2,0,2,3,1,5,1,0,0,"20",1,2,3,3,0,1,1037831,"2023-11-26T00:00:00.000Z",20,FALSE,24,17895858,"G",20,20,"New York Knicks","Quentin Grimes",0,6,8,5,5,8.6
8,1,6,10,5,25,15,2,0,"38",0,5,35,6,3,3,1037831,"2023-11-26T00:00:00.000Z",20,FALSE,24,73,"G",20,20,"New York Knicks","Jalen Brunson",4,41,49,43,14,63.2
0,0,0,0,0,0,0,0,0,"00",0,0,0,0,0,0,1037831,"2023-11-26T00:00:00.000Z",20,FALSE,24,19,"G",20,20,"New York Knicks","Ryan Arcidiacono",0,0,0,0,0,0
0,0,1,3,2,6,2,0,0,"14",0,1,6,1,2,0,1037831,"2023-11-26T00:00:00.000Z",20,FALSE,24,131,"G",20,20,"New York Knicks","Donte DiVincenzo",2,7,7,6,1,13.2
0,0,0,0,0,0,0,0,0,"00",0,0,0,0,0,0,1037831,"2023-11-26T00:00:00.000Z",20,FALSE,24,160,"G-F",20,20,"New York Knicks","Evan Fournier",0,0,0,0,0,0
2,0,3,2,0,3,1,2,2,"24",0,0,4,3,0,0,1037831,"2023-11-26T00:00:00.000Z",20,FALSE,24,202,"G",20,20,"New York Knicks","Josh Hart",0,7,9,6,5,10.6
1,1,1,0,0,3,2,4,3,"14",4,3,7,5,0,0,1037831,"2023-11-26T00:00:00.000Z",20,FALSE,24,201,"F-C",20,20,"New York Knicks","Isaiah Hartenstein",1,12,13,8,6,17.5
0,0,0,0,0,0,0,0,0,"00",0,0,0,0,0,0,1037831,"2023-11-26T00:00:00.000Z",20,FALSE,24,666675,"F",20,20,"New York Knicks","DaQuan Jeffries",0,0,0,0,0,0
0,0,0,0,0,0,0,0,0,"00",0,0,0,0,0,0,1037831,"2023-11-26T00:00:00.000Z",20,FALSE,24,17896033,"G",20,20,"New York Knicks","Miles McBride",0,0,0,0,0,0
1,1,2,6,3,11,4,8,7,"29",0,1,18,2,1,0,1037831,"2023-11-26T00:00:00.000Z",20,FALSE,24,3547269,"G",20,20,"New York Knicks","Immanuel Quickley",2,20,21,19,3,27.9
0,0,0,0,0,0,0,0,0,"00",0,0,0,0,0,0,1037831,"2023-11-26T00:00:00.000Z",20,FALSE,24,17896063,"F",20,20,"New York Knicks","Jericho Sims",0,0,0,0,0,0
0,0,0,0,0,0,0,0,0,"00",0,0,0,0,0,0,1037831,"2023-11-26T00:00:00.000Z",20,FALSE,24,666474,"G",20,20,"New York Knicks","Charles Brown",0,0,0,0,0,0
0,0,0,0,0,0,0,0,0,"00",0,0,0,0,0,0,1037831,"2023-11-26T00:00:00.000Z",20,FALSE,24,56677795,"F",20,20,"New York Knicks","Jacob Toppin",0,0,0,0,0,0
0,0,0,0,0,0,0,0,0,"00",0,0,0,0,0,0,1037831,"2023-11-26T00:00:00.000Z",20,FALSE,24,17896089,"G",20,20,"New York Knicks","Duane Washington Jr.",0,0,0,0,0,0
0,0,0,0,0,0,0,0,0,"00",0,0,0,0,0,0,1037831,"2023-11-26T00:00:00.000Z",20,FALSE,24,666971,"G-F",20,20,"New York Knicks","Dylan Windler",0,0,0,0,0,0
2,1,5,5,0,11,3,3,3,"27",2,3,9,7,2,1,1037831,"2023-11-26T00:00:00.000Z",20,FALSE,24,32,"F",24,24,"Phoenix Suns","Keita Bates-Diop",3,16,18,11,9,28.4
2,0,3,3,0,5,0,4,3,"17",1,3,3,4,1,2,1037831,"2023-11-26T00:00:00.000Z",20,FALSE,24,356,"G",24,24,"Phoenix Suns","Josh Okogie",1,7,9,5,6,11.8
4,4,6,2,0,9,4,0,0,"33",4,2,8,10,1,1,1037831,"2023-11-26T00:00:00.000Z",20,FALSE,24,349,"C",24,24,"Phoenix Suns","Jusuf Nurkic",5,18,22,12,14,40
11,2,3,4,1,25,10,8,7,"38",2,3,28,5,0,2,1037831,"2023-11-26T00:00:00.000Z",20,FALSE,24,57,"G",24,24,"Phoenix Suns","Devin Booker",2,33,44,39,16,54.5
2,1,2,9,6,13,9,2,1,"33",0,3,25,2,0,2,1037831,"2023-11-26T00:00:00.000Z",20,FALSE,24,178,"G",24,24,"Phoenix Suns","Eric Gordon",1,27,29,27,4,31.4
0,0,0,0,0,0,0,0,0,"00",0,0,0,0,0,0,1037831,"2023-11-26T00:00:00.000Z",20,FALSE,24,3547095,"C-F",24,24,"Phoenix Suns","Udoka Azubuike",0,0,0,0,0,0
0,0,0,0,0,0,0,0,0,"00",0,0,0,0,0,0,1037831,"2023-11-26T00:00:00.000Z",20,FALSE,24,666451,"C",24,24,"Phoenix Suns","Bol Bol",0,0,0,0,0,0
0,0,0,0,0,0,0,0,0,"00",0,0,0,0,0,0,1037831,"2023-11-26T00:00:00.000Z",20,FALSE,24,140,"F",24,24,"Phoenix Suns","Kevin Durant",0,0,0,0,0,0
1,0,2,0,0,2,1,2,1,"15",4,4,3,6,0,2,1037831,"2023-11-26T00:00:00.000Z",20,FALSE,24,147,"F",24,24,"Phoenix Suns","Drew Eubanks",0,9,10,4,7,9.7
5,1,4,3,2,10,6,0,0,"29",3,2,14,7,1,0,1037831,"2023-11-26T00:00:00.000Z",20,FALSE,24,18678058,"",24,24,"Phoenix Suns","Jordan Goodwin",2,21,26,19,12,35.9
0,0,0,0,0,0,0,0,0,"00",0,0,0,0,0,0,1037831,"2023-11-26T00:00:00.000Z",20,FALSE,24,3547298,"G",24,24,"Phoenix Suns","Saben Lee",0,0,0,0,0,0
0,2,2,6,3,9,4,0,0,"20",0,1,11,2,0,1,1037831,"2023-11-26T00:00:00.000Z",20,FALSE,24,666729,"F",24,24,"Phoenix Suns","Nassir Little",2,13,13,11,2,18.4
0,0,2,2,2,3,3,0,0,"13",2,3,8,4,0,0,1037831,"2023-11-26T00:00:00.000Z",20,FALSE,24,314,"F",24,24,"Phoenix Suns","Chimezie Metu",0,12,12,8,4,12.8
0,0,0,4,2,4,2,2,1,"15",0,1,7,0,0,0,1037831,"2023-11-26T00:00:00.000Z",20,FALSE,24,470,"G",24,24,"Phoenix Suns","Yuta Watanabe",0,7,7,7,0,7
0,0,0,0,0,0,0,0,0,"00",0,0,0,0,0,0,1037831,"2023-11-26T00:00:00.000Z",20,FALSE,24,8,"G",24,24,"Phoenix Suns","Grayson Allen",0,0,0,0,0,0
0,0,0,0,0,0,0,0,0,"00",0,0,0,0,0,0,1037831,"2023-11-26T00:00:00.000Z",20,FALSE,24,37,"G",24,24,"Phoenix Suns","Bradley Beal",0,0,0,0,0,0
0,0,0,0,0,0,0,0,0,"00",0,0,0,0,0,0,1037831,"2023-11-26T00:00:00.000Z",20,FALSE,24,272,"G",24,24,"Phoenix Suns","Damion Lee",0,0,0,0,0,0
4,0,2,0,0,3,2,0,0,"17",0,2,4,2,1,1,1037832,"2023-11-26T00:00:00.000Z",22,FALSE,4,422,"G",4,4,"Charlotte Hornets","Ish Smith",1,6,10,8,6,14.4
0,0,0,0,0,0,0,0,0,"00",0,0,0,0,0,0,1037832,"2023-11-26T00:00:00.000Z",22,FALSE,4,56677846,"G",4,4,"Charlotte Hornets","Nick Smith Jr.",0,0,0,0,0,0
0,0,0,3,2,4,2,0,0,"09",0,1,6,0,0,0,1037832,"2023-11-26T00:00:00.000Z",22,FALSE,4,18678001,"F",4,4,"Charlotte Hornets","JT Thor",0,6,6,6,0,6
2,3,4,9,3,10,3,6,4,"28",0,5,13,4,0,1,1037832,"2023-11-26T00:00:00.000Z",22,FALSE,4,666950,"F",4,4,"Charlotte Hornets","P.J. Washington",3,17,19,15,6,28.8
0,0,0,0,0,0,0,0,0,"00",0,0,0,0,0,0,1037832,"2023-11-26T00:00:00.000Z",22,FALSE,4,56677848,"G",4,4,"Charlotte Hornets","Amari Bailey",0,0,0,0,0,0
0,0,0,0,0,0,0,0,0,"00",0,0,0,0,0,0,1037832,"2023-11-26T00:00:00.000Z",22,FALSE,4,17896037,"G",4,4,"Charlotte Hornets","James Bouknight",0,0,0,0,0,0
2,0,6,3,2,15,11,9,6,"35",1,3,30,7,2,3,1037832,"2023-11-26T00:00:00.000Z",22,FALSE,4,17896026,"F",22,22,"Orlando Magic","Franz Wagner",2,37,39,32,9,44.4
8,0,7,5,2,18,9,6,3,"37",0,2,23,7,2,2,1037832,"2023-11-26T00:00:00.000Z",22,FALSE,4,38017683,"F",22,22,"Orlando Magic","Paolo Banchero",2,30,38,31,15,47.4
3,0,5,0,0,7,5,1,1,"20",2,4,11,7,1,2,1037832,"2023-11-26T00:00:00.000Z",22,FALSE,4,666442,"C",22,22,"Orlando Magic","Goga Bitadze",1,18,21,14,10,24.9
1,2,5,5,2,9,5,0,0,"32",0,2,12,5,1,1,1037832,"2023-11-26T00:00:00.000Z",22,FALSE,4,17896073,"G",22,22,"Orlando Magic","Jalen Suggs",3,17,18,13,6,27.5
3,0,0,1,0,4,1,0,0,"15",0,3,2,0,0,0,1037832,"2023-11-26T00:00:00.000Z",22,FALSE,4,56677827,"G",22,22,"Orlando Magic","Anthony Black",0,2,5,5,3,6.5
7,1,6,3,1,16,9,12,11,"32",1,3,30,7,2,2,1037832,"2023-11-26T00:00:00.000Z",22,FALSE,4,3547251,"G",22,22,"Orlando Magic","Cole Anthony",3,37,44,37,14,55.9
6,0,0,5,1,6,2,0,0,"24",0,2,5,0,1,0,1037832,"2023-11-26T00:00:00.000Z",22,FALSE,4,196,"G",22,22,"Orlando Magic","Gary Harris",1,5,11,11,6,17
0,0,1,2,1,2,1,3,3,"12",1,2,6,2,0,0,1037832,"2023-11-26T00:00:00.000Z",22,FALSE,4,38017724,"G",22,22,"Orlando Magic","Caleb Houstan",0,8,8,6,2,8.4
1,0,2,1,0,3,0,0,0,"15",0,2,0,2,1,2,1037832,"2023-11-26T00:00:00.000Z",22,FALSE,4,226,"F",22,22,"Orlando Magic","Joe Ingles",1,2,3,1,3,4.9
0,0,0,0,0,0,0,0,0,"00",0,0,0,0,0,0,1037832,"2023-11-26T00:00:00.000Z",22,FALSE,4,229,"F",22,22,"Orlando Magic","Jonathan Isaac",0,0,0,0,0,0
0,0,0,0,0,0,0,0,0,"00",0,0,0,0,0,0,1037832,"2023-11-26T00:00:00.000Z",22,FALSE,4,666818,"F",22,22,"Orlando Magic","Chuma Okeke",0,0,0,0,0,0
0,0,0,0,0,0,0,0,0,"00",0,0,0,0,0,0,1037832,"2023-11-26T00:00:00.000Z",22,FALSE,4,666885,"F",22,22,"Orlando Magic","Admiral Schofield",0,0,0,0,0,0
2,0,5,2,1,7,4,2,2,"18",2,3,11,7,0,2,1037832,"2023-11-26T00:00:00.000Z",22,FALSE,4,462,"C",22,22,"Orlando Magic","Moritz Wagner",0,18,20,13,9,20.4
0,0,0,0,0,0,0,0,0,"00",0,0,0,0,0,0,1037832,"2023-11-26T00:00:00.000Z",22,FALSE,4,85,"F",22,22,"Orlando Magic","Wendell Carter Jr.",0,0,0,0,0,0
0,0,0,0,0,0,0,0,0,"00",0,0,0,0,0,0,1037832,"2023-11-26T00:00:00.000Z",22,FALSE,4,165,"G",22,22,"Orlando Magic","Markelle Fultz",0,0,0,0,0,0
0,0,0,0,0,0,0,0,0,"00",0,0,0,0,0,0,1037832,"2023-11-26T00:00:00.000Z",22,FALSE,4,38017607,"G",22,22,"Orlando Magic","Kevon Harris",0,0,0,0,0,0
0,0,0,0,0,0,0,0,0,"00",0,0,0,0,0,0,1037832,"2023-11-26T00:00:00.000Z",22,FALSE,4,56677839,"G",22,22,"Orlando Magic","Jett Howard",0,0,0,0,0,0
0,0,0,0,0,0,0,0,0,"00",0,0,0,0,0,0,1037832,"2023-11-26T00:00:00.000Z",22,FALSE,4,17553983,"G",22,22,"Orlando Magic","Trevelin Queen",0,0,0,0,0,0
2,1,5,4,2,11,4,2,0,"33",0,1,10,5,0,3,1037832,"2023-11-26T00:00:00.000Z",22,FALSE,4,204,"F",4,4,"Charlotte Hornets","Gordon Hayward",1,15,17,12,7,19
2,1,7,4,1,17,9,6,4,"37",3,2,23,10,1,3,1037832,"2023-11-26T00:00:00.000Z",22,FALSE,4,62,"F",4,4,"Charlotte Hornets","Miles Bridges",2,33,35,25,12,41
1,1,5,0,0,6,5,2,2,"22",1,4,12,6,1,1,1037832,"2023-11-26T00:00:00.000Z",22,FALSE,4,38017698,"C",4,4,"Charlotte Hornets","Mark Williams",2,18,19,13,7,25.7
9,1,1,4,2,15,9,4,2,"37",0,4,22,1,1,5,1037832,"2023-11-26T00:00:00.000Z",22,FALSE,4,403,"G",4,4,"Charlotte Hornets","Terry Rozier",2,23,32,31,10,37.7
2,0,1,3,1,6,3,0,0,"14",0,0,7,1,0,1,1037832,"2023-11-26T00:00:00.000Z",22,FALSE,4,3547239,"G",4,4,"Charlotte Hornets","LaMelo Ball",0,8,10,9,3,10.2
0,0,0,0,0,0,0,0,0,"00",0,0,0,0,0,0,1037832,"2023-11-26T00:00:00.000Z",22,FALSE,4,56677866,"F",4,4,"Charlotte Hornets","Leaky Black",0,0,0,0,0,0
3,0,0,0,0,0,0,0,0,"04",0,0,0,0,0,0,1037832,"2023-11-26T00:00:00.000Z",22,FALSE,4,3547253,"G",4,4,"Charlotte Hornets","Theo Maledon",0,0,3,3,3,4.5
1,0,1,0,0,0,0,0,0,"06",1,2,0,2,1,1,1037832,"2023-11-26T00:00:00.000Z",22,FALSE,4,38017708,"G",4,4,"Charlotte Hornets","Bryce McGowens",1,2,3,1,3,5.9
1,0,5,3,2,11,7,5,4,"33",0,5,20,5,1,2,1037832,"2023-11-26T00:00:00.000Z",22,FALSE,4,56677823,"F",4,4,"Charlotte Hornets","Brandon Miller",1,25,26,21,6,28.5
0,0,0,0,0,0,0,0,0,"00",0,0,0,0,0,0,1037832,"2023-11-26T00:00:00.000Z",22,FALSE,4,666748,"F",4,4,"Charlotte Hornets","Cody Martin",0,0,0,0,0,0
0,0,0,0,0,0,0,0,0,"00",0,0,0,0,0,0,1037832,"2023-11-26T00:00:00.000Z",22,FALSE,4,347,"G",4,4,"Charlotte Hornets","Frank Ntilikina",0,0,0,0,0,0
0,0,0,0,0,0,0,0,0,"00",0,0,0,0,0,0,1037832,"2023-11-26T00:00:00.000Z",22,FALSE,4,3547282,"C",4,4,"Charlotte Hornets","Nick Richards",0,0,0,0,0,0
0,0,0,0,0,0,0,0,0,"00",0,0,0,0,0,0,1037833,"2023-11-26T00:00:00.000Z",15,FALSE,18,666505,"F",15,15,"Memphis Grizzlies","Brandon Clarke",0,0,0,0,0,0
0,0,0,0,0,0,0,0,0,"00",0,0,0,0,0,0,1037833,"2023-11-26T00:00:00.000Z",15,FALSE,18,56677830,"F",15,15,"Memphis Grizzlies","GG Jackson",0,0,0,0,0,0
0,0,0,0,0,0,0,0,0,"00",0,0,0,0,0,0,1037833,"2023-11-26T00:00:00.000Z",15,FALSE,18,254,"G",15,15,"Memphis Grizzlies","Luke Kennard",0,0,0,0,0,0
0,0,0,0,0,0,0,0,0,"00",0,0,0,0,0,0,1037833,"2023-11-26T00:00:00.000Z",15,FALSE,18,38017728,"F",15,15,"Memphis Grizzlies","Jake LaRavia",0,0,0,0,0,0
0,0,0,0,0,0,0,0,0,"00",0,0,0,0,0,0,1037833,"2023-11-26T00:00:00.000Z",15,FALSE,18,666786,"G",15,15,"Memphis Grizzlies","Ja Morant",0,0,0,0,0,0
0,0,0,0,0,0,0,0,0,"00",0,0,0,0,0,0,1037833,"2023-11-26T00:00:00.000Z",15,FALSE,18,420,"G",15,15,"Memphis Grizzlies","Marcus Smart",0,0,0,0,0,0
0,0,0,0,0,0,0,0,0,"00",0,0,0,0,0,0,1037833,"2023-11-26T00:00:00.000Z",15,FALSE,18,3547285,"F",15,15,"Memphis Grizzlies","Xavier Tillman",0,0,0,0,0,0
3,1,5,1,0,7,3,0,0,"23",1,3,6,6,0,0,1037833,"2023-11-26T00:00:00.000Z",15,FALSE,18,12,"F",18,18,"Minnesota Timberwolves","Kyle Anderson",1,12,15,9,9,20.7
1,0,2,4,2,4,2,0,0,"18",2,1,6,4,0,1,1037833,"2023-11-26T00:00:00.000Z",15,FALSE,18,68,"F",18,18,"Minnesota Timberwolves","Troy Brown Jr.",0,10,11,7,5,11.3
1,0,2,0,0,1,1,0,0,"02",0,0,2,2,0,0,1037833,"2023-11-26T00:00:00.000Z",15,FALSE,18,56677782,"F",18,18,"Minnesota Timberwolves","Leonard Miller",0,4,5,3,3,5.9
3,0,2,3,1,6,2,2,1,"19",0,2,6,2,1,1,1037833,"2023-11-26T00:00:00.000Z",15,FALSE,18,320,"G",18,18,"Minnesota Timberwolves","Shake Milton",1,8,11,9,5,14.9
0,0,0,1,0,2,1,0,0,"02",0,0,2,0,0,0,1037833,"2023-11-26T00:00:00.000Z",15,FALSE,18,38017715,"F",18,18,"Minnesota Timberwolves","Josh Minott",0,2,2,2,0,2
2,0,5,7,1,15,6,2,1,"27",2,0,14,7,0,1,1037833,"2023-11-26T00:00:00.000Z",15,FALSE,18,17896067,"F",15,15,"Memphis Grizzlies","Santi Aldama",0,21,23,16,9,24.4
3,3,4,6,2,14,4,10,8,"37",0,3,18,4,1,2,1037833,"2023-11-26T00:00:00.000Z",15,FALSE,18,231,"F-C",15,15,"Memphis Grizzlies","Jaren Jackson Jr.",4,22,25,21,7,37.3
3,0,3,0,0,3,2,10,6,"30",2,1,10,5,1,1,1037833,"2023-11-26T00:00:00.000Z",15,FALSE,18,48,"C",15,15,"Memphis Grizzlies","Bismack Biyombo",1,15,18,13,8,22.5
4,0,1,9,3,16,5,0,0,"34",1,3,13,2,0,5,1037833,"2023-11-26T00:00:00.000Z",15,FALSE,18,3547287,"G",15,15,"Memphis Grizzlies","Desmond Bane",0,15,19,17,6,16.4
1,0,0,2,0,2,0,0,0,"16",0,0,0,0,0,0,1037833,"2023-11-26T00:00:00.000Z",15,FALSE,18,48248287,"G",15,15,"Memphis Grizzlies","Jacob Gilyard",0,0,1,1,1,1.5
0,1,1,0,0,2,1,0,0,"02",0,0,2,1,0,0,1037833,"2023-11-26T00:00:00.000Z",15,FALSE,18,199,"G",15,15,"Memphis Grizzlies","Shaquille Harrison",1,3,3,2,1,6.2
0,0,0,0,0,0,0,0,0,"02",0,0,0,0,0,0,1037833,"2023-11-26T00:00:00.000Z",15,FALSE,18,666703,"G-F",15,15,"Memphis Grizzlies","John Konchar",0,0,0,0,0,0
0,0,0,0,0,1,1,0,0,"02",0,0,2,0,0,0,1037833,"2023-11-26T00:00:00.000Z",15,FALSE,18,38017732,"F",15,15,"Memphis Grizzlies","Kenneth Lofton Jr.",0,2,2,2,0,2
3,0,4,1,0,4,2,0,0,"14",1,1,4,5,0,0,1037833,"2023-11-26T00:00:00.000Z",15,FALSE,18,666809,"G",15,15,"Memphis Grizzlies","Jaylen Nowell",0,9,12,7,8,14.5
2,0,2,5,2,9,4,1,1,"28",2,2,11,4,0,1,1037833,"2023-11-26T00:00:00.000Z",15,FALSE,18,38017729,"F",15,15,"Memphis Grizzlies","David Roddy",0,15,17,13,6,17.8
4,0,0,2,0,12,5,2,2,"20",2,2,12,2,1,1,1037833,"2023-11-26T00:00:00.000Z",15,FALSE,18,401,"G",15,15,"Memphis Grizzlies","Derrick Rose",1,14,18,16,6,22.4
1,0,2,2,0,2,0,0,0,"10",1,1,0,3,1,0,1037833,"2023-11-26T00:00:00.000Z",15,FALSE,18,38017731,"G",15,15,"Memphis Grizzlies","Vince Williams Jr.",1,3,4,1,4,8.1
1,0,2,3,2,8,4,2,1,"18",0,5,11,2,0,2,1037833,"2023-11-26T00:00:00.000Z",15,FALSE,18,17896027,"G-F",15,15,"Memphis Grizzlies","Ziaire Williams",0,13,14,12,3,12.9
0,0,0,0,0,0,0,0,0,"00",0,0,0,0,0,0,1037833,"2023-11-26T00:00:00.000Z",15,FALSE,18,3,"C",15,15,"Memphis Grizzlies","Steven Adams",0,0,0,0,0,0
3,0,1,6,2,7,3,3,1,"34",0,2,9,1,1,1,1037833,"2023-11-26T00:00:00.000Z",15,FALSE,18,666400,"G",18,18,"Minnesota Timberwolves","Nickeil Alexander-Walker",1,10,13,12,4,16.7
2,1,8,3,1,11,7,3,3,"26",0,5,18,8,1,4,1037833,"2023-11-26T00:00:00.000Z",15,FALSE,18,447,"C",18,18,"Minnesota Timberwolves","Karl-Anthony Towns",2,26,28,20,10,32.6
0,2,3,0,0,7,5,4,3,"26",1,5,13,4,0,2,1037833,"2023-11-26T00:00:00.000Z",15,FALSE,18,176,"C",18,18,"Minnesota Timberwolves","Rudy Gobert",2,17,17,13,4,21.8
6,1,5,4,1,14,8,7,7,"34",0,3,24,5,0,2,1037833,"2023-11-26T00:00:00.000Z",15,FALSE,18,3547238,"G",18,18,"Minnesota Timberwolves","Anthony Edwards",1,29,35,30,11,40
10,0,4,9,6,11,6,0,0,"32",0,1,18,4,1,2,1037833,"2023-11-26T00:00:00.000Z",15,FALSE,18,104,"G",18,18,"Minnesota Timberwolves","Mike Conley",1,22,32,28,14,38.8
0,0,4,2,1,9,4,4,3,"22",2,4,12,6,1,1,1037833,"2023-11-26T00:00:00.000Z",15,FALSE,18,667378,"F-C",18,18,"Minnesota Timberwolves","Naz Reid",1,18,18,12,6,21.2
0,0,0,0,0,0,0,0,0,"00",0,0,0,0,0,0,1037833,"2023-11-26T00:00:00.000Z",15,FALSE,18,56677851,"G",18,18,"Minnesota Timberwolves","Jaylen Clark",0,0,0,0,0,0
0,0,0,0,0,0,0,0,0,"00",0,0,0,0,0,0,1037833,"2023-11-26T00:00:00.000Z",15,FALSE,18,17896056,"C",18,18,"Minnesota Timberwolves","Luka Garza",0,0,0,0,0,0
0,0,0,0,0,0,0,0,0,"00",0,0,0,0,0,0,1037833,"2023-11-26T00:00:00.000Z",15,FALSE,18,3547259,"F",18,18,"Minnesota Timberwolves","Jaden McDaniels",0,0,0,0,0,0
0,0,0,0,0,0,0,0,0,"00",0,0,0,0,0,0,1037833,"2023-11-26T00:00:00.000Z",15,FALSE,18,666767,"G",18,18,"Minnesota Timberwolves","Jordan McLaughlin",0,0,0,0,0,0
0,0,0,0,0,0,0,0,0,"00",0,0,0,0,0,0,1037833,"2023-11-26T00:00:00.000Z",15,FALSE,18,38017700,"G",18,18,"Minnesota Timberwolves","Wendell Moore Jr.",0,0,0,0,0,0
0,0,0,1,1,2,1,0,0,"02",0,0,3,0,0,0,1037833,"2023-11-26T00:00:00.000Z",15,FALSE,18,17895968,"F",18,18,"Minnesota Timberwolves","Daishen Nix",0,3,3,3,0,3
6,0,2,5,2,8,4,0,0,"22",2,2,10,4,0,0,1037834,"2023-11-26T00:00:00.000Z",3,FALSE,5,666679,"F",3,3,"Brooklyn Nets","Cameron Johnson",0,14,20,16,10,23.8
4,0,9,10,6,11,7,0,0,"36",0,2,20,9,1,1,1037834,"2023-11-26T00:00:00.000Z",3,FALSE,5,351,"F",3,3,"Brooklyn Nets","Royce O'Neale",1,29,33,24,13,38.8
1,1,4,7,3,10,3,0,0,"34",0,3,9,4,2,1,1037834,"2023-11-26T00:00:00.000Z",3,FALSE,5,158,"F",3,3,"Brooklyn Nets","Dorian Finney-Smith",3,13,14,10,5,23.3
6,0,2,6,4,7,5,2,1,"36",0,0,15,2,0,2,1037834,"2023-11-26T00:00:00.000Z",3,FALSE,5,61,"F",3,3,"Brooklyn Nets","Mikal Bridges",0,17,23,21,8,24.4
7,0,3,9,3,17,7,8,7,"38",2,4,24,5,1,2,1037834,"2023-11-26T00:00:00.000Z",3,FALSE,5,130,"G",3,3,"Brooklyn Nets","Spencer Dinwiddie",1,29,36,31,12,41.5
0,0,1,2,0,2,0,0,0,"05",0,1,0,1,0,0,1037834,"2023-11-26T00:00:00.000Z",3,FALSE,5,9051997,"G",3,3,"Brooklyn Nets","Armoni Brooks",0,1,1,0,1,1.2
3,1,6,2,0,7,4,2,1,"27",3,4,9,9,0,1,1037834,"2023-11-26T00:00:00.000Z",3,FALSE,5,17896038,"C",3,3,"Brooklyn Nets","Day'Ron Sharpe",1,18,21,12,12,26.3
0,0,1,10,6,13,6,2,2,"25",0,1,20,1,2,2,1037834,"2023-11-26T00:00:00.000Z",3,FALSE,5,464,"G",3,3,"Brooklyn Nets","Lonnie Walker IV",2,21,21,20,1,25.2
2,0,3,2,1,8,5,1,0,"17",1,2,11,4,1,0,1037834,"2023-11-26T00:00:00.000Z",3,FALSE,5,17896058,"F",3,3,"Brooklyn Nets","Trendon Watford",1,15,17,13,6,21.8
0,0,0,0,0,0,0,0,0,"00",0,0,0,0,0,0,1037834,"2023-11-26T00:00:00.000Z",3,FALSE,5,17896041,"G",3,3,"Brooklyn Nets","Keon Johnson",0,0,0,0,0,0
0,0,0,0,0,0,0,0,0,"00",0,0,0,0,0,0,1037834,"2023-11-26T00:00:00.000Z",3,FALSE,5,417,"G-F",3,3,"Brooklyn Nets","Ben Simmons",0,0,0,0,0,0
0,0,0,0,0,0,0,0,0,"00",0,0,0,0,0,0,1037834,"2023-11-26T00:00:00.000Z",3,FALSE,5,421,"G",3,3,"Brooklyn Nets","Dennis Smith Jr.",0,0,0,0,0,0
0,0,0,0,0,0,0,0,0,"00",0,0,0,0,0,0,1037834,"2023-11-26T00:00:00.000Z",3,FALSE,5,17896048,"G",3,3,"Brooklyn Nets","Cam Thomas",0,0,0,0,0,0
0,0,0,0,0,0,0,0,0,"00",0,0,0,0,0,0,1037834,"2023-11-26T00:00:00.000Z",3,FALSE,5,56677841,"F",3,3,"Brooklyn Nets","Dariq Whitehead",0,0,0,0,0,0
6,0,4,4,2,22,11,5,3,"38",2,2,27,6,1,1,1037834,"2023-11-26T00:00:00.000Z",3,FALSE,5,125,"G",5,5,"Chicago Bulls","DeMar DeRozan",1,33,39,33,12,45.2
0,0,3,5,4,9,7,2,2,"35",1,2,20,4,0,1,1037834,"2023-11-26T00:00:00.000Z",3,FALSE,5,3547248,"F",5,5,"Chicago Bulls","Patrick Williams",0,24,24,20,4,23.8
5,1,8,3,0,9,3,0,0,"37",1,5,6,9,1,2,1037834,"2023-11-26T00:00:00.000Z",3,FALSE,5,460,"C",5,5,"Chicago Bulls","Nikola Vucevic",2,15,20,11,14,28.3
0,0,0,2,0,2,0,0,0,"08",0,0,0,0,0,1,1037834,"2023-11-26T00:00:00.000Z",3,FALSE,5,87,"G",5,5,"Chicago Bulls","Jevon Carter",0,0,0,0,0,-1
0,0,1,0,0,2,1,2,2,"20",2,0,4,3,0,2,1037834,"2023-11-26T00:00:00.000Z",3,FALSE,5,110,"F",5,5,"Chicago Bulls","Torrey Craig",0,7,7,4,3,5.6
2,0,1,1,0,3,2,2,1,"14",1,2,5,2,0,1,1037834,"2023-11-26T00:00:00.000Z",3,FALSE,5,17895983,"G",5,5,"Chicago Bulls","Ayo Dosunmu",0,7,9,7,4,9.4
0,0,3,0,0,2,1,3,2,"11",2,3,4,5,1,2,1037834,"2023-11-26T00:00:00.000Z",3,FALSE,5,137,"C",5,5,"Chicago Bulls","Andre Drummond",1,9,9,4,5,11
0,0,0,0,0,0,0,0,0,"00",0,0,0,0,0,0,1037834,"2023-11-26T00:00:00.000Z",3,FALSE,5,56677857,"F",5,5,"Chicago Bulls","Julian Phillips",0,0,0,0,0,0
0,0,0,0,0,0,0,0,0,"00",0,0,0,0,0,0,1037834,"2023-11-26T00:00:00.000Z",3,FALSE,5,17896116,"G",5,5,"Chicago Bulls","Terry Taylor",0,0,0,0,0,0
0,0,0,0,0,0,0,0,0,"00",0,0,0,0,0,0,1037834,"2023-11-26T00:00:00.000Z",3,FALSE,5,38017719,"F",5,5,"Chicago Bulls","Dalen Terry",0,0,0,0,0,0
0,0,0,0,0,0,0,0,0,"00",0,0,0,0,0,0,1037834,"2023-11-26T00:00:00.000Z",3,FALSE,5,27,"G",5,5,"Chicago Bulls","Lonzo Ball",0,0,0,0,0,0
0,0,0,0,0,0,0,0,0,"00",0,0,0,0,0,0,1037834,"2023-11-26T00:00:00.000Z",3,FALSE,5,56677874,"F",5,5,"Chicago Bulls","Onuralp Bitim",0,0,0,0,0,0
0,0,0,0,0,0,0,0,0,"00",0,0,0,0,0,0,1037834,"2023-11-26T00:00:00.000Z",3,FALSE,5,89,"G",5,5,"Chicago Bulls","Alex Caruso",0,0,0,0,0,0
0,0,0,0,0,0,0,0,0,"00",0,0,0,0,0,0,1037834,"2023-11-26T00:00:00.000Z",3,FALSE,5,45969255,"F",5,5,"Chicago Bulls","Justin Lewis",0,0,0,0,0,0
0,0,0,0,0,0,0,0,0,"00",0,0,0,0,0,0,1037834,"2023-11-26T00:00:00.000Z",3,FALSE,5,56677860,"F",5,5,"Chicago Bulls","Adama Sanogo",0,0,0,0,0,0
0,0,0,0,0,0,0,0,0,"00",0,0,0,0,0,0,1037834,"2023-11-26T00:00:00.000Z",3,FALSE,5,174,"F-C",3,3,"Brooklyn Nets","Harry Giles III",0,0,0,0,0,0
0,0,0,0,0,0,0,0,0,"00",0,0,0,0,0,0,1037834,"2023-11-26T00:00:00.000Z",3,FALSE,5,56677722,"F",3,3,"Brooklyn Nets","Jalen Wilson",0,0,0,0,0,0
4,0,6,5,1,18,8,4,3,"39",0,1,20,6,0,0,1037834,"2023-11-26T00:00:00.000Z",3,FALSE,5,268,"G",5,5,"Chicago Bulls","Zach LaVine",0,26,30,24,10,33.2
4,1,4,12,5,16,7,4,4,"38",1,3,23,5,0,1,1037834,"2023-11-26T00:00:00.000Z",3,FALSE,5,666956,"G",5,5,"Chicago Bulls","Coby White",1,28,32,27,9,37
0,0,0,0,0,0,0,0,0,"00",0,0,0,0,0,0,1037834,"2023-11-26T00:00:00.000Z",3,FALSE,5,666508,"F-C",3,3,"Brooklyn Nets","Nicolas Claxton",0,0,0,0,0,0
0,0,0,0,0,0,0,0,0,"00",0,0,0,0,0,0,1037834,"2023-11-26T00:00:00.000Z",3,FALSE,5,56677843,"F",3,3,"Brooklyn Nets","Noah Clowney",0,0,0,0,0,0
1,0,2,2,1,4,1,4,1,"13",0,0,4,2,1,0,1037835,"2023-11-26T00:00:00.000Z",6,FALSE,28,3547249,"F",28,28,"Toronto Raptors","Precious Achiuwa",1,6,7,5,3,10.9
0,0,4,4,1,6,1,0,0,"17",0,1,3,4,0,1,1037835,"2023-11-26T00:00:00.000Z",6,FALSE,28,3547275,"G",28,28,"Toronto Raptors","Malachi Flynn",0,7,7,3,4,6.8
0,0,2,0,0,2,1,4,3,"10",2,0,5,4,1,1,1037835,"2023-11-26T00:00:00.000Z",6,FALSE,28,58,"F",28,28,"Toronto Raptors","Chris Boucher",1,9,9,5,4,11.8
0,0,0,1,0,1,0,0,0,"05",1,0,0,1,0,0,1037835,"2023-11-26T00:00:00.000Z",6,FALSE,28,376,"F",28,28,"Toronto Raptors","Otto Porter Jr.",0,1,1,0,1,1.2
0,0,0,0,0,0,0,0,0,"00",0,0,0,0,0,0,1037835,"2023-11-26T00:00:00.000Z",6,FALSE,28,666762,"F",28,28,"Toronto Raptors","Jalen McDaniels",0,0,0,0,0,0
0,0,0,0,0,0,0,0,0,"00",0,0,0,0,0,0,1037835,"2023-11-26T00:00:00.000Z",6,FALSE,28,436,"G-F",28,28,"Toronto Raptors","Garrett Temple",0,0,0,0,0,0
0,0,0,0,0,0,0,0,0,"00",0,0,0,0,0,0,1037835,"2023-11-26T00:00:00.000Z",6,FALSE,28,489,"F",28,28,"Toronto Raptors","Thaddeus Young",0,0,0,0,0,0
5,1,10,9,4,16,8,0,0,"37",1,4,20,11,0,2,1037835,"2023-11-26T00:00:00.000Z",6,FALSE,28,666908,"G",6,6,"Cleveland Cavaliers","Max Strus",1,31,36,25,16,41.7
1,2,11,1,0,14,5,2,2,"38",3,3,12,14,0,3,1037835,"2023-11-26T00:00:00.000Z",6,FALSE,28,17896076,"F-C",6,6,"Cleveland Cavaliers","Evan Mobley",2,26,27,13,15,33.3
3,2,1,0,0,10,9,0,0,"27",3,4,18,4,0,2,1037835,"2023-11-26T00:00:00.000Z",6,FALSE,28,9,"C",6,6,"Cleveland Cavaliers","Jarrett Allen",2,22,25,21,7,31.3
4,0,4,5,0,17,4,3,2,"34",1,0,10,5,1,0,1037835,"2023-11-26T00:00:00.000Z",6,FALSE,28,322,"G",6,6,"Cleveland Cavaliers","Donovan Mitchell",1,15,19,14,9,25
8,0,2,6,3,16,10,1,1,"41",0,2,24,2,0,5,1037835,"2023-11-26T00:00:00.000Z",6,FALSE,28,666581,"G",6,6,"Cleveland Cavaliers","Darius Garland",0,26,34,32,10,33.4
0,0,0,0,0,0,0,0,0,"00",0,0,0,0,0,0,1037835,"2023-11-26T00:00:00.000Z",6,FALSE,28,248,"C",6,6,"Cleveland Cavaliers","Damian Jones",0,0,0,0,0,0
1,0,3,4,1,10,3,0,0,"22",0,1,7,3,0,0,1037835,"2023-11-26T00:00:00.000Z",6,FALSE,28,277,"G",6,6,"Cleveland Cavaliers","Caris LeVert",0,10,11,8,4,12.1
0,0,0,0,0,0,0,0,0,"00",0,0,0,0,0,0,1037835,"2023-11-26T00:00:00.000Z",6,FALSE,28,3547299,"G",6,6,"Cleveland Cavaliers","Sam Merrill",0,0,0,0,0,0
3,0,6,5,2,9,3,0,0,"23",0,4,8,6,1,0,1037835,"2023-11-26T00:00:00.000Z",6,FALSE,28,344,"F",6,6,"Cleveland Cavaliers","Georges Niang",1,14,17,11,9,22.7
0,0,0,1,0,3,1,0,0,"10",0,0,2,0,0,1,1037835,"2023-11-26T00:00:00.000Z",6,FALSE,28,3547247,"F-G",6,6,"Cleveland Cavaliers","Isaac Okoro",0,2,2,2,0,1
0,0,0,0,0,0,0,0,0,"00",0,0,0,0,0,0,1037835,"2023-11-26T00:00:00.000Z",6,FALSE,28,56677872,"G",6,6,"Cleveland Cavaliers","Craig Porter",0,0,0,0,0,0
4,0,0,0,0,2,2,0,0,"08",4,0,4,4,0,1,1037835,"2023-11-26T00:00:00.000Z",6,FALSE,28,444,"C-F",6,6,"Cleveland Cavaliers","Tristan Thompson",0,8,12,8,8,13.8
0,0,0,0,0,0,0,0,0,"00",0,0,0,0,0,0,1037835,"2023-11-26T00:00:00.000Z",6,FALSE,28,56677847,"F",6,6,"Cleveland Cavaliers","Emoni Bates",0,0,0,0,0,0
0,0,0,0,0,0,0,0,0,"00",0,0,0,0,0,0,1037835,"2023-11-26T00:00:00.000Z",6,FALSE,28,666676,"G",6,6,"Cleveland Cavaliers","Ty Jerome",0,0,0,0,0,0
0,0,0,0,0,0,0,0,0,"00",0,0,0,0,0,0,1037835,"2023-11-26T00:00:00.000Z",6,FALSE,28,38017662,"F",6,6,"Cleveland Cavaliers","Isaiah Mobley",0,0,0,0,0,0
0,0,0,0,0,0,0,0,0,"00",0,0,0,0,0,0,1037835,"2023-11-26T00:00:00.000Z",6,FALSE,28,404,"G",6,6,"Cleveland Cavaliers","Ricky Rubio",0,0,0,0,0,0
0,0,0,0,0,0,0,0,0,"00",0,0,0,0,0,0,1037835,"2023-11-26T00:00:00.000Z",6,FALSE,28,666940,"F",6,6,"Cleveland Cavaliers","Dean Wade",0,0,0,0,0,0
3,1,7,4,1,14,5,5,4,"33",1,1,15,8,1,2,1037835,"2023-11-26T00:00:00.000Z",6,FALSE,28,17896055,"G-F",28,28,"Toronto Raptors","Scottie Barnes",2,23,26,18,11,33.1
6,1,4,4,0,17,7,6,4,"38",4,0,18,8,1,4,1037835,"2023-11-26T00:00:00.000Z",6,FALSE,28,416,"F",28,28,"Toronto Raptors","Pascal Siakam",2,26,32,24,14,38.6
2,0,9,0,0,9,8,2,2,"35",4,3,18,13,2,1,1037835,"2023-11-26T00:00:00.000Z",6,FALSE,28,373,"C",28,28,"Toronto Raptors","Jakob Poeltl",2,31,33,20,15,41.6
1,1,2,5,2,12,4,3,1,"34",5,1,11,7,0,1,1037835,"2023-11-26T00:00:00.000Z",6,FALSE,28,18,"F",28,28,"Toronto Raptors","OG Anunoby",1,18,19,12,8,22.9
0,0,0,0,0,0,0,0,0,"00",0,0,0,0,0,0,1037835,"2023-11-26T00:00:00.000Z",6,FALSE,28,38017710,"C",28,28,"Toronto Raptors","Christian Koloko",0,0,0,0,0,0
0,0,0,0,0,0,0,0,0,"00",0,0,0,0,0,0,1037835,"2023-11-26T00:00:00.000Z",6,FALSE,28,56677869,"G",28,28,"Toronto Raptors","Markquis Nowell",0,0,0,0,0,0
4,0,2,5,2,11,5,3,3,"29",0,5,15,2,2,1,1037835,"2023-11-26T00:00:00.000Z",6,FALSE,28,409,"G",28,28,"Toronto Raptors","Dennis Schroder",2,17,21,19,6,28.4
0,0,1,7,1,13,5,2,2,"26",0,0,13,1,1,1,1037835,"2023-11-26T00:00:00.000Z",6,FALSE,28,3089,"",28,28,"Toronto Raptors","Gary Trent Jr.",1,14,14,13,1,16.2
0,0,0,0,0,0,0,0,0,"00",0,0,0,0,0,0,1037835,"2023-11-26T00:00:00.000Z",6,FALSE,28,56677828,"G",28,28,"Toronto Raptors","Gradey Dick",0,0,0,0,0,0
0,0,0,0,0,0,0,0,0,"00",0,0,0,0,0,0,1037835,"2023-11-26T00:00:00.000Z",6,FALSE,28,56677805,"G",28,28,"Toronto Raptors","Javon Freeman-Liberty",0,0,0,0,0,0
0,0,0,0,0,0,0,0,0,"00",0,0,0,0,0,0,1037835,"2023-11-26T00:00:00.000Z",6,FALSE,28,38017717,"F",28,28,"Toronto Raptors","Ron Harper Jr.",0,0,0,0,0,0
3,0,2,4,1,5,2,0,0,"27",0,2,5,2,1,0,1037836,"2023-11-26T00:00:00.000Z",8,FALSE,27,215,"F-G",8,8,"Denver Nuggets","Justin Holiday",1,7,10,8,5,14.9
2,1,6,9,4,14,8,6,5,"33",1,0,25,7,0,3,1037836,"2023-11-26T00:00:00.000Z",8,FALSE,27,375,"F",8,8,"Denver Nuggets","Michael Porter Jr.",1,32,34,27,9,36.4
9,0,6,0,0,29,17,5,5,"34",5,3,39,11,1,5,1037836,"2023-11-26T00:00:00.000Z",8,FALSE,27,246,"C",8,8,"Denver Nuggets","Nikola Jokic",1,50,59,48,20,63.7
6,0,1,4,2,7,5,4,4,"31",0,3,16,1,1,3,1037836,"2023-11-26T00:00:00.000Z",8,FALSE,27,81,"G",8,8,"Denver Nuggets","Kentavious Caldwell-Pope",1,17,23,22,7,26.2
6,0,5,3,3,10,7,3,3,"28",2,5,20,7,1,4,1037836,"2023-11-26T00:00:00.000Z",8,FALSE,27,236,"G",8,8,"Denver Nuggets","Reggie Jackson",1,27,33,26,13,36.4
4,0,3,1,0,5,1,4,3,"25",1,1,5,4,0,0,1037836,"2023-11-26T00:00:00.000Z",8,FALSE,27,38017709,"G",8,8,"Denver Nuggets","Christian Braun",0,9,13,9,8,15.8
0,0,0,0,0,0,0,0,0,"02",0,0,0,0,0,0,1037836,"2023-11-26T00:00:00.000Z",8,FALSE,27,38017727,"G",8,8,"Denver Nuggets","Collin Gillespie",0,0,0,0,0,0
0,0,0,0,0,1,1,0,0,"01",0,0,2,0,0,0,1037836,"2023-11-26T00:00:00.000Z",8,FALSE,27,17896103,"F-C",8,8,"Denver Nuggets","Jay Huff",0,2,2,2,0,2
1,0,1,1,0,1,0,0,0,"02",0,0,0,1,0,0,1037836,"2023-11-26T00:00:00.000Z",8,FALSE,27,17896007,"G",8,8,"Denver Nuggets","Braxton Key",0,1,2,1,2,2.7
0,0,0,0,0,0,0,0,0,"01",0,2,0,0,0,0,1037836,"2023-11-26T00:00:00.000Z",8,FALSE,27,3547268,"F-C",8,8,"Denver Nuggets","Zeke Nnaji",0,0,0,0,0,0
3,0,2,4,1,9,4,0,0,"21",2,4,9,4,1,4,1037836,"2023-11-26T00:00:00.000Z",8,FALSE,27,102,"F-C",27,27,"San Antonio Spurs","Zach Collins",1,13,16,12,7,17.3
2,0,1,2,0,7,3,5,4,"31",0,1,10,1,0,0,1037836,"2023-11-26T00:00:00.000Z",8,FALSE,27,666682,"F",27,27,"San Antonio Spurs","Keldon Johnson",0,11,13,12,3,14.2
2,4,7,5,2,17,7,7,6,"25",4,4,22,11,6,3,1037836,"2023-11-26T00:00:00.000Z",8,FALSE,27,56677822,"F-C",27,27,"San Antonio Spurs","Victor Wembanyama",10,33,35,24,13,65.2
0,0,0,0,0,0,0,0,0,"02",0,1,0,0,0,1,1037836,"2023-11-26T00:00:00.000Z",8,FALSE,27,56677582,"G",8,8,"Denver Nuggets","Jalen Pickett",0,0,0,0,0,-1
0,0,1,0,0,0,0,0,0,"01",0,0,0,1,0,0,1037836,"2023-11-26T00:00:00.000Z",8,FALSE,27,56677871,"F",8,8,"Denver Nuggets","Hunter Tyson",0,1,1,0,1,1.2
2,2,3,2,0,6,2,0,0,"22",1,1,4,4,1,1,1037836,"2023-11-26T00:00:00.000Z",8,FALSE,27,38017721,"G",8,8,"Denver Nuggets","Peyton Watson",3,8,10,6,6,19.8
0,0,0,0,0,0,0,0,0,"00",0,0,0,0,0,0,1037836,"2023-11-26T00:00:00.000Z",8,FALSE,27,666489,"F",8,8,"Denver Nuggets","Vlatko Cancar",0,0,0,0,0,0
0,0,0,0,0,0,0,0,0,"00",0,0,0,0,0,0,1037836,"2023-11-26T00:00:00.000Z",8,FALSE,27,177,"F",8,8,"Denver Nuggets","Aaron Gordon",0,0,0,0,0,0
0,0,0,0,0,0,0,0,0,"00",0,0,0,0,0,0,1037836,"2023-11-26T00:00:00.000Z",8,FALSE,27,335,"G",8,8,"Denver Nuggets","Jamal Murray",0,0,0,0,0,0
3,0,2,3,1,5,1,4,4,"16",1,2,7,3,0,3,1037836,"2023-11-26T00:00:00.000Z",8,FALSE,27,359,"F",27,27,"San Antonio Spurs","Cedi Osman",0,10,13,10,6,12.1
2,1,4,0,0,5,3,3,3,"15",2,3,9,6,0,1,1037836,"2023-11-26T00:00:00.000Z",8,FALSE,27,17895854,"G",27,27,"San Antonio Spurs","Charles Bassey",1,15,17,11,8,21.2
1,1,1,6,3,8,4,4,2,"17",0,1,13,1,0,0,1037836,"2023-11-26T00:00:00.000Z",8,FALSE,27,38017649,"F",27,27,"San Antonio Spurs","Julian Champagnie",1,14,15,14,2,18.7
3,0,0,1,0,2,1,0,0,"07",0,0,2,0,0,0,1037836,"2023-11-26T00:00:00.000Z",8,FALSE,27,180,"G",27,27,"San Antonio Spurs","Devonte' Graham",0,2,5,5,3,6.5
2,0,0,0,0,0,0,0,0,"06",0,1,0,0,1,0,1037836,"2023-11-26T00:00:00.000Z",8,FALSE,27,17896059,"F",27,27,"San Antonio Spurs","Sandro Mamukelashvili",1,0,2,2,2,6
1,0,0,2,0,2,0,0,0,"12",0,0,0,0,0,0,1037836,"2023-11-26T00:00:00.000Z",8,FALSE,27,305,"F",27,27,"San Antonio Spurs","Doug McDermott",0,0,1,1,1,1.5
0,0,0,0,0,0,0,0,0,"00",0,0,0,0,0,0,1037836,"2023-11-26T00:00:00.000Z",8,FALSE,27,38017730,"F",27,27,"San Antonio Spurs","Dominick Barlow",0,0,0,0,0,0
0,0,0,0,0,0,0,0,0,"00",0,0,0,0,0,0,1037836,"2023-11-26T00:00:00.000Z",8,FALSE,27,56677865,"C",27,27,"San Antonio Spurs","Charles Bediako",0,0,0,0,0,0
4,0,1,4,2,8,4,0,0,"19",0,4,10,1,3,1,1037836,"2023-11-26T00:00:00.000Z",8,FALSE,27,56677776,"G",8,8,"Denver Nuggets","Julian Strawther",3,11,15,14,5,25.2
1,0,5,0,0,3,3,3,0,"12",1,3,6,6,0,1,1037836,"2023-11-26T00:00:00.000Z",8,FALSE,27,250,"C",8,8,"Denver Nuggets","DeAndre Jordan",0,12,13,7,7,13.7
3,0,1,5,3,11,6,0,0,"25",1,3,15,2,1,0,1037836,"2023-11-26T00:00:00.000Z",8,FALSE,27,38017692,"F",27,27,"San Antonio Spurs","Malaki Branham",1,17,20,18,5,24.9
3,0,2,1,0,6,2,0,0,"17",0,0,4,2,0,3,1037836,"2023-11-26T00:00:00.000Z",8,FALSE,27,38017699,"F",27,27,"San Antonio Spurs","Jeremy Sochan",0,6,9,7,5,7.9
3,0,1,7,4,13,7,1,1,"26",0,1,19,1,1,0,1037836,"2023-11-26T00:00:00.000Z",8,FALSE,27,3547246,"G-F",27,27,"San Antonio Spurs","Devin Vassell",1,20,23,22,4,27.7
6,0,4,1,0,8,4,2,2,"22",0,2,10,4,0,1,1037836,"2023-11-26T00:00:00.000Z",8,FALSE,27,3547274,"G",27,27,"San Antonio Spurs","Tre Jones",0,14,20,16,10,22.8
0,0,0,0,0,0,0,0,0,"00",0,0,0,0,0,0,1037836,"2023-11-26T00:00:00.000Z",8,FALSE,27,56677817,"G",27,27,"San Antonio Spurs","Sidy Cissoko",0,0,0,0,0,0
0,0,0,0,0,0,0,0,0,"00",0,0,0,0,0,0,1037836,"2023-11-26T00:00:00.000Z",8,FALSE,27,56677870,"G",27,27,"San Antonio Spurs","Sir'Jabari Rice",0,0,0,0,0,0
0,0,0,0,0,0,0,0,0,"00",0,0,0,0,0,0,1037836,"2023-11-26T00:00:00.000Z",8,FALSE,27,38017693,"G",27,27,"San Antonio Spurs","Blake Wesley",0,0,0,0,0,0
2,1,4,2,0,14,8,0,0,"28",0,4,16,4,2,1,1037837,"2023-11-27T00:00:00.000Z",9,FALSE,30,56677826,"G-F",9,9,"Detroit Pistons","Ausar Thompson",3,20,22,18,6,31.8
0,0,6,7,1,11,3,0,0,"29",2,2,7,8,1,0,1037837,"2023-11-27T00:00:00.000Z",9,FALSE,30,3547267,"F-C",9,9,"Detroit Pistons","Isaiah Stewart",1,15,15,7,8,19.6
3,5,7,0,0,8,5,5,2,"33",7,5,12,14,1,6,1037837,"2023-11-27T00:00:00.000Z",9,FALSE,30,38017694,"C",9,9,"Detroit Pistons","Jalen Duren",6,26,29,15,17,45.3
7,1,5,3,2,12,6,2,1,"33",2,3,15,7,1,3,1037837,"2023-11-27T00:00:00.000Z",9,FALSE,30,38017682,"G",9,9,"Detroit Pistons","Jaden Ivey",2,22,29,22,14,36.9
7,0,4,7,2,22,10,4,4,"32",1,2,26,5,1,1,1037837,"2023-11-27T00:00:00.000Z",9,FALSE,30,17896075,"G-F",9,9,"Detroit Pistons","Cade Cunningham",1,31,38,33,12,44.5
0,0,0,0,0,0,0,0,0,"00",0,0,0,0,0,0,1037837,"2023-11-27T00:00:00.000Z",9,FALSE,30,24,"F",9,9,"Detroit Pistons","Marvin Bagley III",0,0,0,0,0,0
1,0,0,5,0,8,2,4,4,"13",0,1,8,0,0,0,1037837,"2023-11-27T00:00:00.000Z",9,FALSE,30,77,"G",9,9,"Detroit Pistons","Alec Burks",0,8,9,9,1,9.5
3,3,3,0,0,1,0,0,0,"16",1,1,0,4,0,0,1037837,"2023-11-27T00:00:00.000Z",9,FALSE,30,3547241,"G",9,9,"Detroit Pistons","Killian Hayes",3,4,7,3,7,18.3
0,0,0,0,0,0,0,0,0,"00",0,0,0,0,0,0,1037837,"2023-11-27T00:00:00.000Z",9,FALSE,30,259,"F",9,9,"Detroit Pistons","Kevin Knox",0,0,0,0,0,0
3,0,1,8,2,11,3,0,0,"23",0,1,8,1,1,2,1037837,"2023-11-27T00:00:00.000Z",9,FALSE,30,17896071,"F",9,9,"Detroit Pistons","Isaiah Livers",1,9,12,11,4,14.7
3,1,0,5,1,10,3,0,0,"22",1,1,7,1,0,1,1037837,"2023-11-27T00:00:00.000Z",9,FALSE,30,56677792,"G",9,9,"Detroit Pistons","Marcus Sasser",1,8,11,10,4,14.7
0,0,0,1,0,1,0,0,0,"02",1,2,0,1,0,1,1037837,"2023-11-27T00:00:00.000Z",9,FALSE,30,44477024,"G",9,9,"Detroit Pistons","Stanley Umude",0,1,1,0,1,0.2
0,0,1,0,0,4,3,4,2,"09",3,0,8,4,0,1,1037837,"2023-11-27T00:00:00.000Z",9,FALSE,30,3547240,"C",9,9,"Detroit Pistons","James Wiseman",0,12,12,8,4,11.8
0,0,0,0,0,0,0,0,0,"00",0,0,0,0,0,0,1037837,"2023-11-27T00:00:00.000Z",9,FALSE,30,54,"F",9,9,"Detroit Pistons","Bojan Bogdanovic",0,0,0,0,0,0
0,0,0,0,0,0,0,0,0,"00",0,0,0,0,0,0,1037837,"2023-11-27T00:00:00.000Z",9,FALSE,30,56677729,"G",9,9,"Detroit Pistons","Malcolm Cazalon",0,0,0,0,0,0
0,0,0,0,0,0,0,0,0,"00",0,0,0,0,0,0,1037837,"2023-11-27T00:00:00.000Z",9,FALSE,30,197,"F-G",9,9,"Detroit Pistons","Joe Harris",0,0,0,0,0,0
0,0,0,0,0,0,0,0,0,"00",0,0,0,0,0,0,1037837,"2023-11-27T00:00:00.000Z",9,FALSE,30,330,"G",9,9,"Detroit Pistons","Monte Morris",0,0,0,0,0,0
0,0,0,0,0,0,0,0,0,"00",0,0,0,0,0,0,1037837,"2023-11-27T00:00:00.000Z",9,FALSE,30,42097199,"G",9,9,"Detroit Pistons","Jared Rhoden",0,0,0,0,0,0
5,0,6,3,1,9,6,3,3,"26",0,3,16,6,0,3,1037837,"2023-11-27T00:00:00.000Z",9,FALSE,30,3547242,"F",30,30,"Washington Wizards","Deni Avdija",0,22,27,21,11,27.7
8,0,12,7,2,23,10,11,10,"35",0,0,32,12,0,1,1037837,"2023-11-27T00:00:00.000Z",9,FALSE,30,265,"F",30,30,"Washington Wizards","Kyle Kuzma",0,44,52,40,20,57.4
2,0,2,6,3,8,5,3,3,"19",0,2,16,2,0,1,1037837,"2023-11-27T00:00:00.000Z",9,FALSE,30,167,"F",30,30,"Washington Wizards","Danilo Gallinari",0,18,20,18,4,20.4
0,0,0,0,0,0,0,0,0,"02",0,0,0,0,0,0,1037837,"2023-11-27T00:00:00.000Z",9,FALSE,30,3547302,"F",30,30,"Washington Wizards","Anthony Gill",0,0,0,0,0,0
1,0,5,1,0,7,4,0,0,"19",0,4,8,5,1,0,1037837,"2023-11-27T00:00:00.000Z",9,FALSE,30,17896045,"F",30,30,"Washington Wizards","Corey Kispert",1,13,14,9,6,18.5
0,0,0,0,0,0,0,0,0,"00",0,0,0,0,0,0,1037837,"2023-11-27T00:00:00.000Z",9,FALSE,30,337,"F-C",30,30,"Washington Wizards","Mike Muscala",0,0,0,0,0,0
3,1,2,3,2,7,4,2,2,"22",0,2,12,2,2,1,1037837,"2023-11-27T00:00:00.000Z",9,FALSE,30,414,"G",30,30,"Washington Wizards","Landry Shamet",3,14,17,15,5,26.9
0,0,1,1,0,1,0,0,0,"02",0,1,0,1,0,0,1037837,"2023-11-27T00:00:00.000Z",9,FALSE,30,18677954,"G",30,30,"Washington Wizards","Jared Butler",0,1,1,0,1,1.2
0,1,4,2,0,6,2,1,1,"28",0,1,5,4,2,2,1037837,"2023-11-27T00:00:00.000Z",9,FALSE,30,56677844,"G",30,30,"Washington Wizards","Bilal Coulibaly",3,9,9,5,4,16.8
0,0,0,0,0,2,1,0,0,"07",0,0,2,0,0,1,1037837,"2023-11-27T00:00:00.000Z",9,FALSE,30,38017687,"G",30,30,"Washington Wizards","Johnny Davis",0,2,2,2,0,1
1,4,6,0,0,5,4,2,2,"27",3,2,10,9,2,2,1037837,"2023-11-27T00:00:00.000Z",9,FALSE,30,666577,"F",30,30,"Washington Wizards","Daniel Gafford",6,19,20,11,10,38.3
3,0,0,2,0,9,3,4,4,"25",0,3,10,0,1,4,1037837,"2023-11-27T00:00:00.000Z",9,FALSE,30,666848,"G",30,30,"Washington Wizards","Jordan Poole",1,10,13,13,3,13.5
4,0,2,3,1,9,5,2,1,"26",1,0,12,3,0,0,1037837,"2023-11-27T00:00:00.000Z",9,FALSE,30,249,"G",30,30,"Washington Wizards","Tyus Jones",0,15,19,16,7,21.6
0,0,0,0,0,0,0,0,0,"00",0,0,0,0,0,0,1037837,"2023-11-27T00:00:00.000Z",9,FALSE,30,38017704,"F",30,30,"Washington Wizards","Patrick Baldwin Jr.",0,0,0,0,0,0
0,0,0,0,0,0,0,0,0,"00",0,0,0,0,0,0,1037837,"2023-11-27T00:00:00.000Z",9,FALSE,30,38124126,"F",30,30,"Washington Wizards","John Butler Jr.",0,0,0,0,0,0
0,0,0,0,0,0,0,0,0,"00",0,0,0,0,0,0,1037837,"2023-11-27T00:00:00.000Z",9,FALSE,30,38017712,"G",30,30,"Washington Wizards","Ryan Rollins",0,0,0,0,0,0
0,0,0,0,0,0,0,0,0,"00",0,0,0,0,0,0,1037837,"2023-11-27T00:00:00.000Z",9,FALSE,30,487,"G",30,30,"Washington Wizards","Delon Wright",0,0,0,0,0,0
0,0,0,1,1,3,1,0,0,"02",2,0,3,2,0,0,1037837,"2023-11-27T00:00:00.000Z",9,FALSE,30,17896106,"F",30,30,"Washington Wizards","Eugene Omoruyi",0,5,5,3,2,5.4
3,1,1,6,1,10,3,2,2,"24",0,1,9,1,1,2,1037838,"2023-11-27T00:00:00.000Z",12,FALSE,25,210,"G",12,12,"Indiana Pacers","Buddy Hield",2,10,13,12,4,18.7
2,1,2,4,1,9,3,2,2,"19",2,0,9,4,0,1,1037838,"2023-11-27T00:00:00.000Z",12,FALSE,25,3547243,"F",12,12,"Indiana Pacers","Obi Toppin",1,13,15,11,6,18.8
0,2,7,3,0,11,5,1,1,"27",1,4,11,8,2,1,1037838,"2023-11-27T00:00:00.000Z",12,FALSE,25,452,"C-F",12,12,"Indiana Pacers","Myles Turner",4,19,19,11,8,31.6
3,0,3,5,1,10,5,0,0,"33",0,4,11,3,2,2,1037838,"2023-11-27T00:00:00.000Z",12,FALSE,25,69,"G",12,12,"Indiana Pacers","Bruce Brown",2,14,17,14,6,23.1
9,0,2,6,3,17,11,9,8,"36",0,1,33,2,0,3,1037838,"2023-11-27T00:00:00.000Z",12,FALSE,25,3547245,"G",12,12,"Indiana Pacers","Tyrese Haliburton",0,35,44,42,11,45.9
1,1,4,0,0,2,1,0,0,"10",1,3,2,5,0,1,1037838,"2023-11-27T00:00:00.000Z",12,FALSE,25,17896035,"F",12,12,"Indiana Pacers","Isaiah Jackson",1,7,8,3,6,11.5
0,0,0,0,0,0,0,0,0,"00",0,0,0,0,0,0,1037838,"2023-11-27T00:00:00.000Z",12,FALSE,25,3547289,"G",25,25,"Portland Trail Blazers","Skylar Mays",0,0,0,0,0,0
0,0,0,0,0,0,0,0,0,"00",0,0,0,0,0,0,1037838,"2023-11-27T00:00:00.000Z",12,FALSE,25,47957121,"F",25,25,"Portland Trail Blazers","Justin Minaya",0,0,0,0,0,0
0,0,0,0,0,0,0,0,0,"00",0,0,0,0,0,0,1037838,"2023-11-27T00:00:00.000Z",12,FALSE,25,56677791,"F",25,25,"Portland Trail Blazers","Kris Murray",0,0,0,0,0,0
1,0,2,1,1,1,1,2,1,"10",0,1,4,2,0,1,1037838,"2023-11-27T00:00:00.000Z",12,FALSE,25,56783340,"C",25,25,"Portland Trail Blazers","Duop Reath",0,6,7,5,3,6.9
1,1,1,2,0,2,0,0,0,"29",0,3,0,1,1,2,1037838,"2023-11-27T00:00:00.000Z",12,FALSE,25,666923,"G-F",25,25,"Portland Trail Blazers","Matisse Thybulle",2,1,2,1,2,6.7
0,0,2,1,0,3,0,2,1,"15",1,2,1,3,0,1,1037838,"2023-11-27T00:00:00.000Z",12,FALSE,25,38017711,"F",25,25,"Portland Trail Blazers","Jabari Walker",0,4,4,1,3,3.6
0,0,0,0,0,0,0,0,0,"00",0,0,0,0,0,0,1037838,"2023-11-27T00:00:00.000Z",12,FALSE,25,39613724,"C",25,25,"Portland Trail Blazers","Ibou Badji",0,0,0,0,0,0
0,0,0,0,0,0,0,0,0,"00",0,0,0,0,0,0,1037838,"2023-11-27T00:00:00.000Z",12,FALSE,25,56677829,"G-F",25,25,"Portland Trail Blazers","Rayan Rupert",0,0,0,0,0,0
0,0,0,0,0,0,0,0,0,"00",0,0,0,0,0,0,1037838,"2023-11-27T00:00:00.000Z",12,FALSE,25,419,"G",25,25,"Portland Trail Blazers","Anfernee Simons",0,0,0,0,0,0
0,0,3,2,0,10,4,5,3,"22",1,3,11,4,0,2,1037838,"2023-11-27T00:00:00.000Z",12,FALSE,25,38017686,"G-F",12,12,"Indiana Pacers","Bennedict Mathurin",0,15,15,11,4,13.8
4,1,2,1,0,2,0,2,0,"10",2,0,0,4,1,3,1037838,"2023-11-27T00:00:00.000Z",12,FALSE,25,304,"G",12,12,"Indiana Pacers","T.J. McConnell",2,4,8,4,8,13.8
3,0,1,1,0,6,4,0,0,"21",2,3,8,3,1,2,1037838,"2023-11-27T00:00:00.000Z",12,FALSE,25,38017507,"G-F",12,12,"Indiana Pacers","Andrew Nembhard",1,11,14,11,6,17.1
0,0,2,3,1,6,3,1,0,"25",1,4,7,3,3,2,1037838,"2023-11-27T00:00:00.000Z",12,FALSE,25,3547250,"G-F",12,12,"Indiana Pacers","Aaron Nesmith",3,10,10,7,3,17.6
0,0,0,0,0,0,0,0,0,"00",0,0,0,0,0,0,1037838,"2023-11-27T00:00:00.000Z",12,FALSE,25,3547207,"F",12,12,"Indiana Pacers","Jordan Nwora",0,0,0,0,0,0
0,0,0,0,0,0,0,0,0,"01",0,0,0,0,0,0,1037838,"2023-11-27T00:00:00.000Z",12,FALSE,25,56677861,"G",12,12,"Indiana Pacers","Ben Sheppard",0,0,0,0,0,0
1,0,5,2,1,5,3,2,2,"12",0,1,9,5,0,1,1037838,"2023-11-27T00:00:00.000Z",12,FALSE,25,3547264,"F-C",12,12,"Indiana Pacers","Jalen Smith",0,14,15,10,6,15.5
0,0,0,0,0,0,0,0,0,"00",0,0,0,0,0,0,1037838,"2023-11-27T00:00:00.000Z",12,FALSE,25,56677832,"F",12,12,"Indiana Pacers","Jarace Walker",0,0,0,0,0,0
0,0,0,0,0,0,0,0,0,"00",0,0,0,0,0,0,1037838,"2023-11-27T00:00:00.000Z",12,FALSE,25,38017701,"G",12,12,"Indiana Pacers","Kendall Brown",0,0,0,0,0,0
0,0,0,0,0,0,0,0,0,"00",0,0,0,0,0,0,1037838,"2023-11-27T00:00:00.000Z",12,FALSE,25,56677778,"F-C",12,12,"Indiana Pacers","Oscar Tshiebwe",0,0,0,0,0,0
0,0,0,0,0,0,0,0,0,"00",0,0,0,0,0,0,1037838,"2023-11-27T00:00:00.000Z",12,FALSE,25,56677794,"G",12,12,"Indiana Pacers","Isaiah Wong",0,0,0,0,0,0
0,0,0,2,1,3,1,2,2,"17",2,2,5,2,0,0,1037838,"2023-11-27T00:00:00.000Z",12,FALSE,25,56677850,"F",25,25,"Portland Trail Blazers","Toumani Camara",0,7,7,5,2,7.4
3,3,6,3,3,18,12,7,7,"38",1,1,34,7,0,1,1037838,"2023-11-27T00:00:00.000Z",12,FALSE,25,182,"F",25,25,"Portland Trail Blazers","Jerami Grant",3,41,44,37,10,54.9
0,0,0,0,0,0,0,0,0,"00",0,0,0,0,0,0,1037838,"2023-11-27T00:00:00.000Z",12,FALSE,25,666476,"C",25,25,"Portland Trail Blazers","Moses Brown",0,0,0,0,0,0
0,0,0,0,0,0,0,0,0,"00",0,0,0,0,0,0,1037838,"2023-11-27T00:00:00.000Z",12,FALSE,25,17896120,"F",25,25,"Portland Trail Blazers","Ish Wainright",0,0,0,0,0,0
0,0,0,0,0,0,0,0,0,"00",0,0,0,0,0,0,1037838,"2023-11-27T00:00:00.000Z",12,FALSE,25,476,"C-F",25,25,"Portland Trail Blazers","Robert Williams III",0,0,0,0,0,0
1,0,10,0,0,13,9,4,4,"38",3,1,22,13,1,4,1037838,"2023-11-27T00:00:00.000Z",12,FALSE,25,22,"C",25,25,"Portland Trail Blazers","Deandre Ayton",1,35,36,23,14,38.1
6,0,4,3,1,15,4,2,2,"35",1,5,11,5,3,2,1037838,"2023-11-27T00:00:00.000Z",12,FALSE,25,38017690,"G",25,25,"Portland Trail Blazers","Shaedon Sharpe",3,16,22,17,11,33
7,0,2,3,1,20,9,6,5,"36",0,1,24,2,0,1,1037838,"2023-11-27T00:00:00.000Z",12,FALSE,25,65,"G",25,25,"Portland Trail Blazers","Malcolm Brogdon",0,26,33,31,9,35.9
1,0,2,3,2,10,4,6,3,"22",1,5,13,3,1,4,1037838,"2023-11-27T00:00:00.000Z",12,FALSE,25,56677747,"G",25,25,"Portland Trail Blazers","Scoot Henderson",1,16,17,14,4,17.1
4,0,4,3,2,7,4,0,0,"29",3,3,10,7,3,0,1037839,"2023-11-27T00:00:00.000Z",23,FALSE,14,33,"F-G",23,23,"Philadelphia 76ers","Nicolas Batum",3,17,21,14,11,33.4
0,0,5,4,0,12,3,2,2,"23",0,1,8,5,0,1,1037839,"2023-11-27T00:00:00.000Z",23,FALSE,14,200,"F",23,23,"Philadelphia 76ers","Tobias Harris",0,13,13,8,5,13
11,1,7,3,2,15,9,12,10,"31",4,2,30,11,1,3,1037839,"2023-11-27T00:00:00.000Z",23,FALSE,14,145,"F-C",23,23,"Philadelphia 76ers","Joel Embiid",2,41,52,41,22,62.7
2,0,0,6,3,6,3,0,0,"25",0,2,9,0,1,0,1037839,"2023-11-27T00:00:00.000Z",23,FALSE,14,313,"G",23,23,"Philadelphia 76ers","De'Anthony Melton",1,9,11,11,2,15
8,0,3,12,5,20,9,9,8,"36",0,2,31,3,1,0,1037839,"2023-11-27T00:00:00.000Z",23,FALSE,14,3547254,"G",23,23,"Philadelphia 76ers","Tyrese Maxey",1,34,42,39,11,49.6
0,0,2,1,1,4,3,0,0,"06",1,0,7,3,0,0,1037839,"2023-11-27T00:00:00.000Z",23,FALSE,14,28,"C",23,23,"Philadelphia 76ers","Mo Bamba",0,10,10,7,3,10.6
3,0,4,8,4,9,4,0,0,"24",2,2,12,6,0,1,1037839,"2023-11-27T00:00:00.000Z",23,FALSE,14,45,"G",23,23,"Philadelphia 76ers","Patrick Beverley",0,18,21,15,9,22.7
2,1,4,2,0,3,0,0,0,"18",3,1,0,7,0,0,1037839,"2023-11-27T00:00:00.000Z",23,FALSE,14,108,"F",23,23,"Philadelphia 76ers","Robert Covington",1,7,9,2,9,14.4
0,0,1,5,4,8,6,0,0,"20",0,2,16,1,1,0,1037839,"2023-11-27T00:00:00.000Z",23,FALSE,14,328,"F",23,23,"Philadelphia 76ers","Marcus Morris",1,17,17,16,1,20.2
0,0,2,1,1,5,4,0,0,"17",1,1,9,3,2,0,1037839,"2023-11-27T00:00:00.000Z",23,FALSE,14,3547270,"F",23,23,"Philadelphia 76ers","Paul Reed",2,12,12,9,3,18.6
1,0,3,3,0,6,3,0,0,"26",0,3,6,3,1,1,1037839,"2023-11-27T00:00:00.000Z",23,FALSE,14,38017697,"G",14,14,"Los Angeles Lakers","Max Christie",1,9,10,7,4,13.1
7,0,2,2,1,10,5,2,1,"24",0,0,12,2,0,0,1037839,"2023-11-27T00:00:00.000Z",23,FALSE,14,405,"G",14,14,"Los Angeles Lakers","D'Angelo Russell",0,14,21,19,9,24.9
0,0,0,0,0,1,1,0,0,"02",0,0,2,0,0,1,1037839,"2023-11-27T00:00:00.000Z",23,FALSE,14,56677867,"F",14,14,"Los Angeles Lakers","Alex Fudge",0,2,2,2,0,1
1,1,0,2,0,6,3,1,1,"19",2,3,7,2,0,2,1037839,"2023-11-27T00:00:00.000Z",23,FALSE,14,666626,"C",14,14,"Los Angeles Lakers","Jaxson Hayes",1,9,10,8,3,11.9
1,0,0,3,1,3,1,0,0,"08",0,1,3,0,0,0,1037839,"2023-11-27T00:00:00.000Z",23,FALSE,14,56677868,"G",14,14,"Los Angeles Lakers","D'Moi Hodge",0,3,4,4,1,4.5
2,0,0,2,0,3,0,0,0,"11",0,1,0,0,0,1,1037839,"2023-11-27T00:00:00.000Z",23,FALSE,14,56677835,"G",14,14,"Los Angeles Lakers","Jalen Hood-Schifino",0,0,2,2,2,2
0,0,0,0,0,1,0,0,0,"08",1,0,0,1,0,2,1037839,"2023-11-27T00:00:00.000Z",23,FALSE,14,56677836,"F",14,14,"Los Angeles Lakers","Maxwell Lewis",0,1,1,0,1,-0.8
2,0,2,4,1,10,4,3,3,"29",0,2,12,2,0,3,1037839,"2023-11-27T00:00:00.000Z",23,FALSE,14,17553995,"G",14,14,"Los Angeles Lakers","Austin Reaves",0,14,16,14,4,14.4
0,0,0,0,0,0,0,0,0,"00",0,0,0,0,0,0,1037839,"2023-11-27T00:00:00.000Z",23,FALSE,14,17554001,"G",23,23,"Philadelphia 76ers","Javonte Smart",0,0,0,0,0,0
0,0,0,0,0,0,0,0,0,"00",0,0,0,0,0,0,1037839,"2023-11-27T00:00:00.000Z",23,FALSE,14,56677788,"G",23,23,"Philadelphia 76ers","Terquavion Smith",0,0,0,0,0,0
0,0,0,0,0,0,0,0,0,"00",0,0,0,0,0,0,1037839,"2023-11-27T00:00:00.000Z",23,FALSE,14,17896025,"G",23,23,"Philadelphia 76ers","Jaden Springer",0,0,0,0,0,0
1,0,4,6,3,8,4,0,0,"29",0,3,11,4,0,1,1037839,"2023-11-27T00:00:00.000Z",23,FALSE,14,383,"F",14,14,"Los Angeles Lakers","Taurean Prince",0,15,16,12,5,16.3
5,1,0,1,1,12,8,2,1,"30",0,0,18,0,1,1,1037839,"2023-11-27T00:00:00.000Z",23,FALSE,14,237,"F",14,14,"Los Angeles Lakers","LeBron James",2,18,23,23,5,30.5
2,1,8,0,0,14,7,5,3,"32",3,4,17,11,1,2,1037839,"2023-11-27T00:00:00.000Z",23,FALSE,14,117,"F-C",14,14,"Los Angeles Lakers","Anthony Davis",2,28,30,19,13,37.2
0,0,0,0,0,0,0,0,0,"00",0,0,0,0,0,0,1037839,"2023-11-27T00:00:00.000Z",23,FALSE,14,360,"F",23,23,"Philadelphia 76ers","Kelly Oubre Jr.",0,0,0,0,0,0
1,1,7,5,0,9,3,0,0,"22",0,1,6,7,0,3,1037839,"2023-11-27T00:00:00.000Z",23,FALSE,14,486,"F",14,14,"Los Angeles Lakers","Christian Wood",1,13,14,7,8,15.9
0,0,0,0,0,0,0,0,0,"00",0,0,0,0,0,0,1037839,"2023-11-27T00:00:00.000Z",23,FALSE,14,56677738,"C",14,14,"Los Angeles Lakers","Colin Castleton",0,0,0,0,0,0
0,0,0,0,0,0,0,0,0,"00",0,0,0,0,0,0,1037839,"2023-11-27T00:00:00.000Z",23,FALSE,14,666609,"F",14,14,"Los Angeles Lakers","Rui Hachimura",0,0,0,0,0,0
0,0,0,0,0,0,0,0,0,"00",0,0,0,0,0,0,1037839,"2023-11-27T00:00:00.000Z",23,FALSE,14,666860,"F-G",14,14,"Los Angeles Lakers","Cameron Reddish",0,0,0,0,0,0
0,0,0,0,0,0,0,0,0,"00",0,0,0,0,0,0,1037839,"2023-11-27T00:00:00.000Z",23,FALSE,14,457,"F",14,14,"Los Angeles Lakers","Jarred Vanderbilt",0,0,0,0,0,0
0,0,0,0,0,0,0,0,0,"00",0,0,0,0,0,0,1037839,"2023-11-27T00:00:00.000Z",23,FALSE,14,1603383,"G",14,14,"Los Angeles Lakers","Gabe Vincent",0,0,0,0,0,0
3,0,0,1,0,4,2,1,1,"05",0,0,5,0,2,0,1037839,"2023-11-27T00:00:00.000Z",23,FALSE,14,260,"G-F",23,23,"Philadelphia 76ers","Furkan Korkmaz",2,5,8,8,3,15.5
0,0,1,0,0,0,0,2,1,"06",1,1,1,2,0,0,1037839,"2023-11-27T00:00:00.000Z",23,FALSE,14,3547294,"F",23,23,"Philadelphia 76ers","Kenyon Martin Jr.",0,3,3,1,2,3.4
0,0,0,0,0,0,0,0,0,"00",0,0,0,0,0,0,1037839,"2023-11-27T00:00:00.000Z",23,FALSE,14,56913527,"G",23,23,"Philadelphia 76ers","Ricky Council IV",0,0,0,0,0,0
0,0,0,0,0,0,0,0,0,"00",0,0,0,0,0,0,1037839,"2023-11-27T00:00:00.000Z",23,FALSE,14,2175,"",23,23,"Philadelphia 76ers","Danuel House Jr.",0,0,0,0,0,0
2,0,4,8,3,9,4,4,3,"28",0,3,14,4,2,0,1037840,"2023-11-27T00:00:00.000Z",29,FALSE,19,38017739,"F",29,29,"Utah Jazz","Simone Fontecchio",2,18,20,16,6,27.8
0,0,2,6,2,10,4,3,2,"29",1,1,12,3,0,1,1037840,"2023-11-27T00:00:00.000Z",29,FALSE,19,101,"F-C",29,29,"Utah Jazz","John Collins",0,15,15,12,3,14.6
2,2,5,2,1,4,2,2,2,"22",5,4,7,10,0,2,1037840,"2023-11-27T00:00:00.000Z",29,FALSE,19,11891374,"C",29,29,"Utah Jazz","Omer Yurtseven",2,17,19,9,12,26
10,0,4,9,2,16,4,6,6,"32",0,1,16,4,0,1,1037840,"2023-11-27T00:00:00.000Z",29,FALSE,19,100,"G",29,29,"Utah Jazz","Jordan Clarkson",0,20,30,26,14,34.8
3,0,4,8,3,14,6,6,4,"31",1,0,19,5,2,2,1037840,"2023-11-27T00:00:00.000Z",29,FALSE,19,56677834,"G",29,29,"Utah Jazz","Keyonte George",2,24,27,22,8,33.5
0,0,0,6,3,7,4,1,1,"16",0,1,12,0,0,0,1037840,"2023-11-27T00:00:00.000Z",29,FALSE,19,38017620,"G",29,29,"Utah Jazz","Ochai Agbaji",0,12,12,12,0,12
0,0,0,0,0,0,0,0,0,"00",0,0,0,0,0,0,1037840,"2023-11-27T00:00:00.000Z",29,FALSE,19,139,"G",29,29,"Utah Jazz","Kris Dunn",0,0,0,0,0,0
0,0,0,0,0,0,0,0,0,"00",0,0,0,0,0,0,1037840,"2023-11-27T00:00:00.000Z",29,FALSE,19,56677824,"F",29,29,"Utah Jazz","Taylor Hendricks",0,0,0,0,0,0
7,0,3,3,0,9,2,1,1,"19",0,2,5,3,0,0,1037840,"2023-11-27T00:00:00.000Z",29,FALSE,19,666650,"G",29,29,"Utah Jazz","Talen Horton-Tucker",0,8,15,12,10,19.1
3,2,7,0,0,9,7,1,0,"26",1,4,14,8,0,0,1037840,"2023-11-27T00:00:00.000Z",29,FALSE,19,38017705,"C",29,29,"Utah Jazz","Walker Kessler",2,22,25,17,11,34.1
4,0,4,0,0,1,0,4,4,"19",0,5,4,4,0,0,1037840,"2023-11-27T00:00:00.000Z",29,FALSE,19,358,"F",29,29,"Utah Jazz","Kelly Olynyk",0,8,12,8,8,14.8
0,0,0,0,0,0,0,0,0,"00",0,0,0,0,0,0,1037840,"2023-11-27T00:00:00.000Z",29,FALSE,19,666881,"F",29,29,"Utah Jazz","Luka Samanic",0,0,0,0,0,0
0,0,0,0,0,0,0,0,0,"00",0,0,0,0,0,0,1037840,"2023-11-27T00:00:00.000Z",29,FALSE,19,56677842,"F",29,29,"Utah Jazz","Brice Sensabaugh",0,0,0,0,0,0
0,0,1,6,3,9,4,0,0,"18",1,2,11,2,2,4,1037840,"2023-11-27T00:00:00.000Z",29,FALSE,19,413,"G",29,29,"Utah Jazz","Collin Sexton",2,13,13,11,2,15.4
0,0,0,0,0,0,0,0,0,"00",0,0,0,0,0,0,1037840,"2023-11-27T00:00:00.000Z",29,FALSE,19,17896023,"G",29,29,"Utah Jazz","Josh Christopher",0,0,0,0,0,0
0,0,0,0,0,0,0,0,0,"00",0,0,0,0,0,0,1037840,"2023-11-27T00:00:00.000Z",29,FALSE,19,38017630,"G",29,29,"Utah Jazz","Johnny Juzang",0,0,0,0,0,0
0,0,0,0,0,0,0,0,0,"00",0,0,0,0,0,0,1037840,"2023-11-27T00:00:00.000Z",29,FALSE,19,297,"F",29,29,"Utah Jazz","Lauri Markkanen",0,0,0,0,0,0
0,0,0,0,0,0,0,0,0,"00",0,0,0,0,0,0,1037840,"2023-11-27T00:00:00.000Z",29,FALSE,19,19465584,"F",29,29,"Utah Jazz","Micah Potter",0,0,0,0,0,0
5,0,4,2,0,22,11,4,3,"35",0,3,25,4,0,2,1037840,"2023-11-27T00:00:00.000Z",29,FALSE,19,227,"F",19,19,"New Orleans Pelicans","Brandon Ingram",0,29,34,30,9,35.3
7,0,3,1,1,16,9,9,7,"34",1,2,26,4,1,0,1037840,"2023-11-27T00:00:00.000Z",29,FALSE,19,666969,"F",19,19,"New Orleans Pelicans","Zion Williamson",1,30,37,33,11,44.3
2,1,8,1,0,10,5,6,4,"30",5,3,14,13,0,0,1037840,"2023-11-27T00:00:00.000Z",29,FALSE,19,455,"C",19,19,"New Orleans Pelicans","Jonas Valanciunas",1,27,29,16,15,35.6
0,0,4,5,2,7,4,0,0,"32",0,4,10,4,1,3,1037840,"2023-11-27T00:00:00.000Z",29,FALSE,19,17896024,"F",19,19,"New Orleans Pelicans","Herbert Jones",1,14,14,10,4,14.8
4,0,3,4,0,6,1,0,0,"24",0,4,2,3,0,1,1037840,"2023-11-27T00:00:00.000Z",29,FALSE,19,38017677,"G",19,19,"New Orleans Pelicans","Dyson Daniels",0,5,9,6,7,10.6
2,0,1,0,0,3,2,0,0,"14",0,2,4,1,0,0,1037840,"2023-11-27T00:00:00.000Z",29,FALSE,19,17896097,"G",19,19,"New Orleans Pelicans","Jose Alvarado",0,5,7,6,3,8.2
0,0,4,6,3,11,5,0,0,"25",1,1,13,5,0,0,1037840,"2023-11-27T00:00:00.000Z",29,FALSE,19,56677837,"G",19,19,"New Orleans Pelicans","Jordan Hawkins",0,18,18,13,5,19
0,0,0,0,0,0,0,0,0,"00",0,0,0,0,0,0,1037840,"2023-11-27T00:00:00.000Z",29,FALSE,19,3547260,"G",19,19,"New Orleans Pelicans","Kira Lewis Jr.",0,0,0,0,0,0
3,0,7,3,1,12,6,2,1,"28",2,3,14,9,3,1,1037840,"2023-11-27T00:00:00.000Z",29,FALSE,19,3547293,"F",19,19,"New Orleans Pelicans","Naji Marshall",3,23,26,17,12,37.3
2,0,2,0,0,1,1,2,1,"09",2,1,3,4,0,1,1037840,"2023-11-27T00:00:00.000Z",29,FALSE,19,340,"F",19,19,"New Orleans Pelicans","Larry Nance Jr.",0,7,9,5,6,9.8
0,0,0,0,0,0,0,0,0,"00",0,0,0,0,0,0,1037840,"2023-11-27T00:00:00.000Z",29,FALSE,19,17896021,"F",19,19,"New Orleans Pelicans","Jeremiah Robinson-Earl",0,0,0,0,0,0
2,0,1,0,0,0,0,2,1,"09",0,2,1,1,0,0,1037840,"2023-11-27T00:00:00.000Z",29,FALSE,19,491,"C",19,19,"New Orleans Pelicans","Cody Zeller",0,2,4,3,3,5.2
0,0,0,0,0,0,0,0,0,"00",0,0,0,0,0,0,1037840,"2023-11-27T00:00:00.000Z",29,FALSE,19,38017663,"F",19,19,"New Orleans Pelicans","E.J. Liddell",0,0,0,0,0,0
0,0,0,0,0,0,0,0,0,"00",0,0,0,0,0,0,1037840,"2023-11-27T00:00:00.000Z",29,FALSE,19,303,"G",19,19,"New Orleans Pelicans","CJ McCollum",0,0,0,0,0,0
0,0,0,0,0,0,0,0,0,"00",0,0,0,0,0,0,1037840,"2023-11-27T00:00:00.000Z",29,FALSE,19,18677986,"F",19,19,"New Orleans Pelicans","Trey Murphy III",0,0,0,0,0,0
0,0,0,0,0,0,0,0,0,"00",0,0,0,0,0,0,1037840,"2023-11-27T00:00:00.000Z",29,FALSE,19,17896017,"F",19,19,"New Orleans Pelicans","Matt Ryan",0,0,0,0,0,0
0,0,0,0,0,0,0,0,0,"00",0,0,0,0,0,0,1037840,"2023-11-27T00:00:00.000Z",29,FALSE,19,38017726,"G",19,19,"New Orleans Pelicans","Dereon Seabron",0,0,0,0,0,0
3,2,7,5,2,26,10,9,9,"39",1,0,31,8,1,2,1037841,"2023-11-27T00:00:00.000Z",13,FALSE,8,274,"F",13,13,"LA Clippers","Kawhi Leonard",3,39,42,34,11,52.1
4,1,5,4,0,13,2,2,2,"37",3,5,6,8,1,3,1037841,"2023-11-27T00:00:00.000Z",13,FALSE,8,172,"F",13,13,"LA Clippers","Paul George",2,14,18,10,12,24.6
1,1,6,0,0,15,9,8,5,"32",8,2,23,14,0,1,1037841,"2023-11-27T00:00:00.000Z",13,FALSE,8,493,"C",13,13,"LA Clippers","Ivica Zubac",1,37,38,24,15,43.3
0,1,2,1,0,3,2,2,1,"30",1,2,5,3,0,1,1037841,"2023-11-27T00:00:00.000Z",13,FALSE,8,666743,"G",13,13,"LA Clippers","Terance Mann",1,8,8,5,3,10.6
4,0,2,5,3,7,3,2,2,"36",0,3,11,2,1,3,1037841,"2023-11-27T00:00:00.000Z",13,FALSE,8,192,"G",13,13,"LA Clippers","James Harden",1,13,17,15,6,19.4
0,0,0,0,0,0,0,0,0,"00",0,0,0,0,0,0,1037841,"2023-11-27T00:00:00.000Z",13,FALSE,8,56677849,"F",13,13,"LA Clippers","Kobe Brown",0,0,0,0,0,0
0,0,0,0,0,0,0,0,0,"00",0,0,0,0,0,0,1037841,"2023-11-27T00:00:00.000Z",13,FALSE,8,666511,"G",13,13,"LA Clippers","Amir Coffey",0,0,0,0,0,0
0,0,0,0,0,0,0,0,0,"00",0,0,0,0,0,0,1037841,"2023-11-27T00:00:00.000Z",13,FALSE,8,38017725,"F",13,13,"LA Clippers","Moussa Diabate",0,0,0,0,0,0
0,0,0,0,0,0,0,0,0,"00",0,0,0,0,0,0,1037841,"2023-11-27T00:00:00.000Z",13,FALSE,8,17896031,"G",13,13,"LA Clippers","Nah'Shon Hyland",0,0,0,0,0,0
0,0,0,0,0,0,0,0,0,"00",0,0,0,0,0,0,1037841,"2023-11-27T00:00:00.000Z",13,FALSE,8,56677856,"G",13,13,"LA Clippers","Jordan Miller",0,0,0,0,0,0
0,0,0,0,0,0,0,0,0,"00",0,0,0,0,0,0,1037841,"2023-11-27T00:00:00.000Z",13,FALSE,8,24417679,"G",13,13,"LA Clippers","Xavier Moon",0,0,0,0,0,0
1,1,1,5,1,8,2,5,5,"21",1,3,10,2,1,0,1037841,"2023-11-27T00:00:00.000Z",13,FALSE,8,380,"F-G",13,13,"LA Clippers","Norman Powell",2,12,13,11,3,19.9
1,2,0,0,0,4,2,0,0,"12",1,3,4,1,0,1,1037841,"2023-11-27T00:00:00.000Z",13,FALSE,8,439,"F",13,13,"LA Clippers","Daniel Theis",2,5,6,5,2,11.7
1,0,0,0,0,0,0,0,0,"06",0,1,0,0,2,0,1037841,"2023-11-27T00:00:00.000Z",13,FALSE,8,450,"F",13,13,"LA Clippers","PJ Tucker",2,0,1,1,1,7.5
3,1,10,0,0,9,5,6,4,"27",1,4,14,11,0,2,1037841,"2023-11-27T00:00:00.000Z",13,FALSE,8,472,"G",13,13,"LA Clippers","Russell Westbrook",1,25,28,17,14,32.7
0,0,0,0,0,0,0,0,0,"00",0,0,0,0,0,0,1037841,"2023-11-27T00:00:00.000Z",13,FALSE,8,17896022,"G",13,13,"LA Clippers","Brandon Boston Jr.",0,0,0,0,0,0
0,0,0,0,0,0,0,0,0,"00",0,0,0,0,0,0,1037841,"2023-11-27T00:00:00.000Z",13,FALSE,8,371,"F-C",13,13,"LA Clippers","Mason Plumlee",0,0,0,0,0,0
0,0,0,0,0,0,0,0,0,"00",0,0,0,0,0,0,1037841,"2023-11-27T00:00:00.000Z",13,FALSE,8,17896051,"G",13,13,"LA Clippers","Joshua Primo",0,0,0,0,0,0
3,0,7,7,2,13,3,0,0,"29",3,5,8,10,0,1,1037841,"2023-11-27T00:00:00.000Z",13,FALSE,8,375,"F",8,8,"Denver Nuggets","Michael Porter Jr.",0,18,21,11,13,23.5
1,0,5,4,2,8,5,0,0,"34",1,2,12,6,1,3,1037841,"2023-11-27T00:00:00.000Z",13,FALSE,8,215,"F-G",8,8,"Denver Nuggets","Justin Holiday",1,18,19,13,7,20.7
5,1,10,0,0,11,8,11,5,"33",3,3,21,13,2,2,1037841,"2023-11-27T00:00:00.000Z",13,FALSE,8,250,"C",8,8,"Denver Nuggets","DeAndre Jordan",3,34,39,26,18,51.1
2,0,1,1,0,14,3,6,6,"38",2,2,12,3,1,0,1037841,"2023-11-27T00:00:00.000Z",13,FALSE,8,81,"G",8,8,"Denver Nuggets","Kentavious Caldwell-Pope",1,15,17,14,5,21.6
13,0,4,4,3,19,15,4,2,"40",1,3,35,5,2,2,1037841,"2023-11-27T00:00:00.000Z",13,FALSE,8,236,"G",8,8,"Denver Nuggets","Reggie Jackson",2,40,53,48,18,64.5
2,0,1,1,0,4,0,0,0,"12",1,4,0,2,0,0,1037841,"2023-11-27T00:00:00.000Z",13,FALSE,8,38017709,"G",8,8,"Denver Nuggets","Christian Braun",0,2,4,2,4,5.4
0,0,0,0,0,0,0,0,0,"00",0,0,0,0,0,0,1037841,"2023-11-27T00:00:00.000Z",13,FALSE,8,38017727,"G",8,8,"Denver Nuggets","Collin Gillespie",0,0,0,0,0,0
0,0,0,0,0,0,0,0,0,"01",0,0,0,0,0,0,1037841,"2023-11-27T00:00:00.000Z",13,FALSE,8,17896103,"F-C",8,8,"Denver Nuggets","Jay Huff",0,0,0,0,0,0
0,0,0,0,0,0,0,0,0,"00",0,0,0,0,0,0,1037841,"2023-11-27T00:00:00.000Z",13,FALSE,8,17896007,"G",8,8,"Denver Nuggets","Braxton Key",0,0,0,0,0,0
0,3,0,0,0,8,3,5,2,"11",7,2,8,7,0,1,1037841,"2023-11-27T00:00:00.000Z",13,FALSE,8,3547268,"F-C",8,8,"Denver Nuggets","Zeke Nnaji",3,15,15,8,7,24.4
0,0,0,0,0,0,0,0,0,"00",0,0,0,0,0,0,1037841,"2023-11-27T00:00:00.000Z",13,FALSE,8,56677582,"G",8,8,"Denver Nuggets","Jalen Pickett",0,0,0,0,0,0
1,1,3,5,3,8,3,0,0,"19",0,1,9,3,0,1,1037841,"2023-11-27T00:00:00.000Z",13,FALSE,8,56677776,"G",8,8,"Denver Nuggets","Julian Strawther",1,12,13,10,4,16.1
1,1,3,0,0,7,4,2,0,"23",0,0,8,3,2,1,1037841,"2023-11-27T00:00:00.000Z",13,FALSE,8,38017721,"G",8,8,"Denver Nuggets","Peyton Watson",3,11,12,9,4,21.1
0,0,0,0,0,0,0,0,0,"00",0,0,0,0,0,0,1037841,"2023-11-27T00:00:00.000Z",13,FALSE,8,666489,"F",8,8,"Denver Nuggets","Vlatko Cancar",0,0,0,0,0,0
0,0,0,0,0,0,0,0,0,"00",0,0,0,0,0,0,1037841,"2023-11-27T00:00:00.000Z",13,FALSE,8,177,"F",8,8,"Denver Nuggets","Aaron Gordon",0,0,0,0,0,0
0,0,0,0,0,0,0,0,0,"00",0,0,0,0,0,0,1037841,"2023-11-27T00:00:00.000Z",13,FALSE,8,246,"C",8,8,"Denver Nuggets","Nikola Jokic",0,0,0,0,0,0
0,0,0,0,0,0,0,0,0,"00",0,0,0,0,0,0,1037841,"2023-11-27T00:00:00.000Z",13,FALSE,8,335,"G",8,8,"Denver Nuggets","Jamal Murray",0,0,0,0,0,0
0,0,0,0,0,0,0,0,0,"00",0,0,0,0,0,0,1037841,"2023-11-27T00:00:00.000Z",13,FALSE,8,56677871,"F",8,8,"Denver Nuggets","Hunter Tyson",0,0,0,0,0,0
6,1,6,8,3,23,12,5,3,"35",2,1,30,8,0,3,3277527,"2023-11-28T00:00:00.000Z",2,FALSE,5,70,"G",2,2,"Boston Celtics","Jaylen Brown",1,38,44,36,14,48.6
4,0,6,8,2,16,8,3,3,"35",1,2,21,7,0,4,3277527,"2023-11-28T00:00:00.000Z",2,FALSE,5,434,"F",2,2,"Boston Celtics","Jayson Tatum",0,28,32,25,11,31.4
6,3,9,6,4,8,6,0,0,"28",0,3,16,9,2,3,3277527,"2023-11-28T00:00:00.000Z",2,FALSE,5,219,"C-F",2,2,"Boston Celtics","Al Horford",5,25,31,22,15,47.8
7,0,3,3,2,7,5,2,2,"28",0,4,14,3,2,0,3277527,"2023-11-28T00:00:00.000Z",2,FALSE,5,473,"G",2,2,"Boston Celtics","Derrick White",2,17,24,21,10,34.1
9,0,6,5,4,8,5,0,0,"33",1,3,14,7,1,3,3277527,"2023-11-28T00:00:00.000Z",2,FALSE,5,214,"G",2,2,"Boston Celtics","Jrue Holiday",1,21,30,23,16,35.9
0,1,0,2,1,3,2,0,0,"15",0,1,5,0,0,0,3277527,"2023-11-28T00:00:00.000Z",2,FALSE,5,17896094,"G",2,2,"Boston Celtics","Dalano Banton",1,5,5,5,0,8
0,0,0,0,0,0,0,0,0,"00",0,0,0,0,0,0,3277527,"2023-11-28T00:00:00.000Z",2,FALSE,5,666468,"F",2,2,"Boston Celtics","Oshae Brissett",0,0,0,0,0,0
2,0,6,10,2,12,3,2,1,"21",4,1,9,10,0,2,3277527,"2023-11-28T00:00:00.000Z",2,FALSE,5,17896060,"F",2,2,"Boston Celtics","Sam Hauser",0,19,21,11,12,22
0,3,1,0,0,3,2,0,0,"19",2,3,4,3,0,1,3277527,"2023-11-28T00:00:00.000Z",2,FALSE,5,261,"F-C",2,2,"Boston Celtics","Luke Kornet",3,7,7,4,3,15.6
0,0,0,0,0,0,0,0,0,"02",0,0,0,0,0,0,3277527,"2023-11-28T00:00:00.000Z",2,FALSE,5,338,"G",2,2,"Boston Celtics","Svi Mykhailiuk",0,0,0,0,0,0
2,0,4,7,3,10,4,0,0,"23",1,0,11,5,1,0,3277527,"2023-11-28T00:00:00.000Z",2,FALSE,5,3547276,"G",2,2,"Boston Celtics","Payton Pritchard",1,16,18,13,7,23
0,0,0,0,0,0,0,0,0,"00",0,0,0,0,0,0,3277527,"2023-11-28T00:00:00.000Z",2,FALSE,5,17553967,"C",2,2,"Boston Celtics","Neemias Queta",0,0,0,0,0,0
0,1,0,0,0,0,0,0,0,"01",0,0,0,0,0,0,3277527,"2023-11-28T00:00:00.000Z",2,FALSE,5,3547279,"F",2,2,"Boston Celtics","Lamar Stevens",1,0,0,0,0,3
0,0,0,0,0,0,0,0,0,"00",0,0,0,0,0,0,3277527,"2023-11-28T00:00:00.000Z",2,FALSE,5,38017707,"G",2,2,"Boston Celtics","JD Davison",0,0,0,0,0,0
0,0,0,0,0,0,0,0,0,"00",0,0,0,0,0,0,3277527,"2023-11-28T00:00:00.000Z",2,FALSE,5,3547295,"F-C",2,2,"Boston Celtics","Nathan Knight",0,0,0,0,0,0
0,0,0,0,0,0,0,0,0,"00",0,0,0,0,0,0,3277527,"2023-11-28T00:00:00.000Z",2,FALSE,5,378,"F-C",2,2,"Boston Celtics","Kristaps Porzingis",0,0,0,0,0,0
0,0,0,0,0,0,0,0,0,"00",0,0,0,0,0,0,3277527,"2023-11-28T00:00:00.000Z",2,FALSE,5,56677864,"G",2,2,"Boston Celtics","Jordan Walsh",0,0,0,0,0,0
6,0,2,3,1,14,7,4,4,"26",0,2,19,2,0,2,3277527,"2023-11-28T00:00:00.000Z",2,FALSE,5,125,"G",5,5,"Chicago Bulls","DeMar DeRozan",0,21,27,25,8,28.4
2,2,3,3,1,10,6,2,1,"28",4,2,14,7,1,2,3277527,"2023-11-28T00:00:00.000Z",2,FALSE,5,3547248,"F",5,5,"Chicago Bulls","Patrick Williams",3,21,23,16,9,32.4
2,1,8,2,0,11,4,0,0,"25",0,1,8,8,2,1,3277527,"2023-11-28T00:00:00.000Z",2,FALSE,5,460,"C",5,5,"Chicago Bulls","Nikola Vucevic",3,16,18,10,10,28.6
4,0,1,3,0,9,1,0,0,"25",1,1,2,2,2,0,3277527,"2023-11-28T00:00:00.000Z",2,FALSE,5,268,"G",5,5,"Chicago Bulls","Zach LaVine",2,4,8,6,6,16.4
3,0,1,5,3,12,7,2,2,"30",0,0,19,1,0,0,3277527,"2023-11-28T00:00:00.000Z",2,FALSE,5,666956,"G",5,5,"Chicago Bulls","Coby White",0,20,23,22,4,24.7
2,0,0,3,1,10,4,2,1,"24",0,3,10,0,1,0,3277527,"2023-11-28T00:00:00.000Z",2,FALSE,5,17895983,"G",5,5,"Chicago Bulls","Ayo Dosunmu",1,10,12,12,2,16
2,1,1,1,0,7,4,0,0,"17",0,0,8,1,0,1,3277527,"2023-11-28T00:00:00.000Z",2,FALSE,5,87,"G",5,5,"Chicago Bulls","Jevon Carter",1,9,11,10,3,14.2
2,0,1,6,2,9,3,0,0,"19",1,2,8,2,3,1,3277527,"2023-11-28T00:00:00.000Z",2,FALSE,5,89,"G",5,5,"Chicago Bulls","Alex Caruso",3,10,12,10,4,21.4
0,1,1,1,1,1,1,0,0,"13",0,0,3,1,1,0,3277527,"2023-11-28T00:00:00.000Z",2,FALSE,5,110,"F",5,5,"Chicago Bulls","Torrey Craig",2,4,4,3,1,10.2
0,1,4,0,0,5,2,6,1,"13",2,1,5,6,0,0,3277527,"2023-11-28T00:00:00.000Z",2,FALSE,5,137,"C",5,5,"Chicago Bulls","Andre Drummond",1,11,11,5,6,15.2
1,0,2,1,0,2,0,2,1,"10",0,0,1,2,0,1,3277527,"2023-11-28T00:00:00.000Z",2,FALSE,5,56677857,"F",5,5,"Chicago Bulls","Julian Phillips",0,3,4,2,3,3.9
0,0,0,0,0,0,0,0,0,"03",0,0,0,0,1,0,3277527,"2023-11-28T00:00:00.000Z",2,FALSE,5,17896116,"G",5,5,"Chicago Bulls","Terry Taylor",1,0,0,0,0,3
1,1,4,0,0,0,0,0,0,"07",1,1,0,5,0,0,3277527,"2023-11-28T00:00:00.000Z",2,FALSE,5,38017719,"F",5,5,"Chicago Bulls","Dalen Terry",1,5,6,1,6,10.5
0,0,0,0,0,0,0,0,0,"00",0,0,0,0,0,0,3277527,"2023-11-28T00:00:00.000Z",2,FALSE,5,27,"G",5,5,"Chicago Bulls","Lonzo Ball",0,0,0,0,0,0
0,0,0,0,0,0,0,0,0,"00",0,0,0,0,0,0,3277527,"2023-11-28T00:00:00.000Z",2,FALSE,5,56677874,"F",5,5,"Chicago Bulls","Onuralp Bitim",0,0,0,0,0,0
0,0,0,0,0,0,0,0,0,"00",0,0,0,0,0,0,3277527,"2023-11-28T00:00:00.000Z",2,FALSE,5,45969255,"F",5,5,"Chicago Bulls","Justin Lewis",0,0,0,0,0,0
0,0,0,0,0,0,0,0,0,"00",0,0,0,0,0,0,3277527,"2023-11-28T00:00:00.000Z",2,FALSE,5,56677860,"F",5,5,"Chicago Bulls","Adama Sanogo",0,0,0,0,0,0
3,0,8,4,1,11,6,5,5,"27",1,1,18,9,0,2,3277528,"2023-11-28T00:00:00.000Z",3,FALSE,28,666679,"F",3,3,"Brooklyn Nets","Cameron Johnson",0,27,30,21,12,31.3
2,1,4,4,1,9,2,0,0,"26",5,4,5,9,1,0,3277528,"2023-11-28T00:00:00.000Z",3,FALSE,28,158,"F",3,3,"Brooklyn Nets","Dorian Finney-Smith",2,14,16,7,11,24.8
0,4,6,0,0,10,7,4,1,"32",2,1,15,8,1,0,3277528,"2023-11-28T00:00:00.000Z",3,FALSE,28,666508,"F-C",3,3,"Brooklyn Nets","Nicolas Claxton",5,23,23,15,8,39.6
5,0,9,3,1,17,9,3,3,"38",1,3,22,10,0,5,3277528,"2023-11-28T00:00:00.000Z",3,FALSE,28,61,"F",3,3,"Brooklyn Nets","Mikal Bridges",0,32,37,27,15,36.5
8,0,8,11,3,18,5,10,10,"38",1,0,23,9,4,1,3277528,"2023-11-28T00:00:00.000Z",3,FALSE,28,130,"G",3,3,"Brooklyn Nets","Spencer Dinwiddie",4,32,40,31,17,56.8
0,0,0,0,0,0,0,0,0,"00",0,0,0,0,0,0,3277528,"2023-11-28T00:00:00.000Z",3,FALSE,28,9051997,"G",3,3,"Brooklyn Nets","Armoni Brooks",0,0,0,0,0,0
0,0,0,0,0,0,0,0,0,"00",0,0,0,0,0,0,3277528,"2023-11-28T00:00:00.000Z",3,FALSE,28,174,"F-C",3,3,"Brooklyn Nets","Harry Giles III",0,0,0,0,0,0
4,2,5,12,6,12,6,0,0,"31",2,5,18,7,1,1,3277528,"2023-11-28T00:00:00.000Z",3,FALSE,28,351,"F",3,3,"Brooklyn Nets","Royce O'Neale",3,25,29,22,11,40.4
2,0,4,0,0,4,2,1,1,"15",1,2,5,5,0,0,3277528,"2023-11-28T00:00:00.000Z",3,FALSE,28,17896038,"C",3,3,"Brooklyn Nets","Day'Ron Sharpe",0,10,12,7,7,14
2,0,8,4,0,18,6,7,5,"35",2,2,17,10,1,2,3277528,"2023-11-28T00:00:00.000Z",3,FALSE,28,416,"F",28,28,"Toronto Raptors","Pascal Siakam",1,27,29,19,12,33
4,2,6,0,0,5,3,0,0,"25",3,2,6,9,1,1,3277528,"2023-11-28T00:00:00.000Z",3,FALSE,28,373,"C",28,28,"Toronto Raptors","Jakob Poeltl",3,15,19,10,13,30.8
6,0,7,7,3,19,5,5,4,"36",4,4,17,11,3,1,3277528,"2023-11-28T00:00:00.000Z",3,FALSE,28,17896055,"G-F",28,28,"Toronto Raptors","Scottie Barnes",3,28,34,23,17,47.2
9,0,4,5,2,15,5,3,2,"32",1,3,14,5,1,0,3277528,"2023-11-28T00:00:00.000Z",3,FALSE,28,409,"G",28,28,"Toronto Raptors","Dennis Schroder",1,19,28,23,14,36.5
1,0,2,2,0,4,0,4,1,"10",1,3,1,3,1,1,3277528,"2023-11-28T00:00:00.000Z",3,FALSE,28,3547249,"F",28,28,"Toronto Raptors","Precious Achiuwa",1,4,5,2,4,8.1
1,0,0,3,1,5,2,0,0,"16",0,1,5,0,0,0,3277528,"2023-11-28T00:00:00.000Z",3,FALSE,28,3547275,"G",28,28,"Toronto Raptors","Malachi Flynn",0,5,6,6,1,6.5
1,0,2,4,1,12,7,0,0,"25",0,1,15,2,1,0,3277528,"2023-11-28T00:00:00.000Z",3,FALSE,28,3089,"",28,28,"Toronto Raptors","Gary Trent Jr.",1,17,18,16,3,21.9
2,1,1,4,1,6,2,3,2,"22",0,0,7,1,0,3,3277528,"2023-11-28T00:00:00.000Z",3,FALSE,28,464,"G",3,3,"Brooklyn Nets","Lonnie Walker IV",1,8,10,9,3,11.2
0,0,1,0,0,2,1,0,0,"11",0,1,2,1,0,3,3277528,"2023-11-28T00:00:00.000Z",3,FALSE,28,17896058,"F",3,3,"Brooklyn Nets","Trendon Watford",0,3,3,2,1,0.2
0,0,0,0,0,0,0,0,0,"00",0,0,0,0,0,0,3277528,"2023-11-28T00:00:00.000Z",3,FALSE,28,56677722,"F",3,3,"Brooklyn Nets","Jalen Wilson",0,0,0,0,0,0
0,0,0,0,0,0,0,0,0,"00",0,0,0,0,0,0,3277528,"2023-11-28T00:00:00.000Z",3,FALSE,28,56677843,"F",3,3,"Brooklyn Nets","Noah Clowney",0,0,0,0,0,0
0,0,0,0,0,0,0,0,0,"00",0,0,0,0,0,0,3277528,"2023-11-28T00:00:00.000Z",3,FALSE,28,17896041,"G",3,3,"Brooklyn Nets","Keon Johnson",0,0,0,0,0,0
0,0,0,0,0,0,0,0,0,"00",0,0,0,0,0,0,3277528,"2023-11-28T00:00:00.000Z",3,FALSE,28,417,"G-F",3,3,"Brooklyn Nets","Ben Simmons",0,0,0,0,0,0
0,0,0,0,0,0,0,0,0,"00",0,0,0,0,0,0,3277528,"2023-11-28T00:00:00.000Z",3,FALSE,28,421,"G",3,3,"Brooklyn Nets","Dennis Smith Jr.",0,0,0,0,0,0
0,0,0,0,0,0,0,0,0,"00",0,0,0,0,0,0,3277528,"2023-11-28T00:00:00.000Z",3,FALSE,28,17896048,"G",3,3,"Brooklyn Nets","Cam Thomas",0,0,0,0,0,0
0,0,0,0,0,0,0,0,0,"00",0,0,0,0,0,0,3277528,"2023-11-28T00:00:00.000Z",3,FALSE,28,56677841,"F",3,3,"Brooklyn Nets","Dariq Whitehead",0,0,0,0,0,0
2,0,1,6,2,12,4,0,0,"36",2,3,10,3,0,2,3277528,"2023-11-28T00:00:00.000Z",3,FALSE,28,18,"F",28,28,"Toronto Raptors","OG Anunoby",0,13,15,12,5,14.6
0,0,0,4,3,7,5,0,0,"12",1,0,13,1,1,0,3277528,"2023-11-28T00:00:00.000Z",3,FALSE,28,58,"F",28,28,"Toronto Raptors","Chris Boucher",1,14,14,13,1,17.2
1,1,1,1,1,4,2,0,0,"13",1,2,5,2,2,0,3277528,"2023-11-28T00:00:00.000Z",3,FALSE,28,666762,"F",28,28,"Toronto Raptors","Jalen McDaniels",3,7,8,6,3,17.9
0,0,0,0,0,0,0,0,0,"00",0,0,0,0,0,0,3277528,"2023-11-28T00:00:00.000Z",3,FALSE,28,376,"F",28,28,"Toronto Raptors","Otto Porter Jr.",0,0,0,0,0,0
0,0,0,0,0,0,0,0,0,"00",0,0,0,0,0,0,3277528,"2023-11-28T00:00:00.000Z",3,FALSE,28,436,"G-F",28,28,"Toronto Raptors","Garrett Temple",0,0,0,0,0,0
0,0,0,0,0,0,0,0,0,"00",0,0,0,0,0,0,3277528,"2023-11-28T00:00:00.000Z",3,FALSE,28,489,"F",28,28,"Toronto Raptors","Thaddeus Young",0,0,0,0,0,0
0,0,0,0,0,0,0,0,0,"00",0,0,0,0,0,0,3277528,"2023-11-28T00:00:00.000Z",3,FALSE,28,56677828,"G",28,28,"Toronto Raptors","Gradey Dick",0,0,0,0,0,0
0,0,0,0,0,0,0,0,0,"00",0,0,0,0,0,0,3277528,"2023-11-28T00:00:00.000Z",3,FALSE,28,56677805,"G",28,28,"Toronto Raptors","Javon Freeman-Liberty",0,0,0,0,0,0
0,0,0,0,0,0,0,0,0,"00",0,0,0,0,0,0,3277528,"2023-11-28T00:00:00.000Z",3,FALSE,28,38017717,"F",28,28,"Toronto Raptors","Ron Harper Jr.",0,0,0,0,0,0
0,0,0,0,0,0,0,0,0,"00",0,0,0,0,0,0,3277528,"2023-11-28T00:00:00.000Z",3,FALSE,28,38017710,"C",28,28,"Toronto Raptors","Christian Koloko",0,0,0,0,0,0
0,0,0,0,0,0,0,0,0,"00",0,0,0,0,0,0,3277528,"2023-11-28T00:00:00.000Z",3,FALSE,28,56677869,"G",28,28,"Toronto Raptors","Markquis Nowell",0,0,0,0,0,0
7,2,1,7,3,11,4,0,0,"35",2,2,11,3,2,0,3277529,"2023-11-28T00:00:00.000Z",6,FALSE,1,666908,"G",6,6,"Cleveland Cavaliers","Max Strus",4,14,21,18,10,37.1
1,7,14,1,1,11,8,0,0,"34",5,4,17,19,0,1,3277529,"2023-11-28T00:00:00.000Z",6,FALSE,1,17896076,"F-C",6,6,"Cleveland Cavaliers","Evan Mobley",7,36,37,18,20,61.3
2,0,7,0,0,6,5,1,1,"30",1,4,11,8,0,0,3277529,"2023-11-28T00:00:00.000Z",6,FALSE,1,9,"C",6,6,"Cleveland Cavaliers","Jarrett Allen",0,19,21,13,10,23.6
5,1,9,11,3,25,14,9,9,"35",2,3,40,11,3,6,3277529,"2023-11-28T00:00:00.000Z",6,FALSE,1,322,"G",6,6,"Cleveland Cavaliers","Donovan Mitchell",4,51,56,45,16,66.7
8,0,1,5,2,15,7,4,3,"38",1,1,19,2,2,2,3277529,"2023-11-28T00:00:00.000Z",6,FALSE,1,666581,"G",6,6,"Cleveland Cavaliers","Darius Garland",2,21,29,27,10,37.4
0,0,0,0,0,0,0,0,0,"00",0,0,0,0,0,0,3277529,"2023-11-28T00:00:00.000Z",6,FALSE,1,248,"C",6,6,"Cleveland Cavaliers","Damian Jones",0,0,0,0,0,0
1,0,3,5,2,8,4,0,0,"30",0,3,10,3,1,4,3277529,"2023-11-28T00:00:00.000Z",6,FALSE,1,277,"G",6,6,"Cleveland Cavaliers","Caris LeVert",1,13,14,11,4,14.1
0,0,0,0,0,0,0,0,0,"00",0,0,0,0,0,0,3277529,"2023-11-28T00:00:00.000Z",6,FALSE,1,3547299,"G",6,6,"Cleveland Cavaliers","Sam Merrill",0,0,0,0,0,0
1,0,7,6,2,9,4,2,2,"19",0,3,12,7,0,1,3277529,"2023-11-28T00:00:00.000Z",6,FALSE,1,344,"F",6,6,"Cleveland Cavaliers","Georges Niang",0,19,20,13,8,20.9
2,2,1,1,0,6,3,1,0,"16",1,0,6,2,0,0,3277529,"2023-11-28T00:00:00.000Z",6,FALSE,1,3547247,"F-G",6,6,"Cleveland Cavaliers","Isaac Okoro",2,8,10,8,4,17.4
0,0,0,0,0,2,1,0,0,"03",0,0,2,0,0,2,3277529,"2023-11-28T00:00:00.000Z",6,FALSE,1,56677872,"G",6,6,"Cleveland Cavaliers","Craig Porter",0,2,2,2,0,0
0,0,0,0,0,0,0,0,0,"00",0,0,0,0,0,0,3277529,"2023-11-28T00:00:00.000Z",6,FALSE,1,444,"C-F",6,6,"Cleveland Cavaliers","Tristan Thompson",0,0,0,0,0,0
0,0,0,0,0,0,0,0,0,"00",0,0,0,0,0,0,3277529,"2023-11-28T00:00:00.000Z",6,FALSE,1,56677847,"F",6,6,"Cleveland Cavaliers","Emoni Bates",0,0,0,0,0,0
0,0,0,0,0,0,0,0,0,"00",0,0,0,0,0,0,3277529,"2023-11-28T00:00:00.000Z",6,FALSE,1,666676,"G",6,6,"Cleveland Cavaliers","Ty Jerome",0,0,0,0,0,0
0,0,0,0,0,0,0,0,0,"00",0,0,0,0,0,0,3277529,"2023-11-28T00:00:00.000Z",6,FALSE,1,38017662,"F",6,6,"Cleveland Cavaliers","Isaiah Mobley",0,0,0,0,0,0
0,0,0,0,0,0,0,0,0,"00",0,0,0,0,0,0,3277529,"2023-11-28T00:00:00.000Z",6,FALSE,1,404,"G",6,6,"Cleveland Cavaliers","Ricky Rubio",0,0,0,0,0,0
0,0,0,0,0,0,0,0,0,"00",0,0,0,0,0,0,3277529,"2023-11-28T00:00:00.000Z",6,FALSE,1,666940,"F",6,6,"Cleveland Cavaliers","Dean Wade",0,0,0,0,0,0
2,0,4,6,1,12,5,7,7,"26",0,4,18,4,0,0,3277529,"2023-11-28T00:00:00.000Z",6,FALSE,1,666656,"F",1,1,"Atlanta Hawks","De'Andre Hunter",0,22,24,20,6,25.8
3,0,3,4,2,8,5,2,2,"32",1,4,14,4,2,0,3277529,"2023-11-28T00:00:00.000Z",6,FALSE,1,3547256,"F",1,1,"Atlanta Hawks","Saddiq Bey",2,18,21,17,7,29.3
0,2,3,0,0,10,6,2,2,"22",6,1,14,9,2,2,3277529,"2023-11-28T00:00:00.000Z",6,FALSE,1,83,"C",1,1,"Atlanta Hawks","Clint Capela",4,23,23,14,9,34.8
1,1,2,7,3,14,5,0,0,"31",1,0,13,3,2,3,3277529,"2023-11-28T00:00:00.000Z",6,FALSE,1,334,"G",1,1,"Atlanta Hawks","Dejounte Murray",3,16,17,14,4,24.1
0,0,1,0,0,6,1,0,0,"04",2,1,2,3,0,1,3277529,"2023-11-28T00:00:00.000Z",6,FALSE,1,666564,"F",1,1,"Atlanta Hawks","Bruno Fernando",0,5,5,2,3,4.6
0,0,0,0,0,1,0,0,0,"04",0,0,0,0,0,0,3277529,"2023-11-28T00:00:00.000Z",6,FALSE,1,3547297,"G",1,1,"Atlanta Hawks","Trent Forrest",0,0,0,0,0,0
0,0,0,4,0,8,0,0,0,"15",1,1,0,1,0,0,3277529,"2023-11-28T00:00:00.000Z",6,FALSE,1,38017689,"F",1,1,"Atlanta Hawks","AJ Griffin",0,1,1,0,1,1.2
0,0,1,1,0,1,0,0,0,"04",0,0,0,1,0,0,3277529,"2023-11-28T00:00:00.000Z",6,FALSE,1,666754,"G",1,1,"Atlanta Hawks","Garrison Mathews",0,1,1,0,1,1.2
2,0,3,3,0,3,0,0,0,"17",0,0,0,3,0,0,3277529,"2023-11-28T00:00:00.000Z",6,FALSE,1,301,"G-F",1,1,"Atlanta Hawks","Wesley Matthews",0,3,5,2,5,6.6
0,0,0,0,0,0,0,0,0,"00",0,0,0,0,0,0,3277529,"2023-11-28T00:00:00.000Z",6,FALSE,1,319,"G",1,1,"Atlanta Hawks","Patty Mills",0,0,0,0,0,0
2,0,7,1,1,8,4,5,4,"22",2,0,13,9,0,0,3277529,"2023-11-28T00:00:00.000Z",6,FALSE,1,3547244,"F-C",1,1,"Atlanta Hawks","Onyeka Okongwu",0,22,24,15,11,26.8
0,0,0,0,0,0,0,0,0,"00",0,0,0,0,0,0,3277529,"2023-11-28T00:00:00.000Z",6,FALSE,1,56677838,"G",1,1,"Atlanta Hawks","Kobe Bufkin",0,0,0,0,0,0
0,0,0,0,0,0,0,0,0,"00",0,0,0,0,0,0,3277529,"2023-11-28T00:00:00.000Z",6,FALSE,1,56677806,"F",1,1,"Atlanta Hawks","Mouhamed Gueye",0,0,0,0,0,0
0,0,0,0,0,0,0,0,0,"00",0,0,0,0,0,0,3277529,"2023-11-28T00:00:00.000Z",6,FALSE,1,17896040,"F",1,1,"Atlanta Hawks","Jalen Johnson",0,0,0,0,0,0
0,0,0,0,0,0,0,0,0,"00",0,0,0,0,0,0,3277529,"2023-11-28T00:00:00.000Z",6,FALSE,1,56677855,"G",1,1,"Atlanta Hawks","Seth Lundy",0,0,0,0,0,0
0,0,0,0,0,0,0,0,0,"00",0,0,0,0,0,0,3277529,"2023-11-28T00:00:00.000Z",6,FALSE,1,56677875,"F",1,1,"Atlanta Hawks","Miles Norris",0,0,0,0,0,0
10,0,1,8,2,14,3,6,5,"32",0,3,13,1,1,3,3277529,"2023-11-28T00:00:00.000Z",6,FALSE,1,490,"G",1,1,"Atlanta Hawks","Trae Young",1,14,24,23,11,29.2
1,0,5,10,4,16,6,2,2,"31",1,2,18,6,2,1,3277529,"2023-11-28T00:00:00.000Z",6,FALSE,1,53,"G",1,1,"Atlanta Hawks","Bogdan Bogdanovic",2,24,25,19,7,31.7
7,0,2,7,3,13,7,4,3,"37",1,2,20,3,0,0,3277530,"2023-11-28T00:00:00.000Z",16,FALSE,17,391,"G-F",16,16,"Miami Heat","Josh Richardson",0,23,30,27,10,34.1
4,0,6,5,2,11,2,0,0,"26",4,2,6,10,0,0,3277530,"2023-11-28T00:00:00.000Z",16,FALSE,17,285,"F-C",16,16,"Miami Heat","Kevin Love",0,16,20,10,14,24
5,2,8,0,0,27,13,7,5,"42",2,3,31,10,0,2,3277530,"2023-11-28T00:00:00.000Z",16,FALSE,17,4,"C-F",16,16,"Miami Heat","Bam Adebayo",2,41,46,36,15,54.5
3,1,3,7,3,11,5,2,0,"31",0,3,13,3,0,2,3277530,"2023-11-28T00:00:00.000Z",16,FALSE,17,397,"F",16,16,"Miami Heat","Duncan Robinson",1,16,19,16,6,22.1
6,1,4,5,3,10,7,4,4,"34",0,5,21,4,1,1,3277530,"2023-11-28T00:00:00.000Z",16,FALSE,17,286,"G",16,16,"Miami Heat","Kyle Lowry",2,25,31,27,10,39.8
0,0,0,0,0,0,0,0,0,"00",0,0,0,0,0,0,3277530,"2023-11-28T00:00:00.000Z",16,FALSE,17,74,"C",16,16,"Miami Heat","Thomas Bryant",0,0,0,0,0,0
0,0,0,0,0,0,0,0,0,"00",0,0,0,0,0,0,3277530,"2023-11-28T00:00:00.000Z",16,FALSE,17,3547257,"G",16,16,"Miami Heat","R.J. Hampton",0,0,0,0,0,0
0,0,0,0,0,0,0,0,0,"00",0,0,0,0,0,0,3277530,"2023-11-28T00:00:00.000Z",16,FALSE,17,666633,"G",16,16,"Miami Heat","Tyler Herro",0,0,0,0,0,0
0,0,0,0,0,0,0,0,0,"00",0,0,0,0,0,0,3277530,"2023-11-28T00:00:00.000Z",16,FALSE,17,19465585,"G",16,16,"Miami Heat","Dru Smith",0,0,0,0,0,0
2,0,7,3,1,13,7,2,2,"23",1,3,17,8,0,0,3277530,"2023-11-28T00:00:00.000Z",16,FALSE,17,315,"F",17,17,"Milwaukee Bucks","Khris Middleton",0,25,27,19,10,29.6
5,1,8,2,1,16,11,13,10,"40",2,3,33,10,2,4,3277530,"2023-11-28T00:00:00.000Z",16,FALSE,17,15,"F",17,17,"Milwaukee Bucks","Giannis Antetokounmpo",3,43,48,38,15,57.5
4,1,3,4,0,10,5,2,2,"32",1,4,12,4,0,2,3277530,"2023-11-28T00:00:00.000Z",16,FALSE,17,283,"C",17,17,"Milwaukee Bucks","Brook Lopez",1,16,20,16,8,23.8
1,2,10,8,4,11,6,0,0,"38",0,1,16,10,1,0,3277530,"2023-11-28T00:00:00.000Z",16,FALSE,17,38,"G",17,17,"Milwaukee Bucks","Malik Beasley",3,26,27,17,11,38.5
9,0,2,9,4,18,9,10,10,"37",2,1,32,4,0,1,3277530,"2023-11-28T00:00:00.000Z",16,FALSE,17,278,"G",17,17,"Milwaukee Bucks","Damian Lillard",0,36,45,41,13,49.3
0,0,0,0,0,0,0,0,0,"00",0,0,0,0,0,0,3277530,"2023-11-28T00:00:00.000Z",16,FALSE,17,2148,"",17,17,"Milwaukee Bucks","Thanasis Antetokounmpo",0,0,0,0,0,0
1,0,3,0,0,2,0,0,0,"09",1,4,0,4,0,1,3277530,"2023-11-28T00:00:00.000Z",16,FALSE,17,38017676,"F",17,17,"Milwaukee Bucks","MarJon Beauchamp",0,4,5,1,5,5.3
1,0,1,3,1,5,3,0,0,"15",0,0,7,1,0,0,3277530,"2023-11-28T00:00:00.000Z",16,FALSE,17,105,"G",17,17,"Milwaukee Bucks","Pat Connaughton",0,8,9,8,2,9.7
0,0,0,1,0,1,0,0,0,"02",0,1,0,0,0,0,3277530,"2023-11-28T00:00:00.000Z",16,FALSE,17,38017733,"G",17,17,"Milwaukee Bucks","A.J. Green",0,0,0,0,0,0
0,0,0,2,2,2,2,0,0,"03",1,0,6,1,0,0,3277530,"2023-11-28T00:00:00.000Z",16,FALSE,17,56677852,"G",17,17,"Milwaukee Bucks","Andre Jackson Jr.",0,7,7,6,1,7.2
0,0,0,0,0,0,0,0,0,"00",0,0,0,0,0,0,3277530,"2023-11-28T00:00:00.000Z",16,FALSE,17,56677854,"F",17,17,"Milwaukee Bucks","Chris Livingston",0,0,0,0,0,0
0,0,0,0,0,0,0,0,0,"00",0,0,0,0,0,0,3277530,"2023-11-28T00:00:00.000Z",16,FALSE,17,284,"C",17,17,"Milwaukee Bucks","Robin Lopez",0,0,0,0,0,0
3,0,1,1,0,2,1,0,0,"18",0,2,2,1,0,1,3277530,"2023-11-28T00:00:00.000Z",16,FALSE,17,368,"G",17,17,"Milwaukee Bucks","Cameron Payne",0,3,6,5,4,6.7
0,0,2,2,0,8,3,0,0,"23",0,2,6,2,0,0,3277530,"2023-11-28T00:00:00.000Z",16,FALSE,17,377,"F",17,17,"Milwaukee Bucks","Bobby Portis",0,8,8,6,2,8.4
0,0,0,0,0,0,0,0,0,"00",0,0,0,0,0,0,3277530,"2023-11-28T00:00:00.000Z",16,FALSE,17,666453,"C",17,17,"Milwaukee Bucks","Marques Bolden",0,0,0,0,0,0
0,0,0,0,0,0,0,0,0,"00",0,0,0,0,0,0,3277530,"2023-11-28T00:00:00.000Z",16,FALSE,17,112,"F",17,17,"Milwaukee Bucks","Jae Crowder",0,0,0,0,0,0
0,0,0,0,0,0,0,0,0,"00",0,0,0,0,0,0,3277530,"2023-11-28T00:00:00.000Z",16,FALSE,17,38017691,"G",17,17,"Milwaukee Bucks","TyTy Washington Jr.",0,0,0,0,0,0
0,0,0,0,0,0,0,0,0,"00",0,0,0,0,0,0,3277530,"2023-11-28T00:00:00.000Z",16,FALSE,17,666960,"G",17,17,"Milwaukee Bucks","Lindell Wigginton",0,0,0,0,0,0
0,0,0,0,0,0,0,0,0,"00",0,0,0,0,0,0,3277530,"2023-11-28T00:00:00.000Z",16,FALSE,17,79,"G-F",16,16,"Miami Heat","Jimmy Butler",0,0,0,0,0,0
0,0,0,2,1,2,1,4,2,"11",0,0,5,0,0,0,3277530,"2023-11-28T00:00:00.000Z",16,FALSE,17,38017734,"F",16,16,"Miami Heat","Jamal Cain",0,5,5,5,0,5
0,0,0,0,0,0,0,0,0,"00",0,0,0,0,0,0,3277530,"2023-11-28T00:00:00.000Z",16,FALSE,17,3092,"",16,16,"Miami Heat","Haywood Highsmith",0,0,0,0,0,0
6,1,3,1,0,9,7,0,0,"33",1,5,14,4,1,1,3277530,"2023-11-28T00:00:00.000Z",16,FALSE,17,56677785,"G",16,16,"Miami Heat","Jaime Jaquez Jr.",2,18,24,20,10,32.8
0,0,0,0,0,0,0,0,0,"00",0,0,0,0,0,0,3277530,"2023-11-28T00:00:00.000Z",16,FALSE,17,38017696,"F",16,16,"Miami Heat","Nikola Jovic",0,0,0,0,0,0
1,0,1,3,2,11,6,0,0,"26",0,2,14,1,1,0,3277530,"2023-11-28T00:00:00.000Z",16,FALSE,17,666747,"F",16,16,"Miami Heat","Caleb Martin",1,15,16,15,2,19.7
0,0,0,0,0,0,0,0,0,"00",0,0,0,0,0,0,3277530,"2023-11-28T00:00:00.000Z",16,FALSE,17,39398582,"C",16,16,"Miami Heat","Orlando Robinson",0,0,0,0,0,0
0,0,0,0,0,0,0,0,0,"00",0,0,0,0,0,0,3277530,"2023-11-28T00:00:00.000Z",16,FALSE,17,38017736,"F",16,16,"Miami Heat","Cole Swider",0,0,0,0,0,0
1,0,3,10,4,20,9,1,1,"26",0,1,23,3,0,1,3277531,"2023-11-28T00:00:00.000Z",20,FALSE,4,3547269,"G",20,20,"New York Knicks","Immanuel Quickley",0,26,27,24,4,27.1
0,0,0,0,0,0,0,0,0,"05",0,0,0,0,1,0,3277531,"2023-11-28T00:00:00.000Z",20,FALSE,4,56677866,"F",4,4,"Charlotte Hornets","Leaky Black",1,0,0,0,0,3
2,0,3,4,1,13,3,9,9,"28",0,1,16,3,1,1,3277531,"2023-11-28T00:00:00.000Z",20,FALSE,4,666423,"F-G",20,20,"New York Knicks","RJ Barrett",1,19,21,18,5,24.6
5,0,16,7,2,15,8,8,7,"34",4,2,25,20,2,4,3277531,"2023-11-28T00:00:00.000Z",20,FALSE,4,387,"F",20,20,"New York Knicks","Julius Randle",2,45,50,30,25,58.5
0,6,5,0,0,6,3,0,0,"33",5,1,6,10,2,4,3277531,"2023-11-28T00:00:00.000Z",20,FALSE,4,399,"C",20,20,"New York Knicks","Mitchell Robinson",8,16,16,6,10,38
7,0,2,5,2,9,5,1,0,"33",1,3,12,3,3,2,3277531,"2023-11-28T00:00:00.000Z",20,FALSE,4,73,"G",20,20,"New York Knicks","Jalen Brunson",3,15,22,19,10,33.1
1,0,0,3,2,4,2,0,0,"19",1,0,6,1,0,1,3277531,"2023-11-28T00:00:00.000Z",20,FALSE,4,17895858,"G",20,20,"New York Knicks","Quentin Grimes",0,7,8,7,2,7.7
0,0,0,0,0,0,0,0,0,"00",0,0,0,0,0,0,3277531,"2023-11-28T00:00:00.000Z",20,FALSE,4,19,"G",20,20,"New York Knicks","Ryan Arcidiacono",0,0,0,0,0,0
0,0,2,6,2,8,2,0,0,"19",0,0,6,2,1,2,3277531,"2023-11-28T00:00:00.000Z",20,FALSE,4,131,"G",20,20,"New York Knicks","Donte DiVincenzo",1,8,8,6,2,9.4
0,0,0,0,0,0,0,0,0,"00",0,0,0,0,0,0,3277531,"2023-11-28T00:00:00.000Z",20,FALSE,4,160,"G-F",20,20,"New York Knicks","Evan Fournier",0,0,0,0,0,0
2,1,5,3,2,10,7,1,1,"30",1,2,17,6,1,1,3277531,"2023-11-28T00:00:00.000Z",20,FALSE,4,202,"G",20,20,"New York Knicks","Josh Hart",2,23,25,19,8,32.2
2,0,3,0,0,3,2,0,0,"14",3,2,4,6,0,0,3277531,"2023-11-28T00:00:00.000Z",20,FALSE,4,201,"F-C",20,20,"New York Knicks","Isaiah Hartenstein",0,10,12,6,8,14.2
0,0,0,2,1,3,2,0,0,"05",1,0,5,1,0,0,3277531,"2023-11-28T00:00:00.000Z",20,FALSE,4,17896037,"G",4,4,"Charlotte Hornets","James Bouknight",0,6,6,5,1,6.2
2,0,0,1,0,2,0,0,0,"05",0,1,0,0,0,0,3277531,"2023-11-28T00:00:00.000Z",20,FALSE,4,3547253,"G",4,4,"Charlotte Hornets","Theo Maledon",0,0,2,2,2,3
0,0,1,2,1,5,2,0,0,"13",1,1,5,2,1,0,3277531,"2023-11-28T00:00:00.000Z",20,FALSE,4,38017708,"G",4,4,"Charlotte Hornets","Bryce McGowens",1,7,7,5,2,10.4
1,0,1,0,0,3,2,0,0,"14",0,1,4,1,0,3,3277531,"2023-11-28T00:00:00.000Z",20,FALSE,4,422,"G",4,4,"Charlotte Hornets","Ish Smith",0,5,6,5,2,3.7
0,0,0,2,2,4,3,0,0,"05",0,0,8,0,0,0,3277531,"2023-11-28T00:00:00.000Z",20,FALSE,4,56677846,"G",4,4,"Charlotte Hornets","Nick Smith Jr.",0,8,8,8,0,8
0,0,2,0,0,0,0,0,0,"13",0,1,0,2,0,1,3277531,"2023-11-28T00:00:00.000Z",20,FALSE,4,18678001,"F",4,4,"Charlotte Hornets","JT Thor",0,2,2,0,2,1.4
3,1,5,8,3,10,4,2,0,"27",3,3,11,8,1,3,3277531,"2023-11-28T00:00:00.000Z",20,FALSE,4,666950,"F",4,4,"Charlotte Hornets","P.J. Washington",2,19,22,14,11,28.1
0,0,0,0,0,0,0,0,0,"00",0,0,0,0,0,0,3277531,"2023-11-28T00:00:00.000Z",20,FALSE,4,56677848,"G",4,4,"Charlotte Hornets","Amari Bailey",0,0,0,0,0,0
0,0,0,0,0,0,0,0,0,"00",0,0,0,0,0,0,3277531,"2023-11-28T00:00:00.000Z",20,FALSE,4,3547239,"G",4,4,"Charlotte Hornets","LaMelo Ball",0,0,0,0,0,0
0,0,0,0,0,0,0,0,0,"00",0,0,0,0,0,0,3277531,"2023-11-28T00:00:00.000Z",20,FALSE,4,666748,"F",4,4,"Charlotte Hornets","Cody Martin",0,0,0,0,0,0
0,0,0,0,0,0,0,0,0,"00",0,0,0,0,0,0,3277531,"2023-11-28T00:00:00.000Z",20,FALSE,4,347,"G",4,4,"Charlotte Hornets","Frank Ntilikina",0,0,0,0,0,0
0,0,0,0,0,0,0,0,0,"00",0,0,0,0,0,0,3277531,"2023-11-28T00:00:00.000Z",20,FALSE,4,3547282,"C",4,4,"Charlotte Hornets","Nick Richards",0,0,0,0,0,0
0,0,0,0,0,0,0,0,0,"01",0,0,0,0,0,0,3277531,"2023-11-28T00:00:00.000Z",20,FALSE,4,666675,"F",20,20,"New York Knicks","DaQuan Jeffries",0,0,0,0,0,0
1,0,0,0,0,0,0,0,0,"01",0,0,0,0,0,0,3277531,"2023-11-28T00:00:00.000Z",20,FALSE,4,17896033,"G",20,20,"New York Knicks","Miles McBride",0,0,1,1,1,1.5
0,0,0,0,0,0,0,0,0,"02",0,0,0,0,0,0,3277531,"2023-11-28T00:00:00.000Z",20,FALSE,4,17896063,"F",20,20,"New York Knicks","Jericho Sims",0,0,0,0,0,0
0,0,0,0,0,0,0,0,0,"00",0,0,0,0,0,0,3277531,"2023-11-28T00:00:00.000Z",20,FALSE,4,666474,"G",20,20,"New York Knicks","Charles Brown",0,0,0,0,0,0
0,0,0,0,0,0,0,0,0,"00",0,0,0,0,0,0,3277531,"2023-11-28T00:00:00.000Z",20,FALSE,4,59421201,"G",20,20,"New York Knicks","Jaylen Martin",0,0,0,0,0,0
0,0,0,0,0,0,0,0,0,"00",0,0,0,0,0,0,3277531,"2023-11-28T00:00:00.000Z",20,FALSE,4,56677795,"F",20,20,"New York Knicks","Jacob Toppin",0,0,0,0,0,0
0,0,0,0,0,0,0,0,0,"00",0,0,0,0,0,0,3277531,"2023-11-28T00:00:00.000Z",20,FALSE,4,666971,"G-F",20,20,"New York Knicks","Dylan Windler",0,0,0,0,0,0
2,1,4,3,2,12,5,2,1,"32",0,2,13,4,2,2,3277531,"2023-11-28T00:00:00.000Z",20,FALSE,4,62,"F",4,4,"Charlotte Hornets","Miles Bridges",3,17,19,15,6,27.8
6,0,4,2,0,7,2,0,0,"28",2,1,4,6,0,2,3277531,"2023-11-28T00:00:00.000Z",20,FALSE,4,204,"F",4,4,"Charlotte Hornets","Gordon Hayward",0,10,16,10,12,18.2
0,0,6,0,0,9,5,2,2,"25",6,2,12,12,1,0,3277531,"2023-11-28T00:00:00.000Z",20,FALSE,4,38017698,"C",4,4,"Charlotte Hornets","Mark Williams",1,24,24,12,12,29.4
2,0,3,8,4,18,7,0,0,"36",0,2,18,3,1,3,3277531,"2023-11-28T00:00:00.000Z",20,FALSE,4,56677823,"F",4,4,"Charlotte Hornets","Brandon Miller",1,21,23,20,5,24.6
5,0,2,3,0,16,5,1,1,"32",0,0,11,2,1,3,3277531,"2023-11-28T00:00:00.000Z",20,FALSE,4,403,"G",4,4,"Charlotte Hornets","Terry Rozier",1,13,18,16,7,20.9
1,0,1,5,1,7,1,0,0,"26",1,2,3,2,0,2,3277532,"2023-11-28T00:00:00.000Z",18,FALSE,21,666400,"G",18,18,"Minnesota Timberwolves","Nickeil Alexander-Walker",0,5,6,4,3,4.9
3,0,10,3,1,8,2,8,8,"32",0,4,13,10,0,6,3277532,"2023-11-28T00:00:00.000Z",18,FALSE,21,447,"C",18,18,"Minnesota Timberwolves","Karl-Anthony Towns",0,23,26,16,13,23.5
0,4,10,0,0,10,6,6,5,"36",6,1,17,16,1,1,3277532,"2023-11-28T00:00:00.000Z",18,FALSE,21,176,"C",18,18,"Minnesota Timberwolves","Rudy Gobert",5,33,33,17,16,50.2
1,1,5,6,3,16,7,6,4,"28",0,2,21,5,0,2,3277532,"2023-11-28T00:00:00.000Z",18,FALSE,21,3547238,"G",18,18,"Minnesota Timberwolves","Anthony Edwards",1,26,27,22,6,29.5
8,0,2,10,3,14,3,0,0,"37",0,2,9,2,1,0,3277532,"2023-11-28T00:00:00.000Z",18,FALSE,21,104,"G",18,18,"Minnesota Timberwolves","Mike Conley",1,11,19,17,10,26.4
2,1,3,0,0,6,2,4,3,"23",2,1,7,5,0,4,3277532,"2023-11-28T00:00:00.000Z",18,FALSE,21,12,"F",18,18,"Minnesota Timberwolves","Kyle Anderson",1,12,14,9,7,15
0,0,3,4,3,6,5,6,4,"21",0,2,17,3,0,1,3277532,"2023-11-28T00:00:00.000Z",18,FALSE,21,68,"F",18,18,"Minnesota Timberwolves","Troy Brown Jr.",0,20,20,17,3,19.6
0,0,0,0,0,0,0,0,0,"00",0,0,0,0,0,0,3277532,"2023-11-28T00:00:00.000Z",18,FALSE,21,56677782,"F",18,18,"Minnesota Timberwolves","Leonard Miller",0,0,0,0,0,0
1,1,1,1,0,2,1,2,2,"12",0,1,4,1,1,2,3277532,"2023-11-28T00:00:00.000Z",18,FALSE,21,320,"G",18,18,"Minnesota Timberwolves","Shake Milton",2,5,6,5,2,10.7
0,0,0,0,0,0,0,0,0,"00",0,0,0,0,0,0,3277532,"2023-11-28T00:00:00.000Z",18,FALSE,21,38017715,"F",18,18,"Minnesota Timberwolves","Josh Minott",0,0,0,0,0,0
0,0,0,0,0,0,0,0,0,"00",0,0,0,0,0,0,3277532,"2023-11-28T00:00:00.000Z",18,FALSE,21,38017700,"G",18,18,"Minnesota Timberwolves","Wendell Moore Jr.",0,0,0,0,0,0
0,0,0,0,0,0,0,0,0,"00",0,0,0,0,0,0,3277532,"2023-11-28T00:00:00.000Z",18,FALSE,21,17895968,"F",18,18,"Minnesota Timberwolves","Daishen Nix",0,0,0,0,0,0
2,2,6,4,3,9,6,0,0,"25",1,2,15,7,0,1,3277532,"2023-11-28T00:00:00.000Z",18,FALSE,21,667378,"F-C",18,18,"Minnesota Timberwolves","Naz Reid",2,22,24,17,9,31.4
0,0,0,0,0,0,0,0,0,"00",0,0,0,0,0,0,3277532,"2023-11-28T00:00:00.000Z",18,FALSE,21,56677851,"G",18,18,"Minnesota Timberwolves","Jaylen Clark",0,0,0,0,0,0
0,0,0,0,0,0,0,0,0,"00",0,0,0,0,0,0,3277532,"2023-11-28T00:00:00.000Z",18,FALSE,21,17896056,"C",18,18,"Minnesota Timberwolves","Luka Garza",0,0,0,0,0,0
0,0,0,0,0,0,0,0,0,"00",0,0,0,0,0,0,3277532,"2023-11-28T00:00:00.000Z",18,FALSE,21,3547259,"F",18,18,"Minnesota Timberwolves","Jaden McDaniels",0,0,0,0,0,0
0,0,0,0,0,0,0,0,0,"00",0,0,0,0,0,0,3277532,"2023-11-28T00:00:00.000Z",18,FALSE,21,666767,"G",18,18,"Minnesota Timberwolves","Jordan McLaughlin",0,0,0,0,0,0
1,0,3,2,1,5,1,0,0,"25",0,5,3,3,0,1,3277532,"2023-11-28T00:00:00.000Z",18,FALSE,21,666541,"G",21,21,"Oklahoma City Thunder","Luguentz Dort",0,6,7,4,4,7.1
3,1,3,3,0,10,2,7,6,"34",0,4,10,3,0,1,3277532,"2023-11-28T00:00:00.000Z",18,FALSE,21,38017703,"G-F",21,21,"Oklahoma City Thunder","Jalen Williams",1,13,16,13,6,20.1
6,1,6,8,3,20,6,2,1,"34",2,2,16,8,1,0,3277532,"2023-11-28T00:00:00.000Z",18,FALSE,21,38017685,"C-F",21,21,"Oklahoma City Thunder","Chet Holmgren",2,24,30,22,14,40.6
1,0,3,1,0,8,4,4,2,"28",3,1,10,6,0,2,3277532,"2023-11-28T00:00:00.000Z",18,FALSE,21,17896065,"G",21,21,"Oklahoma City Thunder","Josh Giddey",0,16,17,11,7,16.7
4,2,3,1,0,22,13,6,6,"34",1,2,32,4,3,3,3277532,"2023-11-28T00:00:00.000Z",18,FALSE,21,175,"G",21,21,"Oklahoma City Thunder","Shai Gilgeous-Alexander",5,36,40,36,8,54.8
0,0,0,0,0,0,0,0,0,"00",0,0,0,0,0,0,3277532,"2023-11-28T00:00:00.000Z",18,FALSE,21,44,"F",21,21,"Oklahoma City Thunder","Davis Bertans",0,0,0,0,0,0
0,0,1,0,0,1,0,0,0,"02",0,0,0,1,0,0,3277532,"2023-11-28T00:00:00.000Z",18,FALSE,21,38017716,"F",21,21,"Oklahoma City Thunder","Ousmane Dieng",0,1,1,0,1,1.2
3,0,1,5,1,7,3,2,2,"24",0,2,9,1,3,0,3277532,"2023-11-28T00:00:00.000Z",18,FALSE,21,3547272,"G",21,21,"Oklahoma City Thunder","Isaiah Joe",3,10,13,12,4,23.7
0,0,0,0,0,0,0,0,0,"00",0,0,0,0,0,0,3277532,"2023-11-28T00:00:00.000Z",18,FALSE,21,17896036,"G",21,21,"Oklahoma City Thunder","Tre Mann",0,0,0,0,0,0
0,0,0,0,0,0,0,0,0,"00",0,0,0,0,0,0,3277532,"2023-11-28T00:00:00.000Z",18,FALSE,21,4197029,"G",21,21,"Oklahoma City Thunder","Vasilije Micic",0,0,0,0,0,0
0,0,0,0,0,0,0,0,0,"00",0,0,0,0,0,0,3277532,"2023-11-28T00:00:00.000Z",18,FALSE,21,24572055,"C",21,21,"Oklahoma City Thunder","Olivier Sarr",0,0,0,0,0,0
0,0,0,3,3,4,3,2,1,"17",0,0,10,0,1,0,3277532,"2023-11-28T00:00:00.000Z",18,FALSE,21,56677833,"G",21,21,"Oklahoma City Thunder","Cason Wallace",1,10,10,10,0,13
1,0,2,2,2,4,3,0,0,"16",1,2,8,3,0,0,3277532,"2023-11-28T00:00:00.000Z",18,FALSE,21,17896078,"G",21,21,"Oklahoma City Thunder","Aaron Wiggins",0,11,12,9,4,13.1
3,0,4,3,1,6,1,0,0,"11",1,1,3,5,0,1,3277532,"2023-11-28T00:00:00.000Z",18,FALSE,21,38017706,"F",21,21,"Oklahoma City Thunder","Jaylin Williams",0,8,11,6,8,12.5
0,0,1,2,0,3,1,0,0,"15",1,4,2,2,0,0,3277532,"2023-11-28T00:00:00.000Z",18,FALSE,21,480,"G-F",21,21,"Oklahoma City Thunder","Kenrich Williams",0,4,4,2,2,4.4
0,0,0,0,0,0,0,0,0,"00",0,0,0,0,0,0,3277532,"2023-11-28T00:00:00.000Z",18,FALSE,21,56677853,"F",21,21,"Oklahoma City Thunder","Keyontae Johnson",0,0,0,0,0,0
0,0,0,0,0,0,0,0,0,"00",0,0,0,0,0,0,3277532,"2023-11-28T00:00:00.000Z",18,FALSE,21,3547271,"C",21,21,"Oklahoma City Thunder","Aleksej Pokusevski",0,0,0,0,0,0
0,0,0,0,0,0,0,0,0,"00",0,0,0,0,0,0,3277532,"2023-11-28T00:00:00.000Z",18,FALSE,21,27924547,"F",21,21,"Oklahoma City Thunder","Lindy Waters III",0,0,0,0,0,0
2,1,6,1,1,4,2,0,0,"30",1,4,5,7,0,1,3277533,"2023-11-28T00:00:00.000Z",7,FALSE,11,3547258,"G",7,7,"Dallas Mavericks","Josh Green",1,12,14,7,9,18.4
3,0,4,3,0,5,0,0,0,"17",0,4,0,4,0,2,3277533,"2023-11-28T00:00:00.000Z",7,FALSE,11,666965,"F",7,7,"Dallas Mavericks","Grant Williams",0,4,7,3,7,7.3
2,2,3,0,0,4,4,0,0,"28",2,5,8,5,0,0,3277533,"2023-11-28T00:00:00.000Z",7,FALSE,11,56677840,"C",7,7,"Dallas Mavericks","Dereck Lively II",2,13,15,10,7,23
5,1,1,7,2,22,8,9,9,"36",1,1,27,2,1,0,3277533,"2023-11-28T00:00:00.000Z",7,FALSE,11,228,"G",7,7,"Dallas Mavericks","Kyrie Irving",2,29,34,32,7,42.9
9,0,9,10,3,29,15,9,8,"38",0,3,41,9,2,0,3277533,"2023-11-28T00:00:00.000Z",7,FALSE,11,132,"F-G",7,7,"Dallas Mavericks","Luka Doncic",2,50,59,50,18,71.3
0,0,0,0,0,0,0,0,0,"01",0,0,0,0,0,0,3277533,"2023-11-28T00:00:00.000Z",7,FALSE,11,114,"G",7,7,"Dallas Mavericks","Seth Curry",0,0,0,0,0,0
3,0,0,2,1,4,3,8,5,"15",1,0,12,1,1,2,3277533,"2023-11-28T00:00:00.000Z",7,FALSE,11,151,"G",7,7,"Dallas Mavericks","Dante Exum",1,13,16,15,4,18.7
0,0,0,8,3,12,4,0,0,"21",1,0,11,1,0,0,3277533,"2023-11-28T00:00:00.000Z",7,FALSE,11,191,"G",7,7,"Dallas Mavericks","Tim Hardaway Jr.",0,12,12,11,1,12.2
0,0,0,0,0,1,0,0,0,"04",0,0,0,0,0,0,3277533,"2023-11-28T00:00:00.000Z",7,FALSE,11,38017679,"G",7,7,"Dallas Mavericks","Jaden Hardy",0,0,0,0,0,0
0,0,3,0,0,1,1,0,0,"13",0,4,2,3,0,2,3277533,"2023-11-28T00:00:00.000Z",7,FALSE,11,217,"F-C",7,7,"Dallas Mavericks","Richaun Holmes",0,5,5,2,3,3.6
1,0,3,3,2,7,5,3,3,"34",3,4,15,6,1,0,3277533,"2023-11-28T00:00:00.000Z",7,FALSE,11,247,"F-G",7,7,"Dallas Mavericks","Derrick Jones Jr.",1,21,22,16,7,26.7
0,0,0,0,0,0,0,0,0,"00",0,0,0,0,0,0,3277533,"2023-11-28T00:00:00.000Z",7,FALSE,11,329,"F",7,7,"Dallas Mavericks","Markieff Morris",0,0,0,0,0,0
0,0,0,0,0,0,0,0,0,"03",0,0,0,0,0,0,3277533,"2023-11-28T00:00:00.000Z",7,FALSE,11,379,"F-C",7,7,"Dallas Mavericks","Dwight Powell",0,0,0,0,0,0
0,0,0,0,0,0,0,0,0,"00",0,0,0,0,0,0,3277533,"2023-11-28T00:00:00.000Z",7,FALSE,11,56677859,"F",7,7,"Dallas Mavericks","Olivier-Maxence Prosper",0,0,0,0,0,0
0,0,0,0,0,0,0,0,0,"00",0,0,0,0,0,0,3277533,"2023-11-28T00:00:00.000Z",7,FALSE,11,17896028,"F",7,7,"Dallas Mavericks","Greg Brown III",0,0,0,0,0,0
0,0,0,0,0,0,0,0,0,"00",0,0,0,0,0,0,3277533,"2023-11-28T00:00:00.000Z",7,FALSE,11,17554004,"G",7,7,"Dallas Mavericks","AJ Lawson",0,0,0,0,0,0
1,0,1,4,1,13,7,2,1,"28",0,6,16,1,0,1,3277533,"2023-11-28T00:00:00.000Z",7,FALSE,11,66,"G-F",11,11,"Houston Rockets","Dillon Brooks",0,17,18,17,2,17.7
2,1,8,5,2,11,7,0,0,"37",1,2,16,9,0,1,3277533,"2023-11-28T00:00:00.000Z",7,FALSE,11,38017684,"F",11,11,"Houston Rockets","Jabari Smith Jr.",1,25,27,18,11,31.8
6,1,5,2,0,19,10,14,11,"35",4,2,31,9,0,3,3277533,"2023-11-28T00:00:00.000Z",7,FALSE,11,17896062,"F-C",11,11,"Houston Rockets","Alperen Sengun",1,40,46,37,15,50.8
5,1,2,6,2,14,5,0,0,"33",1,4,12,3,0,2,3277533,"2023-11-28T00:00:00.000Z",7,FALSE,11,17895966,"G",11,11,"Houston Rockets","Jalen Green",1,15,20,17,8,24.1
12,1,4,7,1,9,3,3,3,"41",0,3,10,4,1,0,3277533,"2023-11-28T00:00:00.000Z",7,FALSE,11,458,"G",11,11,"Houston Rockets","Fred VanVleet",2,14,26,22,16,38.8
0,0,0,0,0,0,0,0,0,"00",0,0,0,0,0,0,3277533,"2023-11-28T00:00:00.000Z",7,FALSE,11,75,"G-F",11,11,"Houston Rockets","Reggie Bullock",0,0,0,0,0,0
0,2,6,0,0,7,4,5,3,"21",2,4,11,8,0,2,3277533,"2023-11-28T00:00:00.000Z",7,FALSE,11,38017695,"F",11,11,"Houston Rockets","Tari Eason",2,19,19,11,8,24.6
1,0,0,0,0,2,2,2,2,"13",0,1,6,0,0,2,3277533,"2023-11-28T00:00:00.000Z",7,FALSE,11,188,"F",11,11,"Houston Rockets","Jeff Green",0,6,7,7,1,5.5
0,0,0,0,0,0,0,0,0,"00",0,0,0,0,0,0,3277533,"2023-11-28T00:00:00.000Z",7,FALSE,11,3547281,"G-F",11,11,"Houston Rockets","Nate Hinton",0,0,0,0,0,0
4,0,3,4,2,8,3,0,0,"21",1,3,8,4,0,1,3277533,"2023-11-28T00:00:00.000Z",7,FALSE,11,213,"G",11,11,"Houston Rockets","Aaron Holiday",0,12,16,12,8,17.8
0,0,0,0,0,0,0,0,0,"00",0,0,0,0,0,0,3277533,"2023-11-28T00:00:00.000Z",7,FALSE,11,19465326,"C",11,11,"Houston Rockets","Jock Landale",0,0,0,0,0,0
0,0,0,0,0,0,0,0,0,"00",0,0,0,0,0,0,3277533,"2023-11-28T00:00:00.000Z",7,FALSE,11,56677873,"G",7,7,"Dallas Mavericks","Dexter Dennis",0,0,0,0,0,0
0,0,0,0,0,0,0,0,0,"00",0,0,0,0,0,0,3277533,"2023-11-28T00:00:00.000Z",7,FALSE,11,257,"F",7,7,"Dallas Mavericks","Maxi Kleber",0,0,0,0,0,0
0,0,0,0,0,0,0,0,0,"00",0,0,0,0,0,0,3277533,"2023-11-28T00:00:00.000Z",7,FALSE,11,296,"C",11,11,"Houston Rockets","Boban Marjanovic",0,0,0,0,0,0
0,0,0,0,0,0,0,0,0,"00",0,0,0,0,0,0,3277533,"2023-11-28T00:00:00.000Z",7,FALSE,11,56677809,"F",11,11,"Houston Rockets","Jermaine Samuels Jr.",0,0,0,0,0,0
2,0,1,1,0,2,1,3,3,"11",1,2,5,2,1,0,3277533,"2023-11-28T00:00:00.000Z",7,FALSE,11,3547301,"F",11,11,"Houston Rockets","Jae'Sean Tate",1,7,9,7,4,13.4
0,0,0,0,0,0,0,0,0,"00",0,0,0,0,0,0,3277533,"2023-11-28T00:00:00.000Z",7,FALSE,11,56677831,"F",11,11,"Houston Rockets","Cam Whitmore",0,0,0,0,0,0
0,0,0,0,0,0,0,0,0,"00",0,0,0,0,0,0,3277533,"2023-11-28T00:00:00.000Z",7,FALSE,11,357,"G",11,11,"Houston Rockets","Victor Oladipo",0,0,0,0,0,0
0,0,0,0,0,0,0,0,0,"00",0,0,0,0,0,0,3277533,"2023-11-28T00:00:00.000Z",7,FALSE,11,56677825,"G-F",11,11,"Houston Rockets","Amen Thompson",0,0,0,0,0,0
0,0,0,0,0,0,0,0,0,"00",0,0,0,0,0,0,3277533,"2023-11-28T00:00:00.000Z",7,FALSE,11,47738533,"G",11,11,"Houston Rockets","Jeenathan Williams",0,0,0,0,0,0
5,0,6,7,4,14,8,2,1,"33",3,5,21,9,0,1,3277534,"2023-11-28T00:00:00.000Z",26,FALSE,10,221,"G",26,26,"Sacramento Kings","Kevin Huerter",0,30,35,26,14,38.3
1,1,4,5,2,8,5,0,0,"26",0,1,12,4,1,1,3277534,"2023-11-28T00:00:00.000Z",26,FALSE,10,30,"F",26,26,"Sacramento Kings","Harrison Barnes",2,16,17,13,5,23.3
10,0,6,1,0,7,2,6,5,"37",2,3,9,8,1,1,3277534,"2023-11-28T00:00:00.000Z",26,FALSE,10,406,"F",26,26,"Sacramento Kings","Domantas Sabonis",1,17,27,19,18,35.6
0,0,0,1,0,4,2,2,1,"14",0,2,5,0,2,0,3277534,"2023-11-28T00:00:00.000Z",26,FALSE,10,17896030,"G",26,26,"Sacramento Kings","Chris Duarte",2,5,5,5,0,11
7,0,9,8,2,20,9,17,9,"40",1,4,29,10,2,2,3277534,"2023-11-28T00:00:00.000Z",26,FALSE,10,161,"G",26,26,"Sacramento Kings","De'Aaron Fox",2,39,46,36,17,55.5
0,0,2,1,0,1,0,0,0,"05",0,0,0,2,0,0,3277534,"2023-11-28T00:00:00.000Z",26,FALSE,10,17896044,"F",26,26,"Sacramento Kings","Kessler Edwards",0,2,2,0,2,2.4
0,0,0,2,1,2,1,0,0,"06",0,0,3,0,0,0,3277534,"2023-11-28T00:00:00.000Z",26,FALSE,10,38017714,"G",26,26,"Sacramento Kings","Keon Ellis",0,3,3,3,0,3
0,0,0,0,0,0,0,0,0,"00",0,0,0,0,0,0,3277534,"2023-11-28T00:00:00.000Z",26,FALSE,10,17895990,"G",26,26,"Sacramento Kings","Jordan Ford",0,0,0,0,0,0
0,0,0,0,0,0,0,0,0,"00",0,0,0,0,0,0,3277534,"2023-11-28T00:00:00.000Z",26,FALSE,10,56677845,"G",26,26,"Sacramento Kings","Colby Jones",0,0,0,0,0,0
0,1,3,4,1,6,2,9,6,"24",3,2,11,6,0,1,3277534,"2023-11-28T00:00:00.000Z",26,FALSE,10,290,"F",26,26,"Sacramento Kings","Trey Lyles",1,17,17,11,6,20.2
0,2,0,0,0,1,0,2,1,"05",1,1,1,1,0,1,3277534,"2023-11-28T00:00:00.000Z",26,FALSE,10,306,"C",26,26,"Sacramento Kings","JaVale McGee",2,2,2,1,1,7.2
0,0,0,2,0,4,1,2,2,"09",0,2,4,0,1,0,3277534,"2023-11-28T00:00:00.000Z",26,FALSE,10,17553994,"G",26,26,"Sacramento Kings","Davion Mitchell",1,4,4,4,0,7
2,1,2,7,3,15,8,2,2,"26",1,2,21,3,1,3,3277534,"2023-11-28T00:00:00.000Z",26,FALSE,10,324,"G",26,26,"Sacramento Kings","Malik Monk",2,24,26,23,5,30.6
0,0,0,0,0,0,0,0,0,"00",0,0,0,0,0,0,3277534,"2023-11-28T00:00:00.000Z",26,FALSE,10,56677862,"F",26,26,"Sacramento Kings","Jalen Slawson",0,0,0,0,0,0
0,2,3,6,2,9,3,0,0,"15",1,1,8,4,0,0,3277534,"2023-11-28T00:00:00.000Z",26,FALSE,10,4197162,"F",26,26,"Sacramento Kings","Aleksandar Vezenkov",2,12,12,8,4,18.8
0,0,0,0,0,0,0,0,0,"00",0,0,0,0,0,0,3277534,"2023-11-28T00:00:00.000Z",26,FALSE,10,273,"C",26,26,"Sacramento Kings","Alex Len",0,0,0,0,0,0
0,0,0,0,0,0,0,0,0,"00",0,0,0,0,0,0,3277534,"2023-11-28T00:00:00.000Z",26,FALSE,10,38017688,"F",26,26,"Sacramento Kings","Keegan Murray",0,0,0,0,0,0
3,0,8,5,2,18,11,6,5,"36",2,5,29,10,0,3,3277534,"2023-11-28T00:00:00.000Z",26,FALSE,10,475,"F-G",10,10,"Golden State Warriors","Andrew Wiggins",0,39,42,32,13,42.5
3,2,6,4,2,8,3,0,0,"33",0,4,8,6,0,4,3277534,"2023-11-28T00:00:00.000Z",26,FALSE,10,185,"F",10,10,"Golden State Warriors","Draymond Green",2,14,17,11,9,21.7
2,0,3,0,0,1,0,4,2,"29",1,4,2,4,1,0,3277534,"2023-11-28T00:00:00.000Z",26,FALSE,10,282,"F",10,10,"Golden State Warriors","Kevon Looney",1,6,8,4,6,12.8
2,2,9,9,3,14,6,6,5,"36",0,2,20,9,1,3,3277534,"2023-11-28T00:00:00.000Z",26,FALSE,10,443,"G",10,10,"Golden State Warriors","Klay Thompson",3,29,31,22,11,39.8
6,1,7,12,4,20,8,9,9,"37",3,5,29,10,0,5,3277534,"2023-11-28T00:00:00.000Z",26,FALSE,10,115,"G",10,10,"Golden State Warriors","Stephen Curry",1,39,45,35,16,48
0,0,0,0,0,0,0,0,0,"00",0,0,0,0,0,0,3277534,"2023-11-28T00:00:00.000Z",26,FALSE,10,56677799,"F",10,10,"Golden State Warriors","Trayce Jackson-Davis",0,0,0,0,0,0
3,0,4,0,0,2,1,2,2,"08",0,0,4,4,0,0,3277534,"2023-11-28T00:00:00.000Z",26,FALSE,10,251,"G",10,10,"Golden State Warriors","Cory Joseph",0,8,11,7,7,13.3
0,0,1,1,0,3,0,0,0,"10",0,3,0,1,0,2,3277534,"2023-11-28T00:00:00.000Z",26,FALSE,10,17553979,"F",10,10,"Golden State Warriors","Jonathan Kuminga",0,1,1,0,1,-0.8
2,0,0,3,3,4,4,0,0,"13",1,1,11,1,0,0,3277534,"2023-11-28T00:00:00.000Z",26,FALSE,10,17553992,"G",10,10,"Golden State Warriors","Moses Moody",0,12,14,13,3,15.2
0,0,0,2,1,2,1,0,0,"05",0,1,3,0,2,0,3277534,"2023-11-28T00:00:00.000Z",26,FALSE,10,367,"G",10,10,"Golden State Warriors","Chris Paul",2,3,3,3,0,9
1,1,4,1,0,4,3,1,1,"16",1,3,7,5,2,1,3277534,"2023-11-28T00:00:00.000Z",26,FALSE,10,2189,"",10,10,"Golden State Warriors","Gary Payton II",3,12,13,8,6,22.5
0,0,0,0,0,0,0,0,0,"00",0,0,0,0,0,0,3277534,"2023-11-28T00:00:00.000Z",26,FALSE,10,56677858,"G",10,10,"Golden State Warriors","Brandin Podziemski",0,0,0,0,0,0
0,0,0,0,0,0,0,0,0,"00",0,0,0,0,0,0,3277534,"2023-11-28T00:00:00.000Z",26,FALSE,10,57875092,"F",10,10,"Golden State Warriors","Gui Santos",0,0,0,0,0,0
3,0,1,4,2,7,3,2,2,"17",1,3,10,2,0,0,3277534,"2023-11-28T00:00:00.000Z",26,FALSE,10,407,"F",10,10,"Golden State Warriors","Dario Saric",0,12,15,13,5,16.9
0,0,0,0,0,0,0,0,0,"00",0,0,0,0,0,0,3277534,"2023-11-28T00:00:00.000Z",26,FALSE,10,17896070,"F",10,10,"Golden State Warriors","Usman Garuba",0,0,0,0,0,0
0,0,0,0,0,0,0,0,0,"00",0,0,0,0,0,0,3277534,"2023-11-28T00:00:00.000Z",26,FALSE,10,45658838,"G",10,10,"Golden State Warriors","Lester Quinones",0,0,0,0,0,0
0,0,0,0,0,0,0,0,0,"00",0,0,0,0,0,0,3277534,"2023-11-28T00:00:00.000Z",26,FALSE,10,398,"G",10,10,"Golden State Warriors","Jerome Robinson",0,0,0,0,0,0
4,0,2,5,3,7,4,0,0,"27",1,2,11,3,2,0,1037855,"2023-11-29T00:00:00.000Z",8,FALSE,11,215,"F-G",8,8,"Denver Nuggets","Justin Holiday",2,14,18,15,7,26.6
5,0,8,12,7,17,11,3,1,"34",2,2,30,10,1,0,1037855,"2023-11-29T00:00:00.000Z",8,FALSE,11,375,"F",8,8,"Denver Nuggets","Michael Porter Jr.",1,40,45,35,15,52.5
15,0,4,2,1,19,12,8,7,"33",6,2,32,10,1,0,1037855,"2023-11-29T00:00:00.000Z",8,FALSE,11,246,"C",8,8,"Denver Nuggets","Nikola Jokic",1,42,57,47,25,69.5
2,0,1,3,2,6,4,0,0,"32",0,0,10,1,0,0,1037855,"2023-11-29T00:00:00.000Z",8,FALSE,11,81,"G",8,8,"Denver Nuggets","Kentavious Caldwell-Pope",0,11,13,12,3,14.2
6,0,6,8,3,14,4,5,5,"22",0,2,16,6,0,0,1037855,"2023-11-29T00:00:00.000Z",8,FALSE,11,335,"G",8,8,"Denver Nuggets","Jamal Murray",0,22,28,22,12,32.2
1,0,2,2,1,7,4,2,2,"19",1,2,11,3,0,2,1037855,"2023-11-29T00:00:00.000Z",8,FALSE,11,38017709,"G",8,8,"Denver Nuggets","Christian Braun",0,14,15,12,4,14.1
0,0,0,1,0,1,0,0,0,"03",0,0,0,0,0,1,1037855,"2023-11-29T00:00:00.000Z",8,FALSE,11,38017727,"G",8,8,"Denver Nuggets","Collin Gillespie",0,0,0,0,0,-1
2,1,2,7,2,14,6,0,0,"24",0,3,14,2,0,0,1037855,"2023-11-29T00:00:00.000Z",8,FALSE,11,236,"G",8,8,"Denver Nuggets","Reggie Jackson",1,16,18,16,4,22.4
0,0,0,0,0,1,1,2,0,"06",1,0,2,1,0,0,1037855,"2023-11-29T00:00:00.000Z",8,FALSE,11,250,"C",8,8,"Denver Nuggets","DeAndre Jordan",0,3,3,2,1,3.2
1,0,1,0,0,0,0,2,1,"03",0,1,1,1,0,0,1037855,"2023-11-29T00:00:00.000Z",8,FALSE,11,17896007,"G",8,8,"Denver Nuggets","Braxton Key",0,2,3,2,2,3.7
0,1,1,0,0,4,2,4,3,"18",2,2,7,3,0,0,1037855,"2023-11-29T00:00:00.000Z",8,FALSE,11,3547268,"F-C",8,8,"Denver Nuggets","Zeke Nnaji",1,10,10,7,3,13.6
0,0,0,1,0,1,0,0,0,"03",0,0,0,0,0,0,1037855,"2023-11-29T00:00:00.000Z",8,FALSE,11,56677582,"G",8,8,"Denver Nuggets","Jalen Pickett",0,0,0,0,0,0
1,0,1,2,0,4,0,0,0,"13",0,1,0,1,0,0,1037855,"2023-11-29T00:00:00.000Z",8,FALSE,11,56677776,"G",8,8,"Denver Nuggets","Julian Strawther",0,1,2,1,2,2.7
0,0,0,0,0,0,0,0,0,"03",0,1,0,0,0,0,1037855,"2023-11-29T00:00:00.000Z",8,FALSE,11,56677871,"F",8,8,"Denver Nuggets","Hunter Tyson",0,0,0,0,0,0
0,0,0,0,0,0,0,0,0,"00",0,0,0,0,0,0,1037855,"2023-11-29T00:00:00.000Z",8,FALSE,11,38017721,"G",8,8,"Denver Nuggets","Peyton Watson",0,0,0,0,0,0
9,1,6,8,5,12,8,6,5,"34",0,0,26,6,0,2,1037855,"2023-11-29T00:00:00.000Z",8,FALSE,11,17895966,"G",11,11,"Houston Rockets","Jalen Green",1,32,41,35,15,47.7
5,0,3,5,0,10,4,1,1,"35",0,2,9,3,0,0,1037855,"2023-11-29T00:00:00.000Z",8,FALSE,11,213,"G",11,11,"Houston Rockets","Aaron Holiday",0,12,17,14,8,20.1
0,0,0,2,2,2,2,0,0,"12",1,3,6,1,0,0,1037855,"2023-11-29T00:00:00.000Z",8,FALSE,11,75,"G-F",11,11,"Houston Rockets","Reggie Bullock",0,7,7,6,1,7.2
0,2,0,1,0,5,2,0,0,"17",2,0,4,2,0,0,1037855,"2023-11-29T00:00:00.000Z",8,FALSE,11,38017695,"F",11,11,"Houston Rockets","Tari Eason",2,6,6,4,2,12.4
2,1,2,3,2,6,4,3,2,"22",0,1,12,2,1,0,1037855,"2023-11-29T00:00:00.000Z",8,FALSE,11,188,"F",11,11,"Houston Rockets","Jeff Green",2,14,16,14,4,23.4
0,0,0,1,1,1,1,0,0,"05",1,0,3,1,0,0,1037855,"2023-11-29T00:00:00.000Z",8,FALSE,11,3547281,"G-F",11,11,"Houston Rockets","Nate Hinton",0,4,4,3,1,4.2
0,0,1,1,0,4,2,2,2,"14",0,2,6,1,1,1,1037855,"2023-11-29T00:00:00.000Z",8,FALSE,11,19465326,"C",11,11,"Houston Rockets","Jock Landale",1,7,7,6,1,9.2
0,0,0,0,0,0,0,0,0,"00",0,0,0,0,0,0,1037855,"2023-11-29T00:00:00.000Z",8,FALSE,11,296,"C",11,11,"Houston Rockets","Boban Marjanovic",0,0,0,0,0,0
2,0,2,1,0,1,0,0,0,"06",0,0,0,2,0,0,1037855,"2023-11-29T00:00:00.000Z",8,FALSE,11,56677809,"F",11,11,"Houston Rockets","Jermaine Samuels Jr.",0,2,4,2,4,5.4
0,0,2,2,1,4,3,2,1,"06",0,1,8,2,0,0,1037855,"2023-11-29T00:00:00.000Z",8,FALSE,11,56677831,"F",11,11,"Houston Rockets","Cam Whitmore",0,10,10,8,2,10.4
1,0,0,0,0,2,1,0,0,"06",0,1,2,0,0,0,1037855,"2023-11-29T00:00:00.000Z",8,FALSE,11,47738533,"G",11,11,"Houston Rockets","Jeenathan Williams",0,2,3,3,1,3.5
0,0,0,0,0,0,0,0,0,"00",0,0,0,0,0,0,1037855,"2023-11-29T00:00:00.000Z",8,FALSE,11,357,"G",11,11,"Houston Rockets","Victor Oladipo",0,0,0,0,0,0
0,0,0,0,0,0,0,0,0,"00",0,0,0,0,0,0,1037855,"2023-11-29T00:00:00.000Z",8,FALSE,11,3547301,"F",11,11,"Houston Rockets","Jae'Sean Tate",0,0,0,0,0,0
0,0,0,0,0,0,0,0,0,"00",0,0,0,0,0,0,1037855,"2023-11-29T00:00:00.000Z",8,FALSE,11,56677825,"G-F",11,11,"Houston Rockets","Amen Thompson",0,0,0,0,0,0
0,0,0,0,0,0,0,0,0,"00",0,0,0,0,0,0,1037855,"2023-11-29T00:00:00.000Z",8,FALSE,11,666489,"F",8,8,"Denver Nuggets","Vlatko Cancar",0,0,0,0,0,0
0,0,0,0,0,0,0,0,0,"00",0,0,0,0,0,0,1037855,"2023-11-29T00:00:00.000Z",8,FALSE,11,177,"F",8,8,"Denver Nuggets","Aaron Gordon",0,0,0,0,0,0
0,0,0,0,0,0,0,0,0,"00",0,0,0,0,0,0,1037855,"2023-11-29T00:00:00.000Z",8,FALSE,11,17896103,"F-C",8,8,"Denver Nuggets","Jay Huff",0,0,0,0,0,0
2,0,0,4,1,7,4,3,2,"23",1,4,11,1,0,4,1037855,"2023-11-29T00:00:00.000Z",8,FALSE,11,66,"G-F",11,11,"Houston Rockets","Dillon Brooks",0,12,14,13,3,11.2
2,1,6,7,2,14,6,2,1,"32",1,3,15,7,0,0,1037855,"2023-11-29T00:00:00.000Z",8,FALSE,11,38017684,"F",11,11,"Houston Rockets","Jabari Smith Jr.",1,22,24,17,9,29.4
4,0,5,6,2,18,10,0,0,"28",2,3,22,7,1,1,1037855,"2023-11-29T00:00:00.000Z",8,FALSE,11,17896062,"F-C",11,11,"Houston Rockets","Alperen Sengun",1,29,33,26,11,38.4
0,0,0,0,0,0,0,0,0,"00",0,0,0,0,0,0,1037855,"2023-11-29T00:00:00.000Z",8,FALSE,11,458,"G",11,11,"Houston Rockets","Fred VanVleet",0,0,0,0,0,0
5,0,4,5,1,7,3,0,0,"26",1,3,7,5,0,2,1037856,"2023-11-29T00:00:00.000Z",26,FALSE,13,221,"G",26,26,"Sacramento Kings","Kevin Huerter",0,12,17,12,10,18.5
4,0,4,3,1,7,3,2,2,"34",1,3,9,5,1,0,1037856,"2023-11-29T00:00:00.000Z",26,FALSE,13,30,"F",26,26,"Sacramento Kings","Harrison Barnes",1,14,18,13,9,24
3,0,4,3,2,12,3,4,3,"31",1,3,11,5,0,1,1037856,"2023-11-29T00:00:00.000Z",26,FALSE,13,406,"F",26,26,"Sacramento Kings","Domantas Sabonis",0,16,19,14,8,20.5
0,0,2,2,0,6,3,1,1,"13",1,2,7,3,0,0,1037856,"2023-11-29T00:00:00.000Z",26,FALSE,13,17896030,"G",26,26,"Sacramento Kings","Chris Duarte",0,10,10,7,3,10.6
3,1,4,8,3,23,14,10,9,"38",1,3,40,5,0,4,1037856,"2023-11-29T00:00:00.000Z",26,FALSE,13,161,"G",26,26,"Sacramento Kings","De'Aaron Fox",1,45,48,43,8,49.5
0,0,0,1,0,1,0,0,0,"07",1,0,0,1,0,0,1037856,"2023-11-29T00:00:00.000Z",26,FALSE,13,17896044,"F",26,26,"Sacramento Kings","Kessler Edwards",0,1,1,0,1,1.2
0,0,0,0,0,0,0,0,0,"00",0,0,0,0,0,0,1037856,"2023-11-29T00:00:00.000Z",26,FALSE,13,38017714,"G",26,26,"Sacramento Kings","Keon Ellis",0,0,0,0,0,0
0,0,1,0,0,0,0,0,0,"01",0,0,0,1,0,0,1037856,"2023-11-29T00:00:00.000Z",26,FALSE,13,17895990,"G",26,26,"Sacramento Kings","Jordan Ford",0,1,1,0,1,1.2
0,0,0,1,0,2,1,0,0,"01",1,0,2,1,0,1,1037856,"2023-11-29T00:00:00.000Z",26,FALSE,13,56677845,"G",26,26,"Sacramento Kings","Colby Jones",0,3,3,2,1,2.2
2,0,3,3,0,5,1,2,0,"18",2,2,2,5,0,2,1037856,"2023-11-29T00:00:00.000Z",26,FALSE,13,290,"F",26,26,"Sacramento Kings","Trey Lyles",0,7,9,4,7,9
0,0,2,0,0,1,1,0,0,"05",3,1,2,5,0,1,1037856,"2023-11-29T00:00:00.000Z",26,FALSE,13,306,"C",26,26,"Sacramento Kings","JaVale McGee",0,7,7,2,5,7
3,0,2,5,1,7,3,2,2,"13",0,0,9,2,0,1,1037856,"2023-11-29T00:00:00.000Z",26,FALSE,13,17553994,"G",26,26,"Sacramento Kings","Davion Mitchell",0,11,14,12,5,14.9
2,0,4,5,2,8,3,7,7,"28",0,1,15,4,0,2,1037856,"2023-11-29T00:00:00.000Z",26,FALSE,13,324,"G",26,26,"Sacramento Kings","Malik Monk",0,19,21,17,6,20.8
0,1,0,0,0,0,0,0,0,"01",0,0,0,0,0,0,1037856,"2023-11-29T00:00:00.000Z",26,FALSE,13,56677862,"F",26,26,"Sacramento Kings","Jalen Slawson",1,0,0,0,0,3
0,0,4,5,3,7,5,0,0,"24",1,2,13,5,0,0,1037856,"2023-11-29T00:00:00.000Z",26,FALSE,13,4197162,"F",26,26,"Sacramento Kings","Aleksandar Vezenkov",0,18,18,13,5,19
0,0,0,0,0,0,0,0,0,"00",0,0,0,0,0,0,1037856,"2023-11-29T00:00:00.000Z",26,FALSE,13,273,"C",26,26,"Sacramento Kings","Alex Len",0,0,0,0,0,0
0,0,0,0,0,0,0,0,0,"00",0,0,0,0,0,0,1037856,"2023-11-29T00:00:00.000Z",26,FALSE,13,38017688,"F",26,26,"Sacramento Kings","Keegan Murray",0,0,0,0,0,0
7,0,3,9,4,18,7,2,1,"40",0,1,19,3,0,1,1037856,"2023-11-29T00:00:00.000Z",26,FALSE,13,172,"F",13,13,"LA Clippers","Paul George",0,22,29,26,10,32.1
3,2,9,3,2,18,14,6,4,"37",0,2,34,9,1,0,1037856,"2023-11-29T00:00:00.000Z",26,FALSE,13,274,"F",13,13,"LA Clippers","Kawhi Leonard",3,43,46,37,12,58.3
3,3,5,0,0,12,7,0,0,"31",3,1,14,8,0,0,1037856,"2023-11-29T00:00:00.000Z",26,FALSE,13,493,"C",13,13,"LA Clippers","Ivica Zubac",3,22,25,17,11,37.1
1,0,3,3,1,12,8,1,1,"31",0,1,18,3,0,0,1037856,"2023-11-29T00:00:00.000Z",26,FALSE,13,666743,"G",13,13,"LA Clippers","Terance Mann",0,21,22,19,4,23.1
6,0,2,8,5,14,8,5,5,"39",1,4,26,3,5,2,1037856,"2023-11-29T00:00:00.000Z",26,FALSE,13,192,"G",13,13,"LA Clippers","James Harden",5,29,35,32,9,51.6
0,0,2,2,1,2,1,0,0,"11",0,3,3,2,0,0,1037856,"2023-11-29T00:00:00.000Z",26,FALSE,13,56677849,"F",13,13,"LA Clippers","Kobe Brown",0,5,5,3,2,5.4
0,0,0,0,0,0,0,0,0,"01",0,0,0,0,0,0,1037856,"2023-11-29T00:00:00.000Z",26,FALSE,13,666511,"G",13,13,"LA Clippers","Amir Coffey",0,0,0,0,0,0
0,0,0,0,0,0,0,0,0,"01",0,0,0,0,1,0,1037856,"2023-11-29T00:00:00.000Z",26,FALSE,13,17896031,"G",13,13,"LA Clippers","Nah'Shon Hyland",1,0,0,0,0,3
0,0,1,2,1,6,1,0,0,"13",0,1,3,1,0,0,1037856,"2023-11-29T00:00:00.000Z",26,FALSE,13,380,"F-G",13,13,"LA Clippers","Norman Powell",0,4,4,3,1,4.2
0,0,0,0,0,5,2,2,1,"17",3,5,5,3,0,0,1037856,"2023-11-29T00:00:00.000Z",26,FALSE,13,439,"F",13,13,"LA Clippers","Daniel Theis",0,8,8,5,3,8.6
0,0,0,0,0,0,0,0,0,"00",0,0,0,0,0,0,1037856,"2023-11-29T00:00:00.000Z",26,FALSE,13,450,"F",13,13,"LA Clippers","PJ Tucker",0,0,0,0,0,0
8,0,4,1,0,6,2,6,5,"19",1,2,9,5,1,1,1037856,"2023-11-29T00:00:00.000Z",26,FALSE,13,472,"G",13,13,"LA Clippers","Russell Westbrook",1,14,22,17,13,29
0,0,0,0,0,0,0,0,0,"00",0,0,0,0,0,0,1037856,"2023-11-29T00:00:00.000Z",26,FALSE,13,17896022,"G",13,13,"LA Clippers","Brandon Boston Jr.",0,0,0,0,0,0
0,0,0,0,0,0,0,0,0,"00",0,0,0,0,0,0,1037856,"2023-11-29T00:00:00.000Z",26,FALSE,13,38017725,"F",13,13,"LA Clippers","Moussa Diabate",0,0,0,0,0,0
0,0,0,0,0,0,0,0,0,"00",0,0,0,0,0,0,1037856,"2023-11-29T00:00:00.000Z",26,FALSE,13,56677856,"G",13,13,"LA Clippers","Jordan Miller",0,0,0,0,0,0
0,0,0,0,0,0,0,0,0,"00",0,0,0,0,0,0,1037856,"2023-11-29T00:00:00.000Z",26,FALSE,13,24417679,"G",13,13,"LA Clippers","Xavier Moon",0,0,0,0,0,0
0,0,0,0,0,0,0,0,0,"00",0,0,0,0,0,0,1037856,"2023-11-29T00:00:00.000Z",26,FALSE,13,371,"F-C",13,13,"LA Clippers","Mason Plumlee",0,0,0,0,0,0
0,0,0,0,0,0,0,0,0,"00",0,0,0,0,0,0,1037856,"2023-11-29T00:00:00.000Z",26,FALSE,13,17896051,"G",13,13,"LA Clippers","Joshua Primo",0,0,0,0,0,0
6,1,4,4,2,7,4,5,5,"35",0,1,15,4,1,1,1037854,"2023-11-29T00:00:00.000Z",19,FALSE,23,227,"F",19,19,"New Orleans Pelicans","Brandon Ingram",2,19,25,21,10,33.8
6,0,7,0,0,11,11,12,11,"33",1,1,33,8,3,2,1037854,"2023-11-29T00:00:00.000Z",19,FALSE,23,666969,"F",19,19,"New Orleans Pelicans","Zion Williamson",3,41,47,39,14,58.6
3,0,3,1,0,9,8,3,3,"32",3,5,19,6,0,2,1037854,"2023-11-29T00:00:00.000Z",19,FALSE,23,455,"C",19,19,"New Orleans Pelicans","Jonas Valanciunas",0,25,28,22,9,28.7
6,0,2,3,0,8,3,1,1,"33",1,2,7,3,0,5,1037854,"2023-11-29T00:00:00.000Z",19,FALSE,23,17896024,"F",19,19,"New Orleans Pelicans","Herbert Jones",0,10,16,13,9,14.6
5,1,2,8,3,16,7,3,3,"28",1,3,20,3,2,2,1037854,"2023-11-29T00:00:00.000Z",19,FALSE,23,303,"G",19,19,"New Orleans Pelicans","CJ McCollum",3,23,28,25,8,38.1
1,0,0,2,1,5,2,0,0,"09",2,1,5,2,1,2,1037854,"2023-11-29T00:00:00.000Z",19,FALSE,23,17896097,"G",19,19,"New Orleans Pelicans","Jose Alvarado",1,7,8,6,3,9.9
1,1,4,1,0,5,2,0,0,"14",2,2,4,6,2,1,1037854,"2023-11-29T00:00:00.000Z",19,FALSE,23,38017677,"G",19,19,"New Orleans Pelicans","Dyson Daniels",3,10,11,5,7,20.7
2,0,3,8,3,10,4,6,5,"24",2,2,16,5,0,2,1037854,"2023-11-29T00:00:00.000Z",19,FALSE,23,56677837,"G",19,19,"New Orleans Pelicans","Jordan Hawkins",0,21,23,18,7,23
0,0,0,0,0,0,0,0,0,"00",0,0,0,0,0,0,1037854,"2023-11-29T00:00:00.000Z",19,FALSE,23,3547260,"G",19,19,"New Orleans Pelicans","Kira Lewis Jr.",0,0,0,0,0,0
3,1,1,3,1,4,1,2,1,"19",2,1,4,3,1,1,1037854,"2023-11-29T00:00:00.000Z",19,FALSE,23,3547293,"F",19,19,"New Orleans Pelicans","Naji Marshall",2,7,10,7,6,17.1
0,0,0,0,0,0,0,0,0,"00",0,0,0,0,0,0,1037854,"2023-11-29T00:00:00.000Z",19,FALSE,23,17896021,"F",19,19,"New Orleans Pelicans","Jeremiah Robinson-Earl",0,0,0,0,0,0
0,0,1,0,0,3,0,2,1,"13",0,4,1,1,1,2,1037854,"2023-11-29T00:00:00.000Z",19,FALSE,23,491,"C",19,19,"New Orleans Pelicans","Cody Zeller",1,2,2,1,1,3.2
0,0,0,0,0,0,0,0,0,"00",0,0,0,0,0,0,1037854,"2023-11-29T00:00:00.000Z",19,FALSE,23,38017663,"F",19,19,"New Orleans Pelicans","E.J. Liddell",0,0,0,0,0,0
0,0,0,0,0,0,0,0,0,"00",0,0,0,0,0,0,1037854,"2023-11-29T00:00:00.000Z",19,FALSE,23,18677986,"F",19,19,"New Orleans Pelicans","Trey Murphy III",0,0,0,0,0,0
0,0,0,0,0,0,0,0,0,"00",0,0,0,0,0,0,1037854,"2023-11-29T00:00:00.000Z",19,FALSE,23,340,"F",19,19,"New Orleans Pelicans","Larry Nance Jr.",0,0,0,0,0,0
0,0,0,0,0,0,0,0,0,"00",0,0,0,0,0,0,1037854,"2023-11-29T00:00:00.000Z",19,FALSE,23,17896017,"F",19,19,"New Orleans Pelicans","Matt Ryan",0,0,0,0,0,0
0,0,0,0,0,0,0,0,0,"00",0,0,0,0,0,0,1037854,"2023-11-29T00:00:00.000Z",19,FALSE,23,38017726,"G",19,19,"New Orleans Pelicans","Dereon Seabron",0,0,0,0,0,0
0,0,1,1,1,1,1,0,0,"14",0,1,3,1,0,1,1037854,"2023-11-29T00:00:00.000Z",19,FALSE,23,33,"F-G",23,23,"Philadelphia 76ers","Nicolas Batum",0,4,4,3,1,3.2
2,0,4,2,0,10,5,2,2,"29",0,2,12,4,0,5,1037854,"2023-11-29T00:00:00.000Z",19,FALSE,23,200,"F",23,23,"Philadelphia 76ers","Tobias Harris",0,16,18,14,6,14.8
2,1,2,3,1,7,3,0,0,"17",1,4,7,3,1,1,1037854,"2023-11-29T00:00:00.000Z",19,FALSE,23,328,"F",23,23,"Philadelphia 76ers","Marcus Morris",2,10,12,9,5,18.6
0,0,0,0,0,0,0,0,0,"00",0,0,0,0,0,0,1037854,"2023-11-29T00:00:00.000Z",19,FALSE,23,145,"F-C",23,23,"Philadelphia 76ers","Joel Embiid",0,0,0,0,0,0
0,0,0,0,0,0,0,0,0,"02",0,0,0,0,0,0,1037854,"2023-11-29T00:00:00.000Z",19,FALSE,23,260,"G-F",23,23,"Philadelphia 76ers","Furkan Korkmaz",0,0,0,0,0,0
2,0,2,1,0,4,2,0,0,"17",0,4,4,2,0,2,1037854,"2023-11-29T00:00:00.000Z",19,FALSE,23,3547294,"F",23,23,"Philadelphia 76ers","Kenyon Martin Jr.",0,6,8,6,4,7.4
5,0,2,1,0,4,3,3,3,"27",2,4,9,4,1,3,1037854,"2023-11-29T00:00:00.000Z",19,FALSE,23,3547270,"F",23,23,"Philadelphia 76ers","Paul Reed",1,13,18,14,9,21.3
0,0,0,0,0,0,0,0,0,"00",0,0,0,0,0,0,1037854,"2023-11-29T00:00:00.000Z",19,FALSE,23,56913527,"G",23,23,"Philadelphia 76ers","Ricky Council IV",0,0,0,0,0,0
0,0,0,0,0,0,0,0,0,"00",0,0,0,0,0,0,1037854,"2023-11-29T00:00:00.000Z",19,FALSE,23,2175,"",23,23,"Philadelphia 76ers","Danuel House Jr.",0,0,0,0,0,0
0,0,0,0,0,0,0,0,0,"00",0,0,0,0,0,0,1037854,"2023-11-29T00:00:00.000Z",19,FALSE,23,360,"F",23,23,"Philadelphia 76ers","Kelly Oubre Jr.",0,0,0,0,0,0
0,0,0,0,0,0,0,0,0,"00",0,0,0,0,0,0,1037854,"2023-11-29T00:00:00.000Z",19,FALSE,23,17554001,"G",23,23,"Philadelphia 76ers","Javonte Smart",0,0,0,0,0,0
0,0,0,0,0,0,0,0,0,"00",0,0,0,0,0,0,1037854,"2023-11-29T00:00:00.000Z",19,FALSE,23,56677788,"G",23,23,"Philadelphia 76ers","Terquavion Smith",0,0,0,0,0,0
0,0,0,0,0,0,0,0,0,"00",0,0,0,0,0,0,1037854,"2023-11-29T00:00:00.000Z",19,FALSE,23,17896025,"G",23,23,"Philadelphia 76ers","Jaden Springer",0,0,0,0,0,0
3,0,1,10,3,25,13,4,4,"38",0,2,33,1,1,4,1037854,"2023-11-29T00:00:00.000Z",19,FALSE,23,3547254,"G",23,23,"Philadelphia 76ers","Tyrese Maxey",1,34,37,36,4,37.7
0,3,1,1,0,7,3,1,0,"14",3,3,6,4,0,1,1037854,"2023-11-29T00:00:00.000Z",19,FALSE,23,28,"C",23,23,"Philadelphia 76ers","Mo Bamba",3,10,10,6,4,18.8
7,0,1,1,1,4,3,4,4,"22",0,1,11,1,1,0,1037854,"2023-11-29T00:00:00.000Z",19,FALSE,23,45,"G",23,23,"Philadelphia 76ers","Patrick Beverley",1,12,19,18,8,25.7
1,1,5,4,4,5,4,0,0,"30",2,3,12,7,0,0,1037854,"2023-11-29T00:00:00.000Z",19,FALSE,23,108,"F",23,23,"Philadelphia 76ers","Robert Covington",1,19,20,13,8,24.9
6,1,3,10,4,14,5,4,3,"30",0,2,17,3,4,4,1037854,"2023-11-29T00:00:00.000Z",19,FALSE,23,313,"G",23,23,"Philadelphia 76ers","De'Anthony Melton",5,20,26,23,9,40.6
1,0,5,9,5,11,7,0,0,"25",1,2,19,6,0,0,1037853,"2023-11-29T00:00:00.000Z",15,FALSE,29,38017729,"F",15,15,"Memphis Grizzlies","David Roddy",0,25,26,20,7,27.7
1,6,3,3,0,19,8,4,4,"35",3,2,20,6,1,1,1037853,"2023-11-29T00:00:00.000Z",15,FALSE,29,231,"F-C",15,15,"Memphis Grizzlies","Jaren Jackson Jr.",7,26,27,21,7,48.7
2,3,6,0,0,3,3,0,0,"30",0,3,6,6,1,5,1037853,"2023-11-29T00:00:00.000Z",15,FALSE,29,48,"C",15,15,"Memphis Grizzlies","Bismack Biyombo",4,12,14,8,8,23.2
9,0,6,11,3,17,7,0,0,"36",1,2,17,7,3,3,1037853,"2023-11-29T00:00:00.000Z",15,FALSE,29,3547287,"G",15,15,"Memphis Grizzlies","Desmond Bane",3,24,33,26,16,44.9
9,0,4,3,0,11,7,0,0,"27",0,2,14,4,0,1,1037853,"2023-11-29T00:00:00.000Z",15,FALSE,29,401,"G",15,15,"Memphis Grizzlies","Derrick Rose",0,18,27,23,13,31.3
1,1,2,4,1,9,4,4,2,"25",2,1,11,4,1,1,1037853,"2023-11-29T00:00:00.000Z",15,FALSE,29,17896067,"F",15,15,"Memphis Grizzlies","Santi Aldama",2,15,16,12,5,22.3
0,0,0,0,0,0,0,0,0,"00",0,0,0,0,0,0,1037853,"2023-11-29T00:00:00.000Z",15,FALSE,29,48248287,"G",15,15,"Memphis Grizzlies","Jacob Gilyard",0,0,0,0,0,0
0,0,0,0,0,0,0,0,0,"00",0,0,0,0,0,0,1037853,"2023-11-29T00:00:00.000Z",15,FALSE,29,199,"G",15,15,"Memphis Grizzlies","Shaquille Harrison",0,0,0,0,0,0
0,0,0,0,0,0,0,0,0,"00",0,0,0,0,0,0,1037853,"2023-11-29T00:00:00.000Z",15,FALSE,29,666703,"G-F",15,15,"Memphis Grizzlies","John Konchar",0,0,0,0,0,0
0,0,0,0,0,0,0,0,0,"00",0,0,0,0,0,0,1037853,"2023-11-29T00:00:00.000Z",15,FALSE,29,38017732,"F",15,15,"Memphis Grizzlies","Kenneth Lofton Jr.",0,0,0,0,0,0
1,0,1,3,0,6,0,0,0,"18",1,0,0,2,0,0,1037853,"2023-11-29T00:00:00.000Z",15,FALSE,29,666809,"G",15,15,"Memphis Grizzlies","Jaylen Nowell",0,2,3,1,3,3.9
2,0,6,3,1,3,1,0,0,"19",2,3,3,8,1,2,1037853,"2023-11-29T00:00:00.000Z",15,FALSE,29,38017731,"G",15,15,"Memphis Grizzlies","Vince Williams Jr.",1,11,13,5,10,16.6
0,0,6,3,3,8,6,0,0,"25",2,0,15,8,2,2,1037853,"2023-11-29T00:00:00.000Z",15,FALSE,29,17896027,"G-F",15,15,"Memphis Grizzlies","Ziaire Williams",2,23,23,15,8,28.6
0,0,0,0,0,0,0,0,0,"00",0,0,0,0,0,0,1037853,"2023-11-29T00:00:00.000Z",15,FALSE,29,3,"C",15,15,"Memphis Grizzlies","Steven Adams",0,0,0,0,0,0
0,0,0,0,0,0,0,0,0,"00",0,0,0,0,0,0,1037853,"2023-11-29T00:00:00.000Z",15,FALSE,29,666505,"F",15,15,"Memphis Grizzlies","Brandon Clarke",0,0,0,0,0,0
0,0,0,0,0,0,0,0,0,"00",0,0,0,0,0,0,1037853,"2023-11-29T00:00:00.000Z",15,FALSE,29,56677830,"F",15,15,"Memphis Grizzlies","GG Jackson",0,0,0,0,0,0
0,0,0,0,0,0,0,0,0,"00",0,0,0,0,0,0,1037853,"2023-11-29T00:00:00.000Z",15,FALSE,29,254,"G",15,15,"Memphis Grizzlies","Luke Kennard",0,0,0,0,0,0
0,0,0,0,0,0,0,0,0,"00",0,0,0,0,0,0,1037853,"2023-11-29T00:00:00.000Z",15,FALSE,29,38017728,"F",15,15,"Memphis Grizzlies","Jake LaRavia",0,0,0,0,0,0
0,0,0,0,0,0,0,0,0,"00",0,0,0,0,0,0,1037853,"2023-11-29T00:00:00.000Z",15,FALSE,29,666786,"G",15,15,"Memphis Grizzlies","Ja Morant",0,0,0,0,0,0
3,0,2,4,1,5,2,0,0,"21",1,1,5,3,0,1,1037853,"2023-11-29T00:00:00.000Z",15,FALSE,29,38017620,"G",29,29,"Utah Jazz","Ochai Agbaji",0,8,11,8,6,12.1
3,1,3,5,1,12,2,0,0,"24",1,2,5,4,1,2,1037853,"2023-11-29T00:00:00.000Z",15,FALSE,29,666650,"G",29,29,"Utah Jazz","Talen Horton-Tucker",2,9,12,8,7,18.3
2,0,2,1,1,2,2,0,0,"18",0,3,5,2,2,1,1037853,"2023-11-29T00:00:00.000Z",15,FALSE,29,358,"F",29,29,"Utah Jazz","Kelly Olynyk",2,7,9,7,4,15.4
0,0,0,0,0,0,0,0,0,"00",0,0,0,0,0,0,1037853,"2023-11-29T00:00:00.000Z",15,FALSE,29,19465584,"F",29,29,"Utah Jazz","Micah Potter",0,0,0,0,0,0
0,1,1,1,1,2,2,0,0,"06",1,0,5,2,0,1,1037853,"2023-11-29T00:00:00.000Z",15,FALSE,29,666881,"F",29,29,"Utah Jazz","Luka Samanic",1,7,7,5,2,9.4
3,0,1,4,1,10,3,3,2,"22",1,3,9,2,1,2,1037853,"2023-11-29T00:00:00.000Z",15,FALSE,29,413,"G",29,29,"Utah Jazz","Collin Sexton",1,11,14,12,5,16.9
0,0,0,0,0,0,0,0,0,"00",0,0,0,0,0,0,1037853,"2023-11-29T00:00:00.000Z",15,FALSE,29,17896023,"G",29,29,"Utah Jazz","Josh Christopher",0,0,0,0,0,0
0,0,0,0,0,0,0,0,0,"00",0,0,0,0,0,0,1037853,"2023-11-29T00:00:00.000Z",15,FALSE,29,139,"G",29,29,"Utah Jazz","Kris Dunn",0,0,0,0,0,0
0,0,0,0,0,0,0,0,0,"00",0,0,0,0,0,0,1037853,"2023-11-29T00:00:00.000Z",15,FALSE,29,56677824,"F",29,29,"Utah Jazz","Taylor Hendricks",0,0,0,0,0,0
0,0,0,0,0,0,0,0,0,"00",0,0,0,0,0,0,1037853,"2023-11-29T00:00:00.000Z",15,FALSE,29,38017630,"G",29,29,"Utah Jazz","Johnny Juzang",0,0,0,0,0,0
0,0,0,0,0,0,0,0,0,"00",0,0,0,0,0,0,1037853,"2023-11-29T00:00:00.000Z",15,FALSE,29,297,"F",29,29,"Utah Jazz","Lauri Markkanen",0,0,0,0,0,0
0,0,0,0,0,0,0,0,0,"00",0,0,0,0,0,0,1037853,"2023-11-29T00:00:00.000Z",15,FALSE,29,420,"G",15,15,"Memphis Grizzlies","Marcus Smart",0,0,0,0,0,0
0,0,0,0,0,0,0,0,0,"00",0,0,0,0,0,0,1037853,"2023-11-29T00:00:00.000Z",15,FALSE,29,3547285,"F",15,15,"Memphis Grizzlies","Xavier Tillman",0,0,0,0,0,0
4,0,4,8,4,13,4,0,0,"26",0,1,12,4,1,0,1037853,"2023-11-29T00:00:00.000Z",15,FALSE,29,38017739,"F",29,29,"Utah Jazz","Simone Fontecchio",1,16,20,16,8,25.8
1,0,3,5,3,14,7,2,0,"29",1,2,17,4,1,1,1037853,"2023-11-29T00:00:00.000Z",15,FALSE,29,101,"F-C",29,29,"Utah Jazz","John Collins",1,21,22,18,5,25.3
1,0,2,0,0,5,2,0,0,"15",2,2,4,4,1,2,1037853,"2023-11-29T00:00:00.000Z",15,FALSE,29,11891374,"C",29,29,"Utah Jazz","Omer Yurtseven",1,8,9,5,5,11.3
2,0,2,4,2,6,2,2,2,"24",1,0,8,3,0,2,1037853,"2023-11-29T00:00:00.000Z",15,FALSE,29,56677834,"G",29,29,"Utah Jazz","Keyonte George",0,11,13,10,5,12.6
5,0,2,5,2,10,4,3,2,"27",1,0,12,3,0,4,1037853,"2023-11-29T00:00:00.000Z",15,FALSE,29,100,"G",29,29,"Utah Jazz","Jordan Clarkson",0,15,20,17,8,19.1
2,6,5,2,0,11,4,2,1,"28",3,0,9,8,1,1,1037853,"2023-11-29T00:00:00.000Z",15,FALSE,29,38017705,"C",29,29,"Utah Jazz","Walker Kessler",7,17,19,11,10,41.6
0,0,0,0,0,0,0,0,0,"00",0,0,0,0,0,0,1037853,"2023-11-29T00:00:00.000Z",15,FALSE,29,56677842,"F",29,29,"Utah Jazz","Brice Sensabaugh",0,0,0,0,0,0
1,1,3,5,3,10,5,1,0,"33",0,3,13,3,3,0,1037852,"2023-11-29T00:00:00.000Z",28,FALSE,24,18,"F",28,28,"Toronto Raptors","OG Anunoby",4,16,17,14,4,30.1
3,0,6,5,1,21,9,3,3,"36",3,4,22,9,1,3,1037852,"2023-11-29T00:00:00.000Z",28,FALSE,24,416,"F",28,28,"Toronto Raptors","Pascal Siakam",1,31,34,25,12,37.3
1,1,2,0,0,9,8,2,1,"30",2,4,17,4,0,2,1037852,"2023-11-29T00:00:00.000Z",28,FALSE,24,373,"C",28,28,"Toronto Raptors","Jakob Poeltl",1,21,22,18,5,24.3
4,3,5,3,1,15,7,8,8,"38",2,4,23,7,0,0,1037852,"2023-11-29T00:00:00.000Z",28,FALSE,24,17896055,"G-F",28,28,"Toronto Raptors","Scottie Barnes",3,30,34,27,11,46.4
12,0,5,2,1,11,3,1,1,"34",1,2,8,6,1,0,1037852,"2023-11-29T00:00:00.000Z",28,FALSE,24,409,"G",28,28,"Toronto Raptors","Dennis Schroder",1,14,26,20,18,36.2
1,0,4,1,1,10,5,4,3,"18",6,2,14,10,2,1,1037852,"2023-11-29T00:00:00.000Z",28,FALSE,24,3547249,"F",28,28,"Toronto Raptors","Precious Achiuwa",2,24,25,15,11,32.5
0,0,0,0,0,0,0,0,0,"03",0,0,0,0,0,0,1037852,"2023-11-29T00:00:00.000Z",28,FALSE,24,58,"F",28,28,"Toronto Raptors","Chris Boucher",0,0,0,0,0,0
0,0,0,0,0,0,0,0,0,"00",0,0,0,0,0,0,1037852,"2023-11-29T00:00:00.000Z",28,FALSE,24,56677828,"G",28,28,"Toronto Raptors","Gradey Dick",0,0,0,0,0,0
1,0,4,3,0,3,0,2,2,"14",1,0,2,5,0,1,1037852,"2023-11-29T00:00:00.000Z",28,FALSE,24,3547275,"G",28,28,"Toronto Raptors","Malachi Flynn",0,7,8,3,6,8.5
0,0,0,1,0,1,0,0,0,"09",0,2,0,0,0,2,1037852,"2023-11-29T00:00:00.000Z",28,FALSE,24,666762,"F",28,28,"Toronto Raptors","Jalen McDaniels",0,0,0,0,0,-2
0,0,0,0,0,0,0,0,0,"00",0,0,0,0,0,0,1037852,"2023-11-29T00:00:00.000Z",28,FALSE,24,376,"F",28,28,"Toronto Raptors","Otto Porter Jr.",0,0,0,0,0,0
0,0,0,0,0,0,0,0,0,"00",0,0,0,0,0,0,1037852,"2023-11-29T00:00:00.000Z",28,FALSE,24,436,"G-F",28,28,"Toronto Raptors","Garrett Temple",0,0,0,0,0,0
2,0,5,7,3,13,5,0,0,"25",0,1,13,5,0,0,1037852,"2023-11-29T00:00:00.000Z",28,FALSE,24,3089,"",28,28,"Toronto Raptors","Gary Trent Jr.",0,18,20,15,7,22
0,0,0,0,0,0,0,0,0,"00",0,0,0,0,0,0,1037852,"2023-11-29T00:00:00.000Z",28,FALSE,24,489,"F",28,28,"Toronto Raptors","Thaddeus Young",0,0,0,0,0,0
0,0,0,0,0,0,0,0,0,"00",0,0,0,0,0,0,1037852,"2023-11-29T00:00:00.000Z",28,FALSE,24,56677805,"G",28,28,"Toronto Raptors","Javon Freeman-Liberty",0,0,0,0,0,0
0,0,0,0,0,0,0,0,0,"00",0,0,0,0,0,0,1037852,"2023-11-29T00:00:00.000Z",28,FALSE,24,38017717,"F",28,28,"Toronto Raptors","Ron Harper Jr.",0,0,0,0,0,0
0,0,0,0,0,0,0,0,0,"00",0,0,0,0,0,0,1037852,"2023-11-29T00:00:00.000Z",28,FALSE,24,38017710,"C",28,28,"Toronto Raptors","Christian Koloko",0,0,0,0,0,0
0,0,0,0,0,0,0,0,0,"00",0,0,0,0,0,0,1037852,"2023-11-29T00:00:00.000Z",28,FALSE,24,56677869,"G",28,28,"Toronto Raptors","Markquis Nowell",0,0,0,0,0,0
0,0,0,0,0,0,0,0,0,"00",0,0,0,0,0,0,1037852,"2023-11-29T00:00:00.000Z",28,FALSE,24,3547298,"G",24,24,"Phoenix Suns","Saben Lee",0,0,0,0,0,0
0,0,2,1,1,3,2,0,0,"15",0,3,5,2,0,1,1037852,"2023-11-29T00:00:00.000Z",28,FALSE,24,314,"F",24,24,"Phoenix Suns","Chimezie Metu",0,7,7,5,2,6.4
0,2,0,3,0,5,0,2,1,"16",1,0,1,1,1,1,1037852,"2023-11-29T00:00:00.000Z",28,FALSE,24,470,"G",24,24,"Phoenix Suns","Yuta Watanabe",3,2,2,1,1,10.2
0,0,0,0,0,0,0,0,0,"00",0,0,0,0,0,0,1037852,"2023-11-29T00:00:00.000Z",28,FALSE,24,8,"G",24,24,"Phoenix Suns","Grayson Allen",0,0,0,0,0,0
0,0,0,0,0,0,0,0,0,"00",0,0,0,0,0,0,1037852,"2023-11-29T00:00:00.000Z",28,FALSE,24,666451,"C",24,24,"Phoenix Suns","Bol Bol",0,0,0,0,0,0
1,1,3,0,0,6,2,0,0,"18",1,0,4,4,0,0,1037852,"2023-11-29T00:00:00.000Z",28,FALSE,24,147,"F",24,24,"Phoenix Suns","Drew Eubanks",1,8,9,5,5,13.3
4,0,3,3,1,8,4,0,0,"23",3,2,9,6,0,2,1037852,"2023-11-29T00:00:00.000Z",28,FALSE,24,18678058,"",24,24,"Phoenix Suns","Jordan Goodwin",0,15,19,13,10,20.2
2,0,3,0,0,4,2,6,6,"24",4,1,10,7,0,0,1037852,"2023-11-29T00:00:00.000Z",28,FALSE,24,356,"G",24,24,"Phoenix Suns","Josh Okogie",0,17,19,12,9,21.4
6,0,4,8,2,30,11,6,6,"35",0,1,30,4,1,1,1037852,"2023-11-29T00:00:00.000Z",28,FALSE,24,140,"F",24,24,"Phoenix Suns","Kevin Durant",1,34,40,36,10,45.8
6,2,13,1,1,12,8,2,2,"30",1,3,19,14,0,2,1037852,"2023-11-29T00:00:00.000Z",28,FALSE,24,349,"C",24,24,"Phoenix Suns","Jusuf Nurkic",2,33,39,25,20,48.8
1,0,1,5,2,9,4,0,0,"34",0,2,10,1,1,0,1037852,"2023-11-29T00:00:00.000Z",28,FALSE,24,178,"G",24,24,"Phoenix Suns","Eric Gordon",1,11,12,11,2,15.7
5,0,5,4,0,12,2,4,4,"32",0,3,8,5,0,2,1037852,"2023-11-29T00:00:00.000Z",28,FALSE,24,57,"G",24,24,"Phoenix Suns","Devin Booker",0,13,18,13,10,19.5
0,0,0,0,0,0,0,0,0,"00",0,0,0,0,0,0,1037852,"2023-11-29T00:00:00.000Z",28,FALSE,24,3547095,"C-F",24,24,"Phoenix Suns","Udoka Azubuike",0,0,0,0,0,0
0,0,1,1,0,5,3,3,3,"13",2,0,9,3,0,0,1037852,"2023-11-29T00:00:00.000Z",28,FALSE,24,32,"F",24,24,"Phoenix Suns","Keita Bates-Diop",0,12,12,9,3,12.6
0,0,0,0,0,0,0,0,0,"00",0,0,0,0,0,0,1037852,"2023-11-29T00:00:00.000Z",28,FALSE,24,37,"G",24,24,"Phoenix Suns","Bradley Beal",0,0,0,0,0,0
0,0,0,0,0,0,0,0,0,"00",0,0,0,0,0,0,1037852,"2023-11-29T00:00:00.000Z",28,FALSE,24,272,"G",24,24,"Phoenix Suns","Damion Lee",0,0,0,0,0,0
0,0,0,0,0,0,0,0,0,"00",0,0,0,0,0,0,1037852,"2023-11-29T00:00:00.000Z",28,FALSE,24,666729,"F",24,24,"Phoenix Suns","Nassir Little",0,0,0,0,0,0
3,1,3,6,4,14,11,6,5,"31",3,1,31,6,0,2,1037851,"2023-11-29T00:00:00.000Z",22,FALSE,30,17896026,"F",22,22,"Orlando Magic","Franz Wagner",1,37,40,34,9,43.7
4,0,3,0,0,8,2,3,2,"27",1,2,6,4,0,4,1037851,"2023-11-29T00:00:00.000Z",22,FALSE,30,38017683,"F",22,22,"Orlando Magic","Paolo Banchero",0,10,14,10,8,12.8
2,1,6,0,0,5,2,4,4,"24",1,1,8,7,0,1,1037851,"2023-11-29T00:00:00.000Z",22,FALSE,30,666442,"C",22,22,"Orlando Magic","Goga Bitadze",1,15,17,10,9,21.4
3,0,2,6,3,15,9,1,1,"29",1,4,22,3,2,2,1037851,"2023-11-29T00:00:00.000Z",22,FALSE,30,17896073,"G",22,22,"Orlando Magic","Jalen Suggs",2,25,28,25,6,34.1
3,1,5,2,1,5,3,0,0,"27",0,1,7,5,0,2,1037851,"2023-11-29T00:00:00.000Z",22,FALSE,30,56677827,"G",22,22,"Orlando Magic","Anthony Black",1,12,15,10,8,18.5
5,2,3,5,3,16,9,5,4,"26",3,4,25,6,0,1,1037851,"2023-11-29T00:00:00.000Z",22,FALSE,30,3547251,"G",22,22,"Orlando Magic","Cole Anthony",2,31,36,30,11,44.7
4,0,2,2,2,2,2,3,2,"19",0,3,8,2,2,1,1037851,"2023-11-29T00:00:00.000Z",22,FALSE,30,196,"G",22,22,"Orlando Magic","Gary Harris",2,10,14,12,6,21.4
1,0,3,3,3,3,3,0,0,"10",0,3,9,3,0,1,1037851,"2023-11-29T00:00:00.000Z",22,FALSE,30,38017724,"G",22,22,"Orlando Magic","Caleb Houstan",0,12,13,10,4,13.1
6,0,4,1,1,7,5,1,1,"20",0,1,12,4,1,2,1037851,"2023-11-29T00:00:00.000Z",22,FALSE,30,226,"F",22,22,"Orlando Magic","Joe Ingles",1,16,22,18,10,26.8
0,0,0,0,0,0,0,0,0,"00",0,0,0,0,0,0,1037851,"2023-11-29T00:00:00.000Z",22,FALSE,30,229,"F",22,22,"Orlando Magic","Jonathan Isaac",0,0,0,0,0,0
2,0,0,1,0,2,0,0,0,"05",0,0,0,0,0,0,1037851,"2023-11-29T00:00:00.000Z",22,FALSE,30,666818,"F",22,22,"Orlando Magic","Chuma Okeke",0,0,2,2,2,3
0,0,0,0,0,0,0,0,0,"04",0,1,0,0,0,0,1037851,"2023-11-29T00:00:00.000Z",22,FALSE,30,666885,"F",22,22,"Orlando Magic","Admiral Schofield",0,0,0,0,0,0
1,1,4,1,0,7,5,1,1,"18",0,1,11,4,0,2,1037851,"2023-11-29T00:00:00.000Z",22,FALSE,30,462,"C",22,22,"Orlando Magic","Moritz Wagner",1,15,16,12,5,18.3
0,0,0,0,0,0,0,0,0,"00",0,0,0,0,0,0,1037851,"2023-11-29T00:00:00.000Z",22,FALSE,30,85,"F",22,22,"Orlando Magic","Wendell Carter Jr.",0,0,0,0,0,0
0,0,0,0,0,0,0,0,0,"00",0,0,0,0,0,0,1037851,"2023-11-29T00:00:00.000Z",22,FALSE,30,165,"G",22,22,"Orlando Magic","Markelle Fultz",0,0,0,0,0,0
0,0,0,0,0,0,0,0,0,"00",0,0,0,0,0,0,1037851,"2023-11-29T00:00:00.000Z",22,FALSE,30,38017607,"G",22,22,"Orlando Magic","Kevon Harris",0,0,0,0,0,0
0,0,0,0,0,0,0,0,0,"00",0,0,0,0,0,0,1037851,"2023-11-29T00:00:00.000Z",22,FALSE,30,56677839,"G",22,22,"Orlando Magic","Jett Howard",0,0,0,0,0,0
0,0,0,0,0,0,0,0,0,"00",0,0,0,0,0,0,1037851,"2023-11-29T00:00:00.000Z",22,FALSE,30,17553983,"G",22,22,"Orlando Magic","Trevelin Queen",0,0,0,0,0,0
5,0,1,2,1,12,9,4,3,"28",3,1,22,4,2,0,1037851,"2023-11-29T00:00:00.000Z",22,FALSE,30,3547242,"F",30,30,"Washington Wizards","Deni Avdija",2,26,31,27,9,40.3
6,0,3,4,1,20,9,6,5,"34",0,1,24,3,0,4,1037851,"2023-11-29T00:00:00.000Z",22,FALSE,30,265,"F",30,30,"Washington Wizards","Kyle Kuzma",0,27,33,30,9,32.6
4,2,2,0,0,2,2,0,0,"26",1,3,4,3,1,0,1037851,"2023-11-29T00:00:00.000Z",22,FALSE,30,666577,"F",30,30,"Washington Wizards","Daniel Gafford",3,7,11,8,7,22.6
2,1,5,7,4,12,5,6,5,"26",0,3,19,5,2,2,1037851,"2023-11-29T00:00:00.000Z",22,FALSE,30,666848,"G",30,30,"Washington Wizards","Jordan Poole",3,24,26,21,7,35
4,0,3,2,0,10,3,2,1,"21",0,1,7,3,2,0,1037851,"2023-11-29T00:00:00.000Z",22,FALSE,30,249,"G",30,30,"Washington Wizards","Tyus Jones",2,10,14,11,7,22.6
0,0,0,0,0,0,0,0,0,"00",0,0,0,0,0,0,1037851,"2023-11-29T00:00:00.000Z",22,FALSE,30,38017704,"F",30,30,"Washington Wizards","Patrick Baldwin Jr.",0,0,0,0,0,0
3,0,0,1,0,2,1,2,2,"05",0,0,4,0,2,0,1037851,"2023-11-29T00:00:00.000Z",22,FALSE,30,18677954,"G",30,30,"Washington Wizards","Jared Butler",2,4,7,7,3,14.5
0,0,4,1,1,5,2,2,2,"25",1,1,7,5,0,2,1037851,"2023-11-29T00:00:00.000Z",22,FALSE,30,56677844,"G",30,30,"Washington Wizards","Bilal Coulibaly",0,12,12,7,5,11
0,0,0,0,0,1,0,0,0,"10",1,1,0,1,1,0,1037851,"2023-11-29T00:00:00.000Z",22,FALSE,30,38017687,"G",30,30,"Washington Wizards","Johnny Davis",1,1,1,0,1,4.2
0,0,1,1,0,4,1,5,4,"12",0,1,6,1,0,0,1037851,"2023-11-29T00:00:00.000Z",22,FALSE,30,167,"F",30,30,"Washington Wizards","Danilo Gallinari",0,7,7,6,1,7.2
0,0,1,1,0,1,0,0,0,"05",0,0,0,1,0,0,1037851,"2023-11-29T00:00:00.000Z",22,FALSE,30,3547302,"F",30,30,"Washington Wizards","Anthony Gill",0,1,1,0,1,1.2
2,0,1,5,2,7,4,4,2,"20",0,1,12,1,2,1,1037851,"2023-11-29T00:00:00.000Z",22,FALSE,30,17896045,"F",30,30,"Washington Wizards","Corey Kispert",2,13,15,14,3,21.2
0,0,0,0,0,0,0,0,0,"00",0,0,0,0,0,0,1037851,"2023-11-29T00:00:00.000Z",22,FALSE,30,337,"F-C",30,30,"Washington Wizards","Mike Muscala",0,0,0,0,0,0
1,0,0,2,1,5,3,4,3,"10",1,3,10,1,1,0,1037851,"2023-11-29T00:00:00.000Z",22,FALSE,30,17896106,"F",30,30,"Washington Wizards","Eugene Omoruyi",1,11,12,11,2,15.7
1,0,1,3,1,6,2,0,0,"18",0,4,5,1,1,1,1037851,"2023-11-29T00:00:00.000Z",22,FALSE,30,414,"G",30,30,"Washington Wizards","Landry Shamet",1,6,7,6,2,9.7
0,0,0,0,0,0,0,0,0,"00",0,0,0,0,0,0,1037851,"2023-11-29T00:00:00.000Z",22,FALSE,30,38124126,"F",30,30,"Washington Wizards","John Butler Jr.",0,0,0,0,0,0
0,0,0,0,0,0,0,0,0,"00",0,0,0,0,0,0,1037851,"2023-11-29T00:00:00.000Z",22,FALSE,30,38017712,"G",30,30,"Washington Wizards","Ryan Rollins",0,0,0,0,0,0
0,0,0,0,0,0,0,0,0,"00",0,0,0,0,0,0,1037851,"2023-11-29T00:00:00.000Z",22,FALSE,30,487,"G",30,30,"Washington Wizards","Delon Wright",0,0,0,0,0,0
0,0,5,3,0,11,6,0,0,"21",1,4,12,6,1,0,1037850,"2023-11-29T00:00:00.000Z",9,FALSE,14,56677826,"G-F",9,9,"Detroit Pistons","Ausar Thompson",1,18,18,12,6,22.2
0,1,1,7,3,9,4,1,1,"25",2,3,12,3,0,2,1037850,"2023-11-29T00:00:00.000Z",9,FALSE,14,3547267,"F-C",9,9,"Detroit Pistons","Isaiah Stewart",1,15,15,12,3,16.6
0,1,3,0,0,8,3,0,0,"18",4,3,6,7,0,2,1037850,"2023-11-29T00:00:00.000Z",9,FALSE,14,38017694,"C",9,9,"Detroit Pistons","Jalen Duren",1,13,13,6,7,15.4
5,0,4,4,2,15,6,1,1,"23",0,1,15,4,1,2,1037850,"2023-11-29T00:00:00.000Z",9,FALSE,14,17896075,"G-F",9,9,"Detroit Pistons","Cade Cunningham",1,19,24,20,9,28.3
3,0,1,2,1,6,1,4,4,"19",0,6,7,1,1,1,1037850,"2023-11-29T00:00:00.000Z",9,FALSE,14,38017682,"G",9,9,"Detroit Pistons","Jaden Ivey",1,8,11,10,4,14.7
2,0,3,6,4,8,5,0,0,"22",0,2,14,3,0,2,1037850,"2023-11-29T00:00:00.000Z",9,FALSE,14,17896071,"F",9,9,"Detroit Pistons","Isaiah Livers",0,17,19,16,5,18.6
7,2,1,3,1,8,3,2,2,"28",0,2,9,1,2,1,1037850,"2023-11-29T00:00:00.000Z",9,FALSE,14,56677792,"G",9,9,"Detroit Pistons","Marcus Sasser",4,10,17,16,8,31.7
0,0,4,0,0,2,2,0,0,"12",1,2,4,5,0,1,1037850,"2023-11-29T00:00:00.000Z",9,FALSE,14,3547240,"C",9,9,"Detroit Pistons","James Wiseman",0,9,9,4,5,9
0,0,0,2,0,3,0,0,0,"04",1,1,0,1,0,0,1037850,"2023-11-29T00:00:00.000Z",9,FALSE,14,56677867,"F",14,14,"Los Angeles Lakers","Alex Fudge",0,1,1,0,1,1.2
0,1,1,0,0,0,0,0,0,"07",0,0,0,1,0,0,1037850,"2023-11-29T00:00:00.000Z",9,FALSE,14,666626,"C",14,14,"Los Angeles Lakers","Jaxson Hayes",1,1,1,0,1,4.2
0,0,0,2,1,3,1,0,0,"05",0,1,3,0,0,0,1037850,"2023-11-29T00:00:00.000Z",9,FALSE,14,56677868,"G",14,14,"Los Angeles Lakers","D'Moi Hodge",0,3,3,3,0,3
1,0,1,2,1,4,3,6,3,"11",0,2,10,1,1,1,1037850,"2023-11-29T00:00:00.000Z",9,FALSE,14,56677835,"G",14,14,"Los Angeles Lakers","Jalen Hood-Schifino",1,11,12,11,2,14.7
2,0,0,0,0,0,0,0,0,"07",0,1,0,0,2,0,1037850,"2023-11-29T00:00:00.000Z",9,FALSE,14,56677836,"F",14,14,"Los Angeles Lakers","Maxwell Lewis",2,0,2,2,2,9
4,1,2,4,0,8,3,0,0,"24",1,2,6,3,0,2,1037850,"2023-11-29T00:00:00.000Z",9,FALSE,14,17553995,"G",14,14,"Los Angeles Lakers","Austin Reaves",1,9,13,10,7,16.6
2,0,3,2,0,3,0,0,0,"20",0,2,0,3,0,1,1037850,"2023-11-29T00:00:00.000Z",9,FALSE,14,666860,"F-G",14,14,"Los Angeles Lakers","Cameron Reddish",0,3,5,2,5,5.6
0,2,9,4,0,9,4,4,4,"25",0,1,12,9,1,1,1037850,"2023-11-29T00:00:00.000Z",9,FALSE,14,486,"F",14,14,"Los Angeles Lakers","Christian Wood",3,21,21,12,9,30.8
0,0,0,0,0,0,0,0,0,"00",0,0,0,0,0,0,1037850,"2023-11-29T00:00:00.000Z",9,FALSE,14,56677738,"C",14,14,"Los Angeles Lakers","Colin Castleton",0,0,0,0,0,0
0,0,0,0,0,0,0,0,0,"00",0,0,0,0,0,0,1037850,"2023-11-29T00:00:00.000Z",9,FALSE,14,666609,"F",14,14,"Los Angeles Lakers","Rui Hachimura",0,0,0,0,0,0
0,0,0,0,0,0,0,0,0,"00",0,0,0,0,0,0,1037850,"2023-11-29T00:00:00.000Z",9,FALSE,14,457,"F",14,14,"Los Angeles Lakers","Jarred Vanderbilt",0,0,0,0,0,0
0,0,0,0,0,0,0,0,0,"00",0,0,0,0,0,0,1037850,"2023-11-29T00:00:00.000Z",9,FALSE,14,1603383,"G",14,14,"Los Angeles Lakers","Gabe Vincent",0,0,0,0,0,0
0,0,0,3,1,7,2,1,1,"10",1,1,6,1,0,0,1037850,"2023-11-29T00:00:00.000Z",9,FALSE,14,77,"G",9,9,"Detroit Pistons","Alec Burks",0,7,7,6,1,7.2
8,0,1,3,0,9,3,1,1,"22",0,2,7,1,2,0,1037850,"2023-11-29T00:00:00.000Z",9,FALSE,14,3547241,"G",9,9,"Detroit Pistons","Killian Hayes",2,8,16,15,9,26.2
2,0,6,5,2,9,2,2,2,"20",0,5,8,6,1,3,1037850,"2023-11-29T00:00:00.000Z",9,FALSE,14,44477024,"G",9,9,"Detroit Pistons","Stanley Umude",1,14,16,10,8,18.2
0,0,1,0,0,4,2,2,0,"14",1,0,4,2,0,0,1037850,"2023-11-29T00:00:00.000Z",9,FALSE,14,24,"F",9,9,"Detroit Pistons","Marvin Bagley III",0,6,6,4,2,6.4
0,0,0,1,1,1,1,0,0,"06",0,0,3,0,0,0,1037850,"2023-11-29T00:00:00.000Z",9,FALSE,14,259,"F",9,9,"Detroit Pistons","Kevin Knox",0,3,3,3,0,3
0,0,0,0,0,0,0,0,0,"00",0,0,0,0,0,0,1037850,"2023-11-29T00:00:00.000Z",9,FALSE,14,54,"F",9,9,"Detroit Pistons","Bojan Bogdanovic",0,0,0,0,0,0
0,0,0,0,0,0,0,0,0,"00",0,0,0,0,0,0,1037850,"2023-11-29T00:00:00.000Z",9,FALSE,14,56677729,"G",9,9,"Detroit Pistons","Malcolm Cazalon",0,0,0,0,0,0
0,0,0,0,0,0,0,0,0,"00",0,0,0,0,0,0,1037850,"2023-11-29T00:00:00.000Z",9,FALSE,14,197,"F-G",9,9,"Detroit Pistons","Joe Harris",0,0,0,0,0,0
0,0,0,0,0,0,0,0,0,"00",0,0,0,0,0,0,1037850,"2023-11-29T00:00:00.000Z",9,FALSE,14,330,"G",9,9,"Detroit Pistons","Monte Morris",0,0,0,0,0,0
0,0,0,0,0,0,0,0,0,"00",0,0,0,0,0,0,1037850,"2023-11-29T00:00:00.000Z",9,FALSE,14,42097199,"G",9,9,"Detroit Pistons","Jared Rhoden",0,0,0,0,0,0
1,0,1,4,3,4,3,0,0,"23",0,0,9,1,1,1,1037850,"2023-11-29T00:00:00.000Z",9,FALSE,14,383,"F",14,14,"Los Angeles Lakers","Taurean Prince",1,10,11,10,2,13.7
4,0,6,6,2,19,9,5,5,"29",2,0,25,8,0,1,1037850,"2023-11-29T00:00:00.000Z",9,FALSE,14,237,"F",14,14,"Los Angeles Lakers","LeBron James",0,33,37,29,12,39.6
4,3,12,0,0,15,9,13,10,"29",4,1,28,16,1,0,1037850,"2023-11-29T00:00:00.000Z",9,FALSE,14,117,"F-C",14,14,"Los Angeles Lakers","Anthony Davis",4,44,48,32,20,65.2
0,1,2,2,0,3,0,5,5,"22",0,1,5,2,0,2,1037850,"2023-11-29T00:00:00.000Z",9,FALSE,14,38017697,"G",14,14,"Los Angeles Lakers","Max Christie",1,7,7,5,2,8.4
9,2,4,7,5,17,13,5,4,"34",0,0,35,4,1,3,1037850,"2023-11-29T00:00:00.000Z",9,FALSE,14,405,"G",14,14,"Los Angeles Lakers","D'Angelo Russell",3,39,48,44,13,59.3
3,0,7,3,2,15,8,5,4,"33",4,2,22,11,1,2,1037864,"2023-11-30T00:00:00.000Z",27,FALSE,1,666682,"F",27,27,"San Antonio Spurs","Keldon Johnson",1,33,36,25,14,40.7
2,4,10,5,1,16,9,2,2,"29",2,1,21,12,2,2,1037864,"2023-11-30T00:00:00.000Z",27,FALSE,1,56677822,"F-C",27,27,"San Antonio Spurs","Victor Wembanyama",6,33,35,23,14,54.4
7,0,2,2,1,5,3,4,4,"34",0,3,11,2,0,3,1037864,"2023-11-30T00:00:00.000Z",27,FALSE,1,102,"F-C",27,27,"San Antonio Spurs","Zach Collins",0,13,20,18,9,20.9
3,1,3,2,0,5,1,0,0,"17",0,1,2,3,0,3,1037864,"2023-11-30T00:00:00.000Z",27,FALSE,1,38017692,"F",27,27,"San Antonio Spurs","Malaki Branham",1,5,8,5,6,10.1
6,0,5,3,3,14,12,6,6,"36",3,5,33,8,1,5,1037864,"2023-11-30T00:00:00.000Z",27,FALSE,1,38017699,"F",27,27,"San Antonio Spurs","Jeremy Sochan",1,41,47,39,14,49.6
0,0,0,0,0,0,0,0,0,"00",0,0,0,0,0,0,1037864,"2023-11-30T00:00:00.000Z",27,FALSE,1,38017730,"F",27,27,"San Antonio Spurs","Dominick Barlow",0,0,0,0,0,0
0,2,0,0,0,0,0,0,0,"04",1,3,0,1,0,0,1037864,"2023-11-30T00:00:00.000Z",27,FALSE,1,17895854,"G",27,27,"San Antonio Spurs","Charles Bassey",2,1,1,0,1,7.2
0,0,0,0,0,0,0,0,0,"00",0,0,0,0,0,0,1037864,"2023-11-30T00:00:00.000Z",27,FALSE,1,38017693,"G",27,27,"San Antonio Spurs","Blake Wesley",0,0,0,0,0,0
0,0,0,0,0,0,0,0,0,"00",0,0,0,0,0,0,1037864,"2023-11-30T00:00:00.000Z",27,FALSE,1,56677865,"C",27,27,"San Antonio Spurs","Charles Bediako",0,0,0,0,0,0
0,0,0,0,0,0,0,0,0,"00",0,0,0,0,0,0,1037864,"2023-11-30T00:00:00.000Z",27,FALSE,1,56677817,"G",27,27,"San Antonio Spurs","Sidy Cissoko",0,0,0,0,0,0
0,0,0,0,0,0,0,0,0,"00",0,0,0,0,0,0,1037864,"2023-11-30T00:00:00.000Z",27,FALSE,1,56677870,"G",27,27,"San Antonio Spurs","Sir'Jabari Rice",0,0,0,0,0,0
2,0,6,4,2,8,3,4,4,"22",0,6,12,6,1,3,1037864,"2023-11-30T00:00:00.000Z",27,FALSE,1,666656,"F",1,1,"Atlanta Hawks","De'Andre Hunter",1,18,20,14,8,22.2
0,0,2,4,3,8,5,0,0,"34",2,3,13,4,3,1,1037864,"2023-11-30T00:00:00.000Z",27,FALSE,1,3547256,"F",1,1,"Atlanta Hawks","Saddiq Bey",3,17,17,13,4,25.8
1,1,5,0,0,9,6,0,0,"23",4,4,12,9,0,2,1037864,"2023-11-30T00:00:00.000Z",27,FALSE,1,83,"C",1,1,"Atlanta Hawks","Clint Capela",1,21,22,13,10,25.3
2,0,3,4,2,21,10,2,2,"35",0,1,24,3,5,0,1037864,"2023-11-30T00:00:00.000Z",27,FALSE,1,334,"G",1,1,"Atlanta Hawks","Dejounte Murray",5,27,29,26,5,45.6
0,0,2,8,5,8,5,0,0,"20",1,2,15,3,0,1,1037864,"2023-11-30T00:00:00.000Z",27,FALSE,1,38017649,"F",27,27,"San Antonio Spurs","Julian Champagnie",0,18,18,15,3,17.6
0,0,0,0,0,0,0,0,0,"00",0,0,0,0,0,0,1037864,"2023-11-30T00:00:00.000Z",27,FALSE,1,180,"G",27,27,"San Antonio Spurs","Devonte' Graham",0,0,0,0,0,0
7,0,2,3,1,5,1,1,0,"24",0,1,3,2,0,2,1037864,"2023-11-30T00:00:00.000Z",27,FALSE,1,3547274,"G",27,27,"San Antonio Spurs","Tre Jones",0,5,12,10,9,13.9
0,0,0,0,0,0,0,0,0,"00",0,0,0,0,0,0,1037864,"2023-11-30T00:00:00.000Z",27,FALSE,1,17896059,"F",27,27,"San Antonio Spurs","Sandro Mamukelashvili",0,0,0,0,0,0
0,0,0,0,0,0,0,0,0,"00",0,0,0,0,0,0,1037864,"2023-11-30T00:00:00.000Z",27,FALSE,1,305,"F",27,27,"San Antonio Spurs","Doug McDermott",0,0,0,0,0,0
2,0,1,5,1,7,1,0,0,"16",0,3,3,1,0,1,1037864,"2023-11-30T00:00:00.000Z",27,FALSE,1,359,"F",27,27,"San Antonio Spurs","Cedi Osman",0,4,6,5,3,6.2
4,0,4,10,4,14,8,5,5,"27",0,1,25,4,0,2,1037864,"2023-11-30T00:00:00.000Z",27,FALSE,1,3547246,"G-F",27,27,"San Antonio Spurs","Devin Vassell",0,29,33,29,8,33.8
0,0,0,0,0,0,0,0,0,"00",0,0,0,0,0,0,1037864,"2023-11-30T00:00:00.000Z",27,FALSE,1,56677838,"G",1,1,"Atlanta Hawks","Kobe Bufkin",0,0,0,0,0,0
0,0,0,0,0,0,0,0,0,"00",0,0,0,0,0,0,1037864,"2023-11-30T00:00:00.000Z",27,FALSE,1,56677806,"F",1,1,"Atlanta Hawks","Mouhamed Gueye",0,0,0,0,0,0
0,0,0,0,0,0,0,0,0,"00",0,0,0,0,0,0,1037864,"2023-11-30T00:00:00.000Z",27,FALSE,1,17896040,"F",1,1,"Atlanta Hawks","Jalen Johnson",0,0,0,0,0,0
0,0,0,0,0,0,0,0,0,"00",0,0,0,0,0,0,1037864,"2023-11-30T00:00:00.000Z",27,FALSE,1,56677855,"G",1,1,"Atlanta Hawks","Seth Lundy",0,0,0,0,0,0
0,0,0,0,0,0,0,0,0,"00",0,0,0,0,0,0,1037864,"2023-11-30T00:00:00.000Z",27,FALSE,1,56677875,"F",1,1,"Atlanta Hawks","Miles Norris",0,0,0,0,0,0
0,0,1,4,1,4,1,0,0,"12",0,1,3,1,1,0,1037864,"2023-11-30T00:00:00.000Z",27,FALSE,1,666754,"G",1,1,"Atlanta Hawks","Garrison Mathews",1,4,4,3,1,7.2
0,0,6,3,1,6,3,5,4,"28",2,4,11,8,0,1,1037864,"2023-11-30T00:00:00.000Z",27,FALSE,1,3547244,"F-C",1,1,"Atlanta Hawks","Onyeka Okongwu",0,19,19,11,8,19.6
2,1,0,1,1,1,1,0,0,"14",0,1,3,0,0,0,1037864,"2023-11-30T00:00:00.000Z",27,FALSE,1,301,"G-F",1,1,"Atlanta Hawks","Wesley Matthews",1,3,5,5,2,9
0,0,0,0,0,0,0,0,0,"00",0,0,0,0,0,0,1037864,"2023-11-30T00:00:00.000Z",27,FALSE,1,666564,"F",1,1,"Atlanta Hawks","Bruno Fernando",0,0,0,0,0,0
0,0,0,0,0,0,0,0,0,"00",0,0,0,0,0,0,1037864,"2023-11-30T00:00:00.000Z",27,FALSE,1,3547297,"G",1,1,"Atlanta Hawks","Trent Forrest",0,0,0,0,0,0
0,0,0,0,0,0,0,0,0,"00",0,0,0,0,0,0,1037864,"2023-11-30T00:00:00.000Z",27,FALSE,1,38017689,"F",1,1,"Atlanta Hawks","AJ Griffin",0,0,0,0,0,0
0,0,0,0,0,0,0,0,0,"00",0,0,0,0,0,0,1037864,"2023-11-30T00:00:00.000Z",27,FALSE,1,319,"G",1,1,"Atlanta Hawks","Patty Mills",0,0,0,0,0,0
14,0,4,9,2,29,15,16,13,"40",0,1,45,4,2,2,1037864,"2023-11-30T00:00:00.000Z",27,FALSE,1,490,"G",1,1,"Atlanta Hawks","Trae Young",2,49,63,59,18,74.8
3,0,2,4,2,10,5,2,2,"32",0,4,14,2,2,1,1037864,"2023-11-30T00:00:00.000Z",27,FALSE,1,53,"G",1,1,"Atlanta Hawks","Bogdan Bogdanovic",2,16,19,17,5,25.9
1,1,1,4,1,10,6,0,0,"28",2,2,13,3,0,0,1037865,"2023-11-30T00:00:00.000Z",10,FALSE,13,17553992,"G",10,10,"Golden State Warriors","Moses Moody",1,16,17,14,4,21.1
5,0,4,4,2,8,4,4,3,"29",1,5,13,5,0,2,1037865,"2023-11-30T00:00:00.000Z",10,FALSE,13,185,"F",10,10,"Golden State Warriors","Draymond Green",0,18,23,18,10,24.5
2,0,3,0,0,4,0,2,2,"13",2,2,2,5,0,0,1037865,"2023-11-30T00:00:00.000Z",10,FALSE,13,282,"F",10,10,"Golden State Warriors","Kevon Looney",0,7,9,4,7,11
2,1,4,7,2,18,8,4,4,"34",2,2,22,6,0,2,1037865,"2023-11-30T00:00:00.000Z",10,FALSE,13,443,"G",10,10,"Golden State Warriors","Klay Thompson",1,28,30,24,8,33.2
8,1,7,9,3,15,8,9,7,"33",0,2,26,7,1,2,1037865,"2023-11-30T00:00:00.000Z",10,FALSE,13,115,"G",10,10,"Golden State Warriors","Stephen Curry",2,33,41,34,15,50.4
2,0,6,4,2,10,5,2,1,"31",2,2,13,8,0,0,1037865,"2023-11-30T00:00:00.000Z",10,FALSE,13,56677858,"G",10,10,"Golden State Warriors","Brandin Podziemski",0,21,23,15,10,25.6
0,0,0,0,0,0,0,0,0,"00",0,0,0,0,0,0,1037865,"2023-11-30T00:00:00.000Z",10,FALSE,13,475,"F-G",10,10,"Golden State Warriors","Andrew Wiggins",0,0,0,0,0,0
0,0,6,2,2,17,9,4,3,"35",1,2,23,7,2,0,1037865,"2023-11-30T00:00:00.000Z",10,FALSE,13,274,"F",13,13,"LA Clippers","Kawhi Leonard",2,30,30,23,7,37.4
10,0,1,10,3,18,6,0,0,"37",0,5,15,1,0,1,1037865,"2023-11-30T00:00:00.000Z",10,FALSE,13,172,"F",13,13,"LA Clippers","Paul George",0,16,26,25,11,30.2
0,1,9,0,0,11,7,5,4,"26",4,1,18,13,0,0,1037865,"2023-11-30T00:00:00.000Z",10,FALSE,13,493,"C",13,13,"LA Clippers","Ivica Zubac",1,31,31,18,13,36.6
1,0,2,4,1,10,4,0,0,"34",3,1,9,5,1,2,1037865,"2023-11-30T00:00:00.000Z",10,FALSE,13,666743,"G",13,13,"LA Clippers","Terance Mann",1,14,15,10,6,17.5
7,0,3,10,5,13,6,2,1,"37",0,3,18,3,1,1,1037865,"2023-11-30T00:00:00.000Z",10,FALSE,13,192,"G",13,13,"LA Clippers","James Harden",1,21,28,25,10,34.1
0,0,1,1,0,1,0,0,0,"06",0,2,0,1,0,0,1037865,"2023-11-30T00:00:00.000Z",10,FALSE,13,56677849,"F",13,13,"LA Clippers","Kobe Brown",0,1,1,0,1,1.2
0,0,0,0,0,0,0,0,0,"01",0,2,0,0,0,0,1037865,"2023-11-30T00:00:00.000Z",10,FALSE,13,666511,"G",13,13,"LA Clippers","Amir Coffey",0,0,0,0,0,0
0,0,0,0,0,0,0,2,2,"01",0,0,2,0,0,0,1037865,"2023-11-30T00:00:00.000Z",10,FALSE,13,38017725,"F",13,13,"LA Clippers","Moussa Diabate",0,2,2,2,0,2
0,0,0,1,0,1,0,0,0,"04",0,1,0,0,0,0,1037865,"2023-11-30T00:00:00.000Z",10,FALSE,13,17896031,"G",13,13,"LA Clippers","Nah'Shon Hyland",0,0,0,0,0,0
0,0,0,0,0,0,0,0,0,"00",0,0,0,0,0,0,1037865,"2023-11-30T00:00:00.000Z",10,FALSE,13,24417679,"G",13,13,"LA Clippers","Xavier Moon",0,0,0,0,0,0
0,0,0,0,0,2,1,3,3,"18",0,1,5,0,1,2,1037865,"2023-11-30T00:00:00.000Z",10,FALSE,13,380,"F-G",13,13,"LA Clippers","Norman Powell",1,5,5,5,0,6
2,0,1,1,1,9,4,2,1,"15",1,2,10,2,0,0,1037865,"2023-11-30T00:00:00.000Z",10,FALSE,13,439,"F",13,13,"LA Clippers","Daniel Theis",0,12,14,12,4,15.4
0,0,0,0,0,0,0,0,0,"00",0,0,0,0,0,0,1037865,"2023-11-30T00:00:00.000Z",10,FALSE,13,450,"F",13,13,"LA Clippers","PJ Tucker",0,0,0,0,0,0
6,0,5,3,0,13,5,6,4,"26",6,1,14,11,0,0,1037865,"2023-11-30T00:00:00.000Z",10,FALSE,13,472,"G",13,13,"LA Clippers","Russell Westbrook",0,25,31,20,17,36.2
0,0,0,0,0,0,0,0,0,"00",0,0,0,0,0,0,1037865,"2023-11-30T00:00:00.000Z",10,FALSE,13,17896022,"G",13,13,"LA Clippers","Brandon Boston Jr.",0,0,0,0,0,0
0,0,0,0,0,0,0,0,0,"00",0,0,0,0,0,0,1037865,"2023-11-30T00:00:00.000Z",10,FALSE,13,56677856,"G",13,13,"LA Clippers","Jordan Miller",0,0,0,0,0,0
0,0,0,0,0,0,0,0,0,"00",0,0,0,0,0,0,1037865,"2023-11-30T00:00:00.000Z",10,FALSE,13,17896070,"F",10,10,"Golden State Warriors","Usman Garuba",0,0,0,0,0,0
0,0,0,0,0,0,0,0,0,"00",0,0,0,0,0,0,1037865,"2023-11-30T00:00:00.000Z",10,FALSE,13,367,"G",10,10,"Golden State Warriors","Chris Paul",0,0,0,0,0,0
0,0,0,0,0,0,0,0,0,"00",0,0,0,0,0,0,1037865,"2023-11-30T00:00:00.000Z",10,FALSE,13,2189,"",10,10,"Golden State Warriors","Gary Payton II",0,0,0,0,0,0
0,0,0,0,0,0,0,0,0,"00",0,0,0,0,0,0,1037865,"2023-11-30T00:00:00.000Z",10,FALSE,13,371,"F-C",13,13,"LA Clippers","Mason Plumlee",0,0,0,0,0,0
0,0,0,0,0,0,0,0,0,"00",0,0,0,0,0,0,1037865,"2023-11-30T00:00:00.000Z",10,FALSE,13,17896051,"G",13,13,"LA Clippers","Joshua Primo",0,0,0,0,0,0
5,0,5,4,2,7,4,4,3,"27",0,2,13,5,1,0,1037865,"2023-11-30T00:00:00.000Z",10,FALSE,13,407,"F",10,10,"Golden State Warriors","Dario Saric",1,18,23,18,10,29.5
2,0,2,2,0,2,0,2,1,"22",0,1,1,2,0,0,1037865,"2023-11-30T00:00:00.000Z",10,FALSE,13,251,"G",10,10,"Golden State Warriors","Cory Joseph",0,3,5,3,4,6.4
3,1,5,5,3,8,6,4,2,"23",1,0,17,6,1,1,1037865,"2023-11-30T00:00:00.000Z",10,FALSE,13,17553979,"F",10,10,"Golden State Warriors","Jonathan Kuminga",2,23,26,20,9,33.7
0,0,0,0,0,0,0,0,0,"00",0,0,0,0,0,0,1037865,"2023-11-30T00:00:00.000Z",10,FALSE,13,56677799,"F",10,10,"Golden State Warriors","Trayce Jackson-Davis",0,0,0,0,0,0
0,0,0,0,0,0,0,0,0,"00",0,0,0,0,0,0,1037865,"2023-11-30T00:00:00.000Z",10,FALSE,13,45658838,"G",10,10,"Golden State Warriors","Lester Quinones",0,0,0,0,0,0
0,0,0,0,0,0,0,0,0,"00",0,0,0,0,0,0,1037865,"2023-11-30T00:00:00.000Z",10,FALSE,13,398,"G",10,10,"Golden State Warriors","Jerome Robinson",0,0,0,0,0,0
0,0,0,0,0,0,0,0,0,"00",0,0,0,0,0,0,1037865,"2023-11-30T00:00:00.000Z",10,FALSE,13,57875092,"F",10,10,"Golden State Warriors","Gui Santos",0,0,0,0,0,0
0,0,0,0,0,0,0,0,0,"00",0,0,0,0,0,0,1037863,"2023-11-30T00:00:00.000Z",21,FALSE,14,38017716,"F",21,21,"Oklahoma City Thunder","Ousmane Dieng",0,0,0,0,0,0
0,0,0,0,0,0,0,0,0,"00",0,0,0,0,0,0,1037863,"2023-11-30T00:00:00.000Z",21,FALSE,14,56677853,"F",21,21,"Oklahoma City Thunder","Keyontae Johnson",0,0,0,0,0,0
0,0,0,0,0,0,0,0,0,"00",0,0,0,0,0,0,1037863,"2023-11-30T00:00:00.000Z",21,FALSE,14,24572055,"C",21,21,"Oklahoma City Thunder","Olivier Sarr",0,0,0,0,0,0
2,0,1,5,2,7,2,0,0,"32",0,5,6,1,0,1,1037863,"2023-11-30T00:00:00.000Z",21,FALSE,14,383,"F",14,14,"Los Angeles Lakers","Taurean Prince",0,7,9,8,3,9.2
6,1,10,8,4,12,7,4,3,"35",2,1,21,12,1,5,1037863,"2023-11-30T00:00:00.000Z",21,FALSE,14,237,"F",14,14,"Los Angeles Lakers","LeBron James",2,33,39,27,18,45.4
3,1,4,5,2,9,5,0,0,"28",3,2,12,7,2,0,1037863,"2023-11-30T00:00:00.000Z",21,FALSE,14,666541,"G",21,21,"Oklahoma City Thunder","Luguentz Dort",3,19,22,15,10,33.9
7,1,5,4,1,13,8,5,4,"29",0,3,21,5,0,0,1037863,"2023-11-30T00:00:00.000Z",21,FALSE,14,38017703,"G-F",21,21,"Oklahoma City Thunder","Jalen Williams",1,26,33,28,12,40.5
1,0,4,6,1,15,8,1,1,"28",1,3,18,5,2,2,1037863,"2023-11-30T00:00:00.000Z",21,FALSE,14,38017685,"C-F",21,21,"Oklahoma City Thunder","Chet Holmgren",2,23,24,19,6,29.5
1,0,6,5,2,10,5,2,2,"21",2,2,14,8,1,4,1037863,"2023-11-30T00:00:00.000Z",21,FALSE,14,17896065,"G",21,21,"Oklahoma City Thunder","Josh Giddey",1,22,23,15,9,24.1
7,0,4,4,1,18,11,10,10,"35",0,4,33,4,1,0,1037863,"2023-11-30T00:00:00.000Z",21,FALSE,14,175,"G",21,21,"Oklahoma City Thunder","Shai Gilgeous-Alexander",1,37,44,40,11,51.3
0,0,0,0,0,0,0,0,0,"00",0,0,0,0,0,0,1037863,"2023-11-30T00:00:00.000Z",21,FALSE,14,44,"F",21,21,"Oklahoma City Thunder","Davis Bertans",0,0,0,0,0,0
0,3,5,6,2,8,4,0,0,"20",0,0,10,5,1,0,1037863,"2023-11-30T00:00:00.000Z",21,FALSE,14,3547272,"G",21,21,"Oklahoma City Thunder","Isaiah Joe",4,15,15,10,5,28
2,0,1,0,0,0,0,0,0,"03",0,0,0,1,0,0,1037863,"2023-11-30T00:00:00.000Z",21,FALSE,14,17896036,"G",21,21,"Oklahoma City Thunder","Tre Mann",0,1,3,2,3,4.2
0,0,0,0,0,0,0,0,0,"00",0,0,0,0,0,0,1037863,"2023-11-30T00:00:00.000Z",21,FALSE,14,4197029,"G",21,21,"Oklahoma City Thunder","Vasilije Micic",0,0,0,0,0,0
0,0,0,0,0,1,0,0,0,"03",0,1,0,0,0,0,1037863,"2023-11-30T00:00:00.000Z",21,FALSE,14,3547271,"C",21,21,"Oklahoma City Thunder","Aleksej Pokusevski",0,0,0,0,0,0
1,1,3,4,2,7,4,0,0,"22",0,1,10,3,0,1,1037863,"2023-11-30T00:00:00.000Z",21,FALSE,14,56677833,"G",21,21,"Oklahoma City Thunder","Cason Wallace",1,13,14,11,4,17.1
1,0,1,4,1,5,2,0,0,"12",0,3,5,1,0,0,1037863,"2023-11-30T00:00:00.000Z",21,FALSE,14,27924547,"F",21,21,"Oklahoma City Thunder","Lindy Waters III",0,6,7,6,2,7.7
2,0,3,1,1,2,2,2,1,"13",2,2,6,5,0,0,1037863,"2023-11-30T00:00:00.000Z",21,FALSE,14,17896078,"G",21,21,"Oklahoma City Thunder","Aaron Wiggins",0,11,13,8,7,15
1,0,2,2,1,2,1,0,0,"07",0,0,3,2,0,0,1037863,"2023-11-30T00:00:00.000Z",21,FALSE,14,38017706,"F",21,21,"Oklahoma City Thunder","Jaylin Williams",0,5,6,4,3,6.9
3,0,2,1,0,4,0,2,1,"19",0,3,1,2,2,0,1037863,"2023-11-30T00:00:00.000Z",21,FALSE,14,480,"G-F",21,21,"Oklahoma City Thunder","Kenrich Williams",2,3,6,4,5,13.9
2,0,13,1,0,18,11,10,9,"36",1,1,31,14,2,0,1037863,"2023-11-30T00:00:00.000Z",21,FALSE,14,117,"F-C",14,14,"Los Angeles Lakers","Anthony Davis",2,45,47,33,16,56.8
0,1,0,3,2,7,3,0,0,"21",0,4,8,0,2,1,1037863,"2023-11-30T00:00:00.000Z",21,FALSE,14,38017697,"G",14,14,"Los Angeles Lakers","Max Christie",3,8,8,8,0,16
10,0,2,5,2,13,6,2,2,"32",1,3,16,3,1,2,1037863,"2023-11-30T00:00:00.000Z",21,FALSE,14,405,"G",14,14,"Los Angeles Lakers","D'Angelo Russell",1,19,29,26,13,35.6
0,1,2,0,0,1,0,2,2,"04",1,0,2,3,0,0,1037863,"2023-11-30T00:00:00.000Z",21,FALSE,14,56677738,"C",14,14,"Los Angeles Lakers","Colin Castleton",1,5,5,2,3,8.6
0,0,0,1,0,1,0,2,2,"04",1,0,2,1,0,0,1037863,"2023-11-30T00:00:00.000Z",21,FALSE,14,56677867,"F",14,14,"Los Angeles Lakers","Alex Fudge",0,3,3,2,1,3.2
0,0,0,1,0,1,0,0,0,"04",0,0,0,0,0,0,1037863,"2023-11-30T00:00:00.000Z",21,FALSE,14,56677868,"G",14,14,"Los Angeles Lakers","D'Moi Hodge",0,0,0,0,0,0
0,0,1,3,0,6,1,2,1,"19",0,3,3,1,0,1,1037863,"2023-11-30T00:00:00.000Z",21,FALSE,14,56677835,"G",14,14,"Los Angeles Lakers","Jalen Hood-Schifino",0,4,4,3,1,3.2
0,0,0,0,0,0,0,0,0,"04",0,0,0,0,0,0,1037863,"2023-11-30T00:00:00.000Z",21,FALSE,14,56677836,"F",14,14,"Los Angeles Lakers","Maxwell Lewis",0,0,0,0,0,0
3,0,2,4,1,9,5,3,3,"29",0,2,14,2,0,2,1037863,"2023-11-30T00:00:00.000Z",21,FALSE,14,17553995,"G",14,14,"Los Angeles Lakers","Austin Reaves",0,16,19,17,5,18.9
0,0,0,0,0,0,0,0,0,"00",0,0,0,0,0,0,1037863,"2023-11-30T00:00:00.000Z",21,FALSE,14,666860,"F-G",14,14,"Los Angeles Lakers","Cameron Reddish",0,0,0,0,0,0
1,0,3,2,0,6,1,7,5,"20",1,1,7,4,0,1,1037863,"2023-11-30T00:00:00.000Z",21,FALSE,14,486,"F",14,14,"Los Angeles Lakers","Christian Wood",0,11,12,8,5,12.3
0,0,0,0,0,0,0,0,0,"00",0,0,0,0,0,0,1037863,"2023-11-30T00:00:00.000Z",21,FALSE,14,666609,"F",14,14,"Los Angeles Lakers","Rui Hachimura",0,0,0,0,0,0
0,0,0,0,0,0,0,0,0,"00",0,0,0,0,0,0,1037863,"2023-11-30T00:00:00.000Z",21,FALSE,14,666626,"C",14,14,"Los Angeles Lakers","Jaxson Hayes",0,0,0,0,0,0
0,0,0,0,0,0,0,0,0,"00",0,0,0,0,0,0,1037863,"2023-11-30T00:00:00.000Z",21,FALSE,14,457,"F",14,14,"Los Angeles Lakers","Jarred Vanderbilt",0,0,0,0,0,0
0,0,0,0,0,0,0,0,0,"00",0,0,0,0,0,0,1037863,"2023-11-30T00:00:00.000Z",21,FALSE,14,1603383,"G",14,14,"Los Angeles Lakers","Gabe Vincent",0,0,0,0,0,0
3,0,3,6,1,11,4,0,0,"36",0,6,9,3,2,2,1037857,"2023-11-30T00:00:00.000Z",6,FALSE,25,666908,"G",6,6,"Cleveland Cavaliers","Max Strus",2,12,15,12,6,21.1
3,0,6,1,0,14,9,2,2,"34",2,1,20,8,2,3,1037857,"2023-11-30T00:00:00.000Z",6,FALSE,25,17896076,"F-C",6,6,"Cleveland Cavaliers","Evan Mobley",2,28,31,23,11,37.1
2,2,4,0,0,9,6,0,0,"38",6,3,12,10,0,1,1037857,"2023-11-30T00:00:00.000Z",6,FALSE,25,9,"C",6,6,"Cleveland Cavaliers","Jarrett Allen",2,22,24,14,12,32
6,0,4,9,1,20,7,8,8,"33",3,1,23,7,4,1,1037857,"2023-11-30T00:00:00.000Z",6,FALSE,25,322,"G",6,6,"Cleveland Cavaliers","Donovan Mitchell",4,30,36,29,13,51.4
7,0,3,8,2,18,6,1,1,"37",1,0,15,4,1,8,1037857,"2023-11-30T00:00:00.000Z",6,FALSE,25,666581,"G",6,6,"Cleveland Cavaliers","Darius Garland",1,19,26,22,11,25.3
0,0,0,0,0,0,0,0,0,"00",0,0,0,0,0,0,1037857,"2023-11-30T00:00:00.000Z",6,FALSE,25,248,"C",6,6,"Cleveland Cavaliers","Damian Jones",0,0,0,0,0,0
2,0,1,4,1,9,2,0,0,"26",1,3,5,2,0,2,1037857,"2023-11-30T00:00:00.000Z",6,FALSE,25,277,"G",6,6,"Cleveland Cavaliers","Caris LeVert",0,7,9,7,4,8.4
0,0,0,0,0,0,0,0,0,"00",0,0,0,0,0,0,1037857,"2023-11-30T00:00:00.000Z",6,FALSE,25,3547299,"G",6,6,"Cleveland Cavaliers","Sam Merrill",0,0,0,0,0,0
2,0,0,3,1,6,3,1,1,"19",1,0,8,1,2,0,1037857,"2023-11-30T00:00:00.000Z",6,FALSE,25,344,"F",6,6,"Cleveland Cavaliers","Georges Niang",2,9,11,10,3,18.2
0,0,0,1,1,2,1,0,0,"17",0,1,3,0,1,0,1037857,"2023-11-30T00:00:00.000Z",6,FALSE,25,3547247,"F-G",6,6,"Cleveland Cavaliers","Isaac Okoro",1,3,3,3,0,6
0,0,0,0,0,0,0,0,0,"00",0,0,0,0,0,0,1037857,"2023-11-30T00:00:00.000Z",6,FALSE,25,56677872,"G",6,6,"Cleveland Cavaliers","Craig Porter",0,0,0,0,0,0
0,0,0,0,0,0,0,0,0,"00",0,0,0,0,0,0,1037857,"2023-11-30T00:00:00.000Z",6,FALSE,25,444,"C-F",6,6,"Cleveland Cavaliers","Tristan Thompson",0,0,0,0,0,0
0,0,0,0,0,0,0,0,0,"00",0,0,0,0,0,0,1037857,"2023-11-30T00:00:00.000Z",6,FALSE,25,56677847,"F",6,6,"Cleveland Cavaliers","Emoni Bates",0,0,0,0,0,0
0,0,0,0,0,0,0,0,0,"00",0,0,0,0,0,0,1037857,"2023-11-30T00:00:00.000Z",6,FALSE,25,666676,"G",6,6,"Cleveland Cavaliers","Ty Jerome",0,0,0,0,0,0
0,0,0,0,0,0,0,0,0,"00",0,0,0,0,0,0,1037857,"2023-11-30T00:00:00.000Z",6,FALSE,25,38017662,"F",6,6,"Cleveland Cavaliers","Isaiah Mobley",0,0,0,0,0,0
0,0,0,0,0,0,0,0,0,"00",0,0,0,0,0,0,1037857,"2023-11-30T00:00:00.000Z",6,FALSE,25,404,"G",6,6,"Cleveland Cavaliers","Ricky Rubio",0,0,0,0,0,0
0,0,0,0,0,0,0,0,0,"00",0,0,0,0,0,0,1037857,"2023-11-30T00:00:00.000Z",6,FALSE,25,17896120,"F",25,25,"Portland Trail Blazers","Ish Wainright",0,0,0,0,0,0
0,0,0,0,0,0,0,0,0,"00",0,0,0,0,0,0,1037857,"2023-11-30T00:00:00.000Z",6,FALSE,25,476,"C-F",25,25,"Portland Trail Blazers","Robert Williams III",0,0,0,0,0,0
0,0,0,0,0,0,0,0,0,"00",0,0,0,0,0,0,1037857,"2023-11-30T00:00:00.000Z",6,FALSE,25,666940,"F",6,6,"Cleveland Cavaliers","Dean Wade",0,0,0,0,0,0
1,1,1,3,1,6,4,0,0,"24",1,0,9,2,2,1,1037857,"2023-11-30T00:00:00.000Z",6,FALSE,25,56677850,"F",25,25,"Portland Trail Blazers","Toumani Camara",3,11,12,10,3,20.9
3,1,2,6,3,12,4,2,2,"28",0,4,13,2,2,3,1037857,"2023-11-30T00:00:00.000Z",6,FALSE,25,182,"F",25,25,"Portland Trail Blazers","Jerami Grant",3,15,18,16,5,25.9
3,0,4,0,0,9,5,0,0,"30",2,2,10,6,0,3,1037857,"2023-11-30T00:00:00.000Z",6,FALSE,25,22,"C",25,25,"Portland Trail Blazers","Deandre Ayton",0,16,19,13,9,18.7
5,0,10,7,4,15,11,3,3,"39",0,3,29,10,1,5,1037857,"2023-11-30T00:00:00.000Z",6,FALSE,25,38017690,"G",25,25,"Portland Trail Blazers","Shaedon Sharpe",1,39,44,34,15,46.5
7,1,1,3,1,7,3,4,4,"31",2,0,11,3,2,5,1037857,"2023-11-30T00:00:00.000Z",6,FALSE,25,65,"G",25,25,"Portland Trail Blazers","Malcolm Brogdon",3,14,21,18,10,29.1
0,0,0,0,0,0,0,0,0,"00",0,0,0,0,0,0,1037857,"2023-11-30T00:00:00.000Z",6,FALSE,25,666476,"C",25,25,"Portland Trail Blazers","Moses Brown",0,0,0,0,0,0
7,0,1,5,0,8,1,0,0,"22",0,2,2,1,0,3,1037857,"2023-11-30T00:00:00.000Z",6,FALSE,25,56677747,"G",25,25,"Portland Trail Blazers","Scoot Henderson",0,3,10,9,8,10.7
0,0,0,0,0,0,0,0,0,"00",0,0,0,0,0,0,1037857,"2023-11-30T00:00:00.000Z",6,FALSE,25,3547289,"G",25,25,"Portland Trail Blazers","Skylar Mays",0,0,0,0,0,0
0,0,0,0,0,0,0,0,0,"00",0,0,0,0,0,0,1037857,"2023-11-30T00:00:00.000Z",6,FALSE,25,56677791,"F",25,25,"Portland Trail Blazers","Kris Murray",0,0,0,0,0,0
2,1,1,4,3,5,4,2,2,"18",1,2,13,2,1,1,1037857,"2023-11-30T00:00:00.000Z",6,FALSE,25,56783340,"C",25,25,"Portland Trail Blazers","Duop Reath",2,15,17,15,4,23.4
0,0,1,5,2,8,4,0,0,"24",1,1,10,2,1,0,1037857,"2023-11-30T00:00:00.000Z",6,FALSE,25,666923,"G-F",25,25,"Portland Trail Blazers","Matisse Thybulle",1,12,12,10,2,15.4
1,0,10,2,0,7,3,0,0,"24",2,3,6,12,1,1,1037857,"2023-11-30T00:00:00.000Z",6,FALSE,25,38017711,"F",25,25,"Portland Trail Blazers","Jabari Walker",1,18,19,7,13,23.9
0,0,0,0,0,0,0,0,0,"00",0,0,0,0,0,0,1037857,"2023-11-30T00:00:00.000Z",6,FALSE,25,39613724,"C",25,25,"Portland Trail Blazers","Ibou Badji",0,0,0,0,0,0
0,0,0,0,0,0,0,0,0,"00",0,0,0,0,0,0,1037857,"2023-11-30T00:00:00.000Z",6,FALSE,25,47957121,"F",25,25,"Portland Trail Blazers","Justin Minaya",0,0,0,0,0,0
0,0,0,0,0,0,0,0,0,"00",0,0,0,0,0,0,1037857,"2023-11-30T00:00:00.000Z",6,FALSE,25,56677829,"G-F",25,25,"Portland Trail Blazers","Rayan Rupert",0,0,0,0,0,0
0,0,0,0,0,0,0,0,0,"00",0,0,0,0,0,0,1037857,"2023-11-30T00:00:00.000Z",6,FALSE,25,419,"G",25,25,"Portland Trail Blazers","Anfernee Simons",0,0,0,0,0,0
2,0,0,9,3,18,6,0,0,"28",6,1,15,6,0,2,1037858,"2023-11-30T00:00:00.000Z",3,FALSE,4,666679,"F",3,3,"Brooklyn Nets","Cameron Johnson",0,21,23,17,8,23.2
1,1,3,6,4,7,5,0,0,"39",3,0,14,6,2,1,1037858,"2023-11-30T00:00:00.000Z",3,FALSE,4,158,"F",3,3,"Brooklyn Nets","Dorian Finney-Smith",3,20,21,15,7,30.7
2,2,5,0,0,13,9,2,2,"30",9,1,20,14,1,1,1037858,"2023-11-30T00:00:00.000Z",3,FALSE,4,666508,"F-C",3,3,"Brooklyn Nets","Nicolas Claxton",3,34,36,22,16,47.8
4,0,9,5,2,22,9,3,2,"38",0,1,22,9,1,2,1037858,"2023-11-30T00:00:00.000Z",3,FALSE,4,61,"F",3,3,"Brooklyn Nets","Mikal Bridges",1,31,35,26,13,39.8
8,0,4,6,1,9,3,2,2,"34",0,1,9,4,0,1,1037858,"2023-11-30T00:00:00.000Z",3,FALSE,4,130,"G",3,3,"Brooklyn Nets","Spencer Dinwiddie",0,13,21,17,12,24.8
0,0,0,0,0,0,0,0,0,"00",0,0,0,0,0,0,1037858,"2023-11-30T00:00:00.000Z",3,FALSE,4,174,"F-C",3,3,"Brooklyn Nets","Harry Giles III",0,0,0,0,0,0
0,0,0,0,0,0,0,0,0,"00",0,0,0,0,0,0,1037858,"2023-11-30T00:00:00.000Z",3,FALSE,4,351,"F",3,3,"Brooklyn Nets","Royce O'Neale",0,0,0,0,0,0
0,0,3,0,0,5,4,3,1,"18",2,3,9,5,2,0,1037858,"2023-11-30T00:00:00.000Z",3,FALSE,4,17896038,"C",3,3,"Brooklyn Nets","Day'Ron Sharpe",2,14,14,9,5,21
0,0,0,0,0,0,0,0,0,"00",0,0,0,0,0,0,1037858,"2023-11-30T00:00:00.000Z",3,FALSE,4,421,"G",3,3,"Brooklyn Nets","Dennis Smith Jr.",0,0,0,0,0,0
1,1,2,5,2,21,11,3,2,"25",0,1,26,2,0,1,1037858,"2023-11-30T00:00:00.000Z",3,FALSE,4,17896048,"G",3,3,"Brooklyn Nets","Cam Thomas",1,28,29,27,3,31.9
1,0,1,4,2,5,2,2,1,"14",1,1,7,2,0,1,1037858,"2023-11-30T00:00:00.000Z",3,FALSE,4,464,"G",3,3,"Brooklyn Nets","Lonnie Walker IV",0,9,10,8,3,9.9
2,0,3,1,0,5,3,0,0,"14",1,2,6,4,0,0,1037858,"2023-11-30T00:00:00.000Z",3,FALSE,4,17896058,"F",3,3,"Brooklyn Nets","Trendon Watford",0,10,12,8,6,13.8
0,0,0,0,0,0,0,0,0,"00",0,0,0,0,0,0,1037858,"2023-11-30T00:00:00.000Z",3,FALSE,4,9051997,"G",3,3,"Brooklyn Nets","Armoni Brooks",0,0,0,0,0,0
0,0,0,0,0,0,0,0,0,"00",0,0,0,0,0,0,1037858,"2023-11-30T00:00:00.000Z",3,FALSE,4,56677843,"F",3,3,"Brooklyn Nets","Noah Clowney",0,0,0,0,0,0
0,0,0,0,0,0,0,0,0,"00",0,0,0,0,0,0,1037858,"2023-11-30T00:00:00.000Z",3,FALSE,4,17896041,"G",3,3,"Brooklyn Nets","Keon Johnson",0,0,0,0,0,0
0,0,0,0,0,0,0,0,0,"00",0,0,0,0,0,0,1037858,"2023-11-30T00:00:00.000Z",3,FALSE,4,417,"G-F",3,3,"Brooklyn Nets","Ben Simmons",0,0,0,0,0,0
0,0,0,0,0,0,0,0,0,"00",0,0,0,0,0,0,1037858,"2023-11-30T00:00:00.000Z",3,FALSE,4,56677841,"F",3,3,"Brooklyn Nets","Dariq Whitehead",0,0,0,0,0,0
0,0,0,0,0,0,0,0,0,"00",0,0,0,0,0,0,1037858,"2023-11-30T00:00:00.000Z",3,FALSE,4,56677722,"F",3,3,"Brooklyn Nets","Jalen Wilson",0,0,0,0,0,0
6,0,4,4,2,14,8,4,4,"32",2,1,22,6,0,2,1037858,"2023-11-30T00:00:00.000Z",3,FALSE,4,204,"F",4,4,"Charlotte Hornets","Gordon Hayward",0,28,34,28,12,36.2
2,0,4,4,3,15,9,2,2,"38",1,2,23,5,0,0,1037858,"2023-11-30T00:00:00.000Z",3,FALSE,4,62,"F",4,4,"Charlotte Hornets","Miles Bridges",0,28,30,25,7,32
1,3,7,0,0,12,5,2,2,"32",5,2,12,12,1,0,1037858,"2023-11-30T00:00:00.000Z",3,FALSE,4,38017698,"C",4,4,"Charlotte Hornets","Mark Williams",4,24,25,13,13,39.9
3,1,2,5,4,7,5,0,0,"22",0,1,14,2,0,0,1037858,"2023-11-30T00:00:00.000Z",3,FALSE,4,38017708,"G",4,4,"Charlotte Hornets","Bryce McGowens",1,16,19,17,5,23.9
13,0,4,9,7,25,13,4,4,"40",0,1,37,4,2,3,1037858,"2023-11-30T00:00:00.000Z",3,FALSE,4,403,"G",4,4,"Charlotte Hornets","Terry Rozier",2,41,54,50,17,64.3
0,0,0,0,0,0,0,0,0,"00",0,0,0,0,0,0,1037858,"2023-11-30T00:00:00.000Z",3,FALSE,4,56677866,"F",4,4,"Charlotte Hornets","Leaky Black",0,0,0,0,0,0
0,0,0,0,0,0,0,0,0,"00",0,0,0,0,0,0,1037858,"2023-11-30T00:00:00.000Z",3,FALSE,4,17896037,"G",4,4,"Charlotte Hornets","James Bouknight",0,0,0,0,0,0
0,0,0,0,0,0,0,0,0,"00",0,0,0,0,0,0,1037858,"2023-11-30T00:00:00.000Z",3,FALSE,4,3547253,"G",4,4,"Charlotte Hornets","Theo Maledon",0,0,0,0,0,0
0,0,0,0,0,0,0,0,0,"00",0,0,0,0,0,0,1037858,"2023-11-30T00:00:00.000Z",3,FALSE,4,56677823,"F",4,4,"Charlotte Hornets","Brandon Miller",0,0,0,0,0,0
0,0,0,0,0,0,0,0,0,"13",1,4,0,1,0,2,1037858,"2023-11-30T00:00:00.000Z",3,FALSE,4,422,"G",4,4,"Charlotte Hornets","Ish Smith",0,1,1,0,1,-0.8
0,1,0,3,3,4,3,0,0,"14",1,2,9,1,0,0,1037858,"2023-11-30T00:00:00.000Z",3,FALSE,4,56677846,"G",4,4,"Charlotte Hornets","Nick Smith Jr.",1,10,10,9,1,13.2
0,0,1,2,0,3,1,0,0,"16",1,1,2,2,0,0,1037858,"2023-11-30T00:00:00.000Z",3,FALSE,4,18678001,"F",4,4,"Charlotte Hornets","JT Thor",0,4,4,2,2,4.4
5,2,6,9,2,11,2,4,4,"33",2,2,10,8,3,2,1037858,"2023-11-30T00:00:00.000Z",3,FALSE,4,666950,"F",4,4,"Charlotte Hornets","P.J. Washington",5,18,23,15,13,40.1
0,0,0,0,0,0,0,0,0,"00",0,0,0,0,0,0,1037858,"2023-11-30T00:00:00.000Z",3,FALSE,4,56677848,"G",4,4,"Charlotte Hornets","Amari Bailey",0,0,0,0,0,0
0,0,0,0,0,0,0,0,0,"00",0,0,0,0,0,0,1037858,"2023-11-30T00:00:00.000Z",3,FALSE,4,3547239,"G",4,4,"Charlotte Hornets","LaMelo Ball",0,0,0,0,0,0
0,0,0,0,0,0,0,0,0,"00",0,0,0,0,0,0,1037858,"2023-11-30T00:00:00.000Z",3,FALSE,4,666748,"F",4,4,"Charlotte Hornets","Cody Martin",0,0,0,0,0,0
0,0,0,0,0,0,0,0,0,"00",0,0,0,0,0,0,1037858,"2023-11-30T00:00:00.000Z",3,FALSE,4,347,"G",4,4,"Charlotte Hornets","Frank Ntilikina",0,0,0,0,0,0
0,0,0,0,0,0,0,0,0,"00",0,0,0,0,0,0,1037858,"2023-11-30T00:00:00.000Z",3,FALSE,4,3547282,"C",4,4,"Charlotte Hornets","Nick Richards",0,0,0,0,0,0
3,0,7,1,0,18,9,20,18,"38",3,1,36,10,0,3,1037859,"2023-11-30T00:00:00.000Z",16,FALSE,12,79,"G-F",16,16,"Miami Heat","Jimmy Butler",0,46,49,39,13,49.5
1,0,1,1,0,2,1,0,0,"15",0,4,2,1,0,1,1037859,"2023-11-30T00:00:00.000Z",16,FALSE,12,3092,"",16,16,"Miami Heat","Haywood Highsmith",0,3,4,3,2,3.7
2,0,4,0,0,9,3,2,1,"12",0,1,7,4,0,0,1037859,"2023-11-30T00:00:00.000Z",16,FALSE,12,4,"C-F",16,16,"Miami Heat","Bam Adebayo",0,11,13,9,6,14.8
2,0,1,6,4,9,5,2,2,"29",0,3,16,1,1,1,1037859,"2023-11-30T00:00:00.000Z",16,FALSE,12,397,"F",16,16,"Miami Heat","Duncan Robinson",1,17,19,18,3,22.2
3,1,2,6,3,10,6,0,0,"26",1,5,15,3,0,0,1037859,"2023-11-30T00:00:00.000Z",16,FALSE,12,286,"G",16,16,"Miami Heat","Kyle Lowry",1,18,21,18,6,26.1
1,0,5,3,1,13,8,7,7,"33",0,3,24,5,1,3,1037859,"2023-11-30T00:00:00.000Z",16,FALSE,12,56677785,"G",16,16,"Miami Heat","Jaime Jaquez Jr.",1,29,30,25,6,31.5
6,0,7,0,0,1,1,4,3,"17",1,2,5,8,1,0,1037859,"2023-11-30T00:00:00.000Z",16,FALSE,12,285,"F-C",16,16,"Miami Heat","Kevin Love",1,13,19,11,14,26.6
3,0,3,2,0,11,8,4,3,"32",1,3,19,4,0,2,1037859,"2023-11-30T00:00:00.000Z",16,FALSE,12,391,"G-F",16,16,"Miami Heat","Josh Richardson",0,23,26,22,7,26.3
2,1,5,5,0,14,5,5,3,"29",4,3,13,9,0,0,1037859,"2023-11-30T00:00:00.000Z",16,FALSE,12,452,"C-F",12,12,"Indiana Pacers","Myles Turner",1,22,24,15,11,29.8
3,0,5,2,0,9,5,7,5,"32",1,1,15,6,0,0,1037859,"2023-11-30T00:00:00.000Z",16,FALSE,12,69,"G",12,12,"Indiana Pacers","Bruce Brown",0,21,24,18,9,26.7
10,1,2,16,6,28,15,12,8,"40",0,0,44,2,3,2,1037859,"2023-11-30T00:00:00.000Z",16,FALSE,12,3547245,"G",12,12,"Indiana Pacers","Tyrese Haliburton",4,46,56,54,12,71.4
1,0,1,0,0,0,0,0,0,"06",0,3,0,1,1,0,1037859,"2023-11-30T00:00:00.000Z",16,FALSE,12,17896035,"F",12,12,"Indiana Pacers","Isaiah Jackson",1,1,2,1,2,5.7
0,0,3,0,0,7,5,2,2,"23",0,1,12,3,0,1,1037859,"2023-11-30T00:00:00.000Z",16,FALSE,12,38017686,"G-F",12,12,"Indiana Pacers","Bennedict Mathurin",0,15,15,12,3,14.6
0,0,0,0,0,0,0,0,0,"00",0,0,0,0,0,0,1037859,"2023-11-30T00:00:00.000Z",16,FALSE,12,304,"G",12,12,"Indiana Pacers","T.J. McConnell",0,0,0,0,0,0
5,0,1,1,0,4,1,0,0,"22",0,6,2,1,2,2,1037859,"2023-11-30T00:00:00.000Z",16,FALSE,12,38017507,"G-F",12,12,"Indiana Pacers","Andrew Nembhard",2,3,8,7,6,14.7
1,0,2,1,0,5,4,1,1,"22",3,6,9,5,4,1,1037859,"2023-11-30T00:00:00.000Z",16,FALSE,12,3547250,"G-F",12,12,"Indiana Pacers","Aaron Nesmith",4,14,15,10,6,27.5
0,0,0,0,0,0,0,0,0,"01",0,0,0,0,0,0,1037859,"2023-11-30T00:00:00.000Z",16,FALSE,12,56677861,"G",12,12,"Indiana Pacers","Ben Sheppard",0,0,0,0,0,0
0,0,0,0,0,0,0,0,0,"00",0,0,0,0,0,0,1037859,"2023-11-30T00:00:00.000Z",16,FALSE,12,56677778,"F-C",12,12,"Indiana Pacers","Oscar Tshiebwe",0,0,0,0,0,0
0,0,0,0,0,0,0,0,0,"01",0,0,0,0,0,0,1037859,"2023-11-30T00:00:00.000Z",16,FALSE,12,56677832,"F",12,12,"Indiana Pacers","Jarace Walker",0,0,0,0,0,0
0,0,0,0,0,0,0,0,0,"00",0,0,0,0,0,0,1037859,"2023-11-30T00:00:00.000Z",16,FALSE,12,38017701,"G",12,12,"Indiana Pacers","Kendall Brown",0,0,0,0,0,0
0,0,0,0,0,0,0,0,0,"00",0,0,0,0,0,0,1037859,"2023-11-30T00:00:00.000Z",16,FALSE,12,3547264,"F-C",12,12,"Indiana Pacers","Jalen Smith",0,0,0,0,0,0
0,0,0,0,0,0,0,0,0,"00",0,0,0,0,0,0,1037859,"2023-11-30T00:00:00.000Z",16,FALSE,12,56677794,"G",12,12,"Indiana Pacers","Isaiah Wong",0,0,0,0,0,0
0,0,2,0,0,2,1,0,0,"07",0,1,2,2,0,0,1037859,"2023-11-30T00:00:00.000Z",16,FALSE,12,39398582,"C",16,16,"Miami Heat","Orlando Robinson",0,4,4,2,2,4.4
0,0,0,0,0,0,0,0,0,"00",0,0,0,0,0,0,1037859,"2023-11-30T00:00:00.000Z",16,FALSE,12,38017734,"F",16,16,"Miami Heat","Jamal Cain",0,0,0,0,0,0
0,0,0,0,0,0,0,0,0,"00",0,0,0,0,0,0,1037859,"2023-11-30T00:00:00.000Z",16,FALSE,12,3547257,"G",16,16,"Miami Heat","R.J. Hampton",0,0,0,0,0,0
0,0,0,0,0,0,0,0,0,"00",0,0,0,0,0,0,1037859,"2023-11-30T00:00:00.000Z",16,FALSE,12,666633,"G",16,16,"Miami Heat","Tyler Herro",0,0,0,0,0,0
0,0,0,0,0,0,0,0,0,"00",0,0,0,0,0,0,1037859,"2023-11-30T00:00:00.000Z",16,FALSE,12,19465585,"G",16,16,"Miami Heat","Dru Smith",0,0,0,0,0,0
0,0,0,0,0,0,0,0,0,"00",0,0,0,0,0,0,1037859,"2023-11-30T00:00:00.000Z",16,FALSE,12,38017736,"F",16,16,"Miami Heat","Cole Swider",0,0,0,0,0,0
5,2,4,11,2,16,5,0,0,"31",1,6,12,5,1,1,1037859,"2023-11-30T00:00:00.000Z",16,FALSE,12,210,"G",12,12,"Indiana Pacers","Buddy Hield",3,17,22,17,10,33.5
3,1,1,7,3,15,10,5,2,"33",1,5,25,2,0,2,1037859,"2023-11-30T00:00:00.000Z",16,FALSE,12,3547243,"F",12,12,"Indiana Pacers","Obi Toppin",1,27,30,28,5,32.9
3,0,3,2,0,9,5,6,4,"25",2,4,14,5,1,4,1037859,"2023-11-30T00:00:00.000Z",16,FALSE,12,666747,"F",16,16,"Miami Heat","Caleb Martin",1,19,22,17,8,23.5
1,0,3,0,0,1,1,0,0,"06",1,1,2,4,0,0,1037859,"2023-11-30T00:00:00.000Z",16,FALSE,12,74,"C",16,16,"Miami Heat","Thomas Bryant",0,6,7,3,5,8.3
0,0,0,0,0,0,0,0,0,"00",0,0,0,0,0,0,1037859,"2023-11-30T00:00:00.000Z",16,FALSE,12,38017696,"F",16,16,"Miami Heat","Nikola Jovic",0,0,0,0,0,0
0,0,0,0,0,0,0,0,0,"00",0,0,0,0,0,0,1037859,"2023-11-30T00:00:00.000Z",16,FALSE,12,3547207,"F",12,12,"Indiana Pacers","Jordan Nwora",0,0,0,0,0,0
2,0,1,6,1,12,5,6,4,"24",0,2,15,1,0,2,1037860,"2023-11-30T00:00:00.000Z",20,FALSE,9,666423,"F-G",20,20,"New York Knicks","RJ Barrett",0,16,18,17,3,17.2
8,1,8,5,2,21,12,6,3,"38",2,3,29,10,0,3,1037860,"2023-11-30T00:00:00.000Z",20,FALSE,9,387,"F",20,20,"New York Knicks","Julius Randle",1,39,47,37,18,53
1,1,3,0,0,4,2,2,2,"31",6,2,6,9,1,1,1037860,"2023-11-30T00:00:00.000Z",20,FALSE,9,399,"C",20,20,"New York Knicks","Mitchell Robinson",2,15,16,7,10,23.3
8,0,4,12,7,24,13,10,9,"40",2,3,42,6,1,1,1037860,"2023-11-30T00:00:00.000Z",20,FALSE,9,73,"G",20,20,"New York Knicks","Jalen Brunson",1,48,56,50,14,63.2
0,0,1,3,0,5,0,0,0,"16",0,1,0,1,2,0,1037860,"2023-11-30T00:00:00.000Z",20,FALSE,9,17895858,"G",20,20,"New York Knicks","Quentin Grimes",2,1,1,0,1,7.2
0,0,0,0,0,0,0,0,0,"00",0,0,0,0,0,0,1037860,"2023-11-30T00:00:00.000Z",20,FALSE,9,19,"G",20,20,"New York Knicks","Ryan Arcidiacono",0,0,0,0,0,0
2,1,3,8,4,8,4,0,0,"23",0,1,12,3,0,0,1037860,"2023-11-30T00:00:00.000Z",20,FALSE,9,131,"G",20,20,"New York Knicks","Donte DiVincenzo",1,15,17,14,5,21.6
0,0,0,0,0,0,0,0,0,"00",0,0,0,0,0,0,1037860,"2023-11-30T00:00:00.000Z",20,FALSE,9,160,"G-F",20,20,"New York Knicks","Evan Fournier",0,0,0,0,0,0
2,0,7,2,1,3,2,4,2,"32",0,2,7,7,1,1,1037860,"2023-11-30T00:00:00.000Z",20,FALSE,9,202,"G",20,20,"New York Knicks","Josh Hart",1,14,16,9,9,20.4
0,0,1,0,0,1,1,0,0,"17",2,3,2,3,3,2,1037860,"2023-11-30T00:00:00.000Z",20,FALSE,9,201,"F-C",20,20,"New York Knicks","Isaiah Hartenstein",3,5,5,2,3,12.6
0,0,0,0,0,0,0,0,0,"00",0,0,0,0,0,0,1037860,"2023-11-30T00:00:00.000Z",20,FALSE,9,666675,"F",20,20,"New York Knicks","DaQuan Jeffries",0,0,0,0,0,0
0,0,0,0,0,0,0,0,0,"00",0,0,0,0,0,0,1037860,"2023-11-30T00:00:00.000Z",20,FALSE,9,17896033,"G",20,20,"New York Knicks","Miles McBride",0,0,0,0,0,0
2,0,1,5,1,10,2,0,0,"19",0,0,5,1,0,1,1037860,"2023-11-30T00:00:00.000Z",20,FALSE,9,3547269,"G",20,20,"New York Knicks","Immanuel Quickley",0,6,8,7,3,8.2
0,0,0,0,0,0,0,0,0,"00",0,0,0,0,0,0,1037860,"2023-11-30T00:00:00.000Z",20,FALSE,9,17896063,"F",20,20,"New York Knicks","Jericho Sims",0,0,0,0,0,0
0,0,0,0,0,0,0,0,0,"00",0,0,0,0,0,0,1037860,"2023-11-30T00:00:00.000Z",20,FALSE,9,666474,"G",20,20,"New York Knicks","Charles Brown",0,0,0,0,0,0
0,0,0,0,0,0,0,0,0,"00",0,0,0,0,0,0,1037860,"2023-11-30T00:00:00.000Z",20,FALSE,9,59421201,"G",20,20,"New York Knicks","Jaylen Martin",0,0,0,0,0,0
0,0,0,0,0,0,0,0,0,"00",0,0,0,0,0,0,1037860,"2023-11-30T00:00:00.000Z",20,FALSE,9,56677795,"F",20,20,"New York Knicks","Jacob Toppin",0,0,0,0,0,0
0,0,0,0,0,0,0,0,0,"00",0,0,0,0,0,0,1037860,"2023-11-30T00:00:00.000Z",20,FALSE,9,666971,"G-F",20,20,"New York Knicks","Dylan Windler",0,0,0,0,0,0
1,0,2,5,1,8,2,3,1,"27",2,2,6,4,0,2,1037860,"2023-11-30T00:00:00.000Z",20,FALSE,9,17896071,"F",9,9,"Detroit Pistons","Isaiah Livers",0,10,11,7,5,10.3
0,0,5,4,1,6,2,0,0,"32",2,2,5,7,0,2,1037860,"2023-11-30T00:00:00.000Z",20,FALSE,9,3547267,"F-C",9,9,"Detroit Pistons","Isaiah Stewart",0,12,12,5,7,11.4
2,0,12,0,0,7,5,0,0,"34",0,3,10,12,0,2,1037860,"2023-11-30T00:00:00.000Z",20,FALSE,9,38017694,"C",9,9,"Detroit Pistons","Jalen Duren",0,22,24,12,14,25.4
8,0,2,9,4,20,12,4,3,"37",0,2,31,2,2,7,1037860,"2023-11-30T00:00:00.000Z",20,FALSE,9,17896075,"G-F",9,9,"Detroit Pistons","Cade Cunningham",2,33,41,39,10,44.4
4,1,3,3,2,13,10,4,1,"28",0,3,23,3,1,0,1037860,"2023-11-30T00:00:00.000Z",20,FALSE,9,3547241,"G",9,9,"Detroit Pistons","Killian Hayes",2,26,30,27,7,38.6
1,1,0,0,0,6,3,2,2,"14",3,1,8,3,0,1,1037860,"2023-11-30T00:00:00.000Z",20,FALSE,9,24,"F",9,9,"Detroit Pistons","Marvin Bagley III",1,11,12,9,4,15.1
1,0,0,3,0,3,0,1,1,"11",0,0,1,0,0,0,1037860,"2023-11-30T00:00:00.000Z",20,FALSE,9,77,"G",9,9,"Detroit Pistons","Alec Burks",0,1,2,2,1,2.5
1,1,2,1,1,2,1,2,2,"13",0,3,5,2,0,1,1037860,"2023-11-30T00:00:00.000Z",20,FALSE,9,38017682,"G",9,9,"Detroit Pistons","Jaden Ivey",1,7,8,6,3,10.9
0,0,0,2,0,3,1,1,1,"09",0,1,3,0,0,2,1037860,"2023-11-30T00:00:00.000Z",20,FALSE,9,259,"F",9,9,"Detroit Pistons","Kevin Knox",0,3,3,3,0,1
4,0,2,7,5,11,6,0,0,"20",0,3,17,2,1,0,1037860,"2023-11-30T00:00:00.000Z",20,FALSE,9,56677792,"G",9,9,"Detroit Pistons","Marcus Sasser",1,19,23,21,6,28.4
0,0,6,1,1,2,1,0,0,"13",1,5,3,7,0,3,1037860,"2023-11-30T00:00:00.000Z",20,FALSE,9,56677826,"G-F",9,9,"Detroit Pistons","Ausar Thompson",0,10,10,3,7,8.4
0,0,0,0,0,0,0,0,0,"00",0,0,0,0,0,0,1037860,"2023-11-30T00:00:00.000Z",20,FALSE,9,330,"G",9,9,"Detroit Pistons","Monte Morris",0,0,0,0,0,0
0,0,0,0,0,0,0,0,0,"00",0,0,0,0,0,0,1037860,"2023-11-30T00:00:00.000Z",20,FALSE,9,42097199,"G",9,9,"Detroit Pistons","Jared Rhoden",0,0,0,0,0,0
0,0,0,0,0,0,0,0,0,"00",0,0,0,0,0,0,1037860,"2023-11-30T00:00:00.000Z",20,FALSE,9,54,"F",9,9,"Detroit Pistons","Bojan Bogdanovic",0,0,0,0,0,0
0,0,0,0,0,0,0,0,0,"00",0,0,0,0,0,0,1037860,"2023-11-30T00:00:00.000Z",20,FALSE,9,56677729,"G",9,9,"Detroit Pistons","Malcolm Cazalon",0,0,0,0,0,0
0,0,0,0,0,0,0,0,0,"00",0,0,0,0,0,0,1037860,"2023-11-30T00:00:00.000Z",20,FALSE,9,197,"F-G",9,9,"Detroit Pistons","Joe Harris",0,0,0,0,0,0
0,0,0,0,0,0,0,0,0,"02",0,0,0,0,0,0,1037860,"2023-11-30T00:00:00.000Z",20,FALSE,9,44477024,"G",9,9,"Detroit Pistons","Stanley Umude",0,0,0,0,0,0
0,0,0,0,0,0,0,0,0,"00",0,0,0,0,0,0,1037860,"2023-11-30T00:00:00.000Z",20,FALSE,9,3547240,"C",9,9,"Detroit Pistons","James Wiseman",0,0,0,0,0,0
1,1,1,4,0,14,6,0,0,"36",1,1,12,2,2,1,1037861,"2023-11-30T00:00:00.000Z",5,FALSE,17,3547248,"F",5,5,"Chicago Bulls","Patrick Williams",3,14,15,13,3,23.9
5,1,1,5,3,9,4,0,0,"29",0,1,11,1,2,7,1037861,"2023-11-30T00:00:00.000Z",5,FALSE,17,89,"G",5,5,"Chicago Bulls","Alex Caruso",3,12,17,16,6,21.7
6,0,9,4,2,21,11,6,5,"40",1,2,29,10,1,4,1037861,"2023-11-30T00:00:00.000Z",5,FALSE,17,460,"C",5,5,"Chicago Bulls","Nikola Vucevic",1,39,45,35,16,49
6,0,5,3,1,8,6,2,1,"39",1,2,14,6,3,2,1037861,"2023-11-30T00:00:00.000Z",5,FALSE,17,17895983,"G",5,5,"Chicago Bulls","Ayo Dosunmu",3,20,26,20,12,37.2
7,1,4,11,4,20,7,6,5,"45",0,3,23,4,1,3,1037861,"2023-11-30T00:00:00.000Z",5,FALSE,17,666956,"G",5,5,"Chicago Bulls","Coby White",2,27,34,30,11,41.3
0,0,0,0,0,0,0,0,0,"00",0,0,0,0,0,0,1037861,"2023-11-30T00:00:00.000Z",5,FALSE,17,56677874,"F",5,5,"Chicago Bulls","Onuralp Bitim",0,0,0,0,0,0
1,0,1,2,1,10,5,0,0,"18",1,1,11,2,3,0,1037861,"2023-11-30T00:00:00.000Z",5,FALSE,17,87,"G",5,5,"Chicago Bulls","Jevon Carter",3,13,14,12,3,23.9
2,1,5,6,2,10,4,0,0,"27",3,4,10,8,1,2,1037861,"2023-11-30T00:00:00.000Z",5,FALSE,17,110,"F",5,5,"Chicago Bulls","Torrey Craig",2,18,20,12,10,26.6
1,0,9,0,0,2,2,8,6,"13",5,1,10,14,1,2,1037861,"2023-11-30T00:00:00.000Z",5,FALSE,17,137,"C",5,5,"Chicago Bulls","Andre Drummond",1,24,25,11,15,29.3
3,0,2,2,0,3,0,0,0,"14",1,3,0,3,0,0,1037861,"2023-11-30T00:00:00.000Z",5,FALSE,17,56677857,"F",5,5,"Chicago Bulls","Julian Phillips",0,3,6,3,6,8.1
0,0,0,0,0,0,0,0,0,"00",0,0,0,0,0,0,1037861,"2023-11-30T00:00:00.000Z",5,FALSE,17,56677860,"F",5,5,"Chicago Bulls","Adama Sanogo",0,0,0,0,0,0
0,0,0,0,0,0,0,0,0,"00",0,0,0,0,0,0,1037861,"2023-11-30T00:00:00.000Z",5,FALSE,17,17896116,"G",5,5,"Chicago Bulls","Terry Taylor",0,0,0,0,0,0
0,0,0,0,0,1,0,0,0,"04",1,0,0,1,0,0,1037861,"2023-11-30T00:00:00.000Z",5,FALSE,17,38017719,"F",5,5,"Chicago Bulls","Dalen Terry",0,1,1,0,1,1.2
0,0,0,0,0,0,0,0,0,"00",0,0,0,0,0,0,1037861,"2023-11-30T00:00:00.000Z",5,FALSE,17,27,"G",5,5,"Chicago Bulls","Lonzo Ball",0,0,0,0,0,0
0,0,0,0,0,0,0,0,0,"00",0,0,0,0,0,0,1037861,"2023-11-30T00:00:00.000Z",5,FALSE,17,125,"G",5,5,"Chicago Bulls","DeMar DeRozan",0,0,0,0,0,0
0,0,0,0,0,0,0,0,0,"00",0,0,0,0,0,0,1037861,"2023-11-30T00:00:00.000Z",5,FALSE,17,268,"G",5,5,"Chicago Bulls","Zach LaVine",0,0,0,0,0,0
0,0,0,0,0,0,0,0,0,"00",0,0,0,0,0,0,1037861,"2023-11-30T00:00:00.000Z",5,FALSE,17,45969255,"F",5,5,"Chicago Bulls","Justin Lewis",0,0,0,0,0,0
0,0,0,0,0,0,0,0,0,"00",0,0,0,0,0,0,1037861,"2023-11-30T00:00:00.000Z",5,FALSE,17,2148,"",17,17,"Milwaukee Bucks","Thanasis Antetokounmpo",0,0,0,0,0,0
0,0,3,4,1,7,3,0,0,"22",0,1,7,3,0,2,1037861,"2023-11-30T00:00:00.000Z",5,FALSE,17,38017676,"F",17,17,"Milwaukee Bucks","MarJon Beauchamp",0,10,10,7,3,8.6
0,0,0,0,0,0,0,0,0,"00",0,0,0,0,0,0,1037861,"2023-11-30T00:00:00.000Z",5,FALSE,17,38017733,"G",17,17,"Milwaukee Bucks","A.J. Green",0,0,0,0,0,0
0,0,0,0,0,0,0,0,0,"00",0,0,0,0,0,0,1037861,"2023-11-30T00:00:00.000Z",5,FALSE,17,284,"C",17,17,"Milwaukee Bucks","Robin Lopez",0,0,0,0,0,0
2,0,8,2,0,8,2,0,0,"31",1,3,4,9,2,0,1037861,"2023-11-30T00:00:00.000Z",5,FALSE,17,377,"F",17,17,"Milwaukee Bucks","Bobby Portis",2,13,15,6,11,23.8
0,0,0,0,0,0,0,0,0,"00",0,0,0,0,0,0,1037861,"2023-11-30T00:00:00.000Z",5,FALSE,17,666453,"C",17,17,"Milwaukee Bucks","Marques Bolden",0,0,0,0,0,0
0,0,0,0,0,0,0,0,0,"00",0,0,0,0,0,0,1037861,"2023-11-30T00:00:00.000Z",5,FALSE,17,105,"G",17,17,"Milwaukee Bucks","Pat Connaughton",0,0,0,0,0,0
0,0,0,0,0,0,0,0,0,"00",0,0,0,0,0,0,1037861,"2023-11-30T00:00:00.000Z",5,FALSE,17,112,"F",17,17,"Milwaukee Bucks","Jae Crowder",0,0,0,0,0,0
0,0,0,0,0,0,0,0,0,"00",0,0,0,0,0,0,1037861,"2023-11-30T00:00:00.000Z",5,FALSE,17,56677854,"F",17,17,"Milwaukee Bucks","Chris Livingston",0,0,0,0,0,0
0,0,0,0,0,0,0,0,0,"00",0,0,0,0,0,0,1037861,"2023-11-30T00:00:00.000Z",5,FALSE,17,38017691,"G",17,17,"Milwaukee Bucks","TyTy Washington Jr.",0,0,0,0,0,0
3,0,3,4,1,10,3,5,2,"27",0,3,9,3,2,3,1037861,"2023-11-30T00:00:00.000Z",5,FALSE,17,315,"F",17,17,"Milwaukee Bucks","Khris Middleton",2,12,15,12,6,20.1
5,5,8,1,0,17,11,4,4,"39",6,5,26,14,2,5,1037861,"2023-11-30T00:00:00.000Z",5,FALSE,17,15,"F",17,17,"Milwaukee Bucks","Giannis Antetokounmpo",7,40,45,31,19,66.3
0,0,4,10,6,12,7,0,0,"39",0,5,20,4,0,1,1037861,"2023-11-30T00:00:00.000Z",5,FALSE,17,283,"C",17,17,"Milwaukee Bucks","Brook Lopez",0,24,24,20,4,23.8
3,0,3,15,5,19,7,0,0,"41",0,2,19,3,2,1,1037861,"2023-11-30T00:00:00.000Z",5,FALSE,17,38,"G",17,17,"Milwaukee Bucks","Malik Beasley",2,22,25,22,6,32.1
13,1,4,6,1,16,7,4,3,"43",1,1,18,5,2,7,1037861,"2023-11-30T00:00:00.000Z",5,FALSE,17,278,"G",17,17,"Milwaukee Bucks","Damian Lillard",3,23,36,31,18,45.5
1,0,0,1,0,3,2,0,0,"12",1,1,4,1,2,1,1037861,"2023-11-30T00:00:00.000Z",5,FALSE,17,56677852,"G",17,17,"Milwaukee Bucks","Andre Jackson Jr.",2,5,6,5,2,11.7
1,0,1,5,2,6,2,0,0,"11",0,0,6,1,0,0,1037861,"2023-11-30T00:00:00.000Z",5,FALSE,17,368,"G",17,17,"Milwaukee Bucks","Cameron Payne",0,7,8,7,2,8.7
0,0,0,0,0,0,0,0,0,"00",0,0,0,0,0,0,1037861,"2023-11-30T00:00:00.000Z",5,FALSE,17,666960,"G",17,17,"Milwaukee Bucks","Lindell Wigginton",0,0,0,0,0,0
7,2,3,8,4,16,8,0,0,"36",2,4,20,5,5,4,1037862,"2023-11-30T00:00:00.000Z",18,FALSE,29,666400,"G",18,18,"Minnesota Timberwolves","Nickeil Alexander-Walker",7,25,32,27,12,53.5
5,1,7,7,4,22,12,5,4,"37",4,3,32,11,2,4,1037862,"2023-11-30T00:00:00.000Z",18,FALSE,29,447,"C",18,18,"Minnesota Timberwolves","Karl-Anthony Towns",3,43,48,37,16,57.7
0,3,10,0,0,11,6,4,3,"38",3,4,15,13,0,0,1037862,"2023-11-30T00:00:00.000Z",18,FALSE,29,176,"C",18,18,"Minnesota Timberwolves","Rudy Gobert",3,28,28,15,13,39.6
2,0,3,3,2,6,3,0,0,"29",0,0,8,3,1,1,1037862,"2023-11-30T00:00:00.000Z",18,FALSE,29,68,"F",18,18,"Minnesota Timberwolves","Troy Brown Jr.",1,11,13,10,5,16.6
7,0,3,6,2,6,2,2,2,"29",0,3,8,3,2,2,1037862,"2023-11-30T00:00:00.000Z",18,FALSE,29,104,"G",18,18,"Minnesota Timberwolves","Mike Conley",2,11,18,15,10,26.1
6,0,1,1,0,7,2,0,0,"19",0,0,4,1,0,0,1037862,"2023-11-30T00:00:00.000Z",18,FALSE,29,12,"F",18,18,"Minnesota Timberwolves","Kyle Anderson",0,5,11,10,7,14.2
0,1,2,4,0,9,3,0,0,"22",1,2,6,3,1,0,1037862,"2023-11-30T00:00:00.000Z",18,FALSE,29,667378,"F-C",18,18,"Minnesota Timberwolves","Naz Reid",2,9,9,6,3,15.6
4,0,3,2,1,8,4,5,5,"23",0,1,14,3,0,3,1037862,"2023-11-30T00:00:00.000Z",18,FALSE,29,413,"G",29,29,"Utah Jazz","Collin Sexton",0,17,21,18,7,20.6
0,0,0,0,0,0,0,0,0,"00",0,0,0,0,0,0,1037862,"2023-11-30T00:00:00.000Z",18,FALSE,29,17896023,"G",29,29,"Utah Jazz","Josh Christopher",0,0,0,0,0,0
0,0,0,0,0,0,0,0,0,"00",0,0,0,0,0,0,1037862,"2023-11-30T00:00:00.000Z",18,FALSE,29,100,"G",29,29,"Utah Jazz","Jordan Clarkson",0,0,0,0,0,0
0,0,0,0,0,0,0,0,0,"00",0,0,0,0,0,0,1037862,"2023-11-30T00:00:00.000Z",18,FALSE,29,139,"G",29,29,"Utah Jazz","Kris Dunn",0,0,0,0,0,0
0,0,0,0,0,0,0,0,0,"00",0,0,0,0,0,0,1037862,"2023-11-30T00:00:00.000Z",18,FALSE,29,56677824,"F",29,29,"Utah Jazz","Taylor Hendricks",0,0,0,0,0,0
0,0,0,0,0,0,0,0,0,"00",0,0,0,0,0,0,1037862,"2023-11-30T00:00:00.000Z",18,FALSE,29,297,"F",29,29,"Utah Jazz","Lauri Markkanen",0,0,0,0,0,0
0,0,0,0,0,0,0,0,0,"00",0,0,0,0,0,0,1037862,"2023-11-30T00:00:00.000Z",18,FALSE,29,56677842,"F",29,29,"Utah Jazz","Brice Sensabaugh",0,0,0,0,0,0
0,1,6,1,0,4,1,0,0,"14",1,3,2,7,0,2,1037862,"2023-11-30T00:00:00.000Z",18,FALSE,29,11891374,"C",29,29,"Utah Jazz","Omer Yurtseven",1,9,9,2,7,11.4
3,0,3,6,3,10,5,0,0,"36",3,1,13,6,4,1,1037862,"2023-11-30T00:00:00.000Z",18,FALSE,29,38017620,"G",29,29,"Utah Jazz","Ochai Agbaji",4,19,22,16,9,35.7
4,0,3,6,1,19,4,3,3,"33",1,2,12,4,0,2,1037862,"2023-11-30T00:00:00.000Z",18,FALSE,29,56677834,"G",29,29,"Utah Jazz","Keyonte George",0,16,20,16,8,20.8
1,0,1,3,1,7,3,0,0,"19",0,1,7,1,0,0,1037862,"2023-11-30T00:00:00.000Z",18,FALSE,29,666650,"G",29,29,"Utah Jazz","Talen Horton-Tucker",0,8,9,8,2,9.7
0,0,0,0,0,0,0,0,0,"00",0,0,0,0,0,0,1037862,"2023-11-30T00:00:00.000Z",18,FALSE,29,38017630,"G",29,29,"Utah Jazz","Johnny Juzang",0,0,0,0,0,0
2,3,5,2,0,6,3,2,1,"27",0,1,7,5,1,1,1037862,"2023-11-30T00:00:00.000Z",18,FALSE,29,38017705,"C",29,29,"Utah Jazz","Walker Kessler",4,12,14,9,7,27
3,0,3,2,2,5,3,0,0,"14",1,3,8,4,0,2,1037862,"2023-11-30T00:00:00.000Z",18,FALSE,29,358,"F",29,29,"Utah Jazz","Kelly Olynyk",0,12,15,11,7,15.3
0,0,0,0,0,0,0,0,0,"00",0,0,0,0,0,0,1037862,"2023-11-30T00:00:00.000Z",18,FALSE,29,19465584,"F",29,29,"Utah Jazz","Micah Potter",0,0,0,0,0,0
0,0,3,1,0,4,1,0,0,"12",1,0,2,4,0,2,1037862,"2023-11-30T00:00:00.000Z",18,FALSE,29,666881,"F",29,29,"Utah Jazz","Luka Samanic",0,6,6,2,4,4.8
0,0,0,0,0,0,0,0,0,"00",0,0,0,0,0,0,1037862,"2023-11-30T00:00:00.000Z",18,FALSE,29,666767,"G",18,18,"Minnesota Timberwolves","Jordan McLaughlin",0,0,0,0,0,0
0,0,0,0,0,0,0,0,0,"00",0,0,0,0,0,0,1037862,"2023-11-30T00:00:00.000Z",18,FALSE,29,56677782,"F",18,18,"Minnesota Timberwolves","Leonard Miller",0,0,0,0,0,0
5,0,2,7,2,12,6,2,2,"34",3,3,16,5,1,2,1037862,"2023-11-30T00:00:00.000Z",18,FALSE,29,38017739,"F",29,29,"Utah Jazz","Simone Fontecchio",1,21,26,21,10,30.5
0,0,9,4,1,12,3,2,2,"28",3,4,9,12,0,4,1037862,"2023-11-30T00:00:00.000Z",18,FALSE,29,101,"F-C",29,29,"Utah Jazz","John Collins",0,21,21,9,12,19.4
3,0,2,2,0,7,2,2,1,"20",0,0,5,2,2,0,1037862,"2023-11-30T00:00:00.000Z",18,FALSE,29,320,"G",18,18,"Minnesota Timberwolves","Shake Milton",2,7,10,8,5,17.9
0,0,0,0,0,0,0,0,0,"00",0,0,0,0,0,0,1037862,"2023-11-30T00:00:00.000Z",18,FALSE,29,17896056,"C",18,18,"Minnesota Timberwolves","Luka Garza",0,0,0,0,0,0
0,0,0,0,0,0,0,0,0,"00",0,0,0,0,0,0,1037862,"2023-11-30T00:00:00.000Z",18,FALSE,29,38017715,"F",18,18,"Minnesota Timberwolves","Josh Minott",0,0,0,0,0,0
0,0,0,0,0,0,0,0,0,"00",0,0,0,0,0,0,1037862,"2023-11-30T00:00:00.000Z",18,FALSE,29,38017700,"G",18,18,"Minnesota Timberwolves","Wendell Moore Jr.",0,0,0,0,0,0
0,0,1,4,1,5,1,0,0,"10",0,0,3,1,0,0,1037862,"2023-11-30T00:00:00.000Z",18,FALSE,29,17895968,"F",18,18,"Minnesota Timberwolves","Daishen Nix",0,4,4,3,1,4.2
0,0,0,0,0,0,0,0,0,"00",0,0,0,0,0,0,1037862,"2023-11-30T00:00:00.000Z",18,FALSE,29,56677851,"G",18,18,"Minnesota Timberwolves","Jaylen Clark",0,0,0,0,0,0
0,0,0,0,0,0,0,0,0,"00",0,0,0,0,0,0,1037862,"2023-11-30T00:00:00.000Z",18,FALSE,29,3547238,"G",18,18,"Minnesota Timberwolves","Anthony Edwards",0,0,0,0,0,0
0,0,0,0,0,0,0,0,0,"00",0,0,0,0,0,0,1037862,"2023-11-30T00:00:00.000Z",18,FALSE,29,3547259,"F",18,18,"Minnesota Timberwolves","Jaden McDaniels",0,0,0,0,0,0
8,0,6,3,1,17,9,14,12,"34",1,0,31,7,0,0,1037866,"2023-12-01T00:00:00.000Z",22,FALSE,30,17896026,"F",22,22,"Orlando Magic","Franz Wagner",0,38,46,39,15,51.4
7,0,10,4,3,20,11,3,3,"38",3,2,28,13,0,2,1037866,"2023-12-01T00:00:00.000Z",22,FALSE,30,38017683,"F",22,22,"Orlando Magic","Paolo Banchero",0,41,48,35,20,52.1
4,2,4,1,1,1,1,0,0,"24",1,4,3,5,0,3,1037866,"2023-12-01T00:00:00.000Z",22,FALSE,30,666442,"C",22,22,"Orlando Magic","Goga Bitadze",2,8,12,7,9,18
4,2,2,6,2,9,5,5,3,"27",0,4,15,2,3,3,1037866,"2023-12-01T00:00:00.000Z",22,FALSE,30,17896073,"G",22,22,"Orlando Magic","Jalen Suggs",5,17,21,19,6,35.4
3,1,2,1,1,4,2,2,1,"23",0,3,6,2,0,1,1037866,"2023-12-01T00:00:00.000Z",22,FALSE,30,56677827,"G",22,22,"Orlando Magic","Anthony Black",1,8,11,9,5,14.9
7,0,3,7,3,11,5,1,1,"25",0,3,14,3,0,0,1037866,"2023-12-01T00:00:00.000Z",22,FALSE,30,226,"F",22,22,"Orlando Magic","Joe Ingles",0,17,24,21,10,28.1
3,3,7,0,0,10,7,7,4,"27",4,5,18,11,0,1,1037866,"2023-12-01T00:00:00.000Z",22,FALSE,30,666577,"F",30,30,"Washington Wizards","Daniel Gafford",3,29,32,21,14,43.7
4,0,4,5,0,12,3,9,8,"30",0,5,14,4,1,2,1037866,"2023-12-01T00:00:00.000Z",22,FALSE,30,666848,"G",30,30,"Washington Wizards","Jordan Poole",1,18,22,18,8,25.8
6,0,3,5,3,10,5,0,0,"26",0,2,13,3,2,0,1037866,"2023-12-01T00:00:00.000Z",22,FALSE,30,249,"G",30,30,"Washington Wizards","Tyus Jones",2,16,22,19,9,31.6
0,0,0,0,0,0,0,0,0,"00",0,0,0,0,0,0,1037866,"2023-12-01T00:00:00.000Z",22,FALSE,30,38017704,"F",30,30,"Washington Wizards","Patrick Baldwin Jr.",0,0,0,0,0,0
0,0,0,0,0,0,0,0,0,"00",0,0,0,0,0,0,1037866,"2023-12-01T00:00:00.000Z",22,FALSE,30,18677954,"G",30,30,"Washington Wizards","Jared Butler",0,0,0,0,0,0
0,0,4,0,0,7,6,0,0,"32",1,1,12,5,3,2,1037866,"2023-12-01T00:00:00.000Z",22,FALSE,30,56677844,"G",30,30,"Washington Wizards","Bilal Coulibaly",3,17,17,12,5,25
0,0,0,0,0,2,0,0,0,"06",1,1,0,1,0,0,1037866,"2023-12-01T00:00:00.000Z",22,FALSE,30,38017687,"G",30,30,"Washington Wizards","Johnny Davis",0,1,1,0,1,1.2
1,0,5,1,1,4,3,0,0,"21",1,2,7,6,1,1,1037866,"2023-12-01T00:00:00.000Z",22,FALSE,30,167,"F",30,30,"Washington Wizards","Danilo Gallinari",1,13,14,8,7,17.7
0,0,0,0,0,0,0,0,0,"00",0,0,0,0,0,0,1037866,"2023-12-01T00:00:00.000Z",22,FALSE,30,38017607,"G",22,22,"Orlando Magic","Kevon Harris",0,0,0,0,0,0
0,0,0,0,0,0,0,0,0,"00",0,0,0,0,0,0,1037866,"2023-12-01T00:00:00.000Z",22,FALSE,30,17553983,"G",22,22,"Orlando Magic","Trevelin Queen",0,0,0,0,0,0
5,0,3,2,0,7,2,2,2,"20",0,1,6,3,0,0,1037866,"2023-12-01T00:00:00.000Z",22,FALSE,30,3547242,"F",30,30,"Washington Wizards","Deni Avdija",0,9,14,11,8,17.1
1,2,5,6,2,18,10,6,5,"37",1,6,27,6,1,6,1037866,"2023-12-01T00:00:00.000Z",22,FALSE,30,265,"F",30,30,"Washington Wizards","Kyle Kuzma",3,33,34,28,7,38.7
0,0,0,0,0,0,0,0,0,"00",0,0,0,0,0,0,1037866,"2023-12-01T00:00:00.000Z",22,FALSE,30,3547302,"F",30,30,"Washington Wizards","Anthony Gill",0,0,0,0,0,0
3,0,1,6,4,11,4,4,3,"23",0,2,15,1,0,0,1037866,"2023-12-01T00:00:00.000Z",22,FALSE,30,17896045,"F",30,30,"Washington Wizards","Corey Kispert",0,16,19,18,4,20.7
0,0,0,0,0,0,0,0,0,"00",0,0,0,0,0,0,1037866,"2023-12-01T00:00:00.000Z",22,FALSE,30,337,"F-C",30,30,"Washington Wizards","Mike Muscala",0,0,0,0,0,0
0,0,0,0,0,0,0,0,0,"00",0,0,0,0,0,0,1037866,"2023-12-01T00:00:00.000Z",22,FALSE,30,17896106,"F",30,30,"Washington Wizards","Eugene Omoruyi",0,0,0,0,0,0
2,0,0,3,3,8,5,3,0,"18",0,4,13,0,0,2,1037866,"2023-12-01T00:00:00.000Z",22,FALSE,30,414,"G",30,30,"Washington Wizards","Landry Shamet",0,13,15,15,2,14
0,0,0,0,0,0,0,0,0,"00",0,0,0,0,0,0,1037866,"2023-12-01T00:00:00.000Z",22,FALSE,30,38124126,"F",30,30,"Washington Wizards","John Butler Jr.",0,0,0,0,0,0
0,0,0,0,0,0,0,0,0,"00",0,0,0,0,0,0,1037866,"2023-12-01T00:00:00.000Z",22,FALSE,30,38017712,"G",30,30,"Washington Wizards","Ryan Rollins",0,0,0,0,0,0
0,0,0,0,0,0,0,0,0,"00",0,0,0,0,0,0,1037866,"2023-12-01T00:00:00.000Z",22,FALSE,30,487,"G",30,30,"Washington Wizards","Delon Wright",0,0,0,0,0,0
2,1,1,0,0,3,1,2,2,"17",0,5,4,1,2,1,1037866,"2023-12-01T00:00:00.000Z",22,FALSE,30,3547251,"G",22,22,"Orlando Magic","Cole Anthony",3,5,7,6,3,16.2
0,1,2,2,0,13,8,3,2,"23",4,1,18,6,1,3,1037866,"2023-12-01T00:00:00.000Z",22,FALSE,30,462,"C",22,22,"Orlando Magic","Moritz Wagner",2,24,24,18,6,28.2
0,0,0,0,0,0,0,0,0,"00",0,0,0,0,0,0,1037866,"2023-12-01T00:00:00.000Z",22,FALSE,30,38017724,"G",22,22,"Orlando Magic","Caleb Houstan",0,0,0,0,0,0
0,0,0,0,0,0,0,0,0,"00",0,0,0,0,0,0,1037866,"2023-12-01T00:00:00.000Z",22,FALSE,30,56677839,"G",22,22,"Orlando Magic","Jett Howard",0,0,0,0,0,0
0,1,4,1,0,2,1,1,1,"07",1,1,3,5,0,0,1037866,"2023-12-01T00:00:00.000Z",22,FALSE,30,229,"F",22,22,"Orlando Magic","Jonathan Isaac",1,8,8,3,5,12
0,0,0,0,0,0,0,0,0,"00",0,0,0,0,0,0,1037866,"2023-12-01T00:00:00.000Z",22,FALSE,30,666818,"F",22,22,"Orlando Magic","Chuma Okeke",0,0,0,0,0,0
0,0,0,0,0,0,0,0,0,"00",0,0,0,0,0,0,1037866,"2023-12-01T00:00:00.000Z",22,FALSE,30,666885,"F",22,22,"Orlando Magic","Admiral Schofield",0,0,0,0,0,0
0,0,0,0,0,0,0,0,0,"00",0,0,0,0,0,0,1037866,"2023-12-01T00:00:00.000Z",22,FALSE,30,85,"F",22,22,"Orlando Magic","Wendell Carter Jr.",0,0,0,0,0,0
0,0,0,0,0,0,0,0,0,"00",0,0,0,0,0,0,1037866,"2023-12-01T00:00:00.000Z",22,FALSE,30,165,"G",22,22,"Orlando Magic","Markelle Fultz",0,0,0,0,0,0
0,0,0,6,1,9,3,2,1,"22",0,0,8,0,0,1,1037866,"2023-12-01T00:00:00.000Z",22,FALSE,30,196,"G",22,22,"Orlando Magic","Gary Harris",0,8,8,8,0,7
0,2,3,4,1,20,8,4,3,"35",1,3,20,4,4,3,1037867,"2023-12-01T00:00:00.000Z",2,FALSE,23,70,"G",2,2,"Boston Celtics","Jaylen Brown",6,24,24,20,4,39.8
4,1,7,5,2,9,6,9,7,"28",0,1,21,7,1,7,1037867,"2023-12-01T00:00:00.000Z",2,FALSE,23,434,"F",2,2,"Boston Celtics","Jayson Tatum",2,28,32,25,11,34.4
3,2,4,4,2,9,7,4,4,"33",2,4,20,6,1,1,1037867,"2023-12-01T00:00:00.000Z",2,FALSE,23,219,"C-F",2,2,"Boston Celtics","Al Horford",3,26,29,23,9,39.7
5,1,5,4,3,11,5,8,8,"32",1,2,21,6,1,1,1037867,"2023-12-01T00:00:00.000Z",2,FALSE,23,473,"G",2,2,"Boston Celtics","Derrick White",2,27,32,26,11,40.7
6,0,5,5,3,11,4,2,2,"35",0,2,13,5,1,3,1037867,"2023-12-01T00:00:00.000Z",2,FALSE,23,214,"G",2,2,"Boston Celtics","Jrue Holiday",1,18,24,19,11,28
1,1,2,1,0,4,2,1,0,"10",3,1,4,5,0,0,1037867,"2023-12-01T00:00:00.000Z",2,FALSE,23,17896094,"G",2,2,"Boston Celtics","Dalano Banton",1,9,10,5,6,14.5
0,0,0,0,0,0,0,0,0,"00",0,0,0,0,0,0,1037867,"2023-12-01T00:00:00.000Z",2,FALSE,23,666468,"F",2,2,"Boston Celtics","Oshae Brissett",0,0,0,0,0,0
1,1,4,4,3,5,3,2,2,"26",1,2,11,5,1,3,1037867,"2023-12-01T00:00:00.000Z",2,FALSE,23,17896060,"F",2,2,"Boston Celtics","Sam Hauser",2,16,17,12,6,21.5
0,0,1,0,0,0,0,0,0,"08",0,1,0,1,0,0,1037867,"2023-12-01T00:00:00.000Z",2,FALSE,23,261,"F-C",2,2,"Boston Celtics","Luke Kornet",0,1,1,0,1,1.2
0,0,0,0,0,0,0,0,0,"00",0,0,0,0,0,0,1037867,"2023-12-01T00:00:00.000Z",2,FALSE,23,338,"G",2,2,"Boston Celtics","Svi Mykhailiuk",0,0,0,0,0,0
5,0,2,6,2,7,3,2,2,"23",0,1,10,2,1,0,1037867,"2023-12-01T00:00:00.000Z",2,FALSE,23,3547276,"G",2,2,"Boston Celtics","Payton Pritchard",1,12,17,15,7,22.9
0,0,3,0,0,1,1,4,3,"10",2,1,5,5,0,2,1037867,"2023-12-01T00:00:00.000Z",2,FALSE,23,17553967,"C",2,2,"Boston Celtics","Neemias Queta",0,10,10,5,5,9
0,0,0,0,0,0,0,0,0,"00",0,0,0,0,0,0,1037867,"2023-12-01T00:00:00.000Z",2,FALSE,23,3547279,"F",2,2,"Boston Celtics","Lamar Stevens",0,0,0,0,0,0
0,0,0,0,0,0,0,0,0,"00",0,0,0,0,0,0,1037867,"2023-12-01T00:00:00.000Z",2,FALSE,23,38017707,"G",2,2,"Boston Celtics","JD Davison",0,0,0,0,0,0
0,0,0,0,0,0,0,0,0,"00",0,0,0,0,0,0,1037867,"2023-12-01T00:00:00.000Z",2,FALSE,23,3547295,"F-C",2,2,"Boston Celtics","Nathan Knight",0,0,0,0,0,0
0,0,0,0,0,0,0,0,0,"00",0,0,0,0,0,0,1037867,"2023-12-01T00:00:00.000Z",2,FALSE,23,378,"F-C",2,2,"Boston Celtics","Kristaps Porzingis",0,0,0,0,0,0
0,0,0,0,0,0,0,0,0,"00",0,0,0,0,0,0,1037867,"2023-12-01T00:00:00.000Z",2,FALSE,23,56677864,"G",2,2,"Boston Celtics","Jordan Walsh",0,0,0,0,0,0
3,0,2,1,1,16,6,3,1,"38",3,1,14,5,4,4,1037867,"2023-12-01T00:00:00.000Z",2,FALSE,23,200,"F",23,23,"Philadelphia 76ers","Tobias Harris",4,19,22,17,8,32.5
1,1,6,3,2,12,5,1,1,"28",1,1,13,7,1,0,1037867,"2023-12-01T00:00:00.000Z",2,FALSE,23,328,"F",23,23,"Philadelphia 76ers","Marcus Morris",2,20,21,14,8,28.9
1,1,4,1,1,8,6,1,1,"21",1,3,14,5,0,1,1037867,"2023-12-01T00:00:00.000Z",2,FALSE,23,3547270,"F",23,23,"Philadelphia 76ers","Paul Reed",1,19,20,15,6,23.5
2,1,3,12,4,19,7,4,3,"37",1,6,21,4,1,4,1037867,"2023-12-01T00:00:00.000Z",2,FALSE,23,313,"G",23,23,"Philadelphia 76ers","De'Anthony Melton",2,25,27,23,6,30.8
7,0,6,5,3,15,10,5,3,"38",2,4,26,8,2,3,1037867,"2023-12-01T00:00:00.000Z",2,FALSE,23,45,"G",23,23,"Philadelphia 76ers","Patrick Beverley",2,34,41,33,15,49.1
1,1,1,4,2,7,4,2,1,"20",5,1,11,6,0,2,1037867,"2023-12-01T00:00:00.000Z",2,FALSE,23,28,"C",23,23,"Philadelphia 76ers","Mo Bamba",1,17,18,12,7,20.7
0,0,0,0,0,0,0,0,0,"00",0,0,0,0,0,0,1037867,"2023-12-01T00:00:00.000Z",2,FALSE,23,33,"F-G",23,23,"Philadelphia 76ers","Nicolas Batum",0,0,0,0,0,0
1,1,2,6,3,9,4,7,7,"30",3,4,18,5,5,2,1037867,"2023-12-01T00:00:00.000Z",2,FALSE,23,108,"F",23,23,"Philadelphia 76ers","Robert Covington",6,23,24,19,6,41.5
0,0,1,3,0,4,0,0,0,"15",0,3,0,1,1,0,1037867,"2023-12-01T00:00:00.000Z",2,FALSE,23,260,"G-F",23,23,"Philadelphia 76ers","Furkan Korkmaz",1,1,1,0,1,4.2
0,0,2,0,0,5,1,0,0,"13",0,1,2,2,2,0,1037867,"2023-12-01T00:00:00.000Z",2,FALSE,23,3547294,"F",23,23,"Philadelphia 76ers","Kenyon Martin Jr.",2,4,4,2,2,10.4
0,0,0,0,0,0,0,0,0,"00",0,0,0,0,0,0,1037867,"2023-12-01T00:00:00.000Z",2,FALSE,23,3547254,"G",23,23,"Philadelphia 76ers","Tyrese Maxey",0,0,0,0,0,0
0,0,0,0,0,0,0,0,0,"00",0,0,0,0,0,0,1037867,"2023-12-01T00:00:00.000Z",2,FALSE,23,17896025,"G",23,23,"Philadelphia 76ers","Jaden Springer",0,0,0,0,0,0
0,0,0,0,0,0,0,0,0,"00",0,0,0,0,0,0,1037867,"2023-12-01T00:00:00.000Z",2,FALSE,23,56913527,"G",23,23,"Philadelphia 76ers","Ricky Council IV",0,0,0,0,0,0
0,0,0,0,0,0,0,0,0,"00",0,0,0,0,0,0,1037867,"2023-12-01T00:00:00.000Z",2,FALSE,23,145,"F-C",23,23,"Philadelphia 76ers","Joel Embiid",0,0,0,0,0,0
0,0,0,0,0,0,0,0,0,"00",0,0,0,0,0,0,1037867,"2023-12-01T00:00:00.000Z",2,FALSE,23,360,"F",23,23,"Philadelphia 76ers","Kelly Oubre Jr.",0,0,0,0,0,0
0,0,0,0,0,0,0,0,0,"00",0,0,0,0,0,0,1037867,"2023-12-01T00:00:00.000Z",2,FALSE,23,17554001,"G",23,23,"Philadelphia 76ers","Javonte Smart",0,0,0,0,0,0
0,0,0,0,0,0,0,0,0,"00",0,0,0,0,0,0,1037867,"2023-12-01T00:00:00.000Z",2,FALSE,23,56677788,"G",23,23,"Philadelphia 76ers","Terquavion Smith",0,0,0,0,0,0
0,0,0,0,0,0,0,0,0,"00",0,0,0,0,0,0,1037867,"2023-12-01T00:00:00.000Z",2,FALSE,23,2175,"",23,23,"Philadelphia 76ers","Danuel House Jr.",0,0,0,0,0,0
4,1,6,7,3,19,13,1,0,"37",3,2,29,9,5,2,1037868,"2023-12-01T00:00:00.000Z",28,FALSE,20,17896055,"G-F",28,28,"Toronto Raptors","Scottie Barnes",6,38,42,33,13,61.8
3,0,5,4,0,16,7,8,7,"34",3,3,21,8,0,3,1037868,"2023-12-01T00:00:00.000Z",28,FALSE,20,416,"F",28,28,"Toronto Raptors","Pascal Siakam",0,29,32,24,11,32.1
1,2,8,0,0,9,6,0,0,"28",4,4,12,12,0,1,1037868,"2023-12-01T00:00:00.000Z",28,FALSE,20,373,"C",28,28,"Toronto Raptors","Jakob Poeltl",2,24,25,13,13,32.9
3,2,4,6,1,13,4,0,0,"27",1,5,9,5,1,3,1037868,"2023-12-01T00:00:00.000Z",28,FALSE,20,18,"F",28,28,"Toronto Raptors","OG Anunoby",3,14,17,12,8,25.5
9,0,1,6,1,10,3,4,3,"37",0,1,10,1,0,2,1037868,"2023-12-01T00:00:00.000Z",28,FALSE,20,409,"G",28,28,"Toronto Raptors","Dennis Schroder",0,11,20,19,10,22.7
1,0,1,1,0,11,4,0,0,"17",5,2,8,6,0,1,1037868,"2023-12-01T00:00:00.000Z",28,FALSE,20,3547249,"F",28,28,"Toronto Raptors","Precious Achiuwa",0,14,15,9,7,15.7
2,0,1,4,1,10,4,3,2,"19",2,0,11,3,1,0,1037868,"2023-12-01T00:00:00.000Z",28,FALSE,20,58,"F",28,28,"Toronto Raptors","Chris Boucher",1,14,16,13,5,20.6
4,1,1,1,0,2,0,0,0,"11",0,1,0,1,0,0,1037868,"2023-12-01T00:00:00.000Z",28,FALSE,20,3547275,"G",28,28,"Toronto Raptors","Malachi Flynn",1,1,5,4,5,10.2
1,0,1,2,0,4,1,0,0,"07",1,1,2,2,0,0,1037868,"2023-12-01T00:00:00.000Z",28,FALSE,20,666762,"F",28,28,"Toronto Raptors","Jalen McDaniels",0,4,5,3,3,5.9
0,0,0,0,0,0,0,0,0,"00",0,0,0,0,0,0,1037868,"2023-12-01T00:00:00.000Z",28,FALSE,20,376,"F",28,28,"Toronto Raptors","Otto Porter Jr.",0,0,0,0,0,0
0,0,0,0,0,0,0,0,0,"00",0,0,0,0,0,0,1037868,"2023-12-01T00:00:00.000Z",28,FALSE,20,436,"G-F",28,28,"Toronto Raptors","Garrett Temple",0,0,0,0,0,0
4,0,1,1,0,6,2,1,0,"23",0,0,4,1,0,0,1037868,"2023-12-01T00:00:00.000Z",28,FALSE,20,3089,"",28,28,"Toronto Raptors","Gary Trent Jr.",0,5,9,8,5,11.2
0,0,0,0,0,0,0,0,0,"00",0,0,0,0,0,0,1037868,"2023-12-01T00:00:00.000Z",28,FALSE,20,489,"F",28,28,"Toronto Raptors","Thaddeus Young",0,0,0,0,0,0
0,0,0,0,0,0,0,0,0,"00",0,0,0,0,0,0,1037868,"2023-12-01T00:00:00.000Z",28,FALSE,20,56677828,"G",28,28,"Toronto Raptors","Gradey Dick",0,0,0,0,0,0
0,0,0,0,0,0,0,0,0,"00",0,0,0,0,0,0,1037868,"2023-12-01T00:00:00.000Z",28,FALSE,20,38017717,"F",28,28,"Toronto Raptors","Ron Harper Jr.",0,0,0,0,0,0
0,0,0,0,0,0,0,0,0,"00",0,0,0,0,0,0,1037868,"2023-12-01T00:00:00.000Z",28,FALSE,20,38017710,"C",28,28,"Toronto Raptors","Christian Koloko",0,0,0,0,0,0
0,0,0,0,0,0,0,0,0,"00",0,0,0,0,0,0,1037868,"2023-12-01T00:00:00.000Z",28,FALSE,20,56677869,"G",28,28,"Toronto Raptors","Markquis Nowell",0,0,0,0,0,0
6,0,3,6,1,18,6,3,2,"27",1,1,15,4,0,2,1037868,"2023-12-01T00:00:00.000Z",28,FALSE,20,666423,"F-G",20,20,"New York Knicks","RJ Barrett",0,19,25,21,10,26.8
9,0,8,4,1,15,8,3,3,"35",2,3,20,10,0,2,1037868,"2023-12-01T00:00:00.000Z",28,FALSE,20,387,"F",20,20,"New York Knicks","Julius Randle",0,30,39,29,19,43.5
1,1,3,0,0,3,3,0,0,"32",2,3,6,5,4,2,1037868,"2023-12-01T00:00:00.000Z",28,FALSE,20,399,"C",20,20,"New York Knicks","Mitchell Robinson",5,11,12,7,6,26.5
8,0,5,8,3,21,9,1,1,"37",0,2,22,5,1,2,1037868,"2023-12-01T00:00:00.000Z",28,FALSE,20,73,"G",20,20,"New York Knicks","Jalen Brunson",1,27,35,30,13,41
2,0,0,2,0,3,1,2,2,"21",1,2,4,1,0,0,1037868,"2023-12-01T00:00:00.000Z",28,FALSE,20,17895858,"G",20,20,"New York Knicks","Quentin Grimes",0,5,7,6,3,8.2
0,0,0,0,0,0,0,0,0,"00",0,0,0,0,0,0,1037868,"2023-12-01T00:00:00.000Z",28,FALSE,20,19,"G",20,20,"New York Knicks","Ryan Arcidiacono",0,0,0,0,0,0
1,0,1,9,7,10,7,0,0,"22",0,0,21,1,0,0,1037868,"2023-12-01T00:00:00.000Z",28,FALSE,20,131,"G",20,20,"New York Knicks","Donte DiVincenzo",0,22,23,22,2,23.7
0,0,0,0,0,0,0,0,0,"00",0,0,0,0,0,0,1037868,"2023-12-01T00:00:00.000Z",28,FALSE,20,160,"G-F",20,20,"New York Knicks","Evan Fournier",0,0,0,0,0,0
2,1,5,4,3,11,7,0,0,"31",3,3,17,8,0,3,1037868,"2023-12-01T00:00:00.000Z",28,FALSE,20,202,"G",20,20,"New York Knicks","Josh Hart",1,25,27,19,10,29.6
0,1,6,0,0,3,1,3,2,"16",2,1,4,8,0,0,1037868,"2023-12-01T00:00:00.000Z",28,FALSE,20,201,"F-C",20,20,"New York Knicks","Isaiah Hartenstein",1,12,12,4,8,16.6
0,0,0,0,0,0,0,0,0,"00",0,0,0,0,0,0,1037868,"2023-12-01T00:00:00.000Z",28,FALSE,20,666675,"F",20,20,"New York Knicks","DaQuan Jeffries",0,0,0,0,0,0
0,0,0,0,0,0,0,0,0,"00",0,0,0,0,0,0,1037868,"2023-12-01T00:00:00.000Z",28,FALSE,20,17896033,"G",20,20,"New York Knicks","Miles McBride",0,0,0,0,0,0
1,0,1,3,1,6,3,4,3,"19",0,0,10,1,1,1,1037868,"2023-12-01T00:00:00.000Z",28,FALSE,20,3547269,"G",20,20,"New York Knicks","Immanuel Quickley",1,11,12,11,2,14.7
0,0,0,0,0,0,0,0,0,"00",0,0,0,0,0,0,1037868,"2023-12-01T00:00:00.000Z",28,FALSE,20,17896063,"F",20,20,"New York Knicks","Jericho Sims",0,0,0,0,0,0
0,0,0,0,0,0,0,0,0,"00",0,0,0,0,0,0,1037868,"2023-12-01T00:00:00.000Z",28,FALSE,20,666474,"G",20,20,"New York Knicks","Charles Brown",0,0,0,0,0,0
0,0,0,0,0,0,0,0,0,"00",0,0,0,0,0,0,1037868,"2023-12-01T00:00:00.000Z",28,FALSE,20,59421201,"G",20,20,"New York Knicks","Jaylen Martin",0,0,0,0,0,0
0,0,0,0,0,0,0,0,0,"00",0,0,0,0,0,0,1037868,"2023-12-01T00:00:00.000Z",28,FALSE,20,56677795,"F",20,20,"New York Knicks","Jacob Toppin",0,0,0,0,0,0
0,0,0,0,0,0,0,0,0,"00",0,0,0,0,0,0,1037868,"2023-12-01T00:00:00.000Z",28,FALSE,20,666971,"G-F",20,20,"New York Knicks","Dylan Windler",0,0,0,0,0,0
0,0,0,0,0,0,0,0,0,"00",0,0,0,0,0,0,1037868,"2023-12-01T00:00:00.000Z",28,FALSE,20,56677805,"G",28,28,"Toronto Raptors","Javon Freeman-Liberty",0,0,0,0,0,0
1,0,1,7,4,14,6,0,0,"31",3,1,16,4,1,1,1037869,"2023-12-01T00:00:00.000Z",7,FALSE,15,247,"F-G",7,7,"Dallas Mavericks","Derrick Jones Jr.",1,20,21,17,5,24.3
3,1,6,9,3,12,4,6,5,"31",2,3,16,8,1,1,1037869,"2023-12-01T00:00:00.000Z",7,FALSE,15,666965,"F",7,7,"Dallas Mavericks","Grant Williams",2,24,27,19,11,35.1
1,2,4,0,0,5,2,0,0,"23",1,1,4,5,1,2,1037869,"2023-12-01T00:00:00.000Z",7,FALSE,15,56677840,"C",7,7,"Dallas Mavericks","Dereck Lively II",3,9,10,5,6,18.5
5,0,2,3,1,10,4,1,1,"31",0,0,10,2,3,3,1037869,"2023-12-01T00:00:00.000Z",7,FALSE,15,3547258,"G",7,7,"Dallas Mavericks","Josh Green",3,12,17,15,7,25.9
5,0,5,5,0,15,3,5,4,"36",0,2,10,5,0,1,1037869,"2023-12-01T00:00:00.000Z",7,FALSE,15,228,"G",7,7,"Dallas Mavericks","Kyrie Irving",0,15,20,15,10,22.5
2,0,2,4,2,10,5,0,0,"16",0,2,12,2,1,0,1037869,"2023-12-01T00:00:00.000Z",7,FALSE,15,114,"G",7,7,"Dallas Mavericks","Seth Curry",1,14,16,14,4,20.4
0,0,0,1,0,4,2,1,0,"04",0,0,4,0,1,0,1037869,"2023-12-01T00:00:00.000Z",7,FALSE,15,56677873,"G",7,7,"Dallas Mavericks","Dexter Dennis",1,4,4,4,0,7
5,0,3,4,0,9,4,2,0,"21",2,1,8,5,0,2,1037869,"2023-12-01T00:00:00.000Z",7,FALSE,15,38017679,"G",7,7,"Dallas Mavericks","Jaden Hardy",0,13,18,13,10,19.5
2,2,4,0,0,4,2,2,1,"18",3,1,5,7,1,1,1037869,"2023-12-01T00:00:00.000Z",7,FALSE,15,217,"F-C",7,7,"Dallas Mavericks","Richaun Holmes",3,12,14,7,9,24.4
0,0,1,1,0,1,0,2,1,"04",0,0,1,1,0,0,1037869,"2023-12-01T00:00:00.000Z",7,FALSE,15,17554004,"G",7,7,"Dallas Mavericks","AJ Lawson",0,2,2,1,1,2.2
1,0,1,4,2,7,2,0,0,"14",2,2,6,3,0,0,1037869,"2023-12-01T00:00:00.000Z",7,FALSE,15,329,"F",7,7,"Dallas Mavericks","Markieff Morris",0,9,10,7,4,11.1
0,0,0,0,0,0,0,0,0,"00",0,0,0,0,0,0,1037869,"2023-12-01T00:00:00.000Z",7,FALSE,15,379,"F-C",7,7,"Dallas Mavericks","Dwight Powell",0,0,0,0,0,0
2,0,0,1,0,1,0,2,2,"11",0,0,2,0,0,0,1037869,"2023-12-01T00:00:00.000Z",7,FALSE,15,56677859,"F",7,7,"Dallas Mavericks","Olivier-Maxence Prosper",0,2,4,4,2,5
0,0,0,0,0,0,0,0,0,"00",0,0,0,0,0,0,1037869,"2023-12-01T00:00:00.000Z",7,FALSE,15,17896028,"F",7,7,"Dallas Mavericks","Greg Brown III",0,0,0,0,0,0
0,0,0,0,0,0,0,0,0,"00",0,0,0,0,0,0,1037869,"2023-12-01T00:00:00.000Z",7,FALSE,15,132,"F-G",7,7,"Dallas Mavericks","Luka Doncic",0,0,0,0,0,0
0,0,0,0,0,0,0,0,0,"00",0,0,0,0,0,0,1037869,"2023-12-01T00:00:00.000Z",7,FALSE,15,151,"G",7,7,"Dallas Mavericks","Dante Exum",0,0,0,0,0,0
0,0,0,0,0,0,0,0,0,"00",0,0,0,0,0,0,1037869,"2023-12-01T00:00:00.000Z",7,FALSE,15,191,"G",7,7,"Dallas Mavericks","Tim Hardaway Jr.",0,0,0,0,0,0
0,0,0,0,0,0,0,0,0,"00",0,0,0,0,0,0,1037869,"2023-12-01T00:00:00.000Z",7,FALSE,15,257,"F",7,7,"Dallas Mavericks","Maxi Kleber",0,0,0,0,0,0
3,1,5,3,0,9,2,2,2,"24",1,2,6,6,1,1,1037869,"2023-12-01T00:00:00.000Z",7,FALSE,15,38017729,"F",15,15,"Memphis Grizzlies","David Roddy",2,12,15,9,9,22.7
2,2,3,3,0,8,2,0,0,"14",1,5,4,4,0,1,1037869,"2023-12-01T00:00:00.000Z",7,FALSE,15,231,"F-C",15,15,"Memphis Grizzlies","Jaren Jackson Jr.",2,8,10,6,6,16.8
4,2,5,0,0,3,2,0,0,"23",1,2,4,6,0,2,1037869,"2023-12-01T00:00:00.000Z",7,FALSE,15,48,"C",15,15,"Memphis Grizzlies","Bismack Biyombo",2,10,14,8,10,21.2
5,2,2,6,4,20,11,6,4,"34",2,2,30,4,1,4,1037869,"2023-12-01T00:00:00.000Z",7,FALSE,15,3547287,"G",15,15,"Memphis Grizzlies","Desmond Bane",3,34,39,35,9,47.3
3,0,2,2,0,7,3,0,0,"20",0,3,6,2,1,1,1037869,"2023-12-01T00:00:00.000Z",7,FALSE,15,401,"G",15,15,"Memphis Grizzlies","Derrick Rose",1,8,11,9,5,14.9
3,1,7,4,1,10,7,2,2,"33",5,1,17,12,1,1,1037869,"2023-12-01T00:00:00.000Z",7,FALSE,15,17896067,"F",15,15,"Memphis Grizzlies","Santi Aldama",2,29,32,20,15,40.9
0,0,0,0,0,0,0,0,0,"02",0,0,0,0,0,0,1037869,"2023-12-01T00:00:00.000Z",7,FALSE,15,48248287,"G",15,15,"Memphis Grizzlies","Jacob Gilyard",0,0,0,0,0,0
0,0,0,0,0,0,0,0,0,"02",0,0,0,0,0,0,1037869,"2023-12-01T00:00:00.000Z",7,FALSE,15,199,"G",15,15,"Memphis Grizzlies","Shaquille Harrison",0,0,0,0,0,0
0,0,1,0,0,0,0,0,0,"02",0,1,0,1,0,0,1037869,"2023-12-01T00:00:00.000Z",7,FALSE,15,666703,"G-F",15,15,"Memphis Grizzlies","John Konchar",0,1,1,0,1,1.2
0,0,2,0,0,2,0,0,0,"02",0,0,0,2,0,0,1037869,"2023-12-01T00:00:00.000Z",7,FALSE,15,38017732,"F",15,15,"Memphis Grizzlies","Kenneth Lofton Jr.",0,2,2,0,2,2.4
1,0,3,6,2,14,8,1,1,"26",1,2,19,4,1,1,1037869,"2023-12-01T00:00:00.000Z",7,FALSE,15,666809,"G",15,15,"Memphis Grizzlies","Jaylen Nowell",1,23,24,20,5,27.3
2,2,2,3,0,6,2,0,0,"22",0,0,4,2,2,0,1037869,"2023-12-01T00:00:00.000Z",7,FALSE,15,3547285,"F",15,15,"Memphis Grizzlies","Xavier Tillman",4,6,8,6,4,21.4
3,2,7,6,3,9,6,0,0,"26",2,4,15,9,0,1,1037869,"2023-12-01T00:00:00.000Z",7,FALSE,15,38017731,"G",15,15,"Memphis Grizzlies","Vince Williams Jr.",2,24,27,18,12,35.3
0,0,0,0,0,0,0,0,0,"00",0,0,0,0,0,0,1037869,"2023-12-01T00:00:00.000Z",7,FALSE,15,666505,"F",15,15,"Memphis Grizzlies","Brandon Clarke",0,0,0,0,0,0
0,0,0,0,0,0,0,0,0,"00",0,0,0,0,0,0,1037869,"2023-12-01T00:00:00.000Z",7,FALSE,15,56677830,"F",15,15,"Memphis Grizzlies","GG Jackson",0,0,0,0,0,0
0,0,0,0,0,0,0,0,0,"00",0,0,0,0,0,0,1037869,"2023-12-01T00:00:00.000Z",7,FALSE,15,254,"G",15,15,"Memphis Grizzlies","Luke Kennard",0,0,0,0,0,0
0,0,0,0,0,0,0,0,0,"00",0,0,0,0,0,0,1037869,"2023-12-01T00:00:00.000Z",7,FALSE,15,38017728,"F",15,15,"Memphis Grizzlies","Jake LaRavia",0,0,0,0,0,0
0,0,0,0,0,0,0,0,0,"00",0,0,0,0,0,0,1037869,"2023-12-01T00:00:00.000Z",7,FALSE,15,666786,"G",15,15,"Memphis Grizzlies","Ja Morant",0,0,0,0,0,0
0,0,0,0,0,0,0,0,0,"00",0,0,0,0,0,0,1037869,"2023-12-01T00:00:00.000Z",7,FALSE,15,420,"G",15,15,"Memphis Grizzlies","Marcus Smart",0,0,0,0,0,0
1,0,0,1,1,2,1,0,0,"10",0,1,3,0,1,2,1037869,"2023-12-01T00:00:00.000Z",7,FALSE,15,17896027,"G-F",15,15,"Memphis Grizzlies","Ziaire Williams",1,3,4,4,1,5.5
0,0,0,0,0,0,0,0,0,"00",0,0,0,0,0,0,1037869,"2023-12-01T00:00:00.000Z",7,FALSE,15,3,"C",15,15,"Memphis Grizzlies","Steven Adams",0,0,0,0,0,0
11,3,4,3,1,25,8,13,13,"36",0,2,30,4,1,1,1037871,"2023-12-01T00:00:00.000Z",24,FALSE,8,140,"F",24,24,"Phoenix Suns","Kevin Durant",4,34,45,41,15,62.3
1,0,1,0,0,1,0,4,4,"17",0,0,4,1,0,0,1037871,"2023-12-01T00:00:00.000Z",24,FALSE,8,32,"F",24,24,"Phoenix Suns","Keita Bates-Diop",0,5,6,5,2,6.7
2,1,3,6,2,22,13,5,3,"33",3,6,31,6,0,6,1037871,"2023-12-01T00:00:00.000Z",24,FALSE,8,349,"C",24,24,"Phoenix Suns","Jusuf Nurkic",1,37,39,33,8,38.2
3,1,3,7,4,11,6,0,0,"33",1,1,16,4,1,3,1037871,"2023-12-01T00:00:00.000Z",24,FALSE,8,178,"G",24,24,"Phoenix Suns","Eric Gordon",2,20,23,19,7,28.3
3,0,9,4,1,9,5,2,2,"37",0,2,13,9,1,0,1037871,"2023-12-01T00:00:00.000Z",24,FALSE,8,8,"G",24,24,"Phoenix Suns","Grayson Allen",1,22,25,16,12,31.3
0,0,0,0,0,0,0,0,0,"00",0,0,0,0,0,0,1037871,"2023-12-01T00:00:00.000Z",24,FALSE,8,3547095,"C-F",24,24,"Phoenix Suns","Udoka Azubuike",0,0,0,0,0,0
0,0,0,0,0,0,0,0,0,"00",0,0,0,0,0,0,1037871,"2023-12-01T00:00:00.000Z",24,FALSE,8,666451,"C",24,24,"Phoenix Suns","Bol Bol",0,0,0,0,0,0
1,0,6,0,0,1,0,0,0,"15",0,2,0,6,0,0,1037871,"2023-12-01T00:00:00.000Z",24,FALSE,8,147,"F",24,24,"Phoenix Suns","Drew Eubanks",0,6,7,1,7,8.7
0,0,4,1,0,3,1,0,0,"20",2,1,2,6,0,0,1037871,"2023-12-01T00:00:00.000Z",24,FALSE,8,18678058,"",24,24,"Phoenix Suns","Jordan Goodwin",0,8,8,2,6,9.2
0,0,0,0,0,0,0,0,0,"00",0,0,0,0,0,0,1037871,"2023-12-01T00:00:00.000Z",24,FALSE,8,3547298,"G",24,24,"Phoenix Suns","Saben Lee",0,0,0,0,0,0
0,0,2,0,0,1,1,0,0,"19",0,0,2,2,0,0,1037871,"2023-12-01T00:00:00.000Z",24,FALSE,8,666729,"F",24,24,"Phoenix Suns","Nassir Little",0,4,4,2,2,4.4
5,0,1,5,3,8,6,0,0,"26",1,2,15,2,1,0,1037871,"2023-12-01T00:00:00.000Z",24,FALSE,8,215,"F-G",8,8,"Denver Nuggets","Justin Holiday",1,17,22,20,7,27.9
4,1,9,4,0,16,8,3,3,"37",1,1,19,10,2,2,1037871,"2023-12-01T00:00:00.000Z",24,FALSE,8,375,"F",8,8,"Denver Nuggets","Michael Porter Jr.",3,29,33,23,14,44
16,2,4,3,0,18,9,6,3,"35",1,4,21,5,1,3,1037871,"2023-12-01T00:00:00.000Z",24,FALSE,8,246,"C",8,8,"Denver Nuggets","Nikola Jokic",3,26,42,37,21,57
1,0,1,1,0,2,0,0,0,"04",0,0,0,1,0,0,1037871,"2023-12-01T00:00:00.000Z",24,FALSE,8,314,"F",24,24,"Phoenix Suns","Chimezie Metu",0,1,2,1,2,2.7
0,3,2,5,1,9,5,2,2,"26",2,3,13,4,1,2,1037871,"2023-12-01T00:00:00.000Z",24,FALSE,8,356,"G",24,24,"Phoenix Suns","Josh Okogie",4,17,17,13,4,27.8
0,0,0,0,0,0,0,0,0,"00",0,0,0,0,0,0,1037871,"2023-12-01T00:00:00.000Z",24,FALSE,8,470,"G",24,24,"Phoenix Suns","Yuta Watanabe",0,0,0,0,0,0
0,0,0,0,0,0,0,0,0,"00",0,0,0,0,0,0,1037871,"2023-12-01T00:00:00.000Z",24,FALSE,8,37,"G",24,24,"Phoenix Suns","Bradley Beal",0,0,0,0,0,0
0,0,0,0,0,0,0,0,0,"00",0,0,0,0,0,0,1037871,"2023-12-01T00:00:00.000Z",24,FALSE,8,57,"G",24,24,"Phoenix Suns","Devin Booker",0,0,0,0,0,0
0,0,0,0,0,0,0,0,0,"00",0,0,0,0,0,0,1037871,"2023-12-01T00:00:00.000Z",24,FALSE,8,272,"G",24,24,"Phoenix Suns","Damion Lee",0,0,0,0,0,0
0,0,0,0,0,0,0,0,0,"00",0,0,0,0,0,0,1037871,"2023-12-01T00:00:00.000Z",24,FALSE,8,3547268,"F-C",8,8,"Denver Nuggets","Zeke Nnaji",0,0,0,0,0,0
0,0,0,0,0,0,0,0,0,"00",0,0,0,0,0,0,1037871,"2023-12-01T00:00:00.000Z",24,FALSE,8,666489,"F",8,8,"Denver Nuggets","Vlatko Cancar",0,0,0,0,0,0
5,0,1,6,3,10,6,0,0,"35",0,2,15,1,3,0,1037871,"2023-12-01T00:00:00.000Z",24,FALSE,8,81,"G",8,8,"Denver Nuggets","Kentavious Caldwell-Pope",3,16,21,20,6,32.7
4,0,2,4,3,11,8,2,1,"29",0,3,20,2,0,1,1037871,"2023-12-01T00:00:00.000Z",24,FALSE,8,236,"G",8,8,"Denver Nuggets","Reggie Jackson",0,22,26,24,6,27.4
4,0,3,0,0,6,4,0,0,"22",1,0,8,4,1,1,1037871,"2023-12-01T00:00:00.000Z",24,FALSE,8,38017709,"G",8,8,"Denver Nuggets","Christian Braun",1,12,16,12,8,20.8
0,0,3,2,0,9,4,0,0,"25",0,5,8,3,0,0,1037871,"2023-12-01T00:00:00.000Z",24,FALSE,8,38017721,"G",8,8,"Denver Nuggets","Peyton Watson",0,11,11,8,3,11.6
0,1,3,8,3,9,4,0,0,"18",0,2,11,3,0,0,1037871,"2023-12-01T00:00:00.000Z",24,FALSE,8,56677776,"G",8,8,"Denver Nuggets","Julian Strawther",1,14,14,11,3,17.6
0,0,2,0,0,1,1,1,0,"13",0,2,2,2,0,2,1037871,"2023-12-01T00:00:00.000Z",24,FALSE,8,250,"C",8,8,"Denver Nuggets","DeAndre Jordan",0,4,4,2,2,2.4
0,0,0,0,0,0,0,0,0,"00",0,0,0,0,0,0,1037871,"2023-12-01T00:00:00.000Z",24,FALSE,8,38017727,"G",8,8,"Denver Nuggets","Collin Gillespie",0,0,0,0,0,0
0,0,0,0,0,0,0,0,0,"00",0,0,0,0,0,0,1037871,"2023-12-01T00:00:00.000Z",24,FALSE,8,17896007,"G",8,8,"Denver Nuggets","Braxton Key",0,0,0,0,0,0
0,0,0,0,0,0,0,0,0,"00",0,0,0,0,0,0,1037871,"2023-12-01T00:00:00.000Z",24,FALSE,8,177,"F",8,8,"Denver Nuggets","Aaron Gordon",0,0,0,0,0,0
0,0,0,0,0,0,0,0,0,"00",0,0,0,0,0,0,1037871,"2023-12-01T00:00:00.000Z",24,FALSE,8,17896103,"F-C",8,8,"Denver Nuggets","Jay Huff",0,0,0,0,0,0
0,0,0,0,0,0,0,0,0,"00",0,0,0,0,0,0,1037871,"2023-12-01T00:00:00.000Z",24,FALSE,8,335,"G",8,8,"Denver Nuggets","Jamal Murray",0,0,0,0,0,0
0,0,0,0,0,0,0,0,0,"00",0,0,0,0,0,0,1037871,"2023-12-01T00:00:00.000Z",24,FALSE,8,56677582,"G",8,8,"Denver Nuggets","Jalen Pickett",0,0,0,0,0,0
0,0,0,0,0,0,0,0,0,"00",0,0,0,0,0,0,1037871,"2023-12-01T00:00:00.000Z",24,FALSE,8,56677871,"F",8,8,"Denver Nuggets","Hunter Tyson",0,0,0,0,0,0
7,0,5,4,0,14,3,8,8,"34",0,3,14,5,1,4,1037870,"2023-12-01T00:00:00.000Z",19,FALSE,27,227,"F",19,19,"New Orleans Pelicans","Brandon Ingram",1,19,26,21,12,29.5
7,1,3,0,0,9,4,5,4,"26",1,2,12,4,0,1,1037870,"2023-12-01T00:00:00.000Z",19,FALSE,27,666969,"F",19,19,"New Orleans Pelicans","Zion Williamson",1,16,23,19,11,29.3
1,2,10,1,0,12,9,7,6,"31",2,3,24,12,1,1,1037870,"2023-12-01T00:00:00.000Z",19,FALSE,27,455,"C",19,19,"New Orleans Pelicans","Jonas Valanciunas",3,36,37,25,13,47.9
0,0,2,4,3,8,6,2,2,"31",2,1,17,4,3,1,1037870,"2023-12-01T00:00:00.000Z",19,FALSE,27,17896024,"F",19,19,"New Orleans Pelicans","Herbert Jones",3,21,21,17,4,29.8
8,1,2,8,1,18,8,2,2,"38",1,1,19,3,2,1,1037870,"2023-12-01T00:00:00.000Z",19,FALSE,27,303,"G",19,19,"New Orleans Pelicans","CJ McCollum",3,22,30,27,11,42.6
0,0,0,0,0,0,0,0,0,"00",0,0,0,0,0,0,1037870,"2023-12-01T00:00:00.000Z",19,FALSE,27,17896097,"G",19,19,"New Orleans Pelicans","Jose Alvarado",0,0,0,0,0,0
0,0,0,0,0,0,0,0,0,"00",0,0,0,0,0,0,1037870,"2023-12-01T00:00:00.000Z",19,FALSE,27,38017726,"G",19,19,"New Orleans Pelicans","Dereon Seabron",0,0,0,0,0,0
3,0,4,6,3,7,4,1,1,"22",1,3,12,5,0,3,1037870,"2023-12-01T00:00:00.000Z",19,FALSE,27,38017649,"F",27,27,"San Antonio Spurs","Julian Champagnie",0,17,20,15,8,19.5
1,0,2,1,0,4,1,0,0,"11",0,2,2,2,0,0,1037870,"2023-12-01T00:00:00.000Z",19,FALSE,27,38017677,"G",19,19,"New Orleans Pelicans","Dyson Daniels",0,4,5,3,3,5.9
0,0,0,2,1,3,1,0,0,"15",0,1,3,0,0,1,1037870,"2023-12-01T00:00:00.000Z",19,FALSE,27,56677837,"G",19,19,"New Orleans Pelicans","Jordan Hawkins",0,3,3,3,0,2
0,0,0,0,0,0,0,0,0,"00",0,0,0,0,0,0,1037870,"2023-12-01T00:00:00.000Z",19,FALSE,27,3547260,"G",19,19,"New Orleans Pelicans","Kira Lewis Jr.",0,0,0,0,0,0
0,0,4,1,1,4,3,3,3,"19",2,1,10,6,0,2,1037870,"2023-12-01T00:00:00.000Z",19,FALSE,27,3547293,"F",19,19,"New Orleans Pelicans","Naji Marshall",0,16,16,10,6,15.2
1,1,2,10,4,13,7,0,0,"22",1,0,18,3,1,0,1037870,"2023-12-01T00:00:00.000Z",19,FALSE,27,18677986,"F",19,19,"New Orleans Pelicans","Trey Murphy III",2,21,22,19,4,29.1
1,0,2,0,0,0,0,2,2,"13",1,1,2,3,0,0,1037870,"2023-12-01T00:00:00.000Z",19,FALSE,27,491,"C",19,19,"New Orleans Pelicans","Cody Zeller",0,5,6,3,4,7.1
0,0,0,0,0,0,0,0,0,"00",0,0,0,0,0,0,1037870,"2023-12-01T00:00:00.000Z",19,FALSE,27,38017663,"F",19,19,"New Orleans Pelicans","E.J. Liddell",0,0,0,0,0,0
0,0,0,0,0,0,0,0,0,"00",0,0,0,0,0,0,1037870,"2023-12-01T00:00:00.000Z",19,FALSE,27,340,"F",19,19,"New Orleans Pelicans","Larry Nance Jr.",0,0,0,0,0,0
0,0,0,0,0,0,0,0,0,"00",0,0,0,0,0,0,1037870,"2023-12-01T00:00:00.000Z",19,FALSE,27,17896021,"F",19,19,"New Orleans Pelicans","Jeremiah Robinson-Earl",0,0,0,0,0,0
0,0,0,0,0,0,0,0,0,"00",0,0,0,0,0,0,1037870,"2023-12-01T00:00:00.000Z",19,FALSE,27,17896017,"F",19,19,"New Orleans Pelicans","Matt Ryan",0,0,0,0,0,0
3,0,6,3,1,7,4,2,2,"33",1,2,11,7,1,2,1037870,"2023-12-01T00:00:00.000Z",19,FALSE,27,666682,"F",27,27,"San Antonio Spurs","Keldon Johnson",1,18,21,14,10,24.9
3,1,2,5,1,11,3,6,5,"24",3,2,12,5,2,3,1037870,"2023-12-01T00:00:00.000Z",19,FALSE,27,102,"F-C",27,27,"San Antonio Spurs","Zach Collins",3,17,20,15,8,28.5
0,0,2,3,2,7,4,0,0,"22",0,1,10,2,0,3,1037870,"2023-12-01T00:00:00.000Z",19,FALSE,27,38017692,"F",27,27,"San Antonio Spurs","Malaki Branham",0,12,12,10,2,9.4
4,0,3,4,2,13,4,4,3,"31",0,2,13,3,0,2,1037870,"2023-12-01T00:00:00.000Z",19,FALSE,27,38017699,"F",27,27,"San Antonio Spurs","Jeremy Sochan",0,16,20,17,7,20.6
3,3,10,0,0,4,4,0,0,"19",1,4,8,11,0,1,1037870,"2023-12-01T00:00:00.000Z",19,FALSE,27,17895854,"G",27,27,"San Antonio Spurs","Charles Bassey",3,19,22,11,14,33.7
3,0,2,4,2,9,4,0,0,"23",1,1,10,3,0,2,1037870,"2023-12-01T00:00:00.000Z",19,FALSE,27,3547274,"G",27,27,"San Antonio Spurs","Tre Jones",0,13,16,13,6,16.1
1,0,0,2,1,2,1,0,0,"06",0,1,3,0,0,0,1037870,"2023-12-01T00:00:00.000Z",19,FALSE,27,17896059,"F",27,27,"San Antonio Spurs","Sandro Mamukelashvili",0,3,4,4,1,4.5
5,1,2,5,2,9,4,2,1,"27",0,3,11,2,0,0,1037870,"2023-12-01T00:00:00.000Z",19,FALSE,27,359,"F",27,27,"San Antonio Spurs","Cedi Osman",1,13,18,16,7,23.9
1,0,0,7,2,12,5,2,2,"27",0,2,14,0,2,3,1037870,"2023-12-01T00:00:00.000Z",19,FALSE,27,3547246,"G-F",27,27,"San Antonio Spurs","Devin Vassell",2,14,15,15,1,18.5
0,0,0,0,0,0,0,0,0,"00",0,0,0,0,0,0,1037870,"2023-12-01T00:00:00.000Z",19,FALSE,27,305,"F",27,27,"San Antonio Spurs","Doug McDermott",0,0,0,0,0,0
0,0,0,0,0,0,0,0,0,"00",0,0,0,0,0,0,1037870,"2023-12-01T00:00:00.000Z",19,FALSE,27,56677870,"G",27,27,"San Antonio Spurs","Sir'Jabari Rice",0,0,0,0,0,0
0,0,0,0,0,0,0,0,0,"00",0,0,0,0,0,0,1037870,"2023-12-01T00:00:00.000Z",19,FALSE,27,56677822,"F-C",27,27,"San Antonio Spurs","Victor Wembanyama",0,0,0,0,0,0
0,0,0,0,0,1,1,0,0,"03",0,0,2,0,0,0,1037870,"2023-12-01T00:00:00.000Z",19,FALSE,27,38017730,"F",27,27,"San Antonio Spurs","Dominick Barlow",0,2,2,2,0,2
0,0,0,0,0,0,0,0,0,"00",0,0,0,0,0,0,1037870,"2023-12-01T00:00:00.000Z",19,FALSE,27,180,"G",27,27,"San Antonio Spurs","Devonte' Graham",0,0,0,0,0,0
2,0,0,0,0,0,0,0,0,"03",0,0,0,0,0,0,1037870,"2023-12-01T00:00:00.000Z",19,FALSE,27,38017693,"G",27,27,"San Antonio Spurs","Blake Wesley",0,0,2,2,2,3
0,0,0,0,0,0,0,0,0,"00",0,0,0,0,0,0,1037870,"2023-12-01T00:00:00.000Z",19,FALSE,27,56677865,"C",27,27,"San Antonio Spurs","Charles Bediako",0,0,0,0,0,0
0,0,0,0,0,0,0,0,0,"00",0,0,0,0,0,0,1037870,"2023-12-01T00:00:00.000Z",19,FALSE,27,56677817,"G",27,27,"San Antonio Spurs","Sidy Cissoko",0,0,0,0,0,0
5,1,4,8,1,12,3,0,0,"35",1,2,7,5,0,2,1037881,"2023-12-02T00:00:00.000Z",29,FALSE,25,38017739,"F",29,29,"Utah Jazz","Simone Fontecchio",1,12,17,12,10,21.5
3,3,7,4,1,14,6,6,5,"35",2,2,18,9,1,2,1037881,"2023-12-02T00:00:00.000Z",29,FALSE,25,101,"F-C",29,29,"Utah Jazz","John Collins",4,27,30,21,12,43.3
4,1,11,1,0,8,4,1,1,"27",4,3,9,15,1,1,1037881,"2023-12-02T00:00:00.000Z",29,FALSE,25,11891374,"C",29,29,"Utah Jazz","Omer Yurtseven",2,24,28,13,19,38
0,0,2,0,0,4,3,0,0,"26",0,2,6,2,0,2,1037881,"2023-12-02T00:00:00.000Z",29,FALSE,25,38017620,"G",29,29,"Utah Jazz","Ochai Agbaji",0,8,8,6,2,6.4
6,0,4,8,1,17,7,8,5,"36",2,2,20,6,0,4,1037881,"2023-12-02T00:00:00.000Z",29,FALSE,25,56677834,"G",29,29,"Utah Jazz","Keyonte George",0,26,32,26,12,32.2
0,2,1,4,1,7,2,0,0,"18",1,1,5,2,0,0,1037881,"2023-12-02T00:00:00.000Z",29,FALSE,25,56677824,"F",29,29,"Utah Jazz","Taylor Hendricks",2,7,7,5,2,13.4
4,0,2,5,3,8,5,2,1,"21",0,3,14,2,3,1,1037881,"2023-12-02T00:00:00.000Z",29,FALSE,25,666650,"G",29,29,"Utah Jazz","Talen Horton-Tucker",3,16,20,18,6,30.4
0,0,0,0,0,0,0,0,0,"00",0,0,0,0,0,0,1037881,"2023-12-02T00:00:00.000Z",29,FALSE,25,38017630,"G",29,29,"Utah Jazz","Johnny Juzang",0,0,0,0,0,0
0,2,4,0,0,6,6,0,0,"25",4,1,12,8,0,2,1037881,"2023-12-02T00:00:00.000Z",29,FALSE,25,38017705,"C",29,29,"Utah Jazz","Walker Kessler",2,20,20,12,8,25.6
0,0,0,0,0,0,0,0,0,"00",0,0,0,0,0,0,1037881,"2023-12-02T00:00:00.000Z",29,FALSE,25,19465584,"F",29,29,"Utah Jazz","Micah Potter",0,0,0,0,0,0
0,1,2,2,0,5,1,0,0,"12",1,3,2,3,0,0,1037881,"2023-12-02T00:00:00.000Z",29,FALSE,25,666881,"F",29,29,"Utah Jazz","Luka Samanic",1,5,5,2,3,8.6
0,0,0,0,0,0,0,0,0,"00",0,0,0,0,0,0,1037881,"2023-12-02T00:00:00.000Z",29,FALSE,25,139,"G",29,29,"Utah Jazz","Kris Dunn",0,0,0,0,0,0
0,0,0,0,0,0,0,0,0,"00",0,0,0,0,0,0,1037881,"2023-12-02T00:00:00.000Z",29,FALSE,25,297,"F",29,29,"Utah Jazz","Lauri Markkanen",0,0,0,0,0,0
0,0,0,0,0,0,0,0,0,"00",0,0,0,0,0,0,1037881,"2023-12-02T00:00:00.000Z",29,FALSE,25,358,"F",29,29,"Utah Jazz","Kelly Olynyk",0,0,0,0,0,0
0,1,1,3,0,8,4,0,0,"30",2,4,8,3,4,0,1037881,"2023-12-02T00:00:00.000Z",29,FALSE,25,56677850,"F",25,25,"Portland Trail Blazers","Toumani Camara",5,11,11,8,3,26.6
0,1,3,5,0,9,1,7,7,"26",0,2,9,3,0,3,1037881,"2023-12-02T00:00:00.000Z",29,FALSE,25,182,"F",25,25,"Portland Trail Blazers","Jerami Grant",1,12,12,9,3,12.6
0,0,10,0,0,8,4,2,2,"35",1,3,10,11,0,0,1037881,"2023-12-02T00:00:00.000Z",29,FALSE,25,22,"C",25,25,"Portland Trail Blazers","Deandre Ayton",0,21,21,10,11,23.2
4,0,3,8,3,20,9,4,4,"44",2,5,25,5,2,0,1037881,"2023-12-02T00:00:00.000Z",29,FALSE,25,38017690,"G",25,25,"Portland Trail Blazers","Shaedon Sharpe",2,30,34,29,9,43
6,1,2,9,5,17,8,6,4,"38",1,0,25,3,2,3,1037881,"2023-12-02T00:00:00.000Z",29,FALSE,25,65,"G",25,25,"Portland Trail Blazers","Malcolm Brogdon",3,28,34,31,9,43.6
3,0,3,5,2,15,6,4,3,"21",2,5,17,5,1,2,1037881,"2023-12-02T00:00:00.000Z",29,FALSE,25,56677747,"G",25,25,"Portland Trail Blazers","Scoot Henderson",1,22,25,20,8,28.5
1,0,4,2,0,5,1,2,2,"24",2,0,4,6,1,1,1037881,"2023-12-02T00:00:00.000Z",29,FALSE,25,38017711,"F",25,25,"Portland Trail Blazers","Jabari Walker",1,10,11,5,7,14.7
0,0,0,0,0,0,0,0,0,"00",0,0,0,0,0,0,1037881,"2023-12-02T00:00:00.000Z",29,FALSE,25,47957121,"F",25,25,"Portland Trail Blazers","Justin Minaya",0,0,0,0,0,0
0,0,0,0,0,0,0,0,0,"00",0,0,0,0,0,0,1037881,"2023-12-02T00:00:00.000Z",29,FALSE,25,56677829,"G-F",25,25,"Portland Trail Blazers","Rayan Rupert",0,0,0,0,0,0
0,0,0,0,0,0,0,0,0,"00",0,0,0,0,0,0,1037881,"2023-12-02T00:00:00.000Z",29,FALSE,25,419,"G",25,25,"Portland Trail Blazers","Anfernee Simons",0,0,0,0,0,0
0,0,0,0,0,0,0,0,0,"00",0,0,0,0,0,0,1037881,"2023-12-02T00:00:00.000Z",29,FALSE,25,17896120,"F",25,25,"Portland Trail Blazers","Ish Wainright",0,0,0,0,0,0
0,0,0,0,0,0,0,0,0,"00",0,0,0,0,0,0,1037881,"2023-12-02T00:00:00.000Z",29,FALSE,25,476,"C-F",25,25,"Portland Trail Blazers","Robert Williams III",0,0,0,0,0,0
0,0,0,0,0,0,0,0,0,"00",0,0,0,0,0,0,1037881,"2023-12-02T00:00:00.000Z",29,FALSE,25,56677842,"F",29,29,"Utah Jazz","Brice Sensabaugh",0,0,0,0,0,0
5,0,3,2,0,13,9,7,7,"30",1,2,25,4,0,3,1037881,"2023-12-02T00:00:00.000Z",29,FALSE,25,413,"G",29,29,"Utah Jazz","Collin Sexton",0,29,34,30,9,34.3
0,0,0,0,0,0,0,0,0,"00",0,0,0,0,0,0,1037881,"2023-12-02T00:00:00.000Z",29,FALSE,25,17896023,"G",29,29,"Utah Jazz","Josh Christopher",0,0,0,0,0,0
0,0,0,0,0,0,0,0,0,"00",0,0,0,0,0,0,1037881,"2023-12-02T00:00:00.000Z",29,FALSE,25,100,"G",29,29,"Utah Jazz","Jordan Clarkson",0,0,0,0,0,0
0,0,0,0,0,0,0,0,0,"00",0,0,0,0,0,0,1037881,"2023-12-02T00:00:00.000Z",29,FALSE,25,666476,"C",25,25,"Portland Trail Blazers","Moses Brown",0,0,0,0,0,0
0,0,0,0,0,0,0,0,0,"00",0,0,0,0,0,0,1037881,"2023-12-02T00:00:00.000Z",29,FALSE,25,3547289,"G",25,25,"Portland Trail Blazers","Skylar Mays",0,0,0,0,0,0
0,0,0,0,0,0,0,0,0,"00",0,0,0,0,0,0,1037881,"2023-12-02T00:00:00.000Z",29,FALSE,25,56677791,"F",25,25,"Portland Trail Blazers","Kris Murray",0,0,0,0,0,0
0,0,0,0,0,0,0,0,0,"00",0,0,0,0,0,0,1037881,"2023-12-02T00:00:00.000Z",29,FALSE,25,39613724,"C",25,25,"Portland Trail Blazers","Ibou Badji",0,0,0,0,0,0
2,2,3,4,2,5,2,0,0,"33",0,1,6,3,1,0,1037881,"2023-12-02T00:00:00.000Z",29,FALSE,25,666923,"G-F",25,25,"Portland Trail Blazers","Matisse Thybulle",3,9,11,8,5,21.6
1,0,0,4,1,8,3,2,2,"14",1,0,9,1,0,0,1037881,"2023-12-02T00:00:00.000Z",29,FALSE,25,56783340,"C",25,25,"Portland Trail Blazers","Duop Reath",0,10,11,10,2,11.7
3,0,6,1,1,11,6,1,0,"33",0,2,13,6,2,2,1037875,"2023-12-02T00:00:00.000Z",9,FALSE,6,3547241,"G",9,9,"Detroit Pistons","Killian Hayes",2,19,22,16,9,28.7
5,0,6,5,1,9,4,2,2,"30",1,0,11,7,2,3,1037875,"2023-12-02T00:00:00.000Z",9,FALSE,6,3547267,"F-C",9,9,"Detroit Pistons","Isaiah Stewart",2,18,23,16,12,29.9
1,2,7,0,0,8,8,6,1,"30",4,3,17,11,1,2,1037875,"2023-12-02T00:00:00.000Z",9,FALSE,6,38017694,"C",9,9,"Detroit Pistons","Jalen Duren",3,28,29,18,12,38.7
1,0,2,3,0,7,2,4,3,"29",0,3,7,2,0,1,1037875,"2023-12-02T00:00:00.000Z",9,FALSE,6,38017682,"G",9,9,"Detroit Pistons","Jaden Ivey",0,9,10,8,3,9.9
11,0,8,6,3,20,8,4,4,"37",0,3,23,8,3,1,1037875,"2023-12-02T00:00:00.000Z",9,FALSE,6,17896075,"G-F",9,9,"Detroit Pistons","Cade Cunningham",3,31,42,34,19,57.1
0,0,2,0,0,1,0,0,0,"07",1,1,0,3,1,0,1037875,"2023-12-02T00:00:00.000Z",9,FALSE,6,24,"F",9,9,"Detroit Pistons","Marvin Bagley III",1,3,3,0,3,6.6
2,0,1,9,3,15,7,6,5,"28",1,1,22,2,1,1,1037875,"2023-12-02T00:00:00.000Z",9,FALSE,6,54,"F",9,9,"Detroit Pistons","Bojan Bogdanovic",1,24,26,24,4,29.4
0,0,0,0,0,0,0,0,0,"00",0,0,0,0,0,0,1037875,"2023-12-02T00:00:00.000Z",9,FALSE,6,77,"G",9,9,"Detroit Pistons","Alec Burks",0,0,0,0,0,0
0,0,0,0,0,0,0,0,0,"00",0,0,0,0,0,0,1037875,"2023-12-02T00:00:00.000Z",9,FALSE,6,259,"F",9,9,"Detroit Pistons","Kevin Knox",0,0,0,0,0,0
0,0,0,1,0,1,0,0,0,"14",0,1,0,0,0,2,1037875,"2023-12-02T00:00:00.000Z",9,FALSE,6,17896071,"F",9,9,"Detroit Pistons","Isaiah Livers",0,0,0,0,0,-2
1,0,2,2,0,5,2,0,0,"16",0,1,4,2,0,2,1037875,"2023-12-02T00:00:00.000Z",9,FALSE,6,56677792,"G",9,9,"Detroit Pistons","Marcus Sasser",0,6,7,5,3,5.9
0,0,4,2,0,6,2,0,0,"16",3,5,4,7,0,2,1037875,"2023-12-02T00:00:00.000Z",9,FALSE,6,56677826,"G-F",9,9,"Detroit Pistons","Ausar Thompson",0,11,11,4,7,10.4
0,0,0,0,0,0,0,0,0,"00",0,0,0,0,0,0,1037875,"2023-12-02T00:00:00.000Z",9,FALSE,6,56677729,"G",9,9,"Detroit Pistons","Malcolm Cazalon",0,0,0,0,0,0
0,0,0,0,0,0,0,0,0,"00",0,0,0,0,0,0,1037875,"2023-12-02T00:00:00.000Z",9,FALSE,6,197,"F-G",9,9,"Detroit Pistons","Joe Harris",0,0,0,0,0,0
0,0,0,0,0,0,0,0,0,"00",0,0,0,0,0,0,1037875,"2023-12-02T00:00:00.000Z",9,FALSE,6,330,"G",9,9,"Detroit Pistons","Monte Morris",0,0,0,0,0,0
0,0,0,0,0,0,0,0,0,"00",0,0,0,0,0,0,1037875,"2023-12-02T00:00:00.000Z",9,FALSE,6,42097199,"G",9,9,"Detroit Pistons","Jared Rhoden",0,0,0,0,0,0
5,0,5,10,4,16,9,0,0,"38",0,4,22,5,1,1,1037875,"2023-12-02T00:00:00.000Z",9,FALSE,6,666908,"G",6,6,"Cleveland Cavaliers","Max Strus",1,27,32,27,10,37.5
0,0,0,0,0,0,0,0,0,"00",0,0,0,0,0,0,1037875,"2023-12-02T00:00:00.000Z",9,FALSE,6,3547240,"C",9,9,"Detroit Pistons","James Wiseman",0,0,0,0,0,0
1,0,9,0,0,5,2,3,2,"36",1,3,6,10,0,2,1037875,"2023-12-02T00:00:00.000Z",9,FALSE,6,17896076,"F-C",6,6,"Cleveland Cavaliers","Evan Mobley",0,16,17,7,11,17.5
1,0,7,0,0,9,8,5,3,"34",5,2,19,12,1,2,1037875,"2023-12-02T00:00:00.000Z",9,FALSE,6,9,"C",6,6,"Cleveland Cavaliers","Jarrett Allen",1,31,32,20,13,35.9
6,1,1,7,2,23,9,3,2,"34",0,1,22,1,3,2,1037875,"2023-12-02T00:00:00.000Z",9,FALSE,6,666581,"G",6,6,"Cleveland Cavaliers","Darius Garland",4,23,29,28,7,42.2
4,0,2,5,2,19,7,5,4,"33",1,2,20,3,2,4,1037875,"2023-12-02T00:00:00.000Z",9,FALSE,6,322,"G",6,6,"Cleveland Cavaliers","Donovan Mitchell",2,23,27,24,7,31.6
4,0,7,3,1,6,4,0,0,"33",0,3,9,7,4,1,1037875,"2023-12-02T00:00:00.000Z",9,FALSE,6,3547247,"F-G",6,6,"Cleveland Cavaliers","Isaac Okoro",4,16,20,13,11,34.4
2,0,3,4,1,8,5,2,1,"22",0,1,12,3,0,0,1037875,"2023-12-02T00:00:00.000Z",9,FALSE,6,344,"F",6,6,"Cleveland Cavaliers","Georges Niang",0,15,17,14,5,18.6
0,0,0,0,0,0,0,0,0,"04",0,1,0,0,0,0,1037875,"2023-12-02T00:00:00.000Z",9,FALSE,6,56677872,"G",6,6,"Cleveland Cavaliers","Craig Porter",0,0,0,0,0,0
0,0,0,0,0,0,0,0,0,"00",0,0,0,0,0,0,1037875,"2023-12-02T00:00:00.000Z",9,FALSE,6,248,"C",6,6,"Cleveland Cavaliers","Damian Jones",0,0,0,0,0,0
0,0,0,0,0,0,0,0,0,"00",0,0,0,0,0,0,1037875,"2023-12-02T00:00:00.000Z",9,FALSE,6,277,"G",6,6,"Cleveland Cavaliers","Caris LeVert",0,0,0,0,0,0
1,0,0,1,0,1,0,0,0,"03",0,1,0,0,0,0,1037875,"2023-12-02T00:00:00.000Z",9,FALSE,6,3547299,"G",6,6,"Cleveland Cavaliers","Sam Merrill",0,0,1,1,1,1.5
0,0,0,0,0,0,0,0,0,"00",0,0,0,0,0,0,1037875,"2023-12-02T00:00:00.000Z",9,FALSE,6,38017662,"F",6,6,"Cleveland Cavaliers","Isaiah Mobley",0,0,0,0,0,0
0,0,0,0,0,0,0,0,0,"00",0,0,0,0,0,0,1037875,"2023-12-02T00:00:00.000Z",9,FALSE,6,44477024,"G",9,9,"Detroit Pistons","Stanley Umude",0,0,0,0,0,0
0,0,1,0,0,1,0,0,0,"03",1,0,0,2,0,0,1037875,"2023-12-02T00:00:00.000Z",9,FALSE,6,444,"C-F",6,6,"Cleveland Cavaliers","Tristan Thompson",0,2,2,0,2,2.4
0,0,0,0,0,0,0,0,0,"00",0,0,0,0,0,0,1037875,"2023-12-02T00:00:00.000Z",9,FALSE,6,56677847,"F",6,6,"Cleveland Cavaliers","Emoni Bates",0,0,0,0,0,0
0,0,0,0,0,0,0,0,0,"00",0,0,0,0,0,0,1037875,"2023-12-02T00:00:00.000Z",9,FALSE,6,666676,"G",6,6,"Cleveland Cavaliers","Ty Jerome",0,0,0,0,0,0
0,0,0,0,0,0,0,0,0,"00",0,0,0,0,0,0,1037875,"2023-12-02T00:00:00.000Z",9,FALSE,6,404,"G",6,6,"Cleveland Cavaliers","Ricky Rubio",0,0,0,0,0,0
0,0,0,0,0,0,0,0,0,"00",0,0,0,0,0,0,1037875,"2023-12-02T00:00:00.000Z",9,FALSE,6,666940,"F",6,6,"Cleveland Cavaliers","Dean Wade",0,0,0,0,0,0
5,0,3,1,0,23,12,9,9,"37",2,1,33,5,0,1,1037876,"2023-12-02T00:00:00.000Z",16,FALSE,12,79,"G-F",16,16,"Miami Heat","Jimmy Butler",0,38,43,38,10,45.5
0,0,0,1,0,1,0,0,0,"03",0,1,0,0,0,1,1037876,"2023-12-02T00:00:00.000Z",16,FALSE,12,3092,"",16,16,"Miami Heat","Haywood Highsmith",0,0,0,0,0,-1
3,0,4,2,2,11,7,0,0,"29",1,1,16,5,0,1,1037876,"2023-12-02T00:00:00.000Z",16,FALSE,12,39398582,"C",16,16,"Miami Heat","Orlando Robinson",0,21,24,19,8,25.5
3,0,1,3,2,11,7,1,1,"30",1,6,17,2,0,2,1037876,"2023-12-02T00:00:00.000Z",16,FALSE,12,397,"F",16,16,"Miami Heat","Duncan Robinson",0,19,22,20,5,21.9
2,0,7,3,0,4,0,4,4,"29",1,2,4,8,0,0,1037876,"2023-12-02T00:00:00.000Z",16,FALSE,12,286,"G",16,16,"Miami Heat","Kyle Lowry",0,12,14,6,10,16.6
0,0,0,0,0,0,0,0,0,"00",0,0,0,0,0,0,1037876,"2023-12-02T00:00:00.000Z",16,FALSE,12,74,"C",16,16,"Miami Heat","Thomas Bryant",0,0,0,0,0,0
0,0,0,0,0,0,0,0,0,"05",0,2,0,0,0,0,1037876,"2023-12-02T00:00:00.000Z",16,FALSE,12,38017734,"F",16,16,"Miami Heat","Jamal Cain",0,0,0,0,0,0
3,0,3,2,1,9,4,5,2,"29",0,1,11,3,2,0,1037876,"2023-12-02T00:00:00.000Z",16,FALSE,12,56677785,"G",16,16,"Miami Heat","Jaime Jaquez Jr.",2,14,17,14,6,25.1
0,0,0,0,0,0,0,0,0,"00",0,0,0,0,0,0,1037876,"2023-12-02T00:00:00.000Z",16,FALSE,12,38017696,"F",16,16,"Miami Heat","Nikola Jovic",0,0,0,0,0,0
0,0,0,0,0,0,0,0,0,"00",0,0,0,0,0,0,1037876,"2023-12-02T00:00:00.000Z",16,FALSE,12,38017736,"F",16,16,"Miami Heat","Cole Swider",0,0,0,0,0,0
2,0,1,4,1,7,3,0,0,"24",0,3,7,1,2,1,1037876,"2023-12-02T00:00:00.000Z",16,FALSE,12,210,"G",12,12,"Indiana Pacers","Buddy Hield",2,8,10,9,3,16.2
2,4,2,5,4,8,7,4,4,"35",0,5,22,2,1,0,1037876,"2023-12-02T00:00:00.000Z",16,FALSE,12,3547243,"F",12,12,"Indiana Pacers","Obi Toppin",5,24,26,24,4,42.4
1,2,8,4,1,12,8,0,0,"30",2,4,17,10,0,2,1037876,"2023-12-02T00:00:00.000Z",16,FALSE,12,452,"C-F",12,12,"Indiana Pacers","Myles Turner",2,27,28,18,11,34.5
2,0,4,6,4,16,11,5,4,"37",0,0,30,4,0,1,1037876,"2023-12-02T00:00:00.000Z",16,FALSE,12,69,"G",12,12,"Indiana Pacers","Bruce Brown",0,34,36,32,6,36.8
11,0,1,4,0,9,1,2,2,"23",0,1,4,1,1,0,1037876,"2023-12-02T00:00:00.000Z",16,FALSE,12,38017507,"G-F",12,12,"Indiana Pacers","Andrew Nembhard",1,5,16,15,12,24.7
1,1,3,0,0,3,3,2,2,"08",0,1,8,3,0,0,1037876,"2023-12-02T00:00:00.000Z",16,FALSE,12,17896035,"F",12,12,"Indiana Pacers","Isaiah Jackson",1,11,12,9,4,16.1
4,0,4,3,2,10,6,3,2,"25",1,4,16,5,0,4,1037876,"2023-12-02T00:00:00.000Z",16,FALSE,12,38017686,"G-F",12,12,"Indiana Pacers","Bennedict Mathurin",0,21,25,20,9,24
11,0,2,0,0,11,10,0,0,"25",0,0,20,2,0,1,1037876,"2023-12-02T00:00:00.000Z",16,FALSE,12,304,"G",12,12,"Indiana Pacers","T.J. McConnell",0,22,33,31,13,37.9
1,1,4,6,4,9,7,4,2,"29",0,4,20,4,0,0,1037876,"2023-12-02T00:00:00.000Z",16,FALSE,12,3547250,"G-F",12,12,"Indiana Pacers","Aaron Nesmith",1,24,25,21,5,29.3
0,0,0,0,0,0,0,0,0,"00",0,0,0,0,0,0,1037876,"2023-12-02T00:00:00.000Z",16,FALSE,12,3547207,"F",12,12,"Indiana Pacers","Jordan Nwora",0,0,0,0,0,0
5,0,1,5,3,6,4,3,3,"19",0,4,14,1,0,0,1037876,"2023-12-02T00:00:00.000Z",16,FALSE,12,285,"F-C",16,16,"Miami Heat","Kevin Love",0,15,20,19,6,22.7
3,0,1,4,2,15,8,0,0,"35",1,3,18,2,1,3,1037876,"2023-12-02T00:00:00.000Z",16,FALSE,12,666747,"F",16,16,"Miami Heat","Caleb Martin",1,20,23,21,5,24.9
3,1,2,4,2,9,6,2,2,"24",0,1,16,2,0,2,1037876,"2023-12-02T00:00:00.000Z",16,FALSE,12,391,"G-F",16,16,"Miami Heat","Josh Richardson",1,18,21,19,5,23.9
0,0,0,0,0,0,0,0,0,"00",0,0,0,0,0,0,1037876,"2023-12-02T00:00:00.000Z",16,FALSE,12,4,"C-F",16,16,"Miami Heat","Bam Adebayo",0,0,0,0,0,0
0,0,0,0,0,0,0,0,0,"00",0,0,0,0,0,0,1037876,"2023-12-02T00:00:00.000Z",16,FALSE,12,3547257,"G",16,16,"Miami Heat","R.J. Hampton",0,0,0,0,0,0
0,0,0,0,0,0,0,0,0,"00",0,0,0,0,0,0,1037876,"2023-12-02T00:00:00.000Z",16,FALSE,12,666633,"G",16,16,"Miami Heat","Tyler Herro",0,0,0,0,0,0
0,0,0,0,0,0,0,0,0,"00",0,0,0,0,0,0,1037876,"2023-12-02T00:00:00.000Z",16,FALSE,12,19465585,"G",16,16,"Miami Heat","Dru Smith",0,0,0,0,0,0
0,0,0,0,0,0,0,0,0,"04",0,2,0,0,0,0,1037876,"2023-12-02T00:00:00.000Z",16,FALSE,12,56677861,"G",12,12,"Indiana Pacers","Ben Sheppard",0,0,0,0,0,0
0,0,0,0,0,0,0,0,0,"00",0,0,0,0,0,0,1037876,"2023-12-02T00:00:00.000Z",16,FALSE,12,56677778,"F-C",12,12,"Indiana Pacers","Oscar Tshiebwe",0,0,0,0,0,0
0,0,0,0,0,0,0,0,0,"00",0,0,0,0,0,0,1037876,"2023-12-02T00:00:00.000Z",16,FALSE,12,56677832,"F",12,12,"Indiana Pacers","Jarace Walker",0,0,0,0,0,0
0,0,0,0,0,0,0,0,0,"00",0,0,0,0,0,0,1037876,"2023-12-02T00:00:00.000Z",16,FALSE,12,38017701,"G",12,12,"Indiana Pacers","Kendall Brown",0,0,0,0,0,0
0,0,0,0,0,0,0,0,0,"00",0,0,0,0,0,0,1037876,"2023-12-02T00:00:00.000Z",16,FALSE,12,3547245,"G",12,12,"Indiana Pacers","Tyrese Haliburton",0,0,0,0,0,0
0,0,0,0,0,0,0,0,0,"00",0,0,0,0,0,0,1037876,"2023-12-02T00:00:00.000Z",16,FALSE,12,3547264,"F-C",12,12,"Indiana Pacers","Jalen Smith",0,0,0,0,0,0
0,0,0,0,0,0,0,0,0,"00",0,0,0,0,0,0,1037876,"2023-12-02T00:00:00.000Z",16,FALSE,12,56677794,"G",12,12,"Indiana Pacers","Isaiah Wong",0,0,0,0,0,0
10,0,5,4,2,18,10,2,2,"40",0,3,24,5,0,2,1037877,"2023-12-02T00:00:00.000Z",5,FALSE,19,125,"G",5,5,"Chicago Bulls","DeMar DeRozan",0,29,39,34,15,43
2,2,3,5,1,11,6,4,1,"29",1,3,14,4,2,1,1037877,"2023-12-02T00:00:00.000Z",5,FALSE,19,3547248,"F",5,5,"Chicago Bulls","Patrick Williams",4,18,20,16,6,32.8
4,3,4,5,0,12,3,0,0,"33",3,1,6,7,0,1,1037877,"2023-12-02T00:00:00.000Z",5,FALSE,19,460,"C",5,5,"Chicago Bulls","Nikola Vucevic",3,13,17,10,11,28.4
2,1,2,4,2,5,3,0,0,"12",0,2,8,2,0,1,1037877,"2023-12-02T00:00:00.000Z",5,FALSE,19,89,"G",5,5,"Chicago Bulls","Alex Caruso",1,10,12,10,4,15.4
0,0,0,0,0,1,1,0,0,"04",0,0,2,0,1,0,1037877,"2023-12-02T00:00:00.000Z",5,FALSE,19,56677857,"F",5,5,"Chicago Bulls","Julian Phillips",1,2,2,2,0,5
0,0,0,0,0,0,0,0,0,"00",0,0,0,0,0,0,1037877,"2023-12-02T00:00:00.000Z",5,FALSE,19,17896116,"G",5,5,"Chicago Bulls","Terry Taylor",0,0,0,0,0,0
0,0,0,0,0,0,0,0,0,"00",0,0,0,0,0,0,1037877,"2023-12-02T00:00:00.000Z",5,FALSE,19,38017719,"F",5,5,"Chicago Bulls","Dalen Terry",0,0,0,0,0,0
0,0,0,0,0,0,0,0,0,"00",0,0,0,0,0,0,1037877,"2023-12-02T00:00:00.000Z",5,FALSE,19,27,"G",5,5,"Chicago Bulls","Lonzo Ball",0,0,0,0,0,0
0,0,0,0,0,0,0,0,0,"00",0,0,0,0,0,0,1037877,"2023-12-02T00:00:00.000Z",5,FALSE,19,56677874,"F",5,5,"Chicago Bulls","Onuralp Bitim",0,0,0,0,0,0
0,0,0,0,0,0,0,0,0,"00",0,0,0,0,0,0,1037877,"2023-12-02T00:00:00.000Z",5,FALSE,19,268,"G",5,5,"Chicago Bulls","Zach LaVine",0,0,0,0,0,0
0,0,0,0,0,0,0,0,0,"00",0,0,0,0,0,0,1037877,"2023-12-02T00:00:00.000Z",5,FALSE,19,45969255,"F",5,5,"Chicago Bulls","Justin Lewis",0,0,0,0,0,0
0,0,0,0,0,0,0,0,0,"00",0,0,0,0,0,0,1037877,"2023-12-02T00:00:00.000Z",5,FALSE,19,56677860,"F",5,5,"Chicago Bulls","Adama Sanogo",0,0,0,0,0,0
6,0,6,0,0,15,10,6,3,"36",0,1,23,6,3,2,1037877,"2023-12-02T00:00:00.000Z",5,FALSE,19,227,"F",19,19,"New Orleans Pelicans","Brandon Ingram",3,29,35,29,12,46.2
3,0,3,0,0,15,10,9,7,"30",2,3,27,5,1,5,1037877,"2023-12-02T00:00:00.000Z",5,FALSE,19,666969,"F",19,19,"New Orleans Pelicans","Zion Williamson",1,32,35,30,8,35.5
1,0,8,4,2,11,6,2,1,"36",2,3,15,10,0,0,1037877,"2023-12-02T00:00:00.000Z",5,FALSE,19,455,"C",19,19,"New Orleans Pelicans","Jonas Valanciunas",0,25,26,16,11,28.5
4,1,3,4,0,11,4,10,9,"35",4,1,17,7,3,2,1037877,"2023-12-02T00:00:00.000Z",5,FALSE,19,17896024,"F",19,19,"New Orleans Pelicans","Herbert Jones",4,24,28,21,11,41.4
2,0,2,3,1,5,3,0,0,"22",0,2,7,2,1,1,1037877,"2023-12-02T00:00:00.000Z",5,FALSE,19,38017677,"G",19,19,"New Orleans Pelicans","Dyson Daniels",1,9,11,9,4,14.4
2,0,1,5,2,8,3,0,0,"18",0,0,8,1,0,1,1037877,"2023-12-02T00:00:00.000Z",5,FALSE,19,17896097,"G",19,19,"New Orleans Pelicans","Jose Alvarado",0,9,11,10,3,11.2
0,0,1,5,2,6,2,4,4,"24",0,2,10,1,0,0,1037877,"2023-12-02T00:00:00.000Z",5,FALSE,19,56677837,"G",19,19,"New Orleans Pelicans","Jordan Hawkins",0,11,11,10,1,11.2
6,0,7,13,8,17,10,3,3,"40",2,4,31,9,1,3,1037877,"2023-12-02T00:00:00.000Z",5,FALSE,19,666956,"G",5,5,"Chicago Bulls","Coby White",1,40,46,37,15,50.8
2,0,0,1,0,2,1,0,0,"15",0,1,2,0,0,1,1037877,"2023-12-02T00:00:00.000Z",5,FALSE,19,87,"G",5,5,"Chicago Bulls","Jevon Carter",0,2,4,4,2,4
2,1,3,4,3,6,5,2,2,"19",3,3,15,6,0,1,1037877,"2023-12-02T00:00:00.000Z",5,FALSE,19,110,"F",5,5,"Chicago Bulls","Torrey Craig",1,21,23,17,8,27.2
3,0,0,4,1,9,6,2,2,"33",0,2,15,0,2,2,1037877,"2023-12-02T00:00:00.000Z",5,FALSE,19,17895983,"G",5,5,"Chicago Bulls","Ayo Dosunmu",2,15,18,18,3,23.5
1,1,5,0,0,7,3,2,1,"15",3,2,7,8,0,1,1037877,"2023-12-02T00:00:00.000Z",5,FALSE,19,137,"C",5,5,"Chicago Bulls","Andre Drummond",1,15,16,8,9,20.1
0,0,0,0,0,0,0,0,0,"00",0,0,0,0,0,0,1037877,"2023-12-02T00:00:00.000Z",5,FALSE,19,3547260,"G",19,19,"New Orleans Pelicans","Kira Lewis Jr.",0,0,0,0,0,0
2,0,1,4,1,7,2,2,2,"26",2,3,7,3,1,1,1037877,"2023-12-02T00:00:00.000Z",5,FALSE,19,3547293,"F",19,19,"New Orleans Pelicans","Naji Marshall",1,10,12,9,5,15.6
0,0,0,0,0,0,0,0,0,"01",0,0,0,0,0,0,1037877,"2023-12-02T00:00:00.000Z",5,FALSE,19,17896021,"F",19,19,"New Orleans Pelicans","Jeremiah Robinson-Earl",0,0,0,0,0,0
0,0,0,0,0,0,0,0,0,"00",0,0,0,0,0,0,1037877,"2023-12-02T00:00:00.000Z",5,FALSE,19,38017726,"G",19,19,"New Orleans Pelicans","Dereon Seabron",0,0,0,0,0,0
0,0,1,0,0,4,1,2,2,"12",3,2,4,4,0,0,1037877,"2023-12-02T00:00:00.000Z",5,FALSE,19,491,"C",19,19,"New Orleans Pelicans","Cody Zeller",0,8,8,4,4,8.8
0,0,0,0,0,0,0,0,0,"00",0,0,0,0,0,0,1037877,"2023-12-02T00:00:00.000Z",5,FALSE,19,38017663,"F",19,19,"New Orleans Pelicans","E.J. Liddell",0,0,0,0,0,0
0,0,0,0,0,0,0,0,0,"00",0,0,0,0,0,0,1037877,"2023-12-02T00:00:00.000Z",5,FALSE,19,303,"G",19,19,"New Orleans Pelicans","CJ McCollum",0,0,0,0,0,0
0,0,0,0,0,0,0,0,0,"00",0,0,0,0,0,0,1037877,"2023-12-02T00:00:00.000Z",5,FALSE,19,17896017,"F",19,19,"New Orleans Pelicans","Matt Ryan",0,0,0,0,0,0
0,0,0,0,0,0,0,0,0,"00",0,0,0,0,0,0,1037877,"2023-12-02T00:00:00.000Z",5,FALSE,19,18677986,"F",19,19,"New Orleans Pelicans","Trey Murphy III",0,0,0,0,0,0
0,0,0,0,0,0,0,0,0,"00",0,0,0,0,0,0,1037877,"2023-12-02T00:00:00.000Z",5,FALSE,19,340,"F",19,19,"New Orleans Pelicans","Larry Nance Jr.",0,0,0,0,0,0
3,0,5,4,2,9,5,0,0,"25",0,0,12,5,1,1,1037878,"2023-12-02T00:00:00.000Z",17,FALSE,1,315,"F",17,17,"Milwaukee Bucks","Khris Middleton",1,17,20,15,8,24.5
10,1,9,1,0,20,14,5,4,"36",2,1,32,11,2,5,1037878,"2023-12-02T00:00:00.000Z",17,FALSE,1,15,"F",17,17,"Milwaukee Bucks","Giannis Antetokounmpo",3,43,53,42,21,64.2
4,3,1,4,1,7,3,6,4,"33",1,2,11,2,0,2,1037878,"2023-12-02T00:00:00.000Z",17,FALSE,1,283,"C",17,17,"Milwaukee Bucks","Brook Lopez",3,13,17,15,6,26.4
3,0,3,7,4,11,6,0,0,"39",1,1,16,4,1,2,1037878,"2023-12-02T00:00:00.000Z",17,FALSE,1,38,"G",17,17,"Milwaukee Bucks","Malik Beasley",1,20,23,19,7,26.3
9,0,5,6,3,16,10,2,2,"38",1,3,25,6,1,4,1037878,"2023-12-02T00:00:00.000Z",17,FALSE,1,278,"G",17,17,"Milwaukee Bucks","Damian Lillard",1,31,40,34,15,44.7
0,0,0,0,0,0,0,0,0,"00",0,0,0,0,0,0,1037878,"2023-12-02T00:00:00.000Z",17,FALSE,1,2148,"",17,17,"Milwaukee Bucks","Thanasis Antetokounmpo",0,0,0,0,0,0
2,1,1,1,1,2,1,0,0,"17",0,3,3,1,0,0,1037878,"2023-12-02T00:00:00.000Z",17,FALSE,1,38017676,"F",17,17,"Milwaukee Bucks","MarJon Beauchamp",1,4,6,5,3,10.2
0,0,0,0,0,0,0,0,0,"09",1,1,0,1,0,0,1037878,"2023-12-02T00:00:00.000Z",17,FALSE,1,38017733,"G",17,17,"Milwaukee Bucks","A.J. Green",0,1,1,0,1,1.2
2,0,3,6,2,11,7,2,2,"20",0,5,18,3,0,1,1037878,"2023-12-02T00:00:00.000Z",17,FALSE,1,368,"G",17,17,"Milwaukee Bucks","Cameron Payne",0,21,23,20,5,23.6
0,0,0,0,0,0,0,0,0,"00",0,0,0,0,0,0,1037878,"2023-12-02T00:00:00.000Z",17,FALSE,1,666453,"C",17,17,"Milwaukee Bucks","Marques Bolden",0,0,0,0,0,0
0,0,0,0,0,0,0,0,0,"00",0,0,0,0,0,0,1037878,"2023-12-02T00:00:00.000Z",17,FALSE,1,56677854,"F",17,17,"Milwaukee Bucks","Chris Livingston",0,0,0,0,0,0
0,0,0,0,0,0,0,0,0,"00",0,0,0,0,0,0,1037878,"2023-12-02T00:00:00.000Z",17,FALSE,1,284,"C",17,17,"Milwaukee Bucks","Robin Lopez",0,0,0,0,0,0
3,0,3,2,0,4,2,3,1,"27",1,3,5,4,0,0,1037878,"2023-12-02T00:00:00.000Z",17,FALSE,1,3547244,"F-C",1,1,"Atlanta Hawks","Onyeka Okongwu",0,9,12,8,7,14.3
0,0,0,0,0,0,0,0,0,"00",0,0,0,0,0,0,1037878,"2023-12-02T00:00:00.000Z",17,FALSE,1,319,"G",1,1,"Atlanta Hawks","Patty Mills",0,0,0,0,0,0
0,0,0,0,0,0,0,0,0,"00",0,0,0,0,0,0,1037878,"2023-12-02T00:00:00.000Z",17,FALSE,1,56677838,"G",1,1,"Atlanta Hawks","Kobe Bufkin",0,0,0,0,0,0
0,0,0,0,0,0,0,0,0,"00",0,0,0,0,0,0,1037878,"2023-12-02T00:00:00.000Z",17,FALSE,1,56677806,"F",1,1,"Atlanta Hawks","Mouhamed Gueye",0,0,0,0,0,0
0,0,0,0,0,0,0,0,0,"00",0,0,0,0,0,0,1037878,"2023-12-02T00:00:00.000Z",17,FALSE,1,17896040,"F",1,1,"Atlanta Hawks","Jalen Johnson",0,0,0,0,0,0
0,0,0,0,0,0,0,0,0,"00",0,0,0,0,0,0,1037878,"2023-12-02T00:00:00.000Z",17,FALSE,1,56677855,"G",1,1,"Atlanta Hawks","Seth Lundy",0,0,0,0,0,0
0,0,0,0,0,0,0,0,0,"00",0,0,0,0,0,0,1037878,"2023-12-02T00:00:00.000Z",17,FALSE,1,56677875,"F",1,1,"Atlanta Hawks","Miles Norris",0,0,0,0,0,0
0,0,9,4,1,13,7,0,0,"23",2,3,15,11,0,0,1037878,"2023-12-02T00:00:00.000Z",17,FALSE,1,377,"F",17,17,"Milwaukee Bucks","Bobby Portis",0,26,26,15,11,28.2
0,0,0,0,0,0,0,0,0,"00",0,0,0,0,0,0,1037878,"2023-12-02T00:00:00.000Z",17,FALSE,1,38017691,"G",17,17,"Milwaukee Bucks","TyTy Washington Jr.",0,0,0,0,0,0
0,0,0,0,0,0,0,0,0,"00",0,0,0,0,0,0,1037878,"2023-12-02T00:00:00.000Z",17,FALSE,1,666960,"G",17,17,"Milwaukee Bucks","Lindell Wigginton",0,0,0,0,0,0
0,0,0,0,0,0,0,0,0,"00",0,0,0,0,0,0,1037878,"2023-12-02T00:00:00.000Z",17,FALSE,1,105,"G",17,17,"Milwaukee Bucks","Pat Connaughton",0,0,0,0,0,0
0,0,0,0,0,0,0,0,0,"00",0,0,0,0,0,0,1037878,"2023-12-02T00:00:00.000Z",17,FALSE,1,112,"F",17,17,"Milwaukee Bucks","Jae Crowder",0,0,0,0,0,0
0,0,0,0,0,0,0,0,0,"00",0,0,0,0,0,0,1037878,"2023-12-02T00:00:00.000Z",17,FALSE,1,56677852,"G",17,17,"Milwaukee Bucks","Andre Jackson Jr.",0,0,0,0,0,0
0,0,1,2,0,10,3,6,6,"31",0,2,12,1,2,2,1037878,"2023-12-02T00:00:00.000Z",17,FALSE,1,666656,"F",1,1,"Atlanta Hawks","De'Andre Hunter",2,13,13,12,1,17.2
1,0,6,6,4,7,5,4,3,"36",3,2,17,9,0,0,1037878,"2023-12-02T00:00:00.000Z",17,FALSE,1,3547256,"F",1,1,"Atlanta Hawks","Saddiq Bey",0,26,27,18,10,29.3
4,3,9,0,0,13,4,2,2,"30",8,4,10,17,1,2,1037878,"2023-12-02T00:00:00.000Z",17,FALSE,1,83,"C",1,1,"Atlanta Hawks","Clint Capela",4,27,31,14,21,46.4
3,0,2,6,4,19,12,2,2,"34",0,0,30,2,2,2,1037878,"2023-12-02T00:00:00.000Z",17,FALSE,1,334,"G",1,1,"Atlanta Hawks","Dejounte Murray",2,32,35,33,5,40.9
12,0,0,13,5,28,13,2,1,"37",2,0,32,2,2,4,1037878,"2023-12-02T00:00:00.000Z",17,FALSE,1,490,"G",1,1,"Atlanta Hawks","Trae Young",2,34,46,44,14,54.4
0,1,3,7,2,18,6,0,0,"25",0,2,14,3,2,0,1037878,"2023-12-02T00:00:00.000Z",17,FALSE,1,53,"G",1,1,"Atlanta Hawks","Bogdan Bogdanovic",3,17,17,14,3,26.6
0,0,0,0,0,0,0,0,0,"00",0,0,0,0,0,0,1037878,"2023-12-02T00:00:00.000Z",17,FALSE,1,666564,"F",1,1,"Atlanta Hawks","Bruno Fernando",0,0,0,0,0,0
0,0,0,0,0,0,0,0,0,"00",0,0,0,0,0,0,1037878,"2023-12-02T00:00:00.000Z",17,FALSE,1,3547297,"G",1,1,"Atlanta Hawks","Trent Forrest",0,0,0,0,0,0
0,0,0,0,0,0,0,0,0,"00",0,0,0,0,0,0,1037878,"2023-12-02T00:00:00.000Z",17,FALSE,1,38017689,"F",1,1,"Atlanta Hawks","AJ Griffin",0,0,0,0,0,0
0,0,0,0,0,0,0,0,0,"08",1,1,0,1,0,1,1037878,"2023-12-02T00:00:00.000Z",17,FALSE,1,666754,"G",1,1,"Atlanta Hawks","Garrison Mathews",0,1,1,0,1,0.2
0,0,1,2,0,2,0,2,1,"12",0,0,1,1,2,0,1037878,"2023-12-02T00:00:00.000Z",17,FALSE,1,301,"G-F",1,1,"Atlanta Hawks","Wesley Matthews",2,2,2,1,1,8.2
1,1,3,12,6,15,8,2,2,"33",1,3,24,4,1,3,1037879,"2023-12-02T00:00:00.000Z",7,FALSE,21,247,"F-G",7,7,"Dallas Mavericks","Derrick Jones Jr.",2,28,29,25,5,33.3
1,0,0,4,0,6,1,4,3,"27",1,3,5,1,0,0,1037879,"2023-12-02T00:00:00.000Z",7,FALSE,21,666965,"F",7,7,"Dallas Mavericks","Grant Williams",0,6,7,6,2,7.7
0,7,10,0,0,9,9,5,2,"39",6,2,20,16,1,2,1037879,"2023-12-02T00:00:00.000Z",7,FALSE,21,56677840,"C",7,7,"Dallas Mavericks","Dereck Lively II",8,36,36,20,16,61.2
3,1,2,9,4,15,4,0,0,"36",3,2,12,5,1,0,1037879,"2023-12-02T00:00:00.000Z",7,FALSE,21,114,"G",7,7,"Dallas Mavericks","Seth Curry",2,17,20,15,8,28.5
18,2,13,13,5,22,11,14,9,"46",2,2,36,15,2,7,1037879,"2023-12-02T00:00:00.000Z",7,FALSE,21,132,"F-G",7,7,"Dallas Mavericks","Luka Doncic",4,51,69,54,33,86
0,0,0,0,0,0,0,0,0,"00",0,0,0,0,0,0,1037879,"2023-12-02T00:00:00.000Z",7,FALSE,21,17896028,"F",7,7,"Dallas Mavericks","Greg Brown III",0,0,0,0,0,0
0,0,1,2,0,2,0,0,0,"03",1,0,0,2,0,0,1037879,"2023-12-02T00:00:00.000Z",7,FALSE,21,56677873,"G",7,7,"Dallas Mavericks","Dexter Dennis",0,2,2,0,2,2.4
0,0,2,4,1,6,2,2,1,"14",0,5,6,2,0,2,1037879,"2023-12-02T00:00:00.000Z",7,FALSE,21,38017679,"G",7,7,"Dallas Mavericks","Jaden Hardy",0,8,8,6,2,6.4
0,0,1,0,0,0,0,2,1,"05",0,0,1,1,0,0,1037879,"2023-12-02T00:00:00.000Z",7,FALSE,21,217,"F-C",7,7,"Dallas Mavericks","Richaun Holmes",0,2,2,1,1,2.2
2,1,0,7,3,10,4,2,1,"19",0,1,12,0,0,0,1037879,"2023-12-02T00:00:00.000Z",7,FALSE,21,17554004,"G",7,7,"Dallas Mavericks","AJ Lawson",1,12,14,14,2,18
0,0,0,0,0,0,0,0,0,"00",0,0,0,0,0,0,1037879,"2023-12-02T00:00:00.000Z",7,FALSE,21,329,"F",7,7,"Dallas Mavericks","Markieff Morris",0,0,0,0,0,0
0,0,0,0,0,0,0,2,2,"04",0,1,2,0,0,1,1037879,"2023-12-02T00:00:00.000Z",7,FALSE,21,379,"F-C",7,7,"Dallas Mavericks","Dwight Powell",0,2,2,2,0,1
0,0,0,0,0,0,0,0,0,"00",0,0,0,0,0,0,1037879,"2023-12-02T00:00:00.000Z",7,FALSE,21,17896036,"G",21,21,"Oklahoma City Thunder","Tre Mann",0,0,0,0,0,0
0,0,0,0,0,0,0,0,0,"00",0,0,0,0,0,0,1037879,"2023-12-02T00:00:00.000Z",7,FALSE,21,4197029,"G",21,21,"Oklahoma City Thunder","Vasilije Micic",0,0,0,0,0,0
0,0,0,0,0,0,0,0,0,"00",0,0,0,0,0,0,1037879,"2023-12-02T00:00:00.000Z",7,FALSE,21,3547271,"C",21,21,"Oklahoma City Thunder","Aleksej Pokusevski",0,0,0,0,0,0
0,0,0,0,0,0,0,0,0,"00",0,0,0,0,0,0,1037879,"2023-12-02T00:00:00.000Z",7,FALSE,21,24572055,"C",21,21,"Oklahoma City Thunder","Olivier Sarr",0,0,0,0,0,0
0,0,4,7,2,12,6,2,1,"20",2,3,15,6,0,0,1037879,"2023-12-02T00:00:00.000Z",7,FALSE,21,56677833,"G",21,21,"Oklahoma City Thunder","Cason Wallace",0,21,21,15,6,22.2
0,0,0,0,0,1,0,0,0,"10",0,0,0,0,0,0,1037879,"2023-12-02T00:00:00.000Z",7,FALSE,21,17896078,"G",21,21,"Oklahoma City Thunder","Aaron Wiggins",0,0,0,0,0,0
0,0,2,5,4,6,4,2,2,"15",1,1,14,3,0,1,1037879,"2023-12-02T00:00:00.000Z",7,FALSE,21,38017706,"F",21,21,"Oklahoma City Thunder","Jaylin Williams",0,17,17,14,3,16.6
0,0,3,1,1,4,2,0,0,"11",3,1,5,6,0,2,1037879,"2023-12-02T00:00:00.000Z",7,FALSE,21,480,"G-F",21,21,"Oklahoma City Thunder","Kenrich Williams",0,11,11,5,6,10.2
0,0,0,0,0,0,0,0,0,"00",0,0,0,0,0,0,1037879,"2023-12-02T00:00:00.000Z",7,FALSE,21,38017716,"F",21,21,"Oklahoma City Thunder","Ousmane Dieng",0,0,0,0,0,0
0,0,0,0,0,0,0,0,0,"00",0,0,0,0,0,0,1037879,"2023-12-02T00:00:00.000Z",7,FALSE,21,56677853,"F",21,21,"Oklahoma City Thunder","Keyontae Johnson",0,0,0,0,0,0
1,0,0,1,0,2,0,2,2,"14",1,2,2,1,0,0,1037879,"2023-12-02T00:00:00.000Z",7,FALSE,21,56677859,"F",7,7,"Dallas Mavericks","Olivier-Maxence Prosper",0,3,4,3,2,4.7
0,0,0,0,0,0,0,0,0,"00",0,0,0,0,0,0,1037879,"2023-12-02T00:00:00.000Z",7,FALSE,21,151,"G",7,7,"Dallas Mavericks","Dante Exum",0,0,0,0,0,0
0,0,0,0,0,0,0,0,0,"00",0,0,0,0,0,0,1037879,"2023-12-02T00:00:00.000Z",7,FALSE,21,3547258,"G",7,7,"Dallas Mavericks","Josh Green",0,0,0,0,0,0
0,0,0,0,0,0,0,0,0,"00",0,0,0,0,0,0,1037879,"2023-12-02T00:00:00.000Z",7,FALSE,21,191,"G",7,7,"Dallas Mavericks","Tim Hardaway Jr.",0,0,0,0,0,0
0,0,0,0,0,0,0,0,0,"00",0,0,0,0,0,0,1037879,"2023-12-02T00:00:00.000Z",7,FALSE,21,228,"G",7,7,"Dallas Mavericks","Kyrie Irving",0,0,0,0,0,0
0,0,0,0,0,0,0,0,0,"00",0,0,0,0,0,0,1037879,"2023-12-02T00:00:00.000Z",7,FALSE,21,257,"F",7,7,"Dallas Mavericks","Maxi Kleber",0,0,0,0,0,0
3,0,4,6,1,13,4,2,1,"32",1,4,10,5,0,2,1037879,"2023-12-02T00:00:00.000Z",7,FALSE,21,666541,"G",21,21,"Oklahoma City Thunder","Luguentz Dort",0,15,18,13,8,18.5
1,0,1,3,3,3,3,6,6,"11",0,3,15,1,1,0,1037879,"2023-12-02T00:00:00.000Z",7,FALSE,21,44,"F",21,21,"Oklahoma City Thunder","Davis Bertans",1,16,17,16,2,20.7
2,0,6,5,2,6,2,0,0,"25",1,1,6,7,0,0,1037879,"2023-12-02T00:00:00.000Z",7,FALSE,21,3547272,"G",21,21,"Oklahoma City Thunder","Isaiah Joe",0,13,15,8,9,17.4
0,0,0,0,0,0,0,0,0,"00",0,0,0,0,0,0,1037879,"2023-12-02T00:00:00.000Z",7,FALSE,21,27924547,"F",21,21,"Oklahoma City Thunder","Lindy Waters III",0,0,0,0,0,0
5,0,3,5,3,19,9,2,2,"30",2,3,23,5,1,1,1037879,"2023-12-02T00:00:00.000Z",7,FALSE,21,38017703,"G-F",21,21,"Oklahoma City Thunder","Jalen Williams",1,28,33,28,10,38.5
3,5,8,3,0,10,4,4,3,"30",3,3,11,11,1,2,1037879,"2023-12-02T00:00:00.000Z",7,FALSE,21,38017685,"C-F",21,21,"Oklahoma City Thunder","Chet Holmgren",6,22,25,14,14,44.7
1,0,1,6,2,13,4,0,0,"17",2,1,10,3,0,2,1037879,"2023-12-02T00:00:00.000Z",7,FALSE,21,17896065,"G",21,21,"Oklahoma City Thunder","Josh Giddey",0,13,14,11,4,13.1
9,1,2,3,2,13,6,4,3,"39",1,4,17,3,5,2,1037879,"2023-12-02T00:00:00.000Z",7,FALSE,21,175,"G",21,21,"Oklahoma City Thunder","Shai Gilgeous-Alexander",6,20,29,26,12,50.1
1,1,4,1,0,2,1,6,1,"26",3,2,3,7,3,1,1037880,"2023-12-02T00:00:00.000Z",24,FALSE,15,356,"G",24,24,"Phoenix Suns","Josh Okogie",4,10,11,4,8,23.9
5,1,2,3,2,14,10,7,5,"33",0,1,27,2,1,2,1037880,"2023-12-02T00:00:00.000Z",24,FALSE,15,140,"F",24,24,"Phoenix Suns","Kevin Durant",2,29,34,32,7,40.9
3,1,6,3,0,18,6,2,2,"26",3,6,14,9,2,3,1037880,"2023-12-02T00:00:00.000Z",24,FALSE,15,349,"C",24,24,"Phoenix Suns","Jusuf Nurkic",3,23,26,17,12,35.3
4,0,1,2,1,4,1,6,6,"33",1,1,9,2,1,2,1037880,"2023-12-02T00:00:00.000Z",24,FALSE,15,8,"G",24,24,"Phoenix Suns","Grayson Allen",1,11,15,13,6,18.4
7,0,9,8,3,21,9,13,13,"37",1,2,34,10,1,2,1037880,"2023-12-02T00:00:00.000Z",24,FALSE,15,57,"G",24,24,"Phoenix Suns","Devin Booker",1,44,51,41,17,57.5
0,0,3,2,1,6,3,1,1,"18",0,0,8,3,1,1,1037880,"2023-12-02T00:00:00.000Z",24,FALSE,15,32,"F",24,24,"Phoenix Suns","Keita Bates-Diop",1,11,11,8,3,13.6
1,0,3,3,1,6,2,2,2,"19",1,3,7,4,0,1,1037880,"2023-12-02T00:00:00.000Z",24,FALSE,15,18678058,"",24,24,"Phoenix Suns","Jordan Goodwin",0,11,12,8,5,12.3
2,0,1,2,0,5,1,2,2,"15",1,0,4,2,0,1,1037880,"2023-12-02T00:00:00.000Z",24,FALSE,15,666729,"F",24,24,"Phoenix Suns","Nassir Little",0,6,8,6,4,8.4
0,0,0,0,0,0,0,0,0,"00",0,0,0,0,0,0,1037880,"2023-12-02T00:00:00.000Z",24,FALSE,15,272,"G",24,24,"Phoenix Suns","Damion Lee",0,0,0,0,0,0
1,0,4,3,2,7,3,0,0,"30",2,2,8,6,1,1,1037880,"2023-12-02T00:00:00.000Z",24,FALSE,15,38017729,"F",15,15,"Memphis Grizzlies","David Roddy",1,14,15,9,7,18.7
2,1,8,5,2,21,13,10,9,"36",1,4,37,9,1,4,1037880,"2023-12-02T00:00:00.000Z",24,FALSE,15,231,"F-C",15,15,"Memphis Grizzlies","Jaren Jackson Jr.",2,46,48,39,11,52.8
1,3,3,0,0,5,1,0,0,"17",1,4,2,4,0,2,1037880,"2023-12-02T00:00:00.000Z",24,FALSE,15,48,"C",15,15,"Memphis Grizzlies","Bismack Biyombo",3,6,7,3,5,15.3
5,1,2,6,3,17,10,5,4,"30",1,5,27,3,2,2,1037880,"2023-12-02T00:00:00.000Z",24,FALSE,15,3547287,"G",15,15,"Memphis Grizzlies","Desmond Bane",3,30,35,32,8,45.1
2,0,1,4,0,12,3,2,2,"34",0,5,8,1,1,1,1037880,"2023-12-02T00:00:00.000Z",24,FALSE,15,666809,"G",15,15,"Memphis Grizzlies","Jaylen Nowell",1,9,11,10,3,14.2
1,1,7,6,1,10,3,0,0,"31",0,5,7,7,3,1,1037880,"2023-12-02T00:00:00.000Z",24,FALSE,15,17896067,"F",15,15,"Memphis Grizzlies","Santi Aldama",4,14,15,8,8,27.9
0,1,2,2,0,5,2,2,2,"20",2,0,6,4,1,2,1037880,"2023-12-02T00:00:00.000Z",24,FALSE,15,666703,"G-F",15,15,"Memphis Grizzlies","John Konchar",2,10,10,6,4,14.8
0,1,0,2,0,4,1,0,0,"12",0,0,2,0,0,1,1037880,"2023-12-02T00:00:00.000Z",24,FALSE,15,3547285,"F",15,15,"Memphis Grizzlies","Xavier Tillman",1,2,2,2,0,4
2,0,5,3,1,5,3,5,5,"30",1,6,12,6,0,1,1037880,"2023-12-02T00:00:00.000Z",24,FALSE,15,38017731,"G",15,15,"Memphis Grizzlies","Vince Williams Jr.",0,18,20,14,8,21.2
0,0,0,0,0,0,0,0,0,"00",0,0,0,0,0,0,1037880,"2023-12-02T00:00:00.000Z",24,FALSE,15,3547298,"G",24,24,"Phoenix Suns","Saben Lee",0,0,0,0,0,0
0,0,0,0,0,0,0,0,0,"00",0,0,0,0,0,0,1037880,"2023-12-02T00:00:00.000Z",24,FALSE,15,314,"F",24,24,"Phoenix Suns","Chimezie Metu",0,0,0,0,0,0
0,0,0,0,0,0,0,0,0,"00",0,0,0,0,0,0,1037880,"2023-12-02T00:00:00.000Z",24,FALSE,15,37,"G",24,24,"Phoenix Suns","Bradley Beal",0,0,0,0,0,0
0,0,0,0,0,0,0,0,0,"00",0,0,0,0,0,0,1037880,"2023-12-02T00:00:00.000Z",24,FALSE,15,178,"G",24,24,"Phoenix Suns","Eric Gordon",0,0,0,0,0,0
0,0,0,0,0,0,0,0,0,"00",0,0,0,0,0,0,1037880,"2023-12-02T00:00:00.000Z",24,FALSE,15,48248287,"G",15,15,"Memphis Grizzlies","Jacob Gilyard",0,0,0,0,0,0
0,0,0,0,0,0,0,0,0,"00",0,0,0,0,0,0,1037880,"2023-12-02T00:00:00.000Z",24,FALSE,15,199,"G",15,15,"Memphis Grizzlies","Shaquille Harrison",0,0,0,0,0,0
0,0,0,0,0,0,0,0,0,"00",0,0,0,0,0,0,1037880,"2023-12-02T00:00:00.000Z",24,FALSE,15,38017732,"F",15,15,"Memphis Grizzlies","Kenneth Lofton Jr.",0,0,0,0,0,0
0,0,0,0,0,0,0,0,0,"00",0,0,0,0,0,0,1037880,"2023-12-02T00:00:00.000Z",24,FALSE,15,3,"C",15,15,"Memphis Grizzlies","Steven Adams",0,0,0,0,0,0
0,0,0,0,0,0,0,0,0,"00",0,0,0,0,0,0,1037880,"2023-12-02T00:00:00.000Z",24,FALSE,15,666505,"F",15,15,"Memphis Grizzlies","Brandon Clarke",0,0,0,0,0,0
0,0,0,0,0,0,0,0,0,"00",0,0,0,0,0,0,1037880,"2023-12-02T00:00:00.000Z",24,FALSE,15,56677830,"F",15,15,"Memphis Grizzlies","GG Jackson",0,0,0,0,0,0
0,0,0,0,0,0,0,0,0,"00",0,0,0,0,0,0,1037880,"2023-12-02T00:00:00.000Z",24,FALSE,15,254,"G",15,15,"Memphis Grizzlies","Luke Kennard",0,0,0,0,0,0
1,2,2,0,0,5,2,2,2,"18",1,3,6,3,0,1,1037880,"2023-12-02T00:00:00.000Z",24,FALSE,15,147,"F",24,24,"Phoenix Suns","Drew Eubanks",2,9,10,7,4,16.1
0,0,1,2,1,2,1,2,1,"15",1,3,4,2,1,2,1037880,"2023-12-02T00:00:00.000Z",24,FALSE,15,470,"G",24,24,"Phoenix Suns","Yuta Watanabe",1,6,6,4,2,7.4
0,0,0,0,0,0,0,0,0,"00",0,0,0,0,0,0,1037880,"2023-12-02T00:00:00.000Z",24,FALSE,15,3547095,"C-F",24,24,"Phoenix Suns","Udoka Azubuike",0,0,0,0,0,0
0,0,0,0,0,0,0,0,0,"00",0,0,0,0,0,0,1037880,"2023-12-02T00:00:00.000Z",24,FALSE,15,666451,"C",24,24,"Phoenix Suns","Bol Bol",0,0,0,0,0,0
0,0,0,0,0,0,0,0,0,"00",0,0,0,0,0,0,1037880,"2023-12-02T00:00:00.000Z",24,FALSE,15,38017728,"F",15,15,"Memphis Grizzlies","Jake LaRavia",0,0,0,0,0,0
0,0,0,0,0,0,0,0,0,"00",0,0,0,0,0,0,1037880,"2023-12-02T00:00:00.000Z",24,FALSE,15,666786,"G",15,15,"Memphis Grizzlies","Ja Morant",0,0,0,0,0,0
0,0,0,0,0,0,0,0,0,"00",0,0,0,0,0,0,1037880,"2023-12-02T00:00:00.000Z",24,FALSE,15,401,"G",15,15,"Memphis Grizzlies","Derrick Rose",0,0,0,0,0,0
0,0,0,0,0,0,0,0,0,"00",0,0,0,0,0,0,1037880,"2023-12-02T00:00:00.000Z",24,FALSE,15,420,"G",15,15,"Memphis Grizzlies","Marcus Smart",0,0,0,0,0,0
0,0,0,0,0,0,0,0,0,"00",0,0,0,0,0,0,1037880,"2023-12-02T00:00:00.000Z",24,FALSE,15,17896027,"G-F",15,15,"Memphis Grizzlies","Ziaire Williams",0,0,0,0,0,0
6,0,6,8,4,17,8,5,5,"38",0,5,25,6,1,1,1037872,"2023-12-02T00:00:00.000Z",13,FALSE,10,172,"F",13,13,"LA Clippers","Paul George",1,31,37,31,12,43.2
7,0,8,5,2,16,9,0,0,"39",0,2,20,8,1,3,1037872,"2023-12-02T00:00:00.000Z",13,FALSE,10,274,"F",13,13,"LA Clippers","Kawhi Leonard",1,28,35,27,15,40.1
1,3,6,0,0,6,6,0,0,"23",1,4,12,7,0,3,1037872,"2023-12-02T00:00:00.000Z",13,FALSE,10,493,"C",13,13,"LA Clippers","Ivica Zubac",3,19,20,13,8,27.9
2,0,1,5,1,6,1,0,0,"24",1,1,3,2,1,0,1037872,"2023-12-02T00:00:00.000Z",13,FALSE,10,666743,"G",13,13,"LA Clippers","Terance Mann",1,5,7,5,4,11.4
9,0,5,7,2,14,7,5,5,"35",0,4,21,5,1,1,1037872,"2023-12-02T00:00:00.000Z",13,FALSE,10,192,"G",13,13,"LA Clippers","James Harden",1,26,35,30,14,42.5
3,0,1,3,0,3,0,0,0,"11",0,1,0,1,0,0,1037872,"2023-12-02T00:00:00.000Z",13,FALSE,10,56677849,"F",13,13,"LA Clippers","Kobe Brown",0,1,4,3,4,5.7
0,0,0,0,0,0,0,0,0,"00",0,0,0,0,0,0,1037872,"2023-12-02T00:00:00.000Z",13,FALSE,10,666511,"G",13,13,"LA Clippers","Amir Coffey",0,0,0,0,0,0
0,0,0,0,0,0,0,0,0,"00",0,0,0,0,0,0,1037872,"2023-12-02T00:00:00.000Z",13,FALSE,10,38017725,"F",13,13,"LA Clippers","Moussa Diabate",0,0,0,0,0,0
0,0,0,0,0,0,0,0,0,"00",0,0,0,0,0,0,1037872,"2023-12-02T00:00:00.000Z",13,FALSE,10,17896031,"G",13,13,"LA Clippers","Nah'Shon Hyland",0,0,0,0,0,0
0,0,0,0,0,0,0,0,0,"00",0,0,0,0,0,0,1037872,"2023-12-02T00:00:00.000Z",13,FALSE,10,24417679,"G",13,13,"LA Clippers","Xavier Moon",0,0,0,0,0,0
0,0,0,5,2,12,5,0,0,"29",1,1,12,1,0,2,1037872,"2023-12-02T00:00:00.000Z",13,FALSE,10,380,"F-G",13,13,"LA Clippers","Norman Powell",0,13,13,12,1,11.2
1,2,2,2,0,11,6,0,0,"22",2,3,12,4,1,1,1037872,"2023-12-02T00:00:00.000Z",13,FALSE,10,439,"F",13,13,"LA Clippers","Daniel Theis",3,16,17,13,5,26.3
0,0,0,0,0,0,0,0,0,"00",0,0,0,0,0,0,1037872,"2023-12-02T00:00:00.000Z",13,FALSE,10,450,"F",13,13,"LA Clippers","PJ Tucker",0,0,0,0,0,0
2,1,6,4,2,5,2,4,2,"19",0,0,8,6,0,0,1037872,"2023-12-02T00:00:00.000Z",13,FALSE,10,472,"G",13,13,"LA Clippers","Russell Westbrook",1,14,16,10,8,21.2
0,0,0,0,0,0,0,0,0,"00",0,0,0,0,0,0,1037872,"2023-12-02T00:00:00.000Z",13,FALSE,10,56677856,"G",13,13,"LA Clippers","Jordan Miller",0,0,0,0,0,0
0,0,0,0,0,0,0,0,0,"00",0,0,0,0,0,0,1037872,"2023-12-02T00:00:00.000Z",13,FALSE,10,371,"F-C",13,13,"LA Clippers","Mason Plumlee",0,0,0,0,0,0
0,0,0,0,0,0,0,0,0,"00",0,0,0,0,0,0,1037872,"2023-12-02T00:00:00.000Z",13,FALSE,10,17896051,"G",13,13,"LA Clippers","Joshua Primo",0,0,0,0,0,0
2,0,2,5,2,13,5,10,9,"32",3,3,21,5,2,0,1037872,"2023-12-02T00:00:00.000Z",13,FALSE,10,17553992,"G",10,10,"Golden State Warriors","Moses Moody",2,26,28,23,7,36
4,1,8,8,4,15,8,2,1,"32",1,2,21,9,0,3,1037872,"2023-12-02T00:00:00.000Z",13,FALSE,10,185,"F",10,10,"Golden State Warriors","Draymond Green",1,30,34,25,13,37.8
3,0,2,2,0,7,3,0,0,"20",0,2,6,2,1,3,1037872,"2023-12-02T00:00:00.000Z",13,FALSE,10,407,"F",10,10,"Golden State Warriors","Dario Saric",1,8,11,9,5,12.9
2,0,5,11,4,13,5,4,3,"33",1,3,17,6,1,2,1037872,"2023-12-02T00:00:00.000Z",13,FALSE,10,443,"G",10,10,"Golden State Warriors","Klay Thompson",1,23,25,19,8,28.2
11,0,3,9,4,18,7,4,4,"37",1,0,22,4,0,2,1037872,"2023-12-02T00:00:00.000Z",13,FALSE,10,115,"G",10,10,"Golden State Warriors","Stephen Curry",0,26,37,33,15,41.3
0,0,0,0,0,0,0,0,0,"00",0,0,0,0,0,0,1037872,"2023-12-02T00:00:00.000Z",13,FALSE,10,56677799,"F",10,10,"Golden State Warriors","Trayce Jackson-Davis",0,0,0,0,0,0
3,0,0,2,0,2,0,0,0,"16",0,2,0,0,0,0,1037872,"2023-12-02T00:00:00.000Z",13,FALSE,10,251,"G",10,10,"Golden State Warriors","Cory Joseph",0,0,3,3,3,4.5
0,0,2,3,1,6,2,2,1,"16",0,0,6,2,0,1,1037872,"2023-12-02T00:00:00.000Z",13,FALSE,10,17553979,"F",10,10,"Golden State Warriors","Jonathan Kuminga",0,8,8,6,2,7.4
3,1,8,0,0,3,3,2,1,"18",0,1,7,8,0,1,1037872,"2023-12-02T00:00:00.000Z",13,FALSE,10,282,"F",10,10,"Golden State Warriors","Kevon Looney",1,15,18,10,11,23.1
3,2,6,3,2,9,5,0,0,"36",0,2,12,6,1,1,1037872,"2023-12-02T00:00:00.000Z",13,FALSE,10,56677858,"G",10,10,"Golden State Warriors","Brandin Podziemski",3,18,21,15,9,31.7
0,0,0,0,0,0,0,0,0,"00",0,0,0,0,0,0,1037872,"2023-12-02T00:00:00.000Z",13,FALSE,10,398,"G",10,10,"Golden State Warriors","Jerome Robinson",0,0,0,0,0,0
0,0,0,0,0,0,0,0,0,"00",0,0,0,0,0,0,1037872,"2023-12-02T00:00:00.000Z",13,FALSE,10,17896070,"F",10,10,"Golden State Warriors","Usman Garuba",0,0,0,0,0,0
0,0,0,0,0,0,0,0,0,"00",0,0,0,0,0,0,1037872,"2023-12-02T00:00:00.000Z",13,FALSE,10,367,"G",10,10,"Golden State Warriors","Chris Paul",0,0,0,0,0,0
0,0,0,0,0,0,0,0,0,"00",0,0,0,0,0,0,1037872,"2023-12-02T00:00:00.000Z",13,FALSE,10,2189,"",10,10,"Golden State Warriors","Gary Payton II",0,0,0,0,0,0
0,0,0,0,0,0,0,0,0,"00",0,0,0,0,0,0,1037872,"2023-12-02T00:00:00.000Z",13,FALSE,10,45658838,"G",10,10,"Golden State Warriors","Lester Quinones",0,0,0,0,0,0
0,0,0,0,0,0,0,0,0,"00",0,0,0,0,0,0,1037872,"2023-12-02T00:00:00.000Z",13,FALSE,10,57875092,"F",10,10,"Golden State Warriors","Gui Santos",0,0,0,0,0,0
0,0,0,0,0,0,0,0,0,"00",0,0,0,0,0,0,1037872,"2023-12-02T00:00:00.000Z",13,FALSE,10,475,"F-G",10,10,"Golden State Warriors","Andrew Wiggins",0,0,0,0,0,0
0,0,0,0,0,0,0,0,0,"00",0,0,0,0,0,0,1037872,"2023-12-02T00:00:00.000Z",13,FALSE,10,17896022,"G",13,13,"LA Clippers","Brandon Boston Jr.",0,0,0,0,0,0
3,0,1,2,1,11,7,2,2,"31",1,1,17,2,2,2,1037873,"2023-12-02T00:00:00.000Z",4,FALSE,18,204,"F",4,4,"Charlotte Hornets","Gordon Hayward",2,19,22,20,5,27.9
4,0,4,0,0,6,2,7,7,"26",2,3,11,6,2,2,1037873,"2023-12-02T00:00:00.000Z",4,FALSE,18,12,"F",18,18,"Minnesota Timberwolves","Kyle Anderson",2,17,21,15,10,28.2
0,0,0,0,0,0,0,0,0,"00",0,0,0,0,0,0,1037873,"2023-12-02T00:00:00.000Z",4,FALSE,18,17896056,"C",18,18,"Minnesota Timberwolves","Luka Garza",0,0,0,0,0,0
2,0,1,2,0,8,2,2,2,"23",0,2,6,1,1,0,1037873,"2023-12-02T00:00:00.000Z",4,FALSE,18,320,"G",18,18,"Minnesota Timberwolves","Shake Milton",1,7,9,8,3,13.2
0,0,0,0,0,0,0,0,0,"00",0,0,0,0,0,0,1037873,"2023-12-02T00:00:00.000Z",4,FALSE,18,38017715,"F",18,18,"Minnesota Timberwolves","Josh Minott",0,0,0,0,0,0
2,0,3,6,3,14,9,2,2,"24",2,0,23,5,1,2,1037873,"2023-12-02T00:00:00.000Z",4,FALSE,18,667378,"F-C",18,18,"Minnesota Timberwolves","Naz Reid",1,28,30,25,7,33
1,0,2,6,3,7,3,0,0,"32",1,4,9,3,1,1,1037873,"2023-12-02T00:00:00.000Z",4,FALSE,18,68,"F",18,18,"Minnesota Timberwolves","Troy Brown Jr.",1,12,13,10,4,16.1
10,0,5,7,1,9,3,8,7,"34",0,2,14,5,0,1,1037873,"2023-12-02T00:00:00.000Z",4,FALSE,18,104,"G",18,18,"Minnesota Timberwolves","Mike Conley",0,19,29,24,15,34
0,0,0,0,0,0,0,0,0,"00",0,0,0,0,0,0,1037873,"2023-12-02T00:00:00.000Z",4,FALSE,18,3547259,"F",18,18,"Minnesota Timberwolves","Jaden McDaniels",0,0,0,0,0,0
0,0,0,0,0,0,0,0,0,"00",0,0,0,0,0,0,1037873,"2023-12-02T00:00:00.000Z",4,FALSE,18,666767,"G",18,18,"Minnesota Timberwolves","Jordan McLaughlin",0,0,0,0,0,0
0,0,0,0,0,0,0,0,0,"00",0,0,0,0,0,0,1037873,"2023-12-02T00:00:00.000Z",4,FALSE,18,56677782,"F",18,18,"Minnesota Timberwolves","Leonard Miller",0,0,0,0,0,0
0,0,0,0,0,0,0,0,0,"00",0,0,0,0,0,0,1037873,"2023-12-02T00:00:00.000Z",4,FALSE,18,38017700,"G",18,18,"Minnesota Timberwolves","Wendell Moore Jr.",0,0,0,0,0,0
0,0,0,0,0,0,0,0,0,"00",0,0,0,0,0,0,1037873,"2023-12-02T00:00:00.000Z",4,FALSE,18,17895968,"F",18,18,"Minnesota Timberwolves","Daishen Nix",0,0,0,0,0,0
0,0,0,0,0,0,0,0,0,"00",0,0,0,0,0,0,1037873,"2023-12-02T00:00:00.000Z",4,FALSE,18,56677851,"G",18,18,"Minnesota Timberwolves","Jaylen Clark",0,0,0,0,0,0
0,0,0,0,0,0,0,0,0,"00",0,0,0,0,0,0,1037873,"2023-12-02T00:00:00.000Z",4,FALSE,18,3547238,"G",18,18,"Minnesota Timberwolves","Anthony Edwards",0,0,0,0,0,0
4,0,2,5,2,18,8,4,4,"36",1,5,22,3,1,1,1037873,"2023-12-02T00:00:00.000Z",4,FALSE,18,62,"F",4,4,"Charlotte Hornets","Miles Bridges",1,25,29,26,7,33.6
0,0,4,0,0,6,4,4,3,"29",2,6,11,6,0,1,1037873,"2023-12-02T00:00:00.000Z",4,FALSE,18,38017698,"C",4,4,"Charlotte Hornets","Mark Williams",0,17,17,11,6,17.2
3,2,4,4,2,13,5,2,2,"36",1,3,14,5,0,2,1037873,"2023-12-02T00:00:00.000Z",4,FALSE,18,56677823,"F",4,4,"Charlotte Hornets","Brandon Miller",2,19,22,17,8,28.5
7,0,5,7,3,20,8,5,4,"36",1,4,23,6,2,1,1037873,"2023-12-02T00:00:00.000Z",4,FALSE,18,403,"G",4,4,"Charlotte Hornets","Terry Rozier",2,29,36,30,13,45.7
5,1,4,7,4,14,7,0,0,"31",3,1,18,7,0,1,1037873,"2023-12-02T00:00:00.000Z",4,FALSE,18,666950,"F",4,4,"Charlotte Hornets","P.J. Washington",1,25,30,23,12,35.9
1,1,2,0,0,3,1,2,2,"09",1,1,4,3,1,0,1037873,"2023-12-02T00:00:00.000Z",4,FALSE,18,3547282,"C",4,4,"Charlotte Hornets","Nick Richards",2,7,8,5,4,15.1
5,0,3,0,0,3,3,0,0,"16",1,0,6,4,0,0,1037873,"2023-12-02T00:00:00.000Z",4,FALSE,18,422,"G",4,4,"Charlotte Hornets","Ish Smith",0,10,15,11,9,18.3
1,0,1,0,0,4,1,0,0,"16",0,1,2,1,0,0,1037873,"2023-12-02T00:00:00.000Z",4,FALSE,18,38017708,"G",4,4,"Charlotte Hornets","Bryce McGowens",0,3,4,3,2,4.7
0,0,0,0,0,0,0,0,0,"00",0,0,0,0,0,0,1037873,"2023-12-02T00:00:00.000Z",4,FALSE,18,56677866,"F",4,4,"Charlotte Hornets","Leaky Black",0,0,0,0,0,0
0,0,0,0,0,0,0,0,0,"00",0,0,0,0,0,0,1037873,"2023-12-02T00:00:00.000Z",4,FALSE,18,17896037,"G",4,4,"Charlotte Hornets","James Bouknight",0,0,0,0,0,0
0,0,0,0,0,0,0,0,0,"00",0,0,0,0,0,0,1037873,"2023-12-02T00:00:00.000Z",4,FALSE,18,3547253,"G",4,4,"Charlotte Hornets","Theo Maledon",0,0,0,0,0,0
0,0,0,0,0,0,0,0,0,"00",0,0,0,0,0,0,1037873,"2023-12-02T00:00:00.000Z",4,FALSE,18,56677846,"G",4,4,"Charlotte Hornets","Nick Smith Jr.",0,0,0,0,0,0
0,0,0,0,0,0,0,0,0,"00",0,0,0,0,0,0,1037873,"2023-12-02T00:00:00.000Z",4,FALSE,18,18678001,"F",4,4,"Charlotte Hornets","JT Thor",0,0,0,0,0,0
0,0,0,0,0,0,0,0,0,"00",0,0,0,0,0,0,1037873,"2023-12-02T00:00:00.000Z",4,FALSE,18,56677848,"G",4,4,"Charlotte Hornets","Amari Bailey",0,0,0,0,0,0
0,0,0,0,0,0,0,0,0,"00",0,0,0,0,0,0,1037873,"2023-12-02T00:00:00.000Z",4,FALSE,18,3547239,"G",4,4,"Charlotte Hornets","LaMelo Ball",0,0,0,0,0,0
0,0,0,0,0,0,0,0,0,"00",0,0,0,0,0,0,1037873,"2023-12-02T00:00:00.000Z",4,FALSE,18,666748,"F",4,4,"Charlotte Hornets","Cody Martin",0,0,0,0,0,0
0,0,0,0,0,0,0,0,0,"00",0,0,0,0,0,0,1037873,"2023-12-02T00:00:00.000Z",4,FALSE,18,347,"G",4,4,"Charlotte Hornets","Frank Ntilikina",0,0,0,0,0,0
2,0,2,2,0,5,2,2,2,"30",0,1,6,2,0,1,1037873,"2023-12-02T00:00:00.000Z",4,FALSE,18,666400,"G",18,18,"Minnesota Timberwolves","Nickeil Alexander-Walker",0,8,10,8,4,10.4
5,1,4,8,4,23,12,0,0,"32",3,3,28,7,0,3,1037873,"2023-12-02T00:00:00.000Z",4,FALSE,18,447,"C",18,18,"Minnesota Timberwolves","Karl-Anthony Towns",1,35,40,33,12,43.9
0,3,10,0,0,12,10,9,6,"39",2,1,26,12,0,1,1037873,"2023-12-02T00:00:00.000Z",4,FALSE,18,176,"C",18,18,"Minnesota Timberwolves","Rudy Gobert",3,38,38,26,12,48.4
3,3,4,6,3,20,12,18,15,"35",1,3,42,5,1,3,1037874,"2023-12-02T00:00:00.000Z",3,FALSE,22,61,"F",3,3,"Brooklyn Nets","Mikal Bridges",4,47,50,45,8,61.5
3,0,4,6,3,10,5,2,1,"30",3,2,14,7,0,0,1037874,"2023-12-02T00:00:00.000Z",3,FALSE,22,666679,"F",3,3,"Brooklyn Nets","Cameron Johnson",0,21,24,17,10,26.9
1,1,3,0,0,4,3,0,0,"24",4,4,6,7,0,1,1037874,"2023-12-02T00:00:00.000Z",3,FALSE,22,666508,"F-C",3,3,"Brooklyn Nets","Nicolas Claxton",1,13,14,7,8,17.9
5,0,7,9,4,23,7,2,2,"38",0,3,20,7,0,2,1037874,"2023-12-02T00:00:00.000Z",3,FALSE,22,17896048,"G",3,3,"Brooklyn Nets","Cam Thomas",0,27,32,25,12,33.9
3,0,4,7,3,15,8,4,3,"35",0,2,22,4,0,2,1037874,"2023-12-02T00:00:00.000Z",3,FALSE,22,130,"G",3,3,"Brooklyn Nets","Spencer Dinwiddie",0,26,29,25,7,29.3
0,0,0,0,0,0,0,0,0,"00",0,0,0,0,0,0,1037874,"2023-12-02T00:00:00.000Z",3,FALSE,22,158,"F",3,3,"Brooklyn Nets","Dorian Finney-Smith",0,0,0,0,0,0
7,0,5,3,1,3,1,0,0,"26",1,3,3,6,1,0,1037874,"2023-12-02T00:00:00.000Z",3,FALSE,22,351,"F",3,3,"Brooklyn Nets","Royce O'Neale",1,9,16,10,13,23.7
0,0,0,3,1,3,1,0,0,"16",0,1,3,0,0,0,1037874,"2023-12-02T00:00:00.000Z",3,FALSE,22,38017724,"G",22,22,"Orlando Magic","Caleb Houstan",0,3,3,3,0,3
2,0,1,1,1,2,1,3,2,"17",1,2,5,2,1,1,1037874,"2023-12-02T00:00:00.000Z",3,FALSE,22,226,"F",22,22,"Orlando Magic","Joe Ingles",1,7,9,7,4,12.4
0,0,0,0,0,0,0,0,0,"00",0,0,0,0,0,0,1037874,"2023-12-02T00:00:00.000Z",3,FALSE,22,229,"F",22,22,"Orlando Magic","Jonathan Isaac",0,0,0,0,0,0
2,1,1,2,2,9,6,5,4,"22",1,2,18,2,0,2,1037874,"2023-12-02T00:00:00.000Z",3,FALSE,22,462,"C",22,22,"Orlando Magic","Moritz Wagner",1,20,22,20,4,24.4
5,1,6,3,2,16,6,6,6,"34",1,5,20,7,0,1,1037874,"2023-12-02T00:00:00.000Z",3,FALSE,22,17896026,"F",22,22,"Orlando Magic","Franz Wagner",1,27,32,25,12,37.9
8,0,9,2,0,15,6,9,7,"34",1,3,19,10,1,1,1037874,"2023-12-02T00:00:00.000Z",3,FALSE,22,38017683,"F",22,22,"Orlando Magic","Paolo Banchero",1,29,37,27,18,45
0,1,2,0,0,6,1,2,1,"15",3,2,3,5,0,0,1037874,"2023-12-02T00:00:00.000Z",3,FALSE,22,666442,"C",22,22,"Orlando Magic","Goga Bitadze",1,8,8,3,5,12
2,1,0,3,1,7,3,0,0,"23",0,5,7,0,1,4,1037874,"2023-12-02T00:00:00.000Z",3,FALSE,22,17896073,"G",22,22,"Orlando Magic","Jalen Suggs",2,7,9,9,2,12
1,0,3,0,0,1,1,0,0,"19",0,3,2,3,0,0,1037874,"2023-12-02T00:00:00.000Z",3,FALSE,22,56677827,"G",22,22,"Orlando Magic","Anthony Black",0,5,6,3,4,7.1
1,1,5,6,2,16,8,2,2,"31",0,3,20,5,0,1,1037874,"2023-12-02T00:00:00.000Z",3,FALSE,22,3547251,"G",22,22,"Orlando Magic","Cole Anthony",1,25,26,21,6,29.5
2,0,1,5,0,8,2,0,0,"21",0,1,4,1,0,0,1037874,"2023-12-02T00:00:00.000Z",3,FALSE,22,196,"G",22,22,"Orlando Magic","Gary Harris",0,5,7,6,3,8.2
0,0,0,0,0,0,0,0,0,"00",0,0,0,0,0,0,1037874,"2023-12-02T00:00:00.000Z",3,FALSE,22,174,"F-C",3,3,"Brooklyn Nets","Harry Giles III",0,0,0,0,0,0
2,1,5,0,0,2,2,3,1,"24",1,3,5,6,0,1,1037874,"2023-12-02T00:00:00.000Z",3,FALSE,22,17896038,"C",3,3,"Brooklyn Nets","Day'Ron Sharpe",1,11,13,7,8,17.2
6,1,10,3,0,10,5,1,0,"21",1,0,10,11,2,1,1037874,"2023-12-02T00:00:00.000Z",3,FALSE,22,421,"G",3,3,"Brooklyn Nets","Dennis Smith Jr.",3,21,27,16,17,40.2
0,0,0,0,0,0,0,0,0,"00",0,0,0,0,0,0,1037874,"2023-12-02T00:00:00.000Z",3,FALSE,22,464,"G",3,3,"Brooklyn Nets","Lonnie Walker IV",0,0,0,0,0,0
1,1,1,0,0,4,3,1,1,"07",3,1,7,4,0,1,1037874,"2023-12-02T00:00:00.000Z",3,FALSE,22,17896058,"F",3,3,"Brooklyn Nets","Trendon Watford",1,11,12,8,5,15.3
0,0,0,0,0,0,0,0,0,"00",0,0,0,0,0,0,1037874,"2023-12-02T00:00:00.000Z",3,FALSE,22,56677841,"F",3,3,"Brooklyn Nets","Dariq Whitehead",0,0,0,0,0,0
0,0,0,0,0,0,0,0,0,"00",0,0,0,0,0,0,1037874,"2023-12-02T00:00:00.000Z",3,FALSE,22,9051997,"G",3,3,"Brooklyn Nets","Armoni Brooks",0,0,0,0,0,0
0,0,0,0,0,0,0,0,0,"00",0,0,0,0,0,0,1037874,"2023-12-02T00:00:00.000Z",3,FALSE,22,56677843,"F",3,3,"Brooklyn Nets","Noah Clowney",0,0,0,0,0,0
0,0,0,0,0,0,0,0,0,"00",0,0,0,0,0,0,1037874,"2023-12-02T00:00:00.000Z",3,FALSE,22,17896041,"G",3,3,"Brooklyn Nets","Keon Johnson",0,0,0,0,0,0
0,0,0,0,0,0,0,0,0,"00",0,0,0,0,0,0,1037874,"2023-12-02T00:00:00.000Z",3,FALSE,22,417,"G-F",3,3,"Brooklyn Nets","Ben Simmons",0,0,0,0,0,0
0,0,0,0,0,0,0,0,0,"00",0,0,0,0,0,0,1037874,"2023-12-02T00:00:00.000Z",3,FALSE,22,56677722,"F",3,3,"Brooklyn Nets","Jalen Wilson",0,0,0,0,0,0
0,0,0,0,0,0,0,0,0,"00",0,0,0,0,0,0,1037874,"2023-12-02T00:00:00.000Z",3,FALSE,22,165,"G",22,22,"Orlando Magic","Markelle Fultz",0,0,0,0,0,0
0,0,0,0,0,0,0,0,0,"00",0,0,0,0,0,0,1037874,"2023-12-02T00:00:00.000Z",3,FALSE,22,38017607,"G",22,22,"Orlando Magic","Kevon Harris",0,0,0,0,0,0
0,0,0,0,0,0,0,0,0,"00",0,0,0,0,0,0,1037874,"2023-12-02T00:00:00.000Z",3,FALSE,22,56677839,"G",22,22,"Orlando Magic","Jett Howard",0,0,0,0,0,0
0,0,0,0,0,0,0,0,0,"00",0,0,0,0,0,0,1037874,"2023-12-02T00:00:00.000Z",3,FALSE,22,17553983,"G",22,22,"Orlando Magic","Trevelin Queen",0,0,0,0,0,0
0,0,0,2,0,2,0,0,0,"04",0,0,0,0,0,1,1037874,"2023-12-02T00:00:00.000Z",3,FALSE,22,666818,"F",22,22,"Orlando Magic","Chuma Okeke",0,0,0,0,0,-1
1,0,1,2,0,2,0,0,0,"04",0,0,0,1,0,0,1037874,"2023-12-02T00:00:00.000Z",3,FALSE,22,666885,"F",22,22,"Orlando Magic","Admiral Schofield",0,1,2,1,2,2.7
0,0,0,0,0,0,0,0,0,"00",0,0,0,0,0,0,1037874,"2023-12-02T00:00:00.000Z",3,FALSE,22,85,"F",22,22,"Orlando Magic","Wendell Carter Jr.",0,0,0,0,0,0
0,0,1,2,1,9,5,0,0,"33",2,1,11,3,0,0,1037882,"2023-12-02T00:00:00.000Z",26,FALSE,8,30,"F",26,26,"Sacramento Kings","Harrison Barnes",0,14,14,11,3,14.6
1,0,5,5,2,10,3,0,0,"24",0,0,8,5,0,2,1037882,"2023-12-02T00:00:00.000Z",26,FALSE,8,38017688,"F",26,26,"Sacramento Kings","Keegan Murray",0,13,14,9,6,13.5
7,0,13,3,1,18,7,3,2,"36",2,5,17,15,1,2,1037882,"2023-12-02T00:00:00.000Z",26,FALSE,8,406,"F",26,26,"Sacramento Kings","Domantas Sabonis",1,32,39,24,22,46.5
2,1,6,6,4,10,6,0,0,"29",0,0,16,6,1,2,1037882,"2023-12-02T00:00:00.000Z",26,FALSE,8,221,"G",26,26,"Sacramento Kings","Kevin Huerter",2,22,24,18,8,30.2
16,1,3,6,3,22,10,4,3,"38",1,1,26,4,3,1,1037882,"2023-12-02T00:00:00.000Z",26,FALSE,8,161,"G",26,26,"Sacramento Kings","De'Aaron Fox",4,30,46,42,20,65.8
0,0,0,0,0,0,0,0,0,"00",0,0,0,0,0,0,1037882,"2023-12-02T00:00:00.000Z",26,FALSE,8,17896030,"G",26,26,"Sacramento Kings","Chris Duarte",0,0,0,0,0,0
0,0,0,0,0,0,0,0,0,"00",0,0,0,0,0,0,1037882,"2023-12-02T00:00:00.000Z",26,FALSE,8,17896044,"F",26,26,"Sacramento Kings","Kessler Edwards",0,0,0,0,0,0
2,0,0,1,0,1,0,0,0,"08",0,1,0,0,0,0,1037882,"2023-12-02T00:00:00.000Z",26,FALSE,8,38017714,"G",26,26,"Sacramento Kings","Keon Ellis",0,0,2,2,2,3
0,0,0,0,0,0,0,0,0,"00",0,0,0,0,0,0,1037882,"2023-12-02T00:00:00.000Z",26,FALSE,8,56677845,"G",26,26,"Sacramento Kings","Colby Jones",0,0,0,0,0,0
1,0,2,3,0,8,3,1,1,"18",2,2,7,4,0,0,1037882,"2023-12-02T00:00:00.000Z",26,FALSE,8,290,"F",26,26,"Sacramento Kings","Trey Lyles",0,11,12,8,5,13.3
0,3,3,0,0,4,4,0,0,"12",1,3,8,4,0,0,1037882,"2023-12-02T00:00:00.000Z",26,FALSE,8,306,"C",26,26,"Sacramento Kings","JaVale McGee",3,12,12,8,4,21.8
4,0,3,7,4,14,9,4,4,"28",0,1,26,3,2,3,1037882,"2023-12-02T00:00:00.000Z",26,FALSE,8,324,"G",26,26,"Sacramento Kings","Malik Monk",2,29,33,30,7,38.6
0,0,0,0,0,0,0,0,0,"00",0,0,0,0,0,0,1037882,"2023-12-02T00:00:00.000Z",26,FALSE,8,56677862,"F",26,26,"Sacramento Kings","Jalen Slawson",0,0,0,0,0,0
0,0,2,1,1,3,1,3,1,"14",1,0,4,3,0,1,1037882,"2023-12-02T00:00:00.000Z",26,FALSE,8,4197162,"F",26,26,"Sacramento Kings","Aleksandar Vezenkov",0,7,7,4,3,6.6
0,0,0,0,0,0,0,0,0,"00",0,0,0,0,0,0,1037882,"2023-12-02T00:00:00.000Z",26,FALSE,8,17895990,"G",26,26,"Sacramento Kings","Jordan Ford",0,0,0,0,0,0
0,0,0,0,0,0,0,0,0,"00",0,0,0,0,0,0,1037882,"2023-12-02T00:00:00.000Z",26,FALSE,8,273,"C",26,26,"Sacramento Kings","Alex Len",0,0,0,0,0,0
0,0,0,0,0,0,0,0,0,"00",0,0,0,0,0,0,1037882,"2023-12-02T00:00:00.000Z",26,FALSE,8,17553994,"G",26,26,"Sacramento Kings","Davion Mitchell",0,0,0,0,0,0
2,2,8,5,1,12,6,0,0,"33",0,1,13,8,0,1,1037882,"2023-12-02T00:00:00.000Z",26,FALSE,8,375,"F",8,8,"Denver Nuggets","Michael Porter Jr.",2,21,23,15,10,30.6
3,1,3,3,1,13,8,0,0,"33",4,1,17,7,0,1,1037882,"2023-12-02T00:00:00.000Z",26,FALSE,8,177,"F",8,8,"Denver Nuggets","Aaron Gordon",1,24,27,20,10,31.9
14,1,11,4,1,23,13,12,9,"38",2,3,36,13,2,0,1037882,"2023-12-02T00:00:00.000Z",26,FALSE,8,246,"C",8,8,"Denver Nuggets","Nikola Jokic",3,49,63,50,27,81.6
3,0,5,3,0,12,4,2,1,"38",0,1,9,5,4,4,1037882,"2023-12-02T00:00:00.000Z",26,FALSE,8,81,"G",8,8,"Denver Nuggets","Kentavious Caldwell-Pope",4,14,17,12,8,27.5
8,0,1,6,2,18,9,0,0,"33",0,3,20,1,1,2,1037882,"2023-12-02T00:00:00.000Z",26,FALSE,8,236,"G",8,8,"Denver Nuggets","Reggie Jackson",1,21,29,28,9,34.2
2,1,3,2,1,10,5,0,0,"17",0,1,11,3,1,1,1037882,"2023-12-02T00:00:00.000Z",26,FALSE,8,38017709,"G",8,8,"Denver Nuggets","Christian Braun",2,14,16,13,5,22.6
0,0,0,0,0,0,0,0,0,"00",0,0,0,0,0,0,1037882,"2023-12-02T00:00:00.000Z",26,FALSE,8,38017727,"G",8,8,"Denver Nuggets","Collin Gillespie",0,0,0,0,0,0
0,0,3,0,0,1,0,0,0,"12",0,2,0,3,0,0,1037882,"2023-12-02T00:00:00.000Z",26,FALSE,8,215,"F-G",8,8,"Denver Nuggets","Justin Holiday",0,3,3,0,3,3.6
0,0,2,0,0,6,2,2,0,"10",2,0,4,4,0,1,1037882,"2023-12-02T00:00:00.000Z",26,FALSE,8,250,"C",8,8,"Denver Nuggets","DeAndre Jordan",0,8,8,4,4,7.8
0,0,0,0,0,0,0,0,0,"00",0,0,0,0,0,0,1037882,"2023-12-02T00:00:00.000Z",26,FALSE,8,17896007,"G",8,8,"Denver Nuggets","Braxton Key",0,0,0,0,0,0
0,0,0,0,0,0,0,0,0,"00",0,0,0,0,0,0,1037882,"2023-12-02T00:00:00.000Z",26,FALSE,8,3547268,"F-C",8,8,"Denver Nuggets","Zeke Nnaji",0,0,0,0,0,0
2,0,1,2,0,3,1,2,1,"12",0,0,3,1,0,0,1037882,"2023-12-02T00:00:00.000Z",26,FALSE,8,56677776,"G",8,8,"Denver Nuggets","Julian Strawther",0,4,6,5,3,7.2
1,2,1,0,0,1,1,2,2,"14",0,2,4,1,1,0,1037882,"2023-12-02T00:00:00.000Z",26,FALSE,8,38017721,"G",8,8,"Denver Nuggets","Peyton Watson",3,5,6,5,2,15.7
0,0,0,0,0,0,0,0,0,"00",0,0,0,0,0,0,1037882,"2023-12-02T00:00:00.000Z",26,FALSE,8,666489,"F",8,8,"Denver Nuggets","Vlatko Cancar",0,0,0,0,0,0
0,0,0,0,0,0,0,0,0,"00",0,0,0,0,0,0,1037882,"2023-12-02T00:00:00.000Z",26,FALSE,8,17896103,"F-C",8,8,"Denver Nuggets","Jay Huff",0,0,0,0,0,0
0,0,0,0,0,0,0,0,0,"00",0,0,0,0,0,0,1037882,"2023-12-02T00:00:00.000Z",26,FALSE,8,335,"G",8,8,"Denver Nuggets","Jamal Murray",0,0,0,0,0,0
0,0,0,0,0,0,0,0,0,"00",0,0,0,0,0,0,1037882,"2023-12-02T00:00:00.000Z",26,FALSE,8,56677582,"G",8,8,"Denver Nuggets","Jalen Pickett",0,0,0,0,0,0
0,0,0,0,0,0,0,0,0,"00",0,0,0,0,0,0,1037882,"2023-12-02T00:00:00.000Z",26,FALSE,8,56677871,"F",8,8,"Denver Nuggets","Hunter Tyson",0,0,0,0,0,0
1,1,4,1,0,7,4,3,3,"25",1,3,11,5,0,0,1037883,"2023-12-02T00:00:00.000Z",14,FALSE,11,666860,"F-G",14,14,"Los Angeles Lakers","Cameron Reddish",1,16,17,12,6,21.5
7,1,4,4,0,17,7,5,2,"35",0,0,16,4,1,5,1037883,"2023-12-02T00:00:00.000Z",14,FALSE,11,237,"F",14,14,"Los Angeles Lakers","LeBron James",2,20,27,23,11,32.3
3,5,8,0,0,22,10,9,7,"37",6,2,27,14,0,1,1037883,"2023-12-02T00:00:00.000Z",14,FALSE,11,117,"F-C",14,14,"Los Angeles Lakers","Anthony Davis",5,41,44,30,17,62.3
1,0,6,5,3,7,4,0,0,"29",0,0,11,6,2,1,1037883,"2023-12-02T00:00:00.000Z",14,FALSE,11,383,"F",14,14,"Los Angeles Lakers","Taurean Prince",2,17,18,12,7,24.7
7,0,2,5,1,10,4,0,0,"26",0,2,9,2,5,0,1037883,"2023-12-02T00:00:00.000Z",14,FALSE,11,405,"G",14,14,"Los Angeles Lakers","D'Angelo Russell",5,11,18,16,9,36.9
2,0,7,3,3,7,4,2,1,"29",0,3,12,7,0,0,1037883,"2023-12-02T00:00:00.000Z",14,FALSE,11,38017697,"G",14,14,"Los Angeles Lakers","Max Christie",0,19,21,14,9,23.4
1,0,3,2,0,2,0,0,0,"14",1,1,0,4,0,0,1037883,"2023-12-02T00:00:00.000Z",14,FALSE,11,457,"F",14,14,"Los Angeles Lakers","Jarred Vanderbilt",0,4,5,1,5,6.3
0,0,0,0,0,0,0,0,0,"00",0,0,0,0,0,0,1037883,"2023-12-02T00:00:00.000Z",14,FALSE,11,56677868,"G",14,14,"Los Angeles Lakers","D'Moi Hodge",0,0,0,0,0,0
0,0,0,0,0,0,0,0,0,"00",0,0,0,0,0,0,1037883,"2023-12-02T00:00:00.000Z",14,FALSE,11,1603383,"G",14,14,"Los Angeles Lakers","Gabe Vincent",0,0,0,0,0,0
1,0,1,4,2,9,4,0,0,"33",1,4,10,2,0,1,1037883,"2023-12-02T00:00:00.000Z",14,FALSE,11,66,"G-F",11,11,"Houston Rockets","Dillon Brooks",0,12,13,11,3,12.9
3,3,8,3,0,7,4,2,2,"30",1,5,10,9,2,3,1037883,"2023-12-02T00:00:00.000Z",14,FALSE,11,38017684,"F",11,11,"Houston Rockets","Jabari Smith Jr.",5,19,22,13,12,37.3
5,2,10,8,3,25,8,2,2,"34",3,2,21,13,2,0,1037883,"2023-12-02T00:00:00.000Z",14,FALSE,11,17896062,"F-C",11,11,"Houston Rockets","Alperen Sengun",4,34,39,26,18,56.1
2,0,6,6,1,15,4,2,1,"32",1,1,10,7,0,6,1037883,"2023-12-02T00:00:00.000Z",14,FALSE,11,17895966,"G",11,11,"Houston Rockets","Jalen Green",0,17,19,12,9,15.4
7,0,4,7,4,15,7,4,4,"40",1,1,22,5,0,3,1037883,"2023-12-02T00:00:00.000Z",14,FALSE,11,458,"G",11,11,"Houston Rockets","Fred VanVleet",0,27,34,29,12,35.5
0,0,0,0,0,0,0,0,0,"00",0,0,0,0,0,0,1037883,"2023-12-02T00:00:00.000Z",14,FALSE,11,75,"G-F",11,11,"Houston Rockets","Reggie Bullock",0,0,0,0,0,0
2,1,5,1,0,5,2,2,2,"20",2,2,6,7,1,1,1037883,"2023-12-02T00:00:00.000Z",14,FALSE,11,38017695,"F",11,11,"Houston Rockets","Tari Eason",2,13,15,8,9,22.4
0,0,1,0,0,2,0,0,0,"11",0,3,0,1,0,2,1037883,"2023-12-02T00:00:00.000Z",14,FALSE,11,188,"F",11,11,"Houston Rockets","Jeff Green",0,1,1,0,1,-0.8
0,0,2,0,0,1,0,0,0,"03",0,1,0,2,0,0,1037883,"2023-12-02T00:00:00.000Z",14,FALSE,11,3547281,"G-F",11,11,"Houston Rockets","Nate Hinton",0,2,2,0,2,2.4
3,0,0,2,1,6,5,0,0,"14",1,2,11,1,0,0,1037883,"2023-12-02T00:00:00.000Z",14,FALSE,11,213,"G",11,11,"Houston Rockets","Aaron Holiday",0,12,15,14,4,16.7
0,1,0,0,0,0,0,0,0,"03",0,0,0,0,0,0,1037883,"2023-12-02T00:00:00.000Z",14,FALSE,11,19465326,"C",11,11,"Houston Rockets","Jock Landale",1,0,0,0,0,3
0,0,0,0,0,0,0,0,0,"00",0,0,0,0,0,0,1037883,"2023-12-02T00:00:00.000Z",14,FALSE,11,296,"C",11,11,"Houston Rockets","Boban Marjanovic",0,0,0,0,0,0
0,0,2,0,0,0,0,0,0,"03",0,0,0,2,0,0,1037883,"2023-12-02T00:00:00.000Z",14,FALSE,11,56677809,"F",11,11,"Houston Rockets","Jermaine Samuels Jr.",0,2,2,0,2,2.4
0,0,2,0,0,2,1,0,0,"14",0,2,2,2,0,0,1037883,"2023-12-02T00:00:00.000Z",14,FALSE,11,3547301,"F",11,11,"Houston Rockets","Jae'Sean Tate",0,4,4,2,2,4.4
1,0,2,0,0,2,1,6,3,"03",1,0,5,3,0,0,1037883,"2023-12-02T00:00:00.000Z",14,FALSE,11,56677831,"F",11,11,"Houston Rockets","Cam Whitmore",0,8,9,6,4,10.1
0,0,0,0,0,0,0,0,0,"00",0,0,0,0,0,0,1037883,"2023-12-02T00:00:00.000Z",14,FALSE,11,357,"G",11,11,"Houston Rockets","Victor Oladipo",0,0,0,0,0,0
0,0,0,0,0,0,0,0,0,"00",0,0,0,0,0,0,1037883,"2023-12-02T00:00:00.000Z",14,FALSE,11,56677825,"G-F",11,11,"Houston Rockets","Amen Thompson",0,0,0,0,0,0
0,0,0,0,0,0,0,0,0,"00",0,0,0,0,0,0,1037883,"2023-12-02T00:00:00.000Z",14,FALSE,11,47738533,"G",11,11,"Houston Rockets","Jeenathan Williams",0,0,0,0,0,0
1,0,3,4,1,11,6,6,5,"22",1,2,18,4,3,1,1037883,"2023-12-02T00:00:00.000Z",14,FALSE,11,17553995,"G",14,14,"Los Angeles Lakers","Austin Reaves",3,22,23,19,5,32.3
1,0,2,0,0,1,0,2,1,"11",0,0,1,2,0,1,1037883,"2023-12-02T00:00:00.000Z",14,FALSE,11,486,"F",14,14,"Los Angeles Lakers","Christian Wood",0,3,4,2,3,3.9
0,0,0,0,0,0,0,0,0,"00",0,0,0,0,0,0,1037883,"2023-12-02T00:00:00.000Z",14,FALSE,11,666609,"F",14,14,"Los Angeles Lakers","Rui Hachimura",0,0,0,0,0,0
0,0,0,1,0,2,1,0,0,"06",0,3,2,0,0,0,1037883,"2023-12-02T00:00:00.000Z",14,FALSE,11,666626,"C",14,14,"Los Angeles Lakers","Jaxson Hayes",0,2,2,2,0,2
0,0,0,1,0,2,0,0,0,"03",0,0,0,0,0,0,1037883,"2023-12-02T00:00:00.000Z",14,FALSE,11,56677835,"G",14,14,"Los Angeles Lakers","Jalen Hood-Schifino",0,0,0,0,0,0
0,0,0,1,0,1,0,0,0,"03",0,1,0,0,0,0,1037883,"2023-12-02T00:00:00.000Z",14,FALSE,11,56677836,"F",14,14,"Los Angeles Lakers","Maxwell Lewis",0,0,0,0,0,0
0,0,0,0,0,0,0,0,0,"00",0,0,0,0,0,0,1037883,"2023-12-02T00:00:00.000Z",14,FALSE,11,56677738,"C",14,14,"Los Angeles Lakers","Colin Castleton",0,0,0,0,0,0
0,0,0,0,0,0,0,0,0,"00",0,0,0,0,0,0,1037883,"2023-12-02T00:00:00.000Z",14,FALSE,11,56677867,"F",14,14,"Los Angeles Lakers","Alex Fudge",0,0,0,0,0,0
2,0,0,6,4,11,7,4,3,"32",2,2,21,2,2,1,7045521,"2023-12-04T00:00:00.000Z",12,FALSE,2,210,"G",12,12,"Indiana Pacers","Buddy Hield",2,23,25,23,4,31.4
1,2,2,4,2,8,4,2,2,"26",0,1,12,2,0,0,7045521,"2023-12-04T00:00:00.000Z",12,FALSE,2,3547243,"F",12,12,"Indiana Pacers","Obi Toppin",2,14,15,13,3,21.9
1,1,9,6,2,16,7,1,1,"34",1,1,17,10,1,0,7045521,"2023-12-04T00:00:00.000Z",12,FALSE,2,452,"C-F",12,12,"Indiana Pacers","Myles Turner",2,27,28,18,11,36.5
4,0,8,3,1,10,3,7,6,"36",0,4,13,8,3,3,7045521,"2023-12-04T00:00:00.000Z",12,FALSE,2,69,"G",12,12,"Indiana Pacers","Bruce Brown",3,21,25,17,12,34.6
13,0,7,11,5,18,10,1,1,"40",3,2,26,10,1,0,7045521,"2023-12-04T00:00:00.000Z",12,FALSE,2,3547245,"G",12,12,"Indiana Pacers","Tyrese Haliburton",1,36,49,39,23,60.5
0,0,0,0,0,0,0,0,0,"00",0,0,0,0,0,0,7045521,"2023-12-04T00:00:00.000Z",12,FALSE,2,17896035,"F",12,12,"Indiana Pacers","Isaiah Jackson",0,0,0,0,0,0
2,0,4,7,4,14,5,2,2,"27",1,1,16,5,0,1,7045521,"2023-12-04T00:00:00.000Z",12,FALSE,2,38017686,"G-F",12,12,"Indiana Pacers","Bennedict Mathurin",0,21,23,18,7,24
3,0,2,0,0,5,1,0,0,"09",0,0,2,2,1,0,7045521,"2023-12-04T00:00:00.000Z",12,FALSE,2,304,"G",12,12,"Indiana Pacers","T.J. McConnell",1,4,7,5,5,11.9
1,0,1,0,0,2,0,2,1,"05",0,1,1,1,0,0,7045521,"2023-12-04T00:00:00.000Z",12,FALSE,2,38017507,"G-F",12,12,"Indiana Pacers","Andrew Nembhard",0,2,3,2,2,3.7
1,1,1,3,1,10,6,2,1,"31",0,3,14,1,0,1,7045521,"2023-12-04T00:00:00.000Z",12,FALSE,2,3547250,"G-F",12,12,"Indiana Pacers","Aaron Nesmith",1,15,16,15,2,18.7
0,0,0,0,0,0,0,0,0,"00",0,0,0,0,0,0,7045521,"2023-12-04T00:00:00.000Z",12,FALSE,2,3547207,"F",12,12,"Indiana Pacers","Jordan Nwora",0,0,0,0,0,0
0,0,0,0,0,0,0,0,0,"00",0,0,0,0,0,0,7045521,"2023-12-04T00:00:00.000Z",12,FALSE,2,56677861,"G",12,12,"Indiana Pacers","Ben Sheppard",0,0,0,0,0,0
0,0,0,0,0,0,0,0,0,"00",0,0,0,0,0,0,7045521,"2023-12-04T00:00:00.000Z",12,FALSE,2,56677778,"F-C",12,12,"Indiana Pacers","Oscar Tshiebwe",0,0,0,0,0,0
0,0,0,0,0,0,0,0,0,"00",0,0,0,0,0,0,7045521,"2023-12-04T00:00:00.000Z",12,FALSE,2,56677832,"F",12,12,"Indiana Pacers","Jarace Walker",0,0,0,0,0,0
0,0,0,0,0,0,0,0,0,"00",0,0,0,0,0,0,7045521,"2023-12-04T00:00:00.000Z",12,FALSE,2,38017701,"G",12,12,"Indiana Pacers","Kendall Brown",0,0,0,0,0,0
0,0,0,0,0,0,0,0,0,"00",0,0,0,0,0,0,7045521,"2023-12-04T00:00:00.000Z",12,FALSE,2,3547264,"F-C",12,12,"Indiana Pacers","Jalen Smith",0,0,0,0,0,0
0,0,0,0,0,0,0,0,0,"00",0,0,0,0,0,0,7045521,"2023-12-04T00:00:00.000Z",12,FALSE,2,56677794,"G",12,12,"Indiana Pacers","Isaiah Wong",0,0,0,0,0,0
6,0,11,8,2,26,13,7,4,"37",1,2,32,12,1,2,7045521,"2023-12-04T00:00:00.000Z",12,FALSE,2,434,"F",2,2,"Boston Celtics","Jayson Tatum",1,44,50,38,18,56.4
0,2,7,7,2,23,14,1,0,"32",2,6,30,9,1,3,7045521,"2023-12-04T00:00:00.000Z",12,FALSE,2,70,"G",2,2,"Boston Celtics","Jaylen Brown",3,39,39,30,9,46.8
4,1,5,1,0,3,1,0,0,"31",2,1,2,7,0,2,7045521,"2023-12-04T00:00:00.000Z",12,FALSE,2,219,"C-F",2,2,"Boston Celtics","Al Horford",1,9,13,6,11,17.4
8,1,4,9,2,16,7,2,2,"36",0,4,18,4,1,5,7045521,"2023-12-04T00:00:00.000Z",12,FALSE,2,473,"G",2,2,"Boston Celtics","Derrick White",2,22,30,26,12,35.8
3,1,5,5,1,9,3,2,2,"38",1,1,9,6,1,1,7045521,"2023-12-04T00:00:00.000Z",12,FALSE,2,214,"G",2,2,"Boston Celtics","Jrue Holiday",2,15,18,12,9,25.7
1,0,4,7,5,9,5,0,0,"23",2,2,15,6,0,0,7045521,"2023-12-04T00:00:00.000Z",12,FALSE,2,17896060,"F",2,2,"Boston Celtics","Sam Hauser",0,21,22,16,7,23.7
1,0,3,0,0,1,0,0,0,"11",1,1,0,4,0,3,7045521,"2023-12-04T00:00:00.000Z",12,FALSE,2,17896094,"G",2,2,"Boston Celtics","Dalano Banton",0,4,5,1,5,3.3
0,0,0,0,0,0,0,0,0,"00",0,0,0,0,0,0,7045521,"2023-12-04T00:00:00.000Z",12,FALSE,2,666468,"F",2,2,"Boston Celtics","Oshae Brissett",0,0,0,0,0,0
2,4,0,0,0,5,3,0,0,"17",4,2,6,4,1,1,7045521,"2023-12-04T00:00:00.000Z",12,FALSE,2,261,"F-C",2,2,"Boston Celtics","Luke Kornet",5,10,12,8,6,27.8
0,0,0,0,0,0,0,0,0,"00",0,0,0,0,0,0,7045521,"2023-12-04T00:00:00.000Z",12,FALSE,2,338,"G",2,2,"Boston Celtics","Svi Mykhailiuk",0,0,0,0,0,0
2,0,4,4,0,5,0,0,0,"15",0,0,0,4,0,0,7045521,"2023-12-04T00:00:00.000Z",12,FALSE,2,3547276,"G",2,2,"Boston Celtics","Payton Pritchard",0,4,6,2,6,7.8
0,0,0,0,0,0,0,0,0,"00",0,0,0,0,0,0,7045521,"2023-12-04T00:00:00.000Z",12,FALSE,2,17553967,"C",2,2,"Boston Celtics","Neemias Queta",0,0,0,0,0,0
0,0,0,0,0,0,0,0,0,"00",0,0,0,0,0,0,7045521,"2023-12-04T00:00:00.000Z",12,FALSE,2,3547279,"F",2,2,"Boston Celtics","Lamar Stevens",0,0,0,0,0,0
0,0,0,0,0,0,0,0,0,"00",0,0,0,0,0,0,7045521,"2023-12-04T00:00:00.000Z",12,FALSE,2,38017707,"G",2,2,"Boston Celtics","JD Davison",0,0,0,0,0,0
0,0,0,0,0,0,0,0,0,"00",0,0,0,0,0,0,7045521,"2023-12-04T00:00:00.000Z",12,FALSE,2,3547295,"F-C",2,2,"Boston Celtics","Nathan Knight",0,0,0,0,0,0
0,0,0,0,0,0,0,0,0,"00",0,0,0,0,0,0,7045521,"2023-12-04T00:00:00.000Z",12,FALSE,2,378,"F-C",2,2,"Boston Celtics","Kristaps Porzingis",0,0,0,0,0,0
0,0,0,0,0,0,0,0,0,"00",0,0,0,0,0,0,7045521,"2023-12-04T00:00:00.000Z",12,FALSE,2,56677864,"G",2,2,"Boston Celtics","Jordan Walsh",0,0,0,0,0,0
1,1,3,3,1,3,1,2,1,"34",1,0,4,4,1,2,7045522,"2023-12-04T00:00:00.000Z",26,FALSE,19,30,"F",26,26,"Sacramento Kings","Harrison Barnes",2,8,9,5,5,14.3
1,0,4,8,4,11,5,0,0,"31",0,5,14,4,0,1,7045522,"2023-12-04T00:00:00.000Z",26,FALSE,19,38017688,"F",26,26,"Sacramento Kings","Keegan Murray",0,18,19,15,5,19.3
10,1,8,1,0,12,8,10,10,"36",5,3,26,13,2,1,7045522,"2023-12-04T00:00:00.000Z",26,FALSE,19,406,"F",26,26,"Sacramento Kings","Domantas Sabonis",3,39,49,36,23,64.6
2,0,4,7,2,10,5,0,0,"32",1,2,12,5,0,0,7045522,"2023-12-04T00:00:00.000Z",26,FALSE,19,221,"G",26,26,"Sacramento Kings","Kevin Huerter",0,17,19,14,7,21
4,0,4,7,1,25,10,13,9,"40",1,2,30,5,1,6,7045522,"2023-12-04T00:00:00.000Z",26,FALSE,19,161,"G",26,26,"Sacramento Kings","De'Aaron Fox",1,35,39,34,9,39
0,0,0,0,0,0,0,0,0,"00",0,0,0,0,0,0,7045522,"2023-12-04T00:00:00.000Z",26,FALSE,19,17896044,"F",26,26,"Sacramento Kings","Kessler Edwards",0,0,0,0,0,0
0,0,0,2,1,2,1,2,2,"08",0,1,5,0,1,0,7045522,"2023-12-04T00:00:00.000Z",26,FALSE,19,38017714,"G",26,26,"Sacramento Kings","Keon Ellis",1,5,5,5,0,8
0,0,0,0,0,0,0,0,0,"00",0,0,0,0,0,0,7045522,"2023-12-04T00:00:00.000Z",26,FALSE,19,17895990,"G",26,26,"Sacramento Kings","Jordan Ford",0,0,0,0,0,0
0,0,0,0,0,0,0,0,0,"00",0,0,0,0,0,0,7045522,"2023-12-04T00:00:00.000Z",26,FALSE,19,56677845,"G",26,26,"Sacramento Kings","Colby Jones",0,0,0,0,0,0
6,0,1,3,0,4,1,4,3,"16",0,3,5,1,0,0,7045522,"2023-12-04T00:00:00.000Z",26,FALSE,19,290,"F",26,26,"Sacramento Kings","Trey Lyles",0,6,12,11,7,15.2
0,0,1,0,0,1,0,0,0,"04",0,0,0,1,1,0,7045522,"2023-12-04T00:00:00.000Z",26,FALSE,19,306,"C",26,26,"Sacramento Kings","JaVale McGee",1,1,1,0,1,4.2
0,0,0,0,0,0,0,0,0,"00",0,0,0,0,0,0,7045522,"2023-12-04T00:00:00.000Z",26,FALSE,19,17553994,"G",26,26,"Sacramento Kings","Davion Mitchell",0,0,0,0,0,0
5,0,2,9,5,14,7,2,2,"33",1,0,21,3,2,3,7045522,"2023-12-04T00:00:00.000Z",26,FALSE,19,324,"G",26,26,"Sacramento Kings","Malik Monk",2,24,29,26,8,35.1
0,0,0,0,0,0,0,0,0,"00",0,0,0,0,0,0,7045522,"2023-12-04T00:00:00.000Z",26,FALSE,19,56677837,"G",19,19,"New Orleans Pelicans","Jordan Hawkins",0,0,0,0,0,0
0,0,0,0,0,0,0,0,0,"00",0,0,0,0,0,0,7045522,"2023-12-04T00:00:00.000Z",26,FALSE,19,3547260,"G",19,19,"New Orleans Pelicans","Kira Lewis Jr.",0,0,0,0,0,0
2,0,2,2,0,3,1,2,2,"13",2,1,4,4,1,1,7045522,"2023-12-04T00:00:00.000Z",26,FALSE,19,3547293,"F",19,19,"New Orleans Pelicans","Naji Marshall",1,8,10,6,6,13.8
1,1,2,8,3,13,6,2,1,"30",0,1,16,2,0,0,7045522,"2023-12-04T00:00:00.000Z",26,FALSE,19,18677986,"F",19,19,"New Orleans Pelicans","Trey Murphy III",1,18,19,17,3,22.9
0,0,0,0,0,0,0,0,0,"00",0,0,0,0,0,0,7045522,"2023-12-04T00:00:00.000Z",26,FALSE,19,17896021,"F",19,19,"New Orleans Pelicans","Jeremiah Robinson-Earl",0,0,0,0,0,0
0,0,0,0,0,0,0,0,0,"05",0,0,0,0,1,0,7045522,"2023-12-04T00:00:00.000Z",26,FALSE,19,491,"C",19,19,"New Orleans Pelicans","Cody Zeller",1,0,0,0,0,3
0,0,0,0,0,0,0,0,0,"00",0,0,0,0,0,0,7045522,"2023-12-04T00:00:00.000Z",26,FALSE,19,38017663,"F",19,19,"New Orleans Pelicans","E.J. Liddell",0,0,0,0,0,0
0,0,0,0,0,0,0,0,0,"00",0,0,0,0,0,0,7045522,"2023-12-04T00:00:00.000Z",26,FALSE,19,340,"F",19,19,"New Orleans Pelicans","Larry Nance Jr.",0,0,0,0,0,0
0,0,0,0,0,0,0,0,0,"00",0,0,0,0,0,0,7045522,"2023-12-04T00:00:00.000Z",26,FALSE,19,17896017,"F",19,19,"New Orleans Pelicans","Matt Ryan",0,0,0,0,0,0
0,0,0,0,0,0,0,0,0,"00",0,0,0,0,0,0,7045522,"2023-12-04T00:00:00.000Z",26,FALSE,19,38017726,"G",19,19,"New Orleans Pelicans","Dereon Seabron",0,0,0,0,0,0
0,0,0,0,0,0,0,0,0,"00",0,0,0,0,0,0,7045522,"2023-12-04T00:00:00.000Z",26,FALSE,19,56677862,"F",26,26,"Sacramento Kings","Jalen Slawson",0,0,0,0,0,0
0,0,0,1,0,3,0,0,0,"06",2,2,0,2,0,0,7045522,"2023-12-04T00:00:00.000Z",26,FALSE,19,4197162,"F",26,26,"Sacramento Kings","Aleksandar Vezenkov",0,2,2,0,2,2.4
0,0,0,0,0,0,0,0,0,"00",0,0,0,0,0,0,7045522,"2023-12-04T00:00:00.000Z",26,FALSE,19,17896030,"G",26,26,"Sacramento Kings","Chris Duarte",0,0,0,0,0,0
0,0,0,0,0,0,0,0,0,"00",0,0,0,0,0,0,7045522,"2023-12-04T00:00:00.000Z",26,FALSE,19,273,"C",26,26,"Sacramento Kings","Alex Len",0,0,0,0,0,0
6,0,6,6,3,20,10,9,7,"40",2,2,30,8,1,2,7045522,"2023-12-04T00:00:00.000Z",26,FALSE,19,227,"F",19,19,"New Orleans Pelicans","Brandon Ingram",1,38,44,36,14,49.6
6,0,5,2,0,8,5,0,0,"28",1,3,10,6,3,4,7045522,"2023-12-04T00:00:00.000Z",26,FALSE,19,666969,"F",19,19,"New Orleans Pelicans","Zion Williamson",3,16,22,16,12,31.2
0,0,7,0,0,11,7,4,4,"29",4,6,18,11,0,1,7045522,"2023-12-04T00:00:00.000Z",26,FALSE,19,455,"C",19,19,"New Orleans Pelicans","Jonas Valanciunas",0,29,29,18,11,30.2
5,2,2,5,3,13,8,4,4,"35",3,5,23,5,0,1,7045522,"2023-12-04T00:00:00.000Z",26,FALSE,19,17896024,"F",19,19,"New Orleans Pelicans","Herbert Jones",2,28,33,28,10,41.5
7,2,2,5,3,14,7,0,0,"36",0,2,17,2,2,2,7045522,"2023-12-04T00:00:00.000Z",26,FALSE,19,303,"G",19,19,"New Orleans Pelicans","CJ McCollum",4,19,26,24,9,39.9
2,2,3,3,2,4,3,2,1,"18",0,1,9,3,2,1,7045522,"2023-12-04T00:00:00.000Z",26,FALSE,19,17896097,"G",19,19,"New Orleans Pelicans","Jose Alvarado",4,12,14,11,5,26.6
0,0,0,0,0,1,0,0,0,"06",1,1,0,1,2,0,7045522,"2023-12-04T00:00:00.000Z",26,FALSE,19,38017677,"G",19,19,"New Orleans Pelicans","Dyson Daniels",2,1,1,0,1,7.2
7,0,2,3,2,12,6,0,0,"26",2,1,14,4,1,2,7045523,"2023-12-05T00:00:00.000Z",17,FALSE,20,315,"F",17,17,"Milwaukee Bucks","Khris Middleton",1,18,25,21,11,30.3
10,0,5,1,1,22,15,9,4,"34",3,3,35,8,3,4,7045523,"2023-12-05T00:00:00.000Z",17,FALSE,20,15,"F",17,17,"Milwaukee Bucks","Giannis Antetokounmpo",3,43,53,45,18,64.6
3,3,6,4,1,8,4,0,0,"34",2,4,9,8,3,0,7045523,"2023-12-05T00:00:00.000Z",17,FALSE,20,283,"C",17,17,"Milwaukee Bucks","Brook Lopez",6,17,20,12,11,41.1
0,0,3,10,6,11,6,0,0,"33",0,4,18,3,0,0,7045523,"2023-12-05T00:00:00.000Z",17,FALSE,20,38,"G",17,17,"Milwaukee Bucks","Malik Beasley",0,21,21,18,3,21.6
7,1,2,7,5,13,8,8,7,"34",1,4,28,3,1,3,7045523,"2023-12-05T00:00:00.000Z",17,FALSE,20,278,"G",17,17,"Milwaukee Bucks","Damian Lillard",2,31,38,35,10,45.1
0,0,0,0,0,1,1,0,0,"02",1,0,2,1,1,0,7045523,"2023-12-05T00:00:00.000Z",17,FALSE,20,2148,"",17,17,"Milwaukee Bucks","Thanasis Antetokounmpo",1,3,3,2,1,6.2
1,0,2,2,2,3,2,0,0,"19",0,1,6,2,1,0,7045523,"2023-12-05T00:00:00.000Z",17,FALSE,20,38017676,"F",17,17,"Milwaukee Bucks","MarJon Beauchamp",1,8,9,7,3,12.9
0,0,0,0,0,0,0,0,0,"00",0,0,0,0,0,0,7045523,"2023-12-05T00:00:00.000Z",17,FALSE,20,666453,"C",17,17,"Milwaukee Bucks","Marques Bolden",0,0,0,0,0,0
1,0,0,4,3,4,3,0,0,"15",0,0,9,0,0,0,7045523,"2023-12-05T00:00:00.000Z",17,FALSE,20,38017733,"G",17,17,"Milwaukee Bucks","A.J. Green",0,9,10,10,1,10.5
0,0,0,0,0,0,0,0,0,"01",0,0,0,0,0,0,7045523,"2023-12-05T00:00:00.000Z",17,FALSE,20,56677852,"G",17,17,"Milwaukee Bucks","Andre Jackson Jr.",0,0,0,0,0,0
0,0,1,0,0,1,0,0,0,"02",1,0,0,2,1,1,7045523,"2023-12-05T00:00:00.000Z",17,FALSE,20,56677854,"F",17,17,"Milwaukee Bucks","Chris Livingston",1,2,2,0,2,4.4
0,0,0,1,0,1,0,0,0,"02",0,0,0,0,0,0,7045523,"2023-12-05T00:00:00.000Z",17,FALSE,20,284,"C",17,17,"Milwaukee Bucks","Robin Lopez",0,0,0,0,0,0
2,0,2,3,2,6,5,0,0,"14",0,2,12,2,1,1,7045523,"2023-12-05T00:00:00.000Z",17,FALSE,20,368,"G",17,17,"Milwaukee Bucks","Cameron Payne",1,14,16,14,4,19.4
1,2,2,3,1,9,5,2,2,"24",2,4,13,4,0,1,7045523,"2023-12-05T00:00:00.000Z",17,FALSE,20,377,"F",17,17,"Milwaukee Bucks","Bobby Portis",2,17,18,14,5,24.3
0,0,0,0,0,0,0,0,0,"00",0,0,0,0,0,0,7045523,"2023-12-05T00:00:00.000Z",17,FALSE,20,666960,"G",17,17,"Milwaukee Bucks","Lindell Wigginton",0,0,0,0,0,0
0,0,0,0,0,0,0,0,0,"00",0,0,0,0,0,0,7045523,"2023-12-05T00:00:00.000Z",17,FALSE,20,105,"G",17,17,"Milwaukee Bucks","Pat Connaughton",0,0,0,0,0,0
0,0,0,0,0,0,0,0,0,"00",0,0,0,0,0,0,7045523,"2023-12-05T00:00:00.000Z",17,FALSE,20,112,"F",17,17,"Milwaukee Bucks","Jae Crowder",0,0,0,0,0,0
0,0,0,0,0,0,0,0,0,"00",0,0,0,0,0,0,7045523,"2023-12-05T00:00:00.000Z",17,FALSE,20,38017691,"G",17,17,"Milwaukee Bucks","TyTy Washington Jr.",0,0,0,0,0,0
1,0,5,4,1,18,7,8,8,"31",3,0,23,8,0,2,7045523,"2023-12-05T00:00:00.000Z",17,FALSE,20,666423,"F-G",20,20,"New York Knicks","RJ Barrett",0,31,32,24,9,32.1
5,0,3,2,2,19,14,12,11,"37",3,3,41,6,0,4,7045523,"2023-12-05T00:00:00.000Z",17,FALSE,20,387,"F",20,20,"New York Knicks","Julius Randle",0,47,52,46,11,51.7
3,1,3,0,0,2,1,0,0,"27",1,2,2,4,2,2,7045523,"2023-12-05T00:00:00.000Z",17,FALSE,20,399,"C",20,20,"New York Knicks","Mitchell Robinson",3,6,9,5,7,18.3
1,0,1,0,0,0,0,0,0,"02",0,0,0,1,1,0,7045523,"2023-12-05T00:00:00.000Z",17,FALSE,20,19,"G",20,20,"New York Knicks","Ryan Arcidiacono",1,1,2,1,2,5.7
0,0,0,1,0,1,0,0,0,"02",0,0,0,0,0,2,7045523,"2023-12-05T00:00:00.000Z",17,FALSE,20,666474,"G",20,20,"New York Knicks","Charles Brown",0,0,0,0,0,-2
2,0,1,4,1,5,2,2,2,"17",0,2,7,1,0,0,7045523,"2023-12-05T00:00:00.000Z",17,FALSE,20,131,"G",20,20,"New York Knicks","Donte DiVincenzo",0,8,10,9,3,11.2
1,0,3,1,1,8,5,0,0,"26",1,3,11,4,3,0,7045523,"2023-12-05T00:00:00.000Z",17,FALSE,20,202,"G",20,20,"New York Knicks","Josh Hart",3,15,16,12,5,26.3
5,2,3,0,0,3,2,0,0,"18",4,2,4,7,0,1,7045523,"2023-12-05T00:00:00.000Z",17,FALSE,20,201,"F-C",20,20,"New York Knicks","Isaiah Hartenstein",2,11,16,9,12,24.9
0,0,1,1,0,1,0,0,0,"18",0,4,0,1,1,0,7045523,"2023-12-05T00:00:00.000Z",17,FALSE,20,17895858,"G",20,20,"New York Knicks","Quentin Grimes",1,1,1,0,1,4.2
6,0,3,5,0,22,10,7,4,"34",0,1,24,3,1,3,7045523,"2023-12-05T00:00:00.000Z",17,FALSE,20,73,"G",20,20,"New York Knicks","Jalen Brunson",1,27,33,30,9,36.6
0,0,0,0,0,0,0,0,0,"00",0,0,0,0,0,0,7045523,"2023-12-05T00:00:00.000Z",17,FALSE,20,59421201,"G",20,20,"New York Knicks","Jaylen Martin",0,0,0,0,0,0
0,0,0,1,1,1,1,0,0,"03",0,0,3,0,0,0,7045523,"2023-12-05T00:00:00.000Z",17,FALSE,20,17896033,"G",20,20,"New York Knicks","Miles McBride",0,3,3,3,0,3
3,0,1,4,1,7,1,4,4,"19",0,0,7,1,0,1,7045523,"2023-12-05T00:00:00.000Z",17,FALSE,20,3547269,"G",20,20,"New York Knicks","Immanuel Quickley",0,8,11,10,4,11.7
0,0,0,0,0,0,0,0,0,"03",0,0,0,0,0,1,7045523,"2023-12-05T00:00:00.000Z",17,FALSE,20,17896063,"F",20,20,"New York Knicks","Jericho Sims",0,0,0,0,0,-1
0,1,0,0,0,0,0,0,0,"03",0,0,0,0,0,0,7045523,"2023-12-05T00:00:00.000Z",17,FALSE,20,56677795,"F",20,20,"New York Knicks","Jacob Toppin",1,0,0,0,0,3
0,0,0,0,0,0,0,0,0,"00",0,0,0,0,0,0,7045523,"2023-12-05T00:00:00.000Z",17,FALSE,20,160,"G-F",20,20,"New York Knicks","Evan Fournier",0,0,0,0,0,0
0,0,0,0,0,0,0,0,0,"00",0,0,0,0,0,0,7045523,"2023-12-05T00:00:00.000Z",17,FALSE,20,666675,"F",20,20,"New York Knicks","DaQuan Jeffries",0,0,0,0,0,0
0,0,0,0,0,0,0,0,0,"00",0,0,0,0,0,0,7045523,"2023-12-05T00:00:00.000Z",17,FALSE,20,666971,"G-F",20,20,"New York Knicks","Dylan Windler",0,0,0,0,0,0
1,0,4,2,1,6,3,0,0,"15",2,1,7,6,0,1,7045524,"2023-12-05T00:00:00.000Z",14,FALSE,24,18678058,"",24,24,"Phoenix Suns","Jordan Goodwin",0,13,14,8,7,14.7
1,0,1,2,0,4,0,4,4,"30",1,4,4,2,1,0,7045524,"2023-12-05T00:00:00.000Z",14,FALSE,24,666860,"F-G",14,14,"Los Angeles Lakers","Cameron Reddish",1,6,7,5,3,10.9
11,0,5,4,2,25,12,6,5,"40",3,3,31,8,5,2,7045524,"2023-12-05T00:00:00.000Z",14,FALSE,24,237,"F",14,14,"Los Angeles Lakers","LeBron James",5,39,50,42,19,70.1
1,2,6,0,0,26,10,8,7,"39",9,1,27,15,0,0,7045524,"2023-12-05T00:00:00.000Z",14,FALSE,24,117,"F-C",14,14,"Los Angeles Lakers","Anthony Davis",2,42,43,28,16,52.5
0,0,3,2,0,6,2,2,1,"27",0,1,5,3,3,3,7045524,"2023-12-05T00:00:00.000Z",14,FALSE,24,383,"F",14,14,"Los Angeles Lakers","Taurean Prince",3,8,8,5,3,14.6
5,0,0,6,2,11,3,0,0,"24",1,2,8,1,0,0,7045524,"2023-12-05T00:00:00.000Z",14,FALSE,24,405,"G",14,14,"Los Angeles Lakers","D'Angelo Russell",0,9,14,13,6,16.7
1,0,0,2,1,2,1,0,0,"08",0,2,3,0,0,0,7045524,"2023-12-05T00:00:00.000Z",14,FALSE,24,38017697,"G",14,14,"Los Angeles Lakers","Max Christie",0,3,4,4,1,4.5
2,0,4,8,3,16,7,3,3,"27",2,1,20,6,0,3,7045524,"2023-12-05T00:00:00.000Z",14,FALSE,24,17553995,"G",14,14,"Los Angeles Lakers","Austin Reaves",0,26,28,22,8,27.2
2,0,2,2,0,2,0,2,1,"15",4,2,1,6,1,1,7045524,"2023-12-05T00:00:00.000Z",14,FALSE,24,457,"F",14,14,"Los Angeles Lakers","Jarred Vanderbilt",1,7,9,3,8,13.2
0,0,0,0,0,0,0,0,0,"00",0,0,0,0,0,0,7045524,"2023-12-05T00:00:00.000Z",14,FALSE,24,3547095,"C-F",24,24,"Phoenix Suns","Udoka Azubuike",0,0,0,0,0,0
1,1,0,1,0,3,1,0,0,"06",1,0,2,1,0,0,7045524,"2023-12-05T00:00:00.000Z",14,FALSE,24,32,"F",24,24,"Phoenix Suns","Keita Bates-Diop",1,3,4,3,2,7.7
0,0,0,0,0,0,0,0,0,"00",0,0,0,0,0,0,7045524,"2023-12-05T00:00:00.000Z",14,FALSE,24,3547298,"G",24,24,"Phoenix Suns","Saben Lee",0,0,0,0,0,0
0,0,0,0,0,0,0,0,0,"00",0,0,0,0,0,0,7045524,"2023-12-05T00:00:00.000Z",14,FALSE,24,314,"F",24,24,"Phoenix Suns","Chimezie Metu",0,0,0,0,0,0
0,0,0,0,0,0,0,0,0,"00",0,0,0,0,0,0,7045524,"2023-12-05T00:00:00.000Z",14,FALSE,24,470,"G",24,24,"Phoenix Suns","Yuta Watanabe",0,0,0,0,0,0
0,0,0,0,0,0,0,0,0,"00",0,0,0,0,0,0,7045524,"2023-12-05T00:00:00.000Z",14,FALSE,24,37,"G",24,24,"Phoenix Suns","Bradley Beal",0,0,0,0,0,0
0,0,0,0,0,0,0,0,0,"00",0,0,0,0,0,0,7045524,"2023-12-05T00:00:00.000Z",14,FALSE,24,272,"G",24,24,"Phoenix Suns","Damion Lee",0,0,0,0,0,0
0,0,0,0,0,0,0,0,0,"00",0,0,0,0,0,0,7045524,"2023-12-05T00:00:00.000Z",14,FALSE,24,666451,"C",24,24,"Phoenix Suns","Bol Bol",0,0,0,0,0,0
1,0,2,4,1,8,3,0,0,"21",0,1,7,2,0,0,7045524,"2023-12-05T00:00:00.000Z",14,FALSE,24,666609,"F",14,14,"Los Angeles Lakers","Rui Hachimura",0,9,10,8,3,10.9
0,0,1,0,0,2,0,0,0,"09",1,2,0,2,1,0,7045524,"2023-12-05T00:00:00.000Z",14,FALSE,24,666626,"C",14,14,"Los Angeles Lakers","Jaxson Hayes",1,2,2,0,2,5.4
0,0,0,0,0,0,0,0,0,"00",0,0,0,0,0,0,7045524,"2023-12-05T00:00:00.000Z",14,FALSE,24,56677835,"G",14,14,"Los Angeles Lakers","Jalen Hood-Schifino",0,0,0,0,0,0
0,0,0,0,0,0,0,0,0,"00",0,0,0,0,0,0,7045524,"2023-12-05T00:00:00.000Z",14,FALSE,24,56677836,"F",14,14,"Los Angeles Lakers","Maxwell Lewis",0,0,0,0,0,0
0,0,0,0,0,0,0,0,0,"00",0,0,0,0,0,0,7045524,"2023-12-05T00:00:00.000Z",14,FALSE,24,486,"F",14,14,"Los Angeles Lakers","Christian Wood",0,0,0,0,0,0
0,0,0,0,0,0,0,0,0,"00",0,0,0,0,0,0,7045524,"2023-12-05T00:00:00.000Z",14,FALSE,24,56677738,"C",14,14,"Los Angeles Lakers","Colin Castleton",0,0,0,0,0,0
0,0,0,0,0,0,0,0,0,"00",0,0,0,0,0,0,7045524,"2023-12-05T00:00:00.000Z",14,FALSE,24,56677867,"F",14,14,"Los Angeles Lakers","Alex Fudge",0,0,0,0,0,0
0,0,0,0,0,0,0,0,0,"00",0,0,0,0,0,0,7045524,"2023-12-05T00:00:00.000Z",14,FALSE,24,56677868,"G",14,14,"Los Angeles Lakers","D'Moi Hodge",0,0,0,0,0,0
0,0,0,0,0,0,0,0,0,"00",0,0,0,0,0,0,7045524,"2023-12-05T00:00:00.000Z",14,FALSE,24,1603383,"G",14,14,"Los Angeles Lakers","Gabe Vincent",0,0,0,0,0,0
4,1,4,4,1,8,3,0,0,"35",0,1,7,4,2,1,7045524,"2023-12-05T00:00:00.000Z",14,FALSE,24,178,"G",24,24,"Phoenix Suns","Eric Gordon",3,11,15,11,8,25.8
4,1,7,7,4,17,12,4,3,"39",0,5,31,7,0,5,7045524,"2023-12-05T00:00:00.000Z",14,FALSE,24,140,"F",24,24,"Phoenix Suns","Kevin Durant",1,38,42,35,11,43.4
4,0,8,0,0,3,1,4,1,"29",0,4,3,8,1,2,7045524,"2023-12-05T00:00:00.000Z",14,FALSE,24,349,"C",24,24,"Phoenix Suns","Jusuf Nurkic",1,11,15,7,12,19.6
2,1,2,8,4,14,6,5,5,"39",0,2,21,2,2,0,7045524,"2023-12-05T00:00:00.000Z",14,FALSE,24,8,"G",24,24,"Phoenix Suns","Grayson Allen",3,23,25,23,4,35.4
6,1,9,1,1,16,6,8,8,"37",2,5,21,11,1,7,7045524,"2023-12-05T00:00:00.000Z",14,FALSE,24,57,"G",24,24,"Phoenix Suns","Devin Booker",2,32,38,27,17,42.2
1,0,0,0,0,3,3,0,0,"17",2,2,6,2,1,3,7045524,"2023-12-05T00:00:00.000Z",14,FALSE,24,147,"F",24,24,"Phoenix Suns","Drew Eubanks",1,8,9,7,3,9.9
0,0,1,1,0,1,0,0,0,"09",0,0,0,1,1,0,7045524,"2023-12-05T00:00:00.000Z",14,FALSE,24,356,"G",24,24,"Phoenix Suns","Josh Okogie",1,1,1,0,1,4.2
2,0,1,1,1,4,2,0,0,"14",1,1,5,2,0,1,7045524,"2023-12-05T00:00:00.000Z",14,FALSE,24,666729,"F",24,24,"Phoenix Suns","Nassir Little",0,7,9,7,4,9.4
6,0,4,8,4,10,5,4,3,"31",1,5,17,5,1,1,7049313,"2023-12-06T00:00:00.000Z",6,FALSE,22,666908,"G",6,6,"Cleveland Cavaliers","Max Strus",1,22,28,23,11,34
2,1,4,0,0,12,8,0,0,"36",1,5,16,5,1,4,7049313,"2023-12-06T00:00:00.000Z",6,FALSE,22,17896076,"F-C",6,6,"Cleveland Cavaliers","Evan Mobley",2,21,23,18,7,27
2,0,9,0,0,5,4,0,0,"19",2,5,8,11,1,4,7049313,"2023-12-06T00:00:00.000Z",6,FALSE,22,9,"C",6,6,"Cleveland Cavaliers","Jarrett Allen",1,19,21,10,13,23.2
6,0,5,10,5,24,12,9,6,"37",2,3,35,7,1,4,7049313,"2023-12-06T00:00:00.000Z",6,FALSE,22,322,"G",6,6,"Cleveland Cavaliers","Donovan Mitchell",1,42,48,41,13,51.4
9,0,1,4,1,18,10,5,5,"40",2,1,26,3,0,0,7049313,"2023-12-06T00:00:00.000Z",6,FALSE,22,666581,"G",6,6,"Cleveland Cavaliers","Darius Garland",0,29,38,35,12,43.1
0,0,0,0,0,0,0,0,0,"00",0,0,0,0,0,0,7049313,"2023-12-06T00:00:00.000Z",6,FALSE,22,248,"C",6,6,"Cleveland Cavaliers","Damian Jones",0,0,0,0,0,0
0,0,0,0,0,0,0,0,0,"00",0,0,0,0,0,0,7049313,"2023-12-06T00:00:00.000Z",6,FALSE,22,3547299,"G",6,6,"Cleveland Cavaliers","Sam Merrill",0,0,0,0,0,0
3,0,4,5,2,7,4,0,0,"28",1,4,10,5,0,2,7049313,"2023-12-06T00:00:00.000Z",6,FALSE,22,344,"F",6,6,"Cleveland Cavaliers","Georges Niang",0,15,18,13,8,18.5
1,0,1,2,0,4,0,0,0,"29",0,1,0,1,1,0,7049313,"2023-12-06T00:00:00.000Z",6,FALSE,22,3547247,"F-G",6,6,"Cleveland Cavaliers","Isaac Okoro",1,1,2,1,2,5.7
0,0,0,0,0,0,0,0,0,"00",0,0,0,0,0,0,7049313,"2023-12-06T00:00:00.000Z",6,FALSE,22,56677872,"G",6,6,"Cleveland Cavaliers","Craig Porter",0,0,0,0,0,0
0,1,3,0,0,0,0,2,1,"06",0,1,1,3,0,0,7049313,"2023-12-06T00:00:00.000Z",6,FALSE,22,444,"C-F",6,6,"Cleveland Cavaliers","Tristan Thompson",1,4,4,1,3,7.6
0,0,4,5,2,6,3,0,0,"14",1,2,8,5,0,0,7049313,"2023-12-06T00:00:00.000Z",6,FALSE,22,666940,"F",6,6,"Cleveland Cavaliers","Dean Wade",0,13,13,8,5,14
0,0,0,0,0,0,0,0,0,"00",0,0,0,0,0,0,7049313,"2023-12-06T00:00:00.000Z",6,FALSE,22,56677847,"F",6,6,"Cleveland Cavaliers","Emoni Bates",0,0,0,0,0,0
0,0,0,0,0,0,0,0,0,"00",0,0,0,0,0,0,7049313,"2023-12-06T00:00:00.000Z",6,FALSE,22,666676,"G",6,6,"Cleveland Cavaliers","Ty Jerome",0,0,0,0,0,0
0,0,0,0,0,0,0,0,0,"00",0,0,0,0,0,0,7049313,"2023-12-06T00:00:00.000Z",6,FALSE,22,277,"G",6,6,"Cleveland Cavaliers","Caris LeVert",0,0,0,0,0,0
0,0,0,0,0,0,0,0,0,"00",0,0,0,0,0,0,7049313,"2023-12-06T00:00:00.000Z",6,FALSE,22,38017662,"F",6,6,"Cleveland Cavaliers","Isaiah Mobley",0,0,0,0,0,0
0,0,0,0,0,0,0,0,0,"00",0,0,0,0,0,0,7049313,"2023-12-06T00:00:00.000Z",6,FALSE,22,404,"G",6,6,"Cleveland Cavaliers","Ricky Rubio",0,0,0,0,0,0
9,0,4,5,0,16,3,10,8,"41",2,1,14,6,3,2,7049313,"2023-12-06T00:00:00.000Z",6,FALSE,22,17896026,"F",22,22,"Orlando Magic","Franz Wagner",3,20,29,23,15,41.7
1,2,5,5,1,26,16,12,9,"38",1,3,42,6,0,3,7049313,"2023-12-06T00:00:00.000Z",6,FALSE,22,38017683,"F",22,22,"Orlando Magic","Paolo Banchero",2,48,49,43,7,53.7
3,1,3,1,0,4,3,1,0,"25",0,3,6,3,0,0,7049313,"2023-12-06T00:00:00.000Z",6,FALSE,22,666442,"C",22,22,"Orlando Magic","Goga Bitadze",1,9,12,9,6,17.1
1,1,0,1,0,2,0,0,0,"09",0,0,0,0,2,1,7049313,"2023-12-06T00:00:00.000Z",6,FALSE,22,17896073,"G",22,22,"Orlando Magic","Jalen Suggs",3,0,1,1,1,9.5
0,0,0,0,0,5,5,1,1,"15",0,1,11,0,0,0,7049313,"2023-12-06T00:00:00.000Z",6,FALSE,22,56677827,"G",22,22,"Orlando Magic","Anthony Black",0,11,11,11,0,11
2,2,6,4,1,14,8,3,2,"32",1,3,19,7,1,2,7049313,"2023-12-06T00:00:00.000Z",6,FALSE,22,3547251,"G",22,22,"Orlando Magic","Cole Anthony",3,26,28,21,9,37.4
3,0,2,4,0,7,1,6,6,"31",1,4,8,3,1,0,7049313,"2023-12-06T00:00:00.000Z",6,FALSE,22,196,"G",22,22,"Orlando Magic","Gary Harris",1,11,14,11,6,19.1
0,0,2,1,0,2,0,0,0,"11",1,1,0,3,0,0,7049313,"2023-12-06T00:00:00.000Z",6,FALSE,22,38017724,"G",22,22,"Orlando Magic","Caleb Houstan",0,3,3,0,3,3.6
3,0,4,1,0,1,0,0,0,"17",0,3,0,4,1,0,7049313,"2023-12-06T00:00:00.000Z",6,FALSE,22,226,"F",22,22,"Orlando Magic","Joe Ingles",1,4,7,3,7,12.3
0,0,0,0,0,0,0,0,0,"00",0,0,0,0,0,0,7049313,"2023-12-06T00:00:00.000Z",6,FALSE,22,666818,"F",22,22,"Orlando Magic","Chuma Okeke",0,0,0,0,0,0
0,0,0,0,0,0,0,0,0,"00",0,0,0,0,0,0,7049313,"2023-12-06T00:00:00.000Z",6,FALSE,22,666885,"F",22,22,"Orlando Magic","Admiral Schofield",0,0,0,0,0,0
0,0,3,1,0,7,5,4,1,"21",1,2,11,4,2,3,7049313,"2023-12-06T00:00:00.000Z",6,FALSE,22,462,"C",22,22,"Orlando Magic","Moritz Wagner",2,15,15,11,4,18.8
0,0,0,0,0,0,0,0,0,"00",0,0,0,0,0,0,7049313,"2023-12-06T00:00:00.000Z",6,FALSE,22,85,"F",22,22,"Orlando Magic","Wendell Carter Jr.",0,0,0,0,0,0
0,0,0,0,0,0,0,0,0,"00",0,0,0,0,0,0,7049313,"2023-12-06T00:00:00.000Z",6,FALSE,22,165,"G",22,22,"Orlando Magic","Markelle Fultz",0,0,0,0,0,0
0,0,0,0,0,0,0,0,0,"00",0,0,0,0,0,0,7049313,"2023-12-06T00:00:00.000Z",6,FALSE,22,38017607,"G",22,22,"Orlando Magic","Kevon Harris",0,0,0,0,0,0
0,0,0,0,0,0,0,0,0,"00",0,0,0,0,0,0,7049313,"2023-12-06T00:00:00.000Z",6,FALSE,22,56677839,"G",22,22,"Orlando Magic","Jett Howard",0,0,0,0,0,0
0,0,0,0,0,0,0,0,0,"00",0,0,0,0,0,0,7049313,"2023-12-06T00:00:00.000Z",6,FALSE,22,229,"F",22,22,"Orlando Magic","Jonathan Isaac",0,0,0,0,0,0
0,0,0,0,0,0,0,0,0,"00",0,0,0,0,0,0,7049313,"2023-12-06T00:00:00.000Z",6,FALSE,22,17553983,"G",22,22,"Orlando Magic","Trevelin Queen",0,0,0,0,0,0
3,1,0,3,1,9,3,0,0,"26",3,0,7,3,1,1,7049314,"2023-12-06T00:00:00.000Z",9,FALSE,15,17896067,"F",15,15,"Memphis Grizzlies","Santi Aldama",2,10,13,10,6,20.1
0,0,0,0,0,0,0,0,0,"01",0,0,0,0,0,0,7049314,"2023-12-06T00:00:00.000Z",9,FALSE,15,48248287,"G",15,15,"Memphis Grizzlies","Jacob Gilyard",0,0,0,0,0,0
2,1,5,2,2,4,3,2,1,"22",1,0,9,6,2,0,7049314,"2023-12-06T00:00:00.000Z",9,FALSE,15,666703,"G-F",15,15,"Memphis Grizzlies","John Konchar",3,15,17,11,8,28.2
0,0,1,0,0,0,0,0,0,"01",0,0,0,1,0,0,7049314,"2023-12-06T00:00:00.000Z",9,FALSE,15,38017732,"F",15,15,"Memphis Grizzlies","Kenneth Lofton Jr.",0,1,1,0,1,1.2
4,0,2,2,0,8,6,0,0,"26",0,0,12,2,1,0,7049314,"2023-12-06T00:00:00.000Z",9,FALSE,15,666809,"G",15,15,"Memphis Grizzlies","Jaylen Nowell",1,14,18,16,6,23.4
1,0,0,0,0,4,1,0,0,"06",1,0,2,1,0,0,7049314,"2023-12-06T00:00:00.000Z",9,FALSE,15,3547285,"F",15,15,"Memphis Grizzlies","Xavier Tillman",0,3,4,3,2,4.7
1,0,4,2,1,2,1,0,0,"25",0,0,3,4,1,0,7049314,"2023-12-06T00:00:00.000Z",9,FALSE,15,38017731,"G",15,15,"Memphis Grizzlies","Vince Williams Jr.",1,7,8,4,5,12.3
7,0,4,8,4,15,8,2,2,"32",0,0,22,4,3,2,7049314,"2023-12-06T00:00:00.000Z",9,FALSE,15,54,"F",9,9,"Detroit Pistons","Bojan Bogdanovic",3,26,33,29,11,44.3
1,0,5,3,1,7,3,2,2,"28",2,5,9,7,0,1,7049314,"2023-12-06T00:00:00.000Z",9,FALSE,15,3547267,"F-C",9,9,"Detroit Pistons","Isaiah Stewart",0,16,17,10,8,17.9
0,1,10,0,0,12,8,1,1,"30",1,1,17,11,0,2,7049314,"2023-12-06T00:00:00.000Z",9,FALSE,15,38017694,"C",9,9,"Detroit Pistons","Jalen Duren",1,28,28,17,11,31.2
4,0,2,3,1,13,5,1,1,"27",2,3,12,4,1,3,7049314,"2023-12-06T00:00:00.000Z",9,FALSE,15,3547241,"G",9,9,"Detroit Pistons","Killian Hayes",1,16,20,16,8,22.8
10,1,4,5,1,14,6,3,3,"34",0,2,16,4,2,5,7049314,"2023-12-06T00:00:00.000Z",9,FALSE,15,17896075,"G-F",9,9,"Detroit Pistons","Cade Cunningham",3,20,30,26,14,39.8
0,0,0,0,0,0,0,0,0,"00",0,0,0,0,0,0,7049314,"2023-12-06T00:00:00.000Z",9,FALSE,15,24,"F",9,9,"Detroit Pistons","Marvin Bagley III",0,0,0,0,0,0
2,0,2,5,1,6,1,0,0,"17",0,1,3,2,0,1,7049314,"2023-12-06T00:00:00.000Z",9,FALSE,15,77,"G",9,9,"Detroit Pistons","Alec Burks",0,5,7,5,4,7.4
2,2,3,3,1,8,4,0,0,"24",0,0,9,3,3,1,7049314,"2023-12-06T00:00:00.000Z",9,FALSE,15,38017682,"G",9,9,"Detroit Pistons","Jaden Ivey",5,12,14,11,5,29.6
0,0,0,0,0,0,0,0,0,"00",0,0,0,0,0,0,7049314,"2023-12-06T00:00:00.000Z",9,FALSE,15,259,"F",9,9,"Detroit Pistons","Kevin Knox",0,0,0,0,0,0
1,0,1,4,1,5,2,0,0,"19",0,2,5,1,0,0,7049314,"2023-12-06T00:00:00.000Z",9,FALSE,15,17896071,"F",9,9,"Detroit Pistons","Isaiah Livers",0,6,7,6,2,7.7
2,0,1,0,0,2,0,0,0,"05",0,1,0,1,0,0,7049314,"2023-12-06T00:00:00.000Z",9,FALSE,15,56677792,"G",9,9,"Detroit Pistons","Marcus Sasser",0,1,3,2,3,4.2
0,0,2,4,1,6,2,0,0,"16",2,0,5,4,0,0,7049314,"2023-12-06T00:00:00.000Z",9,FALSE,15,56677826,"G-F",9,9,"Detroit Pistons","Ausar Thompson",0,9,9,5,4,9.8
1,2,0,0,0,3,2,0,0,"08",1,2,4,1,0,1,7049314,"2023-12-06T00:00:00.000Z",9,FALSE,15,3547240,"C",9,9,"Detroit Pistons","James Wiseman",2,5,6,5,2,11.7
0,0,0,0,0,0,0,0,0,"00",0,0,0,0,0,0,7049314,"2023-12-06T00:00:00.000Z",9,FALSE,15,56677729,"G",9,9,"Detroit Pistons","Malcolm Cazalon",0,0,0,0,0,0
0,0,0,0,0,0,0,0,0,"00",0,0,0,0,0,0,7049314,"2023-12-06T00:00:00.000Z",9,FALSE,15,197,"F-G",9,9,"Detroit Pistons","Joe Harris",0,0,0,0,0,0
0,0,0,0,0,0,0,0,0,"00",0,0,0,0,0,0,7049314,"2023-12-06T00:00:00.000Z",9,FALSE,15,330,"G",9,9,"Detroit Pistons","Monte Morris",0,0,0,0,0,0
0,0,0,0,0,0,0,0,0,"00",0,0,0,0,0,0,7049314,"2023-12-06T00:00:00.000Z",9,FALSE,15,42097199,"G",9,9,"Detroit Pistons","Jared Rhoden",0,0,0,0,0,0
0,0,0,0,0,0,0,0,0,"00",0,0,0,0,0,0,7049314,"2023-12-06T00:00:00.000Z",9,FALSE,15,44477024,"G",9,9,"Detroit Pistons","Stanley Umude",0,0,0,0,0,0
1,0,6,2,1,3,1,2,1,"22",1,1,4,7,2,3,7049314,"2023-12-06T00:00:00.000Z",9,FALSE,15,38017729,"F",15,15,"Memphis Grizzlies","David Roddy",2,11,12,5,8,16.9
0,4,4,6,2,20,10,3,2,"35",0,3,24,4,0,0,7049314,"2023-12-06T00:00:00.000Z",9,FALSE,15,231,"F-C",15,15,"Memphis Grizzlies","Jaren Jackson Jr.",4,28,28,24,4,40.8
4,1,9,0,0,3,1,0,0,"25",2,2,2,11,0,2,7049314,"2023-12-06T00:00:00.000Z",9,FALSE,15,48,"C",15,15,"Memphis Grizzlies","Bismack Biyombo",1,13,17,6,15,22.2
2,0,1,1,0,7,2,0,0,"15",0,1,4,1,2,5,7049314,"2023-12-06T00:00:00.000Z",9,FALSE,15,401,"G",15,15,"Memphis Grizzlies","Derrick Rose",2,5,7,6,3,9.2
7,1,5,8,4,31,19,7,7,"35",1,2,49,6,1,3,7049314,"2023-12-06T00:00:00.000Z",9,FALSE,15,3547287,"G",15,15,"Memphis Grizzlies","Desmond Bane",2,55,62,56,13,69.7
0,0,0,0,0,0,0,0,0,"00",0,0,0,0,0,0,7049314,"2023-12-06T00:00:00.000Z",9,FALSE,15,56677830,"F",15,15,"Memphis Grizzlies","GG Jackson",0,0,0,0,0,0
0,0,0,0,0,0,0,0,0,"00",0,0,0,0,0,0,7049314,"2023-12-06T00:00:00.000Z",9,FALSE,15,254,"G",15,15,"Memphis Grizzlies","Luke Kennard",0,0,0,0,0,0
0,0,0,0,0,0,0,0,0,"00",0,0,0,0,0,0,7049314,"2023-12-06T00:00:00.000Z",9,FALSE,15,38017728,"F",15,15,"Memphis Grizzlies","Jake LaRavia",0,0,0,0,0,0
0,0,0,0,0,0,0,0,0,"00",0,0,0,0,0,0,7049314,"2023-12-06T00:00:00.000Z",9,FALSE,15,666786,"G",15,15,"Memphis Grizzlies","Ja Morant",0,0,0,0,0,0
0,0,0,0,0,0,0,0,0,"00",0,0,0,0,0,0,7049314,"2023-12-06T00:00:00.000Z",9,FALSE,15,420,"G",15,15,"Memphis Grizzlies","Marcus Smart",0,0,0,0,0,0
0,0,0,0,0,0,0,0,0,"01",0,0,0,0,0,0,7049314,"2023-12-06T00:00:00.000Z",9,FALSE,15,17896027,"G-F",15,15,"Memphis Grizzlies","Ziaire Williams",0,0,0,0,0,0
0,0,0,0,0,0,0,0,0,"00",0,0,0,0,0,0,7049314,"2023-12-06T00:00:00.000Z",9,FALSE,15,3,"C",15,15,"Memphis Grizzlies","Steven Adams",0,0,0,0,0,0
0,0,0,0,0,0,0,0,0,"00",0,0,0,0,0,0,7049314,"2023-12-06T00:00:00.000Z",9,FALSE,15,666505,"F",15,15,"Memphis Grizzlies","Brandon Clarke",0,0,0,0,0,0
6,1,7,10,5,13,8,2,2,"39",1,2,23,8,1,2,7049315,"2023-12-06T00:00:00.000Z",28,FALSE,16,18,"F",28,28,"Toronto Raptors","OG Anunoby",2,31,37,29,14,45.6
6,1,3,1,1,13,9,11,11,"36",1,1,30,4,0,2,7049315,"2023-12-06T00:00:00.000Z",28,FALSE,16,416,"F",28,28,"Toronto Raptors","Pascal Siakam",1,34,40,36,10,44.8
1,4,5,0,0,2,1,2,0,"28",1,2,2,6,0,0,7049315,"2023-12-06T00:00:00.000Z",28,FALSE,16,373,"C",28,28,"Toronto Raptors","Jakob Poeltl",4,8,9,3,7,22.7
5,1,8,7,2,17,5,0,0,"34",3,2,12,11,0,3,7049315,"2023-12-06T00:00:00.000Z",28,FALSE,16,17896055,"G-F",28,28,"Toronto Raptors","Scottie Barnes",1,23,28,17,16,32.7
5,0,3,5,1,18,4,0,0,"35",2,5,9,5,0,3,7049315,"2023-12-06T00:00:00.000Z",28,FALSE,16,409,"G",28,28,"Toronto Raptors","Dennis Schroder",0,14,19,14,10,19.5
2,0,3,3,1,7,4,0,0,"13",0,0,9,3,1,1,7049315,"2023-12-06T00:00:00.000Z",28,FALSE,16,3547249,"F",28,28,"Toronto Raptors","Precious Achiuwa",1,12,14,11,5,17.6
0,0,4,1,0,2,0,0,0,"10",0,0,0,4,0,1,7049315,"2023-12-06T00:00:00.000Z",28,FALSE,16,58,"F",28,28,"Toronto Raptors","Chris Boucher",0,4,4,0,4,3.8
1,0,1,1,1,1,1,0,0,"06",0,1,3,1,0,0,7049315,"2023-12-06T00:00:00.000Z",28,FALSE,16,3547275,"G",28,28,"Toronto Raptors","Malachi Flynn",0,4,5,4,2,5.7
0,0,0,0,0,0,0,0,0,"00",0,0,0,0,0,0,7049315,"2023-12-06T00:00:00.000Z",28,FALSE,16,666762,"F",28,28,"Toronto Raptors","Jalen McDaniels",0,0,0,0,0,0
1,1,2,2,0,2,0,0,0,"14",0,2,0,2,1,1,7049315,"2023-12-06T00:00:00.000Z",28,FALSE,16,376,"F",28,28,"Toronto Raptors","Otto Porter Jr.",2,2,3,1,3,8.9
0,0,0,0,0,0,0,0,0,"00",0,0,0,0,0,0,7049315,"2023-12-06T00:00:00.000Z",28,FALSE,16,436,"G-F",28,28,"Toronto Raptors","Garrett Temple",0,0,0,0,0,0
2,0,2,7,3,11,5,2,2,"25",0,3,15,2,0,1,7049315,"2023-12-06T00:00:00.000Z",28,FALSE,16,3089,"",28,28,"Toronto Raptors","Gary Trent Jr.",0,17,19,17,4,19.4
0,0,0,0,0,0,0,0,0,"00",0,0,0,0,0,0,7049315,"2023-12-06T00:00:00.000Z",28,FALSE,16,489,"F",28,28,"Toronto Raptors","Thaddeus Young",0,0,0,0,0,0
0,0,0,0,0,0,0,0,0,"00",0,0,0,0,0,0,7049315,"2023-12-06T00:00:00.000Z",28,FALSE,16,56677828,"G",28,28,"Toronto Raptors","Gradey Dick",0,0,0,0,0,0
0,0,0,0,0,0,0,0,0,"00",0,0,0,0,0,0,7049315,"2023-12-06T00:00:00.000Z",28,FALSE,16,56677805,"G",28,28,"Toronto Raptors","Javon Freeman-Liberty",0,0,0,0,0,0
0,0,0,0,0,0,0,0,0,"00",0,0,0,0,0,0,7049315,"2023-12-06T00:00:00.000Z",28,FALSE,16,38017717,"F",28,28,"Toronto Raptors","Ron Harper Jr.",0,0,0,0,0,0
0,0,0,0,0,0,0,0,0,"00",0,0,0,0,0,0,7049315,"2023-12-06T00:00:00.000Z",28,FALSE,16,38017710,"C",28,28,"Toronto Raptors","Christian Koloko",0,0,0,0,0,0
0,0,0,0,0,0,0,0,0,"00",0,0,0,0,0,0,7049315,"2023-12-06T00:00:00.000Z",28,FALSE,16,56677869,"G",28,28,"Toronto Raptors","Markquis Nowell",0,0,0,0,0,0
8,0,2,1,1,16,7,5,4,"35",0,2,19,2,1,0,7049315,"2023-12-06T00:00:00.000Z",28,FALSE,16,79,"G-F",16,16,"Miami Heat","Jimmy Butler",1,21,29,27,10,36.4
3,1,10,7,4,16,9,4,2,"31",2,1,24,12,0,0,7049315,"2023-12-06T00:00:00.000Z",28,FALSE,16,666747,"F",16,16,"Miami Heat","Caleb Martin",1,36,39,27,15,45.9
4,1,9,3,2,9,5,3,3,"33",3,3,15,12,3,1,7049315,"2023-12-06T00:00:00.000Z",28,FALSE,16,39398582,"C",16,16,"Miami Heat","Orlando Robinson",4,27,31,19,16,46.4
7,0,5,10,3,19,9,0,0,"32",1,1,21,6,1,0,7049315,"2023-12-06T00:00:00.000Z",28,FALSE,16,397,"F",16,16,"Miami Heat","Duncan Robinson",1,27,34,28,13,41.7
3,2,4,4,1,4,1,0,0,"28",0,2,3,4,0,2,7049315,"2023-12-06T00:00:00.000Z",28,FALSE,16,286,"G",16,16,"Miami Heat","Kyle Lowry",2,7,10,6,7,16.3
0,0,0,0,0,0,0,0,0,"00",0,0,0,0,0,0,7049315,"2023-12-06T00:00:00.000Z",28,FALSE,16,74,"C",16,16,"Miami Heat","Thomas Bryant",0,0,0,0,0,0
0,0,0,0,0,0,0,0,0,"00",0,0,0,0,0,0,7049315,"2023-12-06T00:00:00.000Z",28,FALSE,16,38017734,"F",16,16,"Miami Heat","Jamal Cain",0,0,0,0,0,0
0,0,0,0,0,0,0,0,0,"00",0,0,0,0,0,0,7049315,"2023-12-06T00:00:00.000Z",28,FALSE,16,3092,"",16,16,"Miami Heat","Haywood Highsmith",0,0,0,0,0,0
0,0,2,1,0,1,0,0,0,"03",0,2,0,2,0,1,7049315,"2023-12-06T00:00:00.000Z",28,FALSE,16,38017696,"F",16,16,"Miami Heat","Nikola Jovic",0,2,2,0,2,1.4
0,0,0,0,0,0,0,0,0,"00",0,0,0,0,0,0,7049315,"2023-12-06T00:00:00.000Z",28,FALSE,16,4,"C-F",16,16,"Miami Heat","Bam Adebayo",0,0,0,0,0,0
0,0,0,0,0,0,0,0,0,"00",0,0,0,0,0,0,7049315,"2023-12-06T00:00:00.000Z",28,FALSE,16,3547257,"G",16,16,"Miami Heat","R.J. Hampton",0,0,0,0,0,0
0,0,0,0,0,0,0,0,0,"00",0,0,0,0,0,0,7049315,"2023-12-06T00:00:00.000Z",28,FALSE,16,666633,"G",16,16,"Miami Heat","Tyler Herro",0,0,0,0,0,0
0,0,0,0,0,0,0,0,0,"00",0,0,0,0,0,0,7049315,"2023-12-06T00:00:00.000Z",28,FALSE,16,19465585,"G",16,16,"Miami Heat","Dru Smith",0,0,0,0,0,0
0,0,0,0,0,0,0,0,0,"00",0,0,0,0,0,0,7049315,"2023-12-06T00:00:00.000Z",28,FALSE,16,38017736,"F",16,16,"Miami Heat","Cole Swider",0,0,0,0,0,0
2,0,0,4,1,13,6,2,2,"32",0,2,15,0,0,2,7049315,"2023-12-06T00:00:00.000Z",28,FALSE,16,56677785,"G",16,16,"Miami Heat","Jaime Jaquez Jr.",0,15,17,17,2,16
4,0,1,4,1,5,2,3,3,"15",1,2,8,2,0,0,7049315,"2023-12-06T00:00:00.000Z",28,FALSE,16,285,"F-C",16,16,"Miami Heat","Kevin Love",0,10,14,12,6,16.4
2,0,3,4,1,6,2,2,2,"31",1,3,7,4,0,1,7049315,"2023-12-06T00:00:00.000Z",28,FALSE,16,391,"G-F",16,16,"Miami Heat","Josh Richardson",0,11,13,9,6,13.8
8,0,8,4,0,10,4,0,0,"31",0,2,8,8,0,2,7049316,"2023-12-06T00:00:00.000Z",30,FALSE,23,3547242,"F",30,30,"Washington Wizards","Deni Avdija",0,16,24,16,16,27.6
7,1,3,5,2,16,7,0,0,"34",0,3,16,3,0,1,7049316,"2023-12-06T00:00:00.000Z",30,FALSE,23,265,"F",30,30,"Washington Wizards","Kyle Kuzma",1,19,26,23,10,32.1
4,2,4,0,0,10,8,2,2,"23",2,6,18,6,1,0,7049316,"2023-12-06T00:00:00.000Z",30,FALSE,23,666577,"F",30,30,"Washington Wizards","Daniel Gafford",3,24,28,22,10,40.2
2,0,1,5,3,15,10,0,0,"32",0,3,23,1,1,4,7049316,"2023-12-06T00:00:00.000Z",30,FALSE,23,666848,"G",30,30,"Washington Wizards","Jordan Poole",1,24,26,25,3,26.2
8,2,3,4,2,11,8,2,2,"31",0,0,20,3,1,1,7049316,"2023-12-06T00:00:00.000Z",30,FALSE,23,249,"G",30,30,"Washington Wizards","Tyus Jones",3,23,31,28,11,43.6
0,0,0,0,0,0,0,0,0,"00",0,0,0,0,0,0,7049316,"2023-12-06T00:00:00.000Z",30,FALSE,23,38017704,"F",30,30,"Washington Wizards","Patrick Baldwin Jr.",0,0,0,0,0,0
4,0,1,1,0,3,0,0,0,"14",0,5,0,1,0,1,7049316,"2023-12-06T00:00:00.000Z",30,FALSE,23,18677954,"G",30,30,"Washington Wizards","Jared Butler",0,1,5,4,5,6.2
0,0,0,0,0,0,0,0,0,"00",0,0,0,0,0,0,7049316,"2023-12-06T00:00:00.000Z",30,FALSE,23,38124126,"F",30,30,"Washington Wizards","John Butler Jr.",0,0,0,0,0,0
3,0,1,5,1,10,6,1,1,"27",0,1,14,1,3,2,7049316,"2023-12-06T00:00:00.000Z",30,FALSE,23,56677844,"G",30,30,"Washington Wizards","Bilal Coulibaly",3,15,18,17,4,26.7
2,0,6,5,2,6,2,1,1,"17",0,1,7,6,1,0,7049316,"2023-12-06T00:00:00.000Z",30,FALSE,23,167,"F",30,30,"Washington Wizards","Danilo Gallinari",1,13,15,9,8,20.2
0,0,0,0,0,0,0,0,0,"00",0,0,0,0,0,0,7049316,"2023-12-06T00:00:00.000Z",30,FALSE,23,3547302,"F",30,30,"Washington Wizards","Anthony Gill",0,0,0,0,0,0
1,0,3,5,4,7,5,2,2,"25",0,1,16,3,1,1,7049316,"2023-12-06T00:00:00.000Z",30,FALSE,23,17896045,"F",30,30,"Washington Wizards","Corey Kispert",1,19,20,17,4,23.1
0,0,0,1,0,3,2,0,0,"06",0,0,4,0,0,0,7049316,"2023-12-06T00:00:00.000Z",30,FALSE,23,337,"F-C",30,30,"Washington Wizards","Mike Muscala",0,4,4,4,0,4
0,0,0,0,0,0,0,0,0,"00",0,0,0,0,0,0,7049316,"2023-12-06T00:00:00.000Z",30,FALSE,23,17896106,"F",30,30,"Washington Wizards","Eugene Omoruyi",0,0,0,0,0,0
0,0,0,0,0,0,0,0,0,"00",0,0,0,0,0,0,7049316,"2023-12-06T00:00:00.000Z",30,FALSE,23,38017687,"G",30,30,"Washington Wizards","Johnny Davis",0,0,0,0,0,0
0,0,0,0,0,0,0,0,0,"00",0,0,0,0,0,0,7049316,"2023-12-06T00:00:00.000Z",30,FALSE,23,38017712,"G",30,30,"Washington Wizards","Ryan Rollins",0,0,0,0,0,0
0,0,0,0,0,0,0,0,0,"00",0,0,0,0,0,0,7049316,"2023-12-06T00:00:00.000Z",30,FALSE,23,414,"G",30,30,"Washington Wizards","Landry Shamet",0,0,0,0,0,0
0,0,0,0,0,0,0,0,0,"00",0,0,0,0,0,0,7049316,"2023-12-06T00:00:00.000Z",30,FALSE,23,487,"G",30,30,"Washington Wizards","Delon Wright",0,0,0,0,0,0
1,0,4,1,0,9,3,0,0,"35",2,2,6,6,2,0,7049316,"2023-12-06T00:00:00.000Z",30,FALSE,23,200,"F",23,23,"Philadelphia 76ers","Tobias Harris",2,12,13,7,7,20.7
5,0,5,3,1,4,2,7,4,"33",1,2,9,6,0,0,7049316,"2023-12-06T00:00:00.000Z",30,FALSE,23,33,"F-G",23,23,"Philadelphia 76ers","Nicolas Batum",0,15,20,14,11,23.7
7,1,7,2,1,28,19,13,11,"38",5,2,50,12,1,6,7049316,"2023-12-06T00:00:00.000Z",30,FALSE,23,145,"F-C",23,23,"Philadelphia 76ers","Joel Embiid",2,62,69,57,19,74.9
7,0,1,6,2,20,10,4,4,"38",0,2,26,1,1,0,7049316,"2023-12-06T00:00:00.000Z",30,FALSE,23,3547254,"G",23,23,"Philadelphia 76ers","Tyrese Maxey",1,27,34,33,8,40.7
4,1,5,5,2,10,5,7,7,"27",0,1,19,5,2,1,7049316,"2023-12-06T00:00:00.000Z",30,FALSE,23,313,"G",23,23,"Philadelphia 76ers","De'Anthony Melton",3,24,28,23,9,39
0,0,0,0,0,0,0,0,0,"00",0,0,0,0,0,0,7049316,"2023-12-06T00:00:00.000Z",30,FALSE,23,28,"C",23,23,"Philadelphia 76ers","Mo Bamba",0,0,0,0,0,0
4,0,4,5,1,7,2,0,0,"21",0,0,5,4,1,2,7049316,"2023-12-06T00:00:00.000Z",30,FALSE,23,45,"G",23,23,"Philadelphia 76ers","Patrick Beverley",1,9,13,9,8,16.8
0,0,1,0,0,0,0,0,0,"04",0,1,0,1,0,1,7049316,"2023-12-06T00:00:00.000Z",30,FALSE,23,108,"F",23,23,"Philadelphia 76ers","Robert Covington",0,1,1,0,1,0.2
0,0,0,0,0,0,0,0,0,"00",0,0,0,0,0,0,7049316,"2023-12-06T00:00:00.000Z",30,FALSE,23,2175,"",23,23,"Philadelphia 76ers","Danuel House Jr.",0,0,0,0,0,0
0,0,0,0,0,0,0,0,0,"00",0,0,0,0,0,0,7049316,"2023-12-06T00:00:00.000Z",30,FALSE,23,260,"G-F",23,23,"Philadelphia 76ers","Furkan Korkmaz",0,0,0,0,0,0
0,0,0,0,0,0,0,0,0,"00",0,0,0,0,0,0,7049316,"2023-12-06T00:00:00.000Z",30,FALSE,23,3547294,"F",23,23,"Philadelphia 76ers","Kenyon Martin Jr.",0,0,0,0,0,0
0,0,2,1,0,4,1,2,2,"15",1,0,4,3,0,0,7049316,"2023-12-06T00:00:00.000Z",30,FALSE,23,328,"F",23,23,"Philadelphia 76ers","Marcus Morris",0,7,7,4,3,7.6
1,0,1,3,1,8,5,1,1,"19",1,1,12,2,1,1,7049316,"2023-12-06T00:00:00.000Z",30,FALSE,23,360,"F",23,23,"Philadelphia 76ers","Kelly Oubre Jr.",1,14,15,13,3,17.9
0,0,1,1,0,1,0,0,0,"10",0,3,0,1,0,0,7049316,"2023-12-06T00:00:00.000Z",30,FALSE,23,3547270,"F",23,23,"Philadelphia 76ers","Paul Reed",0,1,1,0,1,1.2
0,0,0,0,0,0,0,0,0,"00",0,0,0,0,0,0,7049316,"2023-12-06T00:00:00.000Z",30,FALSE,23,17896025,"G",23,23,"Philadelphia 76ers","Jaden Springer",0,0,0,0,0,0
0,0,0,0,0,0,0,0,0,"00",0,0,0,0,0,0,7049316,"2023-12-06T00:00:00.000Z",30,FALSE,23,56913527,"G",23,23,"Philadelphia 76ers","Ricky Council IV",0,0,0,0,0,0
0,0,0,0,0,0,0,0,0,"00",0,0,0,0,0,0,7049316,"2023-12-06T00:00:00.000Z",30,FALSE,23,17554001,"G",23,23,"Philadelphia 76ers","Javonte Smart",0,0,0,0,0,0
0,0,0,0,0,0,0,0,0,"00",0,0,0,0,0,0,7049316,"2023-12-06T00:00:00.000Z",30,FALSE,23,56677788,"G",23,23,"Philadelphia 76ers","Terquavion Smith",0,0,0,0,0,0
2,0,4,3,1,15,6,1,1,"36",0,1,14,4,0,1,7049317,"2023-12-06T00:00:00.000Z",1,FALSE,3,666656,"F",1,1,"Atlanta Hawks","De'Andre Hunter",0,18,20,16,6,20.8
1,0,3,6,3,13,7,4,4,"37",4,1,21,7,1,3,7049317,"2023-12-06T00:00:00.000Z",1,FALSE,3,3547256,"F",1,1,"Atlanta Hawks","Saddiq Bey",1,28,29,22,8,30.9
1,2,8,0,0,6,4,2,1,"29",4,5,9,12,0,1,7049317,"2023-12-06T00:00:00.000Z",1,FALSE,3,83,"C",1,1,"Atlanta Hawks","Clint Capela",2,21,22,10,13,29.9
9,0,10,5,1,16,6,0,0,"32",0,3,13,10,1,0,7049317,"2023-12-06T00:00:00.000Z",1,FALSE,3,334,"G",1,1,"Atlanta Hawks","Dejounte Murray",1,23,32,22,19,41.5
9,2,0,9,3,24,11,5,5,"37",1,2,30,1,0,5,7049317,"2023-12-06T00:00:00.000Z",1,FALSE,3,490,"G",1,1,"Atlanta Hawks","Trae Young",2,31,40,39,10,45.7
1,0,4,9,4,14,7,2,2,"27",0,2,20,4,0,0,7049317,"2023-12-06T00:00:00.000Z",1,FALSE,3,53,"G",1,1,"Atlanta Hawks","Bogdan Bogdanovic",0,24,25,21,5,26.3
0,0,0,0,0,0,0,0,0,"00",0,0,0,0,0,0,7049317,"2023-12-06T00:00:00.000Z",1,FALSE,3,666564,"F",1,1,"Atlanta Hawks","Bruno Fernando",0,0,0,0,0,0
0,0,0,0,0,0,0,0,0,"00",0,0,0,0,0,0,7049317,"2023-12-06T00:00:00.000Z",1,FALSE,3,3547297,"G",1,1,"Atlanta Hawks","Trent Forrest",0,0,0,0,0,0
0,0,0,0,0,0,0,0,0,"00",0,0,0,0,0,0,7049317,"2023-12-06T00:00:00.000Z",1,FALSE,3,38017689,"F",1,1,"Atlanta Hawks","AJ Griffin",0,0,0,0,0,0
0,0,1,0,0,0,0,0,0,"07",0,3,0,1,1,1,7049317,"2023-12-06T00:00:00.000Z",1,FALSE,3,666754,"G",1,1,"Atlanta Hawks","Garrison Mathews",1,1,1,0,1,3.2
0,0,0,0,0,0,0,0,0,"00",0,0,0,0,0,0,7049317,"2023-12-06T00:00:00.000Z",1,FALSE,3,319,"G",1,1,"Atlanta Hawks","Patty Mills",0,0,0,0,0,0
2,0,7,2,0,5,1,0,0,"24",2,4,2,9,1,1,7049317,"2023-12-06T00:00:00.000Z",1,FALSE,3,3547244,"F-C",1,1,"Atlanta Hawks","Onyeka Okongwu",1,11,13,4,11,17.8
0,0,0,0,0,0,0,0,0,"00",0,0,0,0,0,0,7049317,"2023-12-06T00:00:00.000Z",1,FALSE,3,56677838,"G",1,1,"Atlanta Hawks","Kobe Bufkin",0,0,0,0,0,0
0,0,0,0,0,0,0,0,0,"00",0,0,0,0,0,0,7049317,"2023-12-06T00:00:00.000Z",1,FALSE,3,56677806,"F",1,1,"Atlanta Hawks","Mouhamed Gueye",0,0,0,0,0,0
0,0,0,0,0,0,0,0,0,"00",0,0,0,0,0,0,7049317,"2023-12-06T00:00:00.000Z",1,FALSE,3,17896040,"F",1,1,"Atlanta Hawks","Jalen Johnson",0,0,0,0,0,0
0,0,0,0,0,0,0,0,0,"00",0,0,0,0,0,0,7049317,"2023-12-06T00:00:00.000Z",1,FALSE,3,56677855,"G",1,1,"Atlanta Hawks","Seth Lundy",0,0,0,0,0,0
0,0,0,0,0,0,0,0,0,"00",0,0,0,0,0,0,7049317,"2023-12-06T00:00:00.000Z",1,FALSE,3,56677875,"F",1,1,"Atlanta Hawks","Miles Norris",0,0,0,0,0,0
0,0,1,1,0,1,0,4,4,"11",0,2,4,1,1,0,7049317,"2023-12-06T00:00:00.000Z",1,FALSE,3,301,"G-F",1,1,"Atlanta Hawks","Wesley Matthews",1,5,5,4,1,8.2
6,1,5,4,3,19,12,5,5,"35",0,2,32,5,0,1,7049317,"2023-12-06T00:00:00.000Z",1,FALSE,3,61,"F",3,3,"Brooklyn Nets","Mikal Bridges",1,37,43,38,11,49
3,0,5,6,3,13,7,0,0,"30",1,2,17,6,1,0,7049317,"2023-12-06T00:00:00.000Z",1,FALSE,3,666679,"F",3,3,"Brooklyn Nets","Cameron Johnson",1,23,26,20,9,31.7
4,1,8,0,0,5,1,4,2,"28",2,1,4,10,1,0,7049317,"2023-12-06T00:00:00.000Z",1,FALSE,3,666508,"F-C",3,3,"Brooklyn Nets","Nicolas Claxton",2,14,18,8,14,28
1,0,1,2,0,10,3,0,0,"27",0,2,6,1,0,5,7049317,"2023-12-06T00:00:00.000Z",1,FALSE,3,17896048,"G",3,3,"Brooklyn Nets","Cam Thomas",0,7,8,7,2,3.7
4,1,1,5,1,19,5,3,2,"28",1,0,13,2,1,2,7049317,"2023-12-06T00:00:00.000Z",1,FALSE,3,130,"G",3,3,"Brooklyn Nets","Spencer Dinwiddie",2,15,19,17,6,25.4
0,1,3,6,3,10,6,0,0,"30",2,3,15,5,1,1,7049317,"2023-12-06T00:00:00.000Z",1,FALSE,3,158,"F",3,3,"Brooklyn Nets","Dorian Finney-Smith",2,20,20,15,5,26
2,0,3,4,1,6,2,2,1,"21",0,2,6,3,1,0,7049317,"2023-12-06T00:00:00.000Z",1,FALSE,3,351,"F",3,3,"Brooklyn Nets","Royce O'Neale",1,9,11,8,5,15.6
0,2,6,0,0,5,3,5,2,"19",4,4,8,10,0,3,7049317,"2023-12-06T00:00:00.000Z",1,FALSE,3,17896038,"C",3,3,"Brooklyn Nets","Day'Ron Sharpe",2,18,18,8,10,23
4,0,1,0,0,7,4,5,5,"22",2,3,13,3,2,0,7049317,"2023-12-06T00:00:00.000Z",1,FALSE,3,421,"G",3,3,"Brooklyn Nets","Dennis Smith Jr.",2,16,20,17,7,28.6
0,0,0,0,0,0,0,0,0,"00",0,0,0,0,0,0,7049317,"2023-12-06T00:00:00.000Z",1,FALSE,3,174,"F-C",3,3,"Brooklyn Nets","Harry Giles III",0,0,0,0,0,0
0,0,0,0,0,0,0,0,0,"00",0,0,0,0,0,0,7049317,"2023-12-06T00:00:00.000Z",1,FALSE,3,464,"G",3,3,"Brooklyn Nets","Lonnie Walker IV",0,0,0,0,0,0
0,0,0,0,0,0,0,0,0,"00",0,0,0,0,0,0,7049317,"2023-12-06T00:00:00.000Z",1,FALSE,3,17896058,"F",3,3,"Brooklyn Nets","Trendon Watford",0,0,0,0,0,0
0,0,0,0,0,0,0,0,0,"00",0,0,0,0,0,0,7049317,"2023-12-06T00:00:00.000Z",1,FALSE,3,9051997,"G",3,3,"Brooklyn Nets","Armoni Brooks",0,0,0,0,0,0
0,0,0,0,0,0,0,0,0,"00",0,0,0,0,0,0,7049317,"2023-12-06T00:00:00.000Z",1,FALSE,3,56677843,"F",3,3,"Brooklyn Nets","Noah Clowney",0,0,0,0,0,0
0,0,0,0,0,0,0,0,0,"00",0,0,0,0,0,0,7049317,"2023-12-06T00:00:00.000Z",1,FALSE,3,17896041,"G",3,3,"Brooklyn Nets","Keon Johnson",0,0,0,0,0,0
0,0,0,0,0,0,0,0,0,"00",0,0,0,0,0,0,7049317,"2023-12-06T00:00:00.000Z",1,FALSE,3,417,"G-F",3,3,"Brooklyn Nets","Ben Simmons",0,0,0,0,0,0
0,0,0,0,0,0,0,0,0,"00",0,0,0,0,0,0,7049317,"2023-12-06T00:00:00.000Z",1,FALSE,3,56677841,"F",3,3,"Brooklyn Nets","Dariq Whitehead",0,0,0,0,0,0
0,0,0,0,0,0,0,0,0,"00",0,0,0,0,0,0,7049317,"2023-12-06T00:00:00.000Z",1,FALSE,3,56677722,"F",3,3,"Brooklyn Nets","Jalen Wilson",0,0,0,0,0,0
0,0,2,6,1,8,3,0,0,"20",0,1,7,2,0,1,7049318,"2023-12-06T00:00:00.000Z",18,FALSE,27,666400,"G",18,18,"Minnesota Timberwolves","Nickeil Alexander-Walker",0,9,9,7,2,8.4
2,1,9,3,2,6,5,3,2,"32",1,2,14,10,0,6,7049318,"2023-12-06T00:00:00.000Z",18,FALSE,27,447,"C",18,18,"Minnesota Timberwolves","Karl-Anthony Towns",1,24,26,16,12,26
2,2,15,0,0,8,7,2,2,"30",6,3,16,21,0,1,7049318,"2023-12-06T00:00:00.000Z",18,FALSE,27,176,"C",18,18,"Minnesota Timberwolves","Rudy Gobert",2,37,39,18,23,49.2
6,1,6,5,2,17,4,8,7,"37",1,2,17,7,1,3,7049318,"2023-12-06T00:00:00.000Z",18,FALSE,27,3547238,"G",18,18,"Minnesota Timberwolves","Anthony Edwards",2,24,30,23,13,37.4
4,0,4,10,4,13,5,4,4,"33",0,3,18,4,3,1,7049318,"2023-12-06T00:00:00.000Z",18,FALSE,27,104,"G",18,18,"Minnesota Timberwolves","Mike Conley",3,22,26,22,8,36.8
2,4,1,0,0,6,2,4,3,"22",0,2,7,1,0,0,7049318,"2023-12-06T00:00:00.000Z",18,FALSE,27,12,"F",18,18,"Minnesota Timberwolves","Kyle Anderson",4,8,10,9,3,23.2
2,1,1,8,2,9,3,0,0,"25",0,1,8,1,0,1,7049318,"2023-12-06T00:00:00.000Z",18,FALSE,27,68,"F",18,18,"Minnesota Timberwolves","Troy Brown Jr.",1,9,11,10,3,14.2
0,0,1,1,0,2,0,0,0,"12",0,0,0,1,0,0,7049318,"2023-12-06T00:00:00.000Z",18,FALSE,27,320,"G",18,18,"Minnesota Timberwolves","Shake Milton",0,1,1,0,1,1.2
0,0,0,0,0,0,0,0,0,"00",0,0,0,0,0,0,7049318,"2023-12-06T00:00:00.000Z",18,FALSE,27,38017715,"F",18,18,"Minnesota Timberwolves","Josh Minott",0,0,0,0,0,0
0,0,0,0,0,0,0,0,0,"00",0,0,0,0,0,0,7049318,"2023-12-06T00:00:00.000Z",18,FALSE,27,38017700,"G",18,18,"Minnesota Timberwolves","Wendell Moore Jr.",0,0,0,0,0,0
0,0,0,0,0,0,0,0,0,"00",0,0,0,0,0,0,7049318,"2023-12-06T00:00:00.000Z",18,FALSE,27,17895968,"F",18,18,"Minnesota Timberwolves","Daishen Nix",0,0,0,0,0,0
2,1,5,7,1,18,7,0,0,"29",3,2,15,8,0,1,7049318,"2023-12-06T00:00:00.000Z",18,FALSE,27,667378,"F-C",18,18,"Minnesota Timberwolves","Naz Reid",1,23,25,17,10,29.6
0,0,0,0,0,0,0,0,0,"00",0,0,0,0,0,0,7049318,"2023-12-06T00:00:00.000Z",18,FALSE,27,56677851,"G",18,18,"Minnesota Timberwolves","Jaylen Clark",0,0,0,0,0,0
0,0,0,0,0,0,0,0,0,"00",0,0,0,0,0,0,7049318,"2023-12-06T00:00:00.000Z",18,FALSE,27,17896056,"C",18,18,"Minnesota Timberwolves","Luka Garza",0,0,0,0,0,0
0,0,0,0,0,0,0,0,0,"00",0,0,0,0,0,0,7049318,"2023-12-06T00:00:00.000Z",18,FALSE,27,3547259,"F",18,18,"Minnesota Timberwolves","Jaden McDaniels",0,0,0,0,0,0
0,0,0,0,0,0,0,0,0,"00",0,0,0,0,0,0,7049318,"2023-12-06T00:00:00.000Z",18,FALSE,27,666767,"G",18,18,"Minnesota Timberwolves","Jordan McLaughlin",0,0,0,0,0,0
0,0,0,0,0,0,0,0,0,"00",0,0,0,0,0,0,7049318,"2023-12-06T00:00:00.000Z",18,FALSE,27,56677782,"F",18,18,"Minnesota Timberwolves","Leonard Miller",0,0,0,0,0,0
6,0,6,3,0,8,3,2,0,"32",2,2,6,8,2,1,7049318,"2023-12-06T00:00:00.000Z",18,FALSE,27,359,"F",27,27,"San Antonio Spurs","Cedi Osman",2,14,20,12,14,29.6
1,1,7,2,0,13,4,6,4,"33",3,1,12,10,1,2,7049318,"2023-12-06T00:00:00.000Z",18,FALSE,27,56677822,"F-C",27,27,"San Antonio Spurs","Victor Wembanyama",2,22,23,13,11,29.5
4,0,4,6,0,20,6,0,0,"30",4,3,12,8,0,3,7049318,"2023-12-06T00:00:00.000Z",18,FALSE,27,102,"F-C",27,27,"San Antonio Spurs","Zach Collins",0,20,24,16,12,24.6
3,1,9,3,1,16,8,5,4,"32",1,4,21,10,2,4,7049318,"2023-12-06T00:00:00.000Z",18,FALSE,27,666682,"F",27,27,"San Antonio Spurs","Keldon Johnson",3,31,34,24,13,42.5
2,1,3,8,4,16,9,0,0,"31",0,1,22,3,1,0,7049318,"2023-12-06T00:00:00.000Z",18,FALSE,27,3547246,"G-F",27,27,"San Antonio Spurs","Devin Vassell",2,25,27,24,5,34.6
0,0,0,0,0,0,0,0,0,"00",0,0,0,0,0,0,7049318,"2023-12-06T00:00:00.000Z",18,FALSE,27,17895854,"G",27,27,"San Antonio Spurs","Charles Bassey",0,0,0,0,0,0
0,0,0,1,0,2,0,0,0,"10",2,2,0,2,0,0,7049318,"2023-12-06T00:00:00.000Z",18,FALSE,27,38017692,"F",27,27,"San Antonio Spurs","Malaki Branham",0,2,2,0,2,2.4
0,0,1,1,0,1,0,0,0,"04",0,0,0,1,0,0,7049318,"2023-12-06T00:00:00.000Z",18,FALSE,27,38017649,"F",27,27,"San Antonio Spurs","Julian Champagnie",0,1,1,0,1,1.2
0,1,1,2,0,10,3,0,0,"22",1,1,6,2,0,1,7049318,"2023-12-06T00:00:00.000Z",18,FALSE,27,38017699,"F",27,27,"San Antonio Spurs","Jeremy Sochan",1,8,8,6,2,10.4
0,0,0,0,0,0,0,0,0,"00",0,0,0,0,0,0,7049318,"2023-12-06T00:00:00.000Z",18,FALSE,27,38017730,"F",27,27,"San Antonio Spurs","Dominick Barlow",0,0,0,0,0,0
0,0,0,0,0,0,0,0,0,"00",0,0,0,0,0,0,7049318,"2023-12-06T00:00:00.000Z",18,FALSE,27,56677865,"C",27,27,"San Antonio Spurs","Charles Bediako",0,0,0,0,0,0
0,0,0,0,0,0,0,0,0,"00",0,0,0,0,0,0,7049318,"2023-12-06T00:00:00.000Z",18,FALSE,27,56677817,"G",27,27,"San Antonio Spurs","Sidy Cissoko",0,0,0,0,0,0
0,0,0,0,0,0,0,0,0,"00",0,0,0,0,0,0,7049318,"2023-12-06T00:00:00.000Z",18,FALSE,27,56677870,"G",27,27,"San Antonio Spurs","Sir'Jabari Rice",0,0,0,0,0,0
0,0,0,0,0,0,0,0,0,"00",0,0,0,0,0,0,7049318,"2023-12-06T00:00:00.000Z",18,FALSE,27,38017693,"G",27,27,"San Antonio Spurs","Blake Wesley",0,0,0,0,0,0
0,0,0,0,0,0,0,0,0,"00",0,0,0,0,0,0,7049318,"2023-12-06T00:00:00.000Z",18,FALSE,27,180,"G",27,27,"San Antonio Spurs","Devonte' Graham",0,0,0,0,0,0
5,0,2,3,0,8,2,0,0,"24",0,2,4,2,1,0,7049318,"2023-12-06T00:00:00.000Z",18,FALSE,27,3547274,"G",27,27,"San Antonio Spurs","Tre Jones",1,6,11,9,7,16.9
0,0,0,0,0,0,0,0,0,"00",0,0,0,0,0,0,7049318,"2023-12-06T00:00:00.000Z",18,FALSE,27,17896059,"F",27,27,"San Antonio Spurs","Sandro Mamukelashvili",0,0,0,0,0,0
2,0,3,8,3,8,3,2,2,"22",0,1,11,3,0,0,7049318,"2023-12-06T00:00:00.000Z",18,FALSE,27,305,"F",27,27,"San Antonio Spurs","Doug McDermott",0,14,16,13,5,17.6
3,1,6,3,2,17,8,2,2,"34",6,0,20,12,0,2,7049319,"2023-12-06T00:00:00.000Z",5,FALSE,4,460,"C",5,5,"Chicago Bulls","Nikola Vucevic",1,32,35,23,15,39.9
2,2,2,2,1,7,4,4,3,"30",4,2,12,6,0,1,7049319,"2023-12-06T00:00:00.000Z",5,FALSE,4,89,"G",5,5,"Chicago Bulls","Alex Caruso",2,18,20,14,8,27.2
5,0,9,7,3,16,6,5,4,"38",0,3,19,9,0,0,7049319,"2023-12-06T00:00:00.000Z",5,FALSE,4,666956,"G",5,5,"Chicago Bulls","Coby White",0,28,33,24,14,37.3
3,0,0,1,0,1,0,0,0,"11",0,1,0,0,1,1,7049319,"2023-12-06T00:00:00.000Z",5,FALSE,4,87,"G",5,5,"Chicago Bulls","Jevon Carter",1,0,3,3,3,6.5
2,0,1,2,2,4,2,0,0,"17",3,2,6,4,1,0,7049319,"2023-12-06T00:00:00.000Z",5,FALSE,4,110,"F",5,5,"Chicago Bulls","Torrey Craig",1,10,12,8,6,16.8
2,0,2,4,2,9,3,0,0,"22",0,2,8,2,1,4,7049319,"2023-12-06T00:00:00.000Z",5,FALSE,4,17895983,"G",5,5,"Chicago Bulls","Ayo Dosunmu",1,10,12,10,4,12.4
1,0,4,0,0,8,3,2,1,"14",5,3,7,9,1,3,7049319,"2023-12-06T00:00:00.000Z",5,FALSE,4,137,"C",5,5,"Chicago Bulls","Andre Drummond",1,16,17,8,10,19.3
1,0,0,1,0,2,1,0,0,"06",0,0,2,0,0,0,7049319,"2023-12-06T00:00:00.000Z",5,FALSE,4,56677857,"F",5,5,"Chicago Bulls","Julian Phillips",0,2,3,3,1,3.5
0,0,0,0,0,0,0,0,0,"00",0,0,0,0,0,0,7049319,"2023-12-06T00:00:00.000Z",5,FALSE,4,17896116,"G",5,5,"Chicago Bulls","Terry Taylor",0,0,0,0,0,0
0,0,0,0,0,0,0,0,0,"03",0,0,0,0,0,0,7049319,"2023-12-06T00:00:00.000Z",5,FALSE,4,38017719,"F",5,5,"Chicago Bulls","Dalen Terry",0,0,0,0,0,0
0,0,0,0,0,0,0,0,0,"00",0,0,0,0,0,0,7049319,"2023-12-06T00:00:00.000Z",5,FALSE,4,27,"G",5,5,"Chicago Bulls","Lonzo Ball",0,0,0,0,0,0
0,0,0,0,0,0,0,0,0,"00",0,0,0,0,0,0,7049319,"2023-12-06T00:00:00.000Z",5,FALSE,4,56677874,"F",5,5,"Chicago Bulls","Onuralp Bitim",0,0,0,0,0,0
0,0,0,0,0,0,0,0,0,"00",0,0,0,0,0,0,7049319,"2023-12-06T00:00:00.000Z",5,FALSE,4,268,"G",5,5,"Chicago Bulls","Zach LaVine",0,0,0,0,0,0
0,0,0,0,0,0,0,0,0,"00",0,0,0,0,0,0,7049319,"2023-12-06T00:00:00.000Z",5,FALSE,4,45969255,"F",5,5,"Chicago Bulls","Justin Lewis",0,0,0,0,0,0
0,0,0,0,0,0,0,0,0,"00",0,0,0,0,0,0,7049319,"2023-12-06T00:00:00.000Z",5,FALSE,4,56677860,"F",5,5,"Chicago Bulls","Adama Sanogo",0,0,0,0,0,0
4,1,2,4,2,18,10,5,5,"35",2,2,27,4,2,5,7049319,"2023-12-06T00:00:00.000Z",5,FALSE,4,204,"F",4,4,"Charlotte Hornets","Gordon Hayward",3,31,35,31,8,41.8
2,0,6,8,2,15,7,0,0,"40",2,3,16,8,3,1,7049319,"2023-12-06T00:00:00.000Z",5,FALSE,4,62,"F",4,4,"Charlotte Hornets","Miles Bridges",3,24,26,18,10,36.6
0,3,5,0,0,4,2,2,2,"28",6,3,6,11,1,2,7049319,"2023-12-06T00:00:00.000Z",5,FALSE,4,3547282,"C",4,4,"Charlotte Hornets","Nick Richards",4,17,17,6,11,29.2
4,1,6,6,3,14,4,1,1,"39",0,3,12,6,1,2,7049319,"2023-12-06T00:00:00.000Z",5,FALSE,4,56677823,"F",4,4,"Charlotte Hornets","Brandon Miller",2,18,22,16,10,29.2
7,2,4,11,1,24,10,4,4,"40",1,4,25,5,1,2,7049319,"2023-12-06T00:00:00.000Z",5,FALSE,4,403,"G",4,4,"Charlotte Hornets","Terry Rozier",3,30,37,32,12,48.5
0,0,0,0,0,0,0,0,0,"00",0,0,0,0,0,0,7049319,"2023-12-06T00:00:00.000Z",5,FALSE,4,56677866,"F",4,4,"Charlotte Hornets","Leaky Black",0,0,0,0,0,0
0,0,0,0,0,0,0,0,0,"00",0,0,0,0,0,0,7049319,"2023-12-06T00:00:00.000Z",5,FALSE,4,17896037,"G",4,4,"Charlotte Hornets","James Bouknight",0,0,0,0,0,0
0,0,0,0,0,0,0,0,0,"00",0,0,0,0,0,0,7049319,"2023-12-06T00:00:00.000Z",5,FALSE,4,3547253,"G",4,4,"Charlotte Hornets","Theo Maledon",0,0,0,0,0,0
1,0,1,1,1,2,2,0,0,"16",0,3,5,1,0,1,7049319,"2023-12-06T00:00:00.000Z",5,FALSE,4,38017708,"G",4,4,"Charlotte Hornets","Bryce McGowens",0,6,7,6,2,6.7
3,0,1,0,0,0,0,0,0,"14",0,1,0,1,0,2,7049319,"2023-12-06T00:00:00.000Z",5,FALSE,4,422,"G",4,4,"Charlotte Hornets","Ish Smith",0,1,4,3,4,3.7
0,0,0,0,0,0,0,0,0,"00",0,0,0,0,0,0,7049319,"2023-12-06T00:00:00.000Z",5,FALSE,4,56677846,"G",4,4,"Charlotte Hornets","Nick Smith Jr.",0,0,0,0,0,0
0,0,0,0,0,0,0,0,0,"00",0,0,0,0,0,0,7049319,"2023-12-06T00:00:00.000Z",5,FALSE,4,18678001,"F",4,4,"Charlotte Hornets","JT Thor",0,0,0,0,0,0
4,2,5,7,1,13,4,0,0,"28",1,5,9,6,1,1,7049319,"2023-12-06T00:00:00.000Z",5,FALSE,4,666950,"F",4,4,"Charlotte Hornets","P.J. Washington",3,15,19,13,10,30.2
0,0,0,0,0,0,0,0,0,"00",0,0,0,0,0,0,7049319,"2023-12-06T00:00:00.000Z",5,FALSE,4,56677848,"G",4,4,"Charlotte Hornets","Amari Bailey",0,0,0,0,0,0
0,0,0,0,0,0,0,0,0,"00",0,0,0,0,0,0,7049319,"2023-12-06T00:00:00.000Z",5,FALSE,4,3547239,"G",4,4,"Charlotte Hornets","LaMelo Ball",0,0,0,0,0,0
3,1,6,3,1,20,8,14,12,"36",0,1,29,6,0,2,7049319,"2023-12-06T00:00:00.000Z",5,FALSE,4,125,"G",5,5,"Chicago Bulls","DeMar DeRozan",1,35,38,32,9,41.7
1,2,6,2,1,6,3,2,1,"29",3,2,8,9,2,3,7049319,"2023-12-06T00:00:00.000Z",5,FALSE,4,3547248,"F",5,5,"Chicago Bulls","Patrick Williams",4,17,18,9,10,29.3
0,0,0,0,0,0,0,0,0,"00",0,0,0,0,0,0,7049319,"2023-12-06T00:00:00.000Z",5,FALSE,4,666748,"F",4,4,"Charlotte Hornets","Cody Martin",0,0,0,0,0,0
0,0,0,0,0,0,0,0,0,"00",0,0,0,0,0,0,7049319,"2023-12-06T00:00:00.000Z",5,FALSE,4,347,"G",4,4,"Charlotte Hornets","Frank Ntilikina",0,0,0,0,0,0
0,0,0,0,0,0,0,0,0,"00",0,0,0,0,0,0,7049319,"2023-12-06T00:00:00.000Z",5,FALSE,4,38017698,"C",4,4,"Charlotte Hornets","Mark Williams",0,0,0,0,0,0
2,0,2,7,2,17,9,3,3,"40",2,2,23,4,1,3,7049320,"2023-12-06T00:00:00.000Z",11,FALSE,21,66,"G-F",11,11,"Houston Rockets","Dillon Brooks",1,27,29,25,6,30.8
1,0,14,1,1,4,2,1,1,"32",4,1,6,18,0,3,7049320,"2023-12-06T00:00:00.000Z",11,FALSE,21,38017684,"F",11,11,"Houston Rockets","Jabari Smith Jr.",0,24,25,7,19,26.1
7,2,5,2,0,13,8,11,5,"35",1,4,21,6,1,4,7049320,"2023-12-06T00:00:00.000Z",11,FALSE,21,17896062,"F-C",11,11,"Houston Rockets","Alperen Sengun",3,27,34,28,13,43.7
1,0,7,3,1,12,6,2,2,"25",0,3,15,7,0,3,7049320,"2023-12-06T00:00:00.000Z",11,FALSE,21,17895966,"G",11,11,"Houston Rockets","Jalen Green",0,22,23,16,8,21.9
9,1,3,7,3,14,4,0,0,"38",0,0,11,3,3,3,7049320,"2023-12-06T00:00:00.000Z",11,FALSE,21,458,"G",11,11,"Houston Rockets","Fred VanVleet",4,14,23,20,12,37.1
0,0,0,1,0,2,1,1,1,"06",0,0,3,0,0,0,7049320,"2023-12-06T00:00:00.000Z",11,FALSE,21,75,"G-F",11,11,"Houston Rockets","Reggie Bullock",0,3,3,3,0,3
4,2,6,4,2,6,2,4,3,"22",2,2,9,8,0,1,7049320,"2023-12-06T00:00:00.000Z",11,FALSE,21,38017695,"F",11,11,"Houston Rockets","Tari Eason",2,17,21,13,12,29.6
0,0,0,0,0,0,0,0,0,"00",0,0,0,0,0,0,7049320,"2023-12-06T00:00:00.000Z",11,FALSE,21,19465326,"C",11,11,"Houston Rockets","Jock Landale",0,0,0,0,0,0
0,0,0,0,0,0,0,0,0,"00",0,0,0,0,0,0,7049320,"2023-12-06T00:00:00.000Z",11,FALSE,21,357,"G",11,11,"Houston Rockets","Victor Oladipo",0,0,0,0,0,0
0,0,0,0,0,0,0,0,0,"00",0,0,0,0,0,0,7049320,"2023-12-06T00:00:00.000Z",11,FALSE,21,56677809,"F",11,11,"Houston Rockets","Jermaine Samuels Jr.",0,0,0,0,0,0
0,0,0,0,0,0,0,0,0,"00",0,0,0,0,0,0,7049320,"2023-12-06T00:00:00.000Z",11,FALSE,21,56677825,"G-F",11,11,"Houston Rockets","Amen Thompson",0,0,0,0,0,0
0,0,0,0,0,0,0,0,0,"00",0,0,0,0,0,0,7049320,"2023-12-06T00:00:00.000Z",11,FALSE,21,56677831,"F",11,11,"Houston Rockets","Cam Whitmore",0,0,0,0,0,0
0,0,1,3,0,5,0,4,4,"14",2,1,4,3,0,1,7049320,"2023-12-06T00:00:00.000Z",11,FALSE,21,666541,"G",21,21,"Oklahoma City Thunder","Luguentz Dort",0,7,7,4,3,6.6
3,0,5,1,0,13,5,3,3,"33",0,2,13,5,1,2,7049320,"2023-12-06T00:00:00.000Z",11,FALSE,21,38017703,"G-F",21,21,"Oklahoma City Thunder","Jalen Williams",1,18,21,16,8,24.5
2,6,4,4,0,9,2,0,0,"26",1,2,4,5,1,1,7049320,"2023-12-06T00:00:00.000Z",11,FALSE,21,38017685,"C-F",21,21,"Oklahoma City Thunder","Chet Holmgren",7,9,11,6,7,33
6,0,3,5,2,11,3,0,0,"25",1,3,8,4,1,0,7049320,"2023-12-06T00:00:00.000Z",11,FALSE,21,17896065,"G",21,21,"Oklahoma City Thunder","Josh Giddey",1,12,18,14,10,24.8
6,1,3,0,0,18,13,9,7,"37",0,4,33,3,6,2,7049320,"2023-12-06T00:00:00.000Z",11,FALSE,21,175,"G",21,21,"Oklahoma City Thunder","Shai Gilgeous-Alexander",7,36,42,39,9,64.6
0,0,0,0,0,0,0,0,0,"00",0,0,0,0,0,0,7049320,"2023-12-06T00:00:00.000Z",11,FALSE,21,44,"F",21,21,"Oklahoma City Thunder","Davis Bertans",0,0,0,0,0,0
0,0,1,4,1,5,1,0,0,"14",0,1,3,1,0,1,7049320,"2023-12-06T00:00:00.000Z",11,FALSE,21,3547272,"G",21,21,"Oklahoma City Thunder","Isaiah Joe",0,4,4,3,1,3.2
4,0,3,4,2,8,4,0,0,"24",0,0,10,3,2,1,7049320,"2023-12-06T00:00:00.000Z",11,FALSE,21,17896036,"G",21,21,"Oklahoma City Thunder","Tre Mann",2,13,17,14,7,24.6
0,0,0,0,0,0,0,0,0,"00",0,0,0,0,0,0,7049320,"2023-12-06T00:00:00.000Z",11,FALSE,21,4197029,"G",21,21,"Oklahoma City Thunder","Vasilije Micic",0,0,0,0,0,0
0,0,0,0,0,0,0,0,0,"00",0,0,0,0,0,0,7049320,"2023-12-06T00:00:00.000Z",11,FALSE,21,3547271,"C",21,21,"Oklahoma City Thunder","Aleksej Pokusevski",0,0,0,0,0,0
0,0,0,0,0,0,0,0,0,"00",0,0,0,0,0,0,7049320,"2023-12-06T00:00:00.000Z",11,FALSE,21,24572055,"C",21,21,"Oklahoma City Thunder","Olivier Sarr",0,0,0,0,0,0
0,1,3,2,1,5,2,0,0,"25",0,3,5,3,2,0,7049320,"2023-12-06T00:00:00.000Z",11,FALSE,21,56677833,"G",21,21,"Oklahoma City Thunder","Cason Wallace",3,8,8,5,3,17.6
0,0,1,0,0,4,4,4,3,"15",0,3,11,1,1,0,7049320,"2023-12-06T00:00:00.000Z",11,FALSE,21,17896078,"G",21,21,"Oklahoma City Thunder","Aaron Wiggins",1,12,12,11,1,15.2
0,0,0,2,0,4,0,2,2,"12",0,1,2,0,0,0,7049320,"2023-12-06T00:00:00.000Z",11,FALSE,21,38017706,"F",21,21,"Oklahoma City Thunder","Jaylin Williams",0,2,2,2,0,2
1,2,2,4,2,5,3,2,0,"15",0,1,8,2,0,0,7049320,"2023-12-06T00:00:00.000Z",11,FALSE,21,480,"G-F",21,21,"Oklahoma City Thunder","Kenrich Williams",2,10,11,9,3,17.9
0,0,0,0,0,0,0,0,0,"00",0,0,0,0,0,0,7049320,"2023-12-06T00:00:00.000Z",11,FALSE,21,38017716,"F",21,21,"Oklahoma City Thunder","Ousmane Dieng",0,0,0,0,0,0
0,0,0,0,0,0,0,0,0,"00",0,0,0,0,0,0,7049320,"2023-12-06T00:00:00.000Z",11,FALSE,21,56677853,"F",21,21,"Oklahoma City Thunder","Keyontae Johnson",0,0,0,0,0,0
4,0,5,7,6,13,8,0,0,"27",1,3,22,6,1,0,7049320,"2023-12-06T00:00:00.000Z",11,FALSE,21,213,"G",11,11,"Houston Rockets","Aaron Holiday",1,28,32,26,10,38.2
0,0,0,0,0,0,0,0,0,"00",0,0,0,0,0,0,7049320,"2023-12-06T00:00:00.000Z",11,FALSE,21,296,"C",11,11,"Houston Rockets","Boban Marjanovic",0,0,0,0,0,0
0,0,1,1,0,2,0,0,0,"15",0,1,0,1,0,2,7049320,"2023-12-06T00:00:00.000Z",11,FALSE,21,3547301,"F",11,11,"Houston Rockets","Jae'Sean Tate",0,1,1,0,1,-0.8
0,0,0,0,0,0,0,0,0,"00",0,0,0,0,0,0,7049320,"2023-12-06T00:00:00.000Z",11,FALSE,21,47738533,"G",11,11,"Houston Rockets","Jeenathan Williams",0,0,0,0,0,0
0,0,0,0,0,0,0,0,0,"00",0,0,0,0,0,0,7049320,"2023-12-06T00:00:00.000Z",11,FALSE,21,188,"F",11,11,"Houston Rockets","Jeff Green",0,0,0,0,0,0
0,0,0,0,0,0,0,0,0,"00",0,0,0,0,0,0,7049320,"2023-12-06T00:00:00.000Z",11,FALSE,21,3547281,"G-F",11,11,"Houston Rockets","Nate Hinton",0,0,0,0,0,0
0,0,0,0,0,0,0,0,0,"00",0,0,0,0,0,0,7049320,"2023-12-06T00:00:00.000Z",11,FALSE,21,27924547,"F",21,21,"Oklahoma City Thunder","Lindy Waters III",0,0,0,0,0,0
7,0,6,5,1,9,2,0,0,"26",0,1,5,6,2,0,7049321,"2023-12-06T00:00:00.000Z",7,FALSE,29,151,"G",7,7,"Dallas Mavericks","Dante Exum",2,11,18,12,13,28.7
1,2,3,2,1,5,4,5,3,"25",1,3,12,4,1,0,7049321,"2023-12-06T00:00:00.000Z",7,FALSE,29,247,"F-G",7,7,"Dallas Mavericks","Derrick Jones Jr.",3,16,17,13,5,27.3
1,2,3,0,0,6,5,0,0,"24",1,2,10,4,1,0,7049321,"2023-12-06T00:00:00.000Z",7,FALSE,29,56677840,"C",7,7,"Dallas Mavericks","Dereck Lively II",3,14,15,11,5,25.3
4,0,3,7,4,16,11,0,0,"27",0,2,26,3,3,1,7049321,"2023-12-06T00:00:00.000Z",7,FALSE,29,228,"G",7,7,"Dallas Mavericks","Kyrie Irving",3,29,33,30,7,43.6
11,0,8,12,6,25,14,8,6,"32",2,2,40,10,1,4,7049321,"2023-12-06T00:00:00.000Z",7,FALSE,29,132,"F-G",7,7,"Dallas Mavericks","Luka Doncic",1,50,61,51,21,67.5
2,0,1,3,2,7,4,0,0,"19",1,0,10,2,2,0,7049321,"2023-12-06T00:00:00.000Z",7,FALSE,29,114,"G",7,7,"Dallas Mavericks","Seth Curry",2,12,14,12,4,21.4
2,0,3,12,4,14,5,4,3,"22",1,1,17,4,0,0,7049321,"2023-12-06T00:00:00.000Z",7,FALSE,29,191,"G",7,7,"Dallas Mavericks","Tim Hardaway Jr.",0,21,23,19,6,24.8
0,0,0,0,0,0,0,0,0,"00",0,0,0,0,0,0,7049321,"2023-12-06T00:00:00.000Z",7,FALSE,29,257,"F",7,7,"Dallas Mavericks","Maxi Kleber",0,0,0,0,0,0
0,0,0,0,0,0,0,0,0,"00",0,0,0,0,0,0,7049321,"2023-12-06T00:00:00.000Z",7,FALSE,29,666965,"F",7,7,"Dallas Mavericks","Grant Williams",0,0,0,0,0,0
3,1,2,3,1,5,2,2,2,"24",0,1,7,2,0,1,7049321,"2023-12-06T00:00:00.000Z",7,FALSE,29,38017739,"F",29,29,"Utah Jazz","Simone Fontecchio",1,9,12,10,5,15.9
0,0,6,2,0,11,5,0,0,"23",2,2,10,8,0,2,7049321,"2023-12-06T00:00:00.000Z",7,FALSE,29,101,"F-C",29,29,"Utah Jazz","John Collins",0,18,18,10,8,17.6
0,0,1,2,1,3,1,0,0,"05",0,0,3,1,0,0,7049321,"2023-12-06T00:00:00.000Z",7,FALSE,29,329,"F",7,7,"Dallas Mavericks","Markieff Morris",0,4,4,3,1,4.2
0,0,0,0,0,0,0,0,0,"00",0,0,0,0,0,0,7049321,"2023-12-06T00:00:00.000Z",7,FALSE,29,17896028,"F",7,7,"Dallas Mavericks","Greg Brown III",0,0,0,0,0,0
0,0,0,0,0,0,0,0,0,"00",0,0,0,0,0,0,7049321,"2023-12-06T00:00:00.000Z",7,FALSE,29,56677873,"G",7,7,"Dallas Mavericks","Dexter Dennis",0,0,0,0,0,0
0,0,0,0,0,0,0,0,0,"00",0,0,0,0,0,0,7049321,"2023-12-06T00:00:00.000Z",7,FALSE,29,3547258,"G",7,7,"Dallas Mavericks","Josh Green",0,0,0,0,0,0
2,0,3,4,1,8,3,2,1,"17",1,2,8,4,0,0,7049321,"2023-12-06T00:00:00.000Z",7,FALSE,29,139,"G",29,29,"Utah Jazz","Kris Dunn",0,12,14,10,6,15.8
0,0,0,0,0,0,0,0,0,"00",0,0,0,0,0,0,7049321,"2023-12-06T00:00:00.000Z",7,FALSE,29,358,"F",29,29,"Utah Jazz","Kelly Olynyk",0,0,0,0,0,0
0,0,1,2,0,5,1,0,0,"07",0,0,2,1,0,0,7049321,"2023-12-06T00:00:00.000Z",7,FALSE,29,666881,"F",29,29,"Utah Jazz","Luka Samanic",0,3,3,2,1,3.2
0,0,0,0,0,0,0,0,0,"00",0,0,0,0,0,0,7049321,"2023-12-06T00:00:00.000Z",7,FALSE,29,17896023,"G",29,29,"Utah Jazz","Josh Christopher",0,0,0,0,0,0
3,0,3,0,0,2,2,0,0,"18",1,1,4,4,1,0,7049321,"2023-12-06T00:00:00.000Z",7,FALSE,29,379,"F-C",7,7,"Dallas Mavericks","Dwight Powell",1,8,11,7,7,16.3
2,0,4,2,1,4,2,2,1,"21",1,1,6,5,0,0,7049321,"2023-12-06T00:00:00.000Z",7,FALSE,29,56677859,"F",7,7,"Dallas Mavericks","Olivier-Maxence Prosper",0,11,13,8,7,15
4,0,1,4,2,7,3,0,0,"08",2,1,8,3,0,1,7049321,"2023-12-06T00:00:00.000Z",7,FALSE,29,38017679,"G",7,7,"Dallas Mavericks","Jaden Hardy",0,11,15,12,7,16.6
0,1,0,0,0,1,1,0,0,"06",0,0,2,0,0,1,7049321,"2023-12-06T00:00:00.000Z",7,FALSE,29,217,"F-C",7,7,"Dallas Mavericks","Richaun Holmes",1,2,2,2,0,4
0,0,0,0,0,2,2,0,0,"07",1,0,4,1,0,0,7049321,"2023-12-06T00:00:00.000Z",7,FALSE,29,17554004,"G",7,7,"Dallas Mavericks","AJ Lawson",0,5,5,4,1,5.2
0,0,0,0,0,0,0,0,0,"00",0,0,0,0,0,0,7049321,"2023-12-06T00:00:00.000Z",7,FALSE,29,100,"G",29,29,"Utah Jazz","Jordan Clarkson",0,0,0,0,0,0
0,0,0,0,0,0,0,0,0,"00",0,0,0,0,0,0,7049321,"2023-12-06T00:00:00.000Z",7,FALSE,29,38017630,"G",29,29,"Utah Jazz","Johnny Juzang",0,0,0,0,0,0
0,0,0,0,0,0,0,0,0,"00",0,0,0,0,0,0,7049321,"2023-12-06T00:00:00.000Z",7,FALSE,29,297,"F",29,29,"Utah Jazz","Lauri Markkanen",0,0,0,0,0,0
0,0,0,0,0,0,0,0,0,"00",0,0,0,0,0,0,7049321,"2023-12-06T00:00:00.000Z",7,FALSE,29,19465584,"F",29,29,"Utah Jazz","Micah Potter",0,0,0,0,0,0
0,0,0,0,0,0,0,0,0,"00",0,0,0,0,0,0,7049321,"2023-12-06T00:00:00.000Z",7,FALSE,29,56677842,"F",29,29,"Utah Jazz","Brice Sensabaugh",0,0,0,0,0,0
0,0,6,0,0,7,4,0,0,"21",3,5,8,9,0,4,7049321,"2023-12-06T00:00:00.000Z",7,FALSE,29,11891374,"C",29,29,"Utah Jazz","Omer Yurtseven",0,17,17,8,9,14.8
0,0,0,10,5,14,7,2,2,"30",0,1,21,0,2,0,7049321,"2023-12-06T00:00:00.000Z",7,FALSE,29,38017620,"G",29,29,"Utah Jazz","Ochai Agbaji",2,21,21,21,0,27
11,1,4,4,0,11,2,4,3,"32",0,0,7,4,0,5,7049321,"2023-12-06T00:00:00.000Z",7,FALSE,29,56677834,"G",29,29,"Utah Jazz","Keyonte George",1,11,22,18,15,26.3
0,0,4,0,0,7,3,0,0,"27",4,4,6,8,1,2,7049321,"2023-12-06T00:00:00.000Z",7,FALSE,29,38017705,"C",29,29,"Utah Jazz","Walker Kessler",1,14,14,6,8,16.6
0,1,1,4,2,6,4,0,0,"25",1,3,10,2,2,2,7049321,"2023-12-06T00:00:00.000Z",7,FALSE,29,56677824,"F",29,29,"Utah Jazz","Taylor Hendricks",3,12,12,10,2,19.4
5,0,3,1,0,4,0,8,7,"18",0,1,7,3,1,2,7049321,"2023-12-06T00:00:00.000Z",7,FALSE,29,413,"G",29,29,"Utah Jazz","Collin Sexton",1,10,15,12,8,19.1
1,0,2,3,3,9,4,0,0,"16",0,1,11,2,0,1,7049321,"2023-12-06T00:00:00.000Z",7,FALSE,29,666650,"G",29,29,"Utah Jazz","Talen Horton-Tucker",0,13,14,12,3,13.9
1,0,2,1,0,12,3,3,3,"27",1,1,9,3,0,1,7049322,"2023-12-06T00:00:00.000Z",10,FALSE,25,475,"F-G",10,10,"Golden State Warriors","Andrew Wiggins",0,12,13,10,4,13.1
9,2,4,2,0,7,3,4,4,"31",6,3,10,10,0,4,7049322,"2023-12-06T00:00:00.000Z",10,FALSE,25,185,"F",10,10,"Golden State Warriors","Draymond Green",2,20,29,19,19,37.5
0,0,6,0,0,6,2,2,2,"16",2,2,6,8,1,0,7049322,"2023-12-06T00:00:00.000Z",10,FALSE,25,282,"F",10,10,"Golden State Warriors","Kevon Looney",1,14,14,6,8,18.6
1,0,5,8,1,13,3,4,4,"27",0,0,11,5,0,0,7049322,"2023-12-06T00:00:00.000Z",10,FALSE,25,443,"G",10,10,"Golden State Warriors","Klay Thompson",0,16,17,12,6,18.5
1,0,5,13,5,18,8,11,10,"34",0,2,31,5,0,4,7049322,"2023-12-06T00:00:00.000Z",10,FALSE,25,115,"G",10,10,"Golden State Warriors","Stephen Curry",0,36,37,32,6,34.5
0,0,0,0,0,0,0,0,0,"00",0,0,0,0,0,0,7049322,"2023-12-06T00:00:00.000Z",10,FALSE,25,56677799,"F",10,10,"Golden State Warriors","Trayce Jackson-Davis",0,0,0,0,0,0
0,0,0,0,0,0,0,0,0,"00",0,0,0,0,0,0,7049322,"2023-12-06T00:00:00.000Z",10,FALSE,25,251,"G",10,10,"Golden State Warriors","Cory Joseph",0,0,0,0,0,0
1,0,1,0,0,6,6,2,1,"17",0,2,13,1,2,0,7049322,"2023-12-06T00:00:00.000Z",10,FALSE,25,17553979,"F",10,10,"Golden State Warriors","Jonathan Kuminga",2,14,15,14,2,21.7
0,1,2,4,1,10,5,1,1,"26",2,2,12,4,1,1,7049322,"2023-12-06T00:00:00.000Z",10,FALSE,25,17553992,"G",10,10,"Golden State Warriors","Moses Moody",2,16,16,12,4,21.8
6,0,2,2,0,4,1,0,0,"21",1,2,2,3,0,2,7049322,"2023-12-06T00:00:00.000Z",10,FALSE,25,367,"G",10,10,"Golden State Warriors","Chris Paul",0,5,11,8,9,12.6
0,0,0,0,0,0,0,0,0,"00",0,0,0,0,0,0,7049322,"2023-12-06T00:00:00.000Z",10,FALSE,25,2189,"",10,10,"Golden State Warriors","Gary Payton II",0,0,0,0,0,0
1,0,4,1,1,3,1,2,0,"21",1,2,3,5,0,1,7049322,"2023-12-06T00:00:00.000Z",10,FALSE,25,56677858,"G",10,10,"Golden State Warriors","Brandin Podziemski",0,8,9,4,6,9.5
0,0,4,3,2,7,4,4,3,"20",2,3,13,6,0,4,7049322,"2023-12-06T00:00:00.000Z",10,FALSE,25,407,"F",10,10,"Golden State Warriors","Dario Saric",0,19,19,13,6,16.2
0,0,0,0,0,0,0,0,0,"00",0,0,0,0,0,0,7049322,"2023-12-06T00:00:00.000Z",10,FALSE,25,17896070,"F",10,10,"Golden State Warriors","Usman Garuba",0,0,0,0,0,0
0,0,0,0,0,0,0,0,0,"00",0,0,0,0,0,0,7049322,"2023-12-06T00:00:00.000Z",10,FALSE,25,476,"C-F",25,25,"Portland Trail Blazers","Robert Williams III",0,0,0,0,0,0
0,0,0,0,0,0,0,0,0,"00",0,0,0,0,0,0,7049322,"2023-12-06T00:00:00.000Z",10,FALSE,25,45658838,"G",10,10,"Golden State Warriors","Lester Quinones",0,0,0,0,0,0
0,0,0,0,0,0,0,0,0,"00",0,0,0,0,0,0,7049322,"2023-12-06T00:00:00.000Z",10,FALSE,25,398,"G",10,10,"Golden State Warriors","Jerome Robinson",0,0,0,0,0,0
0,0,0,0,0,0,0,0,0,"00",0,0,0,0,0,0,7049322,"2023-12-06T00:00:00.000Z",10,FALSE,25,57875092,"F",10,10,"Golden State Warriors","Gui Santos",0,0,0,0,0,0
5,0,6,9,4,18,10,4,2,"42",0,1,26,6,0,1,7049322,"2023-12-06T00:00:00.000Z",10,FALSE,25,38017690,"G",25,25,"Portland Trail Blazers","Shaedon Sharpe",0,32,37,31,11,39.7
2,0,8,4,0,14,3,0,0,"27",5,6,6,13,0,3,7049322,"2023-12-06T00:00:00.000Z",10,FALSE,25,56677850,"F",25,25,"Portland Trail Blazers","Toumani Camara",0,19,21,8,15,21.6
2,1,5,5,1,6,2,6,5,"22",1,5,10,6,1,0,7049322,"2023-12-06T00:00:00.000Z",10,FALSE,25,56783340,"C",25,25,"Portland Trail Blazers","Duop Reath",2,16,18,12,8,26.2
4,0,0,13,6,27,10,2,2,"37",1,3,28,1,0,1,7049322,"2023-12-06T00:00:00.000Z",10,FALSE,25,419,"G",25,25,"Portland Trail Blazers","Anfernee Simons",0,29,33,32,5,34.2
2,0,1,1,0,3,0,0,0,"12",0,1,0,1,0,1,7049322,"2023-12-06T00:00:00.000Z",10,FALSE,25,65,"G",25,25,"Portland Trail Blazers","Malcolm Brogdon",0,1,3,2,3,3.2
0,0,0,0,0,0,0,0,0,"00",0,0,0,0,0,0,7049322,"2023-12-06T00:00:00.000Z",10,FALSE,25,39613724,"C",25,25,"Portland Trail Blazers","Ibou Badji",0,0,0,0,0,0
0,0,0,0,0,0,0,0,0,"00",0,0,0,0,0,0,7049322,"2023-12-06T00:00:00.000Z",10,FALSE,25,666476,"C",25,25,"Portland Trail Blazers","Moses Brown",0,0,0,0,0,0
4,0,0,3,0,9,4,2,1,"26",2,5,9,2,1,1,7049322,"2023-12-06T00:00:00.000Z",10,FALSE,25,56677747,"G",25,25,"Portland Trail Blazers","Scoot Henderson",1,11,15,13,6,19.4
0,0,0,0,0,0,0,0,0,"00",0,0,0,0,0,0,7049322,"2023-12-06T00:00:00.000Z",10,FALSE,25,3547289,"G",25,25,"Portland Trail Blazers","Skylar Mays",0,0,0,0,0,0
1,0,5,4,2,4,2,0,0,"21",0,2,6,5,2,0,7049322,"2023-12-06T00:00:00.000Z",10,FALSE,25,56677791,"F",25,25,"Portland Trail Blazers","Kris Murray",2,11,12,7,6,19.5
0,0,0,0,0,0,0,0,0,"00",0,0,0,0,0,0,7049322,"2023-12-06T00:00:00.000Z",10,FALSE,25,56677829,"G-F",25,25,"Portland Trail Blazers","Rayan Rupert",0,0,0,0,0,0
1,1,1,5,3,6,3,0,0,"31",0,1,9,1,3,1,7049322,"2023-12-06T00:00:00.000Z",10,FALSE,25,666923,"G-F",25,25,"Portland Trail Blazers","Matisse Thybulle",4,10,11,10,2,22.7
1,1,3,2,0,8,5,2,2,"22",2,6,12,5,1,2,7049322,"2023-12-06T00:00:00.000Z",10,FALSE,25,38017711,"F",25,25,"Portland Trail Blazers","Jabari Walker",2,17,18,13,6,23.5
0,0,0,0,0,0,0,0,0,"00",0,0,0,0,0,0,7049322,"2023-12-06T00:00:00.000Z",10,FALSE,25,22,"C",25,25,"Portland Trail Blazers","Deandre Ayton",0,0,0,0,0,0
0,0,0,0,0,0,0,0,0,"00",0,0,0,0,0,0,7049322,"2023-12-06T00:00:00.000Z",10,FALSE,25,182,"F",25,25,"Portland Trail Blazers","Jerami Grant",0,0,0,0,0,0
0,0,0,0,0,0,0,0,0,"00",0,0,0,0,0,0,7049322,"2023-12-06T00:00:00.000Z",10,FALSE,25,47957121,"F",25,25,"Portland Trail Blazers","Justin Minaya",0,0,0,0,0,0
0,0,0,0,0,0,0,0,0,"00",0,0,0,0,0,0,7049322,"2023-12-06T00:00:00.000Z",10,FALSE,25,17896120,"F",25,25,"Portland Trail Blazers","Ish Wainright",0,0,0,0,0,0
0,0,1,0,0,2,1,0,0,"20",0,1,2,1,0,0,7049323,"2023-12-06T00:00:00.000Z",13,FALSE,8,666743,"G",13,13,"LA Clippers","Terance Mann",0,3,3,2,1,3.2
5,1,3,3,1,16,8,0,0,"38",1,2,17,4,1,2,7049323,"2023-12-06T00:00:00.000Z",13,FALSE,8,274,"F",13,13,"LA Clippers","Kawhi Leonard",2,21,26,22,9,33.3
0,1,7,0,0,7,4,6,2,"27",2,3,10,9,2,0,7049323,"2023-12-06T00:00:00.000Z",13,FALSE,8,493,"C",13,13,"LA Clippers","Ivica Zubac",3,19,19,10,9,29.8
1,1,7,9,5,20,8,4,4,"38",1,1,25,8,0,2,7049323,"2023-12-06T00:00:00.000Z",13,FALSE,8,172,"F",13,13,"LA Clippers","Paul George",1,33,34,26,9,37.1
11,0,1,3,2,10,6,7,6,"32",0,0,20,1,3,4,7049323,"2023-12-06T00:00:00.000Z",13,FALSE,8,192,"G",13,13,"LA Clippers","James Harden",3,21,32,31,12,42.7
1,0,4,3,1,4,1,0,0,"17",0,4,3,4,0,0,7049323,"2023-12-06T00:00:00.000Z",13,FALSE,8,56677849,"F",13,13,"LA Clippers","Kobe Brown",0,7,8,4,5,9.3
0,0,0,0,0,0,0,0,0,"00",0,0,0,0,0,0,7049323,"2023-12-06T00:00:00.000Z",13,FALSE,8,666511,"G",13,13,"LA Clippers","Amir Coffey",0,0,0,0,0,0
0,0,0,0,0,0,0,0,0,"00",0,0,0,0,0,0,7049323,"2023-12-06T00:00:00.000Z",13,FALSE,8,17896031,"G",13,13,"LA Clippers","Nah'Shon Hyland",0,0,0,0,0,0
2,0,4,3,1,12,5,6,6,"31",0,0,17,4,1,1,7049323,"2023-12-06T00:00:00.000Z",13,FALSE,8,380,"F-G",13,13,"LA Clippers","Norman Powell",1,21,23,19,6,26.8
0,3,6,4,2,8,3,0,0,"21",5,2,8,11,0,1,7049323,"2023-12-06T00:00:00.000Z",13,FALSE,8,439,"F",13,13,"LA Clippers","Daniel Theis",3,19,19,8,11,29.2
0,0,0,0,0,0,0,0,0,"00",0,0,0,0,0,0,7049323,"2023-12-06T00:00:00.000Z",13,FALSE,8,450,"F",13,13,"LA Clippers","PJ Tucker",0,0,0,0,0,0
1,1,4,2,0,8,4,2,1,"16",4,1,9,8,0,1,7049323,"2023-12-06T00:00:00.000Z",13,FALSE,8,472,"G",13,13,"LA Clippers","Russell Westbrook",1,17,18,10,9,22.1
0,0,0,0,0,0,0,0,0,"00",0,0,0,0,0,0,7049323,"2023-12-06T00:00:00.000Z",13,FALSE,8,17896022,"G",13,13,"LA Clippers","Brandon Boston Jr.",0,0,0,0,0,0
0,0,0,0,0,0,0,0,0,"00",0,0,0,0,0,0,7049323,"2023-12-06T00:00:00.000Z",13,FALSE,8,38017725,"F",13,13,"LA Clippers","Moussa Diabate",0,0,0,0,0,0
0,0,0,0,0,0,0,0,0,"00",0,0,0,0,0,0,7049323,"2023-12-06T00:00:00.000Z",13,FALSE,8,56677856,"G",13,13,"LA Clippers","Jordan Miller",0,0,0,0,0,0
0,0,0,0,0,0,0,0,0,"00",0,0,0,0,0,0,7049323,"2023-12-06T00:00:00.000Z",13,FALSE,8,24417679,"G",13,13,"LA Clippers","Xavier Moon",0,0,0,0,0,0
0,0,0,0,0,0,0,0,0,"00",0,0,0,0,0,0,7049323,"2023-12-06T00:00:00.000Z",13,FALSE,8,371,"F-C",13,13,"LA Clippers","Mason Plumlee",0,0,0,0,0,0
0,0,0,0,0,0,0,0,0,"00",0,0,0,0,0,0,7049323,"2023-12-06T00:00:00.000Z",13,FALSE,8,17896051,"G",13,13,"LA Clippers","Joshua Primo",0,0,0,0,0,0
0,1,6,5,4,8,7,0,0,"34",3,2,18,9,0,2,7049323,"2023-12-06T00:00:00.000Z",13,FALSE,8,375,"F",8,8,"Denver Nuggets","Michael Porter Jr.",1,27,27,18,9,29.8
2,0,4,0,0,8,4,0,0,"31",1,2,8,5,2,0,7049323,"2023-12-06T00:00:00.000Z",13,FALSE,8,177,"F",8,8,"Denver Nuggets","Aaron Gordon",2,13,15,10,7,23
10,0,10,7,2,32,9,2,2,"37",5,2,22,15,1,4,7049323,"2023-12-06T00:00:00.000Z",13,FALSE,8,246,"C",8,8,"Denver Nuggets","Nikola Jokic",1,37,47,32,25,54
0,1,4,1,0,5,4,0,0,"16",1,3,8,5,0,0,7049323,"2023-12-06T00:00:00.000Z",13,FALSE,8,38017709,"G",8,8,"Denver Nuggets","Christian Braun",1,13,13,8,5,17
0,0,0,0,0,0,0,0,0,"00",0,0,0,0,0,0,7049323,"2023-12-06T00:00:00.000Z",13,FALSE,8,38017727,"G",8,8,"Denver Nuggets","Collin Gillespie",0,0,0,0,0,0
0,0,0,0,0,0,0,0,0,"00",0,0,0,0,0,0,7049323,"2023-12-06T00:00:00.000Z",13,FALSE,8,215,"F-G",8,8,"Denver Nuggets","Justin Holiday",0,0,0,0,0,0
3,0,1,4,3,10,4,4,3,"19",0,1,14,1,1,2,7049323,"2023-12-06T00:00:00.000Z",13,FALSE,8,236,"G",8,8,"Denver Nuggets","Reggie Jackson",1,15,18,17,4,20.7
0,1,2,0,0,6,2,0,0,"11",3,0,4,5,0,0,7049323,"2023-12-06T00:00:00.000Z",13,FALSE,8,250,"C",8,8,"Denver Nuggets","DeAndre Jordan",1,9,9,4,5,13
0,0,0,0,0,0,0,0,0,"00",0,0,0,0,0,0,7049323,"2023-12-06T00:00:00.000Z",13,FALSE,8,17896007,"G",8,8,"Denver Nuggets","Braxton Key",0,0,0,0,0,0
0,0,0,0,0,0,0,0,0,"00",0,0,0,0,0,0,7049323,"2023-12-06T00:00:00.000Z",13,FALSE,8,3547268,"F-C",8,8,"Denver Nuggets","Zeke Nnaji",0,0,0,0,0,0
2,0,1,2,0,2,0,0,0,"13",0,4,0,1,0,1,7049323,"2023-12-06T00:00:00.000Z",13,FALSE,8,56677776,"G",8,8,"Denver Nuggets","Julian Strawther",0,1,3,2,3,3.2
3,1,3,2,0,3,0,2,2,"16",0,1,2,3,1,1,7049323,"2023-12-06T00:00:00.000Z",13,FALSE,8,38017721,"G",8,8,"Denver Nuggets","Peyton Watson",2,5,8,5,6,15.1
0,0,0,0,0,0,0,0,0,"00",0,0,0,0,0,0,7049323,"2023-12-06T00:00:00.000Z",13,FALSE,8,666489,"F",8,8,"Denver Nuggets","Vlatko Cancar",0,0,0,0,0,0
0,0,0,0,0,0,0,0,0,"00",0,0,0,0,0,0,7049323,"2023-12-06T00:00:00.000Z",13,FALSE,8,17896103,"F-C",8,8,"Denver Nuggets","Jay Huff",0,0,0,0,0,0
0,0,0,0,0,0,0,0,0,"00",0,0,0,0,0,0,7049323,"2023-12-06T00:00:00.000Z",13,FALSE,8,56677582,"G",8,8,"Denver Nuggets","Jalen Pickett",0,0,0,0,0,0
0,0,0,0,0,0,0,0,0,"00",0,0,0,0,0,0,7049323,"2023-12-06T00:00:00.000Z",13,FALSE,8,56677871,"F",8,8,"Denver Nuggets","Hunter Tyson",0,0,0,0,0,0
3,0,1,3,1,4,1,0,0,"34",0,1,3,1,1,0,7049323,"2023-12-06T00:00:00.000Z",13,FALSE,8,81,"G",8,8,"Denver Nuggets","Kentavious Caldwell-Pope",1,4,7,6,4,11.7
6,1,0,7,2,18,10,1,1,"29",0,4,23,0,1,1,7049323,"2023-12-06T00:00:00.000Z",13,FALSE,8,335,"G",8,8,"Denver Nuggets","Jamal Murray",2,23,29,29,6,37
2,0,3,2,1,6,3,2,2,"24",2,1,9,5,0,1,7996352,"2023-12-07T00:00:00.000Z",14,FALSE,19,666860,"F-G",14,14,"Los Angeles Lakers","Cameron Reddish",0,14,16,11,7,17
8,0,5,4,4,12,9,8,8,"23",0,1,30,5,0,0,7996352,"2023-12-07T00:00:00.000Z",14,FALSE,19,237,"F",14,14,"Los Angeles Lakers","LeBron James",0,35,43,38,13,48
5,2,10,2,0,10,5,8,6,"31",5,1,16,15,2,2,7996352,"2023-12-07T00:00:00.000Z",14,FALSE,19,117,"F-C",14,14,"Los Angeles Lakers","Anthony Davis",4,31,36,21,20,51.5
1,0,3,8,5,9,5,0,0,"23",0,3,15,3,1,0,7996352,"2023-12-07T00:00:00.000Z",14,FALSE,19,383,"F",14,14,"Los Angeles Lakers","Taurean Prince",1,18,19,16,4,23.1
1,0,3,5,2,10,6,0,0,"22",0,1,14,3,1,4,7996352,"2023-12-07T00:00:00.000Z",14,FALSE,19,405,"G",14,14,"Los Angeles Lakers","D'Angelo Russell",1,17,18,15,4,18.1
0,0,2,1,0,5,3,2,0,"17",0,1,6,2,1,0,7996352,"2023-12-07T00:00:00.000Z",14,FALSE,19,38017697,"G",14,14,"Los Angeles Lakers","Max Christie",1,8,8,6,2,11.4
2,0,1,3,1,9,5,2,1,"21",0,3,12,1,0,0,7996352,"2023-12-07T00:00:00.000Z",14,FALSE,19,666609,"F",14,14,"Los Angeles Lakers","Rui Hachimura",0,13,15,14,3,16.2
0,0,4,1,0,3,2,1,0,"17",0,4,4,4,0,1,7996352,"2023-12-07T00:00:00.000Z",14,FALSE,19,666626,"C",14,14,"Los Angeles Lakers","Jaxson Hayes",0,8,8,4,4,7.8
1,1,3,0,0,3,0,2,1,"08",1,1,1,4,0,1,7996352,"2023-12-07T00:00:00.000Z",14,FALSE,19,56677835,"G",14,14,"Los Angeles Lakers","Jalen Hood-Schifino",1,5,6,2,5,9.3
1,0,1,2,1,4,1,0,0,"08",0,0,3,1,0,1,7996352,"2023-12-07T00:00:00.000Z",14,FALSE,19,56677836,"F",14,14,"Los Angeles Lakers","Maxwell Lewis",0,4,5,4,2,4.7
1,1,5,0,0,2,1,0,0,"15",0,0,2,5,0,0,7996352,"2023-12-07T00:00:00.000Z",14,FALSE,19,457,"F",14,14,"Los Angeles Lakers","Jarred Vanderbilt",1,7,8,3,6,12.5
7,0,5,6,3,9,5,4,4,"23",0,0,17,5,1,2,7996352,"2023-12-07T00:00:00.000Z",14,FALSE,19,17553995,"G",14,14,"Los Angeles Lakers","Austin Reaves",1,22,29,24,12,34.5
1,0,3,1,0,4,2,0,0,"08",3,0,4,6,0,2,7996352,"2023-12-07T00:00:00.000Z",14,FALSE,19,486,"F",14,14,"Los Angeles Lakers","Christian Wood",0,10,11,5,7,10.7
0,0,0,0,0,0,0,0,0,"00",0,0,0,0,0,0,7996352,"2023-12-07T00:00:00.000Z",14,FALSE,19,56677738,"C",14,14,"Los Angeles Lakers","Colin Castleton",0,0,0,0,0,0
0,0,0,0,0,0,0,0,0,"00",0,0,0,0,0,0,7996352,"2023-12-07T00:00:00.000Z",14,FALSE,19,56677867,"F",14,14,"Los Angeles Lakers","Alex Fudge",0,0,0,0,0,0
0,0,0,0,0,0,0,0,0,"00",0,0,0,0,0,0,7996352,"2023-12-07T00:00:00.000Z",14,FALSE,19,56677868,"G",14,14,"Los Angeles Lakers","D'Moi Hodge",0,0,0,0,0,0
0,0,0,0,0,0,0,0,0,"00",0,0,0,0,0,0,7996352,"2023-12-07T00:00:00.000Z",14,FALSE,19,1603383,"G",14,14,"Los Angeles Lakers","Gabe Vincent",0,0,0,0,0,0
7,0,2,3,0,13,4,2,1,"31",1,3,9,3,0,3,7996352,"2023-12-07T00:00:00.000Z",14,FALSE,19,227,"F",19,19,"New Orleans Pelicans","Brandon Ingram",0,12,19,16,10,20.1
3,0,1,0,0,8,6,6,1,"26",1,3,13,2,0,3,7996352,"2023-12-07T00:00:00.000Z",14,FALSE,19,666969,"F",19,19,"New Orleans Pelicans","Zion Williamson",0,15,18,16,5,16.9
2,3,3,4,1,9,3,2,2,"23",0,2,9,3,1,1,7996352,"2023-12-07T00:00:00.000Z",14,FALSE,19,455,"C",19,19,"New Orleans Pelicans","Jonas Valanciunas",4,12,14,11,5,26.6
1,1,3,3,0,10,4,2,2,"26",4,4,10,7,2,1,7996352,"2023-12-07T00:00:00.000Z",14,FALSE,19,17896024,"F",19,19,"New Orleans Pelicans","Herbert Jones",3,17,18,11,8,27.9
1,0,1,0,0,1,0,2,2,"12",1,2,2,2,0,0,7996352,"2023-12-07T00:00:00.000Z",14,FALSE,19,491,"C",19,19,"New Orleans Pelicans","Cody Zeller",0,4,5,3,3,5.9
0,0,0,0,0,0,0,0,0,"00",0,0,0,0,0,0,7996352,"2023-12-07T00:00:00.000Z",14,FALSE,19,38017663,"F",19,19,"New Orleans Pelicans","E.J. Liddell",0,0,0,0,0,0
0,0,0,0,0,0,0,0,0,"00",0,0,0,0,0,0,7996352,"2023-12-07T00:00:00.000Z",14,FALSE,19,340,"F",19,19,"New Orleans Pelicans","Larry Nance Jr.",0,0,0,0,0,0
0,0,0,0,0,0,0,0,0,"00",0,0,0,0,0,0,7996352,"2023-12-07T00:00:00.000Z",14,FALSE,19,17896017,"F",19,19,"New Orleans Pelicans","Matt Ryan",0,0,0,0,0,0
0,0,0,0,0,0,0,0,0,"00",0,0,0,0,0,0,7996352,"2023-12-07T00:00:00.000Z",14,FALSE,19,38017726,"G",19,19,"New Orleans Pelicans","Dereon Seabron",0,0,0,0,0,0
0,0,2,1,1,2,1,2,2,"12",2,1,5,4,0,1,7996352,"2023-12-07T00:00:00.000Z",14,FALSE,19,3547293,"F",19,19,"New Orleans Pelicans","Naji Marshall",0,9,9,5,4,8.8
1,0,3,7,2,13,5,2,2,"23",0,1,14,3,0,0,7996352,"2023-12-07T00:00:00.000Z",14,FALSE,19,18677986,"F",19,19,"New Orleans Pelicans","Trey Murphy III",0,17,18,15,4,19.1
4,0,2,3,2,7,3,0,0,"20",0,1,8,2,2,1,7996352,"2023-12-07T00:00:00.000Z",14,FALSE,19,17896097,"G",19,19,"New Orleans Pelicans","Jose Alvarado",2,10,14,12,6,21.4
0,1,6,2,0,5,1,2,2,"17",2,1,4,8,0,0,7996352,"2023-12-07T00:00:00.000Z",14,FALSE,19,38017677,"G",19,19,"New Orleans Pelicans","Dyson Daniels",1,12,12,4,8,16.6
0,0,2,3,0,8,2,0,0,"12",0,1,4,2,0,0,7996352,"2023-12-07T00:00:00.000Z",14,FALSE,19,56677837,"G",19,19,"New Orleans Pelicans","Jordan Hawkins",0,6,6,4,2,6.4
0,0,0,1,0,3,1,0,0,"07",0,0,2,0,0,1,7996352,"2023-12-07T00:00:00.000Z",14,FALSE,19,3547260,"G",19,19,"New Orleans Pelicans","Kira Lewis Jr.",0,2,2,2,0,1
1,0,2,0,0,2,0,0,0,"06",0,0,0,2,0,0,7996352,"2023-12-07T00:00:00.000Z",14,FALSE,19,17896021,"F",19,19,"New Orleans Pelicans","Jeremiah Robinson-Earl",0,2,3,1,3,3.9
2,0,3,4,1,14,4,0,0,"25",1,2,9,4,2,1,7996352,"2023-12-07T00:00:00.000Z",14,FALSE,19,303,"G",19,19,"New Orleans Pelicans","CJ McCollum",2,13,15,11,6,21.8
4,0,6,5,4,13,7,2,2,"30",1,2,20,7,2,4,7981414,"2023-12-07T00:00:00.000Z",17,FALSE,12,315,"F",17,17,"Milwaukee Bucks","Khris Middleton",2,27,31,24,11,36.4
2,2,9,1,0,19,13,13,11,"41",1,3,37,10,0,1,7981414,"2023-12-07T00:00:00.000Z",17,FALSE,12,15,"F",17,17,"Milwaukee Bucks","Giannis Antetokounmpo",2,47,49,39,12,57
2,4,4,10,3,17,7,3,1,"37",2,5,18,6,0,1,7981414,"2023-12-07T00:00:00.000Z",17,FALSE,12,283,"C",17,17,"Milwaukee Bucks","Brook Lopez",4,24,26,20,8,39.2
1,0,2,4,1,9,3,0,0,"36",1,2,7,3,0,0,7981414,"2023-12-07T00:00:00.000Z",17,FALSE,12,38,"G",17,17,"Milwaukee Bucks","Malik Beasley",0,10,11,8,4,12.1
7,1,7,9,4,20,7,6,6,"42",0,2,24,7,1,3,7981414,"2023-12-07T00:00:00.000Z",17,FALSE,12,278,"G",17,17,"Milwaukee Bucks","Damian Lillard",2,31,38,31,14,45.9
0,0,0,0,0,0,0,0,0,"00",0,0,0,0,0,0,7981414,"2023-12-07T00:00:00.000Z",17,FALSE,12,2148,"",17,17,"Milwaukee Bucks","Thanasis Antetokounmpo",0,0,0,0,0,0
0,1,3,0,0,3,2,4,1,"15",3,0,5,6,0,0,7981414,"2023-12-07T00:00:00.000Z",17,FALSE,12,38017676,"F",17,17,"Milwaukee Bucks","MarJon Beauchamp",1,11,11,5,6,15.2
0,0,0,0,0,1,0,0,0,"04",0,0,0,0,0,0,7981414,"2023-12-07T00:00:00.000Z",17,FALSE,12,38017733,"G",17,17,"Milwaukee Bucks","A.J. Green",0,0,0,0,0,0
0,0,0,0,0,0,0,0,0,"01",0,1,0,0,0,0,7981414,"2023-12-07T00:00:00.000Z",17,FALSE,12,56677852,"G",17,17,"Milwaukee Bucks","Andre Jackson Jr.",0,0,0,0,0,0
0,0,0,0,0,0,0,0,0,"00",0,0,0,0,0,0,7981414,"2023-12-07T00:00:00.000Z",17,FALSE,12,56677854,"F",17,17,"Milwaukee Bucks","Chris Livingston",0,0,0,0,0,0
0,0,0,0,0,0,0,0,0,"00",0,0,0,0,0,0,7981414,"2023-12-07T00:00:00.000Z",17,FALSE,12,284,"C",17,17,"Milwaukee Bucks","Robin Lopez",0,0,0,0,0,0
2,0,1,3,0,9,2,0,0,"16",0,0,4,1,0,2,7981414,"2023-12-07T00:00:00.000Z",17,FALSE,12,368,"G",17,17,"Milwaukee Bucks","Cameron Payne",0,5,7,6,3,6.2
1,1,2,1,0,5,2,0,0,"18",4,2,4,6,0,1,7981414,"2023-12-07T00:00:00.000Z",17,FALSE,12,377,"F",17,17,"Milwaukee Bucks","Bobby Portis",1,10,11,5,7,14.7
0,0,0,0,0,0,0,0,0,"00",0,0,0,0,0,0,7981414,"2023-12-07T00:00:00.000Z",17,FALSE,12,38017691,"G",17,17,"Milwaukee Bucks","TyTy Washington Jr.",0,0,0,0,0,0
0,0,0,0,0,0,0,0,0,"00",0,0,0,0,0,0,7981414,"2023-12-07T00:00:00.000Z",17,FALSE,12,666960,"G",17,17,"Milwaukee Bucks","Lindell Wigginton",0,0,0,0,0,0
0,0,0,0,0,0,0,0,0,"00",0,0,0,0,0,0,7981414,"2023-12-07T00:00:00.000Z",17,FALSE,12,666453,"C",17,17,"Milwaukee Bucks","Marques Bolden",0,0,0,0,0,0
0,0,0,0,0,0,0,0,0,"00",0,0,0,0,0,0,7981414,"2023-12-07T00:00:00.000Z",17,FALSE,12,105,"G",17,17,"Milwaukee Bucks","Pat Connaughton",0,0,0,0,0,0
0,0,0,0,0,0,0,0,0,"00",0,0,0,0,0,0,7981414,"2023-12-07T00:00:00.000Z",17,FALSE,12,112,"F",17,17,"Milwaukee Bucks","Jae Crowder",0,0,0,0,0,0
2,1,7,6,0,11,3,2,2,"30",4,3,8,11,2,2,7981414,"2023-12-07T00:00:00.000Z",17,FALSE,12,210,"G",12,12,"Indiana Pacers","Buddy Hield",3,19,21,10,13,31.2
15,1,4,9,3,19,11,2,2,"37",3,1,27,7,0,0,7981414,"2023-12-07T00:00:00.000Z",17,FALSE,12,3547245,"G",12,12,"Indiana Pacers","Tyrese Haliburton",1,34,49,42,22,60.9
1,1,4,2,0,12,3,3,3,"24",2,4,9,6,0,2,7981414,"2023-12-07T00:00:00.000Z",17,FALSE,12,38017686,"G-F",12,12,"Indiana Pacers","Bennedict Mathurin",1,15,16,10,7,18.7
2,1,0,0,0,5,4,0,0,"14",0,0,8,0,1,0,7981414,"2023-12-07T00:00:00.000Z",17,FALSE,12,38017507,"G-F",12,12,"Indiana Pacers","Andrew Nembhard",2,8,10,10,2,17
1,1,1,4,1,6,2,1,1,"27",0,5,6,1,0,0,7981414,"2023-12-07T00:00:00.000Z",17,FALSE,12,3547250,"G-F",12,12,"Indiana Pacers","Aaron Nesmith",1,7,8,7,2,11.7
2,0,3,3,1,8,6,2,1,"21",3,3,14,6,0,0,7981414,"2023-12-07T00:00:00.000Z",17,FALSE,12,3547243,"F",12,12,"Indiana Pacers","Obi Toppin",0,20,22,16,8,24.2
2,3,9,8,2,18,9,8,6,"32",1,2,26,10,1,0,7981414,"2023-12-07T00:00:00.000Z",17,FALSE,12,452,"C-F",12,12,"Indiana Pacers","Myles Turner",4,36,38,28,12,53
1,0,3,1,0,9,3,4,4,"28",0,2,10,3,1,1,7981414,"2023-12-07T00:00:00.000Z",17,FALSE,12,69,"G",12,12,"Indiana Pacers","Bruce Brown",1,13,14,11,4,17.1
0,0,5,0,0,7,5,1,1,"16",1,1,11,6,1,1,7981414,"2023-12-07T00:00:00.000Z",17,FALSE,12,17896035,"F",12,12,"Indiana Pacers","Isaiah Jackson",1,17,17,11,6,20.2
4,0,0,0,0,7,4,2,1,"11",1,0,9,1,3,3,7981414,"2023-12-07T00:00:00.000Z",17,FALSE,12,304,"G",12,12,"Indiana Pacers","T.J. McConnell",3,10,14,13,5,22.2
0,0,0,0,0,0,0,0,0,"00",0,0,0,0,0,0,7981414,"2023-12-07T00:00:00.000Z",17,FALSE,12,3547207,"F",12,12,"Indiana Pacers","Jordan Nwora",0,0,0,0,0,0
0,0,0,0,0,0,0,0,0,"00",0,0,0,0,0,0,7981414,"2023-12-07T00:00:00.000Z",17,FALSE,12,56677861,"G",12,12,"Indiana Pacers","Ben Sheppard",0,0,0,0,0,0
0,0,0,0,0,0,0,0,0,"00",0,0,0,0,0,0,7981414,"2023-12-07T00:00:00.000Z",17,FALSE,12,56677778,"F-C",12,12,"Indiana Pacers","Oscar Tshiebwe",0,0,0,0,0,0
0,0,0,0,0,0,0,0,0,"00",0,0,0,0,0,0,7981414,"2023-12-07T00:00:00.000Z",17,FALSE,12,56677832,"F",12,12,"Indiana Pacers","Jarace Walker",0,0,0,0,0,0
0,0,0,0,0,0,0,0,0,"00",0,0,0,0,0,0,7981414,"2023-12-07T00:00:00.000Z",17,FALSE,12,38017701,"G",12,12,"Indiana Pacers","Kendall Brown",0,0,0,0,0,0
0,0,0,0,0,0,0,0,0,"00",0,0,0,0,0,0,7981414,"2023-12-07T00:00:00.000Z",17,FALSE,12,3547264,"F-C",12,12,"Indiana Pacers","Jalen Smith",0,0,0,0,0,0
0,0,0,0,0,0,0,0,0,"00",0,0,0,0,0,0,7981414,"2023-12-07T00:00:00.000Z",17,FALSE,12,56677794,"G",12,12,"Indiana Pacers","Isaiah Wong",0,0,0,0,0,0
4,0,1,2,1,15,10,4,3,"35",3,1,24,4,1,3,7050282,"2023-12-08T00:00:00.000Z",4,FALSE,28,204,"F",4,4,"Charlotte Hornets","Gordon Hayward",1,28,32,28,8,34.8
3,0,8,6,3,15,8,3,3,"38",0,0,22,8,2,1,7050282,"2023-12-08T00:00:00.000Z",4,FALSE,28,62,"F",4,4,"Charlotte Hornets","Miles Bridges",2,30,33,25,11,41.1
1,2,1,0,0,4,2,0,0,"20",2,2,4,3,1,1,7050282,"2023-12-08T00:00:00.000Z",4,FALSE,28,38017698,"C",4,4,"Charlotte Hornets","Mark Williams",3,7,8,5,4,17.1
3,2,5,7,4,15,7,2,2,"35",0,1,20,5,0,4,7050282,"2023-12-08T00:00:00.000Z",4,FALSE,28,56677823,"F",4,4,"Charlotte Hornets","Brandon Miller",2,25,28,23,8,32.5
13,0,2,5,2,15,7,5,5,"40",0,5,21,2,0,2,7050282,"2023-12-08T00:00:00.000Z",4,FALSE,28,403,"G",4,4,"Charlotte Hornets","Terry Rozier",0,23,36,34,15,40.9
0,0,0,0,0,0,0,0,0,"00",0,0,0,0,0,0,7050282,"2023-12-08T00:00:00.000Z",4,FALSE,28,3547239,"G",4,4,"Charlotte Hornets","LaMelo Ball",0,0,0,0,0,0
0,0,0,0,0,0,0,0,0,"00",0,0,0,0,0,0,7050282,"2023-12-08T00:00:00.000Z",4,FALSE,28,56677866,"F",4,4,"Charlotte Hornets","Leaky Black",0,0,0,0,0,0
0,0,0,0,0,0,0,0,0,"00",0,0,0,0,0,0,7050282,"2023-12-08T00:00:00.000Z",4,FALSE,28,17896037,"G",4,4,"Charlotte Hornets","James Bouknight",0,0,0,0,0,0
0,0,0,0,0,0,0,0,0,"00",0,0,0,0,0,0,7050282,"2023-12-08T00:00:00.000Z",4,FALSE,28,3547253,"G",4,4,"Charlotte Hornets","Theo Maledon",0,0,0,0,0,0
0,0,0,0,0,0,0,0,0,"07",0,0,0,0,0,0,7050282,"2023-12-08T00:00:00.000Z",4,FALSE,28,38017708,"G",4,4,"Charlotte Hornets","Bryce McGowens",0,0,0,0,0,0
0,0,6,0,0,7,5,6,5,"26",2,2,15,8,1,1,7050282,"2023-12-08T00:00:00.000Z",4,FALSE,28,3547282,"C",4,4,"Charlotte Hornets","Nick Richards",1,23,23,15,8,26.6
4,0,0,0,0,1,1,0,0,"14",0,0,2,0,0,1,7050282,"2023-12-08T00:00:00.000Z",4,FALSE,28,422,"G",4,4,"Charlotte Hornets","Ish Smith",0,2,6,6,4,7
0,0,0,0,0,0,0,0,0,"00",0,0,0,0,0,0,7050282,"2023-12-08T00:00:00.000Z",4,FALSE,28,18678001,"F",4,4,"Charlotte Hornets","JT Thor",0,0,0,0,0,0
2,0,1,5,3,7,4,0,0,"25",0,4,11,1,2,2,7050282,"2023-12-08T00:00:00.000Z",4,FALSE,28,666950,"F",4,4,"Charlotte Hornets","P.J. Washington",2,12,14,13,3,19.2
0,0,0,0,0,0,0,0,0,"00",0,0,0,0,0,0,7050282,"2023-12-08T00:00:00.000Z",4,FALSE,28,56677848,"G",4,4,"Charlotte Hornets","Amari Bailey",0,0,0,0,0,0
0,0,0,0,0,0,0,0,0,"00",0,0,0,0,0,0,7050282,"2023-12-08T00:00:00.000Z",4,FALSE,28,666748,"F",4,4,"Charlotte Hornets","Cody Martin",0,0,0,0,0,0
0,0,0,0,0,0,0,0,0,"00",0,0,0,0,0,0,7050282,"2023-12-08T00:00:00.000Z",4,FALSE,28,347,"G",4,4,"Charlotte Hornets","Frank Ntilikina",0,0,0,0,0,0
0,0,0,0,0,0,0,0,0,"00",0,0,0,0,0,0,7050282,"2023-12-08T00:00:00.000Z",4,FALSE,28,56677846,"G",4,4,"Charlotte Hornets","Nick Smith Jr.",0,0,0,0,0,0
4,0,3,6,0,12,3,5,5,"36",0,3,11,3,1,0,7050282,"2023-12-08T00:00:00.000Z",4,FALSE,28,18,"F",28,28,"Toronto Raptors","OG Anunoby",1,14,18,15,7,23.6
4,0,4,1,0,15,11,4,3,"33",1,2,25,5,1,1,7050282,"2023-12-08T00:00:00.000Z",4,FALSE,28,416,"F",28,28,"Toronto Raptors","Pascal Siakam",1,30,34,29,9,39
1,0,4,0,0,4,4,0,0,"26",4,2,8,8,0,0,7050282,"2023-12-08T00:00:00.000Z",4,FALSE,28,373,"C",28,28,"Toronto Raptors","Jakob Poeltl",0,16,17,9,9,19.1
10,1,6,6,3,18,12,8,4,"36",4,1,31,10,2,5,7050282,"2023-12-08T00:00:00.000Z",4,FALSE,28,17896055,"G-F",28,28,"Toronto Raptors","Scottie Barnes",3,41,51,41,20,62
5,0,1,4,0,10,3,1,1,"30",0,4,7,1,1,2,7050282,"2023-12-08T00:00:00.000Z",4,FALSE,28,409,"G",28,28,"Toronto Raptors","Dennis Schroder",1,8,13,12,6,16.7
1,0,6,4,3,10,7,0,0,"22",4,4,17,10,0,4,7050282,"2023-12-08T00:00:00.000Z",4,FALSE,28,3547249,"F",28,28,"Toronto Raptors","Precious Achiuwa",0,27,28,18,11,26.5
0,1,2,3,0,9,4,1,1,"13",1,4,9,3,0,1,7050282,"2023-12-08T00:00:00.000Z",4,FALSE,28,58,"F",28,28,"Toronto Raptors","Chris Boucher",1,12,12,9,3,14.6
4,0,0,4,0,7,3,2,2,"18",0,1,8,0,2,1,7050282,"2023-12-08T00:00:00.000Z",4,FALSE,28,3547275,"G",28,28,"Toronto Raptors","Malachi Flynn",2,8,12,12,4,19
1,0,0,1,0,1,0,0,0,"06",0,0,0,0,0,0,7050282,"2023-12-08T00:00:00.000Z",4,FALSE,28,376,"F",28,28,"Toronto Raptors","Otto Porter Jr.",0,0,1,1,1,1.5
2,0,2,3,0,7,0,0,0,"20",0,0,0,2,0,0,7050282,"2023-12-08T00:00:00.000Z",4,FALSE,28,3089,"",28,28,"Toronto Raptors","Gary Trent Jr.",0,2,4,2,4,5.4
0,0,0,0,0,0,0,0,0,"00",0,0,0,0,0,0,7050282,"2023-12-08T00:00:00.000Z",4,FALSE,28,666762,"F",28,28,"Toronto Raptors","Jalen McDaniels",0,0,0,0,0,0
0,0,0,0,0,0,0,0,0,"00",0,0,0,0,0,0,7050282,"2023-12-08T00:00:00.000Z",4,FALSE,28,436,"G-F",28,28,"Toronto Raptors","Garrett Temple",0,0,0,0,0,0
0,0,0,0,0,0,0,0,0,"00",0,0,0,0,0,0,7050282,"2023-12-08T00:00:00.000Z",4,FALSE,28,489,"F",28,28,"Toronto Raptors","Thaddeus Young",0,0,0,0,0,0
0,0,0,0,0,0,0,0,0,"00",0,0,0,0,0,0,7050282,"2023-12-08T00:00:00.000Z",4,FALSE,28,56677828,"G",28,28,"Toronto Raptors","Gradey Dick",0,0,0,0,0,0
0,0,0,0,0,0,0,0,0,"00",0,0,0,0,0,0,7050282,"2023-12-08T00:00:00.000Z",4,FALSE,28,56677805,"G",28,28,"Toronto Raptors","Javon Freeman-Liberty",0,0,0,0,0,0
0,0,0,0,0,0,0,0,0,"00",0,0,0,0,0,0,7050282,"2023-12-08T00:00:00.000Z",4,FALSE,28,38017710,"C",28,28,"Toronto Raptors","Christian Koloko",0,0,0,0,0,0
0,0,0,0,0,0,0,0,0,"00",0,0,0,0,0,0,7050282,"2023-12-08T00:00:00.000Z",4,FALSE,28,56677869,"G",28,28,"Toronto Raptors","Markquis Nowell",0,0,0,0,0,0
0,2,7,6,3,12,8,1,1,"40",1,3,20,8,0,2,7050290,"2023-12-08T00:00:00.000Z",8,FALSE,11,375,"F",8,8,"Denver Nuggets","Michael Porter Jr.",2,28,28,20,8,33.6
3,0,5,2,0,5,1,5,1,"22",1,1,3,6,0,1,7050290,"2023-12-08T00:00:00.000Z",8,FALSE,11,177,"F",8,8,"Denver Nuggets","Aaron Gordon",0,9,12,6,9,13.7
5,2,9,2,1,26,9,7,4,"34",7,5,23,16,0,3,7050290,"2023-12-08T00:00:00.000Z",8,FALSE,11,246,"C",8,8,"Denver Nuggets","Nikola Jokic",2,39,44,28,21,52.7
0,1,0,3,2,6,5,2,2,"25",0,1,14,0,0,0,7050290,"2023-12-08T00:00:00.000Z",8,FALSE,11,81,"G",8,8,"Denver Nuggets","Kentavious Caldwell-Pope",1,14,14,14,0,17
3,0,5,8,4,17,6,5,5,"32",0,2,21,5,0,1,7050290,"2023-12-08T00:00:00.000Z",8,FALSE,11,335,"G",8,8,"Denver Nuggets","Jamal Murray",0,26,29,24,8,30.5
1,0,1,2,0,4,1,0,0,"14",0,3,2,1,2,1,7050290,"2023-12-08T00:00:00.000Z",8,FALSE,11,38017709,"G",8,8,"Denver Nuggets","Christian Braun",2,3,4,3,2,9.7
0,0,0,0,0,1,1,0,0,"06",0,1,2,0,1,0,7050290,"2023-12-08T00:00:00.000Z",8,FALSE,11,215,"F-G",8,8,"Denver Nuggets","Justin Holiday",1,2,2,2,0,5
6,0,2,4,0,8,2,2,2,"25",1,2,6,3,0,0,7050290,"2023-12-08T00:00:00.000Z",8,FALSE,11,236,"G",8,8,"Denver Nuggets","Reggie Jackson",0,9,15,12,9,18.6
2,0,3,0,0,2,1,0,0,"12",1,2,2,4,1,1,7050290,"2023-12-08T00:00:00.000Z",8,FALSE,11,250,"C",8,8,"Denver Nuggets","DeAndre Jordan",1,6,8,4,6,11.8
0,0,0,0,0,0,0,0,0,"00",0,0,0,0,0,0,7050290,"2023-12-08T00:00:00.000Z",8,FALSE,11,3547268,"F-C",8,8,"Denver Nuggets","Zeke Nnaji",0,0,0,0,0,0
0,0,0,0,0,0,0,0,0,"00",0,0,0,0,0,0,7050290,"2023-12-08T00:00:00.000Z",8,FALSE,11,56677582,"G",8,8,"Denver Nuggets","Jalen Pickett",0,0,0,0,0,0
0,0,0,0,0,0,0,0,0,"04",0,1,0,0,0,0,7050290,"2023-12-08T00:00:00.000Z",8,FALSE,11,56677776,"G",8,8,"Denver Nuggets","Julian Strawther",0,0,0,0,0,0
0,0,0,0,0,0,0,0,0,"00",0,0,0,0,0,0,7050290,"2023-12-08T00:00:00.000Z",8,FALSE,11,56677871,"F",8,8,"Denver Nuggets","Hunter Tyson",0,0,0,0,0,0
2,0,3,1,0,9,4,5,5,"26",1,3,13,4,0,1,7050290,"2023-12-08T00:00:00.000Z",8,FALSE,11,38017721,"G",8,8,"Denver Nuggets","Peyton Watson",0,17,19,15,6,19.8
0,0,0,0,0,0,0,0,0,"00",0,0,0,0,0,0,7050290,"2023-12-08T00:00:00.000Z",8,FALSE,11,666489,"F",8,8,"Denver Nuggets","Vlatko Cancar",0,0,0,0,0,0
0,0,0,0,0,0,0,0,0,"00",0,0,0,0,0,0,7050290,"2023-12-08T00:00:00.000Z",8,FALSE,11,38017727,"G",8,8,"Denver Nuggets","Collin Gillespie",0,0,0,0,0,0
0,0,0,0,0,0,0,0,0,"00",0,0,0,0,0,0,7050290,"2023-12-08T00:00:00.000Z",8,FALSE,11,56677809,"F",11,11,"Houston Rockets","Jermaine Samuels Jr.",0,0,0,0,0,0
0,0,0,0,0,0,0,0,0,"00",0,0,0,0,0,0,7050290,"2023-12-08T00:00:00.000Z",8,FALSE,11,56677825,"G-F",11,11,"Houston Rockets","Amen Thompson",0,0,0,0,0,0
0,0,0,0,0,0,0,0,0,"00",0,0,0,0,0,0,7050290,"2023-12-08T00:00:00.000Z",8,FALSE,11,56677831,"F",11,11,"Houston Rockets","Cam Whitmore",0,0,0,0,0,0
0,0,0,0,0,0,0,0,0,"00",0,0,0,0,0,0,7050290,"2023-12-08T00:00:00.000Z",8,FALSE,11,3547281,"G-F",11,11,"Houston Rockets","Nate Hinton",0,0,0,0,0,0
0,0,0,0,0,0,0,0,0,"00",0,0,0,0,0,0,7050290,"2023-12-08T00:00:00.000Z",8,FALSE,11,19465326,"C",11,11,"Houston Rockets","Jock Landale",0,0,0,0,0,0
0,0,0,0,0,0,0,0,0,"00",0,0,0,0,0,0,7050290,"2023-12-08T00:00:00.000Z",8,FALSE,11,357,"G",11,11,"Houston Rockets","Victor Oladipo",0,0,0,0,0,0
0,0,0,0,0,0,0,0,0,"00",0,0,0,0,0,0,7050290,"2023-12-08T00:00:00.000Z",8,FALSE,11,17896007,"G",8,8,"Denver Nuggets","Braxton Key",0,0,0,0,0,0
1,0,4,10,4,12,6,0,0,"33",1,5,16,5,2,3,7050290,"2023-12-08T00:00:00.000Z",8,FALSE,11,66,"G-F",11,11,"Houston Rockets","Dillon Brooks",2,21,22,17,6,26.5
5,0,6,2,0,9,3,4,3,"25",4,1,9,10,0,1,7050290,"2023-12-08T00:00:00.000Z",8,FALSE,11,38017684,"F",11,11,"Houston Rockets","Jabari Smith Jr.",0,19,24,14,15,27.5
7,1,8,1,0,14,7,5,3,"34",2,3,17,10,0,1,7050290,"2023-12-08T00:00:00.000Z",8,FALSE,11,17896062,"F-C",11,11,"Houston Rockets","Alperen Sengun",1,27,34,24,17,41.5
1,0,3,9,2,17,8,9,7,"35",0,0,25,3,0,1,7050290,"2023-12-08T00:00:00.000Z",8,FALSE,11,17895966,"G",11,11,"Houston Rockets","Jalen Green",0,28,29,26,4,29.1
3,1,3,10,4,17,6,13,10,"40",2,3,26,5,0,1,7050290,"2023-12-08T00:00:00.000Z",8,FALSE,11,458,"G",11,11,"Houston Rockets","Fred VanVleet",1,31,34,29,8,38.5
0,0,0,0,0,0,0,0,0,"00",0,0,0,0,0,0,7050290,"2023-12-08T00:00:00.000Z",8,FALSE,11,17896103,"F-C",8,8,"Denver Nuggets","Jay Huff",0,0,0,0,0,0
1,0,1,2,2,5,3,1,0,"16",0,1,8,1,0,2,7050290,"2023-12-08T00:00:00.000Z",8,FALSE,11,213,"G",11,11,"Houston Rockets","Aaron Holiday",0,9,10,9,2,8.7
1,1,2,1,0,1,0,6,5,"27",1,4,5,3,1,0,7050290,"2023-12-08T00:00:00.000Z",8,FALSE,11,188,"F",11,11,"Houston Rockets","Jeff Green",2,8,9,6,4,16.1
2,0,7,2,0,4,0,4,3,"17",1,1,3,8,0,0,7050290,"2023-12-08T00:00:00.000Z",8,FALSE,11,38017695,"F",11,11,"Houston Rockets","Tari Eason",0,11,13,5,10,15.6
0,0,2,2,1,3,2,0,0,"13",0,2,5,2,0,0,7050290,"2023-12-08T00:00:00.000Z",8,FALSE,11,3547301,"F",11,11,"Houston Rockets","Jae'Sean Tate",0,7,7,5,2,7.4
0,0,0,0,0,0,0,0,0,"00",0,0,0,0,0,0,7050290,"2023-12-08T00:00:00.000Z",8,FALSE,11,75,"G-F",11,11,"Houston Rockets","Reggie Bullock",0,0,0,0,0,0
0,0,0,0,0,0,0,0,0,"00",0,0,0,0,0,0,7050290,"2023-12-08T00:00:00.000Z",8,FALSE,11,296,"C",11,11,"Houston Rockets","Boban Marjanovic",0,0,0,0,0,0
0,0,0,0,0,0,0,0,0,"00",0,0,0,0,0,0,7050290,"2023-12-08T00:00:00.000Z",8,FALSE,11,47738533,"G",11,11,"Houston Rockets","Jeenathan Williams",0,0,0,0,0,0
0,0,2,5,2,8,3,2,0,"31",0,4,8,2,0,2,7050291,"2023-12-08T00:00:00.000Z",29,FALSE,13,38017739,"F",29,29,"Utah Jazz","Simone Fontecchio",0,10,10,8,2,8.4
2,4,10,5,1,12,7,5,5,"35",3,1,20,13,2,2,7050291,"2023-12-08T00:00:00.000Z",29,FALSE,13,101,"F-C",29,29,"Utah Jazz","John Collins",6,33,35,22,15,54.6
3,4,8,0,0,9,4,0,0,"31",4,2,8,12,2,2,7050291,"2023-12-08T00:00:00.000Z",29,FALSE,13,38017705,"C",29,29,"Utah Jazz","Walker Kessler",6,20,23,11,15,42.9
5,0,3,3,0,9,2,3,2,"28",1,2,6,4,1,1,7050291,"2023-12-08T00:00:00.000Z",29,FALSE,13,100,"G",29,29,"Utah Jazz","Jordan Clarkson",1,10,15,11,9,20.3
3,0,0,5,2,11,5,5,3,"28",0,1,15,0,1,1,7050291,"2023-12-08T00:00:00.000Z",29,FALSE,13,56677834,"G",29,29,"Utah Jazz","Keyonte George",1,15,18,18,3,21.5
0,0,1,2,1,4,2,0,0,"17",0,2,5,1,0,1,7050291,"2023-12-08T00:00:00.000Z",29,FALSE,13,38017620,"G",29,29,"Utah Jazz","Ochai Agbaji",0,6,6,5,1,5.2
0,0,0,0,0,0,0,0,0,"00",0,0,0,0,0,0,7050291,"2023-12-08T00:00:00.000Z",29,FALSE,13,139,"G",29,29,"Utah Jazz","Kris Dunn",0,0,0,0,0,0
0,0,0,2,0,3,0,0,0,"12",0,0,0,0,1,1,7050291,"2023-12-08T00:00:00.000Z",29,FALSE,13,56677824,"F",29,29,"Utah Jazz","Taylor Hendricks",1,0,0,0,0,2
5,1,1,4,1,11,6,3,2,"22",0,0,15,1,1,2,7050291,"2023-12-08T00:00:00.000Z",29,FALSE,13,666650,"G",29,29,"Utah Jazz","Talen Horton-Tucker",2,16,21,20,6,27.7
2,0,4,1,1,5,4,4,4,"18",0,3,13,4,1,0,7050291,"2023-12-08T00:00:00.000Z",29,FALSE,13,358,"F",29,29,"Utah Jazz","Kelly Olynyk",1,17,19,15,6,23.8
0,0,0,0,0,0,0,0,0,"00",0,0,0,0,0,0,7050291,"2023-12-08T00:00:00.000Z",29,FALSE,13,666881,"F",29,29,"Utah Jazz","Luka Samanic",0,0,0,0,0,0
3,0,3,4,1,12,5,2,2,"18",0,2,13,3,1,1,7050291,"2023-12-08T00:00:00.000Z",29,FALSE,13,413,"G",29,29,"Utah Jazz","Collin Sexton",1,16,19,16,6,23.1
0,0,0,0,0,0,0,0,0,"00",0,0,0,0,0,0,7050291,"2023-12-08T00:00:00.000Z",29,FALSE,13,11891374,"C",29,29,"Utah Jazz","Omer Yurtseven",0,0,0,0,0,0
0,0,0,0,0,0,0,0,0,"00",0,0,0,0,0,0,7050291,"2023-12-08T00:00:00.000Z",29,FALSE,13,17896023,"G",29,29,"Utah Jazz","Josh Christopher",0,0,0,0,0,0
0,0,0,0,0,0,0,0,0,"00",0,0,0,0,0,0,7050291,"2023-12-08T00:00:00.000Z",29,FALSE,13,38017630,"G",29,29,"Utah Jazz","Johnny Juzang",0,0,0,0,0,0
0,0,0,0,0,0,0,0,0,"00",0,0,0,0,0,0,7050291,"2023-12-08T00:00:00.000Z",29,FALSE,13,297,"F",29,29,"Utah Jazz","Lauri Markkanen",0,0,0,0,0,0
0,0,0,0,0,0,0,0,0,"00",0,0,0,0,0,0,7050291,"2023-12-08T00:00:00.000Z",29,FALSE,13,19465584,"F",29,29,"Utah Jazz","Micah Potter",0,0,0,0,0,0
0,0,0,0,0,0,0,0,0,"00",0,0,0,0,0,0,7050291,"2023-12-08T00:00:00.000Z",29,FALSE,13,56677842,"F",29,29,"Utah Jazz","Brice Sensabaugh",0,0,0,0,0,0
5,1,2,8,6,23,14,7,7,"38",3,1,41,5,0,2,7050291,"2023-12-08T00:00:00.000Z",29,FALSE,13,274,"F",13,13,"LA Clippers","Kawhi Leonard",1,46,51,46,10,55.5
2,1,3,5,2,13,8,3,2,"37",0,2,20,3,6,1,7050291,"2023-12-08T00:00:00.000Z",29,FALSE,13,172,"F",13,13,"LA Clippers","Paul George",7,23,25,22,5,46.6
3,2,7,0,0,15,9,0,0,"42",5,5,18,12,0,1,7050291,"2023-12-08T00:00:00.000Z",29,FALSE,13,493,"C",13,13,"LA Clippers","Ivica Zubac",2,30,33,21,15,41.9
1,1,3,5,2,9,4,2,0,"30",1,3,10,4,1,2,7050291,"2023-12-08T00:00:00.000Z",29,FALSE,13,666743,"G",13,13,"LA Clippers","Terance Mann",2,14,15,11,5,20.3
8,1,7,6,2,8,2,7,6,"34",0,2,12,7,0,2,7050291,"2023-12-08T00:00:00.000Z",29,FALSE,13,192,"G",13,13,"LA Clippers","James Harden",1,19,27,20,15,33.4
1,1,1,0,0,2,0,2,1,"14",2,3,1,3,0,0,7050291,"2023-12-08T00:00:00.000Z",29,FALSE,13,56677849,"F",13,13,"LA Clippers","Kobe Brown",1,4,5,2,4,9.1
0,0,0,0,0,0,0,0,0,"00",0,0,0,0,0,0,7050291,"2023-12-08T00:00:00.000Z",29,FALSE,13,666511,"G",13,13,"LA Clippers","Amir Coffey",0,0,0,0,0,0
0,0,0,0,0,0,0,0,0,"00",0,0,0,0,0,0,7050291,"2023-12-08T00:00:00.000Z",29,FALSE,13,17896031,"G",13,13,"LA Clippers","Nah'Shon Hyland",0,0,0,0,0,0
1,0,1,8,2,11,4,0,0,"28",0,0,10,1,0,1,7050291,"2023-12-08T00:00:00.000Z",29,FALSE,13,380,"F-G",13,13,"LA Clippers","Norman Powell",0,11,12,11,2,11.7
0,0,0,0,0,0,0,0,0,"00",0,0,0,0,0,0,7050291,"2023-12-08T00:00:00.000Z",29,FALSE,13,56677856,"G",13,13,"LA Clippers","Jordan Miller",0,0,0,0,0,0
0,0,0,0,0,0,0,0,0,"00",0,0,0,0,0,0,7050291,"2023-12-08T00:00:00.000Z",29,FALSE,13,24417679,"G",13,13,"LA Clippers","Xavier Moon",0,0,0,0,0,0
0,0,0,0,0,0,0,0,0,"00",0,0,0,0,0,0,7050291,"2023-12-08T00:00:00.000Z",29,FALSE,13,371,"F-C",13,13,"LA Clippers","Mason Plumlee",0,0,0,0,0,0
0,0,0,0,0,0,0,0,0,"00",0,0,0,0,0,0,7050291,"2023-12-08T00:00:00.000Z",29,FALSE,13,17896051,"G",13,13,"LA Clippers","Joshua Primo",0,0,0,0,0,0
0,0,0,0,0,0,0,0,0,"00",0,0,0,0,0,0,7050291,"2023-12-08T00:00:00.000Z",29,FALSE,13,439,"F",13,13,"LA Clippers","Daniel Theis",0,0,0,0,0,0
0,0,0,0,0,0,0,0,0,"00",0,0,0,0,0,0,7050291,"2023-12-08T00:00:00.000Z",29,FALSE,13,38017725,"F",13,13,"LA Clippers","Moussa Diabate",0,0,0,0,0,0
0,0,0,0,0,0,0,0,0,"00",0,0,0,0,0,0,7050291,"2023-12-08T00:00:00.000Z",29,FALSE,13,450,"F",13,13,"LA Clippers","PJ Tucker",0,0,0,0,0,0
2,2,5,2,1,7,2,0,0,"17",0,2,5,5,1,3,7050291,"2023-12-08T00:00:00.000Z",29,FALSE,13,472,"G",13,13,"LA Clippers","Russell Westbrook",3,10,12,7,7,20
0,0,0,0,0,0,0,0,0,"00",0,0,0,0,0,0,7050291,"2023-12-08T00:00:00.000Z",29,FALSE,13,17896022,"G",13,13,"LA Clippers","Brandon Boston Jr.",0,0,0,0,0,0
1,1,5,5,3,7,3,0,0,"36",3,0,9,8,3,2,7050292,"2023-12-08T00:00:00.000Z",25,FALSE,7,666923,"G-F",25,25,"Portland Trail Blazers","Matisse Thybulle",4,17,18,10,9,30.1
0,0,3,10,2,20,6,0,0,"32",6,5,14,9,1,0,7050292,"2023-12-08T00:00:00.000Z",25,FALSE,7,56677850,"F",25,25,"Portland Trail Blazers","Toumani Camara",1,23,23,14,9,27.8
1,0,4,6,2,9,4,0,0,"21",2,4,10,6,2,1,7050292,"2023-12-08T00:00:00.000Z",25,FALSE,7,56783340,"C",25,25,"Portland Trail Blazers","Duop Reath",2,16,17,11,7,23.7
5,0,7,10,5,15,7,6,5,"32",2,4,24,9,1,2,7050292,"2023-12-08T00:00:00.000Z",25,FALSE,7,38017690,"G",25,25,"Portland Trail Blazers","Shaedon Sharpe",1,33,38,29,14,43.3
8,0,3,10,4,21,10,6,6,"36",2,4,30,5,1,6,7050292,"2023-12-08T00:00:00.000Z",25,FALSE,7,419,"G",25,25,"Portland Trail Blazers","Anfernee Simons",1,35,43,38,13,45
0,0,0,0,0,0,0,0,0,"00",0,0,0,0,0,0,7050292,"2023-12-08T00:00:00.000Z",25,FALSE,7,39613724,"C",25,25,"Portland Trail Blazers","Ibou Badji",0,0,0,0,0,0
0,0,0,0,0,0,0,0,0,"00",0,0,0,0,0,0,7050292,"2023-12-08T00:00:00.000Z",25,FALSE,7,666476,"C",25,25,"Portland Trail Blazers","Moses Brown",0,0,0,0,0,0
3,0,2,6,0,17,4,3,2,"30",1,4,10,3,0,4,7050292,"2023-12-08T00:00:00.000Z",25,FALSE,7,56677747,"G",25,25,"Portland Trail Blazers","Scoot Henderson",0,13,16,13,6,14.1
0,0,0,0,0,0,0,0,0,"00",0,0,0,0,0,0,7050292,"2023-12-08T00:00:00.000Z",25,FALSE,7,3547289,"G",25,25,"Portland Trail Blazers","Skylar Mays",0,0,0,0,0,0
0,0,0,0,0,0,0,0,0,"08",0,1,0,0,0,0,7050292,"2023-12-08T00:00:00.000Z",25,FALSE,7,47957121,"F",25,25,"Portland Trail Blazers","Justin Minaya",0,0,0,0,0,0
0,0,4,3,1,6,2,0,0,"18",1,0,5,5,1,0,7050292,"2023-12-08T00:00:00.000Z",25,FALSE,7,56677791,"F",25,25,"Portland Trail Blazers","Kris Murray",1,10,10,5,5,14
0,0,0,0,0,0,0,0,0,"00",0,0,0,0,0,0,7050292,"2023-12-08T00:00:00.000Z",25,FALSE,7,56677829,"G-F",25,25,"Portland Trail Blazers","Rayan Rupert",0,0,0,0,0,0
2,0,2,3,1,10,3,3,3,"27",1,2,10,3,0,0,7050292,"2023-12-08T00:00:00.000Z",25,FALSE,7,38017711,"F",25,25,"Portland Trail Blazers","Jabari Walker",0,13,15,12,5,16.6
0,0,0,0,0,0,0,0,0,"00",0,0,0,0,0,0,7050292,"2023-12-08T00:00:00.000Z",25,FALSE,7,22,"C",25,25,"Portland Trail Blazers","Deandre Ayton",0,0,0,0,0,0
0,0,0,0,0,0,0,0,0,"00",0,0,0,0,0,0,7050292,"2023-12-08T00:00:00.000Z",25,FALSE,7,65,"G",25,25,"Portland Trail Blazers","Malcolm Brogdon",0,0,0,0,0,0
0,0,0,0,0,0,0,0,0,"00",0,0,0,0,0,0,7050292,"2023-12-08T00:00:00.000Z",25,FALSE,7,182,"F",25,25,"Portland Trail Blazers","Jerami Grant",0,0,0,0,0,0
0,0,0,0,0,0,0,0,0,"00",0,0,0,0,0,0,7050292,"2023-12-08T00:00:00.000Z",25,FALSE,7,17896120,"F",25,25,"Portland Trail Blazers","Ish Wainright",0,0,0,0,0,0
0,0,0,0,0,0,0,0,0,"00",0,0,0,0,0,0,7050292,"2023-12-08T00:00:00.000Z",25,FALSE,7,476,"C-F",25,25,"Portland Trail Blazers","Robert Williams III",0,0,0,0,0,0
3,0,1,0,0,2,1,2,2,"12",1,5,4,2,3,1,7050292,"2023-12-08T00:00:00.000Z",25,FALSE,7,379,"F-C",7,7,"Dallas Mavericks","Dwight Powell",3,6,9,7,5,18.9
0,0,1,1,0,1,0,0,0,"05",0,0,0,1,0,0,7050292,"2023-12-08T00:00:00.000Z",25,FALSE,7,56677859,"F",7,7,"Dallas Mavericks","Olivier-Maxence Prosper",0,1,1,0,1,1.2
0,0,0,0,0,0,0,0,0,"00",0,0,0,0,0,0,7050292,"2023-12-08T00:00:00.000Z",25,FALSE,7,17896028,"F",7,7,"Dallas Mavericks","Greg Brown III",0,0,0,0,0,0
0,0,0,0,0,0,0,0,0,"00",0,0,0,0,0,0,7050292,"2023-12-08T00:00:00.000Z",25,FALSE,7,56677873,"G",7,7,"Dallas Mavericks","Dexter Dennis",0,0,0,0,0,0
0,0,0,0,0,0,0,0,0,"00",0,0,0,0,0,0,7050292,"2023-12-08T00:00:00.000Z",25,FALSE,7,3547258,"G",7,7,"Dallas Mavericks","Josh Green",0,0,0,0,0,0
0,0,0,0,0,0,0,0,0,"00",0,0,0,0,0,0,7050292,"2023-12-08T00:00:00.000Z",25,FALSE,7,38017679,"G",7,7,"Dallas Mavericks","Jaden Hardy",0,0,0,0,0,0
0,0,0,0,0,0,0,0,0,"00",0,0,0,0,0,0,7050292,"2023-12-08T00:00:00.000Z",25,FALSE,7,217,"F-C",7,7,"Dallas Mavericks","Richaun Holmes",0,0,0,0,0,0
0,0,1,2,0,3,1,0,0,"07",0,1,2,1,0,0,7050292,"2023-12-08T00:00:00.000Z",25,FALSE,7,17554004,"G",7,7,"Dallas Mavericks","AJ Lawson",0,3,3,2,1,3.2
0,0,1,0,0,1,1,0,0,"07",0,1,2,1,0,3,7050292,"2023-12-08T00:00:00.000Z",25,FALSE,7,329,"F",7,7,"Dallas Mavericks","Markieff Morris",0,3,3,2,1,0.2
1,0,1,4,2,5,2,1,1,"18",1,1,7,2,0,1,7050292,"2023-12-08T00:00:00.000Z",25,FALSE,7,114,"G",7,7,"Dallas Mavericks","Seth Curry",0,9,10,8,3,9.9
0,0,0,0,0,0,0,0,0,"00",0,0,0,0,0,0,7050292,"2023-12-08T00:00:00.000Z",25,FALSE,7,666965,"F",7,7,"Dallas Mavericks","Grant Williams",0,0,0,0,0,0
0,0,0,0,0,0,0,0,0,"00",0,0,0,0,0,0,7050292,"2023-12-08T00:00:00.000Z",25,FALSE,7,257,"F",7,7,"Dallas Mavericks","Maxi Kleber",0,0,0,0,0,0
7,0,4,2,2,15,9,4,3,"33",2,3,23,6,0,1,7050292,"2023-12-08T00:00:00.000Z",25,FALSE,7,151,"G",7,7,"Dallas Mavericks","Dante Exum",0,29,36,30,13,39.7
1,2,4,7,1,12,6,2,1,"39",4,2,14,8,2,1,7050292,"2023-12-08T00:00:00.000Z",25,FALSE,7,247,"F-G",7,7,"Dallas Mavericks","Derrick Jones Jr.",4,22,23,15,9,36.1
2,2,8,0,0,6,5,0,0,"28",1,4,10,9,1,2,7050292,"2023-12-08T00:00:00.000Z",25,FALSE,7,56677840,"C",7,7,"Dallas Mavericks","Dereck Lively II",3,19,21,12,11,30.8
10,1,6,14,3,28,11,8,7,"41",0,1,32,6,1,5,7050292,"2023-12-08T00:00:00.000Z",25,FALSE,7,132,"F-G",7,7,"Dallas Mavericks","Luka Doncic",2,38,48,42,16,55.2
2,0,2,0,0,6,4,3,3,"13",0,1,11,2,1,0,7050292,"2023-12-08T00:00:00.000Z",25,FALSE,7,228,"G",7,7,"Dallas Mavericks","Kyrie Irving",1,13,15,13,4,19.4
0,0,4,9,4,12,7,2,2,"37",0,4,20,4,0,1,7050292,"2023-12-08T00:00:00.000Z",25,FALSE,7,191,"G",7,7,"Dallas Mavericks","Tim Hardaway Jr.",0,24,24,20,4,23.8
3,0,2,4,2,20,12,1,1,"31",0,0,27,2,0,0,7050283,"2023-12-08T00:00:00.000Z",22,FALSE,9,17896026,"F",22,22,"Orlando Magic","Franz Wagner",0,29,32,30,5,33.9
2,0,4,3,0,17,9,7,6,"30",0,3,24,4,2,0,7050283,"2023-12-08T00:00:00.000Z",22,FALSE,9,38017683,"F",22,22,"Orlando Magic","Paolo Banchero",2,28,30,26,6,37.8
2,4,4,0,0,7,6,1,1,"28",4,1,13,8,0,1,7050283,"2023-12-08T00:00:00.000Z",22,FALSE,9,666442,"C",22,22,"Orlando Magic","Goga Bitadze",4,21,23,15,10,36.6
1,0,3,5,2,8,4,1,1,"23",0,3,11,3,2,1,7050283,"2023-12-08T00:00:00.000Z",22,FALSE,9,196,"G",22,22,"Orlando Magic","Gary Harris",2,14,15,12,4,21.1
3,0,4,1,0,4,2,4,2,"25",1,2,6,5,0,1,7050283,"2023-12-08T00:00:00.000Z",22,FALSE,9,56677827,"G",22,22,"Orlando Magic","Anthony Black",0,11,14,9,8,15.5
6,0,3,3,1,12,6,3,3,"24",0,4,16,3,0,1,7050283,"2023-12-08T00:00:00.000Z",22,FALSE,9,3547251,"G",22,22,"Orlando Magic","Cole Anthony",0,19,25,22,9,27.6
1,0,4,6,2,6,2,0,0,"25",0,1,6,4,0,0,7050283,"2023-12-08T00:00:00.000Z",22,FALSE,9,38017724,"G",22,22,"Orlando Magic","Caleb Houstan",0,10,11,7,5,12.3
1,0,1,1,1,2,2,2,1,"05",0,1,6,1,0,0,7050283,"2023-12-08T00:00:00.000Z",22,FALSE,9,56677839,"G",22,22,"Orlando Magic","Jett Howard",0,7,8,7,2,8.7
5,0,4,3,2,6,2,0,0,"16",0,1,6,4,0,0,7050283,"2023-12-08T00:00:00.000Z",22,FALSE,9,226,"F",22,22,"Orlando Magic","Joe Ingles",0,10,15,11,9,18.3
0,0,3,0,0,7,4,2,1,"23",2,1,9,5,0,4,7050283,"2023-12-08T00:00:00.000Z",22,FALSE,9,24,"F",9,9,"Detroit Pistons","Marvin Bagley III",0,14,14,9,5,11
4,1,6,2,0,11,7,3,2,"32",1,1,16,7,0,2,7050283,"2023-12-08T00:00:00.000Z",22,FALSE,9,3547241,"G",9,9,"Detroit Pistons","Killian Hayes",1,23,27,20,11,31.4
6,0,2,6,2,15,8,4,3,"32",0,1,21,2,1,3,7050283,"2023-12-08T00:00:00.000Z",22,FALSE,9,17896075,"G-F",9,9,"Detroit Pistons","Cade Cunningham",1,23,29,27,8,32.4
0,0,2,3,2,7,4,4,4,"12",1,1,14,3,0,1,7050283,"2023-12-08T00:00:00.000Z",22,FALSE,9,77,"G",9,9,"Detroit Pistons","Alec Burks",0,17,17,14,3,16.6
0,1,0,0,0,1,0,0,0,"04",0,0,0,0,0,0,7050283,"2023-12-08T00:00:00.000Z",22,FALSE,9,197,"F-G",9,9,"Detroit Pistons","Joe Harris",1,0,0,0,0,3
0,0,2,4,0,7,2,4,4,"21",0,2,8,2,0,0,7050283,"2023-12-08T00:00:00.000Z",22,FALSE,9,38017682,"G",9,9,"Detroit Pistons","Jaden Ivey",0,10,10,8,2,10.4
0,0,1,0,0,0,0,0,0,"05",0,0,0,1,0,1,7050283,"2023-12-08T00:00:00.000Z",22,FALSE,9,259,"F",9,9,"Detroit Pistons","Kevin Knox",0,1,1,0,1,0.2
0,0,0,0,0,0,0,0,0,"00",0,0,0,0,0,0,7050283,"2023-12-08T00:00:00.000Z",22,FALSE,9,17896073,"G",22,22,"Orlando Magic","Jalen Suggs",0,0,0,0,0,0
1,0,3,3,1,10,4,1,0,"29",0,1,9,3,1,2,7050283,"2023-12-08T00:00:00.000Z",22,FALSE,9,54,"F",9,9,"Detroit Pistons","Bojan Bogdanovic",1,12,13,10,4,15.1
3,1,6,3,1,3,1,0,0,"29",1,3,3,7,0,1,7050283,"2023-12-08T00:00:00.000Z",22,FALSE,9,3547267,"F-C",9,9,"Detroit Pistons","Isaiah Stewart",1,10,13,6,10,17.9
0,0,4,0,0,1,1,0,0,"13",0,0,2,4,1,1,7050283,"2023-12-08T00:00:00.000Z",22,FALSE,9,666818,"F",22,22,"Orlando Magic","Chuma Okeke",1,6,6,2,4,8.8
0,0,2,0,0,2,1,0,0,"04",0,3,2,2,0,2,7050283,"2023-12-08T00:00:00.000Z",22,FALSE,9,666885,"F",22,22,"Orlando Magic","Admiral Schofield",0,4,4,2,2,2.4
2,0,4,0,0,4,2,0,0,"16",1,1,4,5,0,2,7050283,"2023-12-08T00:00:00.000Z",22,FALSE,9,462,"C",22,22,"Orlando Magic","Moritz Wagner",0,9,11,6,7,11
0,0,0,0,0,0,0,0,0,"00",0,0,0,0,0,0,7050283,"2023-12-08T00:00:00.000Z",22,FALSE,9,85,"F",22,22,"Orlando Magic","Wendell Carter Jr.",0,0,0,0,0,0
0,0,0,0,0,0,0,0,0,"00",0,0,0,0,0,0,7050283,"2023-12-08T00:00:00.000Z",22,FALSE,9,165,"G",22,22,"Orlando Magic","Markelle Fultz",0,0,0,0,0,0
0,0,0,0,0,0,0,0,0,"00",0,0,0,0,0,0,7050283,"2023-12-08T00:00:00.000Z",22,FALSE,9,38017607,"G",22,22,"Orlando Magic","Kevon Harris",0,0,0,0,0,0
0,0,0,0,0,0,0,0,0,"00",0,0,0,0,0,0,7050283,"2023-12-08T00:00:00.000Z",22,FALSE,9,229,"F",22,22,"Orlando Magic","Jonathan Isaac",0,0,0,0,0,0
0,0,0,0,0,0,0,0,0,"00",0,0,0,0,0,0,7050283,"2023-12-08T00:00:00.000Z",22,FALSE,9,17553983,"G",22,22,"Orlando Magic","Trevelin Queen",0,0,0,0,0,0
2,0,1,5,0,12,2,2,1,"20",1,3,5,2,1,0,7050283,"2023-12-08T00:00:00.000Z",22,FALSE,9,56677826,"G-F",9,9,"Detroit Pistons","Ausar Thompson",1,7,9,7,4,13.4
0,0,3,0,0,0,0,4,2,"16",2,2,2,5,0,1,7050283,"2023-12-08T00:00:00.000Z",22,FALSE,9,3547240,"C",9,9,"Detroit Pistons","James Wiseman",0,7,7,2,5,7
1,0,1,3,0,5,0,0,0,"12",0,2,0,1,0,0,7050283,"2023-12-08T00:00:00.000Z",22,FALSE,9,17896071,"F",9,9,"Detroit Pistons","Isaiah Livers",0,1,2,1,2,2.7
1,0,0,1,0,3,2,0,0,"05",0,0,4,0,0,0,7050283,"2023-12-08T00:00:00.000Z",22,FALSE,9,56677792,"G",9,9,"Detroit Pistons","Marcus Sasser",0,4,5,5,1,5.5
0,0,0,0,0,0,0,0,0,"00",0,0,0,0,0,0,7050283,"2023-12-08T00:00:00.000Z",22,FALSE,9,56677729,"G",9,9,"Detroit Pistons","Malcolm Cazalon",0,0,0,0,0,0
0,0,0,0,0,0,0,0,0,"00",0,0,0,0,0,0,7050283,"2023-12-08T00:00:00.000Z",22,FALSE,9,38017694,"C",9,9,"Detroit Pistons","Jalen Duren",0,0,0,0,0,0
0,0,0,0,0,0,0,0,0,"00",0,0,0,0,0,0,7050283,"2023-12-08T00:00:00.000Z",22,FALSE,9,330,"G",9,9,"Detroit Pistons","Monte Morris",0,0,0,0,0,0
0,0,0,0,0,0,0,0,0,"00",0,0,0,0,0,0,7050283,"2023-12-08T00:00:00.000Z",22,FALSE,9,42097199,"G",9,9,"Detroit Pistons","Jared Rhoden",0,0,0,0,0,0
0,0,0,0,0,0,0,0,0,"00",0,0,0,0,0,0,7050283,"2023-12-08T00:00:00.000Z",22,FALSE,9,44477024,"G",9,9,"Detroit Pistons","Stanley Umude",0,0,0,0,0,0
4,0,2,3,2,4,3,0,0,"29",2,1,8,4,0,0,7050284,"2023-12-08T00:00:00.000Z",23,FALSE,1,33,"F-G",23,23,"Philadelphia 76ers","Nicolas Batum",0,12,16,12,8,18.8
2,0,6,1,0,9,5,3,3,"34",2,3,13,8,1,2,7050284,"2023-12-08T00:00:00.000Z",23,FALSE,1,200,"F",23,23,"Philadelphia 76ers","Tobias Harris",1,21,23,15,10,26.6
3,4,10,3,1,24,12,15,13,"36",4,1,38,14,1,2,7050284,"2023-12-08T00:00:00.000Z",23,FALSE,1,145,"F-C",23,23,"Philadelphia 76ers","Joel Embiid",5,52,55,41,17,72.3
5,1,6,7,2,13,6,2,1,"34",0,0,15,6,1,1,7050284,"2023-12-08T00:00:00.000Z",23,FALSE,1,313,"G",23,23,"Philadelphia 76ers","De'Anthony Melton",2,21,26,20,11,34.7
7,1,2,8,4,18,8,12,10,"39",0,3,30,2,1,0,7050284,"2023-12-08T00:00:00.000Z",23,FALSE,1,3547254,"G",23,23,"Philadelphia 76ers","Tyrese Maxey",2,32,39,37,9,48.9
0,0,2,0,0,1,0,0,0,"05",1,1,0,3,0,1,7050284,"2023-12-08T00:00:00.000Z",23,FALSE,1,28,"C",23,23,"Philadelphia 76ers","Mo Bamba",0,3,3,0,3,2.6
1,0,0,3,0,6,2,1,1,"18",1,0,5,1,0,1,7050284,"2023-12-08T00:00:00.000Z",23,FALSE,1,45,"G",23,23,"Philadelphia 76ers","Patrick Beverley",0,6,7,6,2,6.7
0,0,0,0,0,0,0,0,0,"00",0,0,0,0,0,0,7050284,"2023-12-08T00:00:00.000Z",23,FALSE,1,108,"F",23,23,"Philadelphia 76ers","Robert Covington",0,0,0,0,0,0
0,0,0,0,0,0,0,0,0,"00",0,0,0,0,0,0,7050284,"2023-12-08T00:00:00.000Z",23,FALSE,1,2175,"",23,23,"Philadelphia 76ers","Danuel House Jr.",0,0,0,0,0,0
0,0,0,0,0,0,0,0,0,"00",0,0,0,0,0,0,7050284,"2023-12-08T00:00:00.000Z",23,FALSE,1,260,"G-F",23,23,"Philadelphia 76ers","Furkan Korkmaz",0,0,0,0,0,0
0,0,0,0,0,0,0,0,0,"00",0,0,0,0,0,0,7050284,"2023-12-08T00:00:00.000Z",23,FALSE,1,3547294,"F",23,23,"Philadelphia 76ers","Kenyon Martin Jr.",0,0,0,0,0,0
1,1,3,1,1,1,1,0,0,"16",0,3,3,3,0,0,7050284,"2023-12-08T00:00:00.000Z",23,FALSE,1,328,"F",23,23,"Philadelphia 76ers","Marcus Morris",1,6,7,4,4,11.1
1,1,1,4,1,9,4,4,2,"23",2,1,11,3,2,0,7050284,"2023-12-08T00:00:00.000Z",23,FALSE,1,360,"F",23,23,"Philadelphia 76ers","Kelly Oubre Jr.",3,14,15,12,4,25.1
0,0,2,0,0,2,1,0,0,"06",2,1,2,4,0,3,7050284,"2023-12-08T00:00:00.000Z",23,FALSE,1,3547270,"F",23,23,"Philadelphia 76ers","Paul Reed",0,6,6,2,4,3.8
0,0,0,0,0,0,0,0,0,"00",0,0,0,0,0,0,7050284,"2023-12-08T00:00:00.000Z",23,FALSE,1,17896025,"G",23,23,"Philadelphia 76ers","Jaden Springer",0,0,0,0,0,0
0,0,0,0,0,0,0,0,0,"00",0,0,0,0,0,0,7050284,"2023-12-08T00:00:00.000Z",23,FALSE,1,56913527,"G",23,23,"Philadelphia 76ers","Ricky Council IV",0,0,0,0,0,0
0,0,0,0,0,0,0,0,0,"00",0,0,0,0,0,0,7050284,"2023-12-08T00:00:00.000Z",23,FALSE,1,17554001,"G",23,23,"Philadelphia 76ers","Javonte Smart",0,0,0,0,0,0
0,0,0,0,0,0,0,0,0,"00",0,0,0,0,0,0,7050284,"2023-12-08T00:00:00.000Z",23,FALSE,1,56677788,"G",23,23,"Philadelphia 76ers","Terquavion Smith",0,0,0,0,0,0
1,0,6,7,4,18,9,2,2,"37",1,2,24,7,0,3,7050284,"2023-12-08T00:00:00.000Z",23,FALSE,1,666656,"F",1,1,"Atlanta Hawks","De'Andre Hunter",0,31,32,25,8,30.9
1,0,3,9,3,20,6,1,1,"38",5,1,16,8,0,0,7050284,"2023-12-08T00:00:00.000Z",23,FALSE,1,3547256,"F",1,1,"Atlanta Hawks","Saddiq Bey",0,24,25,17,9,27.1
2,1,6,0,0,12,6,4,3,"30",10,5,15,16,0,2,7050284,"2023-12-08T00:00:00.000Z",23,FALSE,1,83,"C",1,1,"Atlanta Hawks","Clint Capela",1,31,33,17,18,38.2
2,0,8,11,3,17,7,3,3,"39",1,5,20,9,1,2,7050284,"2023-12-08T00:00:00.000Z",23,FALSE,1,53,"G",1,1,"Atlanta Hawks","Bogdan Bogdanovic",1,29,31,22,11,34.8
9,0,3,5,2,17,7,4,4,"36",1,1,20,4,1,4,7050284,"2023-12-08T00:00:00.000Z",23,FALSE,1,334,"G",1,1,"Atlanta Hawks","Dejounte Murray",1,24,33,29,13,37.3
0,0,0,0,0,0,0,0,0,"00",0,0,0,0,0,0,7050284,"2023-12-08T00:00:00.000Z",23,FALSE,1,666564,"F",1,1,"Atlanta Hawks","Bruno Fernando",0,0,0,0,0,0
1,0,0,0,0,5,2,2,2,"12",1,2,6,1,0,1,7050284,"2023-12-08T00:00:00.000Z",23,FALSE,1,3547297,"G",1,1,"Atlanta Hawks","Trent Forrest",0,7,8,7,2,7.7
0,0,0,0,0,0,0,0,0,"00",0,0,0,0,0,0,7050284,"2023-12-08T00:00:00.000Z",23,FALSE,1,38017689,"F",1,1,"Atlanta Hawks","AJ Griffin",0,0,0,0,0,0
0,0,1,1,0,1,0,0,0,"03",0,0,0,1,0,0,7050284,"2023-12-08T00:00:00.000Z",23,FALSE,1,666754,"G",1,1,"Atlanta Hawks","Garrison Mathews",0,1,1,0,1,1.2
0,0,0,1,0,3,0,3,3,"10",0,0,3,0,0,0,7050284,"2023-12-08T00:00:00.000Z",23,FALSE,1,301,"G-F",1,1,"Atlanta Hawks","Wesley Matthews",0,3,3,3,0,3
2,1,1,3,1,4,1,0,0,"17",0,2,3,1,1,1,7050284,"2023-12-08T00:00:00.000Z",23,FALSE,1,319,"G",1,1,"Atlanta Hawks","Patty Mills",2,4,6,5,3,12.2
2,2,4,2,0,7,3,2,1,"18",4,5,7,8,0,0,7050284,"2023-12-08T00:00:00.000Z",23,FALSE,1,3547244,"F-C",1,1,"Atlanta Hawks","Onyeka Okongwu",2,15,17,9,10,25.6
0,0,0,0,0,0,0,0,0,"00",0,0,0,0,0,0,7050284,"2023-12-08T00:00:00.000Z",23,FALSE,1,56677838,"G",1,1,"Atlanta Hawks","Kobe Bufkin",0,0,0,0,0,0
0,0,0,0,0,0,0,0,0,"00",0,0,0,0,0,0,7050284,"2023-12-08T00:00:00.000Z",23,FALSE,1,56677806,"F",1,1,"Atlanta Hawks","Mouhamed Gueye",0,0,0,0,0,0
0,0,0,0,0,0,0,0,0,"00",0,0,0,0,0,0,7050284,"2023-12-08T00:00:00.000Z",23,FALSE,1,17896040,"F",1,1,"Atlanta Hawks","Jalen Johnson",0,0,0,0,0,0
0,0,0,0,0,0,0,0,0,"00",0,0,0,0,0,0,7050284,"2023-12-08T00:00:00.000Z",23,FALSE,1,56677855,"G",1,1,"Atlanta Hawks","Seth Lundy",0,0,0,0,0,0
0,0,0,0,0,0,0,0,0,"00",0,0,0,0,0,0,7050284,"2023-12-08T00:00:00.000Z",23,FALSE,1,56677875,"F",1,1,"Atlanta Hawks","Miles Norris",0,0,0,0,0,0
0,0,0,0,0,0,0,0,0,"00",0,0,0,0,0,0,7050284,"2023-12-08T00:00:00.000Z",23,FALSE,1,490,"G",1,1,"Atlanta Hawks","Trae Young",0,0,0,0,0,0
3,2,3,3,2,15,9,1,1,"31",1,0,21,4,0,2,7050285,"2023-12-08T00:00:00.000Z",3,FALSE,30,61,"F",3,3,"Brooklyn Nets","Mikal Bridges",2,25,28,24,7,34.3
0,0,3,5,1,8,3,0,0,"25",2,3,7,5,0,1,7050285,"2023-12-08T00:00:00.000Z",3,FALSE,30,666679,"F",3,3,"Brooklyn Nets","Cameron Johnson",0,12,12,7,5,12
0,2,11,0,0,8,6,2,1,"26",4,3,13,15,0,1,7050285,"2023-12-08T00:00:00.000Z",3,FALSE,30,666508,"F-C",3,3,"Brooklyn Nets","Nicolas Claxton",2,28,28,13,15,36
4,1,2,4,2,19,7,2,1,"29",0,3,17,2,1,2,7050285,"2023-12-08T00:00:00.000Z",3,FALSE,30,17896048,"G",3,3,"Brooklyn Nets","Cam Thomas",2,19,23,21,6,29.4
9,0,3,6,1,15,6,1,1,"33",0,3,14,3,4,2,7050285,"2023-12-08T00:00:00.000Z",3,FALSE,30,130,"G",3,3,"Brooklyn Nets","Spencer Dinwiddie",4,17,26,23,12,41.1
0,0,1,4,1,5,2,3,3,"26",2,0,8,3,1,0,7050285,"2023-12-08T00:00:00.000Z",3,FALSE,30,158,"F",3,3,"Brooklyn Nets","Dorian Finney-Smith",1,11,11,8,3,14.6
0,2,0,1,0,6,4,2,0,"05",2,0,8,2,0,0,7050285,"2023-12-08T00:00:00.000Z",3,FALSE,30,174,"F-C",3,3,"Brooklyn Nets","Harry Giles III",2,10,10,8,2,16.4
5,1,6,9,3,10,4,2,2,"26",2,1,13,8,0,0,7050285,"2023-12-08T00:00:00.000Z",3,FALSE,30,351,"F",3,3,"Brooklyn Nets","Royce O'Neale",1,21,26,18,13,33.1
4,1,6,0,0,13,7,1,1,"20",5,3,15,11,1,1,7050285,"2023-12-08T00:00:00.000Z",3,FALSE,30,17896038,"C",3,3,"Brooklyn Nets","Day'Ron Sharpe",2,26,30,19,15,39.2
0,0,0,0,0,0,0,0,0,"00",0,0,0,0,0,0,7050285,"2023-12-08T00:00:00.000Z",3,FALSE,30,421,"G",3,3,"Brooklyn Nets","Dennis Smith Jr.",0,0,0,0,0,0
3,1,2,1,0,10,6,2,2,"28",0,0,14,2,1,1,7050285,"2023-12-08T00:00:00.000Z",3,FALSE,30,249,"G",30,30,"Washington Wizards","Tyus Jones",2,16,19,17,5,25.9
0,0,2,0,0,3,0,0,0,"04",2,1,0,4,0,0,7050285,"2023-12-08T00:00:00.000Z",3,FALSE,30,38017704,"F",30,30,"Washington Wizards","Patrick Baldwin Jr.",0,4,4,0,4,4.8
1,0,0,1,0,1,0,0,0,"04",0,0,0,0,0,0,7050285,"2023-12-08T00:00:00.000Z",3,FALSE,30,NA,NA,NA,30,"Washington Wizards","NA NA",0,0,1,1,1,1.5
0,0,3,2,0,4,1,4,3,"14",0,1,5,3,0,3,7050285,"2023-12-08T00:00:00.000Z",3,FALSE,30,18677954,"G",30,30,"Washington Wizards","Jared Butler",0,8,8,5,3,5.6
2,0,6,2,1,6,4,4,2,"25",4,3,11,10,0,2,7050285,"2023-12-08T00:00:00.000Z",3,FALSE,30,56677844,"G",30,30,"Washington Wizards","Bilal Coulibaly",0,21,23,13,12,24
1,0,2,5,0,9,2,0,0,"19",0,3,4,2,0,0,7050285,"2023-12-08T00:00:00.000Z",3,FALSE,30,167,"F",30,30,"Washington Wizards","Danilo Gallinari",0,6,7,5,3,7.9
0,0,0,1,0,4,1,0,0,"04",3,1,2,3,0,0,7050285,"2023-12-08T00:00:00.000Z",3,FALSE,30,3547302,"F",30,30,"Washington Wizards","Anthony Gill",0,5,5,2,3,5.6
2,1,2,7,1,11,3,0,0,"21",0,2,7,2,0,0,7050285,"2023-12-08T00:00:00.000Z",3,FALSE,30,17896045,"F",30,30,"Washington Wizards","Corey Kispert",1,9,11,9,4,15.4
0,0,0,3,2,3,2,2,2,"15",0,1,8,0,1,1,7050285,"2023-12-08T00:00:00.000Z",3,FALSE,30,337,"F-C",30,30,"Washington Wizards","Mike Muscala",1,8,8,8,0,10
0,1,1,1,0,2,1,1,1,"04",0,0,3,1,0,1,7050285,"2023-12-08T00:00:00.000Z",3,FALSE,30,17896106,"F",30,30,"Washington Wizards","Eugene Omoruyi",1,4,4,3,1,6.2
0,0,0,0,0,0,0,0,0,"00",0,0,0,0,0,0,7050285,"2023-12-08T00:00:00.000Z",3,FALSE,30,38017687,"G",30,30,"Washington Wizards","Johnny Davis",0,0,0,0,0,0
0,0,0,0,0,0,0,0,0,"00",0,0,0,0,0,0,7050285,"2023-12-08T00:00:00.000Z",3,FALSE,30,38017712,"G",30,30,"Washington Wizards","Ryan Rollins",0,0,0,0,0,0
0,0,0,0,0,0,0,0,0,"00",0,0,0,0,0,0,7050285,"2023-12-08T00:00:00.000Z",3,FALSE,30,414,"G",30,30,"Washington Wizards","Landry Shamet",0,0,0,0,0,0
0,0,0,0,0,0,0,0,0,"00",0,0,0,0,0,0,7050285,"2023-12-08T00:00:00.000Z",3,FALSE,30,487,"G",30,30,"Washington Wizards","Delon Wright",0,0,0,0,0,0
0,0,0,0,0,0,0,0,0,"00",0,0,0,0,0,0,7050285,"2023-12-08T00:00:00.000Z",3,FALSE,30,9051997,"G",3,3,"Brooklyn Nets","Armoni Brooks",0,0,0,0,0,0
0,0,0,0,0,0,0,0,0,"00",0,0,0,0,0,0,7050285,"2023-12-08T00:00:00.000Z",3,FALSE,30,56677843,"F",3,3,"Brooklyn Nets","Noah Clowney",0,0,0,0,0,0
0,0,0,0,0,0,0,0,0,"00",0,0,0,0,0,0,7050285,"2023-12-08T00:00:00.000Z",3,FALSE,30,17896041,"G",3,3,"Brooklyn Nets","Keon Johnson",0,0,0,0,0,0
0,0,0,0,0,0,0,0,0,"00",0,0,0,0,0,0,7050285,"2023-12-08T00:00:00.000Z",3,FALSE,30,417,"G-F",3,3,"Brooklyn Nets","Ben Simmons",0,0,0,0,0,0
0,0,0,0,0,0,0,0,0,"00",0,0,0,0,0,0,7050285,"2023-12-08T00:00:00.000Z",3,FALSE,30,56677841,"F",3,3,"Brooklyn Nets","Dariq Whitehead",0,0,0,0,0,0
0,0,0,0,0,0,0,0,0,"00",0,0,0,0,0,0,7050285,"2023-12-08T00:00:00.000Z",3,FALSE,30,56677722,"F",3,3,"Brooklyn Nets","Jalen Wilson",0,0,0,0,0,0
4,2,7,4,1,9,6,3,2,"27",0,1,15,7,1,0,7050285,"2023-12-08T00:00:00.000Z",3,FALSE,30,3547242,"F",30,30,"Washington Wizards","Deni Avdija",3,22,26,19,11,38.4
0,0,0,0,0,0,0,0,0,"00",0,0,0,0,0,0,7050285,"2023-12-08T00:00:00.000Z",3,FALSE,30,464,"G",3,3,"Brooklyn Nets","Lonnie Walker IV",0,0,0,0,0,0
2,0,2,1,0,5,2,4,4,"19",0,2,8,2,0,0,7050285,"2023-12-08T00:00:00.000Z",3,FALSE,30,17896058,"F",3,3,"Brooklyn Nets","Trendon Watford",0,10,12,10,4,13.4
2,2,0,0,0,5,1,2,1,"22",2,1,3,2,0,1,7050285,"2023-12-08T00:00:00.000Z",3,FALSE,30,666577,"F",30,30,"Washington Wizards","Daniel Gafford",2,5,7,5,4,13.4
2,0,2,2,0,7,3,2,2,"23",0,3,8,2,0,3,7050285,"2023-12-08T00:00:00.000Z",3,FALSE,30,666848,"G",30,30,"Washington Wizards","Jordan Poole",0,10,12,10,4,10.4
2,0,2,4,1,17,8,1,0,"30",1,2,17,3,0,3,7050285,"2023-12-08T00:00:00.000Z",3,FALSE,30,265,"F",30,30,"Washington Wizards","Kyle Kuzma",0,20,22,19,5,20.6
2,0,2,2,0,15,5,7,6,"36",3,1,16,5,1,2,7050286,"2023-12-08T00:00:00.000Z",16,FALSE,6,79,"G-F",16,16,"Miami Heat","Jimmy Butler",1,21,23,18,7,26
4,2,5,8,3,15,6,2,0,"34",1,5,15,6,0,1,7050286,"2023-12-08T00:00:00.000Z",16,FALSE,6,666747,"F",16,16,"Miami Heat","Caleb Martin",2,21,25,19,10,33.2
3,1,6,0,0,3,2,1,1,"20",2,3,5,8,0,1,7050286,"2023-12-08T00:00:00.000Z",16,FALSE,6,39398582,"C",16,16,"Miami Heat","Orlando Robinson",1,13,16,8,11,21.1
1,0,0,6,0,7,0,2,1,"23",0,4,1,0,0,6,7050286,"2023-12-08T00:00:00.000Z",16,FALSE,6,397,"F",16,16,"Miami Heat","Duncan Robinson",0,1,2,2,1,-3.5
5,0,2,9,3,13,6,3,2,"33",0,1,17,2,2,3,7050286,"2023-12-08T00:00:00.000Z",16,FALSE,6,286,"G",16,16,"Miami Heat","Kyle Lowry",2,19,24,22,7,29.9
0,0,0,0,0,0,0,0,0,"00",0,0,0,0,0,0,7050286,"2023-12-08T00:00:00.000Z",16,FALSE,6,74,"C",16,16,"Miami Heat","Thomas Bryant",0,0,0,0,0,0
0,0,0,0,0,0,0,0,0,"00",0,0,0,0,0,0,7050286,"2023-12-08T00:00:00.000Z",16,FALSE,6,38017734,"F",16,16,"Miami Heat","Jamal Cain",0,0,0,0,0,0
3,1,2,2,0,13,7,0,0,"35",1,3,14,3,0,3,7050286,"2023-12-08T00:00:00.000Z",16,FALSE,6,56677785,"G",16,16,"Miami Heat","Jaime Jaquez Jr.",1,17,20,17,6,22.1
0,0,0,0,0,0,0,0,0,"00",0,0,0,0,0,0,7050286,"2023-12-08T00:00:00.000Z",16,FALSE,6,38017696,"F",16,16,"Miami Heat","Nikola Jovic",0,0,0,0,0,0
3,1,12,8,4,9,5,0,0,"28",0,3,14,12,1,1,7050286,"2023-12-08T00:00:00.000Z",16,FALSE,6,285,"F-C",16,16,"Miami Heat","Kevin Love",2,26,29,17,15,37.9
2,0,1,7,5,11,6,0,0,"31",0,3,17,1,1,1,7050286,"2023-12-08T00:00:00.000Z",16,FALSE,6,391,"G-F",16,16,"Miami Heat","Josh Richardson",1,18,20,19,3,23.2
0,0,0,0,0,0,0,0,0,"00",0,0,0,0,0,0,7050286,"2023-12-08T00:00:00.000Z",16,FALSE,6,38017736,"F",16,16,"Miami Heat","Cole Swider",0,0,0,0,0,0
0,0,0,0,0,0,0,0,0,"00",0,0,0,0,0,0,7050286,"2023-12-08T00:00:00.000Z",16,FALSE,6,4,"C-F",16,16,"Miami Heat","Bam Adebayo",0,0,0,0,0,0
0,0,0,0,0,0,0,0,0,"00",0,0,0,0,0,0,7050286,"2023-12-08T00:00:00.000Z",16,FALSE,6,3547257,"G",16,16,"Miami Heat","R.J. Hampton",0,0,0,0,0,0
0,0,0,0,0,0,0,0,0,"00",0,0,0,0,0,0,7050286,"2023-12-08T00:00:00.000Z",16,FALSE,6,666633,"G",16,16,"Miami Heat","Tyler Herro",0,0,0,0,0,0
0,0,0,0,0,0,0,0,0,"00",0,0,0,0,0,0,7050286,"2023-12-08T00:00:00.000Z",16,FALSE,6,3092,"",16,16,"Miami Heat","Haywood Highsmith",0,0,0,0,0,0
0,0,0,0,0,0,0,0,0,"00",0,0,0,0,0,0,7050286,"2023-12-08T00:00:00.000Z",16,FALSE,6,19465585,"G",16,16,"Miami Heat","Dru Smith",0,0,0,0,0,0
1,0,5,11,2,17,4,1,1,"34",2,3,11,7,1,0,7050286,"2023-12-08T00:00:00.000Z",16,FALSE,6,666908,"G",6,6,"Cleveland Cavaliers","Max Strus",1,18,19,12,8,23.9
1,0,7,0,0,9,3,2,0,"25",2,2,6,9,1,0,7050286,"2023-12-08T00:00:00.000Z",16,FALSE,6,9,"C",6,6,"Cleveland Cavaliers","Jarrett Allen",1,15,16,7,10,21.3
6,0,12,8,3,17,9,8,6,"36",1,1,27,13,1,5,7050286,"2023-12-08T00:00:00.000Z",16,FALSE,6,322,"G",6,6,"Cleveland Cavaliers","Donovan Mitchell",1,40,46,33,19,49.6
6,0,2,4,1,11,6,7,5,"26",0,4,18,2,4,2,7050286,"2023-12-08T00:00:00.000Z",16,FALSE,6,666581,"G",6,6,"Cleveland Cavaliers","Darius Garland",4,20,26,24,8,39.4
0,0,1,0,0,0,0,0,0,"03",0,1,0,1,0,1,7050286,"2023-12-08T00:00:00.000Z",16,FALSE,6,248,"C",6,6,"Cleveland Cavaliers","Damian Jones",0,1,1,0,1,0.2
1,0,2,5,3,5,3,0,0,"10",1,2,9,3,0,0,7050286,"2023-12-08T00:00:00.000Z",16,FALSE,6,3547299,"G",6,6,"Cleveland Cavaliers","Sam Merrill",0,12,13,10,4,14.1
0,0,0,0,0,0,0,0,0,"00",0,0,0,0,0,0,7050286,"2023-12-08T00:00:00.000Z",16,FALSE,6,38017662,"F",6,6,"Cleveland Cavaliers","Isaiah Mobley",0,0,0,0,0,0
2,0,2,4,3,9,5,0,0,"20",1,1,13,3,0,2,7050286,"2023-12-08T00:00:00.000Z",16,FALSE,6,344,"F",6,6,"Cleveland Cavaliers","Georges Niang",0,16,18,15,5,17.6
0,1,1,2,1,4,3,2,2,"22",0,2,9,1,1,1,7050286,"2023-12-08T00:00:00.000Z",16,FALSE,6,3547247,"F-G",6,6,"Cleveland Cavaliers","Isaac Okoro",2,10,10,9,1,15.2
4,1,3,0,0,7,3,4,2,"23",0,0,8,3,2,0,7050286,"2023-12-08T00:00:00.000Z",16,FALSE,6,56677872,"G",6,6,"Cleveland Cavaliers","Craig Porter",3,11,15,12,7,26.6
0,0,1,0,0,3,2,2,1,"16",2,0,5,3,0,1,7050286,"2023-12-08T00:00:00.000Z",16,FALSE,6,444,"C-F",6,6,"Cleveland Cavaliers","Tristan Thompson",0,8,8,5,3,7.6
0,0,0,0,0,0,0,0,0,"00",0,0,0,0,0,0,7050286,"2023-12-08T00:00:00.000Z",16,FALSE,6,56677847,"F",6,6,"Cleveland Cavaliers","Emoni Bates",0,0,0,0,0,0
0,0,0,0,0,0,0,0,0,"00",0,0,0,0,0,0,7050286,"2023-12-08T00:00:00.000Z",16,FALSE,6,666676,"G",6,6,"Cleveland Cavaliers","Ty Jerome",0,0,0,0,0,0
0,0,0,0,0,0,0,0,0,"00",0,0,0,0,0,0,7050286,"2023-12-08T00:00:00.000Z",16,FALSE,6,277,"G",6,6,"Cleveland Cavaliers","Caris LeVert",0,0,0,0,0,0
0,0,0,0,0,0,0,0,0,"00",0,0,0,0,0,0,7050286,"2023-12-08T00:00:00.000Z",16,FALSE,6,17896076,"F-C",6,6,"Cleveland Cavaliers","Evan Mobley",0,0,0,0,0,0
0,0,0,0,0,0,0,0,0,"00",0,0,0,0,0,0,7050286,"2023-12-08T00:00:00.000Z",16,FALSE,6,404,"G",6,6,"Cleveland Cavaliers","Ricky Rubio",0,0,0,0,0,0
0,0,3,4,1,5,2,0,0,"25",3,1,5,6,3,1,7050286,"2023-12-08T00:00:00.000Z",16,FALSE,6,666940,"F",6,6,"Cleveland Cavaliers","Dean Wade",3,11,11,5,6,20.2
0,0,3,4,1,11,6,0,0,"25",0,0,13,3,0,0,7050287,"2023-12-08T00:00:00.000Z",15,FALSE,18,38017729,"F",15,15,"Memphis Grizzlies","David Roddy",0,16,16,13,3,16.6
1,1,1,4,3,14,7,4,4,"29",1,5,21,2,1,2,7050287,"2023-12-08T00:00:00.000Z",15,FALSE,18,231,"F-C",15,15,"Memphis Grizzlies","Jaren Jackson Jr.",2,23,24,22,3,28.9
2,0,3,0,0,2,1,0,0,"20",0,4,2,3,0,0,7050287,"2023-12-08T00:00:00.000Z",15,FALSE,18,48,"C",15,15,"Memphis Grizzlies","Bismack Biyombo",0,5,7,4,5,8.6
1,1,2,6,4,13,6,0,0,"37",0,5,16,2,0,4,7050287,"2023-12-08T00:00:00.000Z",15,FALSE,18,3547287,"G",15,15,"Memphis Grizzlies","Desmond Bane",1,18,19,17,3,18.9
7,0,1,1,0,7,2,2,2,"22",0,1,6,1,0,1,7050287,"2023-12-08T00:00:00.000Z",15,FALSE,18,401,"G",15,15,"Memphis Grizzlies","Derrick Rose",0,7,14,13,8,16.7
6,1,6,3,1,8,2,6,4,"24",4,1,9,10,0,0,7050287,"2023-12-08T00:00:00.000Z",15,FALSE,18,17896067,"F",15,15,"Memphis Grizzlies","Santi Aldama",1,19,25,15,16,33
2,0,0,1,0,1,0,0,0,"04",0,0,0,0,0,0,7050287,"2023-12-08T00:00:00.000Z",15,FALSE,18,48248287,"G",15,15,"Memphis Grizzlies","Jacob Gilyard",0,0,2,2,2,3
0,1,3,4,1,5,1,0,0,"17",0,1,3,3,1,0,7050287,"2023-12-08T00:00:00.000Z",15,FALSE,18,666703,"G-F",15,15,"Memphis Grizzlies","John Konchar",2,6,6,3,3,12.6
2,0,0,2,1,3,1,2,2,"04",0,0,5,0,1,0,7050287,"2023-12-08T00:00:00.000Z",15,FALSE,18,38017732,"F",15,15,"Memphis Grizzlies","Kenneth Lofton Jr.",1,5,7,7,2,11
2,0,0,4,2,6,3,0,0,"20",0,4,8,0,0,1,7050287,"2023-12-08T00:00:00.000Z",15,FALSE,18,666809,"G",15,15,"Memphis Grizzlies","Jaylen Nowell",0,8,10,10,2,10
0,0,0,2,1,8,5,3,1,"17",2,1,12,2,4,0,7050287,"2023-12-08T00:00:00.000Z",15,FALSE,18,3547285,"F",15,15,"Memphis Grizzlies","Xavier Tillman",4,14,14,12,2,26.4
0,0,0,0,0,3,2,0,0,"04",0,0,4,0,0,0,7050287,"2023-12-08T00:00:00.000Z",15,FALSE,18,17896027,"G-F",15,15,"Memphis Grizzlies","Ziaire Williams",0,4,4,4,0,4
0,0,0,0,0,0,0,0,0,"00",0,0,0,0,0,0,7050287,"2023-12-08T00:00:00.000Z",15,FALSE,18,3,"C",15,15,"Memphis Grizzlies","Steven Adams",0,0,0,0,0,0
0,0,0,0,0,0,0,0,0,"00",0,0,0,0,0,0,7050287,"2023-12-08T00:00:00.000Z",15,FALSE,18,666505,"F",15,15,"Memphis Grizzlies","Brandon Clarke",0,0,0,0,0,0
0,0,0,0,0,0,0,0,0,"00",0,0,0,0,0,0,7050287,"2023-12-08T00:00:00.000Z",15,FALSE,18,56677830,"F",15,15,"Memphis Grizzlies","GG Jackson",0,0,0,0,0,0
0,0,0,0,0,0,0,0,0,"00",0,0,0,0,0,0,7050287,"2023-12-08T00:00:00.000Z",15,FALSE,18,254,"G",15,15,"Memphis Grizzlies","Luke Kennard",0,0,0,0,0,0
0,0,0,0,0,0,0,0,0,"00",0,0,0,0,0,0,7050287,"2023-12-08T00:00:00.000Z",15,FALSE,18,38017728,"F",15,15,"Memphis Grizzlies","Jake LaRavia",0,0,0,0,0,0
0,0,0,0,0,0,0,0,0,"00",0,0,0,0,0,0,7050287,"2023-12-08T00:00:00.000Z",15,FALSE,18,666786,"G",15,15,"Memphis Grizzlies","Ja Morant",0,0,0,0,0,0
0,0,0,0,0,0,0,0,0,"00",0,0,0,0,0,0,7050287,"2023-12-08T00:00:00.000Z",15,FALSE,18,420,"G",15,15,"Memphis Grizzlies","Marcus Smart",0,0,0,0,0,0
2,1,0,8,4,9,4,2,2,"34",2,2,14,2,0,2,7050287,"2023-12-08T00:00:00.000Z",15,FALSE,18,666400,"G",18,18,"Minnesota Timberwolves","Nickeil Alexander-Walker",1,16,18,16,4,20.4
4,0,3,6,4,10,8,0,0,"30",1,2,20,4,1,1,7050287,"2023-12-08T00:00:00.000Z",15,FALSE,18,68,"F",18,18,"Minnesota Timberwolves","Troy Brown Jr.",1,24,28,24,8,32.8
1,0,0,0,0,1,0,0,0,"03",0,1,0,0,0,0,7050287,"2023-12-08T00:00:00.000Z",15,FALSE,18,17896056,"C",18,18,"Minnesota Timberwolves","Luka Garza",0,0,1,1,1,1.5
0,0,0,0,0,0,0,0,0,"00",0,0,0,0,0,0,7050287,"2023-12-08T00:00:00.000Z",15,FALSE,18,666767,"G",18,18,"Minnesota Timberwolves","Jordan McLaughlin",0,0,0,0,0,0
1,0,2,5,3,9,6,2,2,"22",0,1,17,2,0,2,7050287,"2023-12-08T00:00:00.000Z",15,FALSE,18,320,"G",18,18,"Minnesota Timberwolves","Shake Milton",0,19,20,18,3,18.9
2,1,9,5,0,12,5,0,0,"24",0,2,10,9,1,1,7050287,"2023-12-08T00:00:00.000Z",15,FALSE,18,667378,"F-C",18,18,"Minnesota Timberwolves","Naz Reid",2,19,21,12,11,28.8
7,0,4,3,2,11,6,5,5,"32",0,1,19,4,0,2,7050287,"2023-12-08T00:00:00.000Z",15,FALSE,18,104,"G",18,18,"Minnesota Timberwolves","Mike Conley",0,23,30,26,11,32.3
5,0,5,6,0,11,2,4,3,"22",1,0,7,6,0,2,7050287,"2023-12-08T00:00:00.000Z",15,FALSE,18,12,"F",18,18,"Minnesota Timberwolves","Kyle Anderson",0,13,18,12,11,19.7
1,0,1,4,1,5,1,2,1,"17",1,1,4,2,0,1,7050287,"2023-12-08T00:00:00.000Z",15,FALSE,18,38017731,"G",15,15,"Memphis Grizzlies","Vince Williams Jr.",0,6,7,5,3,6.9
1,0,0,1,0,1,0,0,0,"04",0,0,0,0,0,0,7050287,"2023-12-08T00:00:00.000Z",15,FALSE,18,38017700,"G",18,18,"Minnesota Timberwolves","Wendell Moore Jr.",0,0,1,1,1,1.5
0,0,0,0,0,0,0,0,0,"00",0,0,0,0,0,0,7050287,"2023-12-08T00:00:00.000Z",15,FALSE,18,56677851,"G",18,18,"Minnesota Timberwolves","Jaylen Clark",0,0,0,0,0,0
0,0,0,0,0,0,0,0,0,"00",0,0,0,0,0,0,7050287,"2023-12-08T00:00:00.000Z",15,FALSE,18,3547259,"F",18,18,"Minnesota Timberwolves","Jaden McDaniels",0,0,0,0,0,0
0,0,0,0,0,0,0,0,0,"00",0,0,0,0,0,0,7050287,"2023-12-08T00:00:00.000Z",15,FALSE,18,56677782,"F",18,18,"Minnesota Timberwolves","Leonard Miller",0,0,0,0,0,0
0,0,0,0,0,0,0,0,0,"00",0,0,0,0,0,0,7050287,"2023-12-08T00:00:00.000Z",15,FALSE,18,38017715,"F",18,18,"Minnesota Timberwolves","Josh Minott",0,0,0,0,0,0
0,0,0,0,0,0,0,0,0,"00",0,0,0,0,0,0,7050287,"2023-12-08T00:00:00.000Z",15,FALSE,18,17895968,"F",18,18,"Minnesota Timberwolves","Daishen Nix",0,0,0,0,0,0
5,0,5,4,2,14,7,9,8,"29",2,4,24,7,1,1,7050287,"2023-12-08T00:00:00.000Z",15,FALSE,18,447,"C",18,18,"Minnesota Timberwolves","Karl-Anthony Towns",1,31,36,29,12,41.9
1,6,11,0,0,9,6,4,4,"36",9,4,16,20,1,2,7050287,"2023-12-08T00:00:00.000Z",15,FALSE,18,176,"C",18,18,"Minnesota Timberwolves","Rudy Gobert",7,36,37,17,21,60.5
1,0,0,0,0,1,0,0,0,"04",0,0,0,0,0,0,7050287,"2023-12-08T00:00:00.000Z",15,FALSE,18,3547238,"G",18,18,"Minnesota Timberwolves","Anthony Edwards",0,0,1,1,1,1.5
1,1,1,3,0,9,4,8,8,"39",4,4,16,5,0,1,7050288,"2023-12-08T00:00:00.000Z",21,FALSE,10,666541,"G",21,21,"Oklahoma City Thunder","Luguentz Dort",1,21,22,17,6,25.5
2,1,5,1,1,15,12,4,3,"40",0,3,28,5,3,1,7050288,"2023-12-08T00:00:00.000Z",21,FALSE,10,38017703,"G-F",21,21,"Oklahoma City Thunder","Jalen Williams",4,33,35,30,7,48
1,3,5,4,1,12,6,8,8,"34",2,4,21,7,0,3,7050288,"2023-12-08T00:00:00.000Z",21,FALSE,10,38017685,"C-F",21,21,"Oklahoma City Thunder","Chet Holmgren",3,28,29,22,8,36.9
4,0,8,6,1,12,4,0,0,"25",1,2,9,9,3,1,7050288,"2023-12-08T00:00:00.000Z",21,FALSE,10,17896065,"G",21,21,"Oklahoma City Thunder","Josh Giddey",3,18,22,13,13,33.8
5,1,2,3,0,30,15,11,8,"42",3,4,38,5,5,0,7050288,"2023-12-08T00:00:00.000Z",21,FALSE,10,175,"G",21,21,"Oklahoma City Thunder","Shai Gilgeous-Alexander",6,43,48,43,10,69.5
0,0,0,0,0,0,0,0,0,"01",0,0,0,0,0,0,7050288,"2023-12-08T00:00:00.000Z",21,FALSE,10,44,"F",21,21,"Oklahoma City Thunder","Davis Bertans",0,0,0,0,0,0
0,0,0,0,0,0,0,0,0,"00",0,0,0,0,0,0,7050288,"2023-12-08T00:00:00.000Z",21,FALSE,10,38017716,"F",21,21,"Oklahoma City Thunder","Ousmane Dieng",0,0,0,0,0,0
1,0,1,3,0,4,1,3,3,"23",0,1,5,1,3,0,7050288,"2023-12-08T00:00:00.000Z",21,FALSE,10,3547272,"G",21,21,"Oklahoma City Thunder","Isaiah Joe",3,6,7,6,2,16.7
0,0,0,0,0,0,0,0,0,"00",0,0,0,0,0,0,7050288,"2023-12-08T00:00:00.000Z",21,FALSE,10,17896036,"G",21,21,"Oklahoma City Thunder","Tre Mann",0,0,0,0,0,0
0,0,0,0,0,0,0,0,0,"00",0,0,0,0,0,0,7050288,"2023-12-08T00:00:00.000Z",21,FALSE,10,4197029,"G",21,21,"Oklahoma City Thunder","Vasilije Micic",0,0,0,0,0,0
0,0,0,0,0,0,0,0,0,"00",0,0,0,0,0,0,7050288,"2023-12-08T00:00:00.000Z",21,FALSE,10,3547271,"C",21,21,"Oklahoma City Thunder","Aleksej Pokusevski",0,0,0,0,0,0
0,1,1,2,1,5,4,2,1,"24",0,0,10,1,1,1,7050288,"2023-12-08T00:00:00.000Z",21,FALSE,10,56677833,"G",21,21,"Oklahoma City Thunder","Cason Wallace",2,11,11,10,1,16.2
1,0,2,2,1,5,4,0,0,"22",1,2,9,3,2,1,7050288,"2023-12-08T00:00:00.000Z",21,FALSE,10,17896078,"G",21,21,"Oklahoma City Thunder","Aaron Wiggins",2,12,13,10,4,19.1
0,0,1,2,0,2,0,0,0,"06",0,1,0,1,0,1,7050288,"2023-12-08T00:00:00.000Z",21,FALSE,10,38017706,"F",21,21,"Oklahoma City Thunder","Jaylin Williams",0,1,1,0,1,0.2
0,0,2,3,0,4,1,0,0,"09",0,1,2,2,0,0,7050288,"2023-12-08T00:00:00.000Z",21,FALSE,10,480,"G-F",21,21,"Oklahoma City Thunder","Kenrich Williams",0,4,4,2,2,4.4
0,0,0,0,0,0,0,0,0,"00",0,0,0,0,0,0,7050288,"2023-12-08T00:00:00.000Z",21,FALSE,10,56677853,"F",21,21,"Oklahoma City Thunder","Keyontae Johnson",0,0,0,0,0,0
0,0,0,0,0,0,0,0,0,"00",0,0,0,0,0,0,7050288,"2023-12-08T00:00:00.000Z",21,FALSE,10,24572055,"C",21,21,"Oklahoma City Thunder","Olivier Sarr",0,0,0,0,0,0
0,0,0,0,0,0,0,0,0,"00",0,0,0,0,0,0,7050288,"2023-12-08T00:00:00.000Z",21,FALSE,10,27924547,"F",21,21,"Oklahoma City Thunder","Lindy Waters III",0,0,0,0,0,0
1,0,4,4,2,11,4,2,2,"32",2,3,12,6,0,6,7050288,"2023-12-08T00:00:00.000Z",21,FALSE,10,475,"F-G",10,10,"Golden State Warriors","Andrew Wiggins",0,18,19,13,7,14.7
13,1,4,2,1,7,5,2,1,"35",1,6,12,5,0,4,7050288,"2023-12-08T00:00:00.000Z",21,FALSE,10,185,"F",10,10,"Golden State Warriors","Draymond Green",1,17,30,25,18,36.5
2,0,3,0,0,2,2,3,1,"16",1,1,5,4,0,2,7050288,"2023-12-08T00:00:00.000Z",21,FALSE,10,282,"F",10,10,"Golden State Warriors","Kevon Looney",0,9,11,7,6,10.8
0,1,3,9,4,15,8,2,2,"39",1,4,22,4,0,4,7050288,"2023-12-08T00:00:00.000Z",21,FALSE,10,443,"G",10,10,"Golden State Warriors","Klay Thompson",1,26,26,22,4,25.8
3,0,6,12,6,20,10,8,8,"40",0,0,34,6,1,3,7050288,"2023-12-08T00:00:00.000Z",21,FALSE,10,115,"G",10,10,"Golden State Warriors","Stephen Curry",1,40,43,37,9,45.7
0,0,0,0,0,0,0,0,0,"00",0,0,0,0,0,0,7050288,"2023-12-08T00:00:00.000Z",21,FALSE,10,56677799,"F",10,10,"Golden State Warriors","Trayce Jackson-Davis",0,0,0,0,0,0
3,0,1,1,0,3,1,0,0,"13",0,0,2,1,0,0,7050288,"2023-12-08T00:00:00.000Z",21,FALSE,10,251,"G",10,10,"Golden State Warriors","Cory Joseph",0,3,6,5,4,7.7
0,0,6,6,3,21,10,1,1,"29",6,6,24,12,0,3,7050288,"2023-12-08T00:00:00.000Z",21,FALSE,10,17553979,"F",10,10,"Golden State Warriors","Jonathan Kuminga",0,36,36,24,12,35.4
0,0,2,3,0,5,1,0,0,"16",2,4,2,4,0,2,7050288,"2023-12-08T00:00:00.000Z",21,FALSE,10,17553992,"G",10,10,"Golden State Warriors","Moses Moody",0,6,6,2,4,4.8
0,0,0,0,0,0,0,0,0,"00",0,0,0,0,0,0,7050288,"2023-12-08T00:00:00.000Z",21,FALSE,10,367,"G",10,10,"Golden State Warriors","Chris Paul",0,0,0,0,0,0
0,0,0,0,0,0,0,0,0,"00",0,0,0,0,0,0,7050288,"2023-12-08T00:00:00.000Z",21,FALSE,10,2189,"",10,10,"Golden State Warriors","Gary Payton II",0,0,0,0,0,0
4,0,1,4,1,11,5,1,1,"23",5,2,12,6,1,1,7050288,"2023-12-08T00:00:00.000Z",21,FALSE,10,56677858,"G",10,10,"Golden State Warriors","Brandin Podziemski",1,18,22,16,10,27.2
3,0,6,6,2,8,3,4,3,"22",5,2,11,11,1,3,7050288,"2023-12-08T00:00:00.000Z",21,FALSE,10,407,"F",10,10,"Golden State Warriors","Dario Saric",1,22,25,14,14,28.7
0,0,0,0,0,0,0,0,0,"00",0,0,0,0,0,0,7050288,"2023-12-08T00:00:00.000Z",21,FALSE,10,17896070,"F",10,10,"Golden State Warriors","Usman Garuba",0,0,0,0,0,0
0,0,0,0,0,0,0,0,0,"00",0,0,0,0,0,0,7050288,"2023-12-08T00:00:00.000Z",21,FALSE,10,45658838,"G",10,10,"Golden State Warriors","Lester Quinones",0,0,0,0,0,0
0,0,0,0,0,0,0,0,0,"00",0,0,0,0,0,0,7050288,"2023-12-08T00:00:00.000Z",21,FALSE,10,398,"G",10,10,"Golden State Warriors","Jerome Robinson",0,0,0,0,0,0
0,0,0,0,0,0,0,0,0,"00",0,0,0,0,0,0,7050288,"2023-12-08T00:00:00.000Z",21,FALSE,10,57875092,"F",10,10,"Golden State Warriors","Gui Santos",0,0,0,0,0,0
5,0,2,9,1,15,4,3,2,"34",0,1,11,2,1,3,7050289,"2023-12-08T00:00:00.000Z",27,FALSE,5,3547246,"G-F",27,27,"San Antonio Spurs","Devin Vassell",1,13,18,16,7,20.9
5,1,2,11,6,11,6,2,2,"35",0,3,20,2,0,0,7050289,"2023-12-08T00:00:00.000Z",27,FALSE,5,666682,"F",27,27,"San Antonio Spurs","Keldon Johnson",1,22,27,25,7,32.9
4,4,13,4,0,20,8,6,5,"32",7,2,21,20,1,1,7050289,"2023-12-08T00:00:00.000Z",27,FALSE,5,56677822,"F-C",27,27,"San Antonio Spurs","Victor Wembanyama",5,41,45,25,24,65
2,1,0,4,2,6,3,2,2,"23",0,2,10,0,0,0,7050289,"2023-12-08T00:00:00.000Z",27,FALSE,5,38017692,"F",27,27,"San Antonio Spurs","Malaki Branham",1,10,12,12,2,16
4,1,3,2,0,6,2,0,0,"34",0,3,4,3,0,5,7050289,"2023-12-08T00:00:00.000Z",27,FALSE,5,38017699,"F",27,27,"San Antonio Spurs","Jeremy Sochan",1,7,11,8,7,11.6
0,0,0,0,0,0,0,0,0,"00",0,0,0,0,0,0,7050289,"2023-12-08T00:00:00.000Z",27,FALSE,5,38017730,"F",27,27,"San Antonio Spurs","Dominick Barlow",0,0,0,0,0,0
0,0,0,0,0,0,0,0,0,"00",0,0,0,0,0,0,7050289,"2023-12-08T00:00:00.000Z",27,FALSE,5,17895854,"G",27,27,"San Antonio Spurs","Charles Bassey",0,0,0,0,0,0
0,1,0,0,0,0,0,0,0,"06",0,3,0,0,0,0,7050289,"2023-12-08T00:00:00.000Z",27,FALSE,5,38017649,"F",27,27,"San Antonio Spurs","Julian Champagnie",1,0,0,0,0,3
4,0,6,2,2,5,4,3,2,"23",3,1,12,9,1,1,7050289,"2023-12-08T00:00:00.000Z",27,FALSE,5,102,"F-C",27,27,"San Antonio Spurs","Zach Collins",1,21,25,16,13,30.8
0,0,0,0,0,0,0,0,0,"00",0,0,0,0,0,0,7050289,"2023-12-08T00:00:00.000Z",27,FALSE,5,180,"G",27,27,"San Antonio Spurs","Devonte' Graham",0,0,0,0,0,0
9,0,5,2,2,7,6,4,4,"28",0,2,18,5,1,1,7050289,"2023-12-08T00:00:00.000Z",27,FALSE,5,3547274,"G",27,27,"San Antonio Spurs","Tre Jones",1,23,32,27,14,39.5
0,0,0,0,0,0,0,0,0,"00",0,0,0,0,0,0,7050289,"2023-12-08T00:00:00.000Z",27,FALSE,5,17896059,"F",27,27,"San Antonio Spurs","Sandro Mamukelashvili",0,0,0,0,0,0
1,0,1,4,3,6,3,0,0,"15",0,2,9,1,0,1,7050289,"2023-12-08T00:00:00.000Z",27,FALSE,5,305,"F",27,27,"San Antonio Spurs","Doug McDermott",0,10,11,10,2,10.7
1,1,2,4,1,7,3,0,0,"10",0,1,7,2,0,0,7050289,"2023-12-08T00:00:00.000Z",27,FALSE,5,359,"F",27,27,"San Antonio Spurs","Cedi Osman",1,9,10,8,3,13.9
0,0,0,0,0,0,0,0,0,"00",0,0,0,0,0,0,7050289,"2023-12-08T00:00:00.000Z",27,FALSE,5,38017693,"G",27,27,"San Antonio Spurs","Blake Wesley",0,0,0,0,0,0
0,0,0,0,0,0,0,0,0,"00",0,0,0,0,0,0,7050289,"2023-12-08T00:00:00.000Z",27,FALSE,5,56677865,"C",27,27,"San Antonio Spurs","Charles Bediako",0,0,0,0,0,0
0,0,0,0,0,0,0,0,0,"00",0,0,0,0,0,0,7050289,"2023-12-08T00:00:00.000Z",27,FALSE,5,56677817,"G",27,27,"San Antonio Spurs","Sidy Cissoko",0,0,0,0,0,0
0,0,0,0,0,0,0,0,0,"00",0,0,0,0,0,0,7050289,"2023-12-08T00:00:00.000Z",27,FALSE,5,56677870,"G",27,27,"San Antonio Spurs","Sir'Jabari Rice",0,0,0,0,0,0
10,0,5,2,0,24,7,10,6,"39",1,2,20,6,3,2,7050289,"2023-12-08T00:00:00.000Z",27,FALSE,5,125,"G",5,5,"Chicago Bulls","DeMar DeRozan",3,26,36,30,16,49.2
3,1,5,3,2,11,8,4,2,"34",1,3,20,6,1,0,7050289,"2023-12-08T00:00:00.000Z",27,FALSE,5,3547248,"F",5,5,"Chicago Bulls","Patrick Williams",2,26,29,23,9,37.7
2,1,6,2,0,22,9,3,3,"36",10,2,21,16,0,0,7050289,"2023-12-08T00:00:00.000Z",27,FALSE,5,460,"C",5,5,"Chicago Bulls","Nikola Vucevic",1,37,39,23,18,46.2
2,0,2,2,0,5,2,0,0,"18",1,2,4,3,1,2,7050289,"2023-12-08T00:00:00.000Z",27,FALSE,5,89,"G",5,5,"Chicago Bulls","Alex Caruso",1,7,9,6,5,11.6
6,0,4,7,5,15,9,1,1,"39",0,0,24,4,1,3,7050289,"2023-12-08T00:00:00.000Z",27,FALSE,5,666956,"G",5,5,"Chicago Bulls","Coby White",1,28,34,30,10,37.8
3,0,3,2,0,5,2,0,0,"26",0,1,4,3,1,0,7050289,"2023-12-08T00:00:00.000Z",27,FALSE,5,17895983,"G",5,5,"Chicago Bulls","Ayo Dosunmu",1,7,10,7,6,15.1
0,0,0,0,0,0,0,0,0,"00",0,0,0,0,0,0,7050289,"2023-12-08T00:00:00.000Z",27,FALSE,5,17896116,"G",5,5,"Chicago Bulls","Terry Taylor",0,0,0,0,0,0
0,0,0,0,0,0,0,0,0,"00",0,0,0,0,0,0,7050289,"2023-12-08T00:00:00.000Z",27,FALSE,5,38017719,"F",5,5,"Chicago Bulls","Dalen Terry",0,0,0,0,0,0
0,0,0,0,0,0,0,0,0,"00",0,0,0,0,0,0,7050289,"2023-12-08T00:00:00.000Z",27,FALSE,5,27,"G",5,5,"Chicago Bulls","Lonzo Ball",0,0,0,0,0,0
0,0,0,0,0,0,0,0,0,"00",0,0,0,0,0,0,7050289,"2023-12-08T00:00:00.000Z",27,FALSE,5,56677874,"F",5,5,"Chicago Bulls","Onuralp Bitim",0,0,0,0,0,0
0,0,0,0,0,0,0,0,0,"00",0,0,0,0,0,0,7050289,"2023-12-08T00:00:00.000Z",27,FALSE,5,268,"G",5,5,"Chicago Bulls","Zach LaVine",0,0,0,0,0,0
0,0,0,0,0,0,0,0,0,"00",0,0,0,0,0,0,7050289,"2023-12-08T00:00:00.000Z",27,FALSE,5,45969255,"F",5,5,"Chicago Bulls","Justin Lewis",0,0,0,0,0,0
0,0,0,0,0,0,0,0,0,"00",0,0,0,0,0,0,7050289,"2023-12-08T00:00:00.000Z",27,FALSE,5,56677860,"F",5,5,"Chicago Bulls","Adama Sanogo",0,0,0,0,0,0
0,0,1,0,0,1,1,0,0,"04",1,2,2,2,0,0,7050289,"2023-12-08T00:00:00.000Z",27,FALSE,5,56677857,"F",5,5,"Chicago Bulls","Julian Phillips",0,4,4,2,2,4.4
1,0,0,3,1,4,1,0,0,"09",0,2,3,0,0,0,7050289,"2023-12-08T00:00:00.000Z",27,FALSE,5,87,"G",5,5,"Chicago Bulls","Jevon Carter",0,3,4,4,1,4.5
0,0,2,0,0,7,3,4,1,"12",6,2,7,8,0,0,7050289,"2023-12-08T00:00:00.000Z",27,FALSE,5,137,"C",5,5,"Chicago Bulls","Andre Drummond",0,15,15,7,8,16.6
0,0,4,7,5,8,5,2,1,"23",4,3,16,8,2,0,7050289,"2023-12-08T00:00:00.000Z",27,FALSE,5,110,"F",5,5,"Chicago Bulls","Torrey Craig",2,24,24,16,8,31.6
3,2,0,3,0,5,0,0,0,"29",2,3,0,2,2,1,7996365,"2023-12-08T00:00:00.000Z",24,FALSE,26,356,"G",24,24,"Phoenix Suns","Josh Okogie",4,2,5,3,5,17.9
2,0,3,3,1,6,2,2,0,"17",1,0,5,4,0,0,7996365,"2023-12-08T00:00:00.000Z",24,FALSE,26,32,"F",24,24,"Phoenix Suns","Keita Bates-Diop",0,9,11,7,6,12.8
3,0,8,4,2,13,6,4,1,"30",1,3,15,9,1,0,7996365,"2023-12-08T00:00:00.000Z",24,FALSE,26,349,"C",24,24,"Phoenix Suns","Jusuf Nurkic",1,24,27,18,12,33.3
3,1,0,7,3,13,7,2,2,"38",0,3,19,0,2,4,7996365,"2023-12-08T00:00:00.000Z",24,FALSE,26,178,"G",24,24,"Phoenix Suns","Eric Gordon",3,19,22,22,3,28.5
7,0,7,2,2,14,10,9,6,"37",0,4,28,7,1,3,7996365,"2023-12-08T00:00:00.000Z",24,FALSE,26,57,"G",24,24,"Phoenix Suns","Devin Booker",1,35,42,35,14,46.9
6,0,3,1,0,6,3,2,2,"20",2,2,8,5,0,2,7996365,"2023-12-08T00:00:00.000Z",24,FALSE,26,18678058,"",24,24,"Phoenix Suns","Jordan Goodwin",0,13,19,14,11,21
1,2,4,4,0,9,4,2,2,"23",0,1,10,4,2,0,7996365,"2023-12-08T00:00:00.000Z",24,FALSE,26,314,"F",24,24,"Phoenix Suns","Chimezie Metu",4,14,15,11,5,28.3
0,0,2,7,1,13,6,0,0,"30",2,6,13,4,1,1,7996365,"2023-12-08T00:00:00.000Z",24,FALSE,26,38017688,"F",26,26,"Sacramento Kings","Keegan Murray",1,17,17,13,4,19.8
5,0,13,0,0,11,6,4,3,"38",4,4,15,17,0,4,7996365,"2023-12-08T00:00:00.000Z",24,FALSE,26,406,"F",26,26,"Sacramento Kings","Domantas Sabonis",0,32,37,20,22,38.9
1,0,3,3,0,4,0,1,1,"17",0,3,1,3,1,0,7996365,"2023-12-08T00:00:00.000Z",24,FALSE,26,221,"G",26,26,"Sacramento Kings","Kevin Huerter",1,4,5,2,4,9.1
7,0,2,7,4,24,11,10,8,"35",2,0,34,4,1,2,7996365,"2023-12-08T00:00:00.000Z",24,FALSE,26,161,"G",26,26,"Sacramento Kings","De'Aaron Fox",1,38,45,41,11,50.3
0,0,0,0,0,0,0,0,0,"00",0,0,0,0,0,0,7996365,"2023-12-08T00:00:00.000Z",24,FALSE,26,140,"F",24,24,"Phoenix Suns","Kevin Durant",0,0,0,0,0,0
0,0,0,0,0,0,0,0,0,"00",0,0,0,0,0,0,7996365,"2023-12-08T00:00:00.000Z",24,FALSE,26,272,"G",24,24,"Phoenix Suns","Damion Lee",0,0,0,0,0,0
2,0,4,4,1,11,3,3,2,"32",4,0,9,8,1,0,7996365,"2023-12-08T00:00:00.000Z",24,FALSE,26,30,"F",26,26,"Sacramento Kings","Harrison Barnes",1,17,19,11,10,24.6
0,0,0,0,0,0,0,0,0,"00",0,0,0,0,0,0,7996365,"2023-12-08T00:00:00.000Z",24,FALSE,26,273,"C",26,26,"Sacramento Kings","Alex Len",0,0,0,0,0,0
0,0,0,0,0,0,0,0,0,"00",0,0,0,0,0,0,7996365,"2023-12-08T00:00:00.000Z",24,FALSE,26,56677862,"F",26,26,"Sacramento Kings","Jalen Slawson",0,0,0,0,0,0
0,0,1,0,0,0,0,0,0,"04",0,0,0,1,0,0,7996365,"2023-12-08T00:00:00.000Z",24,FALSE,26,666729,"F",24,24,"Phoenix Suns","Nassir Little",0,1,1,0,1,1.2
0,0,4,0,0,8,4,0,0,"16",2,3,8,6,0,1,7996365,"2023-12-08T00:00:00.000Z",24,FALSE,26,147,"F",24,24,"Phoenix Suns","Drew Eubanks",0,14,14,8,6,14.2
1,0,2,8,3,8,3,0,0,"24",0,0,9,2,0,0,7996365,"2023-12-08T00:00:00.000Z",24,FALSE,26,470,"G",24,24,"Phoenix Suns","Yuta Watanabe",0,11,12,10,3,12.9
0,0,0,0,0,0,0,0,0,"01",0,0,0,0,0,0,7996365,"2023-12-08T00:00:00.000Z",24,FALSE,26,666451,"C",24,24,"Phoenix Suns","Bol Bol",0,0,0,0,0,0
0,0,0,0,0,1,1,2,2,"01",0,0,4,0,0,0,7996365,"2023-12-08T00:00:00.000Z",24,FALSE,26,3547298,"G",24,24,"Phoenix Suns","Saben Lee",0,4,4,4,0,4
0,0,0,0,0,0,0,0,0,"00",0,0,0,0,0,0,7996365,"2023-12-08T00:00:00.000Z",24,FALSE,26,8,"G",24,24,"Phoenix Suns","Grayson Allen",0,0,0,0,0,0
0,0,0,0,0,0,0,0,0,"00",0,0,0,0,0,0,7996365,"2023-12-08T00:00:00.000Z",24,FALSE,26,3547095,"C-F",24,24,"Phoenix Suns","Udoka Azubuike",0,0,0,0,0,0
0,0,0,0,0,0,0,0,0,"00",0,0,0,0,0,0,7996365,"2023-12-08T00:00:00.000Z",24,FALSE,26,37,"G",24,24,"Phoenix Suns","Bradley Beal",0,0,0,0,0,0
2,0,6,4,1,6,2,0,0,"13",0,1,5,6,0,0,7996365,"2023-12-08T00:00:00.000Z",24,FALSE,26,290,"F",26,26,"Sacramento Kings","Trey Lyles",0,11,13,7,8,15.2
2,0,0,3,2,7,5,2,2,"20",3,1,14,3,3,1,7996365,"2023-12-08T00:00:00.000Z",24,FALSE,26,4197162,"F",26,26,"Sacramento Kings","Aleksandar Vezenkov",3,17,19,16,5,28.6
0,0,1,0,0,0,0,0,0,"07",0,1,0,1,0,0,7996365,"2023-12-08T00:00:00.000Z",24,FALSE,26,306,"C",26,26,"Sacramento Kings","JaVale McGee",0,1,1,0,1,1.2
0,0,0,0,0,0,0,0,0,"01",0,0,0,0,0,0,7996365,"2023-12-08T00:00:00.000Z",24,FALSE,26,17896030,"G",26,26,"Sacramento Kings","Chris Duarte",0,0,0,0,0,0
0,0,0,0,0,0,0,0,0,"01",0,1,0,0,0,0,7996365,"2023-12-08T00:00:00.000Z",24,FALSE,26,17896044,"F",26,26,"Sacramento Kings","Kessler Edwards",0,0,0,0,0,0
0,0,0,0,0,0,0,0,0,"01",0,0,0,0,0,0,7996365,"2023-12-08T00:00:00.000Z",24,FALSE,26,17553994,"G",26,26,"Sacramento Kings","Davion Mitchell",0,0,0,0,0,0
0,0,0,0,0,0,0,0,0,"00",0,0,0,0,0,0,7996365,"2023-12-08T00:00:00.000Z",24,FALSE,26,17895990,"G",26,26,"Sacramento Kings","Jordan Ford",0,0,0,0,0,0
0,0,0,0,0,0,0,0,0,"00",0,0,0,0,0,0,7996365,"2023-12-08T00:00:00.000Z",24,FALSE,26,56677845,"G",26,26,"Sacramento Kings","Colby Jones",0,0,0,0,0,0
6,0,2,7,3,10,5,0,0,"28",0,2,13,2,0,2,7996365,"2023-12-08T00:00:00.000Z",24,FALSE,26,324,"G",26,26,"Sacramento Kings","Malik Monk",0,15,21,19,8,22.4
0,0,2,4,2,6,4,0,0,"17",0,3,10,2,0,2,7996365,"2023-12-08T00:00:00.000Z",24,FALSE,26,38017714,"G",26,26,"Sacramento Kings","Keon Ellis",0,12,12,10,2,10.4
4,1,0,5,2,13,7,1,1,"27",0,5,17,0,1,2,7981426,"2023-12-08T00:00:00.000Z",2,FALSE,20,70,"G",2,2,"Boston Celtics","Jaylen Brown",2,17,21,21,4,27
5,0,6,9,3,18,8,8,6,"38",0,3,25,6,1,0,7981426,"2023-12-08T00:00:00.000Z",2,FALSE,20,434,"F",2,2,"Boston Celtics","Jayson Tatum",1,31,36,30,11,42.7
1,0,2,6,3,13,7,4,4,"29",1,2,21,3,2,2,7981426,"2023-12-08T00:00:00.000Z",2,FALSE,20,378,"F-C",2,2,"Boston Celtics","Kristaps Porzingis",2,24,25,22,4,30.1
3,2,1,10,6,16,10,4,4,"32",2,4,30,3,2,0,7981426,"2023-12-08T00:00:00.000Z",2,FALSE,20,473,"G",2,2,"Boston Celtics","Derrick White",4,33,36,33,6,50.1
5,1,6,3,1,11,7,1,1,"35",0,1,16,6,2,1,7981426,"2023-12-08T00:00:00.000Z",2,FALSE,20,214,"G",2,2,"Boston Celtics","Jrue Holiday",3,22,27,21,11,38.7
0,0,0,0,0,0,0,0,0,"01",0,0,0,0,0,0,7981426,"2023-12-08T00:00:00.000Z",2,FALSE,20,17896094,"G",2,2,"Boston Celtics","Dalano Banton",0,0,0,0,0,0
0,0,0,0,0,0,0,0,0,"01",0,0,0,0,0,0,7981426,"2023-12-08T00:00:00.000Z",2,FALSE,20,666468,"F",2,2,"Boston Celtics","Oshae Brissett",0,0,0,0,0,0
1,1,2,5,0,5,0,2,1,"21",1,1,1,3,0,0,7981426,"2023-12-08T00:00:00.000Z",2,FALSE,20,17896060,"F",2,2,"Boston Celtics","Sam Hauser",1,4,5,2,4,9.1
0,0,0,0,0,0,0,0,0,"00",0,0,0,0,0,0,7981426,"2023-12-08T00:00:00.000Z",2,FALSE,20,160,"G-F",20,20,"New York Knicks","Evan Fournier",0,0,0,0,0,0
2,0,1,7,3,10,5,0,0,"19",0,1,13,1,0,2,7981426,"2023-12-08T00:00:00.000Z",2,FALSE,20,17895858,"G",20,20,"New York Knicks","Quentin Grimes",0,14,16,15,3,15.2
7,0,5,3,2,4,2,0,0,"27",1,4,6,6,0,1,7981426,"2023-12-08T00:00:00.000Z",2,FALSE,20,202,"G",20,20,"New York Knicks","Josh Hart",0,12,19,13,13,22.7
4,2,12,0,0,4,2,2,1,"29",4,4,5,16,0,1,7981426,"2023-12-08T00:00:00.000Z",2,FALSE,20,201,"F-C",20,20,"New York Knicks","Isaiah Hartenstein",2,21,25,9,20,35.2
0,0,0,0,0,0,0,0,0,"00",0,0,0,0,0,0,7981426,"2023-12-08T00:00:00.000Z",2,FALSE,20,666675,"F",20,20,"New York Knicks","DaQuan Jeffries",0,0,0,0,0,0
0,0,0,0,0,0,0,0,0,"00",0,0,0,0,0,0,7981426,"2023-12-08T00:00:00.000Z",2,FALSE,20,17896033,"G",20,20,"New York Knicks","Miles McBride",0,0,0,0,0,0
1,0,0,8,3,10,4,6,6,"25",0,2,17,0,0,0,7981426,"2023-12-08T00:00:00.000Z",2,FALSE,20,3547269,"G",20,20,"New York Knicks","Immanuel Quickley",0,17,18,18,1,18.5
0,0,0,0,0,0,0,0,0,"00",0,0,0,0,0,0,7981426,"2023-12-08T00:00:00.000Z",2,FALSE,20,56677864,"G",2,2,"Boston Celtics","Jordan Walsh",0,0,0,0,0,0
3,0,2,5,2,16,9,4,3,"31",1,0,23,3,1,0,7981426,"2023-12-08T00:00:00.000Z",2,FALSE,20,666423,"F-G",20,20,"New York Knicks","RJ Barrett",1,26,29,26,6,34.1
3,1,4,4,3,15,7,4,3,"34",1,2,20,5,1,6,7981426,"2023-12-08T00:00:00.000Z",2,FALSE,20,387,"F",20,20,"New York Knicks","Julius Randle",2,25,28,23,8,30.5
2,0,3,0,0,6,5,2,0,"19",5,2,10,8,1,1,7981426,"2023-12-08T00:00:00.000Z",2,FALSE,20,399,"C",20,20,"New York Knicks","Mitchell Robinson",1,18,20,12,10,24.6
2,0,4,5,2,6,2,0,0,"22",0,2,6,4,0,1,7981426,"2023-12-08T00:00:00.000Z",2,FALSE,20,131,"G",20,20,"New York Knicks","Donte DiVincenzo",0,10,12,8,6,12.8
4,0,1,5,0,17,8,9,7,"34",0,3,23,1,1,1,7981426,"2023-12-08T00:00:00.000Z",2,FALSE,20,73,"G",20,20,"New York Knicks","Jalen Brunson",1,24,28,27,5,32.2
0,0,0,0,0,0,0,0,0,"00",0,0,0,0,0,0,7981426,"2023-12-08T00:00:00.000Z",2,FALSE,20,19,"G",20,20,"New York Knicks","Ryan Arcidiacono",0,0,0,0,0,0
0,0,0,0,0,0,0,0,0,"00",0,0,0,0,0,0,7981426,"2023-12-08T00:00:00.000Z",2,FALSE,20,17896063,"F",20,20,"New York Knicks","Jericho Sims",0,0,0,0,0,0
0,0,0,0,0,0,0,0,0,"00",0,0,0,0,0,0,7981426,"2023-12-08T00:00:00.000Z",2,FALSE,20,666474,"G",20,20,"New York Knicks","Charles Brown",0,0,0,0,0,0
0,0,0,0,0,0,0,0,0,"00",0,0,0,0,0,0,7981426,"2023-12-08T00:00:00.000Z",2,FALSE,20,59421201,"G",20,20,"New York Knicks","Jaylen Martin",0,0,0,0,0,0
0,0,0,0,0,0,0,0,0,"00",0,0,0,0,0,0,7981426,"2023-12-08T00:00:00.000Z",2,FALSE,20,56677795,"F",20,20,"New York Knicks","Jacob Toppin",0,0,0,0,0,0
0,0,0,0,0,0,0,0,0,"00",0,0,0,0,0,0,7981426,"2023-12-08T00:00:00.000Z",2,FALSE,20,666971,"G-F",20,20,"New York Knicks","Dylan Windler",0,0,0,0,0,0
2,0,8,6,3,8,5,1,1,"27",2,1,14,10,0,2,7981426,"2023-12-08T00:00:00.000Z",2,FALSE,20,219,"C-F",2,2,"Boston Celtics","Al Horford",0,24,26,16,12,27
1,0,0,0,0,3,2,0,0,"11",1,0,4,1,0,0,7981426,"2023-12-08T00:00:00.000Z",2,FALSE,20,261,"F-C",2,2,"Boston Celtics","Luke Kornet",0,5,6,5,2,6.7
0,0,0,0,0,0,0,0,0,"00",0,0,0,0,0,0,7981426,"2023-12-08T00:00:00.000Z",2,FALSE,20,338,"G",2,2,"Boston Celtics","Svi Mykhailiuk",0,0,0,0,0,0
2,0,1,3,1,4,2,0,0,"18",1,2,5,2,0,0,7981426,"2023-12-08T00:00:00.000Z",2,FALSE,20,3547276,"G",2,2,"Boston Celtics","Payton Pritchard",0,7,9,7,4,10.4
0,0,0,0,0,0,0,0,0,"00",0,0,0,0,0,0,7981426,"2023-12-08T00:00:00.000Z",2,FALSE,20,17553967,"C",2,2,"Boston Celtics","Neemias Queta",0,0,0,0,0,0
0,0,0,0,0,0,0,0,0,"00",0,0,0,0,0,0,7981426,"2023-12-08T00:00:00.000Z",2,FALSE,20,3547279,"F",2,2,"Boston Celtics","Lamar Stevens",0,0,0,0,0,0
0,0,0,0,0,0,0,0,0,"00",0,0,0,0,0,0,7981426,"2023-12-08T00:00:00.000Z",2,FALSE,20,38017707,"G",2,2,"Boston Celtics","JD Davison",0,0,0,0,0,0
0,0,0,0,0,0,0,0,0,"00",0,0,0,0,0,0,7981426,"2023-12-08T00:00:00.000Z",2,FALSE,20,3547295,"F-C",2,2,"Boston Celtics","Nathan Knight",0,0,0,0,0,0
1,3,1,3,1,7,4,0,0,"33",2,5,9,3,0,3,8258317,"2023-12-09T00:00:00.000Z",14,FALSE,12,666860,"F-G",14,14,"Los Angeles Lakers","Cameron Reddish",3,12,13,10,4,20.1
4,0,10,1,0,21,10,5,4,"35",1,5,24,11,2,6,8258317,"2023-12-09T00:00:00.000Z",14,FALSE,12,237,"F",14,14,"Los Angeles Lakers","LeBron James",2,35,39,28,15,43.2
5,4,15,0,0,24,16,13,9,"41",5,2,41,20,0,4,8258317,"2023-12-09T00:00:00.000Z",14,FALSE,12,117,"F-C",14,14,"Los Angeles Lakers","Anthony Davis",4,61,66,46,25,80.5
2,0,3,2,1,3,2,1,1,"19",0,4,6,3,0,1,8258317,"2023-12-09T00:00:00.000Z",14,FALSE,12,383,"F",14,14,"Los Angeles Lakers","Taurean Prince",0,9,11,8,5,11.6
7,1,3,3,0,15,6,2,1,"32",1,1,13,4,1,2,8258317,"2023-12-09T00:00:00.000Z",14,FALSE,12,405,"G",14,14,"Los Angeles Lakers","D'Angelo Russell",2,17,24,20,11,32.3
1,0,2,1,0,1,0,2,2,"19",0,1,2,2,1,1,8258317,"2023-12-09T00:00:00.000Z",14,FALSE,12,38017697,"G",14,14,"Los Angeles Lakers","Max Christie",1,4,5,3,3,7.9
0,0,0,0,0,1,0,0,0,"09",2,3,0,2,0,0,8258317,"2023-12-09T00:00:00.000Z",14,FALSE,12,666609,"F",14,14,"Los Angeles Lakers","Rui Hachimura",0,2,2,0,2,2.4
1,0,3,0,0,0,0,0,0,"07",1,1,0,4,0,1,8258317,"2023-12-09T00:00:00.000Z",14,FALSE,12,666626,"C",14,14,"Los Angeles Lakers","Jaxson Hayes",0,4,5,1,5,5.3
0,0,0,0,0,0,0,0,0,"01",0,1,0,0,0,0,8258317,"2023-12-09T00:00:00.000Z",14,FALSE,12,56677835,"G",14,14,"Los Angeles Lakers","Jalen Hood-Schifino",0,0,0,0,0,0
0,0,0,0,0,0,0,0,0,"01",0,0,0,0,0,0,8258317,"2023-12-09T00:00:00.000Z",14,FALSE,12,56677836,"F",14,14,"Los Angeles Lakers","Maxwell Lewis",0,0,0,0,0,0
3,0,2,3,0,15,9,12,10,"27",0,1,28,2,0,0,8258317,"2023-12-09T00:00:00.000Z",14,FALSE,12,17553995,"G",14,14,"Los Angeles Lakers","Austin Reaves",0,30,33,31,5,34.9
1,2,4,0,0,1,0,0,0,"16",0,1,0,4,1,0,8258317,"2023-12-09T00:00:00.000Z",14,FALSE,12,457,"F",14,14,"Los Angeles Lakers","Jarred Vanderbilt",3,4,5,1,5,15.3
0,0,0,0,0,0,0,0,0,"00",0,0,0,0,0,0,8258317,"2023-12-09T00:00:00.000Z",14,FALSE,12,486,"F",14,14,"Los Angeles Lakers","Christian Wood",0,0,0,0,0,0
0,0,0,0,0,0,0,0,0,"00",0,0,0,0,0,0,8258317,"2023-12-09T00:00:00.000Z",14,FALSE,12,56677738,"C",14,14,"Los Angeles Lakers","Colin Castleton",0,0,0,0,0,0
0,0,0,0,0,0,0,0,0,"00",0,0,0,0,0,0,8258317,"2023-12-09T00:00:00.000Z",14,FALSE,12,56677867,"F",14,14,"Los Angeles Lakers","Alex Fudge",0,0,0,0,0,0
0,0,0,0,0,0,0,0,0,"00",0,0,0,0,0,0,8258317,"2023-12-09T00:00:00.000Z",14,FALSE,12,1603383,"G",14,14,"Los Angeles Lakers","Gabe Vincent",0,0,0,0,0,0
4,0,4,9,2,11,3,0,0,"32",1,3,8,5,1,2,8258317,"2023-12-09T00:00:00.000Z",14,FALSE,12,210,"G",12,12,"Indiana Pacers","Buddy Hield",1,13,17,12,9,21
0,0,1,7,3,11,5,0,0,"29",1,5,13,2,0,0,8258317,"2023-12-09T00:00:00.000Z",14,FALSE,12,3547243,"F",12,12,"Indiana Pacers","Obi Toppin",0,15,15,13,2,15.4
1,0,6,5,1,11,3,4,3,"25",1,6,10,7,1,2,8258317,"2023-12-09T00:00:00.000Z",14,FALSE,12,452,"C-F",12,12,"Indiana Pacers","Myles Turner",1,17,18,11,8,20.9
1,1,2,2,0,9,2,0,0,"20",0,2,4,2,2,0,8258317,"2023-12-09T00:00:00.000Z",14,FALSE,12,69,"G",12,12,"Indiana Pacers","Bruce Brown",3,6,7,5,3,16.9
11,1,1,8,2,14,8,3,2,"35",0,1,20,1,1,3,8258317,"2023-12-09T00:00:00.000Z",14,FALSE,12,3547245,"G",12,12,"Indiana Pacers","Tyrese Haliburton",2,21,32,31,12,40.7
0,1,2,5,1,11,5,9,9,"30",0,4,20,2,1,0,8258317,"2023-12-09T00:00:00.000Z",14,FALSE,12,38017686,"G-F",12,12,"Indiana Pacers","Bennedict Mathurin",2,22,22,20,2,28.4
0,0,0,0,0,0,0,0,0,"00",0,0,0,0,0,0,8258317,"2023-12-09T00:00:00.000Z",14,FALSE,12,56677868,"G",14,14,"Los Angeles Lakers","D'Moi Hodge",0,0,0,0,0,0
0,0,0,0,0,1,0,0,0,"01",0,0,0,0,0,0,8258317,"2023-12-09T00:00:00.000Z",14,FALSE,12,38017701,"G",12,12,"Indiana Pacers","Kendall Brown",0,0,0,0,0,0
0,4,4,0,0,6,2,6,6,"19",1,3,10,5,0,1,8258317,"2023-12-09T00:00:00.000Z",14,FALSE,12,17896035,"F",12,12,"Indiana Pacers","Isaiah Jackson",4,15,15,10,5,27
9,0,1,0,0,11,3,2,2,"18",3,4,8,4,3,0,8258317,"2023-12-09T00:00:00.000Z",14,FALSE,12,304,"G",12,12,"Indiana Pacers","T.J. McConnell",3,12,21,17,13,35.3
1,0,2,5,1,10,4,7,6,"27",1,5,15,3,1,1,8258317,"2023-12-09T00:00:00.000Z",14,FALSE,12,3547250,"G-F",12,12,"Indiana Pacers","Aaron Nesmith",1,18,19,16,4,22.1
0,0,0,0,0,0,0,0,0,"00",0,0,0,0,0,0,8258317,"2023-12-09T00:00:00.000Z",14,FALSE,12,3547207,"F",12,12,"Indiana Pacers","Jordan Nwora",0,0,0,0,0,0
0,0,0,0,0,0,0,0,0,"01",0,0,0,0,0,0,8258317,"2023-12-09T00:00:00.000Z",14,FALSE,12,56677861,"G",12,12,"Indiana Pacers","Ben Sheppard",0,0,0,0,0,0
0,0,0,0,0,0,0,2,1,"01",1,0,1,1,0,0,8258317,"2023-12-09T00:00:00.000Z",14,FALSE,12,56677778,"F-C",12,12,"Indiana Pacers","Oscar Tshiebwe",0,2,2,1,1,2.2
0,0,0,0,0,0,0,0,0,"01",0,0,0,0,0,0,8258317,"2023-12-09T00:00:00.000Z",14,FALSE,12,56677832,"F",12,12,"Indiana Pacers","Jarace Walker",0,0,0,0,0,0
0,0,0,0,0,0,0,0,0,"01",0,0,0,0,0,0,8258317,"2023-12-09T00:00:00.000Z",14,FALSE,12,56677794,"G",12,12,"Indiana Pacers","Isaiah Wong",0,0,0,0,0,0
0,0,0,0,0,0,0,0,0,"00",0,0,0,0,0,0,8258317,"2023-12-09T00:00:00.000Z",14,FALSE,12,38017507,"G-F",12,12,"Indiana Pacers","Andrew Nembhard",0,0,0,0,0,0
0,0,0,0,0,0,0,0,0,"00",0,0,0,0,0,0,8258317,"2023-12-09T00:00:00.000Z",14,FALSE,12,3547264,"F-C",12,12,"Indiana Pacers","Jalen Smith",0,0,0,0,0,0
1,0,0,1,1,1,1,0,0,"08",0,0,3,0,1,0,1037893,"2023-12-11T00:00:00.000Z",19,FALSE,18,666767,"G",18,18,"Minnesota Timberwolves","Jordan McLaughlin",1,3,4,4,1,7.5
5,0,0,1,0,10,4,4,4,"20",1,4,12,1,0,1,1037893,"2023-12-11T00:00:00.000Z",19,FALSE,18,320,"G",18,18,"Minnesota Timberwolves","Shake Milton",0,13,18,17,6,19.7
0,0,0,0,0,1,1,1,1,"02",0,0,3,0,0,0,1037893,"2023-12-11T00:00:00.000Z",19,FALSE,18,38017715,"F",18,18,"Minnesota Timberwolves","Josh Minott",0,3,3,3,0,3
0,0,1,0,0,0,0,0,0,"02",0,0,0,1,0,0,1037893,"2023-12-11T00:00:00.000Z",19,FALSE,18,38017700,"G",18,18,"Minnesota Timberwolves","Wendell Moore Jr.",0,1,1,0,1,1.2
0,0,0,0,0,0,0,2,0,"02",0,0,0,0,0,0,1037893,"2023-12-11T00:00:00.000Z",19,FALSE,18,17895968,"F",18,18,"Minnesota Timberwolves","Daishen Nix",0,0,0,0,0,0
2,0,3,7,3,15,7,0,0,"24",3,3,17,6,1,0,1037893,"2023-12-11T00:00:00.000Z",19,FALSE,18,667378,"F-C",18,18,"Minnesota Timberwolves","Naz Reid",1,23,25,19,8,30.2
0,0,0,0,0,0,0,0,0,"00",0,0,0,0,0,0,1037893,"2023-12-11T00:00:00.000Z",19,FALSE,18,56677851,"G",18,18,"Minnesota Timberwolves","Jaylen Clark",0,0,0,0,0,0
0,0,0,0,0,0,0,0,0,"00",0,0,0,0,0,0,1037893,"2023-12-11T00:00:00.000Z",19,FALSE,18,3547238,"G",18,18,"Minnesota Timberwolves","Anthony Edwards",0,0,0,0,0,0
0,0,0,0,0,0,0,0,0,"00",0,0,0,0,0,0,1037893,"2023-12-11T00:00:00.000Z",19,FALSE,18,17896056,"C",18,18,"Minnesota Timberwolves","Luka Garza",0,0,0,0,0,0
5,0,3,5,2,13,5,9,8,"29",0,2,20,3,0,4,1037893,"2023-12-11T00:00:00.000Z",19,FALSE,18,227,"F",19,19,"New Orleans Pelicans","Brandon Ingram",0,23,28,25,8,27.1
2,1,3,0,0,17,13,12,10,"33",2,1,36,5,1,1,1037893,"2023-12-11T00:00:00.000Z",19,FALSE,18,666969,"F",19,19,"New Orleans Pelicans","Zion Williamson",2,41,43,38,7,50
4,2,10,1,0,9,5,7,4,"35",3,3,14,13,2,3,1037893,"2023-12-11T00:00:00.000Z",19,FALSE,18,455,"C",19,19,"New Orleans Pelicans","Jonas Valanciunas",4,27,31,18,17,44.6
5,0,7,3,1,7,2,3,2,"32",3,4,7,10,0,0,1037893,"2023-12-11T00:00:00.000Z",19,FALSE,18,17896024,"F",19,19,"New Orleans Pelicans","Herbert Jones",0,17,22,12,15,26.5
4,1,4,7,4,15,8,3,3,"29",0,2,23,4,1,1,1037893,"2023-12-11T00:00:00.000Z",19,FALSE,18,303,"G",19,19,"New Orleans Pelicans","CJ McCollum",2,27,31,27,8,38.8
3,1,1,3,0,5,0,0,0,"15",1,3,0,2,1,1,1037893,"2023-12-11T00:00:00.000Z",19,FALSE,18,17896097,"G",19,19,"New Orleans Pelicans","Jose Alvarado",2,2,5,3,5,11.9
2,1,1,1,1,3,1,4,3,"28",1,3,6,2,2,0,1037893,"2023-12-11T00:00:00.000Z",19,FALSE,18,38017677,"G",19,19,"New Orleans Pelicans","Dyson Daniels",3,8,10,8,4,20.4
0,0,0,0,0,1,0,0,0,"01",0,0,0,0,0,0,1037893,"2023-12-11T00:00:00.000Z",19,FALSE,18,56677837,"G",19,19,"New Orleans Pelicans","Jordan Hawkins",0,0,0,0,0,0
0,0,0,0,0,0,0,0,0,"00",0,0,0,0,0,0,1037893,"2023-12-11T00:00:00.000Z",19,FALSE,18,3547260,"G",19,19,"New Orleans Pelicans","Kira Lewis Jr.",0,0,0,0,0,0
1,1,5,2,1,4,2,0,0,"14",0,2,5,5,0,1,1037893,"2023-12-11T00:00:00.000Z",19,FALSE,18,3547293,"F",19,19,"New Orleans Pelicans","Naji Marshall",1,10,11,6,6,14.5
1,0,3,5,1,8,4,2,1,"24",0,0,10,3,0,2,1037893,"2023-12-11T00:00:00.000Z",19,FALSE,18,18677986,"F",19,19,"New Orleans Pelicans","Trey Murphy III",0,13,14,11,4,13.1
0,0,0,0,0,0,0,0,0,"00",0,0,0,0,0,0,1037893,"2023-12-11T00:00:00.000Z",19,FALSE,18,17896021,"F",19,19,"New Orleans Pelicans","Jeremiah Robinson-Earl",0,0,0,0,0,0
0,0,0,0,0,0,0,0,0,"00",0,0,0,0,0,0,1037893,"2023-12-11T00:00:00.000Z",19,FALSE,18,491,"C",19,19,"New Orleans Pelicans","Cody Zeller",0,0,0,0,0,0
0,0,0,0,0,0,0,0,0,"00",0,0,0,0,0,0,1037893,"2023-12-11T00:00:00.000Z",19,FALSE,18,38017663,"F",19,19,"New Orleans Pelicans","E.J. Liddell",0,0,0,0,0,0
0,0,0,0,0,0,0,0,0,"00",0,0,0,0,0,0,1037893,"2023-12-11T00:00:00.000Z",19,FALSE,18,340,"F",19,19,"New Orleans Pelicans","Larry Nance Jr.",0,0,0,0,0,0
0,0,0,0,0,0,0,0,0,"00",0,0,0,0,0,0,1037893,"2023-12-11T00:00:00.000Z",19,FALSE,18,17896017,"F",19,19,"New Orleans Pelicans","Matt Ryan",0,0,0,0,0,0
0,0,0,0,0,0,0,0,0,"00",0,0,0,0,0,0,1037893,"2023-12-11T00:00:00.000Z",19,FALSE,18,38017726,"G",19,19,"New Orleans Pelicans","Dereon Seabron",0,0,0,0,0,0
5,1,1,4,1,7,2,2,2,"24",0,4,7,1,1,4,1037893,"2023-12-11T00:00:00.000Z",19,FALSE,18,666400,"G",18,18,"Minnesota Timberwolves","Nickeil Alexander-Walker",2,8,13,12,6,17.7
1,0,9,3,1,11,5,7,6,"33",3,6,17,12,0,1,1037893,"2023-12-11T00:00:00.000Z",19,FALSE,18,447,"C",18,18,"Minnesota Timberwolves","Karl-Anthony Towns",0,29,30,18,13,31.9
0,2,6,0,0,8,4,0,0,"25",2,4,8,8,0,1,1037893,"2023-12-11T00:00:00.000Z",19,FALSE,18,176,"C",18,18,"Minnesota Timberwolves","Rudy Gobert",2,16,16,8,8,22.6
0,0,0,0,0,0,0,0,0,"00",0,0,0,0,0,0,1037893,"2023-12-11T00:00:00.000Z",19,FALSE,18,56677782,"F",18,18,"Minnesota Timberwolves","Leonard Miller",0,0,0,0,0,0
2,0,6,7,1,9,2,0,0,"27",0,1,5,6,0,0,1037893,"2023-12-11T00:00:00.000Z",19,FALSE,18,68,"F",18,18,"Minnesota Timberwolves","Troy Brown Jr.",0,11,13,7,8,15.2
7,0,4,7,4,11,6,2,1,"27",1,1,17,5,0,3,1037893,"2023-12-11T00:00:00.000Z",19,FALSE,18,104,"G",18,18,"Minnesota Timberwolves","Mike Conley",0,22,29,24,12,30.5
3,0,3,0,0,6,3,0,0,"19",1,1,6,4,2,0,1037893,"2023-12-11T00:00:00.000Z",19,FALSE,18,12,"F",18,18,"Minnesota Timberwolves","Kyle Anderson",2,10,13,9,7,21.3
0,0,3,6,2,12,5,1,0,"27",0,4,12,3,0,1,1037893,"2023-12-11T00:00:00.000Z",19,FALSE,18,3547259,"F",18,18,"Minnesota Timberwolves","Jaden McDaniels",0,15,15,12,3,14.6
2,2,3,4,2,8,4,0,0,"25",0,4,10,3,1,0,1037894,"2023-12-11T00:00:00.000Z",21,FALSE,29,56677833,"G",21,21,"Oklahoma City Thunder","Cason Wallace",3,13,15,12,5,25.6
3,0,2,2,2,10,5,3,3,"22",1,1,15,3,0,2,1037894,"2023-12-11T00:00:00.000Z",21,FALSE,29,38017703,"G-F",21,21,"Oklahoma City Thunder","Jalen Williams",0,18,21,18,6,21.1
2,2,6,3,2,9,6,2,2,"25",2,2,16,8,1,3,1037894,"2023-12-11T00:00:00.000Z",21,FALSE,29,38017685,"C-F",21,21,"Oklahoma City Thunder","Chet Holmgren",3,24,26,18,10,34.6
8,1,8,3,2,11,5,0,0,"24",2,1,12,10,1,3,1037894,"2023-12-11T00:00:00.000Z",21,FALSE,29,17896065,"G",21,21,"Oklahoma City Thunder","Josh Giddey",2,22,30,20,18,39
7,0,3,1,0,17,12,6,6,"28",1,1,30,4,3,1,1037894,"2023-12-11T00:00:00.000Z",21,FALSE,29,175,"G",21,21,"Oklahoma City Thunder","Shai Gilgeous-Alexander",3,34,41,37,11,53.3
1,1,0,2,1,2,1,0,0,"09",0,1,3,0,0,0,1037894,"2023-12-11T00:00:00.000Z",21,FALSE,29,44,"F",21,21,"Oklahoma City Thunder","Davis Bertans",1,3,4,4,1,7.5
3,0,3,4,3,7,6,4,3,"26",0,2,18,3,0,1,1037894,"2023-12-11T00:00:00.000Z",21,FALSE,29,38017716,"F",21,21,"Oklahoma City Thunder","Ousmane Dieng",0,21,24,21,6,25.1
1,1,0,7,3,8,3,0,0,"14",0,1,9,0,0,0,1037894,"2023-12-11T00:00:00.000Z",21,FALSE,29,3547272,"G",21,21,"Oklahoma City Thunder","Isaiah Joe",1,9,10,10,1,13.5
0,0,2,1,0,6,2,0,0,"13",0,2,4,2,0,1,1037894,"2023-12-11T00:00:00.000Z",21,FALSE,29,17896036,"G",21,21,"Oklahoma City Thunder","Tre Mann",0,6,6,4,2,5.4
5,0,1,3,0,5,1,0,0,"16",0,0,2,1,1,0,1037894,"2023-12-11T00:00:00.000Z",21,FALSE,29,4197029,"G",21,21,"Oklahoma City Thunder","Vasilije Micic",1,3,8,7,6,13.7
0,0,1,2,0,2,0,0,0,"09",0,0,0,1,0,0,1037894,"2023-12-11T00:00:00.000Z",21,FALSE,29,3547271,"C",21,21,"Oklahoma City Thunder","Aleksej Pokusevski",0,1,1,0,1,1.2
1,0,0,4,1,4,1,0,0,"08",0,2,3,0,0,0,1037894,"2023-12-11T00:00:00.000Z",21,FALSE,29,27924547,"F",21,21,"Oklahoma City Thunder","Lindy Waters III",0,3,4,4,1,4.5
0,0,0,1,1,4,1,0,0,"04",1,0,3,1,0,0,1037894,"2023-12-11T00:00:00.000Z",21,FALSE,29,17896078,"G",21,21,"Oklahoma City Thunder","Aaron Wiggins",0,4,4,3,1,4.2
1,0,1,1,1,2,2,2,2,"10",0,0,7,1,1,1,1037894,"2023-12-11T00:00:00.000Z",21,FALSE,29,38017706,"F",21,21,"Oklahoma City Thunder","Jaylin Williams",1,8,9,8,2,11.7
1,0,2,0,0,1,1,0,0,"07",0,0,2,2,1,0,1037894,"2023-12-11T00:00:00.000Z",21,FALSE,29,480,"G-F",21,21,"Oklahoma City Thunder","Kenrich Williams",1,4,5,3,3,8.9
0,0,0,0,0,0,0,0,0,"00",0,0,0,0,0,0,1037894,"2023-12-11T00:00:00.000Z",21,FALSE,29,666541,"G",21,21,"Oklahoma City Thunder","Luguentz Dort",0,0,0,0,0,0
0,0,0,0,0,0,0,0,0,"00",0,0,0,0,0,0,1037894,"2023-12-11T00:00:00.000Z",21,FALSE,29,56677853,"F",21,21,"Oklahoma City Thunder","Keyontae Johnson",0,0,0,0,0,0
0,0,0,0,0,0,0,0,0,"00",0,0,0,0,0,0,1037894,"2023-12-11T00:00:00.000Z",21,FALSE,29,24572055,"C",21,21,"Oklahoma City Thunder","Olivier Sarr",0,0,0,0,0,0
2,1,1,1,0,4,1,0,0,"22",0,1,2,1,3,1,1037894,"2023-12-11T00:00:00.000Z",21,FALSE,29,38017620,"G",29,29,"Utah Jazz","Ochai Agbaji",4,3,5,4,3,17.2
1,4,1,6,3,11,7,2,2,"23",1,1,19,2,0,0,1037894,"2023-12-11T00:00:00.000Z",21,FALSE,29,38017739,"F",29,29,"Utah Jazz","Simone Fontecchio",4,21,22,20,3,34.9
3,0,6,2,0,5,1,0,0,"21",0,2,2,6,0,2,1037894,"2023-12-11T00:00:00.000Z",21,FALSE,29,358,"F",29,29,"Utah Jazz","Kelly Olynyk",0,8,11,5,9,11.7
7,0,3,9,5,17,10,5,5,"33",0,0,30,3,1,3,1037894,"2023-12-11T00:00:00.000Z",21,FALSE,29,56677834,"G",29,29,"Utah Jazz","Keyonte George",1,33,40,37,10,44.1
5,1,2,4,0,13,3,2,2,"22",2,1,8,4,1,2,1037894,"2023-12-11T00:00:00.000Z",21,FALSE,29,100,"G",29,29,"Utah Jazz","Jordan Clarkson",2,12,17,13,9,24.3
2,1,2,4,1,6,3,1,1,"26",0,2,8,2,1,0,1037894,"2023-12-11T00:00:00.000Z",21,FALSE,29,56677824,"F",29,29,"Utah Jazz","Taylor Hendricks",2,10,12,10,4,19.4
2,1,1,3,1,7,3,4,4,"15",0,5,11,1,0,2,1037894,"2023-12-11T00:00:00.000Z",21,FALSE,29,666650,"G",29,29,"Utah Jazz","Talen Horton-Tucker",1,12,14,13,3,16.2
0,0,0,0,0,0,0,0,0,"00",0,0,0,0,0,0,1037894,"2023-12-11T00:00:00.000Z",21,FALSE,29,38017705,"C",29,29,"Utah Jazz","Walker Kessler",0,0,0,0,0,0
1,0,7,4,1,10,6,1,1,"17",0,3,14,7,0,2,1037894,"2023-12-11T00:00:00.000Z",21,FALSE,29,666881,"F",29,29,"Utah Jazz","Luka Samanic",0,21,22,15,8,21.9
2,0,2,4,1,13,7,6,5,"26",2,1,20,4,2,0,1037894,"2023-12-11T00:00:00.000Z",21,FALSE,29,413,"G",29,29,"Utah Jazz","Collin Sexton",2,24,26,22,6,33.8
0,1,3,0,0,2,1,0,0,"10",2,3,2,5,0,3,1037894,"2023-12-11T00:00:00.000Z",21,FALSE,29,11891374,"C",29,29,"Utah Jazz","Omer Yurtseven",1,7,7,2,5,8
0,0,0,0,0,0,0,0,0,"00",0,0,0,0,0,0,1037894,"2023-12-11T00:00:00.000Z",21,FALSE,29,17896023,"G",29,29,"Utah Jazz","Josh Christopher",0,0,0,0,0,0
0,0,0,0,0,0,0,0,0,"00",0,0,0,0,0,0,1037894,"2023-12-11T00:00:00.000Z",21,FALSE,29,101,"F-C",29,29,"Utah Jazz","John Collins",0,0,0,0,0,0
0,0,0,0,0,0,0,0,0,"00",0,0,0,0,0,0,1037894,"2023-12-11T00:00:00.000Z",21,FALSE,29,38017630,"G",29,29,"Utah Jazz","Johnny Juzang",0,0,0,0,0,0
0,0,0,0,0,0,0,0,0,"00",0,0,0,0,0,0,1037894,"2023-12-11T00:00:00.000Z",21,FALSE,29,297,"F",29,29,"Utah Jazz","Lauri Markkanen",0,0,0,0,0,0
0,0,0,0,0,0,0,0,0,"00",0,0,0,0,0,0,1037894,"2023-12-11T00:00:00.000Z",21,FALSE,29,19465584,"F",29,29,"Utah Jazz","Micah Potter",0,0,0,0,0,0
0,0,0,0,0,0,0,0,0,"00",0,0,0,0,0,0,1037894,"2023-12-11T00:00:00.000Z",21,FALSE,29,56677842,"F",29,29,"Utah Jazz","Brice Sensabaugh",0,0,0,0,0,0
7,0,4,1,0,4,2,0,0,"25",2,2,4,6,1,0,1037894,"2023-12-11T00:00:00.000Z",21,FALSE,29,139,"G",29,29,"Utah Jazz","Kris Dunn",1,10,17,11,13,24.7
1,1,2,4,3,7,5,1,1,"27",0,1,14,2,0,1,1037895,"2023-12-11T00:00:00.000Z",26,FALSE,3,30,"F",26,26,"Sacramento Kings","Harrison Barnes",1,16,17,15,3,19.9
3,0,2,4,4,13,9,2,2,"34",1,4,24,3,0,0,1037895,"2023-12-11T00:00:00.000Z",26,FALSE,3,38017688,"F",26,26,"Sacramento Kings","Keegan Murray",0,27,30,27,6,32.1
9,0,12,1,1,14,6,4,2,"34",4,2,15,16,2,4,1037895,"2023-12-11T00:00:00.000Z",26,FALSE,3,406,"F",26,26,"Sacramento Kings","Domantas Sabonis",2,31,40,24,25,49.7
1,0,1,5,2,6,2,0,0,"17",0,4,6,1,0,0,1037895,"2023-12-11T00:00:00.000Z",26,FALSE,3,221,"G",26,26,"Sacramento Kings","Kevin Huerter",0,7,8,7,2,8.7
8,0,3,10,5,22,10,6,4,"33",0,4,29,3,0,3,1037895,"2023-12-11T00:00:00.000Z",26,FALSE,3,161,"G",26,26,"Sacramento Kings","De'Aaron Fox",0,32,40,37,11,41.6
1,0,0,1,0,1,0,0,0,"03",0,0,0,0,0,0,1037895,"2023-12-11T00:00:00.000Z",26,FALSE,3,17896030,"G",26,26,"Sacramento Kings","Chris Duarte",0,0,1,1,1,1.5
0,0,0,0,0,0,0,0,0,"03",0,0,0,0,0,0,1037895,"2023-12-11T00:00:00.000Z",26,FALSE,3,17896044,"F",26,26,"Sacramento Kings","Kessler Edwards",0,0,0,0,0,0
2,0,1,4,1,4,1,0,0,"14",0,1,3,1,1,0,1037895,"2023-12-11T00:00:00.000Z",26,FALSE,3,38017714,"G",26,26,"Sacramento Kings","Keon Ellis",1,4,6,5,3,10.2
0,0,0,0,0,0,0,0,0,"01",0,1,0,0,0,0,1037895,"2023-12-11T00:00:00.000Z",26,FALSE,3,56677845,"G",26,26,"Sacramento Kings","Colby Jones",0,0,0,0,0,0
1,1,6,6,5,7,6,0,0,"23",0,0,17,6,0,0,1037895,"2023-12-11T00:00:00.000Z",26,FALSE,3,290,"F",26,26,"Sacramento Kings","Trey Lyles",1,23,24,18,7,28.7
2,0,1,0,0,2,0,0,0,"08",2,3,0,3,0,1,1037895,"2023-12-11T00:00:00.000Z",26,FALSE,3,306,"C",26,26,"Sacramento Kings","JaVale McGee",0,3,5,2,5,5.6
0,1,4,2,0,4,1,0,0,"11",1,2,2,5,0,1,1037895,"2023-12-11T00:00:00.000Z",26,FALSE,3,4197162,"F",26,26,"Sacramento Kings","Aleksandar Vezenkov",1,7,7,2,5,10
0,0,0,0,0,0,0,0,0,"00",0,0,0,0,0,0,1037895,"2023-12-11T00:00:00.000Z",26,FALSE,3,17895990,"G",26,26,"Sacramento Kings","Jordan Ford",0,0,0,0,0,0
0,0,0,0,0,0,0,0,0,"00",0,0,0,0,0,0,1037895,"2023-12-11T00:00:00.000Z",26,FALSE,3,273,"C",26,26,"Sacramento Kings","Alex Len",0,0,0,0,0,0
5,0,3,5,3,13,6,7,7,"37",2,1,22,5,0,5,1037895,"2023-12-11T00:00:00.000Z",26,FALSE,3,61,"F",3,3,"Brooklyn Nets","Mikal Bridges",0,27,32,27,10,30.5
2,0,4,4,3,13,6,0,0,"31",0,0,15,4,1,1,1037895,"2023-12-11T00:00:00.000Z",26,FALSE,3,666679,"F",3,3,"Brooklyn Nets","Cameron Johnson",1,19,21,17,6,24.8
0,3,6,0,0,6,3,2,2,"26",4,2,8,10,0,0,1037895,"2023-12-11T00:00:00.000Z",26,FALSE,3,666508,"F-C",3,3,"Brooklyn Nets","Nicolas Claxton",3,18,18,8,10,29
3,0,0,6,2,20,7,2,2,"31",0,2,18,0,0,2,1037895,"2023-12-11T00:00:00.000Z",26,FALSE,3,17896048,"G",3,3,"Brooklyn Nets","Cam Thomas",0,18,21,21,3,20.5
7,0,2,8,2,15,6,5,4,"34",0,2,18,2,0,3,1037895,"2023-12-11T00:00:00.000Z",26,FALSE,3,130,"G",3,3,"Brooklyn Nets","Spencer Dinwiddie",0,20,27,25,9,27.9
1,0,0,0,0,1,1,0,0,"04",0,0,2,0,0,0,1037895,"2023-12-11T00:00:00.000Z",26,FALSE,3,9051997,"G",3,3,"Brooklyn Nets","Armoni Brooks",0,2,3,3,1,3.5
1,2,3,4,3,6,5,0,0,"25",0,0,13,3,1,0,1037895,"2023-12-11T00:00:00.000Z",26,FALSE,3,158,"F",3,3,"Brooklyn Nets","Dorian Finney-Smith",3,16,17,14,4,27.1
2,1,6,0,0,4,2,0,0,"14",1,2,4,7,1,1,1037895,"2023-12-11T00:00:00.000Z",26,FALSE,3,17896038,"C",3,3,"Brooklyn Nets","Day'Ron Sharpe",2,11,13,6,9,20.4
0,0,0,0,0,1,1,0,0,"04",1,0,2,1,0,0,1037895,"2023-12-11T00:00:00.000Z",26,FALSE,3,56677722,"F",3,3,"Brooklyn Nets","Jalen Wilson",0,3,3,2,1,3.2
0,0,0,0,0,0,0,0,0,"00",0,0,0,0,0,0,1037895,"2023-12-11T00:00:00.000Z",26,FALSE,3,56677843,"F",3,3,"Brooklyn Nets","Noah Clowney",0,0,0,0,0,0
0,0,0,0,0,0,0,0,0,"00",0,0,0,0,0,0,1037895,"2023-12-11T00:00:00.000Z",26,FALSE,3,17896041,"G",3,3,"Brooklyn Nets","Keon Johnson",0,0,0,0,0,0
0,0,0,0,0,0,0,0,0,"00",0,0,0,0,0,0,1037895,"2023-12-11T00:00:00.000Z",26,FALSE,3,417,"G-F",3,3,"Brooklyn Nets","Ben Simmons",0,0,0,0,0,0
0,0,0,0,0,0,0,0,0,"00",0,0,0,0,0,0,1037895,"2023-12-11T00:00:00.000Z",26,FALSE,3,421,"G",3,3,"Brooklyn Nets","Dennis Smith Jr.",0,0,0,0,0,0
0,0,0,0,0,0,0,0,0,"00",0,0,0,0,0,0,1037895,"2023-12-11T00:00:00.000Z",26,FALSE,3,464,"G",3,3,"Brooklyn Nets","Lonnie Walker IV",0,0,0,0,0,0
0,0,0,0,0,0,0,0,0,"00",0,0,0,0,0,0,1037895,"2023-12-11T00:00:00.000Z",26,FALSE,3,56677841,"F",3,3,"Brooklyn Nets","Dariq Whitehead",0,0,0,0,0,0
1,0,0,1,0,1,0,0,0,"03",1,0,0,1,0,0,1037895,"2023-12-11T00:00:00.000Z",26,FALSE,3,17553994,"G",26,26,"Sacramento Kings","Davion Mitchell",0,1,2,1,2,2.7
9,0,1,7,4,13,8,1,1,"28",1,0,21,2,1,2,1037895,"2023-12-11T00:00:00.000Z",26,FALSE,3,324,"G",26,26,"Sacramento Kings","Malik Monk",1,23,32,30,11,37.9
0,0,0,0,0,0,0,0,0,"01",0,2,0,0,0,1,1037895,"2023-12-11T00:00:00.000Z",26,FALSE,3,56677862,"F",26,26,"Sacramento Kings","Jalen Slawson",0,0,0,0,0,-1
0,0,0,1,0,2,1,1,1,"04",0,1,3,0,0,0,1037895,"2023-12-11T00:00:00.000Z",26,FALSE,3,174,"F-C",3,3,"Brooklyn Nets","Harry Giles III",0,3,3,3,0,3
1,0,3,1,1,3,1,2,2,"19",1,0,5,4,0,0,1037895,"2023-12-11T00:00:00.000Z",26,FALSE,3,351,"F",3,3,"Brooklyn Nets","Royce O'Neale",0,9,10,6,5,11.3
2,0,4,0,0,4,3,2,2,"11",1,3,8,5,1,1,1037895,"2023-12-11T00:00:00.000Z",26,FALSE,3,17896058,"F",3,3,"Brooklyn Nets","Trendon Watford",1,13,15,10,7,19
4,0,1,4,1,6,3,2,2,"29",2,2,9,3,0,0,1037896,"2023-12-11T00:00:00.000Z",13,FALSE,25,666743,"G",13,13,"LA Clippers","Terance Mann",0,12,16,13,7,18.6
5,0,6,8,3,19,11,9,9,"39",0,2,34,6,3,1,1037896,"2023-12-11T00:00:00.000Z",13,FALSE,25,274,"F",13,13,"LA Clippers","Kawhi Leonard",3,40,45,39,11,56.7
2,2,3,0,0,13,9,0,0,"34",3,2,18,6,0,0,1037896,"2023-12-11T00:00:00.000Z",13,FALSE,25,493,"C",13,13,"LA Clippers","Ivica Zubac",2,24,26,20,8,34.2
8,1,5,8,2,17,7,4,4,"41",3,4,20,8,1,1,1037896,"2023-12-11T00:00:00.000Z",13,FALSE,25,172,"F",13,13,"LA Clippers","Paul George",2,28,36,28,16,46.6
7,2,7,6,3,14,7,3,3,"37",0,2,20,7,1,3,1037896,"2023-12-11T00:00:00.000Z",13,FALSE,25,192,"G",13,13,"LA Clippers","James Harden",3,27,34,27,14,44.9
0,0,0,0,0,0,0,0,0,"00",0,0,0,0,0,0,1037896,"2023-12-11T00:00:00.000Z",13,FALSE,25,17896022,"G",13,13,"LA Clippers","Brandon Boston Jr.",0,0,0,0,0,0
0,0,0,1,0,1,0,0,0,"05",0,1,0,0,0,0,1037896,"2023-12-11T00:00:00.000Z",13,FALSE,25,56677849,"F",13,13,"LA Clippers","Kobe Brown",0,0,0,0,0,0
0,0,0,0,0,0,0,0,0,"00",0,0,0,0,0,0,1037896,"2023-12-11T00:00:00.000Z",13,FALSE,25,666511,"G",13,13,"LA Clippers","Amir Coffey",0,0,0,0,0,0
6,1,1,2,1,7,5,2,1,"16",1,1,12,2,0,4,1037896,"2023-12-11T00:00:00.000Z",13,FALSE,25,472,"G",13,13,"LA Clippers","Russell Westbrook",1,14,20,18,8,22.4
0,0,0,0,0,0,0,0,0,"00",0,0,0,0,0,0,1037896,"2023-12-11T00:00:00.000Z",13,FALSE,25,371,"F-C",13,13,"LA Clippers","Mason Plumlee",0,0,0,0,0,0
0,0,0,0,0,0,0,0,0,"00",0,0,0,0,0,0,1037896,"2023-12-11T00:00:00.000Z",13,FALSE,25,17896051,"G",13,13,"LA Clippers","Joshua Primo",0,0,0,0,0,0
0,0,0,0,0,0,0,0,0,"00",0,0,0,0,0,0,1037896,"2023-12-11T00:00:00.000Z",13,FALSE,25,56677856,"G",13,13,"LA Clippers","Jordan Miller",0,0,0,0,0,0
0,0,0,0,0,0,0,0,0,"00",0,0,0,0,0,0,1037896,"2023-12-11T00:00:00.000Z",13,FALSE,25,24417679,"G",13,13,"LA Clippers","Xavier Moon",0,0,0,0,0,0
1,2,3,4,2,9,6,2,2,"25",0,4,16,3,1,0,1037896,"2023-12-11T00:00:00.000Z",13,FALSE,25,380,"F-G",13,13,"LA Clippers","Norman Powell",3,19,20,17,4,30.1
0,1,0,1,1,3,1,0,0,"14",0,2,3,0,1,0,1037896,"2023-12-11T00:00:00.000Z",13,FALSE,25,439,"F",13,13,"LA Clippers","Daniel Theis",2,3,3,3,0,9
0,0,0,0,0,0,0,0,0,"00",0,0,0,0,0,0,1037896,"2023-12-11T00:00:00.000Z",13,FALSE,25,450,"F",13,13,"LA Clippers","PJ Tucker",0,0,0,0,0,0
0,0,0,0,0,0,0,0,0,"00",0,0,0,0,0,0,1037896,"2023-12-11T00:00:00.000Z",13,FALSE,25,38017725,"F",13,13,"LA Clippers","Moussa Diabate",0,0,0,0,0,0
0,0,0,0,0,0,0,0,0,"00",0,0,0,0,0,0,1037896,"2023-12-11T00:00:00.000Z",13,FALSE,25,17896031,"G",13,13,"LA Clippers","Nah'Shon Hyland",0,0,0,0,0,0
4,0,1,6,2,11,4,0,0,"26",2,3,10,3,1,1,1037896,"2023-12-11T00:00:00.000Z",13,FALSE,25,56783340,"C",25,25,"Portland Trail Blazers","Duop Reath",1,13,17,14,7,21.6
6,0,2,9,4,17,8,9,7,"40",1,2,27,3,1,2,1037896,"2023-12-11T00:00:00.000Z",13,FALSE,25,38017690,"G",25,25,"Portland Trail Blazers","Shaedon Sharpe",1,30,36,33,9,40.6
4,1,1,11,5,23,10,13,13,"38",0,1,38,1,0,3,1037896,"2023-12-11T00:00:00.000Z",13,FALSE,25,419,"G",25,25,"Portland Trail Blazers","Anfernee Simons",1,39,43,42,5,45.2
6,2,3,4,3,16,8,0,0,"30",1,5,19,4,0,3,1037896,"2023-12-11T00:00:00.000Z",13,FALSE,25,56677747,"G",25,25,"Portland Trail Blazers","Scoot Henderson",2,23,29,25,10,35.8
1,0,5,2,1,4,3,2,2,"22",3,1,9,8,1,1,1037896,"2023-12-11T00:00:00.000Z",13,FALSE,25,38017711,"F",25,25,"Portland Trail Blazers","Jabari Walker",1,17,18,10,9,22.1
0,0,8,0,0,7,3,0,0,"16",4,1,6,12,0,1,1037896,"2023-12-11T00:00:00.000Z",13,FALSE,25,666476,"C",25,25,"Portland Trail Blazers","Moses Brown",0,18,18,6,12,19.4
0,0,0,0,0,0,0,0,0,"00",0,0,0,0,0,0,1037896,"2023-12-11T00:00:00.000Z",13,FALSE,25,65,"G",25,25,"Portland Trail Blazers","Malcolm Brogdon",0,0,0,0,0,0
0,0,0,0,0,0,0,0,0,"00",0,0,0,0,0,0,1037896,"2023-12-11T00:00:00.000Z",13,FALSE,25,3547289,"G",25,25,"Portland Trail Blazers","Skylar Mays",0,0,0,0,0,0
0,0,0,0,0,0,0,0,0,"00",0,0,0,0,0,0,1037896,"2023-12-11T00:00:00.000Z",13,FALSE,25,56677791,"F",25,25,"Portland Trail Blazers","Kris Murray",0,0,0,0,0,0
0,0,0,0,0,0,0,0,0,"00",0,0,0,0,0,0,1037896,"2023-12-11T00:00:00.000Z",13,FALSE,25,56677829,"G-F",25,25,"Portland Trail Blazers","Rayan Rupert",0,0,0,0,0,0
0,0,0,0,0,0,0,0,0,"00",0,0,0,0,0,0,1037896,"2023-12-11T00:00:00.000Z",13,FALSE,25,22,"C",25,25,"Portland Trail Blazers","Deandre Ayton",0,0,0,0,0,0
0,0,0,0,0,0,0,0,0,"00",0,0,0,0,0,0,1037896,"2023-12-11T00:00:00.000Z",13,FALSE,25,39613724,"C",25,25,"Portland Trail Blazers","Ibou Badji",0,0,0,0,0,0
0,0,0,0,0,0,0,0,0,"00",0,0,0,0,0,0,1037896,"2023-12-11T00:00:00.000Z",13,FALSE,25,182,"F",25,25,"Portland Trail Blazers","Jerami Grant",0,0,0,0,0,0
0,0,0,0,0,0,0,0,0,"00",0,0,0,0,0,0,1037896,"2023-12-11T00:00:00.000Z",13,FALSE,25,47957121,"F",25,25,"Portland Trail Blazers","Justin Minaya",0,0,0,0,0,0
0,0,0,0,0,0,0,0,0,"00",0,0,0,0,0,0,1037896,"2023-12-11T00:00:00.000Z",13,FALSE,25,17896120,"F",25,25,"Portland Trail Blazers","Ish Wainright",0,0,0,0,0,0
0,0,1,5,3,6,4,0,0,"31",0,3,11,1,1,0,1037896,"2023-12-11T00:00:00.000Z",13,FALSE,25,666923,"G-F",25,25,"Portland Trail Blazers","Matisse Thybulle",1,12,12,11,1,15.2
4,1,4,3,1,6,3,2,0,"37",0,5,7,4,1,1,1037896,"2023-12-11T00:00:00.000Z",13,FALSE,25,56677850,"F",25,25,"Portland Trail Blazers","Toumani Camara",2,11,15,11,8,22.8
0,0,0,0,0,0,0,0,0,"00",0,0,0,0,0,0,1037896,"2023-12-11T00:00:00.000Z",13,FALSE,25,476,"C-F",25,25,"Portland Trail Blazers","Robert Williams III",0,0,0,0,0,0
7,0,6,3,1,12,7,4,2,"32",0,4,17,6,1,0,1037884,"2023-12-11T00:00:00.000Z",4,FALSE,16,204,"F",4,4,"Charlotte Hornets","Gordon Hayward",1,23,30,24,13,37.7
1,0,3,6,2,14,7,2,2,"34",1,3,18,4,0,2,1037884,"2023-12-11T00:00:00.000Z",4,FALSE,16,62,"F",4,4,"Charlotte Hornets","Miles Bridges",0,22,23,19,5,22.3
1,0,3,0,0,6,2,2,2,"26",3,1,6,6,0,0,1037884,"2023-12-11T00:00:00.000Z",4,FALSE,16,3547282,"C",4,4,"Charlotte Hornets","Nick Richards",0,12,13,7,7,14.7
2,0,4,8,3,14,6,1,1,"30",0,5,16,4,0,2,1037884,"2023-12-11T00:00:00.000Z",4,FALSE,16,56677823,"F",4,4,"Charlotte Hornets","Brandon Miller",0,20,22,18,6,21.8
13,0,1,13,8,17,10,7,6,"39",1,4,34,2,0,3,1037884,"2023-12-11T00:00:00.000Z",4,FALSE,16,403,"G",4,4,"Charlotte Hornets","Terry Rozier",0,36,49,47,15,52.9
0,0,0,0,0,0,0,0,0,"00",0,0,0,0,0,0,1037884,"2023-12-11T00:00:00.000Z",4,FALSE,16,56677866,"F",4,4,"Charlotte Hornets","Leaky Black",0,0,0,0,0,0
0,0,0,0,0,0,0,0,0,"00",0,0,0,0,0,0,1037884,"2023-12-11T00:00:00.000Z",4,FALSE,16,17896037,"G",4,4,"Charlotte Hornets","James Bouknight",0,0,0,0,0,0
0,0,0,0,0,0,0,0,0,"00",0,0,0,0,0,0,1037884,"2023-12-11T00:00:00.000Z",4,FALSE,16,3547253,"G",4,4,"Charlotte Hornets","Theo Maledon",0,0,0,0,0,0
1,0,1,2,0,4,1,2,1,"23",0,2,3,1,0,1,1037884,"2023-12-11T00:00:00.000Z",4,FALSE,16,38017708,"G",4,4,"Charlotte Hornets","Bryce McGowens",0,4,5,4,2,4.7
3,0,0,1,1,4,2,0,0,"15",0,0,5,0,1,2,1037884,"2023-12-11T00:00:00.000Z",4,FALSE,16,422,"G",4,4,"Charlotte Hornets","Ish Smith",1,5,8,8,3,10.5
0,1,0,2,0,2,0,0,0,"09",0,0,0,0,1,0,1037884,"2023-12-11T00:00:00.000Z",4,FALSE,16,18678001,"F",4,4,"Charlotte Hornets","JT Thor",2,0,0,0,0,6
3,1,7,6,2,11,5,4,3,"32",1,3,15,8,0,0,1037884,"2023-12-11T00:00:00.000Z",4,FALSE,16,666950,"F",4,4,"Charlotte Hornets","P.J. Washington",1,23,26,18,11,32.1
0,0,0,0,0,0,0,0,0,"00",0,0,0,0,0,0,1037884,"2023-12-11T00:00:00.000Z",4,FALSE,16,56677848,"G",4,4,"Charlotte Hornets","Amari Bailey",0,0,0,0,0,0
0,0,0,0,0,0,0,0,0,"00",0,0,0,0,0,0,1037884,"2023-12-11T00:00:00.000Z",4,FALSE,16,3547239,"G",4,4,"Charlotte Hornets","LaMelo Ball",0,0,0,0,0,0
0,0,0,0,0,0,0,0,0,"00",0,0,0,0,0,0,1037884,"2023-12-11T00:00:00.000Z",4,FALSE,16,666748,"F",4,4,"Charlotte Hornets","Cody Martin",0,0,0,0,0,0
0,0,0,0,0,0,0,0,0,"00",0,0,0,0,0,0,1037884,"2023-12-11T00:00:00.000Z",4,FALSE,16,347,"G",4,4,"Charlotte Hornets","Frank Ntilikina",0,0,0,0,0,0
0,0,0,0,0,0,0,0,0,"00",0,0,0,0,0,0,1037884,"2023-12-11T00:00:00.000Z",4,FALSE,16,56677846,"G",4,4,"Charlotte Hornets","Nick Smith Jr.",0,0,0,0,0,0
5,0,7,4,1,14,7,7,5,"39",2,3,20,9,0,3,1037884,"2023-12-11T00:00:00.000Z",4,FALSE,16,666747,"F",16,16,"Miami Heat","Caleb Martin",0,29,34,25,14,35.3
2,2,5,2,1,5,2,4,2,"23",1,5,7,6,0,1,1037884,"2023-12-11T00:00:00.000Z",4,FALSE,16,39398582,"C",16,16,"Miami Heat","Orlando Robinson",2,13,15,9,8,22.2
4,0,6,9,5,14,8,3,3,"33",1,0,24,7,2,0,1037884,"2023-12-11T00:00:00.000Z",4,FALSE,16,397,"F",16,16,"Miami Heat","Duncan Robinson",2,31,35,28,11,44.4
5,0,4,4,1,6,1,2,0,"35",1,3,3,5,2,1,1037884,"2023-12-11T00:00:00.000Z",4,FALSE,16,286,"G",16,16,"Miami Heat","Kyle Lowry",2,8,13,8,10,21.5
1,0,0,3,2,8,5,6,6,"24",0,6,18,0,0,2,1037884,"2023-12-11T00:00:00.000Z",4,FALSE,16,56677785,"G",16,16,"Miami Heat","Jaime Jaquez Jr.",0,18,19,19,1,17.5
4,0,4,4,0,7,0,2,2,"25",0,0,2,4,1,0,1037884,"2023-12-11T00:00:00.000Z",4,FALSE,16,391,"G-F",16,16,"Miami Heat","Josh Richardson",1,6,10,6,8,15.8
8,1,2,1,1,12,7,9,8,"36",2,4,23,4,1,3,1037884,"2023-12-11T00:00:00.000Z",4,FALSE,16,79,"G-F",16,16,"Miami Heat","Jimmy Butler",2,27,35,31,12,42.8
1,0,5,8,4,11,7,1,1,"21",1,1,19,6,1,0,1037884,"2023-12-11T00:00:00.000Z",4,FALSE,16,285,"F-C",16,16,"Miami Heat","Kevin Love",1,25,26,20,7,30.7
1,0,2,0,0,0,0,0,0,"04",0,0,0,2,0,0,1037884,"2023-12-11T00:00:00.000Z",4,FALSE,16,74,"C",16,16,"Miami Heat","Thomas Bryant",0,2,3,1,3,3.9
0,0,0,0,0,0,0,0,0,"00",0,0,0,0,0,0,1037884,"2023-12-11T00:00:00.000Z",4,FALSE,16,38017734,"F",16,16,"Miami Heat","Jamal Cain",0,0,0,0,0,0
0,0,0,0,0,0,0,0,0,"00",0,0,0,0,0,0,1037884,"2023-12-11T00:00:00.000Z",4,FALSE,16,3547257,"G",16,16,"Miami Heat","R.J. Hampton",0,0,0,0,0,0
0,0,0,0,0,0,0,0,0,"00",0,0,0,0,0,0,1037884,"2023-12-11T00:00:00.000Z",4,FALSE,16,38017736,"F",16,16,"Miami Heat","Cole Swider",0,0,0,0,0,0
0,0,0,0,0,0,0,0,0,"00",0,0,0,0,0,0,1037884,"2023-12-11T00:00:00.000Z",4,FALSE,16,4,"C-F",16,16,"Miami Heat","Bam Adebayo",0,0,0,0,0,0
0,0,0,0,0,0,0,0,0,"00",0,0,0,0,0,0,1037884,"2023-12-11T00:00:00.000Z",4,FALSE,16,666633,"G",16,16,"Miami Heat","Tyler Herro",0,0,0,0,0,0
0,0,0,0,0,0,0,0,0,"00",0,0,0,0,0,0,1037884,"2023-12-11T00:00:00.000Z",4,FALSE,16,3092,"",16,16,"Miami Heat","Haywood Highsmith",0,0,0,0,0,0
0,0,0,0,0,0,0,0,0,"00",0,0,0,0,0,0,1037884,"2023-12-11T00:00:00.000Z",4,FALSE,16,38017696,"F",16,16,"Miami Heat","Nikola Jovic",0,0,0,0,0,0
0,0,0,0,0,0,0,0,0,"00",0,0,0,0,0,0,1037884,"2023-12-11T00:00:00.000Z",4,FALSE,16,19465585,"G",16,16,"Miami Heat","Dru Smith",0,0,0,0,0,0
0,0,0,0,0,0,0,0,0,"00",0,0,0,0,0,0,1037884,"2023-12-11T00:00:00.000Z",4,FALSE,16,38017698,"C",4,4,"Charlotte Hornets","Mark Williams",0,0,0,0,0,0
2,0,1,9,3,14,5,7,4,"34",0,2,17,1,3,2,1037885,"2023-12-11T00:00:00.000Z",9,FALSE,12,54,"F",9,9,"Detroit Pistons","Bojan Bogdanovic",3,18,20,19,3,28.2
2,1,4,2,1,10,8,5,3,"33",2,4,20,6,1,1,1037885,"2023-12-11T00:00:00.000Z",9,FALSE,12,56677826,"G-F",9,9,"Detroit Pistons","Ausar Thompson",2,26,28,22,8,35.2
2,0,6,1,1,5,5,4,2,"34",1,3,13,7,0,2,1037885,"2023-12-11T00:00:00.000Z",9,FALSE,12,3547267,"F-C",9,9,"Detroit Pistons","Isaiah Stewart",0,20,22,15,9,22.4
7,0,6,6,1,21,11,0,0,"38",0,3,23,6,1,3,1037885,"2023-12-11T00:00:00.000Z",9,FALSE,12,17896075,"G-F",9,9,"Detroit Pistons","Cade Cunningham",1,29,36,30,13,40.7
7,0,1,0,0,4,2,2,2,"23",0,0,6,1,1,2,1037885,"2023-12-11T00:00:00.000Z",9,FALSE,12,3547241,"G",9,9,"Detroit Pistons","Killian Hayes",1,7,14,13,8,18.7
0,0,0,0,0,0,0,0,0,"00",0,0,0,0,0,0,1037885,"2023-12-11T00:00:00.000Z",9,FALSE,12,24,"F",9,9,"Detroit Pistons","Marvin Bagley III",0,0,0,0,0,0
0,0,0,3,2,6,4,4,4,"13",0,0,14,0,1,1,1037885,"2023-12-11T00:00:00.000Z",9,FALSE,12,77,"G",9,9,"Detroit Pistons","Alec Burks",1,14,14,14,0,16
0,0,0,0,0,0,0,0,0,"00",0,0,0,0,0,0,1037885,"2023-12-11T00:00:00.000Z",9,FALSE,12,197,"F-G",9,9,"Detroit Pistons","Joe Harris",0,0,0,0,0,0
2,0,2,3,0,15,7,4,4,"34",1,2,18,3,1,2,1037885,"2023-12-11T00:00:00.000Z",9,FALSE,12,38017682,"G",9,9,"Detroit Pistons","Jaden Ivey",1,21,23,20,5,25.6
0,0,0,0,0,0,0,0,0,"01",0,0,0,0,0,0,1037885,"2023-12-11T00:00:00.000Z",9,FALSE,12,259,"F",9,9,"Detroit Pistons","Kevin Knox",0,0,0,0,0,0
3,0,2,5,2,5,2,2,2,"17",0,1,8,2,2,0,1037885,"2023-12-11T00:00:00.000Z",9,FALSE,12,17896071,"F",9,9,"Detroit Pistons","Isaiah Livers",2,10,13,11,5,20.9
0,0,0,0,0,0,0,0,0,"00",0,0,0,0,0,0,1037885,"2023-12-11T00:00:00.000Z",9,FALSE,12,56677792,"G",9,9,"Detroit Pistons","Marcus Sasser",0,0,0,0,0,0
0,0,0,0,0,0,0,0,0,"00",0,0,0,0,0,0,1037885,"2023-12-11T00:00:00.000Z",9,FALSE,12,56677832,"F",12,12,"Indiana Pacers","Jarace Walker",0,0,0,0,0,0
0,0,0,0,0,0,0,0,0,"00",0,0,0,0,0,0,1037885,"2023-12-11T00:00:00.000Z",9,FALSE,12,38017701,"G",12,12,"Indiana Pacers","Kendall Brown",0,0,0,0,0,0
0,0,0,0,0,0,0,0,0,"00",0,0,0,0,0,0,1037885,"2023-12-11T00:00:00.000Z",9,FALSE,12,38017507,"G-F",12,12,"Indiana Pacers","Andrew Nembhard",0,0,0,0,0,0
0,0,0,0,0,0,0,0,0,"00",0,0,0,0,0,0,1037885,"2023-12-11T00:00:00.000Z",9,FALSE,12,3547264,"F-C",12,12,"Indiana Pacers","Jalen Smith",0,0,0,0,0,0
0,0,0,0,0,0,0,0,0,"00",0,0,0,0,0,0,1037885,"2023-12-11T00:00:00.000Z",9,FALSE,12,56677794,"G",12,12,"Indiana Pacers","Isaiah Wong",0,0,0,0,0,0
1,3,2,0,0,1,1,2,2,"13",2,3,4,4,1,1,1037885,"2023-12-11T00:00:00.000Z",9,FALSE,12,3547240,"C",9,9,"Detroit Pistons","James Wiseman",4,8,9,5,5,21.3
0,0,0,0,0,0,0,0,0,"00",0,0,0,0,0,0,1037885,"2023-12-11T00:00:00.000Z",9,FALSE,12,56677729,"G",9,9,"Detroit Pistons","Malcolm Cazalon",0,0,0,0,0,0
0,0,0,0,0,0,0,0,0,"00",0,0,0,0,0,0,1037885,"2023-12-11T00:00:00.000Z",9,FALSE,12,38017694,"C",9,9,"Detroit Pistons","Jalen Duren",0,0,0,0,0,0
0,0,0,0,0,0,0,0,0,"00",0,0,0,0,0,0,1037885,"2023-12-11T00:00:00.000Z",9,FALSE,12,330,"G",9,9,"Detroit Pistons","Monte Morris",0,0,0,0,0,0
0,0,0,0,0,0,0,0,0,"00",0,0,0,0,0,0,1037885,"2023-12-11T00:00:00.000Z",9,FALSE,12,42097199,"G",9,9,"Detroit Pistons","Jared Rhoden",0,0,0,0,0,0
0,0,0,0,0,0,0,0,0,"00",0,0,0,0,0,0,1037885,"2023-12-11T00:00:00.000Z",9,FALSE,12,44477024,"G",9,9,"Detroit Pistons","Stanley Umude",0,0,0,0,0,0
2,0,4,7,4,9,6,0,0,"31",0,1,16,4,1,0,1037885,"2023-12-11T00:00:00.000Z",9,FALSE,12,210,"G",12,12,"Indiana Pacers","Buddy Hield",1,20,22,18,6,26.8
0,0,3,2,0,5,3,0,0,"12",0,1,6,3,0,2,1037885,"2023-12-11T00:00:00.000Z",9,FALSE,12,3547243,"F",12,12,"Indiana Pacers","Obi Toppin",0,9,9,6,3,7.6
1,3,5,2,0,15,10,6,3,"31",3,2,23,8,1,2,1037885,"2023-12-11T00:00:00.000Z",9,FALSE,12,452,"C-F",12,12,"Indiana Pacers","Myles Turner",4,31,32,24,9,44.1
0,0,6,4,0,11,4,4,3,"37",3,3,11,9,2,1,1037885,"2023-12-11T00:00:00.000Z",9,FALSE,12,69,"G",12,12,"Indiana Pacers","Bruce Brown",2,20,20,11,9,26.8
16,2,4,6,3,12,5,1,1,"33",0,2,14,4,1,7,1037885,"2023-12-11T00:00:00.000Z",9,FALSE,12,3547245,"G",12,12,"Indiana Pacers","Tyrese Haliburton",3,18,34,30,20,44.8
8,0,4,5,3,17,10,8,7,"37",3,3,30,7,2,2,1037885,"2023-12-11T00:00:00.000Z",9,FALSE,12,38017686,"G-F",12,12,"Indiana Pacers","Bennedict Mathurin",2,37,45,38,15,54.4
1,0,1,4,3,7,5,0,0,"27",0,3,13,1,0,2,1037885,"2023-12-11T00:00:00.000Z",9,FALSE,12,3547250,"G-F",12,12,"Indiana Pacers","Aaron Nesmith",0,14,15,14,2,13.7
0,0,3,0,0,6,5,0,0,"17",2,3,10,5,0,0,1037885,"2023-12-11T00:00:00.000Z",9,FALSE,12,17896035,"F",12,12,"Indiana Pacers","Isaiah Jackson",0,15,15,10,5,16
5,0,2,1,0,10,4,0,0,"15",0,2,8,2,1,2,1037885,"2023-12-11T00:00:00.000Z",9,FALSE,12,304,"G",12,12,"Indiana Pacers","T.J. McConnell",1,10,15,13,7,18.9
0,0,0,0,0,0,0,0,0,"00",0,0,0,0,0,0,1037885,"2023-12-11T00:00:00.000Z",9,FALSE,12,3547207,"F",12,12,"Indiana Pacers","Jordan Nwora",0,0,0,0,0,0
0,0,0,0,0,0,0,0,0,"00",0,0,0,0,0,0,1037885,"2023-12-11T00:00:00.000Z",9,FALSE,12,56677861,"G",12,12,"Indiana Pacers","Ben Sheppard",0,0,0,0,0,0
0,0,0,0,0,0,0,0,0,"00",0,0,0,0,0,0,1037885,"2023-12-11T00:00:00.000Z",9,FALSE,12,56677778,"F-C",12,12,"Indiana Pacers","Oscar Tshiebwe",0,0,0,0,0,0
4,0,7,5,0,18,7,7,5,"33",1,4,19,8,0,1,1037886,"2023-12-11T00:00:00.000Z",22,FALSE,6,17896026,"F",22,22,"Orlando Magic","Franz Wagner",0,27,31,23,12,33.6
4,0,6,3,0,21,9,3,2,"36",4,0,20,10,1,8,1037886,"2023-12-11T00:00:00.000Z",22,FALSE,6,38017683,"F",22,22,"Orlando Magic","Paolo Banchero",1,30,34,24,14,33
2,4,4,0,0,8,6,4,3,"29",3,3,15,7,0,0,1037886,"2023-12-11T00:00:00.000Z",22,FALSE,6,666442,"C",22,22,"Orlando Magic","Goga Bitadze",4,22,24,17,9,38.4
2,1,3,4,2,6,4,2,2,"28",1,2,12,4,0,1,1037886,"2023-12-11T00:00:00.000Z",22,FALSE,6,17896073,"G",22,22,"Orlando Magic","Jalen Suggs",1,16,18,14,6,21.8
0,1,1,1,0,2,0,0,0,"19",0,3,0,1,3,1,1037886,"2023-12-11T00:00:00.000Z",22,FALSE,6,56677827,"G",22,22,"Orlando Magic","Anthony Black",4,1,1,0,1,12.2
4,0,1,1,1,6,3,2,1,"18",1,3,8,2,0,0,1037886,"2023-12-11T00:00:00.000Z",22,FALSE,6,3547251,"G",22,22,"Orlando Magic","Cole Anthony",0,10,14,12,6,16.4
2,1,1,3,1,3,1,0,0,"26",0,2,3,1,0,0,1037886,"2023-12-11T00:00:00.000Z",22,FALSE,6,196,"G",22,22,"Orlando Magic","Gary Harris",1,4,6,5,3,10.2
3,1,3,4,2,5,2,6,6,"20",1,2,12,4,0,1,1037886,"2023-12-11T00:00:00.000Z",22,FALSE,6,226,"F",22,22,"Orlando Magic","Joe Ingles",1,16,19,15,7,23.3
1,0,3,3,1,6,3,0,0,"13",1,0,7,4,2,0,1037886,"2023-12-11T00:00:00.000Z",22,FALSE,6,229,"F",22,22,"Orlando Magic","Jonathan Isaac",2,11,12,8,5,19.3
0,0,2,2,0,9,4,1,0,"18",0,3,8,2,1,0,1037886,"2023-12-11T00:00:00.000Z",22,FALSE,6,462,"C",22,22,"Orlando Magic","Moritz Wagner",1,10,10,8,2,13.4
3,0,1,5,0,9,1,6,4,"26",1,4,6,2,1,3,1037886,"2023-12-11T00:00:00.000Z",22,FALSE,6,666908,"G",6,6,"Cleveland Cavaliers","Max Strus",1,8,11,9,5,12.9
0,0,2,4,2,5,3,2,1,"29",4,2,9,6,3,2,1037886,"2023-12-11T00:00:00.000Z",22,FALSE,6,666940,"F",6,6,"Cleveland Cavaliers","Dean Wade",3,15,15,9,6,23.2
1,0,5,0,0,3,2,0,0,"15",2,6,4,7,1,1,1037886,"2023-12-11T00:00:00.000Z",22,FALSE,6,9,"C",6,6,"Cleveland Cavaliers","Jarrett Allen",1,11,12,5,8,15.9
3,1,2,10,2,18,6,9,8,"37",1,3,22,3,3,2,1037886,"2023-12-11T00:00:00.000Z",22,FALSE,6,322,"G",6,6,"Cleveland Cavaliers","Donovan Mitchell",4,25,28,25,6,40.1
5,0,5,9,3,23,11,12,11,"39",1,0,36,6,2,3,1037886,"2023-12-11T00:00:00.000Z",22,FALSE,6,666581,"G",6,6,"Cleveland Cavaliers","Darius Garland",2,42,47,41,11,53.7
0,0,0,0,0,0,0,0,0,"00",0,0,0,0,0,0,1037886,"2023-12-11T00:00:00.000Z",22,FALSE,6,248,"C",6,6,"Cleveland Cavaliers","Damian Jones",0,0,0,0,0,0
1,0,2,4,2,6,2,0,0,"17",1,2,6,3,0,1,1037886,"2023-12-11T00:00:00.000Z",22,FALSE,6,3547299,"G",6,6,"Cleveland Cavaliers","Sam Merrill",0,9,10,7,4,10.1
0,0,3,5,0,10,0,0,0,"22",1,3,0,4,0,0,1037886,"2023-12-11T00:00:00.000Z",22,FALSE,6,344,"F",6,6,"Cleveland Cavaliers","Georges Niang",0,4,4,0,4,4.8
0,0,1,4,0,4,0,4,1,"26",3,2,1,4,0,1,1037886,"2023-12-11T00:00:00.000Z",22,FALSE,6,3547247,"F-G",6,6,"Cleveland Cavaliers","Isaac Okoro",0,5,5,1,4,4.8
2,2,9,0,0,7,5,0,0,"29",3,1,10,12,0,0,1037886,"2023-12-11T00:00:00.000Z",22,FALSE,6,444,"C-F",6,6,"Cleveland Cavaliers","Tristan Thompson",2,22,24,12,14,33.4
0,0,0,0,0,0,0,0,0,"00",0,0,0,0,0,0,1037886,"2023-12-11T00:00:00.000Z",22,FALSE,6,404,"G",6,6,"Cleveland Cavaliers","Ricky Rubio",0,0,0,0,0,0
0,0,0,0,0,0,0,0,0,"00",0,0,0,0,0,0,1037886,"2023-12-11T00:00:00.000Z",22,FALSE,6,38017607,"G",22,22,"Orlando Magic","Kevon Harris",0,0,0,0,0,0
0,0,0,0,0,0,0,0,0,"00",0,0,0,0,0,0,1037886,"2023-12-11T00:00:00.000Z",22,FALSE,6,17553983,"G",22,22,"Orlando Magic","Trevelin Queen",0,0,0,0,0,0
0,0,0,0,0,0,0,0,0,"00",0,0,0,0,0,0,1037886,"2023-12-11T00:00:00.000Z",22,FALSE,6,666885,"F",22,22,"Orlando Magic","Admiral Schofield",0,0,0,0,0,0
0,0,0,0,0,0,0,0,0,"00",0,0,0,0,0,0,1037886,"2023-12-11T00:00:00.000Z",22,FALSE,6,85,"F",22,22,"Orlando Magic","Wendell Carter Jr.",0,0,0,0,0,0
0,0,0,0,0,0,0,0,0,"00",0,0,0,0,0,0,1037886,"2023-12-11T00:00:00.000Z",22,FALSE,6,165,"G",22,22,"Orlando Magic","Markelle Fultz",0,0,0,0,0,0
0,0,0,0,0,0,0,0,0,"00",0,0,0,0,0,0,1037886,"2023-12-11T00:00:00.000Z",22,FALSE,6,38017724,"G",22,22,"Orlando Magic","Caleb Houstan",0,0,0,0,0,0
0,0,0,0,0,0,0,0,0,"00",0,0,0,0,0,0,1037886,"2023-12-11T00:00:00.000Z",22,FALSE,6,56677839,"G",22,22,"Orlando Magic","Jett Howard",0,0,0,0,0,0
0,0,0,0,0,0,0,0,0,"00",0,0,0,0,0,0,1037886,"2023-12-11T00:00:00.000Z",22,FALSE,6,666818,"F",22,22,"Orlando Magic","Chuma Okeke",0,0,0,0,0,0
0,0,0,0,0,0,0,0,0,"00",0,0,0,0,0,0,1037886,"2023-12-11T00:00:00.000Z",22,FALSE,6,56677872,"G",6,6,"Cleveland Cavaliers","Craig Porter",0,0,0,0,0,0
0,0,0,0,0,0,0,0,0,"00",0,0,0,0,0,0,1037886,"2023-12-11T00:00:00.000Z",22,FALSE,6,56677847,"F",6,6,"Cleveland Cavaliers","Emoni Bates",0,0,0,0,0,0
0,0,0,0,0,0,0,0,0,"00",0,0,0,0,0,0,1037886,"2023-12-11T00:00:00.000Z",22,FALSE,6,666676,"G",6,6,"Cleveland Cavaliers","Ty Jerome",0,0,0,0,0,0
0,0,0,0,0,0,0,0,0,"00",0,0,0,0,0,0,1037886,"2023-12-11T00:00:00.000Z",22,FALSE,6,277,"G",6,6,"Cleveland Cavaliers","Caris LeVert",0,0,0,0,0,0
0,0,0,0,0,0,0,0,0,"00",0,0,0,0,0,0,1037886,"2023-12-11T00:00:00.000Z",22,FALSE,6,17896076,"F-C",6,6,"Cleveland Cavaliers","Evan Mobley",0,0,0,0,0,0
0,0,0,0,0,0,0,0,0,"00",0,0,0,0,0,0,1037886,"2023-12-11T00:00:00.000Z",22,FALSE,6,38017662,"F",6,6,"Cleveland Cavaliers","Isaiah Mobley",0,0,0,0,0,0
1,2,2,3,0,5,2,0,0,"20",0,0,4,2,1,0,1037887,"2023-12-11T00:00:00.000Z",23,FALSE,30,33,"F-G",23,23,"Philadelphia 76ers","Nicolas Batum",3,6,7,5,3,16.9
6,0,4,2,1,5,2,6,5,"30",0,1,10,4,0,0,1037887,"2023-12-11T00:00:00.000Z",23,FALSE,30,200,"F",23,23,"Philadelphia 76ers","Tobias Harris",0,14,20,16,10,23.8
6,1,10,5,2,20,14,4,4,"30",0,4,34,10,2,7,1037887,"2023-12-11T00:00:00.000Z",23,FALSE,30,145,"F-C",23,23,"Philadelphia 76ers","Joel Embiid",3,44,50,40,16,57
5,0,2,7,1,11,2,0,0,"27",1,3,5,3,5,2,1037887,"2023-12-11T00:00:00.000Z",23,FALSE,30,313,"G",23,23,"Philadelphia 76ers","De'Anthony Melton",5,8,13,10,8,29.1
6,0,1,9,5,13,8,3,3,"25",0,1,24,1,0,2,1037887,"2023-12-11T00:00:00.000Z",23,FALSE,30,3547254,"G",23,23,"Philadelphia 76ers","Tyrese Maxey",0,25,31,30,7,32.2
2,2,3,1,0,6,2,2,2,"08",3,1,6,6,0,0,1037887,"2023-12-11T00:00:00.000Z",23,FALSE,30,28,"C",23,23,"Philadelphia 76ers","Mo Bamba",2,12,14,8,8,22.2
2,0,1,4,3,6,4,1,1,"11",1,2,12,2,0,0,1037887,"2023-12-11T00:00:00.000Z",23,FALSE,30,45,"G",23,23,"Philadelphia 76ers","Patrick Beverley",0,14,16,14,4,17.4
0,0,3,3,2,3,2,2,2,"14",1,1,8,4,1,0,1037887,"2023-12-11T00:00:00.000Z",23,FALSE,30,108,"F",23,23,"Philadelphia 76ers","Robert Covington",1,12,12,8,4,15.8
1,0,1,4,3,4,3,2,1,"09",0,0,10,1,0,0,1037887,"2023-12-11T00:00:00.000Z",23,FALSE,30,2175,"",23,23,"Philadelphia 76ers","Danuel House Jr.",0,11,12,11,2,12.7
3,0,4,3,1,8,3,2,2,"26",2,1,9,6,1,3,1037887,"2023-12-11T00:00:00.000Z",23,FALSE,30,3547242,"F",30,30,"Washington Wizards","Deni Avdija",1,15,18,12,9,20.7
1,0,7,2,1,17,9,4,2,"28",2,0,21,9,0,2,1037887,"2023-12-11T00:00:00.000Z",23,FALSE,30,265,"F",30,30,"Washington Wizards","Kyle Kuzma",0,30,31,22,10,31.3
1,0,1,3,0,4,0,2,0,"20",3,3,0,4,0,0,1037887,"2023-12-11T00:00:00.000Z",23,FALSE,30,337,"F-C",30,30,"Washington Wizards","Mike Muscala",0,4,5,1,5,6.3
3,0,0,3,1,11,3,4,4,"26",0,1,11,0,0,3,1037887,"2023-12-11T00:00:00.000Z",23,FALSE,30,666848,"G",30,30,"Washington Wizards","Jordan Poole",0,11,14,14,3,12.5
3,0,5,5,1,9,4,0,0,"21",0,0,9,5,1,2,1037887,"2023-12-11T00:00:00.000Z",23,FALSE,30,249,"G",30,30,"Washington Wizards","Tyus Jones",1,14,17,12,8,20.5
1,0,4,3,2,5,3,2,2,"17",0,2,10,4,0,0,1037887,"2023-12-11T00:00:00.000Z",23,FALSE,30,38017704,"F",30,30,"Washington Wizards","Patrick Baldwin Jr.",0,14,15,11,5,16.3
0,0,0,2,0,4,1,0,0,"06",1,1,2,1,0,1,1037887,"2023-12-11T00:00:00.000Z",23,FALSE,30,NA,NA,NA,30,"Washington Wizards","NA NA",0,3,3,2,1,2.2
4,0,0,0,0,7,5,3,2,"19",0,2,12,0,2,1,1037887,"2023-12-11T00:00:00.000Z",23,FALSE,30,18677954,"G",30,30,"Washington Wizards","Jared Butler",2,12,16,16,4,23
4,1,5,7,2,11,4,6,3,"31",3,0,13,8,1,3,1037887,"2023-12-11T00:00:00.000Z",23,FALSE,30,56677844,"G",30,30,"Washington Wizards","Bilal Coulibaly",2,21,25,17,12,31.6
0,0,1,0,0,0,0,2,2,"11",0,2,2,1,0,2,1037887,"2023-12-11T00:00:00.000Z",23,FALSE,30,167,"F",30,30,"Washington Wizards","Danilo Gallinari",0,3,3,2,1,1.2
0,1,3,0,0,2,1,2,1,"10",1,2,3,4,0,2,1037887,"2023-12-11T00:00:00.000Z",23,FALSE,30,3547302,"F",30,30,"Washington Wizards","Anthony Gill",1,7,7,3,4,8.8
1,0,1,3,1,6,3,4,2,"23",1,4,9,2,0,3,1037887,"2023-12-11T00:00:00.000Z",23,FALSE,30,17896045,"F",30,30,"Washington Wizards","Corey Kispert",0,11,12,10,3,9.9
0,0,0,0,0,1,0,0,0,"02",0,1,0,0,0,0,1037887,"2023-12-11T00:00:00.000Z",23,FALSE,30,17896106,"F",30,30,"Washington Wizards","Eugene Omoruyi",0,0,0,0,0,0
0,0,0,0,0,0,0,0,0,"00",0,0,0,0,0,0,1037887,"2023-12-11T00:00:00.000Z",23,FALSE,30,38017687,"G",30,30,"Washington Wizards","Johnny Davis",0,0,0,0,0,0
0,0,0,0,0,0,0,0,0,"00",0,0,0,0,0,0,1037887,"2023-12-11T00:00:00.000Z",23,FALSE,30,666577,"F",30,30,"Washington Wizards","Daniel Gafford",0,0,0,0,0,0
0,0,0,0,0,0,0,0,0,"00",0,0,0,0,0,0,1037887,"2023-12-11T00:00:00.000Z",23,FALSE,30,38017712,"G",30,30,"Washington Wizards","Ryan Rollins",0,0,0,0,0,0
0,0,0,0,0,0,0,0,0,"00",0,0,0,0,0,0,1037887,"2023-12-11T00:00:00.000Z",23,FALSE,30,414,"G",30,30,"Washington Wizards","Landry Shamet",0,0,0,0,0,0
0,0,0,0,0,0,0,0,0,"00",0,0,0,0,0,0,1037887,"2023-12-11T00:00:00.000Z",23,FALSE,30,487,"G",30,30,"Washington Wizards","Delon Wright",0,0,0,0,0,0
1,0,2,3,2,6,5,0,0,"12",0,3,12,2,1,0,1037887,"2023-12-11T00:00:00.000Z",23,FALSE,30,328,"F",23,23,"Philadelphia 76ers","Marcus Morris",1,14,15,13,3,18.9
1,0,4,4,1,8,3,0,0,"17",1,3,7,5,1,0,1037887,"2023-12-11T00:00:00.000Z",23,FALSE,30,360,"F",23,23,"Philadelphia 76ers","Kelly Oubre Jr.",1,12,13,8,6,17.5
3,1,4,0,0,2,2,1,0,"13",2,3,4,6,0,0,1037887,"2023-12-11T00:00:00.000Z",23,FALSE,30,3547270,"F",23,23,"Philadelphia 76ers","Paul Reed",1,10,13,7,9,18.7
0,0,0,1,0,5,2,2,2,"09",0,3,6,0,2,1,1037887,"2023-12-11T00:00:00.000Z",23,FALSE,30,17896025,"G",23,23,"Philadelphia 76ers","Jaden Springer",2,6,6,6,0,11
0,0,0,0,0,0,0,0,0,"00",0,0,0,0,0,0,1037887,"2023-12-11T00:00:00.000Z",23,FALSE,30,56913527,"G",23,23,"Philadelphia 76ers","Ricky Council IV",0,0,0,0,0,0
0,0,0,0,0,0,0,0,0,"00",0,0,0,0,0,0,1037887,"2023-12-11T00:00:00.000Z",23,FALSE,30,17554001,"G",23,23,"Philadelphia 76ers","Javonte Smart",0,0,0,0,0,0
0,0,0,0,0,0,0,0,0,"00",0,0,0,0,0,0,1037887,"2023-12-11T00:00:00.000Z",23,FALSE,30,56677788,"G",23,23,"Philadelphia 76ers","Terquavion Smith",0,0,0,0,0,0
2,0,0,0,0,0,0,2,2,"09",0,1,2,0,1,1,1037887,"2023-12-11T00:00:00.000Z",23,FALSE,30,260,"G-F",23,23,"Philadelphia 76ers","Furkan Korkmaz",1,2,4,4,2,7
1,0,1,0,0,1,1,0,0,"06",0,1,2,1,0,0,1037887,"2023-12-11T00:00:00.000Z",23,FALSE,30,3547294,"F",23,23,"Philadelphia 76ers","Kenyon Martin Jr.",0,3,4,3,2,4.7
1,0,0,5,1,5,1,0,0,"17",0,1,3,0,1,0,1037888,"2023-12-11T00:00:00.000Z",1,FALSE,8,666754,"G",1,1,"Atlanta Hawks","Garrison Mathews",1,3,4,4,1,7.5
2,1,3,4,1,11,6,4,3,"40",1,2,16,4,1,0,1037888,"2023-12-11T00:00:00.000Z",1,FALSE,8,3547256,"F",1,1,"Atlanta Hawks","Saddiq Bey",2,20,22,18,6,29.8
2,0,4,0,0,11,6,2,2,"28",4,5,14,8,1,0,1037888,"2023-12-11T00:00:00.000Z",1,FALSE,8,83,"C",1,1,"Atlanta Hawks","Clint Capela",1,22,24,16,10,29.6
3,0,2,8,3,23,8,2,2,"38",4,2,21,6,1,2,1037888,"2023-12-11T00:00:00.000Z",1,FALSE,8,334,"G",1,1,"Atlanta Hawks","Dejounte Murray",1,27,30,24,9,33.7
9,0,1,5,2,11,5,7,7,"26",0,2,19,1,1,5,1037888,"2023-12-11T00:00:00.000Z",1,FALSE,8,490,"G",1,1,"Atlanta Hawks","Trae Young",1,20,29,28,10,31.7
3,0,2,17,10,24,14,2,2,"36",1,4,40,3,2,1,1037888,"2023-12-11T00:00:00.000Z",1,FALSE,8,53,"G",1,1,"Atlanta Hawks","Bogdan Bogdanovic",2,43,46,43,6,53.1
1,0,5,0,0,10,7,5,4,"29",7,2,18,12,0,2,1037888,"2023-12-11T00:00:00.000Z",1,FALSE,8,177,"F",8,8,"Denver Nuggets","Aaron Gordon",0,30,31,19,13,31.9
8,2,6,1,1,13,9,7,6,"36",2,3,25,8,3,1,1037888,"2023-12-11T00:00:00.000Z",1,FALSE,8,246,"C",8,8,"Denver Nuggets","Nikola Jokic",5,33,41,33,16,60.6
2,1,3,2,0,6,1,8,6,"30",0,2,8,3,0,2,1037888,"2023-12-11T00:00:00.000Z",1,FALSE,8,81,"G",8,8,"Denver Nuggets","Kentavious Caldwell-Pope",1,11,13,10,5,15.6
4,2,8,5,4,15,12,1,1,"29",1,1,29,9,1,6,1037888,"2023-12-11T00:00:00.000Z",1,FALSE,8,335,"G",8,8,"Denver Nuggets","Jamal Murray",3,38,42,33,13,48.8
1,0,2,0,0,3,2,2,2,"11",0,2,6,2,0,0,1037888,"2023-12-11T00:00:00.000Z",1,FALSE,8,38017709,"G",8,8,"Denver Nuggets","Christian Braun",0,8,9,7,3,9.9
0,0,0,0,0,0,0,0,0,"00",0,0,0,0,0,0,1037888,"2023-12-11T00:00:00.000Z",1,FALSE,8,215,"F-G",8,8,"Denver Nuggets","Justin Holiday",0,0,0,0,0,0
6,0,1,5,1,10,5,1,1,"19",0,0,12,1,0,1,1037888,"2023-12-11T00:00:00.000Z",1,FALSE,8,236,"G",8,8,"Denver Nuggets","Reggie Jackson",0,13,19,18,7,21.2
0,0,0,0,0,0,0,0,0,"00",0,0,0,0,0,0,1037888,"2023-12-11T00:00:00.000Z",1,FALSE,8,250,"C",8,8,"Denver Nuggets","DeAndre Jordan",0,0,0,0,0,0
1,2,3,1,0,2,1,1,1,"12",1,3,3,4,0,1,1037888,"2023-12-11T00:00:00.000Z",1,FALSE,8,3547268,"F-C",8,8,"Denver Nuggets","Zeke Nnaji",2,7,8,4,5,14.3
0,0,0,0,0,0,0,0,0,"00",0,0,0,0,0,0,1037888,"2023-12-11T00:00:00.000Z",1,FALSE,8,56677582,"G",8,8,"Denver Nuggets","Jalen Pickett",0,0,0,0,0,0
2,0,1,11,6,16,8,0,0,"28",0,1,22,1,5,2,1037888,"2023-12-11T00:00:00.000Z",1,FALSE,8,56677776,"G",8,8,"Denver Nuggets","Julian Strawther",5,23,25,24,3,39.2
0,0,0,0,0,0,0,0,0,"00",0,0,0,0,0,0,1037888,"2023-12-11T00:00:00.000Z",1,FALSE,8,56677875,"F",1,1,"Atlanta Hawks","Miles Norris",0,0,0,0,0,0
3,0,5,4,0,11,1,2,1,"26",2,3,3,7,0,1,1037888,"2023-12-11T00:00:00.000Z",1,FALSE,8,375,"F",8,8,"Denver Nuggets","Michael Porter Jr.",0,10,13,6,10,14.9
0,0,0,0,0,0,0,0,0,"00",0,0,0,0,0,0,1037888,"2023-12-11T00:00:00.000Z",1,FALSE,8,56677871,"F",8,8,"Denver Nuggets","Hunter Tyson",0,0,0,0,0,0
0,1,1,0,0,2,1,2,1,"20",1,2,3,2,0,0,1037888,"2023-12-11T00:00:00.000Z",1,FALSE,8,38017721,"G",8,8,"Denver Nuggets","Peyton Watson",1,5,5,3,2,8.4
0,0,0,0,0,0,0,0,0,"00",0,0,0,0,0,0,1037888,"2023-12-11T00:00:00.000Z",1,FALSE,8,666489,"F",8,8,"Denver Nuggets","Vlatko Cancar",0,0,0,0,0,0
0,0,0,0,0,0,0,0,0,"00",0,0,0,0,0,0,1037888,"2023-12-11T00:00:00.000Z",1,FALSE,8,38017727,"G",8,8,"Denver Nuggets","Collin Gillespie",0,0,0,0,0,0
0,0,0,0,0,0,0,0,0,"00",0,0,0,0,0,0,1037888,"2023-12-11T00:00:00.000Z",1,FALSE,8,17896103,"F-C",8,8,"Denver Nuggets","Jay Huff",0,0,0,0,0,0
0,0,0,0,0,0,0,0,0,"00",0,0,0,0,0,0,1037888,"2023-12-11T00:00:00.000Z",1,FALSE,8,17896007,"G",8,8,"Denver Nuggets","Braxton Key",0,0,0,0,0,0
3,1,4,0,0,5,3,1,1,"28",2,3,7,6,0,0,1037888,"2023-12-11T00:00:00.000Z",1,FALSE,8,3547244,"F-C",1,1,"Atlanta Hawks","Onyeka Okongwu",1,13,16,10,9,21.7
1,0,4,4,0,5,1,0,0,"18",1,1,2,5,2,2,1037888,"2023-12-11T00:00:00.000Z",1,FALSE,8,301,"G-F",1,1,"Atlanta Hawks","Wesley Matthews",2,7,8,3,6,13.5
1,0,2,1,0,1,0,0,0,"09",0,1,0,2,0,0,1037888,"2023-12-11T00:00:00.000Z",1,FALSE,8,38017689,"F",1,1,"Atlanta Hawks","AJ Griffin",0,2,3,1,3,3.9
0,0,0,0,0,0,0,0,0,"00",0,0,0,0,0,0,1037888,"2023-12-11T00:00:00.000Z",1,FALSE,8,666564,"F",1,1,"Atlanta Hawks","Bruno Fernando",0,0,0,0,0,0
0,0,0,0,0,0,0,0,0,"00",0,0,0,0,0,0,1037888,"2023-12-11T00:00:00.000Z",1,FALSE,8,3547297,"G",1,1,"Atlanta Hawks","Trent Forrest",0,0,0,0,0,0
0,0,0,0,0,0,0,0,0,"00",0,0,0,0,0,0,1037888,"2023-12-11T00:00:00.000Z",1,FALSE,8,56677855,"G",1,1,"Atlanta Hawks","Seth Lundy",0,0,0,0,0,0
0,0,0,0,0,0,0,0,0,"00",0,0,0,0,0,0,1037888,"2023-12-11T00:00:00.000Z",1,FALSE,8,319,"G",1,1,"Atlanta Hawks","Patty Mills",0,0,0,0,0,0
0,0,0,0,0,0,0,0,0,"00",0,0,0,0,0,0,1037888,"2023-12-11T00:00:00.000Z",1,FALSE,8,56677838,"G",1,1,"Atlanta Hawks","Kobe Bufkin",0,0,0,0,0,0
0,0,0,0,0,0,0,0,0,"00",0,0,0,0,0,0,1037888,"2023-12-11T00:00:00.000Z",1,FALSE,8,56677806,"F",1,1,"Atlanta Hawks","Mouhamed Gueye",0,0,0,0,0,0
0,0,0,0,0,0,0,0,0,"00",0,0,0,0,0,0,1037888,"2023-12-11T00:00:00.000Z",1,FALSE,8,666656,"F",1,1,"Atlanta Hawks","De'Andre Hunter",0,0,0,0,0,0
0,0,0,0,0,0,0,0,0,"00",0,0,0,0,0,0,1037888,"2023-12-11T00:00:00.000Z",1,FALSE,8,17896040,"F",1,1,"Atlanta Hawks","Jalen Johnson",0,0,0,0,0,0
2,0,4,6,0,12,1,0,0,"30",1,3,2,5,0,2,1037890,"2023-12-11T00:00:00.000Z",11,FALSE,27,66,"G-F",11,11,"Houston Rockets","Dillon Brooks",0,7,9,4,7,9
4,1,9,3,1,12,3,2,2,"36",3,3,9,12,1,1,1037890,"2023-12-11T00:00:00.000Z",11,FALSE,27,38017684,"F",11,11,"Houston Rockets","Jabari Smith Jr.",2,21,25,13,16,34.4
4,1,7,1,1,12,6,4,2,"30",2,3,15,9,2,6,1037890,"2023-12-11T00:00:00.000Z",11,FALSE,27,17896062,"F-C",11,11,"Houston Rockets","Alperen Sengun",3,24,28,19,13,34.8
1,0,3,4,1,10,2,2,2,"24",0,1,7,3,0,1,1037890,"2023-12-11T00:00:00.000Z",11,FALSE,27,17895966,"G",11,11,"Houston Rockets","Jalen Green",0,10,11,8,4,11.1
5,0,6,11,4,17,6,0,0,"39",0,0,16,6,2,3,1037890,"2023-12-11T00:00:00.000Z",11,FALSE,27,458,"G",11,11,"Houston Rockets","Fred VanVleet",2,22,27,21,11,33.7
1,0,10,5,2,16,8,1,0,"27",4,2,18,14,2,2,1037890,"2023-12-11T00:00:00.000Z",11,FALSE,27,38017695,"F",11,11,"Houston Rockets","Tari Eason",2,32,33,19,15,40.3
1,0,1,2,1,4,2,7,7,"19",1,3,12,2,0,0,1037890,"2023-12-11T00:00:00.000Z",11,FALSE,27,188,"F",11,11,"Houston Rockets","Jeff Green",0,14,15,13,3,15.9
0,0,1,5,1,6,1,4,4,"15",1,2,7,2,0,0,1037890,"2023-12-11T00:00:00.000Z",11,FALSE,27,213,"G",11,11,"Houston Rockets","Aaron Holiday",0,9,9,7,2,9.4
0,0,0,0,0,0,0,0,0,"00",0,0,0,0,0,0,1037890,"2023-12-11T00:00:00.000Z",11,FALSE,27,19465326,"C",11,11,"Houston Rockets","Jock Landale",0,0,0,0,0,0
0,0,0,0,0,0,0,0,0,"00",0,0,0,0,0,0,1037890,"2023-12-11T00:00:00.000Z",11,FALSE,27,296,"C",11,11,"Houston Rockets","Boban Marjanovic",0,0,0,0,0,0
0,0,1,1,1,2,2,0,0,"10",1,0,5,2,0,1,1037890,"2023-12-11T00:00:00.000Z",11,FALSE,27,3547301,"F",11,11,"Houston Rockets","Jae'Sean Tate",0,7,7,5,2,6.4
1,0,3,1,0,2,1,0,0,"10",2,1,2,5,0,0,1037890,"2023-12-11T00:00:00.000Z",11,FALSE,27,56677825,"G-F",11,11,"Houston Rockets","Amen Thompson",0,7,8,3,6,9.5
0,0,0,0,0,0,0,0,0,"00",0,0,0,0,0,0,1037890,"2023-12-11T00:00:00.000Z",11,FALSE,27,47738533,"G",11,11,"Houston Rockets","Jeenathan Williams",0,0,0,0,0,0
0,0,0,0,0,0,0,0,0,"00",0,0,0,0,0,0,1037890,"2023-12-11T00:00:00.000Z",11,FALSE,27,75,"G-F",11,11,"Houston Rockets","Reggie Bullock",0,0,0,0,0,0
0,0,0,0,0,0,0,0,0,"00",0,0,0,0,0,0,1037890,"2023-12-11T00:00:00.000Z",11,FALSE,27,3547281,"G-F",11,11,"Houston Rockets","Nate Hinton",0,0,0,0,0,0
0,0,0,0,0,0,0,0,0,"00",0,0,0,0,0,0,1037890,"2023-12-11T00:00:00.000Z",11,FALSE,27,357,"G",11,11,"Houston Rockets","Victor Oladipo",0,0,0,0,0,0
0,0,0,0,0,0,0,0,0,"00",0,0,0,0,0,0,1037890,"2023-12-11T00:00:00.000Z",11,FALSE,27,56677809,"F",11,11,"Houston Rockets","Jermaine Samuels Jr.",0,0,0,0,0,0
0,0,1,1,0,1,0,0,0,"08",0,1,0,1,0,0,1037890,"2023-12-11T00:00:00.000Z",11,FALSE,27,38017649,"F",27,27,"San Antonio Spurs","Julian Champagnie",0,1,1,0,1,1.2
0,0,4,0,0,4,1,0,0,"14",0,3,2,4,0,2,1037890,"2023-12-11T00:00:00.000Z",11,FALSE,27,102,"F-C",27,27,"San Antonio Spurs","Zach Collins",0,6,6,2,4,4.8
0,0,0,0,0,0,0,0,0,"00",0,0,0,0,0,0,1037890,"2023-12-11T00:00:00.000Z",11,FALSE,27,180,"G",27,27,"San Antonio Spurs","Devonte' Graham",0,0,0,0,0,0
2,0,0,1,0,1,0,5,3,"16",0,1,3,0,2,0,1037890,"2023-12-11T00:00:00.000Z",11,FALSE,27,3547274,"G",27,27,"San Antonio Spurs","Tre Jones",2,3,5,5,2,12
0,0,1,0,0,0,0,0,0,"04",0,1,0,1,0,0,1037890,"2023-12-11T00:00:00.000Z",11,FALSE,27,17896059,"F",27,27,"San Antonio Spurs","Sandro Mamukelashvili",0,1,1,0,1,1.2
1,0,0,5,2,5,2,0,0,"15",0,0,6,0,1,0,1037890,"2023-12-11T00:00:00.000Z",11,FALSE,27,305,"F",27,27,"San Antonio Spurs","Doug McDermott",1,6,7,7,1,10.5
1,0,2,2,0,7,4,4,2,"13",0,1,10,2,0,2,1037890,"2023-12-11T00:00:00.000Z",11,FALSE,27,359,"F",27,27,"San Antonio Spurs","Cedi Osman",0,12,13,11,3,11.9
0,0,0,0,0,0,0,0,0,"00",0,0,0,0,0,0,1037890,"2023-12-11T00:00:00.000Z",11,FALSE,27,38017693,"G",27,27,"San Antonio Spurs","Blake Wesley",0,0,0,0,0,0
0,0,0,0,0,0,0,0,0,"00",0,0,0,0,0,0,1037890,"2023-12-11T00:00:00.000Z",11,FALSE,27,38017730,"F",27,27,"San Antonio Spurs","Dominick Barlow",0,0,0,0,0,0
0,0,0,0,0,0,0,0,0,"00",0,0,0,0,0,0,1037890,"2023-12-11T00:00:00.000Z",11,FALSE,27,17895854,"G",27,27,"San Antonio Spurs","Charles Bassey",0,0,0,0,0,0
0,0,0,0,0,0,0,0,0,"00",0,0,0,0,0,0,1037890,"2023-12-11T00:00:00.000Z",11,FALSE,27,56677865,"C",27,27,"San Antonio Spurs","Charles Bediako",0,0,0,0,0,0
0,0,0,0,0,0,0,0,0,"00",0,0,0,0,0,0,1037890,"2023-12-11T00:00:00.000Z",11,FALSE,27,56677817,"G",27,27,"San Antonio Spurs","Sidy Cissoko",0,0,0,0,0,0
0,0,0,0,0,0,0,0,0,"00",0,0,0,0,0,0,1037890,"2023-12-11T00:00:00.000Z",11,FALSE,27,56677870,"G",27,27,"San Antonio Spurs","Sir'Jabari Rice",0,0,0,0,0,0
0,0,0,0,0,0,0,0,0,"00",0,0,0,0,0,0,1037890,"2023-12-11T00:00:00.000Z",11,FALSE,27,56677831,"F",11,11,"Houston Rockets","Cam Whitmore",0,0,0,0,0,0
2,0,3,9,1,16,5,5,3,"31",3,1,14,6,0,1,1037890,"2023-12-11T00:00:00.000Z",11,FALSE,27,3547246,"G-F",27,27,"San Antonio Spurs","Devin Vassell",0,20,22,16,8,23.2
2,0,5,9,0,14,3,6,6,"37",2,1,12,7,4,3,1037890,"2023-12-11T00:00:00.000Z",11,FALSE,27,666682,"F",27,27,"San Antonio Spurs","Keldon Johnson",4,19,21,14,9,32.4
3,5,16,6,1,15,7,1,0,"33",2,3,15,18,0,5,1037890,"2023-12-11T00:00:00.000Z",11,FALSE,27,56677822,"F-C",27,27,"San Antonio Spurs","Victor Wembanyama",5,33,36,18,21,51.1
7,0,6,3,0,13,6,1,1,"34",0,0,13,6,1,3,1037890,"2023-12-11T00:00:00.000Z",11,FALSE,27,38017692,"F",27,27,"San Antonio Spurs","Malaki Branham",1,19,26,20,13,30.7
2,0,4,5,1,11,3,0,0,"35",2,2,7,6,1,1,1037890,"2023-12-11T00:00:00.000Z",11,FALSE,27,38017699,"F",27,27,"San Antonio Spurs","Jeremy Sochan",1,13,15,9,8,19.2
3,1,2,5,2,6,2,0,0,"20",0,2,6,2,2,1,1037891,"2023-12-11T00:00:00.000Z",15,FALSE,7,17896067,"F",15,15,"Memphis Grizzlies","Santi Aldama",3,8,11,9,5,20.9
2,0,4,5,1,9,3,2,1,"29",2,1,8,6,1,1,1037891,"2023-12-11T00:00:00.000Z",15,FALSE,7,38017729,"F",15,15,"Memphis Grizzlies","David Roddy",1,14,16,10,8,20.2
2,2,4,10,6,29,15,5,5,"42",0,3,41,4,2,2,1037891,"2023-12-11T00:00:00.000Z",15,FALSE,7,231,"F-C",15,15,"Memphis Grizzlies","Jaren Jackson Jr.",4,45,47,43,6,58.8
8,0,2,9,3,20,11,3,3,"39",1,4,28,3,1,5,1037891,"2023-12-11T00:00:00.000Z",15,FALSE,7,3547287,"G",15,15,"Memphis Grizzlies","Desmond Bane",1,31,39,36,11,41.6
4,0,3,3,1,7,2,2,2,"17",0,1,7,3,0,2,1037891,"2023-12-11T00:00:00.000Z",15,FALSE,7,401,"G",15,15,"Memphis Grizzlies","Derrick Rose",0,10,14,11,7,14.6
1,1,1,0,0,1,1,0,0,"12",1,1,2,2,0,2,1037891,"2023-12-11T00:00:00.000Z",15,FALSE,7,48,"C",15,15,"Memphis Grizzlies","Bismack Biyombo",1,4,5,3,3,6.9
0,0,0,0,0,0,0,0,0,"00",0,0,0,0,0,0,1037891,"2023-12-11T00:00:00.000Z",15,FALSE,7,48248287,"G",15,15,"Memphis Grizzlies","Jacob Gilyard",0,0,0,0,0,0
2,1,4,5,2,5,2,0,0,"25",2,2,6,6,1,2,1037891,"2023-12-11T00:00:00.000Z",15,FALSE,7,666703,"G-F",15,15,"Memphis Grizzlies","John Konchar",2,12,14,8,8,20.2
0,0,0,0,0,0,0,0,0,"00",0,0,0,0,0,0,1037891,"2023-12-11T00:00:00.000Z",15,FALSE,7,38017728,"F",15,15,"Memphis Grizzlies","Jake LaRavia",0,0,0,0,0,0
0,0,0,0,0,0,0,0,0,"00",0,0,0,0,0,0,1037891,"2023-12-11T00:00:00.000Z",15,FALSE,7,38017732,"F",15,15,"Memphis Grizzlies","Kenneth Lofton Jr.",0,0,0,0,0,0
2,0,0,1,0,2,0,0,0,"08",0,0,0,0,0,1,1037891,"2023-12-11T00:00:00.000Z",15,FALSE,7,666809,"G",15,15,"Memphis Grizzlies","Jaylen Nowell",0,0,2,2,2,2
0,0,0,0,0,1,0,2,0,"07",0,0,0,0,1,0,1037891,"2023-12-11T00:00:00.000Z",15,FALSE,7,3547285,"F",15,15,"Memphis Grizzlies","Xavier Tillman",1,0,0,0,0,3
0,3,2,2,0,4,2,1,1,"06",0,0,5,2,0,0,1037891,"2023-12-11T00:00:00.000Z",15,FALSE,7,247,"F-G",7,7,"Dallas Mavericks","Derrick Jones Jr.",3,7,7,5,2,16.4
2,1,11,0,0,9,8,0,0,"35",5,3,16,16,0,4,1037891,"2023-12-11T00:00:00.000Z",15,FALSE,7,56677840,"C",7,7,"Dallas Mavericks","Dereck Lively II",1,32,34,18,18,37.2
2,0,2,3,1,5,2,1,1,"21",1,1,6,3,1,0,1037891,"2023-12-11T00:00:00.000Z",15,FALSE,7,114,"G",7,7,"Dallas Mavericks","Seth Curry",1,9,11,8,5,15.6
6,2,8,10,5,21,9,13,12,"44",0,3,35,8,2,3,1037891,"2023-12-11T00:00:00.000Z",15,FALSE,7,132,"F-G",7,7,"Dallas Mavericks","Luka Doncic",4,43,49,41,14,62.6
4,0,0,7,5,15,7,0,0,"34",0,1,19,0,1,2,1037891,"2023-12-11T00:00:00.000Z",15,FALSE,7,38017679,"G",7,7,"Dallas Mavericks","Jaden Hardy",1,19,23,23,4,26
0,0,0,0,0,0,0,0,0,"00",0,0,0,0,0,0,1037891,"2023-12-11T00:00:00.000Z",15,FALSE,7,217,"F-C",7,7,"Dallas Mavericks","Richaun Holmes",0,0,0,0,0,0
1,0,0,4,0,7,2,0,0,"14",1,0,4,1,0,1,1037891,"2023-12-11T00:00:00.000Z",15,FALSE,7,17554004,"G",7,7,"Dallas Mavericks","AJ Lawson",0,5,6,5,2,5.7
2,1,2,4,2,5,2,0,0,"21",1,1,6,3,2,2,1037891,"2023-12-11T00:00:00.000Z",15,FALSE,7,329,"F",7,7,"Dallas Mavericks","Markieff Morris",3,9,11,8,5,19.6
2,0,1,0,0,2,1,0,0,"12",1,3,2,2,0,1,1037891,"2023-12-11T00:00:00.000Z",15,FALSE,7,379,"F-C",7,7,"Dallas Mavericks","Dwight Powell",0,4,6,4,4,6.4
2,1,4,6,3,7,4,0,0,"18",0,2,11,4,0,1,1037891,"2023-12-11T00:00:00.000Z",15,FALSE,7,56677859,"F",7,7,"Dallas Mavericks","Olivier-Maxence Prosper",1,15,17,13,6,20.8
0,0,0,0,0,0,0,0,0,"00",0,0,0,0,0,0,1037891,"2023-12-11T00:00:00.000Z",15,FALSE,7,17896028,"F",7,7,"Dallas Mavericks","Greg Brown III",0,0,0,0,0,0
0,0,0,0,0,0,0,0,0,"00",0,0,0,0,0,0,1037891,"2023-12-11T00:00:00.000Z",15,FALSE,7,56677873,"G",7,7,"Dallas Mavericks","Dexter Dennis",0,0,0,0,0,0
0,0,0,0,0,0,0,0,0,"00",0,0,0,0,0,0,1037891,"2023-12-11T00:00:00.000Z",15,FALSE,7,3547258,"G",7,7,"Dallas Mavericks","Josh Green",0,0,0,0,0,0
0,0,0,0,0,0,0,0,0,"00",0,0,0,0,0,0,1037891,"2023-12-11T00:00:00.000Z",15,FALSE,7,191,"G",7,7,"Dallas Mavericks","Tim Hardaway Jr.",0,0,0,0,0,0
0,0,0,0,0,0,0,0,0,"00",0,0,0,0,0,0,1037891,"2023-12-11T00:00:00.000Z",15,FALSE,7,228,"G",7,7,"Dallas Mavericks","Kyrie Irving",0,0,0,0,0,0
1,0,6,3,2,4,3,2,2,"26",3,3,10,9,0,1,1037891,"2023-12-11T00:00:00.000Z",15,FALSE,7,38017731,"G",15,15,"Memphis Grizzlies","Vince Williams Jr.",0,19,20,11,10,21.3
1,0,2,3,1,5,2,0,0,"15",1,2,5,3,1,0,1037891,"2023-12-11T00:00:00.000Z",15,FALSE,7,17896027,"G-F",15,15,"Memphis Grizzlies","Ziaire Williams",1,8,9,6,4,13.1
0,0,0,0,0,0,0,0,0,"00",0,0,0,0,0,0,1037891,"2023-12-11T00:00:00.000Z",15,FALSE,7,3,"C",15,15,"Memphis Grizzlies","Steven Adams",0,0,0,0,0,0
0,0,0,0,0,0,0,0,0,"00",0,0,0,0,0,0,1037891,"2023-12-11T00:00:00.000Z",15,FALSE,7,666505,"F",15,15,"Memphis Grizzlies","Brandon Clarke",0,0,0,0,0,0
0,0,0,0,0,0,0,0,0,"00",0,0,0,0,0,0,1037891,"2023-12-11T00:00:00.000Z",15,FALSE,7,56677830,"F",15,15,"Memphis Grizzlies","GG Jackson",0,0,0,0,0,0
0,0,0,0,0,0,0,0,0,"00",0,0,0,0,0,0,1037891,"2023-12-11T00:00:00.000Z",15,FALSE,7,254,"G",15,15,"Memphis Grizzlies","Luke Kennard",0,0,0,0,0,0
0,0,0,0,0,0,0,0,0,"00",0,0,0,0,0,0,1037891,"2023-12-11T00:00:00.000Z",15,FALSE,7,666786,"G",15,15,"Memphis Grizzlies","Ja Morant",0,0,0,0,0,0
0,0,0,0,0,0,0,0,0,"00",0,0,0,0,0,0,1037891,"2023-12-11T00:00:00.000Z",15,FALSE,7,420,"G",15,15,"Memphis Grizzlies","Marcus Smart",0,0,0,0,0,0
6,1,3,4,1,11,6,4,3,"35",1,3,16,4,2,3,1037891,"2023-12-11T00:00:00.000Z",15,FALSE,7,151,"G",7,7,"Dallas Mavericks","Dante Exum",3,20,26,22,10,35.8
0,0,0,0,0,0,0,0,0,"00",0,0,0,0,0,0,1037891,"2023-12-11T00:00:00.000Z",15,FALSE,7,257,"F",7,7,"Dallas Mavericks","Maxi Kleber",0,0,0,0,0,0
0,0,0,0,0,0,0,0,0,"00",0,0,0,0,0,0,1037891,"2023-12-11T00:00:00.000Z",15,FALSE,7,666965,"F",7,7,"Dallas Mavericks","Grant Williams",0,0,0,0,0,0
1,0,3,7,5,11,7,0,0,"27",0,0,19,3,0,0,1037889,"2023-12-11T00:00:00.000Z",20,FALSE,28,17895858,"G",20,20,"New York Knicks","Quentin Grimes",0,22,23,20,4,24.1
8,0,4,3,3,8,6,2,1,"31",3,4,16,7,1,1,1037889,"2023-12-11T00:00:00.000Z",20,FALSE,28,202,"G",20,20,"New York Knicks","Josh Hart",1,23,31,24,15,38.4
2,1,3,0,0,7,4,4,3,"27",5,4,11,8,2,2,1037889,"2023-12-11T00:00:00.000Z",20,FALSE,28,201,"F-C",20,20,"New York Knicks","Isaiah Hartenstein",3,19,21,13,10,30.6
0,0,0,0,0,0,0,0,0,"00",0,0,0,0,0,0,1037889,"2023-12-11T00:00:00.000Z",20,FALSE,28,666675,"F",20,20,"New York Knicks","DaQuan Jeffries",0,0,0,0,0,0
3,0,0,1,1,2,1,0,0,"10",0,1,3,0,0,0,1037889,"2023-12-11T00:00:00.000Z",20,FALSE,28,17896033,"G",20,20,"New York Knicks","Miles McBride",0,3,6,6,3,7.5
0,0,0,0,0,0,0,0,0,"00",0,0,0,0,0,0,1037889,"2023-12-11T00:00:00.000Z",20,FALSE,28,3547269,"G",20,20,"New York Knicks","Immanuel Quickley",0,0,0,0,0,0
0,0,0,0,0,0,0,0,0,"00",0,0,0,0,0,0,1037889,"2023-12-11T00:00:00.000Z",20,FALSE,28,666971,"G-F",20,20,"New York Knicks","Dylan Windler",0,0,0,0,0,0
0,0,0,0,0,0,0,0,0,"00",0,0,0,0,0,0,1037889,"2023-12-11T00:00:00.000Z",20,FALSE,28,59421201,"G",20,20,"New York Knicks","Jaylen Martin",0,0,0,0,0,0
0,0,0,0,0,0,0,0,0,"00",0,0,0,0,0,0,1037889,"2023-12-11T00:00:00.000Z",20,FALSE,28,399,"C",20,20,"New York Knicks","Mitchell Robinson",0,0,0,0,0,0
0,0,0,0,0,0,0,0,0,"00",0,0,0,0,0,0,1037889,"2023-12-11T00:00:00.000Z",20,FALSE,28,56677795,"F",20,20,"New York Knicks","Jacob Toppin",0,0,0,0,0,0
5,0,2,8,3,13,7,3,3,"38",4,1,20,6,2,1,1037889,"2023-12-11T00:00:00.000Z",20,FALSE,28,17896055,"G-F",28,28,"Toronto Raptors","Scottie Barnes",2,26,31,25,11,39.7
4,0,2,2,1,15,8,7,3,"37",2,5,20,4,4,1,1037889,"2023-12-11T00:00:00.000Z",20,FALSE,28,416,"F",28,28,"Toronto Raptors","Pascal Siakam",4,24,28,24,8,41.8
2,0,2,0,0,6,3,8,5,"24",6,2,11,8,0,1,1037889,"2023-12-11T00:00:00.000Z",20,FALSE,28,373,"C",28,28,"Toronto Raptors","Jakob Poeltl",0,19,21,13,10,22.6
2,0,4,11,5,20,11,2,2,"37",1,3,29,5,1,2,1037889,"2023-12-11T00:00:00.000Z",20,FALSE,28,18,"F",28,28,"Toronto Raptors","OG Anunoby",1,34,36,31,7,39
3,0,5,4,1,8,3,2,2,"21",0,4,9,5,1,1,1037889,"2023-12-11T00:00:00.000Z",20,FALSE,28,3547249,"F",28,28,"Toronto Raptors","Precious Achiuwa",1,14,17,12,8,21.5
2,1,3,8,3,21,11,4,2,"32",0,1,27,3,1,1,1037889,"2023-12-11T00:00:00.000Z",20,FALSE,28,666423,"F-G",20,20,"New York Knicks","RJ Barrett",2,30,32,29,5,38.6
5,0,5,3,1,21,14,7,5,"35",3,1,34,8,0,3,1037889,"2023-12-11T00:00:00.000Z",20,FALSE,28,387,"F",20,20,"New York Knicks","Julius Randle",0,42,47,39,13,48.1
1,0,4,0,0,2,1,0,0,"21",3,3,2,7,0,0,1037889,"2023-12-11T00:00:00.000Z",20,FALSE,28,17896063,"F",20,20,"New York Knicks","Jericho Sims",0,9,10,3,8,11.9
9,0,2,5,3,12,7,6,4,"38",0,5,21,2,1,7,1037889,"2023-12-11T00:00:00.000Z",20,FALSE,28,73,"G",20,20,"New York Knicks","Jalen Brunson",1,23,32,30,11,32.9
5,1,4,2,1,2,1,0,0,"19",0,3,3,4,0,1,1037889,"2023-12-11T00:00:00.000Z",20,FALSE,28,131,"G",20,20,"New York Knicks","Donte DiVincenzo",1,7,12,8,9,17.3
0,0,0,0,0,0,0,0,0,"00",0,0,0,0,0,0,1037889,"2023-12-11T00:00:00.000Z",20,FALSE,28,19,"G",20,20,"New York Knicks","Ryan Arcidiacono",0,0,0,0,0,0
0,0,0,0,0,0,0,0,0,"00",0,0,0,0,0,0,1037889,"2023-12-11T00:00:00.000Z",20,FALSE,28,666474,"G",20,20,"New York Knicks","Charles Brown",0,0,0,0,0,0
0,0,0,0,0,0,0,0,0,"00",0,0,0,0,0,0,1037889,"2023-12-11T00:00:00.000Z",20,FALSE,28,160,"G-F",20,20,"New York Knicks","Evan Fournier",0,0,0,0,0,0
0,0,1,4,0,8,2,1,1,"10",2,1,5,3,0,1,1037889,"2023-12-11T00:00:00.000Z",20,FALSE,28,58,"F",28,28,"Toronto Raptors","Chris Boucher",0,8,8,5,3,7.6
0,0,0,0,0,1,1,0,0,"04",0,1,2,0,0,0,1037889,"2023-12-11T00:00:00.000Z",20,FALSE,28,56677828,"G",28,28,"Toronto Raptors","Gradey Dick",0,2,2,2,0,2
4,0,3,2,2,5,4,0,0,"17",1,2,10,4,0,3,1037889,"2023-12-11T00:00:00.000Z",20,FALSE,28,3547275,"G",28,28,"Toronto Raptors","Malachi Flynn",0,14,18,14,8,17.8
0,0,0,0,0,0,0,0,0,"00",0,0,0,0,0,0,1037889,"2023-12-11T00:00:00.000Z",20,FALSE,28,666762,"F",28,28,"Toronto Raptors","Jalen McDaniels",0,0,0,0,0,0
0,0,0,0,0,0,0,0,0,"00",0,0,0,0,0,0,1037889,"2023-12-11T00:00:00.000Z",20,FALSE,28,436,"G-F",28,28,"Toronto Raptors","Garrett Temple",0,0,0,0,0,0
2,0,0,4,0,8,2,0,0,"19",1,0,4,1,0,0,1037889,"2023-12-11T00:00:00.000Z",20,FALSE,28,3089,"",28,28,"Toronto Raptors","Gary Trent Jr.",0,5,7,6,3,8.2
0,0,0,0,0,0,0,0,0,"00",0,0,0,0,0,0,1037889,"2023-12-11T00:00:00.000Z",20,FALSE,28,489,"F",28,28,"Toronto Raptors","Thaddeus Young",0,0,0,0,0,0
0,0,0,0,0,0,0,0,0,"00",0,0,0,0,0,0,1037889,"2023-12-11T00:00:00.000Z",20,FALSE,28,56677805,"G",28,28,"Toronto Raptors","Javon Freeman-Liberty",0,0,0,0,0,0
0,0,0,0,0,0,0,0,0,"00",0,0,0,0,0,0,1037889,"2023-12-11T00:00:00.000Z",20,FALSE,28,38017710,"C",28,28,"Toronto Raptors","Christian Koloko",0,0,0,0,0,0
0,0,0,0,0,0,0,0,0,"00",0,0,0,0,0,0,1037889,"2023-12-11T00:00:00.000Z",20,FALSE,28,56677869,"G",28,28,"Toronto Raptors","Markquis Nowell",0,0,0,0,0,0
0,0,0,0,0,0,0,0,0,"00",0,0,0,0,0,0,1037889,"2023-12-11T00:00:00.000Z",20,FALSE,28,2309958,"C-F",15,28,"Toronto Raptors","Jontay Porter",0,0,0,0,0,0
0,0,0,0,0,0,0,0,0,"00",0,0,0,0,0,0,1037889,"2023-12-11T00:00:00.000Z",20,FALSE,28,376,"F",28,28,"Toronto Raptors","Otto Porter Jr.",0,0,0,0,0,0
10,0,2,4,2,12,6,7,6,"33",0,2,20,2,4,0,1037889,"2023-12-11T00:00:00.000Z",20,FALSE,28,409,"G",28,28,"Toronto Raptors","Dennis Schroder",4,22,32,30,12,49.4
6,0,12,3,0,11,5,4,3,"33",1,4,13,13,1,4,1037892,"2023-12-11T00:00:00.000Z",17,FALSE,5,315,"F",17,17,"Milwaukee Bucks","Khris Middleton",1,26,32,19,19,36.6
6,0,11,0,0,13,9,18,14,"41",1,2,32,12,2,2,1037892,"2023-12-11T00:00:00.000Z",17,FALSE,5,15,"F",17,17,"Milwaukee Bucks","Giannis Antetokounmpo",2,44,50,38,18,59.4
3,3,1,6,2,11,6,6,5,"40",2,4,19,3,1,1,1037892,"2023-12-11T00:00:00.000Z",17,FALSE,5,283,"C",17,17,"Milwaukee Bucks","Brook Lopez",4,22,25,22,6,38.1
2,0,4,8,5,11,7,0,0,"40",0,2,19,4,1,0,1037892,"2023-12-11T00:00:00.000Z",17,FALSE,5,38,"G",17,17,"Milwaukee Bucks","Malik Beasley",1,23,25,21,6,29.8
9,1,4,9,2,17,3,7,6,"41",0,2,14,4,0,2,1037892,"2023-12-11T00:00:00.000Z",17,FALSE,5,278,"G",17,17,"Milwaukee Bucks","Damian Lillard",1,18,27,23,13,33.3
0,0,0,0,0,0,0,0,0,"00",0,0,0,0,0,0,1037892,"2023-12-11T00:00:00.000Z",17,FALSE,5,2148,"",17,17,"Milwaukee Bucks","Thanasis Antetokounmpo",0,0,0,0,0,0
0,0,0,1,0,2,1,0,0,"14",0,1,2,0,0,0,1037892,"2023-12-11T00:00:00.000Z",17,FALSE,5,38017676,"F",17,17,"Milwaukee Bucks","MarJon Beauchamp",0,2,2,2,0,2
3,0,5,5,4,6,4,0,0,"13",0,1,12,5,0,0,1037892,"2023-12-11T00:00:00.000Z",17,FALSE,5,38017733,"G",17,17,"Milwaukee Bucks","A.J. Green",0,17,20,15,8,22.5
0,0,0,0,0,0,0,0,0,"00",0,0,0,0,0,0,1037892,"2023-12-11T00:00:00.000Z",17,FALSE,5,56677852,"G",17,17,"Milwaukee Bucks","Andre Jackson Jr.",0,0,0,0,0,0
0,0,0,0,0,0,0,0,0,"00",0,0,0,0,0,0,1037892,"2023-12-11T00:00:00.000Z",17,FALSE,5,284,"C",17,17,"Milwaukee Bucks","Robin Lopez",0,0,0,0,0,0
5,0,0,2,1,4,2,0,0,"18",0,2,5,0,0,1,1037892,"2023-12-11T00:00:00.000Z",17,FALSE,5,368,"G",17,17,"Milwaukee Bucks","Cameron Payne",0,5,10,10,5,11.5
0,0,5,3,1,11,7,2,2,"25",2,3,17,7,0,1,1037892,"2023-12-11T00:00:00.000Z",17,FALSE,5,377,"F",17,17,"Milwaukee Bucks","Bobby Portis",0,24,24,17,7,24.4
0,0,0,0,0,0,0,0,0,"00",0,0,0,0,0,0,1037892,"2023-12-11T00:00:00.000Z",17,FALSE,5,666453,"C",17,17,"Milwaukee Bucks","Marques Bolden",0,0,0,0,0,0
0,0,0,0,0,0,0,0,0,"00",0,0,0,0,0,0,1037892,"2023-12-11T00:00:00.000Z",17,FALSE,5,105,"G",17,17,"Milwaukee Bucks","Pat Connaughton",0,0,0,0,0,0
0,0,0,0,0,0,0,0,0,"00",0,0,0,0,0,0,1037892,"2023-12-11T00:00:00.000Z",17,FALSE,5,112,"F",17,17,"Milwaukee Bucks","Jae Crowder",0,0,0,0,0,0
0,0,0,0,0,0,0,0,0,"00",0,0,0,0,0,0,1037892,"2023-12-11T00:00:00.000Z",17,FALSE,5,56677854,"F",17,17,"Milwaukee Bucks","Chris Livingston",0,0,0,0,0,0
0,0,0,0,0,0,0,0,0,"00",0,0,0,0,0,0,1037892,"2023-12-11T00:00:00.000Z",17,FALSE,5,38017691,"G",17,17,"Milwaukee Bucks","TyTy Washington Jr.",0,0,0,0,0,0
0,0,0,0,0,0,0,0,0,"00",0,0,0,0,0,0,1037892,"2023-12-11T00:00:00.000Z",17,FALSE,5,666960,"G",17,17,"Milwaukee Bucks","Lindell Wigginton",0,0,0,0,0,0
11,0,2,6,3,30,14,12,10,"42",0,5,41,2,0,2,1037892,"2023-12-11T00:00:00.000Z",17,FALSE,5,125,"G",5,5,"Chicago Bulls","DeMar DeRozan",0,43,54,52,13,57.9
2,0,3,2,1,14,6,2,2,"41",4,4,15,7,0,1,1037892,"2023-12-11T00:00:00.000Z",17,FALSE,5,3547248,"F",5,5,"Chicago Bulls","Patrick Williams",0,22,24,17,9,25.4
5,1,9,5,2,16,6,0,0,"39",1,5,14,10,1,1,1037892,"2023-12-11T00:00:00.000Z",17,FALSE,5,460,"C",5,5,"Chicago Bulls","Nikola Vucevic",2,24,29,19,15,38.5
0,0,0,2,0,6,0,0,0,"27",0,1,0,0,0,0,1037892,"2023-12-11T00:00:00.000Z",17,FALSE,5,17895983,"G",5,5,"Chicago Bulls","Ayo Dosunmu",0,0,0,0,0,0
4,0,6,10,6,20,12,4,3,"45",0,3,33,6,1,2,1037892,"2023-12-11T00:00:00.000Z",17,FALSE,5,666956,"G",5,5,"Chicago Bulls","Coby White",1,39,43,37,10,47.2
0,0,0,0,0,0,0,0,0,"00",0,0,0,0,0,0,1037892,"2023-12-11T00:00:00.000Z",17,FALSE,5,27,"G",5,5,"Chicago Bulls","Lonzo Ball",0,0,0,0,0,0
0,0,0,0,0,0,0,0,0,"00",0,0,0,0,0,0,1037892,"2023-12-11T00:00:00.000Z",17,FALSE,5,56677874,"F",5,5,"Chicago Bulls","Onuralp Bitim",0,0,0,0,0,0
0,0,0,0,0,0,0,0,0,"00",0,0,0,0,0,0,1037892,"2023-12-11T00:00:00.000Z",17,FALSE,5,268,"G",5,5,"Chicago Bulls","Zach LaVine",0,0,0,0,0,0
0,0,0,0,0,0,0,0,0,"00",0,0,0,0,0,0,1037892,"2023-12-11T00:00:00.000Z",17,FALSE,5,45969255,"F",5,5,"Chicago Bulls","Justin Lewis",0,0,0,0,0,0
0,0,0,0,0,0,0,0,0,"00",0,0,0,0,0,0,1037892,"2023-12-11T00:00:00.000Z",17,FALSE,5,56677860,"F",5,5,"Chicago Bulls","Adama Sanogo",0,0,0,0,0,0
0,1,4,2,1,5,3,0,0,"13",1,0,7,5,0,0,1037892,"2023-12-11T00:00:00.000Z",17,FALSE,5,87,"G",5,5,"Chicago Bulls","Jevon Carter",1,12,12,7,5,16
1,1,4,5,1,9,2,4,2,"29",1,6,7,5,0,0,1037892,"2023-12-11T00:00:00.000Z",17,FALSE,5,110,"F",5,5,"Chicago Bulls","Torrey Craig",1,12,13,8,6,17.5
0,0,0,0,0,0,0,0,0,"04",0,0,0,0,0,0,1037892,"2023-12-11T00:00:00.000Z",17,FALSE,5,56677857,"F",5,5,"Chicago Bulls","Julian Phillips",0,0,0,0,0,0
1,0,5,0,0,12,3,3,3,"14",11,1,9,16,1,0,1037892,"2023-12-11T00:00:00.000Z",17,FALSE,5,137,"C",5,5,"Chicago Bulls","Andre Drummond",1,25,26,10,17,32.7
1,1,0,2,1,2,1,0,0,"11",0,2,3,0,0,0,1037892,"2023-12-11T00:00:00.000Z",17,FALSE,5,38017719,"F",5,5,"Chicago Bulls","Dalen Terry",1,3,4,4,1,7.5
0,0,0,0,0,0,0,0,0,"00",0,0,0,0,0,0,1037892,"2023-12-11T00:00:00.000Z",17,FALSE,5,89,"G",5,5,"Chicago Bulls","Alex Caruso",0,0,0,0,0,0
0,0,0,0,0,0,0,0,0,"00",0,0,0,0,0,0,1037892,"2023-12-11T00:00:00.000Z",17,FALSE,5,17896116,"G",5,5,"Chicago Bulls","Terry Taylor",0,0,0,0,0,0
5,2,4,4,1,13,3,7,7,"37",0,5,14,4,1,0,1037899,"2023-12-12T00:00:00.000Z",5,FALSE,8,125,"G",5,5,"Chicago Bulls","DeMar DeRozan",3,18,23,19,9,35.3
0,1,2,5,2,8,2,2,1,"31",0,1,7,2,0,1,1037899,"2023-12-12T00:00:00.000Z",5,FALSE,8,3547248,"F",5,5,"Chicago Bulls","Patrick Williams",1,9,9,7,2,11.4
5,2,12,4,1,21,12,1,1,"33",4,1,26,16,0,3,1037899,"2023-12-12T00:00:00.000Z",5,FALSE,8,460,"C",5,5,"Chicago Bulls","Nikola Vucevic",2,42,47,31,21,55.7
3,1,3,4,1,7,3,2,2,"38",0,4,9,3,0,2,1037899,"2023-12-12T00:00:00.000Z",5,FALSE,8,17895983,"G",5,5,"Chicago Bulls","Ayo Dosunmu",1,12,15,12,6,18.1
8,0,2,10,5,15,8,6,6,"34",2,2,27,4,1,2,1037899,"2023-12-12T00:00:00.000Z",5,FALSE,8,666956,"G",5,5,"Chicago Bulls","Coby White",1,31,39,35,12,44.8
2,0,0,8,3,10,3,0,0,"15",1,2,9,1,1,0,1037899,"2023-12-12T00:00:00.000Z",5,FALSE,8,87,"G",5,5,"Chicago Bulls","Jevon Carter",1,10,12,11,3,16.2
0,0,0,0,0,0,0,0,0,"00",0,0,0,0,0,0,1037899,"2023-12-12T00:00:00.000Z",5,FALSE,8,89,"G",5,5,"Chicago Bulls","Alex Caruso",0,0,0,0,0,0
1,0,3,2,0,4,1,0,0,"19",2,4,2,5,1,2,1037899,"2023-12-12T00:00:00.000Z",5,FALSE,8,110,"F",5,5,"Chicago Bulls","Torrey Craig",1,7,8,3,6,10.5
0,2,3,0,0,4,3,3,2,"14",1,1,8,4,2,1,1037899,"2023-12-12T00:00:00.000Z",5,FALSE,8,137,"C",5,5,"Chicago Bulls","Andre Drummond",4,12,12,8,4,23.8
0,0,7,8,2,16,6,4,3,"32",0,1,17,7,1,0,1037899,"2023-12-12T00:00:00.000Z",5,FALSE,8,375,"F",8,8,"Denver Nuggets","Michael Porter Jr.",1,24,24,17,7,28.4
1,0,1,1,0,1,0,0,0,"07",0,1,0,1,0,1,1037899,"2023-12-12T00:00:00.000Z",5,FALSE,8,56677857,"F",5,5,"Chicago Bulls","Julian Phillips",0,1,2,1,2,1.7
0,0,0,0,0,1,1,0,0,"01",1,0,2,1,0,0,1037899,"2023-12-12T00:00:00.000Z",5,FALSE,8,17896116,"G",5,5,"Chicago Bulls","Terry Taylor",0,3,3,2,1,3.2
1,1,0,2,0,2,0,2,2,"11",0,1,2,0,0,0,1037899,"2023-12-12T00:00:00.000Z",5,FALSE,8,38017719,"F",5,5,"Chicago Bulls","Dalen Terry",1,2,3,3,1,6.5
0,0,0,0,0,0,0,0,0,"00",0,0,0,0,0,0,1037899,"2023-12-12T00:00:00.000Z",5,FALSE,8,27,"G",5,5,"Chicago Bulls","Lonzo Ball",0,0,0,0,0,0
0,0,0,0,0,0,0,0,0,"00",0,0,0,0,0,0,1037899,"2023-12-12T00:00:00.000Z",5,FALSE,8,56677874,"F",5,5,"Chicago Bulls","Onuralp Bitim",0,0,0,0,0,0
0,0,0,0,0,0,0,0,0,"00",0,0,0,0,0,0,1037899,"2023-12-12T00:00:00.000Z",5,FALSE,8,268,"G",5,5,"Chicago Bulls","Zach LaVine",0,0,0,0,0,0
0,0,0,0,0,0,0,0,0,"00",0,0,0,0,0,0,1037899,"2023-12-12T00:00:00.000Z",5,FALSE,8,45969255,"F",5,5,"Chicago Bulls","Justin Lewis",0,0,0,0,0,0
0,0,0,0,0,0,0,0,0,"00",0,0,0,0,0,0,1037899,"2023-12-12T00:00:00.000Z",5,FALSE,8,56677860,"F",5,5,"Chicago Bulls","Adama Sanogo",0,0,0,0,0,0
2,0,0,3,2,4,3,0,0,"23",1,3,8,1,0,0,1037899,"2023-12-12T00:00:00.000Z",5,FALSE,8,215,"F-G",8,8,"Denver Nuggets","Justin Holiday",0,9,11,10,3,12.2
2,2,6,0,0,4,2,10,5,"24",4,5,9,10,1,2,1037899,"2023-12-12T00:00:00.000Z",5,FALSE,8,250,"C",8,8,"Denver Nuggets","DeAndre Jordan",3,19,21,11,12,31
0,0,0,0,0,0,0,0,0,"00",0,0,0,0,0,0,1037899,"2023-12-12T00:00:00.000Z",5,FALSE,8,3547268,"F-C",8,8,"Denver Nuggets","Zeke Nnaji",0,0,0,0,0,0
3,0,6,5,2,9,4,8,6,"23",0,1,16,6,1,2,1037899,"2023-12-12T00:00:00.000Z",5,FALSE,8,56677776,"G",8,8,"Denver Nuggets","Julian Strawther",1,22,25,19,9,28.7
1,1,0,0,0,6,1,2,2,"23",1,1,4,1,1,1,1037899,"2023-12-12T00:00:00.000Z",5,FALSE,8,38017721,"G",8,8,"Denver Nuggets","Peyton Watson",2,5,6,5,2,11.7
6,0,2,2,1,13,6,2,1,"32",5,1,14,7,0,0,1037899,"2023-12-12T00:00:00.000Z",5,FALSE,8,177,"F",8,8,"Denver Nuggets","Aaron Gordon",0,21,27,20,13,31.4
6,0,6,0,0,5,2,0,0,"16",3,1,4,9,0,0,1037899,"2023-12-12T00:00:00.000Z",5,FALSE,8,246,"C",8,8,"Denver Nuggets","Nikola Jokic",0,13,19,10,15,23.8
0,0,1,0,0,4,2,0,0,"12",0,2,4,1,0,0,1037899,"2023-12-12T00:00:00.000Z",5,FALSE,8,81,"G",8,8,"Denver Nuggets","Kentavious Caldwell-Pope",0,5,5,4,1,5.2
6,0,2,8,5,16,9,2,2,"32",0,4,25,2,0,2,1037899,"2023-12-12T00:00:00.000Z",5,FALSE,8,236,"G",8,8,"Denver Nuggets","Reggie Jackson",0,27,33,31,8,34.4
2,1,1,4,2,6,4,4,3,"23",1,1,13,2,0,3,1037899,"2023-12-12T00:00:00.000Z",5,FALSE,8,38017709,"G",8,8,"Denver Nuggets","Christian Braun",1,15,17,15,4,18.4
0,0,0,0,0,0,0,0,0,"00",0,0,0,0,0,0,1037899,"2023-12-12T00:00:00.000Z",5,FALSE,8,56677582,"G",8,8,"Denver Nuggets","Jalen Pickett",0,0,0,0,0,0
0,0,0,0,0,0,0,0,0,"00",0,0,0,0,0,0,1037899,"2023-12-12T00:00:00.000Z",5,FALSE,8,56677871,"F",8,8,"Denver Nuggets","Hunter Tyson",0,0,0,0,0,0
0,0,0,0,0,0,0,0,0,"00",0,0,0,0,0,0,1037899,"2023-12-12T00:00:00.000Z",5,FALSE,8,666489,"F",8,8,"Denver Nuggets","Vlatko Cancar",0,0,0,0,0,0
0,0,0,0,0,0,0,0,0,"00",0,0,0,0,0,0,1037899,"2023-12-12T00:00:00.000Z",5,FALSE,8,38017727,"G",8,8,"Denver Nuggets","Collin Gillespie",0,0,0,0,0,0
0,0,0,0,0,0,0,0,0,"00",0,0,0,0,0,0,1037899,"2023-12-12T00:00:00.000Z",5,FALSE,8,17896103,"F-C",8,8,"Denver Nuggets","Jay Huff",0,0,0,0,0,0
0,0,0,0,0,0,0,0,0,"00",0,0,0,0,0,0,1037899,"2023-12-12T00:00:00.000Z",5,FALSE,8,17896007,"G",8,8,"Denver Nuggets","Braxton Key",0,0,0,0,0,0
0,0,0,0,0,0,0,0,0,"00",0,0,0,0,0,0,1037899,"2023-12-12T00:00:00.000Z",5,FALSE,8,335,"G",8,8,"Denver Nuggets","Jamal Murray",0,0,0,0,0,0
2,1,1,4,3,4,3,2,1,"11",1,1,10,2,0,0,1037900,"2023-12-12T00:00:00.000Z",24,FALSE,10,356,"G",24,24,"Phoenix Suns","Josh Okogie",1,12,14,12,4,18.4
0,0,4,5,3,7,5,2,1,"25",1,2,14,5,1,1,1037900,"2023-12-12T00:00:00.000Z",24,FALSE,10,314,"F",24,24,"Phoenix Suns","Chimezie Metu",1,19,19,14,5,22
7,0,10,3,1,9,3,11,10,"31",3,3,17,13,1,1,1037900,"2023-12-12T00:00:00.000Z",24,FALSE,10,349,"C",24,24,"Phoenix Suns","Jusuf Nurkic",1,30,37,24,20,45.1
3,1,3,3,1,12,5,7,5,"27",0,3,16,3,1,3,1037900,"2023-12-12T00:00:00.000Z",24,FALSE,10,37,"G",24,24,"Phoenix Suns","Bradley Beal",2,19,22,19,6,27.1
7,1,3,6,3,23,12,5,5,"36",1,5,32,4,1,2,1037900,"2023-12-12T00:00:00.000Z",24,FALSE,10,57,"G",24,24,"Phoenix Suns","Devin Booker",2,36,43,39,11,51.3
0,0,0,2,0,2,0,0,0,"06",0,0,0,0,0,1,1037900,"2023-12-12T00:00:00.000Z",24,FALSE,10,32,"F",24,24,"Phoenix Suns","Keita Bates-Diop",0,0,0,0,0,-1
0,0,2,1,0,1,0,0,0,"05",0,1,0,2,0,0,1037900,"2023-12-12T00:00:00.000Z",24,FALSE,10,666451,"C",24,24,"Phoenix Suns","Bol Bol",0,2,2,0,2,2.4
1,2,5,0,0,1,1,1,1,"17",1,1,3,6,1,3,1037900,"2023-12-12T00:00:00.000Z",24,FALSE,10,147,"F",24,24,"Phoenix Suns","Drew Eubanks",3,9,10,4,7,17.7
6,1,5,5,1,10,5,5,5,"30",0,3,16,5,2,1,1037900,"2023-12-12T00:00:00.000Z",24,FALSE,10,18678058,"",24,24,"Phoenix Suns","Jordan Goodwin",3,21,27,22,11,39
0,0,0,6,1,11,3,1,1,"32",0,1,8,0,0,1,1037900,"2023-12-12T00:00:00.000Z",24,FALSE,10,178,"G",24,24,"Phoenix Suns","Eric Gordon",0,8,8,8,0,7
1,1,1,4,1,4,1,0,0,"20",0,2,3,1,1,1,1037900,"2023-12-12T00:00:00.000Z",24,FALSE,10,470,"G",24,24,"Phoenix Suns","Yuta Watanabe",2,4,5,4,2,10.7
0,0,0,0,0,0,0,0,0,"00",0,0,0,0,0,0,1037900,"2023-12-12T00:00:00.000Z",24,FALSE,10,8,"G",24,24,"Phoenix Suns","Grayson Allen",0,0,0,0,0,0
0,0,0,0,0,0,0,0,0,"00",0,0,0,0,0,0,1037900,"2023-12-12T00:00:00.000Z",24,FALSE,10,3547095,"C-F",24,24,"Phoenix Suns","Udoka Azubuike",0,0,0,0,0,0
0,0,0,0,0,0,0,0,0,"00",0,0,0,0,0,0,1037900,"2023-12-12T00:00:00.000Z",24,FALSE,10,140,"F",24,24,"Phoenix Suns","Kevin Durant",0,0,0,0,0,0
0,0,0,0,0,0,0,0,0,"00",0,0,0,0,0,0,1037900,"2023-12-12T00:00:00.000Z",24,FALSE,10,272,"G",24,24,"Phoenix Suns","Damion Lee",0,0,0,0,0,0
0,0,0,0,0,0,0,0,0,"00",0,0,0,0,0,0,1037900,"2023-12-12T00:00:00.000Z",24,FALSE,10,3547298,"G",24,24,"Phoenix Suns","Saben Lee",0,0,0,0,0,0
0,0,0,0,0,0,0,0,0,"00",0,0,0,0,0,0,1037900,"2023-12-12T00:00:00.000Z",24,FALSE,10,666729,"F",24,24,"Phoenix Suns","Nassir Little",0,0,0,0,0,0
1,0,2,3,1,7,1,0,0,"15",2,1,3,4,0,3,1037900,"2023-12-12T00:00:00.000Z",24,FALSE,10,475,"F-G",10,10,"Golden State Warriors","Andrew Wiggins",0,7,8,4,5,6.3
0,0,3,3,2,6,3,6,4,"24",1,3,12,4,0,2,1037900,"2023-12-12T00:00:00.000Z",24,FALSE,10,17553992,"G",10,10,"Golden State Warriors","Moses Moody",0,16,16,12,4,14.8
0,0,4,3,1,10,6,7,3,"28",2,4,16,6,1,1,1037900,"2023-12-12T00:00:00.000Z",24,FALSE,10,17553979,"F",10,10,"Golden State Warriors","Jonathan Kuminga",1,22,22,16,6,25.2
11,0,5,4,3,8,5,3,2,"30",0,4,15,5,2,1,1037900,"2023-12-12T00:00:00.000Z",24,FALSE,10,367,"G",10,10,"Golden State Warriors","Chris Paul",2,20,31,26,16,42.5
2,0,2,2,0,3,1,0,0,"17",0,3,2,2,0,3,1037900,"2023-12-12T00:00:00.000Z",24,FALSE,10,185,"F",10,10,"Golden State Warriors","Draymond Green",0,4,6,4,4,4.4
2,0,3,0,0,0,0,0,0,"11",2,2,0,5,1,0,1037900,"2023-12-12T00:00:00.000Z",24,FALSE,10,282,"F",10,10,"Golden State Warriors","Kevon Looney",1,5,7,2,7,12
0,0,5,8,1,10,2,2,2,"27",0,1,7,5,0,1,1037900,"2023-12-12T00:00:00.000Z",24,FALSE,10,443,"G",10,10,"Golden State Warriors","Klay Thompson",0,12,12,7,5,12
4,0,5,15,4,24,8,4,4,"32",0,2,24,5,3,1,1037900,"2023-12-12T00:00:00.000Z",24,FALSE,10,115,"G",10,10,"Golden State Warriors","Stephen Curry",3,29,33,28,9,44
1,0,3,4,2,9,5,4,3,"20",1,5,15,4,0,0,1037900,"2023-12-12T00:00:00.000Z",24,FALSE,10,407,"F",10,10,"Golden State Warriors","Dario Saric",0,19,20,16,5,21.3
5,0,6,4,2,14,9,1,0,"29",5,2,20,11,1,3,1037900,"2023-12-12T00:00:00.000Z",24,FALSE,10,56677858,"G",10,10,"Golden State Warriors","Brandin Podziemski",1,31,36,25,16,40.7
0,1,0,0,0,1,1,0,0,"07",0,1,2,0,1,0,1037900,"2023-12-12T00:00:00.000Z",24,FALSE,10,56677799,"F",10,10,"Golden State Warriors","Trayce Jackson-Davis",2,2,2,2,0,8
0,0,0,0,0,0,0,0,0,"00",0,0,0,0,0,0,1037900,"2023-12-12T00:00:00.000Z",24,FALSE,10,251,"G",10,10,"Golden State Warriors","Cory Joseph",0,0,0,0,0,0
0,0,0,0,0,0,0,0,0,"00",0,0,0,0,0,0,1037900,"2023-12-12T00:00:00.000Z",24,FALSE,10,2189,"",10,10,"Golden State Warriors","Gary Payton II",0,0,0,0,0,0
0,0,0,0,0,0,0,0,0,"00",0,0,0,0,0,0,1037900,"2023-12-12T00:00:00.000Z",24,FALSE,10,17896070,"F",10,10,"Golden State Warriors","Usman Garuba",0,0,0,0,0,0
0,0,0,0,0,0,0,0,0,"00",0,0,0,0,0,0,1037900,"2023-12-12T00:00:00.000Z",24,FALSE,10,45658838,"G",10,10,"Golden State Warriors","Lester Quinones",0,0,0,0,0,0
0,0,0,0,0,0,0,0,0,"00",0,0,0,0,0,0,1037900,"2023-12-12T00:00:00.000Z",24,FALSE,10,398,"G",10,10,"Golden State Warriors","Jerome Robinson",0,0,0,0,0,0
0,0,0,0,0,0,0,0,0,"00",0,0,0,0,0,0,1037900,"2023-12-12T00:00:00.000Z",24,FALSE,10,57875092,"F",10,10,"Golden State Warriors","Gui Santos",0,0,0,0,0,0
1,0,6,5,2,7,3,1,1,"16",0,0,9,6,2,3,1037901,"2023-12-12T00:00:00.000Z",13,FALSE,26,172,"F",13,13,"LA Clippers","Paul George",2,15,16,10,7,20.7
3,1,4,3,2,14,11,7,7,"31",0,0,31,4,1,1,1037901,"2023-12-12T00:00:00.000Z",13,FALSE,26,274,"F",13,13,"LA Clippers","Kawhi Leonard",2,35,38,34,7,45.3
0,0,9,0,0,5,3,1,0,"23",0,4,6,9,0,1,1037901,"2023-12-12T00:00:00.000Z",13,FALSE,26,493,"C",13,13,"LA Clippers","Ivica Zubac",0,15,15,6,9,15.8
7,0,6,4,0,9,4,7,7,"28",0,3,15,6,2,2,1037901,"2023-12-12T00:00:00.000Z",13,FALSE,26,192,"G",13,13,"LA Clippers","James Harden",2,21,28,22,13,36.7
2,0,4,3,2,6,3,2,2,"30",1,1,10,5,1,1,1037901,"2023-12-12T00:00:00.000Z",13,FALSE,26,666743,"G",13,13,"LA Clippers","Terance Mann",1,15,17,12,7,21
0,1,5,3,1,5,3,0,0,"24",1,5,7,6,0,1,1037901,"2023-12-12T00:00:00.000Z",13,FALSE,26,56677849,"F",13,13,"LA Clippers","Kobe Brown",1,13,13,7,6,16.2
0,0,0,0,0,1,1,0,0,"09",1,0,2,1,0,0,1037901,"2023-12-12T00:00:00.000Z",13,FALSE,26,666511,"G",13,13,"LA Clippers","Amir Coffey",0,3,3,2,1,3.2
1,0,1,4,2,8,2,0,0,"09",0,0,6,1,0,0,1037901,"2023-12-12T00:00:00.000Z",13,FALSE,26,17896031,"G",13,13,"LA Clippers","Nah'Shon Hyland",0,7,8,7,2,8.7
2,0,0,1,0,2,1,0,0,"07",0,1,2,0,0,1,1037901,"2023-12-12T00:00:00.000Z",13,FALSE,26,24417679,"G",13,13,"LA Clippers","Xavier Moon",0,2,4,4,2,4
2,0,1,4,2,11,5,3,3,"27",0,1,15,1,0,1,1037901,"2023-12-12T00:00:00.000Z",13,FALSE,26,380,"F-G",13,13,"LA Clippers","Norman Powell",0,16,18,17,3,18.2
0,0,2,1,0,8,4,0,0,"16",1,2,8,3,1,0,1037901,"2023-12-12T00:00:00.000Z",13,FALSE,26,439,"F",13,13,"LA Clippers","Daniel Theis",1,11,11,8,3,14.6
0,0,0,0,0,0,0,0,0,"00",0,0,0,0,0,0,1037901,"2023-12-12T00:00:00.000Z",13,FALSE,26,450,"F",13,13,"LA Clippers","PJ Tucker",0,0,0,0,0,0
3,0,5,1,0,8,4,0,0,"20",2,0,8,7,0,4,1037901,"2023-12-12T00:00:00.000Z",13,FALSE,26,472,"G",13,13,"LA Clippers","Russell Westbrook",0,15,18,11,10,16.9
0,0,0,0,0,0,0,0,0,"00",0,0,0,0,0,0,1037901,"2023-12-12T00:00:00.000Z",13,FALSE,26,17896022,"G",13,13,"LA Clippers","Brandon Boston Jr.",0,0,0,0,0,0
0,0,0,0,0,0,0,0,0,"00",0,0,0,0,0,0,1037901,"2023-12-12T00:00:00.000Z",13,FALSE,26,38017725,"F",13,13,"LA Clippers","Moussa Diabate",0,0,0,0,0,0
0,0,0,0,0,0,0,0,0,"00",0,0,0,0,0,0,1037901,"2023-12-12T00:00:00.000Z",13,FALSE,26,56677856,"G",13,13,"LA Clippers","Jordan Miller",0,0,0,0,0,0
0,0,0,0,0,0,0,0,0,"00",0,0,0,0,0,0,1037901,"2023-12-12T00:00:00.000Z",13,FALSE,26,371,"F-C",13,13,"LA Clippers","Mason Plumlee",0,0,0,0,0,0
0,0,0,0,0,0,0,0,0,"00",0,0,0,0,0,0,1037901,"2023-12-12T00:00:00.000Z",13,FALSE,26,17896051,"G",13,13,"LA Clippers","Joshua Primo",0,0,0,0,0,0
1,0,1,2,0,3,1,0,0,"19",0,2,2,1,0,0,1037901,"2023-12-12T00:00:00.000Z",13,FALSE,26,30,"F",26,26,"Sacramento Kings","Harrison Barnes",0,3,4,3,2,4.7
1,0,7,5,0,14,6,6,5,"31",0,2,17,7,3,0,1037901,"2023-12-12T00:00:00.000Z",13,FALSE,26,38017688,"F",26,26,"Sacramento Kings","Keegan Murray",3,24,25,18,8,35.9
3,0,5,2,0,11,5,8,5,"26",5,3,15,10,2,2,1037901,"2023-12-12T00:00:00.000Z",13,FALSE,26,406,"F",26,26,"Sacramento Kings","Domantas Sabonis",2,25,28,18,13,35.5
3,0,4,4,1,8,1,0,0,"16",0,1,3,4,1,0,1037901,"2023-12-12T00:00:00.000Z",13,FALSE,26,221,"G",26,26,"Sacramento Kings","Kevin Huerter",1,7,10,6,7,15.3
3,0,3,7,3,16,5,1,1,"25",0,3,14,3,0,4,1037901,"2023-12-12T00:00:00.000Z",13,FALSE,26,161,"G",26,26,"Sacramento Kings","De'Aaron Fox",0,17,20,17,6,18.1
1,1,2,2,0,3,1,4,4,"12",0,1,6,2,0,0,1037901,"2023-12-12T00:00:00.000Z",13,FALSE,26,17896030,"G",26,26,"Sacramento Kings","Chris Duarte",1,8,9,7,3,12.9
0,0,0,1,1,3,3,0,0,"08",0,0,7,0,0,0,1037901,"2023-12-12T00:00:00.000Z",13,FALSE,26,17896044,"F",26,26,"Sacramento Kings","Kessler Edwards",0,7,7,7,0,7
1,1,0,1,1,1,1,0,0,"12",0,0,3,0,0,2,1037901,"2023-12-12T00:00:00.000Z",13,FALSE,26,38017714,"G",26,26,"Sacramento Kings","Keon Ellis",1,3,4,4,1,5.5
1,0,1,1,1,2,2,0,0,"08",0,0,5,1,0,1,1037901,"2023-12-12T00:00:00.000Z",13,FALSE,26,17895990,"G",26,26,"Sacramento Kings","Jordan Ford",0,6,7,6,2,6.7
0,0,0,0,0,0,0,0,0,"00",0,0,0,0,0,0,1037901,"2023-12-12T00:00:00.000Z",13,FALSE,26,273,"C",26,26,"Sacramento Kings","Alex Len",0,0,0,0,0,0
3,0,5,3,0,4,1,2,1,"20",1,1,3,6,1,0,1037901,"2023-12-12T00:00:00.000Z",13,FALSE,26,290,"F",26,26,"Sacramento Kings","Trey Lyles",1,9,12,6,9,17.7
0,0,0,0,0,3,3,1,0,"06",1,1,6,1,0,1,1037901,"2023-12-12T00:00:00.000Z",13,FALSE,26,306,"C",26,26,"Sacramento Kings","JaVale McGee",0,7,7,6,1,6.2
2,0,0,1,0,3,0,2,1,"15",0,1,1,0,0,0,1037901,"2023-12-12T00:00:00.000Z",13,FALSE,26,17553994,"G",26,26,"Sacramento Kings","Davion Mitchell",0,1,3,3,2,4
5,0,0,5,2,8,3,0,0,"22",0,4,8,0,0,4,1037901,"2023-12-12T00:00:00.000Z",13,FALSE,26,324,"G",26,26,"Sacramento Kings","Malik Monk",0,8,13,13,5,11.5
3,0,3,3,1,7,4,0,0,"20",0,0,9,3,1,0,1037901,"2023-12-12T00:00:00.000Z",13,FALSE,26,4197162,"F",26,26,"Sacramento Kings","Aleksandar Vezenkov",1,12,15,12,6,20.1
0,0,0,0,0,0,0,0,0,"00",0,0,0,0,0,0,1037901,"2023-12-12T00:00:00.000Z",13,FALSE,26,56677845,"G",26,26,"Sacramento Kings","Colby Jones",0,0,0,0,0,0
0,0,0,0,0,0,0,0,0,"00",0,0,0,0,0,0,1037901,"2023-12-12T00:00:00.000Z",13,FALSE,26,56677862,"F",26,26,"Sacramento Kings","Jalen Slawson",0,0,0,0,0,0
3,1,2,9,7,10,8,4,3,"36",2,2,26,4,1,1,1037898,"2023-12-12T00:00:00.000Z",7,FALSE,14,151,"G",7,7,"Dallas Mavericks","Dante Exum",2,30,33,29,7,40.3
1,0,2,7,5,9,7,0,0,"40",1,4,19,3,1,1,1037898,"2023-12-12T00:00:00.000Z",7,FALSE,14,666965,"F",7,7,"Dallas Mavericks","Grant Williams",1,22,23,20,4,26.1
0,3,4,0,0,7,4,0,0,"30",4,4,8,8,2,1,1037898,"2023-12-12T00:00:00.000Z",7,FALSE,14,56677840,"C",7,7,"Dallas Mavericks","Dereck Lively II",5,16,16,8,8,31.6
0,1,1,2,1,2,1,0,0,"12",1,0,3,2,0,0,1037898,"2023-12-12T00:00:00.000Z",7,FALSE,14,114,"G",7,7,"Dallas Mavericks","Seth Curry",1,5,5,3,2,8.4
17,0,6,10,3,28,12,6,6,"43",0,0,33,6,1,4,1037898,"2023-12-12T00:00:00.000Z",7,FALSE,14,132,"F-G",7,7,"Dallas Mavericks","Luka Doncic",1,39,56,50,23,64.7
0,0,0,0,0,0,0,0,0,"00",0,0,0,0,0,0,1037898,"2023-12-12T00:00:00.000Z",7,FALSE,14,17896028,"F",7,7,"Dallas Mavericks","Greg Brown III",0,0,0,0,0,0
0,0,0,0,0,0,0,0,0,"00",0,0,0,0,0,0,1037898,"2023-12-12T00:00:00.000Z",7,FALSE,14,56677873,"G",7,7,"Dallas Mavericks","Dexter Dennis",0,0,0,0,0,0
3,0,2,10,5,21,10,8,7,"37",1,2,32,3,1,0,1037898,"2023-12-12T00:00:00.000Z",7,FALSE,14,191,"G",7,7,"Dallas Mavericks","Tim Hardaway Jr.",1,35,38,35,6,43.1
1,0,1,3,0,7,1,0,0,"19",0,2,2,1,0,1,1037898,"2023-12-12T00:00:00.000Z",7,FALSE,14,38017679,"G",7,7,"Dallas Mavericks","Jaden Hardy",0,3,4,3,2,3.7
2,0,4,0,0,3,1,3,2,"15",3,3,4,7,0,2,1037898,"2023-12-12T00:00:00.000Z",7,FALSE,14,217,"F-C",7,7,"Dallas Mavericks","Richaun Holmes",0,11,13,6,9,13.4
0,0,0,0,0,0,0,0,0,"01",0,0,0,0,0,0,1037898,"2023-12-12T00:00:00.000Z",7,FALSE,14,17554004,"G",7,7,"Dallas Mavericks","AJ Lawson",0,0,0,0,0,0
1,0,2,2,0,2,0,0,0,"06",0,0,0,2,1,0,1037898,"2023-12-12T00:00:00.000Z",7,FALSE,14,329,"F",7,7,"Dallas Mavericks","Markieff Morris",1,2,3,1,3,6.9
0,0,0,0,0,0,0,0,0,"00",0,0,0,0,0,0,1037898,"2023-12-12T00:00:00.000Z",7,FALSE,14,379,"F-C",7,7,"Dallas Mavericks","Dwight Powell",0,0,0,0,0,0
0,0,0,0,0,0,0,0,0,"01",0,0,0,0,0,0,1037898,"2023-12-12T00:00:00.000Z",7,FALSE,14,56677859,"F",7,7,"Dallas Mavericks","Olivier-Maxence Prosper",0,0,0,0,0,0
0,0,0,0,0,0,0,0,0,"00",0,0,0,0,0,0,1037898,"2023-12-12T00:00:00.000Z",7,FALSE,14,3547258,"G",7,7,"Dallas Mavericks","Josh Green",0,0,0,0,0,0
0,0,0,0,0,0,0,0,0,"00",0,0,0,0,0,0,1037898,"2023-12-12T00:00:00.000Z",7,FALSE,14,228,"G",7,7,"Dallas Mavericks","Kyrie Irving",0,0,0,0,0,0
0,0,0,0,0,0,0,0,0,"00",0,0,0,0,0,0,1037898,"2023-12-12T00:00:00.000Z",7,FALSE,14,247,"F-G",7,7,"Dallas Mavericks","Derrick Jones Jr.",0,0,0,0,0,0
0,0,0,0,0,0,0,0,0,"00",0,0,0,0,0,0,1037898,"2023-12-12T00:00:00.000Z",7,FALSE,14,257,"F",7,7,"Dallas Mavericks","Maxi Kleber",0,0,0,0,0,0
2,1,2,0,0,4,2,0,0,"22",1,3,4,3,0,2,1037898,"2023-12-12T00:00:00.000Z",7,FALSE,14,666860,"F-G",14,14,"Los Angeles Lakers","Cameron Reddish",1,7,9,6,5,11.6
9,1,6,8,3,27,14,3,2,"40",2,1,33,8,3,4,1037898,"2023-12-12T00:00:00.000Z",7,FALSE,14,237,"F",14,14,"Los Angeles Lakers","LeBron James",4,41,50,42,17,64.1
0,2,6,2,1,21,15,10,6,"37",5,2,37,11,0,2,1037898,"2023-12-12T00:00:00.000Z",7,FALSE,14,117,"F-C",14,14,"Los Angeles Lakers","Anthony Davis",2,48,48,37,11,54.2
4,0,4,6,5,6,5,0,0,"37",0,0,15,4,0,1,1037898,"2023-12-12T00:00:00.000Z",7,FALSE,14,383,"F",14,14,"Los Angeles Lakers","Taurean Prince",0,19,23,19,8,24.8
7,0,2,4,1,9,3,0,0,"25",0,4,7,2,0,2,1037898,"2023-12-12T00:00:00.000Z",7,FALSE,14,405,"G",14,14,"Los Angeles Lakers","D'Angelo Russell",0,9,16,14,9,17.9
1,0,0,0,0,0,0,0,0,"06",0,1,0,0,0,0,1037898,"2023-12-12T00:00:00.000Z",7,FALSE,14,38017697,"G",14,14,"Los Angeles Lakers","Max Christie",0,0,1,1,1,1.5
0,0,0,0,0,0,0,0,0,"00",0,0,0,0,0,0,1037898,"2023-12-12T00:00:00.000Z",7,FALSE,14,457,"F",14,14,"Los Angeles Lakers","Jarred Vanderbilt",0,0,0,0,0,0
0,0,0,0,0,0,0,0,0,"00",0,0,0,0,0,0,1037898,"2023-12-12T00:00:00.000Z",7,FALSE,14,1603383,"G",14,14,"Los Angeles Lakers","Gabe Vincent",0,0,0,0,0,0
0,0,0,0,0,0,0,0,0,"00",0,0,0,0,0,0,1037898,"2023-12-12T00:00:00.000Z",7,FALSE,14,486,"F",14,14,"Los Angeles Lakers","Christian Wood",0,0,0,0,0,0
0,0,0,0,0,0,0,0,0,"00",0,0,0,0,0,0,1037898,"2023-12-12T00:00:00.000Z",7,FALSE,14,56677738,"C",14,14,"Los Angeles Lakers","Colin Castleton",0,0,0,0,0,0
0,0,0,0,0,0,0,0,0,"00",0,0,0,0,0,0,1037898,"2023-12-12T00:00:00.000Z",7,FALSE,14,56677867,"F",14,14,"Los Angeles Lakers","Alex Fudge",0,0,0,0,0,0
0,0,0,0,0,0,0,0,0,"00",0,0,0,0,0,0,1037898,"2023-12-12T00:00:00.000Z",7,FALSE,14,56677868,"G",14,14,"Los Angeles Lakers","D'Moi Hodge",0,0,0,0,0,0
1,0,2,0,0,1,0,0,0,"13",2,4,0,4,0,0,1037898,"2023-12-12T00:00:00.000Z",7,FALSE,14,666626,"C",14,14,"Los Angeles Lakers","Jaxson Hayes",0,4,5,1,5,6.3
8,0,5,7,4,14,7,5,4,"32",0,2,22,5,0,3,1037898,"2023-12-12T00:00:00.000Z",7,FALSE,14,17553995,"G",14,14,"Los Angeles Lakers","Austin Reaves",0,27,35,30,13,37
2,0,3,2,1,9,3,0,0,"28",0,3,7,3,1,1,1037898,"2023-12-12T00:00:00.000Z",7,FALSE,14,666609,"F",14,14,"Los Angeles Lakers","Rui Hachimura",1,10,12,9,5,15.6
0,0,0,0,0,0,0,0,0,"00",0,0,0,0,0,0,1037898,"2023-12-12T00:00:00.000Z",7,FALSE,14,56677835,"G",14,14,"Los Angeles Lakers","Jalen Hood-Schifino",0,0,0,0,0,0
0,0,0,0,0,0,0,0,0,"00",0,0,0,0,0,0,1037898,"2023-12-12T00:00:00.000Z",7,FALSE,14,56677836,"F",14,14,"Los Angeles Lakers","Maxwell Lewis",0,0,0,0,0,0
4,1,1,5,1,17,10,4,4,"35",1,1,25,2,1,3,1037897,"2023-12-12T00:00:00.000Z",2,FALSE,6,70,"G",2,2,"Boston Celtics","Jaylen Brown",2,27,31,29,6,36.4
5,2,10,9,2,19,7,9,9,"40",0,3,25,10,0,4,1037897,"2023-12-12T00:00:00.000Z",2,FALSE,6,434,"F",2,2,"Boston Celtics","Jayson Tatum",2,35,40,30,15,46.5
3,2,7,6,2,16,5,9,9,"32",3,1,21,10,1,3,1037897,"2023-12-12T00:00:00.000Z",2,FALSE,6,378,"F-C",2,2,"Boston Celtics","Kristaps Porzingis",3,31,34,24,13,43.5
4,2,4,8,5,9,5,2,2,"37",0,3,17,4,1,1,1037897,"2023-12-12T00:00:00.000Z",2,FALSE,6,473,"G",2,2,"Boston Celtics","Derrick White",3,21,25,21,8,35.8
2,1,2,5,3,7,4,0,0,"34",2,3,11,4,3,1,1037897,"2023-12-12T00:00:00.000Z",2,FALSE,6,214,"G",2,2,"Boston Celtics","Jrue Holiday",4,15,17,13,6,29.8
0,0,0,0,0,0,0,0,0,"00",0,0,0,0,0,0,1037897,"2023-12-12T00:00:00.000Z",2,FALSE,6,17896094,"G",2,2,"Boston Celtics","Dalano Banton",0,0,0,0,0,0
0,0,0,0,0,0,0,0,0,"00",0,0,0,0,0,0,1037897,"2023-12-12T00:00:00.000Z",2,FALSE,6,666468,"F",2,2,"Boston Celtics","Oshae Brissett",0,0,0,0,0,0
1,0,2,4,3,5,3,0,0,"20",1,1,9,3,0,0,1037897,"2023-12-12T00:00:00.000Z",2,FALSE,6,17896060,"F",2,2,"Boston Celtics","Sam Hauser",0,12,13,10,4,14.1
1,0,3,2,0,3,1,0,0,"22",2,0,2,5,1,0,1037897,"2023-12-12T00:00:00.000Z",2,FALSE,6,219,"C-F",2,2,"Boston Celtics","Al Horford",1,7,8,3,6,12.5
0,0,1,0,0,3,1,2,2,"08",3,0,4,4,0,0,1037897,"2023-12-12T00:00:00.000Z",2,FALSE,6,261,"F-C",2,2,"Boston Celtics","Luke Kornet",0,8,8,4,4,8.8
0,0,0,0,0,0,0,0,0,"00",0,0,0,0,0,0,1037897,"2023-12-12T00:00:00.000Z",2,FALSE,6,338,"G",2,2,"Boston Celtics","Svi Mykhailiuk",0,0,0,0,0,0
3,1,3,5,2,5,2,0,0,"12",0,1,6,3,2,1,1037897,"2023-12-12T00:00:00.000Z",2,FALSE,6,3547276,"G",2,2,"Boston Celtics","Payton Pritchard",3,9,12,9,6,22.1
0,0,0,0,0,0,0,0,0,"00",0,0,0,0,0,0,1037897,"2023-12-12T00:00:00.000Z",2,FALSE,6,17553967,"C",2,2,"Boston Celtics","Neemias Queta",0,0,0,0,0,0
0,0,0,0,0,0,0,0,0,"00",0,0,0,0,0,0,1037897,"2023-12-12T00:00:00.000Z",2,FALSE,6,3547279,"F",2,2,"Boston Celtics","Lamar Stevens",0,0,0,0,0,0
0,0,0,0,0,0,0,0,0,"00",0,0,0,0,0,0,1037897,"2023-12-12T00:00:00.000Z",2,FALSE,6,38017707,"G",2,2,"Boston Celtics","JD Davison",0,0,0,0,0,0
0,0,0,0,0,0,0,0,0,"00",0,0,0,0,0,0,1037897,"2023-12-12T00:00:00.000Z",2,FALSE,6,56677864,"G",2,2,"Boston Celtics","Jordan Walsh",0,0,0,0,0,0
3,0,9,11,5,15,6,0,0,"37",0,4,17,9,0,1,1037897,"2023-12-12T00:00:00.000Z",2,FALSE,6,666908,"G",6,6,"Cleveland Cavaliers","Max Strus",0,26,29,20,12,31.3
3,1,2,6,2,6,2,2,2,"20",1,3,8,3,0,0,1037897,"2023-12-12T00:00:00.000Z",2,FALSE,6,666940,"F",6,6,"Cleveland Cavaliers","Dean Wade",1,11,14,11,6,19.1
5,2,3,0,0,9,6,5,2,"36",2,4,14,5,3,2,1037897,"2023-12-12T00:00:00.000Z",2,FALSE,6,9,"C",6,6,"Cleveland Cavaliers","Jarrett Allen",5,19,24,19,10,40.5
3,0,6,13,5,22,11,2,2,"35",0,3,29,6,1,3,1037897,"2023-12-12T00:00:00.000Z",2,FALSE,6,322,"G",6,6,"Cleveland Cavaliers","Donovan Mitchell",1,35,38,32,9,40.7
7,0,2,8,4,23,11,0,0,"38",0,1,26,2,1,2,1037897,"2023-12-12T00:00:00.000Z",2,FALSE,6,666581,"G",6,6,"Cleveland Cavaliers","Darius Garland",1,28,35,33,9,39.9
0,0,0,0,0,0,0,0,0,"00",0,0,0,0,0,0,1037897,"2023-12-12T00:00:00.000Z",2,FALSE,6,248,"C",6,6,"Cleveland Cavaliers","Damian Jones",0,0,0,0,0,0
3,1,2,4,1,11,5,0,0,"23",0,1,11,2,0,2,1037897,"2023-12-12T00:00:00.000Z",2,FALSE,6,277,"G",6,6,"Cleveland Cavaliers","Caris LeVert",1,13,16,14,5,18.9
0,0,0,0,0,0,0,0,0,"00",0,0,0,0,0,0,1037897,"2023-12-12T00:00:00.000Z",2,FALSE,6,3547299,"G",6,6,"Cleveland Cavaliers","Sam Merrill",0,0,0,0,0,0
1,0,2,1,1,1,1,0,0,"23",0,1,3,2,0,1,1037897,"2023-12-12T00:00:00.000Z",2,FALSE,6,344,"F",6,6,"Cleveland Cavaliers","Georges Niang",0,5,6,4,3,5.9
1,0,2,2,1,4,1,0,0,"16",0,1,3,2,1,1,1037897,"2023-12-12T00:00:00.000Z",2,FALSE,6,3547247,"F-G",6,6,"Cleveland Cavaliers","Isaac Okoro",1,5,6,4,3,8.9
1,0,1,0,0,1,1,0,0,"12",3,0,2,4,0,0,1037897,"2023-12-12T00:00:00.000Z",2,FALSE,6,444,"C-F",6,6,"Cleveland Cavaliers","Tristan Thompson",0,6,7,3,5,8.3
0,0,0,0,0,0,0,0,0,"00",0,0,0,0,0,0,1037897,"2023-12-12T00:00:00.000Z",2,FALSE,6,56677847,"F",6,6,"Cleveland Cavaliers","Emoni Bates",0,0,0,0,0,0
0,0,0,0,0,0,0,0,0,"00",0,0,0,0,0,0,1037897,"2023-12-12T00:00:00.000Z",2,FALSE,6,666676,"G",6,6,"Cleveland Cavaliers","Ty Jerome",0,0,0,0,0,0
0,0,0,0,0,0,0,0,0,"00",0,0,0,0,0,0,1037897,"2023-12-12T00:00:00.000Z",2,FALSE,6,17896076,"F-C",6,6,"Cleveland Cavaliers","Evan Mobley",0,0,0,0,0,0
0,0,0,0,0,0,0,0,0,"00",0,0,0,0,0,0,1037897,"2023-12-12T00:00:00.000Z",2,FALSE,6,38017662,"F",6,6,"Cleveland Cavaliers","Isaiah Mobley",0,0,0,0,0,0
0,0,0,0,0,0,0,0,0,"00",0,0,0,0,0,0,1037897,"2023-12-12T00:00:00.000Z",2,FALSE,6,404,"G",6,6,"Cleveland Cavaliers","Ricky Rubio",0,0,0,0,0,0
0,0,0,0,0,0,0,0,0,"00",0,0,0,0,0,0,1037897,"2023-12-12T00:00:00.000Z",2,FALSE,6,56677872,"G",6,6,"Cleveland Cavaliers","Craig Porter",0,0,0,0,0,0
3,0,6,1,0,7,5,0,0,"30",2,3,10,8,1,0,1037902,"2023-12-13T00:00:00.000Z",9,FALSE,23,56677826,"G-F",9,9,"Detroit Pistons","Ausar Thompson",1,18,21,13,11,27.1
2,0,1,9,5,19,11,8,6,"34",0,1,33,1,1,1,1037902,"2023-12-13T00:00:00.000Z",9,FALSE,23,54,"F",9,9,"Detroit Pistons","Bojan Bogdanovic",1,34,36,35,3,39.2
2,0,2,1,0,3,1,2,2,"22",2,3,4,4,0,2,1037902,"2023-12-13T00:00:00.000Z",9,FALSE,23,3547267,"F-C",9,9,"Detroit Pistons","Isaiah Stewart",0,8,10,6,6,9.8
7,0,5,8,1,17,5,12,10,"30",1,3,21,6,0,1,1037902,"2023-12-13T00:00:00.000Z",9,FALSE,23,17896075,"G-F",9,9,"Detroit Pistons","Cade Cunningham",0,27,34,28,13,37.7
6,0,3,0,0,8,3,0,0,"32",0,2,6,3,1,1,1037902,"2023-12-13T00:00:00.000Z",9,FALSE,23,3547241,"G",9,9,"Detroit Pistons","Killian Hayes",1,9,15,12,9,20.6
0,0,0,0,0,0,0,0,0,"00",0,0,0,0,0,0,1037902,"2023-12-13T00:00:00.000Z",9,FALSE,23,24,"F",9,9,"Detroit Pistons","Marvin Bagley III",0,0,0,0,0,0
0,0,2,3,1,7,1,0,0,"13",1,1,3,3,1,0,1037902,"2023-12-13T00:00:00.000Z",9,FALSE,23,77,"G",9,9,"Detroit Pistons","Alec Burks",1,6,6,3,3,9.6
0,0,0,0,0,0,0,0,0,"00",0,0,0,0,0,0,1037902,"2023-12-13T00:00:00.000Z",9,FALSE,23,197,"F-G",9,9,"Detroit Pistons","Joe Harris",0,0,0,0,0,0
1,1,2,3,0,8,2,6,3,"21",0,2,7,2,0,0,1037902,"2023-12-13T00:00:00.000Z",9,FALSE,23,38017682,"G",9,9,"Detroit Pistons","Jaden Ivey",1,9,10,8,3,13.9
2,1,2,4,1,5,2,2,2,"10",0,0,7,2,0,2,1037902,"2023-12-13T00:00:00.000Z",9,FALSE,23,259,"F",9,9,"Detroit Pistons","Kevin Knox",1,9,11,9,4,13.4
0,0,3,2,0,4,1,0,0,"27",0,1,2,3,1,0,1037902,"2023-12-13T00:00:00.000Z",9,FALSE,23,17896071,"F",9,9,"Detroit Pistons","Isaiah Livers",1,5,5,2,3,8.6
1,0,0,2,2,3,3,0,0,"05",0,0,8,0,0,1,1037902,"2023-12-13T00:00:00.000Z",9,FALSE,23,56677792,"G",9,9,"Detroit Pistons","Marcus Sasser",0,8,9,9,1,8.5
0,1,3,0,0,7,5,0,0,"16",0,6,10,3,1,1,1037902,"2023-12-13T00:00:00.000Z",9,FALSE,23,3547240,"C",9,9,"Detroit Pistons","James Wiseman",2,13,13,10,3,18.6
0,0,0,0,0,0,0,0,0,"00",0,0,0,0,0,0,1037902,"2023-12-13T00:00:00.000Z",9,FALSE,23,56677729,"G",9,9,"Detroit Pistons","Malcolm Cazalon",0,0,0,0,0,0
0,0,0,0,0,0,0,0,0,"00",0,0,0,0,0,0,1037902,"2023-12-13T00:00:00.000Z",9,FALSE,23,38017694,"C",9,9,"Detroit Pistons","Jalen Duren",0,0,0,0,0,0
0,0,0,0,0,0,0,0,0,"00",0,0,0,0,0,0,1037902,"2023-12-13T00:00:00.000Z",9,FALSE,23,42097199,"G",9,9,"Detroit Pistons","Jared Rhoden",0,0,0,0,0,0
0,0,0,0,0,0,0,0,0,"00",0,0,0,0,0,0,1037902,"2023-12-13T00:00:00.000Z",9,FALSE,23,44477024,"G",9,9,"Detroit Pistons","Stanley Umude",0,0,0,0,0,0
2,0,1,1,1,2,2,0,0,"20",0,3,5,1,0,0,1037902,"2023-12-13T00:00:00.000Z",9,FALSE,23,33,"F-G",23,23,"Philadelphia 76ers","Nicolas Batum",0,6,8,7,3,9.2
1,1,6,5,3,10,7,4,4,"26",1,0,21,7,0,1,1037902,"2023-12-13T00:00:00.000Z",9,FALSE,23,200,"F",23,23,"Philadelphia 76ers","Tobias Harris",1,28,29,22,8,32.9
5,0,7,3,1,24,14,12,12,"31",4,1,41,11,2,2,1037902,"2023-12-13T00:00:00.000Z",9,FALSE,23,145,"F-C",23,23,"Philadelphia 76ers","Joel Embiid",2,52,57,46,16,65.7
1,2,5,4,2,9,4,0,0,"21",1,4,10,6,1,0,1037902,"2023-12-13T00:00:00.000Z",9,FALSE,23,313,"G",23,23,"Philadelphia 76ers","De'Anthony Melton",3,16,17,11,7,27.7
9,0,3,6,0,13,2,6,5,"33",1,1,9,4,0,1,1037902,"2023-12-13T00:00:00.000Z",9,FALSE,23,3547254,"G",23,23,"Philadelphia 76ers","Tyrese Maxey",0,13,22,18,13,26.3
0,0,0,0,0,1,1,0,0,"04",0,0,2,0,0,0,1037902,"2023-12-13T00:00:00.000Z",9,FALSE,23,28,"C",23,23,"Philadelphia 76ers","Mo Bamba",0,2,2,2,0,2
1,0,1,2,1,3,1,2,0,"13",0,2,3,1,0,0,1037902,"2023-12-13T00:00:00.000Z",9,FALSE,23,45,"G",23,23,"Philadelphia 76ers","Patrick Beverley",0,4,5,4,2,5.7
2,0,6,2,0,4,2,1,1,"17",0,2,5,6,0,1,1037902,"2023-12-13T00:00:00.000Z",9,FALSE,23,108,"F",23,23,"Philadelphia 76ers","Robert Covington",0,11,13,7,8,14.2
2,1,7,0,0,2,2,0,0,"16",1,2,4,8,0,0,1037902,"2023-12-13T00:00:00.000Z",9,FALSE,23,328,"F",23,23,"Philadelphia 76ers","Marcus Morris",1,12,14,6,10,19.6
1,0,3,4,2,9,7,2,1,"23",0,2,17,3,2,2,1037902,"2023-12-13T00:00:00.000Z",9,FALSE,23,360,"F",23,23,"Philadelphia 76ers","Kelly Oubre Jr.",2,20,21,18,4,26.1
0,0,0,0,0,0,0,0,0,"00",0,0,0,0,0,0,1037902,"2023-12-13T00:00:00.000Z",9,FALSE,23,330,"G",9,9,"Detroit Pistons","Monte Morris",0,0,0,0,0,0
1,0,0,1,0,3,0,0,0,"07",0,0,0,0,0,0,1037902,"2023-12-13T00:00:00.000Z",9,FALSE,23,2175,"",23,23,"Philadelphia 76ers","Danuel House Jr.",0,0,1,1,1,1.5
0,0,0,1,0,1,0,0,0,"05",0,0,0,0,0,0,1037902,"2023-12-13T00:00:00.000Z",9,FALSE,23,260,"G-F",23,23,"Philadelphia 76ers","Furkan Korkmaz",0,0,0,0,0,0
1,0,1,0,0,1,1,0,0,"04",1,0,2,2,1,0,1037902,"2023-12-13T00:00:00.000Z",9,FALSE,23,3547294,"F",23,23,"Philadelphia 76ers","Kenyon Martin Jr.",1,4,5,3,3,8.9
0,0,3,0,0,3,1,3,3,"13",1,2,5,4,0,3,1037902,"2023-12-13T00:00:00.000Z",9,FALSE,23,3547270,"F",23,23,"Philadelphia 76ers","Paul Reed",0,9,9,5,4,6.8
2,0,0,1,1,2,1,4,2,"07",0,1,5,0,0,0,1037902,"2023-12-13T00:00:00.000Z",9,FALSE,23,17896025,"G",23,23,"Philadelphia 76ers","Jaden Springer",0,5,7,7,2,8
0,0,0,0,0,0,0,0,0,"00",0,0,0,0,0,0,1037902,"2023-12-13T00:00:00.000Z",9,FALSE,23,56913527,"G",23,23,"Philadelphia 76ers","Ricky Council IV",0,0,0,0,0,0
0,0,0,0,0,0,0,0,0,"00",0,0,0,0,0,0,1037902,"2023-12-13T00:00:00.000Z",9,FALSE,23,17554001,"G",23,23,"Philadelphia 76ers","Javonte Smart",0,0,0,0,0,0
0,0,0,0,0,0,0,0,0,"00",0,0,0,0,0,0,1037902,"2023-12-13T00:00:00.000Z",9,FALSE,23,56677788,"G",23,23,"Philadelphia 76ers","Terquavion Smith",0,0,0,0,0,0
7,0,5,3,1,8,4,4,4,"30",1,1,13,6,0,2,1037903,"2023-12-13T00:00:00.000Z",30,FALSE,19,3547242,"F",30,30,"Washington Wizards","Deni Avdija",0,19,26,20,13,28.7
4,1,7,8,4,19,10,4,3,"29",0,1,27,7,1,1,1037903,"2023-12-13T00:00:00.000Z",30,FALSE,19,265,"F",30,30,"Washington Wizards","Kyle Kuzma",2,34,38,31,11,46.4
0,2,5,0,0,6,5,4,3,"24",1,3,13,6,1,1,1037903,"2023-12-13T00:00:00.000Z",30,FALSE,19,666577,"F",30,30,"Washington Wizards","Daniel Gafford",3,19,19,13,6,28.2
4,1,1,5,1,12,5,0,0,"31",0,2,11,1,2,5,1037903,"2023-12-13T00:00:00.000Z",30,FALSE,19,666848,"G",30,30,"Washington Wizards","Jordan Poole",3,12,16,15,5,22.2
4,0,0,5,2,6,2,0,0,"26",0,0,6,0,1,1,1037903,"2023-12-13T00:00:00.000Z",30,FALSE,19,249,"G",30,30,"Washington Wizards","Tyus Jones",1,6,10,10,4,14
1,0,0,1,1,1,1,2,2,"04",0,1,5,0,0,0,1037903,"2023-12-13T00:00:00.000Z",30,FALSE,19,38017704,"F",30,30,"Washington Wizards","Patrick Baldwin Jr.",0,5,6,6,1,6.5
4,0,1,4,2,4,2,2,2,"13",0,1,8,1,1,1,1037903,"2023-12-13T00:00:00.000Z",30,FALSE,19,18677954,"G",30,30,"Washington Wizards","Jared Butler",1,9,13,12,5,17.2
1,1,4,6,4,9,6,2,0,"32",1,3,16,5,1,2,1037903,"2023-12-13T00:00:00.000Z",30,FALSE,19,56677844,"G",30,30,"Washington Wizards","Bilal Coulibaly",2,21,22,17,6,27.5
1,0,1,3,1,6,2,4,4,"16",0,0,9,1,0,1,1037903,"2023-12-13T00:00:00.000Z",30,FALSE,19,167,"F",30,30,"Washington Wizards","Danilo Gallinari",0,10,11,10,2,10.7
2,0,2,1,0,2,1,0,0,"10",0,2,2,2,0,0,1037903,"2023-12-13T00:00:00.000Z",30,FALSE,19,3547302,"F",30,30,"Washington Wizards","Anthony Gill",0,4,6,4,4,7.4
0,1,3,6,3,7,4,2,1,"21",0,2,12,3,0,1,1037903,"2023-12-13T00:00:00.000Z",30,FALSE,19,17896045,"F",30,30,"Washington Wizards","Corey Kispert",1,15,15,12,3,17.6
0,0,1,2,0,2,0,0,0,"04",0,0,0,1,0,0,1037903,"2023-12-13T00:00:00.000Z",30,FALSE,19,337,"F-C",30,30,"Washington Wizards","Mike Muscala",0,1,1,0,1,1.2
0,0,0,0,0,0,0,0,0,"00",0,0,0,0,0,0,1037903,"2023-12-13T00:00:00.000Z",30,FALSE,19,NA,NA,NA,30,"Washington Wizards","NA NA",0,0,0,0,0,0
0,0,0,0,0,0,0,0,0,"00",0,0,0,0,0,0,1037903,"2023-12-13T00:00:00.000Z",30,FALSE,19,38017687,"G",30,30,"Washington Wizards","Johnny Davis",0,0,0,0,0,0
0,0,0,0,0,0,0,0,0,"00",0,0,0,0,0,0,1037903,"2023-12-13T00:00:00.000Z",30,FALSE,19,17896106,"F",30,30,"Washington Wizards","Eugene Omoruyi",0,0,0,0,0,0
0,0,0,0,0,0,0,0,0,"00",0,0,0,0,0,0,1037903,"2023-12-13T00:00:00.000Z",30,FALSE,19,38017712,"G",30,30,"Washington Wizards","Ryan Rollins",0,0,0,0,0,0
0,0,0,0,0,0,0,0,0,"00",0,0,0,0,0,0,1037903,"2023-12-13T00:00:00.000Z",30,FALSE,19,414,"G",30,30,"Washington Wizards","Landry Shamet",0,0,0,0,0,0
0,0,0,0,0,0,0,0,0,"00",0,0,0,0,0,0,1037903,"2023-12-13T00:00:00.000Z",30,FALSE,19,487,"G",30,30,"Washington Wizards","Delon Wright",0,0,0,0,0,0
1,0,1,1,0,9,3,0,0,"20",1,3,6,2,2,1,1037903,"2023-12-13T00:00:00.000Z",30,FALSE,19,17896024,"F",19,19,"New Orleans Pelicans","Herbert Jones",2,8,9,7,3,14.9
3,1,1,4,1,23,14,12,11,"31",1,2,40,2,0,1,1037903,"2023-12-13T00:00:00.000Z",30,FALSE,19,227,"F",19,19,"New Orleans Pelicans","Brandon Ingram",1,42,45,43,5,48.9
3,1,15,1,1,9,6,4,3,"33",3,4,16,18,1,4,1037903,"2023-12-13T00:00:00.000Z",30,FALSE,19,455,"C",19,19,"New Orleans Pelicans","Jonas Valanciunas",2,34,37,19,21,44.1
2,0,2,4,0,6,1,0,0,"16",2,0,2,4,2,0,1037903,"2023-12-13T00:00:00.000Z",30,FALSE,19,38017677,"G",19,19,"New Orleans Pelicans","Dyson Daniels",2,6,8,4,6,15.8
6,0,3,6,4,14,8,2,2,"32",0,3,22,3,0,0,1037903,"2023-12-13T00:00:00.000Z",30,FALSE,19,303,"G",19,19,"New Orleans Pelicans","CJ McCollum",0,25,31,28,9,34.6
1,0,1,3,2,3,2,2,1,"18",0,2,7,1,2,2,1037903,"2023-12-13T00:00:00.000Z",30,FALSE,19,17896097,"G",19,19,"New Orleans Pelicans","Jose Alvarado",2,8,9,8,2,13.7
1,0,2,2,0,7,1,0,0,"19",1,1,2,3,0,0,1037903,"2023-12-13T00:00:00.000Z",30,FALSE,19,56677837,"G",19,19,"New Orleans Pelicans","Jordan Hawkins",0,5,6,3,4,7.1
0,0,1,1,0,1,0,0,0,"04",0,0,0,1,0,0,1037903,"2023-12-13T00:00:00.000Z",30,FALSE,19,3547260,"G",19,19,"New Orleans Pelicans","Kira Lewis Jr.",0,1,1,0,1,1.2
7,0,4,5,2,11,6,2,2,"27",0,1,16,4,2,1,1037903,"2023-12-13T00:00:00.000Z",30,FALSE,19,3547293,"F",19,19,"New Orleans Pelicans","Naji Marshall",2,20,27,23,11,36.3
4,1,6,7,6,10,7,8,7,"33",0,0,27,6,2,0,1037903,"2023-12-13T00:00:00.000Z",30,FALSE,19,18677986,"F",19,19,"New Orleans Pelicans","Trey Murphy III",3,33,37,31,10,49.2
0,0,0,0,0,2,1,0,0,"02",2,0,2,2,0,0,1037903,"2023-12-13T00:00:00.000Z",30,FALSE,19,17896021,"F",19,19,"New Orleans Pelicans","Jeremiah Robinson-Earl",0,4,4,2,2,4.4
2,0,0,0,0,1,1,0,0,"05",0,1,2,0,0,0,1037903,"2023-12-13T00:00:00.000Z",30,FALSE,19,491,"C",19,19,"New Orleans Pelicans","Cody Zeller",0,2,4,4,2,5
0,0,0,0,0,0,0,0,0,"00",0,0,0,0,0,0,1037903,"2023-12-13T00:00:00.000Z",30,FALSE,19,38017663,"F",19,19,"New Orleans Pelicans","E.J. Liddell",0,0,0,0,0,0
0,0,0,0,0,0,0,0,0,"00",0,0,0,0,0,0,1037903,"2023-12-13T00:00:00.000Z",30,FALSE,19,340,"F",19,19,"New Orleans Pelicans","Larry Nance Jr.",0,0,0,0,0,0
0,0,0,0,0,0,0,0,0,"00",0,0,0,0,0,0,1037903,"2023-12-13T00:00:00.000Z",30,FALSE,19,17896017,"F",19,19,"New Orleans Pelicans","Matt Ryan",0,0,0,0,0,0
0,0,0,0,0,0,0,0,0,"00",0,0,0,0,0,0,1037903,"2023-12-13T00:00:00.000Z",30,FALSE,19,38017726,"G",19,19,"New Orleans Pelicans","Dereon Seabron",0,0,0,0,0,0
0,0,0,0,0,0,0,0,0,"00",0,0,0,0,0,0,1037903,"2023-12-13T00:00:00.000Z",30,FALSE,19,666969,"F",19,19,"New Orleans Pelicans","Zion Williamson",0,0,0,0,0,0
3,0,3,5,2,13,10,0,0,"37",2,4,22,5,1,2,1037905,"2023-12-13T00:00:00.000Z",28,FALSE,1,18,"F",28,28,"Toronto Raptors","OG Anunoby",1,27,30,25,8,33.5
7,0,6,6,5,19,12,7,4,"36",1,0,33,7,0,2,1037905,"2023-12-13T00:00:00.000Z",28,FALSE,1,416,"F",28,28,"Toronto Raptors","Pascal Siakam",0,40,47,40,14,49.9
6,3,9,0,0,8,5,8,5,"32",4,4,15,13,0,1,1037905,"2023-12-13T00:00:00.000Z",28,FALSE,1,373,"C",28,28,"Toronto Raptors","Jakob Poeltl",3,28,34,21,19,47.6
6,1,9,4,3,14,11,3,2,"34",1,3,27,10,0,3,1037905,"2023-12-13T00:00:00.000Z",28,FALSE,1,17896055,"G-F",28,28,"Toronto Raptors","Scottie Barnes",1,37,43,33,16,48
7,1,3,4,3,11,5,4,4,"37",0,5,17,3,1,2,1037905,"2023-12-13T00:00:00.000Z",28,FALSE,1,409,"G",28,28,"Toronto Raptors","Dennis Schroder",2,20,27,24,10,35.1
1,2,6,3,1,5,2,2,2,"17",1,0,7,7,1,2,1037905,"2023-12-13T00:00:00.000Z",28,FALSE,1,3547249,"F",28,28,"Toronto Raptors","Precious Achiuwa",3,14,15,8,8,23.9
0,2,0,1,0,2,1,0,0,"10",0,0,2,0,0,0,1037905,"2023-12-13T00:00:00.000Z",28,FALSE,1,58,"F",28,28,"Toronto Raptors","Chris Boucher",2,2,2,2,0,8
0,0,0,0,0,0,0,0,0,"00",0,0,0,0,0,0,1037905,"2023-12-13T00:00:00.000Z",28,FALSE,1,56677828,"G",28,28,"Toronto Raptors","Gradey Dick",0,0,0,0,0,0
8,0,2,3,0,4,0,0,0,"17",0,2,0,2,0,2,1037905,"2023-12-13T00:00:00.000Z",28,FALSE,1,3547275,"G",28,28,"Toronto Raptors","Malachi Flynn",0,2,10,8,10,12.4
0,0,0,0,0,0,0,0,0,"00",0,0,0,0,0,0,1037905,"2023-12-13T00:00:00.000Z",28,FALSE,1,666762,"F",28,28,"Toronto Raptors","Jalen McDaniels",0,0,0,0,0,0
0,0,0,0,0,0,0,0,0,"00",0,0,0,0,0,0,1037905,"2023-12-13T00:00:00.000Z",28,FALSE,1,376,"F",28,28,"Toronto Raptors","Otto Porter Jr.",0,0,0,0,0,0
0,0,0,0,0,0,0,0,0,"00",0,0,0,0,0,0,1037905,"2023-12-13T00:00:00.000Z",28,FALSE,1,436,"G-F",28,28,"Toronto Raptors","Garrett Temple",0,0,0,0,0,0
1,0,0,8,4,11,4,0,0,"20",0,0,12,0,0,0,1037905,"2023-12-13T00:00:00.000Z",28,FALSE,1,3089,"",28,28,"Toronto Raptors","Gary Trent Jr.",0,12,13,13,1,13.5
0,0,0,0,0,0,0,0,0,"00",0,0,0,0,0,0,1037905,"2023-12-13T00:00:00.000Z",28,FALSE,1,489,"F",28,28,"Toronto Raptors","Thaddeus Young",0,0,0,0,0,0
0,0,0,0,0,0,0,0,0,"00",0,0,0,0,0,0,1037905,"2023-12-13T00:00:00.000Z",28,FALSE,1,56677805,"G",28,28,"Toronto Raptors","Javon Freeman-Liberty",0,0,0,0,0,0
0,0,0,0,0,0,0,0,0,"00",0,0,0,0,0,0,1037905,"2023-12-13T00:00:00.000Z",28,FALSE,1,38017710,"C",28,28,"Toronto Raptors","Christian Koloko",0,0,0,0,0,0
0,0,0,0,0,0,0,0,0,"00",0,0,0,0,0,0,1037905,"2023-12-13T00:00:00.000Z",28,FALSE,1,56677869,"G",28,28,"Toronto Raptors","Markquis Nowell",0,0,0,0,0,0
0,0,0,0,0,0,0,0,0,"00",0,0,0,0,0,0,1037905,"2023-12-13T00:00:00.000Z",28,FALSE,1,2309958,"C-F",15,28,"Toronto Raptors","Jontay Porter",0,0,0,0,0,0
1,0,1,4,1,6,1,2,2,"14",1,3,5,2,2,0,1037905,"2023-12-13T00:00:00.000Z",28,FALSE,1,301,"G-F",1,1,"Atlanta Hawks","Wesley Matthews",2,7,8,6,3,14.9
2,0,7,5,0,14,5,3,2,"38",3,1,12,10,2,1,1037905,"2023-12-13T00:00:00.000Z",28,FALSE,1,3547256,"F",1,1,"Atlanta Hawks","Saddiq Bey",2,22,24,14,12,32
1,3,4,0,0,12,7,4,3,"34",6,3,17,10,0,0,1037905,"2023-12-13T00:00:00.000Z",28,FALSE,1,83,"C",1,1,"Atlanta Hawks","Clint Capela",3,27,28,18,11,39.5
5,2,3,9,4,17,8,1,0,"34",0,2,20,3,0,0,1037905,"2023-12-13T00:00:00.000Z",28,FALSE,1,334,"G",1,1,"Atlanta Hawks","Dejounte Murray",2,23,28,25,8,37.1
17,1,4,9,4,27,13,6,5,"39",0,3,35,4,0,5,1037905,"2023-12-13T00:00:00.000Z",28,FALSE,1,490,"G",1,1,"Atlanta Hawks","Trae Young",1,39,56,52,21,63.3
5,0,2,7,4,13,7,3,2,"32",1,4,20,3,3,1,1037905,"2023-12-13T00:00:00.000Z",28,FALSE,1,53,"G",1,1,"Atlanta Hawks","Bogdan Bogdanovic",3,23,28,25,8,39.1
0,0,0,0,0,0,0,0,0,"00",0,0,0,0,0,0,1037905,"2023-12-13T00:00:00.000Z",28,FALSE,1,666564,"F",1,1,"Atlanta Hawks","Bruno Fernando",0,0,0,0,0,0
0,0,0,0,0,0,0,0,0,"00",0,0,0,0,0,0,1037905,"2023-12-13T00:00:00.000Z",28,FALSE,1,3547297,"G",1,1,"Atlanta Hawks","Trent Forrest",0,0,0,0,0,0
0,0,0,0,0,0,0,0,0,"00",0,0,0,0,0,0,1037905,"2023-12-13T00:00:00.000Z",28,FALSE,1,56677855,"G",1,1,"Atlanta Hawks","Seth Lundy",0,0,0,0,0,0
0,0,2,2,2,2,2,0,0,"19",0,2,6,2,1,0,1037905,"2023-12-13T00:00:00.000Z",28,FALSE,1,666754,"G",1,1,"Atlanta Hawks","Garrison Mathews",1,8,8,6,2,11.4
0,0,0,0,0,0,0,0,0,"00",0,0,0,0,0,0,1037905,"2023-12-13T00:00:00.000Z",28,FALSE,1,319,"G",1,1,"Atlanta Hawks","Patty Mills",0,0,0,0,0,0
1,2,6,5,3,9,5,0,0,"30",2,0,13,8,1,0,1037905,"2023-12-13T00:00:00.000Z",28,FALSE,1,3547244,"F-C",1,1,"Atlanta Hawks","Onyeka Okongwu",3,21,22,14,9,33.1
0,0,0,0,0,0,0,0,0,"00",0,0,0,0,0,0,1037905,"2023-12-13T00:00:00.000Z",28,FALSE,1,56677838,"G",1,1,"Atlanta Hawks","Kobe Bufkin",0,0,0,0,0,0
0,0,0,0,0,0,0,0,0,"00",0,0,0,0,0,0,1037905,"2023-12-13T00:00:00.000Z",28,FALSE,1,38017689,"F",1,1,"Atlanta Hawks","AJ Griffin",0,0,0,0,0,0
0,0,0,0,0,0,0,0,0,"00",0,0,0,0,0,0,1037905,"2023-12-13T00:00:00.000Z",28,FALSE,1,56677806,"F",1,1,"Atlanta Hawks","Mouhamed Gueye",0,0,0,0,0,0
0,0,0,0,0,0,0,0,0,"00",0,0,0,0,0,0,1037905,"2023-12-13T00:00:00.000Z",28,FALSE,1,666656,"F",1,1,"Atlanta Hawks","De'Andre Hunter",0,0,0,0,0,0
0,0,0,0,0,0,0,0,0,"00",0,0,0,0,0,0,1037905,"2023-12-13T00:00:00.000Z",28,FALSE,1,17896040,"F",1,1,"Atlanta Hawks","Jalen Johnson",0,0,0,0,0,0
0,0,0,0,0,0,0,0,0,"00",0,0,0,0,0,0,1037905,"2023-12-13T00:00:00.000Z",28,FALSE,1,56677875,"F",1,1,"Atlanta Hawks","Miles Norris",0,0,0,0,0,0
1,0,2,3,1,8,4,2,2,"28",0,6,11,2,0,4,1037906,"2023-12-13T00:00:00.000Z",11,FALSE,15,66,"G-F",11,11,"Houston Rockets","Dillon Brooks",0,13,14,12,3,10.9
1,1,8,5,3,10,7,6,3,"30",2,2,20,10,1,1,1037906,"2023-12-13T00:00:00.000Z",11,FALSE,15,38017684,"F",11,11,"Houston Rockets","Jabari Smith Jr.",2,30,31,21,11,38.5
2,0,9,1,0,8,2,6,5,"24",1,4,9,10,0,2,1037906,"2023-12-13T00:00:00.000Z",11,FALSE,15,17896062,"F-C",11,11,"Houston Rockets","Alperen Sengun",0,19,21,11,12,22
4,0,4,5,0,12,2,4,4,"24",0,3,8,4,0,3,1037906,"2023-12-13T00:00:00.000Z",11,FALSE,15,17895966,"G",11,11,"Houston Rockets","Jalen Green",0,12,16,12,8,15.8
9,0,5,3,0,8,2,9,7,"39",0,4,11,5,3,3,1037906,"2023-12-13T00:00:00.000Z",11,FALSE,15,458,"G",11,11,"Houston Rockets","Fred VanVleet",3,16,25,20,14,36.5
0,0,0,4,2,4,2,0,0,"07",0,0,6,0,0,0,1037906,"2023-12-13T00:00:00.000Z",11,FALSE,15,75,"G-F",11,11,"Houston Rockets","Reggie Bullock",0,6,6,6,0,6
1,1,8,4,3,16,10,4,2,"27",6,2,25,14,1,3,1037906,"2023-12-13T00:00:00.000Z",11,FALSE,15,38017695,"F",11,11,"Houston Rockets","Tari Eason",2,39,40,26,15,46.3
0,0,2,0,0,3,3,3,3,"13",1,2,9,3,0,2,1037906,"2023-12-13T00:00:00.000Z",11,FALSE,15,188,"F",11,11,"Houston Rockets","Jeff Green",0,12,12,9,3,10.6
2,1,0,3,2,6,2,0,0,"14",0,2,6,0,0,1,1037906,"2023-12-13T00:00:00.000Z",11,FALSE,15,213,"G",11,11,"Houston Rockets","Aaron Holiday",1,6,8,8,2,11
0,0,1,0,0,2,1,0,0,"11",2,2,2,3,0,0,1037906,"2023-12-13T00:00:00.000Z",11,FALSE,15,19465326,"C",11,11,"Houston Rockets","Jock Landale",0,5,5,2,3,5.6
0,0,0,0,0,0,0,0,0,"00",0,0,0,0,0,0,1037906,"2023-12-13T00:00:00.000Z",11,FALSE,15,296,"C",11,11,"Houston Rockets","Boban Marjanovic",0,0,0,0,0,0
3,0,4,4,1,9,4,3,1,"23",3,1,10,7,1,0,1037906,"2023-12-13T00:00:00.000Z",11,FALSE,15,3547301,"F",11,11,"Houston Rockets","Jae'Sean Tate",1,17,20,13,10,25.9
0,0,0,0,0,0,0,0,0,"00",0,0,0,0,0,0,1037906,"2023-12-13T00:00:00.000Z",11,FALSE,15,47738533,"G",11,11,"Houston Rockets","Jeenathan Williams",0,0,0,0,0,0
0,0,0,0,0,0,0,0,0,"00",0,0,0,0,0,0,1037906,"2023-12-13T00:00:00.000Z",11,FALSE,15,3547281,"G-F",11,11,"Houston Rockets","Nate Hinton",0,0,0,0,0,0
0,0,0,0,0,0,0,0,0,"00",0,0,0,0,0,0,1037906,"2023-12-13T00:00:00.000Z",11,FALSE,15,357,"G",11,11,"Houston Rockets","Victor Oladipo",0,0,0,0,0,0
0,0,0,0,0,0,0,0,0,"00",0,0,0,0,0,0,1037906,"2023-12-13T00:00:00.000Z",11,FALSE,15,56677809,"F",11,11,"Houston Rockets","Jermaine Samuels Jr.",0,0,0,0,0,0
0,0,0,0,0,0,0,0,0,"00",0,0,0,0,0,0,1037906,"2023-12-13T00:00:00.000Z",11,FALSE,15,56677825,"G-F",11,11,"Houston Rockets","Amen Thompson",0,0,0,0,0,0
0,0,0,0,0,0,0,0,0,"00",0,0,0,0,0,0,1037906,"2023-12-13T00:00:00.000Z",11,FALSE,15,56677831,"F",11,11,"Houston Rockets","Cam Whitmore",0,0,0,0,0,0
4,0,5,7,2,14,3,2,1,"32",1,1,9,6,1,1,1037906,"2023-12-13T00:00:00.000Z",11,FALSE,15,38017729,"F",15,15,"Memphis Grizzlies","David Roddy",1,15,19,13,10,24.2
2,1,6,8,3,24,15,13,11,"40",1,4,44,7,4,3,1037906,"2023-12-13T00:00:00.000Z",11,FALSE,15,231,"F-C",15,15,"Memphis Grizzlies","Jaren Jackson Jr.",5,51,53,46,9,67.4
1,0,5,0,0,2,1,6,1,"24",1,5,3,6,0,2,1037906,"2023-12-13T00:00:00.000Z",11,FALSE,15,48,"C",15,15,"Memphis Grizzlies","Bismack Biyombo",0,9,10,4,7,9.7
1,0,6,4,2,5,2,6,4,"28",1,6,10,7,1,0,1037906,"2023-12-13T00:00:00.000Z",11,FALSE,15,38017731,"G",15,15,"Memphis Grizzlies","Vince Williams Jr.",1,17,18,11,8,22.9
6,1,3,4,1,14,7,4,4,"31",1,4,19,4,0,1,1037906,"2023-12-13T00:00:00.000Z",11,FALSE,15,401,"G",15,15,"Memphis Grizzlies","Derrick Rose",1,23,29,25,10,34.8
1,2,5,2,1,4,3,0,0,"16",0,4,7,5,0,1,1037906,"2023-12-13T00:00:00.000Z",11,FALSE,15,17896067,"F",15,15,"Memphis Grizzlies","Santi Aldama",2,12,13,8,6,19.5
3,0,0,1,1,1,1,0,0,"13",0,0,3,0,0,0,1037906,"2023-12-13T00:00:00.000Z",11,FALSE,15,48248287,"G",15,15,"Memphis Grizzlies","Jacob Gilyard",0,3,6,6,3,7.5
1,0,0,1,0,1,0,0,0,"07",0,0,0,0,1,0,1037906,"2023-12-13T00:00:00.000Z",11,FALSE,15,666703,"G-F",15,15,"Memphis Grizzlies","John Konchar",1,0,1,1,1,4.5
2,0,0,3,0,6,2,0,0,"15",0,3,4,0,0,1,1037906,"2023-12-13T00:00:00.000Z",11,FALSE,15,38017728,"F",15,15,"Memphis Grizzlies","Jake LaRavia",0,4,6,6,2,6
0,0,0,0,0,0,0,0,0,"00",0,0,0,0,0,0,1037906,"2023-12-13T00:00:00.000Z",11,FALSE,15,38017732,"F",15,15,"Memphis Grizzlies","Kenneth Lofton Jr.",0,0,0,0,0,0
1,0,0,2,0,3,0,0,0,"08",0,1,0,0,0,1,1037906,"2023-12-13T00:00:00.000Z",11,FALSE,15,666809,"G",15,15,"Memphis Grizzlies","Jaylen Nowell",0,0,1,1,1,0.5
0,0,0,0,0,0,0,0,0,"00",0,0,0,0,0,0,1037906,"2023-12-13T00:00:00.000Z",11,FALSE,15,3547285,"F",15,15,"Memphis Grizzlies","Xavier Tillman",0,0,0,0,0,0
3,0,4,6,0,8,1,3,3,"26",0,2,5,4,0,1,1037906,"2023-12-13T00:00:00.000Z",11,FALSE,15,17896027,"G-F",15,15,"Memphis Grizzlies","Ziaire Williams",0,9,12,8,7,13.3
0,0,0,0,0,0,0,0,0,"00",0,0,0,0,0,0,1037906,"2023-12-13T00:00:00.000Z",11,FALSE,15,3,"C",15,15,"Memphis Grizzlies","Steven Adams",0,0,0,0,0,0
0,0,0,0,0,0,0,0,0,"00",0,0,0,0,0,0,1037906,"2023-12-13T00:00:00.000Z",11,FALSE,15,3547287,"G",15,15,"Memphis Grizzlies","Desmond Bane",0,0,0,0,0,0
0,0,0,0,0,0,0,0,0,"00",0,0,0,0,0,0,1037906,"2023-12-13T00:00:00.000Z",11,FALSE,15,666505,"F",15,15,"Memphis Grizzlies","Brandon Clarke",0,0,0,0,0,0
0,0,0,0,0,0,0,0,0,"00",0,0,0,0,0,0,1037906,"2023-12-13T00:00:00.000Z",11,FALSE,15,56677830,"F",15,15,"Memphis Grizzlies","GG Jackson",0,0,0,0,0,0
0,0,0,0,0,0,0,0,0,"00",0,0,0,0,0,0,1037906,"2023-12-13T00:00:00.000Z",11,FALSE,15,420,"G",15,15,"Memphis Grizzlies","Marcus Smart",0,0,0,0,0,0
0,0,0,0,0,0,0,0,0,"00",0,0,0,0,0,0,1037906,"2023-12-13T00:00:00.000Z",11,FALSE,15,254,"G",15,15,"Memphis Grizzlies","Luke Kennard",0,0,0,0,0,0
0,0,0,0,0,0,0,0,0,"00",0,0,0,0,0,0,1037906,"2023-12-13T00:00:00.000Z",11,FALSE,15,666786,"G",15,15,"Memphis Grizzlies","Ja Morant",0,0,0,0,0,0
7,0,8,3,1,11,6,1,1,"29",1,3,14,9,1,1,1037907,"2023-12-13T00:00:00.000Z",17,FALSE,12,315,"F",17,17,"Milwaukee Bucks","Khris Middleton",1,23,30,21,16,37.3
3,1,11,3,0,28,20,32,24,"37",3,1,64,14,4,3,1037907,"2023-12-13T00:00:00.000Z",17,FALSE,12,15,"F",17,17,"Milwaukee Bucks","Giannis Antetokounmpo",5,78,81,67,17,97.3
1,6,1,2,0,6,1,4,4,"33",2,5,6,3,0,1,1037907,"2023-12-13T00:00:00.000Z",17,FALSE,12,283,"C",17,17,"Milwaukee Bucks","Brook Lopez",6,9,10,7,4,28.1
2,1,2,4,1,7,3,0,0,"36",4,3,7,6,2,0,1037907,"2023-12-13T00:00:00.000Z",17,FALSE,12,38,"G",17,17,"Milwaukee Bucks","Malik Beasley",3,13,15,9,8,26.2
6,0,4,8,2,14,6,9,7,"36",0,2,21,4,1,5,1037907,"2023-12-13T00:00:00.000Z",17,FALSE,12,278,"G",17,17,"Milwaukee Bucks","Damian Lillard",1,25,31,27,10,32.8
0,0,3,0,0,4,3,0,0,"15",0,2,6,3,0,3,1037907,"2023-12-13T00:00:00.000Z",17,FALSE,12,38017676,"F",17,17,"Milwaukee Bucks","MarJon Beauchamp",0,9,9,6,3,6.6
2,0,1,4,3,13,8,0,0,"23",1,2,19,2,0,0,1037907,"2023-12-13T00:00:00.000Z",17,FALSE,12,377,"F",17,17,"Milwaukee Bucks","Bobby Portis",0,21,23,21,4,24.4
1,2,3,0,0,4,3,4,3,"13",0,3,9,3,1,1,1037907,"2023-12-13T00:00:00.000Z",17,FALSE,12,17896035,"F",12,12,"Indiana Pacers","Isaiah Jackson",3,12,13,10,4,22.1
5,0,4,2,0,9,4,1,1,"16",1,1,9,5,2,3,1037907,"2023-12-13T00:00:00.000Z",17,FALSE,12,304,"G",12,12,"Indiana Pacers","T.J. McConnell",2,14,19,14,10,25.5
1,0,0,7,2,11,5,0,0,"25",1,5,12,1,0,2,1037907,"2023-12-13T00:00:00.000Z",17,FALSE,12,3547250,"G-F",12,12,"Indiana Pacers","Aaron Nesmith",0,13,14,13,2,12.7
1,0,1,1,1,2,2,0,0,"06",1,0,5,2,1,1,1037907,"2023-12-13T00:00:00.000Z",17,FALSE,12,3547207,"F",12,12,"Indiana Pacers","Jordan Nwora",1,7,8,6,3,10.9
0,0,0,3,2,6,3,0,0,"06",0,2,8,0,1,0,1037907,"2023-12-13T00:00:00.000Z",17,FALSE,12,56677861,"G",12,12,"Indiana Pacers","Ben Sheppard",1,8,8,8,0,11
0,0,1,0,0,1,0,2,1,"06",0,1,1,1,0,0,1037907,"2023-12-13T00:00:00.000Z",17,FALSE,12,56677778,"F-C",12,12,"Indiana Pacers","Oscar Tshiebwe",0,2,2,1,1,2.2
2,1,0,2,1,3,1,0,0,"06",0,4,3,0,0,1,1037907,"2023-12-13T00:00:00.000Z",17,FALSE,12,56677832,"F",12,12,"Indiana Pacers","Jarace Walker",1,3,5,5,2,8
0,0,0,0,0,0,0,0,0,"00",0,0,0,0,0,0,1037907,"2023-12-13T00:00:00.000Z",17,FALSE,12,38017701,"G",12,12,"Indiana Pacers","Kendall Brown",0,0,0,0,0,0
0,0,0,0,0,0,0,0,0,"00",0,0,0,0,0,0,1037907,"2023-12-13T00:00:00.000Z",17,FALSE,12,38017507,"G-F",12,12,"Indiana Pacers","Andrew Nembhard",0,0,0,0,0,0
0,0,0,0,0,0,0,0,0,"00",0,0,0,0,0,0,1037907,"2023-12-13T00:00:00.000Z",17,FALSE,12,3547264,"F-C",12,12,"Indiana Pacers","Jalen Smith",0,0,0,0,0,0
0,0,0,0,0,0,0,0,0,"00",0,0,0,0,0,0,1037907,"2023-12-13T00:00:00.000Z",17,FALSE,12,56677794,"G",12,12,"Indiana Pacers","Isaiah Wong",0,0,0,0,0,0
2,0,1,1,0,2,1,0,0,"14",1,4,2,2,0,0,1037907,"2023-12-13T00:00:00.000Z",17,FALSE,12,56677852,"G",17,17,"Milwaukee Bucks","Andre Jackson Jr.",0,4,6,4,4,7.4
0,0,0,0,0,0,0,0,0,"01",0,0,0,0,0,1,1037907,"2023-12-13T00:00:00.000Z",17,FALSE,12,2148,"",17,17,"Milwaukee Bucks","Thanasis Antetokounmpo",0,0,0,0,0,-1
0,0,0,0,0,0,0,0,0,"01",0,0,0,0,0,0,1037907,"2023-12-13T00:00:00.000Z",17,FALSE,12,38017733,"G",17,17,"Milwaukee Bucks","A.J. Green",0,0,0,0,0,0
0,0,0,0,0,0,0,0,0,"01",0,1,0,0,0,0,1037907,"2023-12-13T00:00:00.000Z",17,FALSE,12,284,"C",17,17,"Milwaukee Bucks","Robin Lopez",0,0,0,0,0,0
4,0,0,2,0,4,0,2,1,"14",0,1,1,0,0,1,1037907,"2023-12-13T00:00:00.000Z",17,FALSE,12,368,"G",17,17,"Milwaukee Bucks","Cameron Payne",0,1,5,5,4,6
0,0,0,0,0,0,0,0,0,"00",0,0,0,0,0,0,1037907,"2023-12-13T00:00:00.000Z",17,FALSE,12,666453,"C",17,17,"Milwaukee Bucks","Marques Bolden",0,0,0,0,0,0
0,0,0,0,0,0,0,0,0,"00",0,0,0,0,0,0,1037907,"2023-12-13T00:00:00.000Z",17,FALSE,12,105,"G",17,17,"Milwaukee Bucks","Pat Connaughton",0,0,0,0,0,0
0,0,0,0,0,0,0,0,0,"00",0,0,0,0,0,0,1037907,"2023-12-13T00:00:00.000Z",17,FALSE,12,112,"F",17,17,"Milwaukee Bucks","Jae Crowder",0,0,0,0,0,0
0,0,0,0,0,0,0,0,0,"00",0,0,0,0,0,0,1037907,"2023-12-13T00:00:00.000Z",17,FALSE,12,56677854,"F",17,17,"Milwaukee Bucks","Chris Livingston",0,0,0,0,0,0
0,0,0,0,0,0,0,0,0,"00",0,0,0,0,0,0,1037907,"2023-12-13T00:00:00.000Z",17,FALSE,12,38017691,"G",17,17,"Milwaukee Bucks","TyTy Washington Jr.",0,0,0,0,0,0
0,0,0,0,0,0,0,0,0,"00",0,0,0,0,0,0,1037907,"2023-12-13T00:00:00.000Z",17,FALSE,12,666960,"G",17,17,"Milwaukee Bucks","Lindell Wigginton",0,0,0,0,0,0
9,0,5,3,0,10,4,4,1,"27",3,2,9,8,2,1,1037907,"2023-12-13T00:00:00.000Z",17,FALSE,12,69,"G",12,12,"Indiana Pacers","Bruce Brown",2,17,26,18,17,37.1
1,1,4,3,1,7,2,0,0,"19",3,6,5,7,0,0,1037907,"2023-12-13T00:00:00.000Z",17,FALSE,12,3547243,"F",12,12,"Indiana Pacers","Obi Toppin",1,12,13,6,8,17.9
0,1,5,2,2,14,8,4,4,"33",4,4,22,9,0,2,1037907,"2023-12-13T00:00:00.000Z",17,FALSE,12,452,"C-F",12,12,"Indiana Pacers","Myles Turner",1,31,31,22,9,33.8
2,0,1,6,1,9,3,0,0,"27",2,1,7,3,0,1,1037907,"2023-12-13T00:00:00.000Z",17,FALSE,12,210,"G",12,12,"Indiana Pacers","Buddy Hield",0,10,12,9,5,12.6
7,0,4,4,1,16,8,7,5,"31",1,0,22,5,0,3,1037907,"2023-12-13T00:00:00.000Z",17,FALSE,12,3547245,"G",12,12,"Indiana Pacers","Tyrese Haliburton",0,27,34,29,12,35.5
1,0,1,3,0,8,2,10,10,"25",0,3,14,1,0,3,1037907,"2023-12-13T00:00:00.000Z",17,FALSE,12,38017686,"G-F",12,12,"Indiana Pacers","Bennedict Mathurin",0,15,16,15,2,13.7
4,0,5,7,1,15,5,2,2,"35",0,0,13,5,2,2,1037908,"2023-12-13T00:00:00.000Z",27,FALSE,14,3547246,"G-F",27,27,"San Antonio Spurs","Devin Vassell",2,18,22,17,9,29
8,0,4,4,4,14,10,4,4,"36",1,3,28,5,0,1,1037908,"2023-12-13T00:00:00.000Z",27,FALSE,14,666682,"F",27,27,"San Antonio Spurs","Keldon Johnson",0,33,41,36,13,45
2,6,9,5,4,21,11,7,4,"33",4,6,30,13,3,5,1037908,"2023-12-13T00:00:00.000Z",27,FALSE,14,56677822,"F-C",27,27,"San Antonio Spurs","Victor Wembanyama",9,43,45,32,15,70.6
0,0,3,5,2,13,8,1,1,"28",0,1,19,3,1,3,1037908,"2023-12-13T00:00:00.000Z",27,FALSE,14,38017692,"F",27,27,"San Antonio Spurs","Malaki Branham",1,22,22,19,3,22.6
5,0,4,4,1,9,2,2,0,"29",4,3,5,8,0,3,1037908,"2023-12-13T00:00:00.000Z",27,FALSE,14,38017699,"F",27,27,"San Antonio Spurs","Jeremy Sochan",0,13,18,10,13,19.1
1,0,1,2,0,2,0,0,0,"06",0,0,0,1,1,0,1037908,"2023-12-13T00:00:00.000Z",27,FALSE,14,38017649,"F",27,27,"San Antonio Spurs","Julian Champagnie",1,1,2,1,2,5.7
0,0,1,3,2,8,3,2,2,"19",1,3,10,2,0,1,1037908,"2023-12-13T00:00:00.000Z",27,FALSE,14,102,"F-C",27,27,"San Antonio Spurs","Zach Collins",0,12,12,10,2,11.4
0,0,0,0,0,0,0,0,0,"00",0,0,0,0,0,0,1037908,"2023-12-13T00:00:00.000Z",27,FALSE,14,180,"G",27,27,"San Antonio Spurs","Devonte' Graham",0,0,0,0,0,0
5,0,1,2,0,5,3,0,0,"22",0,0,6,1,0,2,1037908,"2023-12-13T00:00:00.000Z",27,FALSE,14,3547274,"G",27,27,"San Antonio Spurs","Tre Jones",0,7,12,11,6,12.7
0,0,0,0,0,0,0,0,0,"00",0,0,0,0,0,0,1037908,"2023-12-13T00:00:00.000Z",27,FALSE,14,17896059,"F",27,27,"San Antonio Spurs","Sandro Mamukelashvili",0,0,0,0,0,0
1,0,1,3,1,5,1,0,0,"15",0,0,3,1,1,0,1037908,"2023-12-13T00:00:00.000Z",27,FALSE,14,305,"F",27,27,"San Antonio Spurs","Doug McDermott",1,4,5,4,2,8.7
2,0,7,2,1,4,2,0,0,"17",0,0,5,7,0,0,1037908,"2023-12-13T00:00:00.000Z",27,FALSE,14,359,"F",27,27,"San Antonio Spurs","Cedi Osman",0,12,14,7,9,16.4
0,0,0,0,0,0,0,0,0,"00",0,0,0,0,0,0,1037908,"2023-12-13T00:00:00.000Z",27,FALSE,14,38017693,"G",27,27,"San Antonio Spurs","Blake Wesley",0,0,0,0,0,0
0,0,0,0,0,0,0,0,0,"00",0,0,0,0,0,0,1037908,"2023-12-13T00:00:00.000Z",27,FALSE,14,38017730,"F",27,27,"San Antonio Spurs","Dominick Barlow",0,0,0,0,0,0
0,0,0,0,0,0,0,0,0,"00",0,0,0,0,0,0,1037908,"2023-12-13T00:00:00.000Z",27,FALSE,14,17895854,"G",27,27,"San Antonio Spurs","Charles Bassey",0,0,0,0,0,0
0,0,0,0,0,0,0,0,0,"00",0,0,0,0,0,0,1037908,"2023-12-13T00:00:00.000Z",27,FALSE,14,56677865,"C",27,27,"San Antonio Spurs","Charles Bediako",0,0,0,0,0,0
0,0,0,0,0,0,0,0,0,"00",0,0,0,0,0,0,1037908,"2023-12-13T00:00:00.000Z",27,FALSE,14,56677817,"G",27,27,"San Antonio Spurs","Sidy Cissoko",0,0,0,0,0,0
0,0,0,0,0,0,0,0,0,"00",0,0,0,0,0,0,1037908,"2023-12-13T00:00:00.000Z",27,FALSE,14,56677870,"G",27,27,"San Antonio Spurs","Sir'Jabari Rice",0,0,0,0,0,0
3,1,2,3,2,7,4,0,0,"24",0,0,10,2,3,1,1037908,"2023-12-13T00:00:00.000Z",27,FALSE,14,666860,"F-G",14,14,"Los Angeles Lakers","Cameron Reddish",4,12,15,13,5,27.9
1,1,7,2,1,10,6,0,0,"24",0,2,13,7,0,3,1037908,"2023-12-13T00:00:00.000Z",27,FALSE,14,666609,"F",14,14,"Los Angeles Lakers","Rui Hachimura",1,20,21,14,8,22.9
1,0,9,3,2,23,13,12,9,"38",1,3,37,10,4,2,1037908,"2023-12-13T00:00:00.000Z",27,FALSE,14,117,"F-C",14,14,"Los Angeles Lakers","Anthony Davis",4,47,48,38,11,60.5
5,1,4,10,4,12,6,2,1,"32",1,1,17,5,2,3,1037908,"2023-12-13T00:00:00.000Z",27,FALSE,14,383,"F",14,14,"Los Angeles Lakers","Taurean Prince",3,22,27,22,10,36.5
10,0,3,4,0,13,6,1,0,"33",0,4,12,3,3,3,1037908,"2023-12-13T00:00:00.000Z",27,FALSE,14,405,"G",14,14,"Los Angeles Lakers","D'Angelo Russell",3,15,25,22,13,36.6
0,0,0,0,0,0,0,0,0,"00",0,0,0,0,0,0,1037908,"2023-12-13T00:00:00.000Z",27,FALSE,14,56677738,"C",14,14,"Los Angeles Lakers","Colin Castleton",0,0,0,0,0,0
2,0,5,4,1,5,1,0,0,"14",0,0,3,5,0,2,1037908,"2023-12-13T00:00:00.000Z",27,FALSE,14,38017697,"G",14,14,"Los Angeles Lakers","Max Christie",0,8,10,5,7,10
0,0,1,0,0,3,2,0,0,"07",0,1,4,1,0,1,1037908,"2023-12-13T00:00:00.000Z",27,FALSE,14,666626,"C",14,14,"Los Angeles Lakers","Jaxson Hayes",0,5,5,4,1,4.2
0,0,0,0,0,0,0,0,0,"00",0,0,0,0,0,0,1037908,"2023-12-13T00:00:00.000Z",27,FALSE,14,56677868,"G",14,14,"Los Angeles Lakers","D'Moi Hodge",0,0,0,0,0,0
0,0,0,0,0,0,0,0,0,"00",0,0,0,0,0,0,1037908,"2023-12-13T00:00:00.000Z",27,FALSE,14,237,"F",14,14,"Los Angeles Lakers","LeBron James",0,0,0,0,0,0
8,0,2,6,3,10,6,0,0,"29",2,2,15,4,1,1,1037908,"2023-12-13T00:00:00.000Z",27,FALSE,14,17553995,"G",14,14,"Los Angeles Lakers","Austin Reaves",1,19,27,23,12,33.8
0,1,3,0,0,1,1,0,0,"17",0,1,2,3,1,0,1037908,"2023-12-13T00:00:00.000Z",27,FALSE,14,457,"F",14,14,"Los Angeles Lakers","Jarred Vanderbilt",2,5,5,2,3,11.6
1,0,5,3,1,7,4,2,0,"22",1,2,9,6,0,0,1037908,"2023-12-13T00:00:00.000Z",27,FALSE,14,486,"F",14,14,"Los Angeles Lakers","Christian Wood",0,15,16,10,7,17.7
0,0,0,0,0,0,0,0,0,"00",0,0,0,0,0,0,1037908,"2023-12-13T00:00:00.000Z",27,FALSE,14,56677867,"F",14,14,"Los Angeles Lakers","Alex Fudge",0,0,0,0,0,0
0,0,0,0,0,0,0,0,0,"00",0,0,0,0,0,0,1037908,"2023-12-13T00:00:00.000Z",27,FALSE,14,1603383,"G",14,14,"Los Angeles Lakers","Gabe Vincent",0,0,0,0,0,0
0,0,0,0,0,0,0,0,0,"00",0,0,0,0,0,0,1037908,"2023-12-13T00:00:00.000Z",27,FALSE,14,56677835,"G",14,14,"Los Angeles Lakers","Jalen Hood-Schifino",0,0,0,0,0,0
0,0,0,0,0,0,0,0,0,"00",0,0,0,0,0,0,1037908,"2023-12-13T00:00:00.000Z",27,FALSE,14,56677836,"F",14,14,"Los Angeles Lakers","Maxwell Lewis",0,0,0,0,0,0
4,2,5,5,1,18,9,10,8,"38",1,3,27,6,1,2,1037909,"2023-12-13T00:00:00.000Z",24,FALSE,3,140,"F",24,24,"Phoenix Suns","Kevin Durant",3,33,37,31,10,47.2
0,0,1,3,2,8,3,0,0,"20",3,2,8,4,2,1,1037909,"2023-12-13T00:00:00.000Z",24,FALSE,3,314,"F",24,24,"Phoenix Suns","Chimezie Metu",2,12,12,8,4,17.8
3,2,16,2,0,15,7,2,1,"31",6,3,15,22,0,0,1037909,"2023-12-13T00:00:00.000Z",24,FALSE,3,349,"C",24,24,"Phoenix Suns","Jusuf Nurkic",2,37,40,18,25,51.9
4,0,1,2,2,9,6,0,0,"34",0,1,14,1,1,2,1037909,"2023-12-13T00:00:00.000Z",24,FALSE,3,37,"G",24,24,"Phoenix Suns","Bradley Beal",1,15,19,18,5,22.2
12,0,5,6,2,15,9,15,14,"40",1,5,34,6,0,2,1037909,"2023-12-13T00:00:00.000Z",24,FALSE,3,57,"G",24,24,"Phoenix Suns","Devin Booker",0,40,52,46,18,57.2
3,0,5,5,2,7,4,0,0,"27",2,2,10,7,0,2,1037909,"2023-12-13T00:00:00.000Z",24,FALSE,3,666729,"F",24,24,"Phoenix Suns","Nassir Little",0,17,20,13,10,20.9
0,0,0,2,0,2,0,0,0,"07",1,2,0,1,0,0,1037909,"2023-12-13T00:00:00.000Z",24,FALSE,3,470,"G",24,24,"Phoenix Suns","Yuta Watanabe",0,1,1,0,1,1.2
2,0,3,9,3,19,7,5,4,"39",0,3,21,3,1,0,1037909,"2023-12-13T00:00:00.000Z",24,FALSE,3,61,"F",3,3,"Brooklyn Nets","Mikal Bridges",1,24,26,23,5,30.6
4,2,4,7,3,10,5,2,2,"34",1,1,15,5,2,1,1037909,"2023-12-13T00:00:00.000Z",24,FALSE,3,666679,"F",3,3,"Brooklyn Nets","Cameron Johnson",4,20,24,19,9,38
1,1,7,1,1,10,6,2,1,"33",0,4,14,7,0,0,1037909,"2023-12-13T00:00:00.000Z",24,FALSE,3,666508,"F-C",3,3,"Brooklyn Nets","Nicolas Claxton",1,21,22,15,8,26.9
4,1,1,8,4,17,6,8,8,"28",1,0,24,2,1,2,1037909,"2023-12-13T00:00:00.000Z",24,FALSE,3,17896048,"G",3,3,"Brooklyn Nets","Cam Thomas",2,26,30,28,6,36.4
7,0,6,5,2,11,6,4,2,"35",2,4,16,8,2,2,1037909,"2023-12-13T00:00:00.000Z",24,FALSE,3,130,"G",3,3,"Brooklyn Nets","Spencer Dinwiddie",2,24,31,23,15,40.1
1,0,3,4,0,9,4,0,0,"26",3,3,8,6,2,2,1037909,"2023-12-13T00:00:00.000Z",24,FALSE,3,158,"F",3,3,"Brooklyn Nets","Dorian Finney-Smith",2,14,15,9,7,20.7
0,0,0,1,0,3,1,2,1,"08",3,0,3,3,0,0,1037909,"2023-12-13T00:00:00.000Z",24,FALSE,3,17896038,"C",3,3,"Brooklyn Nets","Day'Ron Sharpe",0,6,6,3,3,6.6
0,0,0,0,0,0,0,0,0,"00",0,0,0,0,0,0,1037909,"2023-12-13T00:00:00.000Z",24,FALSE,3,178,"G",24,24,"Phoenix Suns","Eric Gordon",0,0,0,0,0,0
0,0,0,0,0,0,0,0,0,"00",0,0,0,0,0,0,1037909,"2023-12-13T00:00:00.000Z",24,FALSE,3,272,"G",24,24,"Phoenix Suns","Damion Lee",0,0,0,0,0,0
0,0,0,0,0,0,0,0,0,"00",0,0,0,0,0,0,1037909,"2023-12-13T00:00:00.000Z",24,FALSE,3,356,"G",24,24,"Phoenix Suns","Josh Okogie",0,0,0,0,0,0
0,0,0,0,0,0,0,0,0,"00",0,0,0,0,0,0,1037909,"2023-12-13T00:00:00.000Z",24,FALSE,3,421,"G",3,3,"Brooklyn Nets","Dennis Smith Jr.",0,0,0,0,0,0
0,0,0,0,0,0,0,0,0,"00",0,0,0,0,0,0,1037909,"2023-12-13T00:00:00.000Z",24,FALSE,3,464,"G",3,3,"Brooklyn Nets","Lonnie Walker IV",0,0,0,0,0,0
0,0,0,0,0,0,0,0,0,"00",0,0,0,0,0,0,1037909,"2023-12-13T00:00:00.000Z",24,FALSE,3,56677841,"F",3,3,"Brooklyn Nets","Dariq Whitehead",0,0,0,0,0,0
0,0,0,0,0,0,0,0,0,"00",0,0,0,0,0,0,1037909,"2023-12-13T00:00:00.000Z",24,FALSE,3,3547095,"C-F",24,24,"Phoenix Suns","Udoka Azubuike",0,0,0,0,0,0
0,0,0,0,0,0,0,0,0,"00",0,0,0,0,0,0,1037909,"2023-12-13T00:00:00.000Z",24,FALSE,3,3547298,"G",24,24,"Phoenix Suns","Saben Lee",0,0,0,0,0,0
0,0,0,0,0,0,0,0,0,"00",0,0,0,0,0,0,1037909,"2023-12-13T00:00:00.000Z",24,FALSE,3,8,"G",24,24,"Phoenix Suns","Grayson Allen",0,0,0,0,0,0
1,0,0,2,0,6,1,0,0,"27",0,1,2,0,1,2,1037909,"2023-12-13T00:00:00.000Z",24,FALSE,3,18678058,"",24,24,"Phoenix Suns","Jordan Goodwin",1,2,3,3,1,4.5
0,0,0,0,0,1,0,0,0,"04",0,0,0,0,0,0,1037909,"2023-12-13T00:00:00.000Z",24,FALSE,3,147,"F",24,24,"Phoenix Suns","Drew Eubanks",0,0,0,0,0,0
1,0,2,1,0,3,1,0,0,"12",0,1,2,2,0,1,1037909,"2023-12-13T00:00:00.000Z",24,FALSE,3,32,"F",24,24,"Phoenix Suns","Keita Bates-Diop",0,4,5,3,3,4.9
0,0,0,0,0,0,0,0,0,"00",0,0,0,0,0,0,1037909,"2023-12-13T00:00:00.000Z",24,FALSE,3,666451,"C",24,24,"Phoenix Suns","Bol Bol",0,0,0,0,0,0
4,0,1,4,2,5,3,0,0,"19",0,1,8,1,0,0,1037909,"2023-12-13T00:00:00.000Z",24,FALSE,3,351,"F",3,3,"Brooklyn Nets","Royce O'Neale",0,9,13,12,5,15.2
1,0,1,2,0,5,3,1,1,"18",0,1,7,1,1,0,1037909,"2023-12-13T00:00:00.000Z",24,FALSE,3,17896058,"F",3,3,"Brooklyn Nets","Trendon Watford",1,8,9,8,2,12.7
0,0,0,0,0,0,0,0,0,"00",0,0,0,0,0,0,1037909,"2023-12-13T00:00:00.000Z",24,FALSE,3,9051997,"G",3,3,"Brooklyn Nets","Armoni Brooks",0,0,0,0,0,0
0,0,0,0,0,0,0,0,0,"00",0,0,0,0,0,0,1037909,"2023-12-13T00:00:00.000Z",24,FALSE,3,174,"F-C",3,3,"Brooklyn Nets","Harry Giles III",0,0,0,0,0,0
0,0,0,0,0,0,0,0,0,"00",0,0,0,0,0,0,1037909,"2023-12-13T00:00:00.000Z",24,FALSE,3,56677722,"F",3,3,"Brooklyn Nets","Jalen Wilson",0,0,0,0,0,0
0,0,0,0,0,0,0,0,0,"00",0,0,0,0,0,0,1037909,"2023-12-13T00:00:00.000Z",24,FALSE,3,56677843,"F",3,3,"Brooklyn Nets","Noah Clowney",0,0,0,0,0,0
0,0,0,0,0,0,0,0,0,"00",0,0,0,0,0,0,1037909,"2023-12-13T00:00:00.000Z",24,FALSE,3,17896041,"G",3,3,"Brooklyn Nets","Keon Johnson",0,0,0,0,0,0
0,0,0,0,0,0,0,0,0,"00",0,0,0,0,0,0,1037909,"2023-12-13T00:00:00.000Z",24,FALSE,3,417,"G-F",3,3,"Brooklyn Nets","Ben Simmons",0,0,0,0,0,0
0,0,7,8,4,13,7,7,5,"25",1,2,23,8,0,0,1037910,"2023-12-13T00:00:00.000Z",29,FALSE,20,297,"F",29,29,"Utah Jazz","Lauri Markkanen",0,31,31,23,8,32.6
2,0,3,10,3,12,4,4,4,"31",3,4,15,6,2,2,1037910,"2023-12-13T00:00:00.000Z",29,FALSE,20,38017739,"F",29,29,"Utah Jazz","Simone Fontecchio",2,21,23,17,8,29.2
8,0,9,2,1,9,3,2,2,"30",1,3,9,10,0,4,1037910,"2023-12-13T00:00:00.000Z",29,FALSE,20,358,"F",29,29,"Utah Jazz","Kelly Olynyk",0,19,27,17,18,29
7,0,3,8,3,18,10,3,3,"30",1,4,26,4,0,2,1037910,"2023-12-13T00:00:00.000Z",29,FALSE,20,413,"G",29,29,"Utah Jazz","Collin Sexton",0,30,37,33,11,39.3
7,0,2,2,2,4,4,0,0,"18",0,3,10,2,1,1,1037910,"2023-12-13T00:00:00.000Z",29,FALSE,20,139,"G",29,29,"Utah Jazz","Kris Dunn",1,12,19,17,9,24.9
1,1,2,3,1,7,2,0,0,"20",2,3,5,4,2,1,1037910,"2023-12-13T00:00:00.000Z",29,FALSE,20,56677824,"F",29,29,"Utah Jazz","Taylor Hendricks",3,9,10,6,5,19.3
0,0,0,1,0,1,0,0,0,"04",0,1,0,0,0,2,1037910,"2023-12-13T00:00:00.000Z",29,FALSE,20,56677834,"G",29,29,"Utah Jazz","Keyonte George",0,0,0,0,0,-2
2,0,1,5,1,12,2,0,0,"30",3,2,5,4,0,0,1037910,"2023-12-13T00:00:00.000Z",29,FALSE,20,38017620,"G",29,29,"Utah Jazz","Ochai Agbaji",0,9,11,7,6,12.8
3,0,4,3,1,14,7,2,0,"24",0,2,15,4,0,1,1037910,"2023-12-13T00:00:00.000Z",29,FALSE,20,666650,"G",29,29,"Utah Jazz","Talen Horton-Tucker",0,19,22,18,7,23.3
1,3,5,0,0,7,4,3,1,"23",3,3,9,8,0,2,1037910,"2023-12-13T00:00:00.000Z",29,FALSE,20,38017705,"C",29,29,"Utah Jazz","Walker Kessler",3,17,18,10,9,27.1
0,0,0,0,0,0,0,0,0,"00",0,0,0,0,0,0,1037910,"2023-12-13T00:00:00.000Z",29,FALSE,20,19465584,"F",29,29,"Utah Jazz","Micah Potter",0,0,0,0,0,0
0,0,0,0,0,0,0,0,0,"00",0,0,0,0,0,0,1037910,"2023-12-13T00:00:00.000Z",29,FALSE,20,56677842,"F",29,29,"Utah Jazz","Brice Sensabaugh",0,0,0,0,0,0
0,0,2,0,0,1,0,0,0,"05",1,0,0,3,0,0,1037910,"2023-12-13T00:00:00.000Z",29,FALSE,20,11891374,"C",29,29,"Utah Jazz","Omer Yurtseven",0,3,3,0,3,3.6
0,0,0,0,0,0,0,0,0,"00",0,0,0,0,0,0,1037910,"2023-12-13T00:00:00.000Z",29,FALSE,20,17896023,"G",29,29,"Utah Jazz","Josh Christopher",0,0,0,0,0,0
0,0,0,0,0,0,0,0,0,"00",0,0,0,0,0,0,1037910,"2023-12-13T00:00:00.000Z",29,FALSE,20,100,"G",29,29,"Utah Jazz","Jordan Clarkson",0,0,0,0,0,0
0,0,0,0,0,0,0,0,0,"00",0,0,0,0,0,0,1037910,"2023-12-13T00:00:00.000Z",29,FALSE,20,101,"F-C",29,29,"Utah Jazz","John Collins",0,0,0,0,0,0
0,0,0,0,0,0,0,0,0,"00",0,0,0,0,0,0,1037910,"2023-12-13T00:00:00.000Z",29,FALSE,20,38017630,"G",29,29,"Utah Jazz","Johnny Juzang",0,0,0,0,0,0
0,0,0,0,0,0,0,0,0,"00",0,0,0,0,0,0,1037910,"2023-12-13T00:00:00.000Z",29,FALSE,20,666881,"F",29,29,"Utah Jazz","Luka Samanic",0,0,0,0,0,0
0,1,1,0,0,2,2,0,0,"18",1,2,4,2,0,1,1037910,"2023-12-13T00:00:00.000Z",29,FALSE,20,17896063,"F",20,20,"New York Knicks","Jericho Sims",1,6,6,4,2,8.4
1,0,4,9,4,13,6,7,5,"27",3,2,21,7,4,0,1037910,"2023-12-13T00:00:00.000Z",29,FALSE,20,131,"G",20,20,"New York Knicks","Donte DiVincenzo",4,28,29,22,8,42.9
8,0,5,6,0,19,6,16,11,"39",2,4,23,7,2,3,1037910,"2023-12-13T00:00:00.000Z",29,FALSE,20,73,"G",20,20,"New York Knicks","Jalen Brunson",2,30,38,31,15,46.4
2,0,2,4,0,5,0,0,0,"29",0,2,0,2,1,0,1037910,"2023-12-13T00:00:00.000Z",29,FALSE,20,202,"G",20,20,"New York Knicks","Josh Hart",1,2,4,2,4,8.4
1,0,1,4,3,8,6,0,0,"18",1,1,15,2,2,1,1037910,"2023-12-13T00:00:00.000Z",29,FALSE,20,3547269,"G",20,20,"New York Knicks","Immanuel Quickley",2,17,18,16,3,23.9
0,1,3,0,0,4,3,1,1,"30",3,3,7,6,0,0,1037910,"2023-12-13T00:00:00.000Z",29,FALSE,20,201,"F-C",20,20,"New York Knicks","Isaiah Hartenstein",1,13,13,7,6,17.2
1,0,2,3,0,4,1,2,0,"16",0,1,2,2,0,1,1037910,"2023-12-13T00:00:00.000Z",29,FALSE,20,17895858,"G",20,20,"New York Knicks","Quentin Grimes",0,4,5,3,3,4.9
0,0,0,0,0,0,0,0,0,"00",0,0,0,0,0,0,1037910,"2023-12-13T00:00:00.000Z",29,FALSE,20,19,"G",20,20,"New York Knicks","Ryan Arcidiacono",0,0,0,0,0,0
2,0,5,7,0,16,3,4,3,"24",1,2,9,6,0,0,1037910,"2023-12-13T00:00:00.000Z",29,FALSE,20,666423,"F-G",20,20,"New York Knicks","RJ Barrett",0,15,17,11,8,19.2
6,1,9,6,2,23,14,2,2,"39",3,4,32,12,1,2,1037910,"2023-12-13T00:00:00.000Z",29,FALSE,20,387,"F",20,20,"New York Knicks","Julius Randle",2,44,50,38,18,59.4
0,0,0,0,0,0,0,0,0,"00",0,0,0,0,0,0,1037910,"2023-12-13T00:00:00.000Z",29,FALSE,20,666675,"F",20,20,"New York Knicks","DaQuan Jeffries",0,0,0,0,0,0
0,0,0,0,0,0,0,0,0,"00",0,0,0,0,0,0,1037910,"2023-12-13T00:00:00.000Z",29,FALSE,20,17896033,"G",20,20,"New York Knicks","Miles McBride",0,0,0,0,0,0
0,0,0,0,0,0,0,0,0,"00",0,0,0,0,0,0,1037910,"2023-12-13T00:00:00.000Z",29,FALSE,20,666474,"G",20,20,"New York Knicks","Charles Brown",0,0,0,0,0,0
0,0,0,0,0,0,0,0,0,"00",0,0,0,0,0,0,1037910,"2023-12-13T00:00:00.000Z",29,FALSE,20,59421201,"G",20,20,"New York Knicks","Jaylen Martin",0,0,0,0,0,0
0,0,0,0,0,0,0,0,0,"00",0,0,0,0,0,0,1037910,"2023-12-13T00:00:00.000Z",29,FALSE,20,399,"C",20,20,"New York Knicks","Mitchell Robinson",0,0,0,0,0,0
0,0,0,0,0,0,0,0,0,"00",0,0,0,0,0,0,1037910,"2023-12-13T00:00:00.000Z",29,FALSE,20,56677795,"F",20,20,"New York Knicks","Jacob Toppin",0,0,0,0,0,0
0,0,0,0,0,0,0,0,0,"00",0,0,0,0,0,0,1037910,"2023-12-13T00:00:00.000Z",29,FALSE,20,160,"G-F",20,20,"New York Knicks","Evan Fournier",0,0,0,0,0,0
10,0,4,0,0,8,4,7,7,"29",2,1,15,6,1,4,1037904,"2023-12-13T00:00:00.000Z",16,FALSE,4,79,"G-F",16,16,"Miami Heat","Jimmy Butler",1,21,31,25,16,36.2
4,1,3,3,1,13,4,0,0,"36",3,2,9,6,0,4,1037904,"2023-12-13T00:00:00.000Z",16,FALSE,4,666747,"F",16,16,"Miami Heat","Caleb Martin",1,15,19,13,10,21.2
1,0,2,0,0,5,3,0,0,"12",2,2,6,4,0,3,1037904,"2023-12-13T00:00:00.000Z",16,FALSE,4,39398582,"C",16,16,"Miami Heat","Orlando Robinson",0,10,11,7,5,9.3
3,0,2,9,6,12,7,3,3,"41",0,2,23,2,2,3,1037904,"2023-12-13T00:00:00.000Z",16,FALSE,4,397,"F",16,16,"Miami Heat","Duncan Robinson",2,25,28,26,5,32.9
1,0,2,4,4,5,5,3,3,"24",0,2,17,2,2,2,1037904,"2023-12-13T00:00:00.000Z",16,FALSE,4,286,"G",16,16,"Miami Heat","Kyle Lowry",2,19,20,18,3,24.9
0,0,0,0,0,0,0,0,0,"00",0,0,0,0,0,0,1037904,"2023-12-13T00:00:00.000Z",16,FALSE,4,4,"C-F",16,16,"Miami Heat","Bam Adebayo",0,0,0,0,0,0
0,0,3,0,0,7,5,1,1,"16",6,2,11,9,0,1,1037904,"2023-12-13T00:00:00.000Z",16,FALSE,4,74,"C",16,16,"Miami Heat","Thomas Bryant",0,20,20,11,9,20.8
1,1,1,6,2,12,5,2,2,"29",2,0,14,3,2,0,1037904,"2023-12-13T00:00:00.000Z",16,FALSE,4,38017734,"F",16,16,"Miami Heat","Jamal Cain",3,17,18,15,4,28.1
0,0,0,0,0,0,0,0,0,"00",0,0,0,0,0,0,1037904,"2023-12-13T00:00:00.000Z",16,FALSE,4,3547257,"G",16,16,"Miami Heat","R.J. Hampton",0,0,0,0,0,0
8,0,4,2,2,16,7,1,1,"33",2,0,17,6,1,2,1037904,"2023-12-13T00:00:00.000Z",16,FALSE,4,56677785,"G",16,16,"Miami Heat","Jaime Jaquez Jr.",1,23,31,25,14,37.2
1,1,9,6,0,9,1,2,1,"20",0,1,3,9,2,2,1037904,"2023-12-13T00:00:00.000Z",16,FALSE,4,285,"F-C",16,16,"Miami Heat","Kevin Love",3,12,13,4,10,22.3
0,0,0,0,0,0,0,0,0,"00",0,0,0,0,0,0,1037904,"2023-12-13T00:00:00.000Z",16,FALSE,4,38017736,"F",16,16,"Miami Heat","Cole Swider",0,0,0,0,0,0
0,0,0,0,0,0,0,0,0,"00",0,0,0,0,0,0,1037904,"2023-12-13T00:00:00.000Z",16,FALSE,4,666633,"G",16,16,"Miami Heat","Tyler Herro",0,0,0,0,0,0
0,0,0,0,0,0,0,0,0,"00",0,0,0,0,0,0,1037904,"2023-12-13T00:00:00.000Z",16,FALSE,4,3092,"",16,16,"Miami Heat","Haywood Highsmith",0,0,0,0,0,0
0,0,0,0,0,0,0,0,0,"00",0,0,0,0,0,0,1037904,"2023-12-13T00:00:00.000Z",16,FALSE,4,38017696,"F",16,16,"Miami Heat","Nikola Jovic",0,0,0,0,0,0
0,0,0,0,0,0,0,0,0,"00",0,0,0,0,0,0,1037904,"2023-12-13T00:00:00.000Z",16,FALSE,4,391,"G-F",16,16,"Miami Heat","Josh Richardson",0,0,0,0,0,0
0,0,0,0,0,0,0,0,0,"00",0,0,0,0,0,0,1037904,"2023-12-13T00:00:00.000Z",16,FALSE,4,19465585,"G",16,16,"Miami Heat","Dru Smith",0,0,0,0,0,0
7,0,4,2,1,12,7,5,5,"35",1,2,20,5,0,4,1037904,"2023-12-13T00:00:00.000Z",16,FALSE,4,204,"F",4,4,"Charlotte Hornets","Gordon Hayward",0,25,32,27,12,32.5
4,1,4,8,1,19,9,0,0,"34",1,2,19,5,2,4,1037904,"2023-12-13T00:00:00.000Z",16,FALSE,4,62,"F",4,4,"Charlotte Hornets","Miles Bridges",3,24,28,23,9,36
0,4,10,0,0,5,3,1,0,"40",1,1,6,11,0,2,1037904,"2023-12-13T00:00:00.000Z",16,FALSE,4,3547282,"C",4,4,"Charlotte Hornets","Nick Richards",4,17,17,6,11,29.2
2,0,2,10,4,16,7,0,0,"39",0,3,18,2,2,5,1037904,"2023-12-13T00:00:00.000Z",16,FALSE,4,56677823,"F",4,4,"Charlotte Hornets","Brandon Miller",2,20,22,20,4,24.4
7,1,3,6,5,14,10,3,3,"37",0,2,28,3,4,1,1037904,"2023-12-13T00:00:00.000Z",16,FALSE,4,403,"G",4,4,"Charlotte Hornets","Terry Rozier",5,31,38,35,10,56.1
0,0,0,0,0,0,0,0,0,"00",0,0,0,0,0,0,1037904,"2023-12-13T00:00:00.000Z",16,FALSE,4,17896037,"G",4,4,"Charlotte Hornets","James Bouknight",0,0,0,0,0,0
0,0,0,0,0,0,0,0,0,"00",0,0,0,0,0,0,1037904,"2023-12-13T00:00:00.000Z",16,FALSE,4,3547253,"G",4,4,"Charlotte Hornets","Theo Maledon",0,0,0,0,0,0
1,0,2,2,1,4,2,2,2,"18",1,2,7,3,0,0,1037904,"2023-12-13T00:00:00.000Z",16,FALSE,4,38017708,"G",4,4,"Charlotte Hornets","Bryce McGowens",0,10,11,8,4,12.1
0,0,0,0,0,0,0,0,0,"00",0,0,0,0,0,0,1037904,"2023-12-13T00:00:00.000Z",16,FALSE,4,347,"G",4,4,"Charlotte Hornets","Frank Ntilikina",0,0,0,0,0,0
4,0,2,1,0,5,3,0,0,"17",0,3,6,2,0,3,1037904,"2023-12-13T00:00:00.000Z",16,FALSE,4,422,"G",4,4,"Charlotte Hornets","Ish Smith",0,8,12,10,6,11.4
0,0,1,2,0,2,0,0,0,"16",0,3,0,1,1,1,1037904,"2023-12-13T00:00:00.000Z",16,FALSE,4,18678001,"F",4,4,"Charlotte Hornets","JT Thor",1,1,1,0,1,3.2
1,0,0,0,0,0,0,0,0,"04",0,0,0,0,1,1,1037904,"2023-12-13T00:00:00.000Z",16,FALSE,4,666950,"F",4,4,"Charlotte Hornets","P.J. Washington",1,0,1,1,1,3.5
0,0,0,0,0,0,0,0,0,"00",0,0,0,0,0,0,1037904,"2023-12-13T00:00:00.000Z",16,FALSE,4,56677848,"G",4,4,"Charlotte Hornets","Amari Bailey",0,0,0,0,0,0
0,0,0,0,0,0,0,0,0,"00",0,0,0,0,0,0,1037904,"2023-12-13T00:00:00.000Z",16,FALSE,4,3547239,"G",4,4,"Charlotte Hornets","LaMelo Ball",0,0,0,0,0,0
0,0,0,0,0,0,0,0,0,"00",0,0,0,0,0,0,1037904,"2023-12-13T00:00:00.000Z",16,FALSE,4,666748,"F",4,4,"Charlotte Hornets","Cody Martin",0,0,0,0,0,0
0,0,0,0,0,0,0,0,0,"00",0,0,0,0,0,0,1037904,"2023-12-13T00:00:00.000Z",16,FALSE,4,56677846,"G",4,4,"Charlotte Hornets","Nick Smith Jr.",0,0,0,0,0,0
0,0,0,0,0,0,0,0,0,"00",0,0,0,0,0,0,1037904,"2023-12-13T00:00:00.000Z",16,FALSE,4,38017698,"C",4,4,"Charlotte Hornets","Mark Williams",0,0,0,0,0,0
0,0,0,0,0,0,0,0,0,"00",0,0,0,0,0,0,1037904,"2023-12-13T00:00:00.000Z",16,FALSE,4,56677866,"F",4,4,"Charlotte Hornets","Leaky Black",0,0,0,0,0,0
5,0,3,5,2,20,10,0,0,"36",2,3,22,5,2,2,1037911,"2023-12-14T00:00:00.000Z",2,FALSE,6,70,"G",2,2,"Boston Celtics","Jaylen Brown",2,27,32,27,10,39.5
3,3,8,10,3,22,9,8,6,"36",3,1,27,11,0,3,1037911,"2023-12-14T00:00:00.000Z",2,FALSE,6,434,"F",2,2,"Boston Celtics","Jayson Tatum",3,38,41,30,14,50.7
0,2,5,6,1,11,5,8,7,"31",1,2,18,6,1,3,1037911,"2023-12-14T00:00:00.000Z",2,FALSE,6,378,"F-C",2,2,"Boston Celtics","Kristaps Porzingis",3,24,24,18,6,31.2
3,0,3,4,2,10,5,2,2,"35",2,0,14,5,3,3,1037911,"2023-12-14T00:00:00.000Z",2,FALSE,6,473,"G",2,2,"Boston Celtics","Derrick White",3,19,22,17,8,30.5
4,0,1,3,1,11,7,0,0,"37",2,2,15,3,0,2,1037911,"2023-12-14T00:00:00.000Z",2,FALSE,6,214,"G",2,2,"Boston Celtics","Jrue Holiday",0,18,22,19,7,22.6
1,0,0,3,3,3,3,0,0,"18",0,2,9,0,0,0,1037911,"2023-12-14T00:00:00.000Z",2,FALSE,6,17896060,"F",2,2,"Boston Celtics","Sam Hauser",0,9,10,10,1,10.5
3,1,7,2,1,4,3,0,0,"24",3,1,7,10,0,0,1037911,"2023-12-14T00:00:00.000Z",2,FALSE,6,219,"C-F",2,2,"Boston Celtics","Al Horford",1,17,20,10,13,26.5
0,0,0,0,0,0,0,0,0,"00",0,0,0,0,0,0,1037911,"2023-12-14T00:00:00.000Z",2,FALSE,6,38017707,"G",2,2,"Boston Celtics","JD Davison",0,0,0,0,0,0
0,0,0,0,0,0,0,0,0,"00",0,0,0,0,0,0,1037911,"2023-12-14T00:00:00.000Z",2,FALSE,6,NA,NA,NA,2,"Boston Celtics","NA NA",0,0,0,0,0,0
0,0,0,0,0,0,0,0,0,"00",0,0,0,0,0,0,1037911,"2023-12-14T00:00:00.000Z",2,FALSE,6,17553967,"C",2,2,"Boston Celtics","Neemias Queta",0,0,0,0,0,0
0,0,0,0,0,0,0,0,0,"00",0,0,0,0,0,0,1037911,"2023-12-14T00:00:00.000Z",2,FALSE,6,56677864,"G",2,2,"Boston Celtics","Jordan Walsh",0,0,0,0,0,0
2,0,2,4,1,5,2,0,0,"31",2,5,5,4,0,1,1037911,"2023-12-14T00:00:00.000Z",2,FALSE,6,666908,"G",6,6,"Cleveland Cavaliers","Max Strus",0,9,11,7,6,11.8
0,0,3,5,1,5,1,2,2,"16",1,0,5,4,0,0,1037911,"2023-12-14T00:00:00.000Z",2,FALSE,6,666940,"F",6,6,"Cleveland Cavaliers","Dean Wade",0,9,9,5,4,9.8
3,0,9,0,0,7,4,0,0,"39",1,1,8,10,0,3,1037911,"2023-12-14T00:00:00.000Z",2,FALSE,6,9,"C",6,6,"Cleveland Cavaliers","Jarrett Allen",0,18,21,11,13,21.5
6,0,7,8,2,24,12,5,5,"40",1,2,31,8,1,3,1037911,"2023-12-14T00:00:00.000Z",2,FALSE,6,322,"G",6,6,"Cleveland Cavaliers","Donovan Mitchell",1,39,45,37,14,49.6
3,0,1,7,3,19,8,0,0,"36",1,2,19,2,2,5,1037911,"2023-12-14T00:00:00.000Z",2,FALSE,6,666581,"G",6,6,"Cleveland Cavaliers","Darius Garland",2,21,24,22,5,26.9
0,0,0,0,0,0,0,0,0,"00",0,0,0,0,0,0,1037911,"2023-12-14T00:00:00.000Z",2,FALSE,6,248,"C",6,6,"Cleveland Cavaliers","Damian Jones",0,0,0,0,0,0
5,1,2,6,3,16,9,6,5,"35",1,2,26,3,3,1,1037911,"2023-12-14T00:00:00.000Z",2,FALSE,6,277,"G",6,6,"Cleveland Cavaliers","Caris LeVert",4,29,34,31,8,48.1
0,0,0,0,0,0,0,0,0,"00",0,0,0,0,0,0,1037911,"2023-12-14T00:00:00.000Z",2,FALSE,6,3547299,"G",6,6,"Cleveland Cavaliers","Sam Merrill",0,0,0,0,0,0
0,0,2,2,0,4,1,2,2,"22",0,2,4,2,0,1,1037911,"2023-12-14T00:00:00.000Z",2,FALSE,6,344,"F",6,6,"Cleveland Cavaliers","Georges Niang",0,6,6,4,2,5.4
2,0,3,1,1,2,2,2,2,"18",1,3,7,4,1,1,1037911,"2023-12-14T00:00:00.000Z",2,FALSE,6,3547247,"F-G",6,6,"Cleveland Cavaliers","Isaac Okoro",1,11,13,9,6,16.8
0,0,0,0,0,0,0,0,0,"00",0,0,0,0,0,0,1037911,"2023-12-14T00:00:00.000Z",2,FALSE,6,56677872,"G",6,6,"Cleveland Cavaliers","Craig Porter",0,0,0,0,0,0
0,0,1,0,0,1,1,0,0,"03",1,1,2,2,0,1,1037911,"2023-12-14T00:00:00.000Z",2,FALSE,6,444,"C-F",6,6,"Cleveland Cavaliers","Tristan Thompson",0,4,4,2,2,3.4
1,1,1,2,0,3,1,2,2,"09",0,3,4,1,1,0,1037911,"2023-12-14T00:00:00.000Z",2,FALSE,6,3547279,"F",2,2,"Boston Celtics","Lamar Stevens",2,5,6,5,2,12.7
2,1,3,1,0,1,0,0,0,"14",0,1,0,3,0,0,1037911,"2023-12-14T00:00:00.000Z",2,FALSE,6,3547276,"G",2,2,"Boston Celtics","Payton Pritchard",1,3,5,2,5,9.6
0,0,0,0,0,0,0,0,0,"00",0,0,0,0,0,0,1037911,"2023-12-14T00:00:00.000Z",2,FALSE,6,17896094,"G",2,2,"Boston Celtics","Dalano Banton",0,0,0,0,0,0
0,0,0,0,0,0,0,0,0,"00",0,0,0,0,0,0,1037911,"2023-12-14T00:00:00.000Z",2,FALSE,6,666468,"F",2,2,"Boston Celtics","Oshae Brissett",0,0,0,0,0,0
0,0,0,0,0,0,0,0,0,"00",0,0,0,0,0,0,1037911,"2023-12-14T00:00:00.000Z",2,FALSE,6,261,"F-C",2,2,"Boston Celtics","Luke Kornet",0,0,0,0,0,0
0,0,0,0,0,0,0,0,0,"00",0,0,0,0,0,0,1037911,"2023-12-14T00:00:00.000Z",2,FALSE,6,338,"G",2,2,"Boston Celtics","Svi Mykhailiuk",0,0,0,0,0,0
0,0,0,0,0,0,0,0,0,"00",0,0,0,0,0,0,1037911,"2023-12-14T00:00:00.000Z",2,FALSE,6,404,"G",6,6,"Cleveland Cavaliers","Ricky Rubio",0,0,0,0,0,0
0,0,0,0,0,0,0,0,0,"00",0,0,0,0,0,0,1037911,"2023-12-14T00:00:00.000Z",2,FALSE,6,56677847,"F",6,6,"Cleveland Cavaliers","Emoni Bates",0,0,0,0,0,0
0,0,0,0,0,0,0,0,0,"00",0,0,0,0,0,0,1037911,"2023-12-14T00:00:00.000Z",2,FALSE,6,666676,"G",6,6,"Cleveland Cavaliers","Ty Jerome",0,0,0,0,0,0
0,0,0,0,0,0,0,0,0,"00",0,0,0,0,0,0,1037911,"2023-12-14T00:00:00.000Z",2,FALSE,6,17896076,"F-C",6,6,"Cleveland Cavaliers","Evan Mobley",0,0,0,0,0,0
0,0,0,0,0,0,0,0,0,"00",0,0,0,0,0,0,1037911,"2023-12-14T00:00:00.000Z",2,FALSE,6,38017662,"F",6,6,"Cleveland Cavaliers","Isaiah Mobley",0,0,0,0,0,0
7,0,5,1,0,15,6,10,8,"36",2,0,20,7,0,1,1037912,"2023-12-14T00:00:00.000Z",16,FALSE,5,79,"G-F",16,16,"Miami Heat","Jimmy Butler",0,27,34,27,14,37.9
4,0,9,4,3,13,7,0,0,"39",2,3,17,11,0,1,1037912,"2023-12-14T00:00:00.000Z",16,FALSE,5,666747,"F",16,16,"Miami Heat","Caleb Martin",0,28,32,21,15,35.2
0,0,0,1,0,2,0,2,1,"14",2,2,1,2,0,1,1037912,"2023-12-14T00:00:00.000Z",16,FALSE,5,39398582,"C",16,16,"Miami Heat","Orlando Robinson",0,3,3,1,2,2.4
3,0,2,6,3,9,4,2,0,"27",0,2,11,2,0,2,1037912,"2023-12-14T00:00:00.000Z",16,FALSE,5,397,"F",16,16,"Miami Heat","Duncan Robinson",0,13,16,14,5,15.9
3,0,2,9,4,12,6,1,1,"39",1,5,17,3,1,1,1037912,"2023-12-14T00:00:00.000Z",16,FALSE,5,286,"G",16,16,"Miami Heat","Kyle Lowry",1,20,23,20,6,27.1
0,1,0,0,0,0,0,4,3,"08",0,1,3,0,0,0,1037912,"2023-12-14T00:00:00.000Z",16,FALSE,5,38017734,"F",16,16,"Miami Heat","Jamal Cain",1,3,3,3,0,6
0,0,2,1,1,1,1,0,0,"09",0,1,3,2,0,1,1037912,"2023-12-14T00:00:00.000Z",16,FALSE,5,3547257,"G",16,16,"Miami Heat","R.J. Hampton",0,5,5,3,2,4.4
4,0,4,4,1,14,6,10,9,"34",0,4,22,4,0,2,1037912,"2023-12-14T00:00:00.000Z",16,FALSE,5,56677785,"G",16,16,"Miami Heat","Jaime Jaquez Jr.",0,26,30,26,8,30.8
4,0,8,8,3,12,5,4,3,"22",1,1,16,9,1,2,1037912,"2023-12-14T00:00:00.000Z",16,FALSE,5,285,"F-C",16,16,"Miami Heat","Kevin Love",1,25,29,20,13,33.8
3,2,0,5,2,9,3,2,1,"32",2,5,9,2,2,0,1037912,"2023-12-14T00:00:00.000Z",16,FALSE,5,3547248,"F",5,5,"Chicago Bulls","Patrick Williams",4,11,14,12,5,27.9
7,0,10,5,2,21,10,2,2,"36",2,2,24,12,3,0,1037912,"2023-12-14T00:00:00.000Z",16,FALSE,5,460,"C",5,5,"Chicago Bulls","Nikola Vucevic",3,36,43,31,19,57.9
1,0,0,3,2,4,2,0,0,"05",0,0,6,0,0,0,1037912,"2023-12-14T00:00:00.000Z",16,FALSE,5,89,"G",5,5,"Chicago Bulls","Alex Caruso",0,6,7,7,1,7.5
11,0,6,11,4,20,9,8,4,"40",1,1,26,7,1,0,1037912,"2023-12-14T00:00:00.000Z",16,FALSE,5,666956,"G",5,5,"Chicago Bulls","Coby White",1,33,44,37,18,53.9
1,0,0,2,0,2,0,0,0,"13",0,3,0,0,1,1,1037912,"2023-12-14T00:00:00.000Z",16,FALSE,5,87,"G",5,5,"Chicago Bulls","Jevon Carter",1,0,1,1,1,3.5
0,0,2,3,0,7,2,1,1,"23",1,3,5,3,1,0,1037912,"2023-12-14T00:00:00.000Z",16,FALSE,5,110,"F",5,5,"Chicago Bulls","Torrey Craig",1,8,8,5,3,11.6
0,0,0,0,0,0,0,0,0,"00",0,0,0,0,0,0,1037912,"2023-12-14T00:00:00.000Z",16,FALSE,5,3092,"",16,16,"Miami Heat","Haywood Highsmith",0,0,0,0,0,0
0,0,0,0,0,0,0,0,0,"00",0,0,0,0,0,0,1037912,"2023-12-14T00:00:00.000Z",16,FALSE,5,38017696,"F",16,16,"Miami Heat","Nikola Jovic",0,0,0,0,0,0
0,0,0,0,0,0,0,0,0,"00",0,0,0,0,0,0,1037912,"2023-12-14T00:00:00.000Z",16,FALSE,5,391,"G-F",16,16,"Miami Heat","Josh Richardson",0,0,0,0,0,0
0,0,0,0,0,0,0,0,0,"00",0,0,0,0,0,0,1037912,"2023-12-14T00:00:00.000Z",16,FALSE,5,19465585,"G",16,16,"Miami Heat","Dru Smith",0,0,0,0,0,0
4,0,3,3,1,14,6,11,10,"41",2,2,23,5,0,3,1037912,"2023-12-14T00:00:00.000Z",16,FALSE,5,125,"G",5,5,"Chicago Bulls","DeMar DeRozan",0,28,32,27,9,32
5,0,6,4,3,12,10,4,1,"35",2,3,24,8,1,0,1037912,"2023-12-14T00:00:00.000Z",16,FALSE,5,17895983,"G",5,5,"Chicago Bulls","Ayo Dosunmu",1,32,37,29,13,44.1
0,0,4,0,0,4,3,2,1,"12",1,3,7,5,0,0,1037912,"2023-12-14T00:00:00.000Z",16,FALSE,5,137,"C",5,5,"Chicago Bulls","Andre Drummond",0,12,12,7,5,13
0,0,0,0,0,0,0,0,0,"00",0,0,0,0,0,0,1037912,"2023-12-14T00:00:00.000Z",16,FALSE,5,56677857,"F",5,5,"Chicago Bulls","Julian Phillips",0,0,0,0,0,0
0,0,0,0,0,0,0,0,0,"00",0,0,0,0,0,0,1037912,"2023-12-14T00:00:00.000Z",16,FALSE,5,17896116,"G",5,5,"Chicago Bulls","Terry Taylor",0,0,0,0,0,0
0,0,1,0,0,0,0,0,0,"03",0,1,0,1,0,1,1037912,"2023-12-14T00:00:00.000Z",16,FALSE,5,38017719,"F",5,5,"Chicago Bulls","Dalen Terry",0,1,1,0,1,0.2
0,0,0,0,0,0,0,0,0,"00",0,0,0,0,0,0,1037912,"2023-12-14T00:00:00.000Z",16,FALSE,5,27,"G",5,5,"Chicago Bulls","Lonzo Ball",0,0,0,0,0,0
0,0,0,0,0,0,0,0,0,"00",0,0,0,0,0,0,1037912,"2023-12-14T00:00:00.000Z",16,FALSE,5,56677874,"F",5,5,"Chicago Bulls","Onuralp Bitim",0,0,0,0,0,0
0,0,0,0,0,0,0,0,0,"00",0,0,0,0,0,0,1037912,"2023-12-14T00:00:00.000Z",16,FALSE,5,268,"G",5,5,"Chicago Bulls","Zach LaVine",0,0,0,0,0,0
0,0,0,0,0,0,0,0,0,"00",0,0,0,0,0,0,1037912,"2023-12-14T00:00:00.000Z",16,FALSE,5,45969255,"F",5,5,"Chicago Bulls","Justin Lewis",0,0,0,0,0,0
0,0,0,0,0,0,0,0,0,"00",0,0,0,0,0,0,1037912,"2023-12-14T00:00:00.000Z",16,FALSE,5,56677860,"F",5,5,"Chicago Bulls","Adama Sanogo",0,0,0,0,0,0
0,0,0,0,0,0,0,0,0,"00",0,0,0,0,0,0,1037912,"2023-12-14T00:00:00.000Z",16,FALSE,5,4,"C-F",16,16,"Miami Heat","Bam Adebayo",0,0,0,0,0,0
0,0,0,0,0,0,0,0,0,"00",0,0,0,0,0,0,1037912,"2023-12-14T00:00:00.000Z",16,FALSE,5,38017736,"F",16,16,"Miami Heat","Cole Swider",0,0,0,0,0,0
0,0,0,0,0,0,0,0,0,"00",0,0,0,0,0,0,1037912,"2023-12-14T00:00:00.000Z",16,FALSE,5,666633,"G",16,16,"Miami Heat","Tyler Herro",0,0,0,0,0,0
1,0,2,0,0,2,2,2,2,"12",0,1,6,2,0,0,1037912,"2023-12-14T00:00:00.000Z",16,FALSE,5,74,"C",16,16,"Miami Heat","Thomas Bryant",0,8,9,7,3,9.9
0,0,4,6,1,8,1,0,0,"30",0,3,3,4,2,0,1037913,"2023-12-14T00:00:00.000Z",7,FALSE,18,247,"F-G",7,7,"Dallas Mavericks","Derrick Jones Jr.",2,7,7,3,4,13.8
1,0,3,7,1,11,2,0,0,"36",0,3,5,3,1,1,1037913,"2023-12-14T00:00:00.000Z",7,FALSE,18,666965,"F",7,7,"Dallas Mavericks","Grant Williams",1,8,9,6,4,12.1
0,2,3,0,0,9,7,2,1,"32",3,3,15,6,1,2,1037913,"2023-12-14T00:00:00.000Z",7,FALSE,18,56677840,"C",7,7,"Dallas Mavericks","Dereck Lively II",3,21,21,15,6,29.2
4,0,4,3,2,6,5,2,2,"28",0,2,14,4,0,2,1037913,"2023-12-14T00:00:00.000Z",7,FALSE,18,151,"G",7,7,"Dallas Mavericks","Dante Exum",0,18,22,18,8,22.8
13,0,5,7,2,27,15,7,7,"39",1,2,39,6,2,8,1037913,"2023-12-14T00:00:00.000Z",7,FALSE,18,132,"F-G",7,7,"Dallas Mavericks","Luka Doncic",2,45,58,52,19,63.7
1,0,0,0,0,0,0,0,0,"02",0,0,0,0,0,0,1037913,"2023-12-14T00:00:00.000Z",7,FALSE,18,17896028,"F",7,7,"Dallas Mavericks","Greg Brown III",0,0,1,1,1,1.5
0,0,0,0,0,0,0,0,0,"00",0,0,0,0,0,0,1037913,"2023-12-14T00:00:00.000Z",7,FALSE,18,56677873,"G",7,7,"Dallas Mavericks","Dexter Dennis",0,0,0,0,0,0
0,0,4,7,0,15,4,3,2,"32",0,2,10,4,0,2,1037913,"2023-12-14T00:00:00.000Z",7,FALSE,18,191,"G",7,7,"Dallas Mavericks","Tim Hardaway Jr.",0,14,14,10,4,12.8
1,0,2,2,1,4,2,0,0,"13",0,0,5,2,0,0,1037913,"2023-12-14T00:00:00.000Z",7,FALSE,18,38017679,"G",7,7,"Dallas Mavericks","Jaden Hardy",0,7,8,6,3,8.9
0,0,0,0,0,0,0,0,0,"03",0,0,0,0,0,0,1037913,"2023-12-14T00:00:00.000Z",7,FALSE,18,217,"F-C",7,7,"Dallas Mavericks","Richaun Holmes",0,0,0,0,0,0
0,0,0,0,0,1,1,0,0,"02",0,0,2,0,0,0,1037913,"2023-12-14T00:00:00.000Z",7,FALSE,18,17554004,"G",7,7,"Dallas Mavericks","AJ Lawson",0,2,2,2,0,2
1,0,1,0,0,1,1,0,0,"13",0,3,2,1,0,0,1037913,"2023-12-14T00:00:00.000Z",7,FALSE,18,329,"F",7,7,"Dallas Mavericks","Markieff Morris",0,3,4,3,2,4.7
0,0,4,0,0,0,0,4,4,"07",0,1,4,4,0,0,1037913,"2023-12-14T00:00:00.000Z",7,FALSE,18,379,"F-C",7,7,"Dallas Mavericks","Dwight Powell",0,8,8,4,4,8.8
0,0,0,0,0,1,1,0,0,"03",0,0,2,0,0,0,1037913,"2023-12-14T00:00:00.000Z",7,FALSE,18,56677859,"F",7,7,"Dallas Mavericks","Olivier-Maxence Prosper",0,2,2,2,0,2
0,0,0,0,0,0,0,0,0,"00",0,0,0,0,0,0,1037913,"2023-12-14T00:00:00.000Z",7,FALSE,18,114,"G",7,7,"Dallas Mavericks","Seth Curry",0,0,0,0,0,0
0,0,0,0,0,0,0,0,0,"00",0,0,0,0,0,0,1037913,"2023-12-14T00:00:00.000Z",7,FALSE,18,3547258,"G",7,7,"Dallas Mavericks","Josh Green",0,0,0,0,0,0
0,0,0,0,0,0,0,0,0,"00",0,0,0,0,0,0,1037913,"2023-12-14T00:00:00.000Z",7,FALSE,18,228,"G",7,7,"Dallas Mavericks","Kyrie Irving",0,0,0,0,0,0
0,0,0,0,0,0,0,0,0,"00",0,0,0,0,0,0,1037913,"2023-12-14T00:00:00.000Z",7,FALSE,18,257,"F",7,7,"Dallas Mavericks","Maxi Kleber",0,0,0,0,0,0
1,1,1,2,0,9,5,1,1,"24",1,3,11,2,0,0,1037913,"2023-12-14T00:00:00.000Z",7,FALSE,18,3547259,"F",18,18,"Minnesota Timberwolves","Jaden McDaniels",1,13,14,12,3,17.9
2,0,12,3,1,14,8,5,4,"31",5,1,21,17,0,3,1037913,"2023-12-14T00:00:00.000Z",7,FALSE,18,447,"C",18,18,"Minnesota Timberwolves","Karl-Anthony Towns",0,38,40,23,19,41.4
5,1,10,0,0,4,3,6,2,"30",2,4,8,12,3,2,1037913,"2023-12-14T00:00:00.000Z",7,FALSE,18,176,"C",18,18,"Minnesota Timberwolves","Rudy Gobert",4,20,25,13,17,39.9
11,0,1,3,0,19,3,6,3,"35",1,2,9,2,2,5,1037913,"2023-12-14T00:00:00.000Z",7,FALSE,18,3547238,"G",18,18,"Minnesota Timberwolves","Anthony Edwards",2,11,22,20,13,28.9
3,0,2,4,2,9,5,2,2,"29",0,2,14,2,1,1,1037913,"2023-12-14T00:00:00.000Z",7,FALSE,18,104,"G",18,18,"Minnesota Timberwolves","Mike Conley",1,16,19,17,5,22.9
1,1,0,4,3,6,5,0,0,"20",1,2,13,1,0,1,1037913,"2023-12-14T00:00:00.000Z",7,FALSE,18,666400,"G",18,18,"Minnesota Timberwolves","Nickeil Alexander-Walker",1,14,15,14,2,17.7
2,1,2,1,0,7,3,0,0,"18",0,2,6,2,2,1,1037913,"2023-12-14T00:00:00.000Z",7,FALSE,18,12,"F",18,18,"Minnesota Timberwolves","Kyle Anderson",3,8,10,8,4,19.4
1,0,1,3,1,4,2,0,0,"14",0,0,5,1,0,0,1037913,"2023-12-14T00:00:00.000Z",7,FALSE,18,68,"F",18,18,"Minnesota Timberwolves","Troy Brown Jr.",0,6,7,6,2,7.7
1,0,0,0,0,0,0,0,0,"02",0,0,0,0,0,0,1037913,"2023-12-14T00:00:00.000Z",7,FALSE,18,666767,"G",18,18,"Minnesota Timberwolves","Jordan McLaughlin",0,0,1,1,1,1.5
0,0,0,0,0,0,0,0,0,"02",0,1,0,0,0,0,1037913,"2023-12-14T00:00:00.000Z",7,FALSE,18,38017700,"G",18,18,"Minnesota Timberwolves","Wendell Moore Jr.",0,0,0,0,0,0
3,0,4,11,7,14,8,4,4,"31",2,2,27,6,1,2,1037913,"2023-12-14T00:00:00.000Z",7,FALSE,18,667378,"F-C",18,18,"Minnesota Timberwolves","Naz Reid",1,33,36,30,9,39.7
0,0,0,0,0,0,0,0,0,"00",0,0,0,0,0,0,1037913,"2023-12-14T00:00:00.000Z",7,FALSE,18,17896056,"C",18,18,"Minnesota Timberwolves","Luka Garza",0,0,0,0,0,0
0,0,0,0,0,0,0,0,0,"00",0,0,0,0,0,0,1037913,"2023-12-14T00:00:00.000Z",7,FALSE,18,56677782,"F",18,18,"Minnesota Timberwolves","Leonard Miller",0,0,0,0,0,0
0,0,0,0,0,0,0,0,0,"00",0,0,0,0,0,0,1037913,"2023-12-14T00:00:00.000Z",7,FALSE,18,17895968,"F",18,18,"Minnesota Timberwolves","Daishen Nix",0,0,0,0,0,0
0,0,0,0,0,1,1,1,1,"02",0,0,3,0,0,0,1037913,"2023-12-14T00:00:00.000Z",7,FALSE,18,38017715,"F",18,18,"Minnesota Timberwolves","Josh Minott",0,3,3,3,0,3
0,0,0,0,0,1,1,0,0,"02",0,0,2,0,0,0,1037913,"2023-12-14T00:00:00.000Z",7,FALSE,18,320,"G",18,18,"Minnesota Timberwolves","Shake Milton",0,2,2,2,0,2
0,0,0,0,0,0,0,0,0,"00",0,0,0,0,0,0,1037913,"2023-12-14T00:00:00.000Z",7,FALSE,18,56677851,"G",18,18,"Minnesota Timberwolves","Jaylen Clark",0,0,0,0,0,0
1,0,4,4,1,8,3,2,2,"24",2,0,9,6,1,0,1037914,"2023-12-14T00:00:00.000Z",8,FALSE,3,375,"F",8,8,"Denver Nuggets","Michael Porter Jr.",1,15,16,10,7,20.7
2,1,2,1,0,9,6,1,1,"24",0,0,13,2,1,2,1037914,"2023-12-14T00:00:00.000Z",8,FALSE,3,177,"F",8,8,"Denver Nuggets","Aaron Gordon",2,15,17,15,4,22.4
10,0,14,2,0,12,8,12,10,"30",1,2,26,15,1,1,1037914,"2023-12-14T00:00:00.000Z",8,FALSE,3,246,"C",8,8,"Denver Nuggets","Nikola Jokic",1,41,51,36,25,61
2,0,1,5,0,6,1,0,0,"27",0,2,2,1,4,1,1037914,"2023-12-14T00:00:00.000Z",8,FALSE,3,215,"F-G",8,8,"Denver Nuggets","Justin Holiday",4,3,5,4,3,17.2
2,1,1,4,2,15,7,0,0,"22",0,2,16,1,3,0,1037914,"2023-12-14T00:00:00.000Z",8,FALSE,3,335,"G",8,8,"Denver Nuggets","Jamal Murray",4,17,19,18,3,32.2
2,2,3,3,1,10,4,1,1,"24",1,0,10,4,1,1,1037914,"2023-12-14T00:00:00.000Z",8,FALSE,3,38017709,"G",8,8,"Denver Nuggets","Christian Braun",3,14,16,12,6,25.8
4,0,0,4,2,13,4,2,2,"23",0,3,12,0,2,1,1037914,"2023-12-14T00:00:00.000Z",8,FALSE,3,236,"G",8,8,"Denver Nuggets","Reggie Jackson",2,12,16,16,4,23
0,1,2,0,0,2,1,0,0,"12",2,2,2,4,0,1,1037914,"2023-12-14T00:00:00.000Z",8,FALSE,3,250,"C",8,8,"Denver Nuggets","DeAndre Jordan",1,6,6,2,4,8.8
1,0,0,1,1,2,2,0,0,"06",3,1,5,3,0,0,1037914,"2023-12-14T00:00:00.000Z",8,FALSE,3,3547268,"F-C",8,8,"Denver Nuggets","Zeke Nnaji",0,8,9,6,4,10.1
1,0,0,1,1,1,1,0,0,"02",0,0,3,0,0,0,1037914,"2023-12-14T00:00:00.000Z",8,FALSE,3,56677582,"G",8,8,"Denver Nuggets","Jalen Pickett",0,3,4,4,1,4.5
1,0,4,6,2,10,3,0,0,"20",0,0,8,4,0,0,1037914,"2023-12-14T00:00:00.000Z",8,FALSE,3,56677776,"G",8,8,"Denver Nuggets","Julian Strawther",0,12,13,9,5,14.3
0,0,1,0,0,0,0,0,0,"02",0,0,0,1,0,0,1037914,"2023-12-14T00:00:00.000Z",8,FALSE,3,56677871,"F",8,8,"Denver Nuggets","Hunter Tyson",0,1,1,0,1,1.2
5,1,4,5,2,10,7,3,2,"24",3,3,18,7,1,1,1037914,"2023-12-14T00:00:00.000Z",8,FALSE,3,38017721,"G",8,8,"Denver Nuggets","Peyton Watson",2,25,30,23,12,38.9
0,0,0,0,0,0,0,0,0,"00",0,0,0,0,0,0,1037914,"2023-12-14T00:00:00.000Z",8,FALSE,3,81,"G",8,8,"Denver Nuggets","Kentavious Caldwell-Pope",0,0,0,0,0,0
0,0,0,0,0,0,0,0,0,"00",0,0,0,0,0,0,1037914,"2023-12-14T00:00:00.000Z",8,FALSE,3,666489,"F",8,8,"Denver Nuggets","Vlatko Cancar",0,0,0,0,0,0
0,0,0,0,0,0,0,0,0,"00",0,0,0,0,0,0,1037914,"2023-12-14T00:00:00.000Z",8,FALSE,3,38017727,"G",8,8,"Denver Nuggets","Collin Gillespie",0,0,0,0,0,0
0,0,0,0,0,0,0,0,0,"00",0,0,0,0,0,0,1037914,"2023-12-14T00:00:00.000Z",8,FALSE,3,17896103,"F-C",8,8,"Denver Nuggets","Jay Huff",0,0,0,0,0,0
0,0,0,0,0,0,0,0,0,"00",0,0,0,0,0,0,1037914,"2023-12-14T00:00:00.000Z",8,FALSE,3,17896007,"G",8,8,"Denver Nuggets","Braxton Key",0,0,0,0,0,0
2,0,3,1,1,4,2,2,2,"17",1,0,7,4,0,0,1037914,"2023-12-14T00:00:00.000Z",8,FALSE,3,56677722,"F",3,3,"Brooklyn Nets","Jalen Wilson",0,11,13,9,6,14.8
2,0,8,0,0,9,5,0,0,"17",1,5,10,9,0,2,1037914,"2023-12-14T00:00:00.000Z",8,FALSE,3,666508,"F-C",3,3,"Brooklyn Nets","Nicolas Claxton",0,19,21,12,11,21.8
0,0,3,2,0,13,5,6,3,"27",0,3,13,3,0,0,1037914,"2023-12-14T00:00:00.000Z",8,FALSE,3,17896048,"G",3,3,"Brooklyn Nets","Cam Thomas",0,16,16,13,3,16.6
8,0,4,4,1,11,5,7,6,"24",0,3,17,4,1,2,1037914,"2023-12-14T00:00:00.000Z",8,FALSE,3,130,"G",3,3,"Brooklyn Nets","Spencer Dinwiddie",1,21,29,25,12,34.8
2,0,0,6,2,9,2,0,0,"15",2,0,6,2,0,1,1037914,"2023-12-14T00:00:00.000Z",8,FALSE,3,9051997,"G",3,3,"Brooklyn Nets","Armoni Brooks",0,8,10,8,4,10.4
0,0,0,1,0,3,0,0,0,"16",4,2,0,4,1,1,1037914,"2023-12-14T00:00:00.000Z",8,FALSE,3,158,"F",3,3,"Brooklyn Nets","Dorian Finney-Smith",1,4,4,0,4,6.8
1,0,3,1,0,9,4,3,3,"15",3,1,11,6,1,0,1037914,"2023-12-14T00:00:00.000Z",8,FALSE,3,174,"F-C",3,3,"Brooklyn Nets","Harry Giles III",1,17,18,12,7,22.7
1,0,1,0,0,1,1,0,0,"14",0,1,2,1,1,1,1037914,"2023-12-14T00:00:00.000Z",8,FALSE,3,351,"F",3,3,"Brooklyn Nets","Royce O'Neale",1,3,4,3,2,6.7
5,1,9,1,0,9,4,0,0,"26",4,4,8,13,0,3,1037914,"2023-12-14T00:00:00.000Z",8,FALSE,3,17896038,"C",3,3,"Brooklyn Nets","Day'Ron Sharpe",1,21,26,13,18,31.1
6,2,2,1,0,9,4,0,0,"22",2,2,8,4,0,2,1037914,"2023-12-14T00:00:00.000Z",8,FALSE,3,17896058,"F",3,3,"Brooklyn Nets","Trendon Watford",2,12,18,14,10,25.8
0,0,0,0,0,0,0,0,0,"00",0,0,0,0,0,0,1037914,"2023-12-14T00:00:00.000Z",8,FALSE,3,56677843,"F",3,3,"Brooklyn Nets","Noah Clowney",0,0,0,0,0,0
0,0,0,0,0,0,0,0,0,"00",0,0,0,0,0,0,1037914,"2023-12-14T00:00:00.000Z",8,FALSE,3,17896041,"G",3,3,"Brooklyn Nets","Keon Johnson",0,0,0,0,0,0
0,0,0,0,0,0,0,0,0,"00",0,0,0,0,0,0,1037914,"2023-12-14T00:00:00.000Z",8,FALSE,3,417,"G-F",3,3,"Brooklyn Nets","Ben Simmons",0,0,0,0,0,0
0,0,0,0,0,0,0,0,0,"00",0,0,0,0,0,0,1037914,"2023-12-14T00:00:00.000Z",8,FALSE,3,421,"G",3,3,"Brooklyn Nets","Dennis Smith Jr.",0,0,0,0,0,0
0,0,0,0,0,0,0,0,0,"00",0,0,0,0,0,0,1037914,"2023-12-14T00:00:00.000Z",8,FALSE,3,464,"G",3,3,"Brooklyn Nets","Lonnie Walker IV",0,0,0,0,0,0
0,0,0,0,0,0,0,0,0,"00",0,0,0,0,0,0,1037914,"2023-12-14T00:00:00.000Z",8,FALSE,3,56677841,"F",3,3,"Brooklyn Nets","Dariq Whitehead",0,0,0,0,0,0
1,0,0,6,2,8,3,2,1,"25",0,0,9,0,1,4,1037914,"2023-12-14T00:00:00.000Z",8,FALSE,3,61,"F",3,3,"Brooklyn Nets","Mikal Bridges",1,9,10,10,1,9.5
0,0,2,7,2,10,4,0,0,"22",1,2,10,3,0,1,1037914,"2023-12-14T00:00:00.000Z",8,FALSE,3,666679,"F",3,3,"Brooklyn Nets","Cameron Johnson",0,13,13,10,3,12.6
2,0,3,4,1,5,1,0,0,"17",0,1,3,3,1,0,1037915,"2023-12-14T00:00:00.000Z",25,FALSE,29,666923,"G-F",25,25,"Portland Trail Blazers","Matisse Thybulle",1,6,8,5,5,12.6
0,0,2,4,3,10,7,2,1,"24",4,3,18,6,0,1,1037915,"2023-12-14T00:00:00.000Z",25,FALSE,29,56677850,"F",25,25,"Portland Trail Blazers","Toumani Camara",0,24,24,18,6,24.2
0,1,4,0,0,13,6,2,2,"21",5,2,14,9,1,4,1037915,"2023-12-14T00:00:00.000Z",25,FALSE,29,22,"C",25,25,"Portland Trail Blazers","Deandre Ayton",2,23,23,14,9,26.8
2,1,5,5,0,12,1,2,2,"27",2,3,4,7,0,0,1037915,"2023-12-14T00:00:00.000Z",25,FALSE,29,38017690,"G",25,25,"Portland Trail Blazers","Shaedon Sharpe",1,11,13,6,9,18.4
6,0,1,6,2,8,3,2,1,"22",0,1,9,1,1,2,1037915,"2023-12-14T00:00:00.000Z",25,FALSE,29,419,"G",25,25,"Portland Trail Blazers","Anfernee Simons",1,10,16,15,7,20.2
1,0,0,6,3,6,3,2,0,"14",0,0,9,0,0,0,1037915,"2023-12-14T00:00:00.000Z",25,FALSE,29,65,"G",25,25,"Portland Trail Blazers","Malcolm Brogdon",0,9,10,10,1,10.5
0,0,1,0,0,0,0,0,0,"05",0,0,0,1,0,0,1037915,"2023-12-14T00:00:00.000Z",25,FALSE,29,666476,"C",25,25,"Portland Trail Blazers","Moses Brown",0,1,1,0,1,1.2
10,0,2,7,2,21,9,3,3,"35",0,1,23,2,1,4,1037915,"2023-12-14T00:00:00.000Z",25,FALSE,29,56677747,"G",25,25,"Portland Trail Blazers","Scoot Henderson",1,25,35,33,12,39.4
1,0,5,2,0,10,5,5,3,"28",4,0,13,9,1,0,1037915,"2023-12-14T00:00:00.000Z",25,FALSE,29,38017711,"F",25,25,"Portland Trail Blazers","Jabari Walker",1,22,23,14,10,28.3
2,0,3,6,2,12,7,0,0,"26",0,3,16,3,0,1,1037915,"2023-12-14T00:00:00.000Z",25,FALSE,29,38017620,"G",29,29,"Utah Jazz","Ochai Agbaji",0,19,21,18,5,21.6
0,0,0,0,0,0,0,0,0,"00",0,0,0,0,0,0,1037915,"2023-12-14T00:00:00.000Z",25,FALSE,29,101,"F-C",29,29,"Utah Jazz","John Collins",0,0,0,0,0,0
5,0,1,2,0,8,3,0,0,"26",1,2,6,2,0,0,1037915,"2023-12-14T00:00:00.000Z",25,FALSE,29,139,"G",29,29,"Utah Jazz","Kris Dunn",0,8,13,11,7,15.9
0,0,4,5,2,9,4,0,0,"25",3,1,10,7,1,2,1037915,"2023-12-14T00:00:00.000Z",25,FALSE,29,56677824,"F",29,29,"Utah Jazz","Taylor Hendricks",1,17,17,10,7,19.4
0,0,0,0,0,0,0,0,0,"03",0,0,0,0,0,0,1037915,"2023-12-14T00:00:00.000Z",25,FALSE,29,19465584,"F",29,29,"Utah Jazz","Micah Potter",0,0,0,0,0,0
0,0,0,0,0,0,0,0,0,"00",0,0,0,0,0,0,1037915,"2023-12-14T00:00:00.000Z",25,FALSE,29,666881,"F",29,29,"Utah Jazz","Luka Samanic",0,0,0,0,0,0
1,2,1,0,0,7,2,0,0,"22",3,3,4,4,1,2,1037915,"2023-12-14T00:00:00.000Z",25,FALSE,29,11891374,"C",29,29,"Utah Jazz","Omer Yurtseven",3,8,9,5,5,17.3
0,0,0,0,0,0,0,0,0,"00",0,0,0,0,0,0,1037915,"2023-12-14T00:00:00.000Z",25,FALSE,29,17896023,"G",29,29,"Utah Jazz","Josh Christopher",0,0,0,0,0,0
0,0,0,0,0,0,0,0,0,"00",0,0,0,0,0,0,1037915,"2023-12-14T00:00:00.000Z",25,FALSE,29,100,"G",29,29,"Utah Jazz","Jordan Clarkson",0,0,0,0,0,0
0,0,0,0,0,0,0,0,0,"00",0,0,0,0,0,0,1037915,"2023-12-14T00:00:00.000Z",25,FALSE,29,56677834,"G",29,29,"Utah Jazz","Keyonte George",0,0,0,0,0,0
0,0,0,0,0,0,0,0,0,"00",0,0,0,0,0,0,1037915,"2023-12-14T00:00:00.000Z",25,FALSE,29,38017630,"G",29,29,"Utah Jazz","Johnny Juzang",0,0,0,0,0,0
0,1,3,6,3,11,6,0,0,"13",2,1,15,5,1,0,1037915,"2023-12-14T00:00:00.000Z",25,FALSE,29,56783340,"C",25,25,"Portland Trail Blazers","Duop Reath",2,20,20,15,5,27
5,0,0,0,0,0,0,0,0,"17",1,0,0,1,1,0,1037915,"2023-12-14T00:00:00.000Z",25,FALSE,29,3547289,"G",25,25,"Portland Trail Blazers","Skylar Mays",1,1,6,5,6,11.7
3,1,2,5,2,7,2,0,0,"17",3,0,6,5,2,0,1037915,"2023-12-14T00:00:00.000Z",25,FALSE,29,56677791,"F",25,25,"Portland Trail Blazers","Kris Murray",3,11,14,9,8,25.5
0,0,0,0,0,0,0,0,0,"00",0,0,0,0,0,0,1037915,"2023-12-14T00:00:00.000Z",25,FALSE,29,39613724,"C",25,25,"Portland Trail Blazers","Ibou Badji",0,0,0,0,0,0
0,0,0,0,0,0,0,0,0,"00",0,0,0,0,0,0,1037915,"2023-12-14T00:00:00.000Z",25,FALSE,29,182,"F",25,25,"Portland Trail Blazers","Jerami Grant",0,0,0,0,0,0
0,0,0,0,0,0,0,0,0,"00",0,0,0,0,0,0,1037915,"2023-12-14T00:00:00.000Z",25,FALSE,29,47957121,"F",25,25,"Portland Trail Blazers","Justin Minaya",0,0,0,0,0,0
0,0,0,0,0,0,0,0,0,"00",0,0,0,0,0,0,1037915,"2023-12-14T00:00:00.000Z",25,FALSE,29,56677829,"G-F",25,25,"Portland Trail Blazers","Rayan Rupert",0,0,0,0,0,0
0,0,0,0,0,0,0,0,0,"00",0,0,0,0,0,0,1037915,"2023-12-14T00:00:00.000Z",25,FALSE,29,17896120,"F",25,25,"Portland Trail Blazers","Ish Wainright",0,0,0,0,0,0
0,0,0,0,0,0,0,0,0,"00",0,0,0,0,0,0,1037915,"2023-12-14T00:00:00.000Z",25,FALSE,29,476,"C-F",25,25,"Portland Trail Blazers","Robert Williams III",0,0,0,0,0,0
0,0,4,5,5,8,7,5,5,"25",1,0,24,5,1,0,1037915,"2023-12-14T00:00:00.000Z",25,FALSE,29,38017739,"F",29,29,"Utah Jazz","Simone Fontecchio",1,29,29,24,5,33
7,0,9,3,0,6,1,0,0,"24",1,1,2,10,0,0,1037915,"2023-12-14T00:00:00.000Z",25,FALSE,29,358,"F",29,29,"Utah Jazz","Kelly Olynyk",0,12,19,9,17,24.5
0,0,0,0,0,0,0,0,0,"00",0,0,0,0,0,0,1037915,"2023-12-14T00:00:00.000Z",25,FALSE,29,297,"F",29,29,"Utah Jazz","Lauri Markkanen",0,0,0,0,0,0
0,0,0,0,0,0,0,0,0,"00",0,0,0,0,0,0,1037915,"2023-12-14T00:00:00.000Z",25,FALSE,29,56677842,"F",29,29,"Utah Jazz","Brice Sensabaugh",0,0,0,0,0,0
4,7,8,1,0,6,5,0,0,"27",2,0,10,10,1,1,1037915,"2023-12-14T00:00:00.000Z",25,FALSE,29,38017705,"C",29,29,"Utah Jazz","Walker Kessler",8,20,24,14,14,51
4,0,1,5,2,17,11,3,3,"32",1,2,27,2,1,2,1037915,"2023-12-14T00:00:00.000Z",25,FALSE,29,413,"G",29,29,"Utah Jazz","Collin Sexton",1,29,33,31,6,36.4
4,0,1,6,0,19,9,6,5,"30",1,2,23,2,4,3,1037915,"2023-12-14T00:00:00.000Z",25,FALSE,29,666650,"G",29,29,"Utah Jazz","Talen Horton-Tucker",4,25,29,27,6,40.4
2,0,1,4,1,7,2,0,0,"21",2,1,5,3,0,2,1037916,"2023-12-14T00:00:00.000Z",26,FALSE,21,30,"F",26,26,"Sacramento Kings","Harrison Barnes",0,8,10,7,5,9.6
1,0,1,2,0,8,4,8,7,"31",2,4,15,3,1,1,1037916,"2023-12-14T00:00:00.000Z",26,FALSE,21,38017688,"F",26,26,"Sacramento Kings","Keegan Murray",1,18,19,16,4,22.1
7,0,14,2,1,13,8,2,1,"40",2,2,18,16,0,2,1037916,"2023-12-14T00:00:00.000Z",26,FALSE,21,406,"F",26,26,"Sacramento Kings","Domantas Sabonis",0,34,41,25,23,45.7
2,1,1,3,0,8,2,0,0,"20",1,1,4,2,2,1,1037916,"2023-12-14T00:00:00.000Z",26,FALSE,21,221,"G",26,26,"Sacramento Kings","Kevin Huerter",3,6,8,6,4,17.4
7,0,3,11,5,23,14,11,8,"34",0,3,41,3,2,6,1037916,"2023-12-14T00:00:00.000Z",26,FALSE,21,161,"G",26,26,"Sacramento Kings","De'Aaron Fox",2,44,51,48,10,55.1
0,0,0,0,0,0,0,0,0,"00",0,0,0,0,0,0,1037916,"2023-12-14T00:00:00.000Z",26,FALSE,21,17896030,"G",26,26,"Sacramento Kings","Chris Duarte",0,0,0,0,0,0
0,0,0,0,0,0,0,0,0,"01",0,0,0,0,0,0,1037916,"2023-12-14T00:00:00.000Z",26,FALSE,21,17896044,"F",26,26,"Sacramento Kings","Kessler Edwards",0,0,0,0,0,0
3,1,4,7,5,8,6,0,0,"27",2,5,17,6,1,0,1037916,"2023-12-14T00:00:00.000Z",26,FALSE,21,38017714,"G",26,26,"Sacramento Kings","Keon Ellis",2,23,26,20,9,34.7
1,1,6,4,1,5,2,0,0,"19",1,2,5,7,0,0,1037916,"2023-12-14T00:00:00.000Z",26,FALSE,21,290,"F",26,26,"Sacramento Kings","Trey Lyles",1,12,13,6,8,17.9
0,0,2,0,0,1,1,0,0,"04",0,1,2,2,0,2,1037916,"2023-12-14T00:00:00.000Z",26,FALSE,21,306,"C",26,26,"Sacramento Kings","JaVale McGee",0,4,4,2,2,2.4
9,1,1,8,4,15,7,0,0,"33",0,2,18,1,0,4,1037916,"2023-12-14T00:00:00.000Z",26,FALSE,21,324,"G",26,26,"Sacramento Kings","Malik Monk",1,19,28,27,10,31.7
0,0,3,4,1,4,1,0,0,"10",1,1,3,4,0,0,1037916,"2023-12-14T00:00:00.000Z",26,FALSE,21,4197162,"F",26,26,"Sacramento Kings","Aleksandar Vezenkov",0,7,7,3,4,7.8
0,0,0,0,0,4,3,0,0,"07",1,0,6,1,0,1,1037916,"2023-12-14T00:00:00.000Z",26,FALSE,21,17896078,"G",21,21,"Oklahoma City Thunder","Aaron Wiggins",0,7,7,6,1,6.2
3,0,5,3,1,3,1,0,0,"15",1,2,3,6,0,0,1037916,"2023-12-14T00:00:00.000Z",26,FALSE,21,38017706,"F",21,21,"Oklahoma City Thunder","Jaylin Williams",0,9,12,6,9,14.7
1,0,0,2,0,5,1,0,0,"11",0,1,2,0,0,0,1037916,"2023-12-14T00:00:00.000Z",26,FALSE,21,480,"G-F",21,21,"Oklahoma City Thunder","Kenrich Williams",0,2,3,3,1,3.5
0,0,0,0,0,0,0,0,0,"00",0,0,0,0,0,0,1037916,"2023-12-14T00:00:00.000Z",26,FALSE,21,56677853,"F",21,21,"Oklahoma City Thunder","Keyontae Johnson",0,0,0,0,0,0
0,0,0,0,0,0,0,0,0,"00",0,0,0,0,0,0,1037916,"2023-12-14T00:00:00.000Z",26,FALSE,21,3547271,"C",21,21,"Oklahoma City Thunder","Aleksej Pokusevski",0,0,0,0,0,0
0,0,0,0,0,0,0,0,0,"00",0,0,0,0,0,0,1037916,"2023-12-14T00:00:00.000Z",26,FALSE,21,27924547,"F",21,21,"Oklahoma City Thunder","Lindy Waters III",0,0,0,0,0,0
0,0,0,0,0,0,0,0,0,"00",0,0,0,0,0,0,1037916,"2023-12-14T00:00:00.000Z",26,FALSE,21,56677862,"F",26,26,"Sacramento Kings","Jalen Slawson",0,0,0,0,0,0
0,1,2,5,3,8,5,5,4,"32",2,4,17,4,2,1,1037916,"2023-12-14T00:00:00.000Z",26,FALSE,21,666541,"G",21,21,"Oklahoma City Thunder","Luguentz Dort",3,21,21,17,4,29.8
3,1,2,4,0,14,2,1,1,"29",2,4,5,4,1,1,1037916,"2023-12-14T00:00:00.000Z",26,FALSE,21,38017703,"G-F",21,21,"Oklahoma City Thunder","Jalen Williams",2,9,12,8,7,19.3
1,1,8,3,0,12,6,2,2,"30",2,5,14,10,0,1,1037916,"2023-12-14T00:00:00.000Z",26,FALSE,21,38017685,"C-F",21,21,"Oklahoma City Thunder","Chet Holmgren",1,24,25,15,11,29.5
4,1,3,3,2,14,8,0,0,"29",5,4,18,8,3,4,1037916,"2023-12-14T00:00:00.000Z",26,FALSE,21,17896065,"G",21,21,"Oklahoma City Thunder","Josh Giddey",4,26,30,22,12,41.6
9,0,4,5,1,27,13,18,16,"38",2,2,43,6,2,3,1037916,"2023-12-14T00:00:00.000Z",26,FALSE,21,175,"G",21,21,"Oklahoma City Thunder","Shai Gilgeous-Alexander",2,49,58,52,15,66.7
1,0,2,1,0,1,0,0,0,"05",1,1,0,3,0,1,1037916,"2023-12-14T00:00:00.000Z",26,FALSE,21,44,"F",21,21,"Oklahoma City Thunder","Davis Bertans",0,3,4,1,4,4.1
0,0,0,4,2,4,2,0,0,"10",0,0,6,0,0,1,1037916,"2023-12-14T00:00:00.000Z",26,FALSE,21,38017716,"F",21,21,"Oklahoma City Thunder","Ousmane Dieng",0,6,6,6,0,5
0,0,1,5,1,7,2,1,1,"15",0,1,6,1,0,0,1037916,"2023-12-14T00:00:00.000Z",26,FALSE,21,3547272,"G",21,21,"Oklahoma City Thunder","Isaiah Joe",0,7,7,6,1,7.2
0,0,0,0,0,0,0,0,0,"00",0,0,0,0,0,0,1037916,"2023-12-14T00:00:00.000Z",26,FALSE,21,17896036,"G",21,21,"Oklahoma City Thunder","Tre Mann",0,0,0,0,0,0
0,0,0,0,0,0,0,0,0,"00",0,0,0,0,0,0,1037916,"2023-12-14T00:00:00.000Z",26,FALSE,21,4197029,"G",21,21,"Oklahoma City Thunder","Vasilije Micic",0,0,0,0,0,0
0,0,0,0,0,0,0,0,0,"00",0,0,0,0,0,0,1037916,"2023-12-14T00:00:00.000Z",26,FALSE,21,24572055,"C",21,21,"Oklahoma City Thunder","Olivier Sarr",0,0,0,0,0,0
4,0,0,2,1,3,1,0,0,"19",0,3,3,0,0,0,1037916,"2023-12-14T00:00:00.000Z",26,FALSE,21,56677833,"G",21,21,"Oklahoma City Thunder","Cason Wallace",0,3,7,7,4,9
0,0,0,0,0,0,0,0,0,"00",0,0,0,0,0,0,1037916,"2023-12-14T00:00:00.000Z",26,FALSE,21,17895990,"G",26,26,"Sacramento Kings","Jordan Ford",0,0,0,0,0,0
0,0,0,0,0,0,0,0,0,"00",0,0,0,0,0,0,1037916,"2023-12-14T00:00:00.000Z",26,FALSE,21,56677845,"G",26,26,"Sacramento Kings","Colby Jones",0,0,0,0,0,0
0,0,0,0,0,0,0,0,0,"00",0,0,0,0,0,0,1037916,"2023-12-14T00:00:00.000Z",26,FALSE,21,17553994,"G",26,26,"Sacramento Kings","Davion Mitchell",0,0,0,0,0,0
0,0,0,0,0,0,0,0,0,"00",0,0,0,0,0,0,1037916,"2023-12-14T00:00:00.000Z",26,FALSE,21,273,"C",26,26,"Sacramento Kings","Alex Len",0,0,0,0,0,0
2,0,2,4,0,5,1,0,0,"20",1,1,2,3,1,0,1037917,"2023-12-14T00:00:00.000Z",13,FALSE,10,666743,"G",13,13,"LA Clippers","Terance Mann",1,5,7,4,5,11.6
2,1,5,4,2,16,9,9,7,"39",3,2,27,8,1,2,1037917,"2023-12-14T00:00:00.000Z",13,FALSE,10,274,"F",13,13,"LA Clippers","Kawhi Leonard",2,35,37,29,10,43.6
2,2,5,0,0,10,5,0,0,"30",3,5,10,8,0,3,1037917,"2023-12-14T00:00:00.000Z",13,FALSE,10,493,"C",13,13,"LA Clippers","Ivica Zubac",2,18,20,12,10,25.6
1,0,3,11,4,15,6,3,2,"30",1,2,18,4,0,1,1037917,"2023-12-14T00:00:00.000Z",13,FALSE,10,666511,"G",13,13,"LA Clippers","Amir Coffey",0,22,23,19,5,23.3
15,4,5,6,5,12,6,12,11,"43",2,3,28,7,1,4,1037917,"2023-12-14T00:00:00.000Z",13,FALSE,10,192,"G",13,13,"LA Clippers","James Harden",5,35,50,43,22,69.9
0,0,0,0,0,0,0,0,0,"00",0,0,0,0,0,0,1037917,"2023-12-14T00:00:00.000Z",13,FALSE,10,17896022,"G",13,13,"LA Clippers","Brandon Boston Jr.",0,0,0,0,0,0
0,0,0,0,0,1,1,0,0,"07",0,2,2,0,1,0,1037917,"2023-12-14T00:00:00.000Z",13,FALSE,10,56677849,"F",13,13,"LA Clippers","Kobe Brown",1,2,2,2,0,5
0,0,0,0,0,0,0,0,0,"00",0,0,0,0,0,0,1037917,"2023-12-14T00:00:00.000Z",13,FALSE,10,56677856,"G",13,13,"LA Clippers","Jordan Miller",0,0,0,0,0,0
0,0,0,0,0,0,0,0,0,"00",0,0,0,0,0,0,1037917,"2023-12-14T00:00:00.000Z",13,FALSE,10,371,"F-C",13,13,"LA Clippers","Mason Plumlee",0,0,0,0,0,0
0,0,0,0,0,0,0,0,0,"00",0,0,0,0,0,0,1037917,"2023-12-14T00:00:00.000Z",13,FALSE,10,17896051,"G",13,13,"LA Clippers","Joshua Primo",0,0,0,0,0,0
2,1,3,3,0,11,2,0,0,"35",4,2,4,7,3,3,1037917,"2023-12-14T00:00:00.000Z",13,FALSE,10,56677858,"G",10,10,"Golden State Warriors","Brandin Podziemski",4,11,13,6,9,24.4
1,0,5,3,2,10,5,3,3,"25",0,4,15,5,1,1,1037917,"2023-12-14T00:00:00.000Z",13,FALSE,10,17553979,"F",10,10,"Golden State Warriors","Jonathan Kuminga",1,20,21,16,6,24.5
5,0,2,0,0,7,4,0,0,"25",5,2,8,7,1,1,1037917,"2023-12-14T00:00:00.000Z",13,FALSE,10,282,"F",10,10,"Golden State Warriors","Kevon Looney",1,15,20,13,12,25.9
5,0,1,12,8,15,9,4,4,"32",0,1,30,1,2,0,1037917,"2023-12-14T00:00:00.000Z",13,FALSE,10,443,"G",10,10,"Golden State Warriors","Klay Thompson",2,31,36,35,6,44.7
4,0,4,13,3,17,5,4,4,"34",0,3,17,4,0,1,1037917,"2023-12-14T00:00:00.000Z",13,FALSE,10,115,"G",10,10,"Golden State Warriors","Stephen Curry",0,21,25,21,8,26.8
0,0,0,0,0,3,1,0,0,"05",3,0,2,3,0,0,1037917,"2023-12-14T00:00:00.000Z",13,FALSE,10,56677799,"F",10,10,"Golden State Warriors","Trayce Jackson-Davis",0,5,5,2,3,5.6
1,0,3,1,0,6,4,4,3,"16",2,1,11,5,1,2,1037917,"2023-12-14T00:00:00.000Z",13,FALSE,10,17553992,"G",10,10,"Golden State Warriors","Moses Moody",1,16,17,12,6,19.5
3,0,2,5,2,9,4,2,2,"29",0,4,12,2,0,2,1037917,"2023-12-14T00:00:00.000Z",13,FALSE,10,367,"G",10,10,"Golden State Warriors","Chris Paul",0,14,17,15,5,16.9
1,0,6,4,1,5,2,0,0,"17",0,2,5,6,0,1,1037917,"2023-12-14T00:00:00.000Z",13,FALSE,10,407,"F",10,10,"Golden State Warriors","Dario Saric",0,11,12,6,7,12.7
0,1,1,4,0,9,4,2,1,"22",2,5,9,3,0,0,1037917,"2023-12-14T00:00:00.000Z",13,FALSE,10,475,"F-G",10,10,"Golden State Warriors","Andrew Wiggins",1,12,12,9,3,15.6
0,0,0,0,0,0,0,0,0,"00",0,0,0,0,0,0,1037917,"2023-12-14T00:00:00.000Z",13,FALSE,10,17896031,"G",13,13,"LA Clippers","Nah'Shon Hyland",0,0,0,0,0,0
0,0,0,0,0,0,0,0,0,"00",0,0,0,0,0,0,1037917,"2023-12-14T00:00:00.000Z",13,FALSE,10,24417679,"G",13,13,"LA Clippers","Xavier Moon",0,0,0,0,0,0
2,0,5,4,1,13,9,2,2,"36",0,3,21,5,1,1,1037917,"2023-12-14T00:00:00.000Z",13,FALSE,10,380,"F-G",13,13,"LA Clippers","Norman Powell",1,26,28,23,7,32
1,1,1,1,0,2,0,4,4,"16",0,2,4,1,1,0,1037917,"2023-12-14T00:00:00.000Z",13,FALSE,10,439,"F",13,13,"LA Clippers","Daniel Theis",2,5,6,5,2,12.7
0,0,0,0,0,0,0,0,0,"00",0,0,0,0,0,0,1037917,"2023-12-14T00:00:00.000Z",13,FALSE,10,450,"F",13,13,"LA Clippers","PJ Tucker",0,0,0,0,0,0
2,1,4,2,1,7,4,0,0,"19",0,0,9,4,0,2,1037917,"2023-12-14T00:00:00.000Z",13,FALSE,10,472,"G",13,13,"LA Clippers","Russell Westbrook",1,13,15,11,6,17.8
0,0,0,0,0,0,0,0,0,"00",0,0,0,0,0,0,1037917,"2023-12-14T00:00:00.000Z",13,FALSE,10,38017725,"F",13,13,"LA Clippers","Moussa Diabate",0,0,0,0,0,0
0,0,0,0,0,0,0,0,0,"00",0,0,0,0,0,0,1037917,"2023-12-14T00:00:00.000Z",13,FALSE,10,172,"F",13,13,"LA Clippers","Paul George",0,0,0,0,0,0
0,0,0,0,0,0,0,0,0,"00",0,0,0,0,0,0,1037917,"2023-12-14T00:00:00.000Z",13,FALSE,10,185,"F",10,10,"Golden State Warriors","Draymond Green",0,0,0,0,0,0
0,0,0,0,0,0,0,0,0,"00",0,0,0,0,0,0,1037917,"2023-12-14T00:00:00.000Z",13,FALSE,10,251,"G",10,10,"Golden State Warriors","Cory Joseph",0,0,0,0,0,0
0,0,0,0,0,0,0,0,0,"00",0,0,0,0,0,0,1037917,"2023-12-14T00:00:00.000Z",13,FALSE,10,2189,"",10,10,"Golden State Warriors","Gary Payton II",0,0,0,0,0,0
0,0,0,0,0,0,0,0,0,"00",0,0,0,0,0,0,1037917,"2023-12-14T00:00:00.000Z",13,FALSE,10,17896070,"F",10,10,"Golden State Warriors","Usman Garuba",0,0,0,0,0,0
0,0,0,0,0,0,0,0,0,"00",0,0,0,0,0,0,1037917,"2023-12-14T00:00:00.000Z",13,FALSE,10,45658838,"G",10,10,"Golden State Warriors","Lester Quinones",0,0,0,0,0,0
0,0,0,0,0,0,0,0,0,"00",0,0,0,0,0,0,1037917,"2023-12-14T00:00:00.000Z",13,FALSE,10,398,"G",10,10,"Golden State Warriors","Jerome Robinson",0,0,0,0,0,0
0,0,0,0,0,0,0,0,0,"00",0,0,0,0,0,0,1037917,"2023-12-14T00:00:00.000Z",13,FALSE,10,57875092,"F",10,10,"Golden State Warriors","Gui Santos",0,0,0,0,0,0
4,1,3,4,1,10,4,0,0,"34",0,2,9,3,1,1,1037918,"2023-12-15T00:00:00.000Z",4,FALSE,19,204,"F",4,4,"Charlotte Hornets","Gordon Hayward",2,12,16,13,7,23.6
2,0,8,8,2,24,10,6,5,"39",2,5,27,10,1,3,1037918,"2023-12-15T00:00:00.000Z",4,FALSE,19,62,"F",4,4,"Charlotte Hornets","Miles Bridges",1,37,39,29,12,42
1,1,5,0,0,7,7,2,2,"30",1,5,16,6,0,0,1037918,"2023-12-15T00:00:00.000Z",4,FALSE,19,3547282,"C",4,4,"Charlotte Hornets","Nick Richards",1,22,23,17,7,27.7
3,0,4,5,2,16,7,2,0,"35",0,3,16,4,1,0,1037918,"2023-12-15T00:00:00.000Z",4,FALSE,19,56677823,"F",4,4,"Charlotte Hornets","Brandon Miller",1,20,23,19,7,28.3
6,0,4,11,4,25,11,4,4,"39",0,0,30,4,3,2,1037918,"2023-12-15T00:00:00.000Z",4,FALSE,19,403,"G",4,4,"Charlotte Hornets","Terry Rozier",3,34,40,36,10,50.8
0,0,0,0,0,0,0,0,0,"00",0,0,0,0,0,0,1037918,"2023-12-15T00:00:00.000Z",4,FALSE,19,56677866,"F",4,4,"Charlotte Hornets","Leaky Black",0,0,0,0,0,0
0,0,0,0,0,0,0,0,0,"00",0,0,0,0,0,0,1037918,"2023-12-15T00:00:00.000Z",4,FALSE,19,17896037,"G",4,4,"Charlotte Hornets","James Bouknight",0,0,0,0,0,0
0,0,1,2,0,5,2,5,3,"21",1,2,7,2,1,0,1037918,"2023-12-15T00:00:00.000Z",4,FALSE,19,38017708,"G",4,4,"Charlotte Hornets","Bryce McGowens",1,9,9,7,2,12.4
0,0,5,0,0,1,0,2,2,"13",2,6,2,7,0,2,1037918,"2023-12-15T00:00:00.000Z",4,FALSE,19,NA,NA,NA,4,"Charlotte Hornets","NA NA",0,9,9,2,7,8.4
2,0,0,0,0,2,0,0,0,"15",1,0,0,1,0,0,1037918,"2023-12-15T00:00:00.000Z",4,FALSE,19,422,"G",4,4,"Charlotte Hornets","Ish Smith",0,1,3,2,3,4.2
0,0,0,0,0,0,0,0,0,"00",0,0,0,0,0,0,1037918,"2023-12-15T00:00:00.000Z",4,FALSE,19,56677846,"G",4,4,"Charlotte Hornets","Nick Smith Jr.",0,0,0,0,0,0
0,2,1,1,0,2,0,0,0,"14",1,1,0,2,0,0,1037918,"2023-12-15T00:00:00.000Z",4,FALSE,19,18678001,"F",4,4,"Charlotte Hornets","JT Thor",2,2,2,0,2,8.4
0,0,0,0,0,0,0,0,0,"00",0,0,0,0,0,0,1037918,"2023-12-15T00:00:00.000Z",4,FALSE,19,56677848,"G",4,4,"Charlotte Hornets","Amari Bailey",0,0,0,0,0,0
0,0,0,0,0,0,0,0,0,"00",0,0,0,0,0,0,1037918,"2023-12-15T00:00:00.000Z",4,FALSE,19,3547239,"G",4,4,"Charlotte Hornets","LaMelo Ball",0,0,0,0,0,0
0,0,0,0,0,0,0,0,0,"00",0,0,0,0,0,0,1037918,"2023-12-15T00:00:00.000Z",4,FALSE,19,3547253,"G",4,4,"Charlotte Hornets","Theo Maledon",0,0,0,0,0,0
0,0,0,0,0,0,0,0,0,"00",0,0,0,0,0,0,1037918,"2023-12-15T00:00:00.000Z",4,FALSE,19,666748,"F",4,4,"Charlotte Hornets","Cody Martin",0,0,0,0,0,0
0,0,0,0,0,0,0,0,0,"00",0,0,0,0,0,0,1037918,"2023-12-15T00:00:00.000Z",4,FALSE,19,347,"G",4,4,"Charlotte Hornets","Frank Ntilikina",0,0,0,0,0,0
0,0,0,0,0,0,0,0,0,"00",0,0,0,0,0,0,1037918,"2023-12-15T00:00:00.000Z",4,FALSE,19,666950,"F",4,4,"Charlotte Hornets","P.J. Washington",0,0,0,0,0,0
0,0,0,0,0,0,0,0,0,"00",0,0,0,0,0,0,1037918,"2023-12-15T00:00:00.000Z",4,FALSE,19,38017698,"C",4,4,"Charlotte Hornets","Mark Williams",0,0,0,0,0,0
7,0,3,1,0,8,3,2,2,"32",0,3,8,3,0,9,1037918,"2023-12-15T00:00:00.000Z",4,FALSE,19,227,"F",19,19,"New Orleans Pelicans","Brandon Ingram",0,11,18,15,10,13.1
4,0,8,0,0,16,9,4,3,"30",3,4,21,11,0,1,1037918,"2023-12-15T00:00:00.000Z",4,FALSE,19,666969,"F",19,19,"New Orleans Pelicans","Zion Williamson",0,32,36,25,15,39.2
0,0,0,0,0,0,0,0,0,"00",0,0,0,0,0,0,1037918,"2023-12-15T00:00:00.000Z",4,FALSE,19,17896017,"F",19,19,"New Orleans Pelicans","Matt Ryan",0,0,0,0,0,0
0,0,0,0,0,0,0,0,0,"00",0,0,0,0,0,0,1037918,"2023-12-15T00:00:00.000Z",4,FALSE,19,38017726,"G",19,19,"New Orleans Pelicans","Dereon Seabron",0,0,0,0,0,0
0,0,0,0,0,0,0,0,0,"00",0,0,0,0,0,0,1037918,"2023-12-15T00:00:00.000Z",4,FALSE,19,38017663,"F",19,19,"New Orleans Pelicans","E.J. Liddell",0,0,0,0,0,0
0,0,0,0,0,0,0,0,0,"00",0,0,0,0,0,0,1037918,"2023-12-15T00:00:00.000Z",4,FALSE,19,340,"F",19,19,"New Orleans Pelicans","Larry Nance Jr.",0,0,0,0,0,0
4,2,9,4,2,16,11,6,5,"37",4,3,29,13,0,2,1037918,"2023-12-15T00:00:00.000Z",4,FALSE,19,455,"C",19,19,"New Orleans Pelicans","Jonas Valanciunas",2,42,46,33,17,54.6
1,1,1,2,1,4,3,6,4,"28",1,1,11,2,1,0,1037918,"2023-12-15T00:00:00.000Z",4,FALSE,19,17896024,"F",19,19,"New Orleans Pelicans","Herbert Jones",2,13,14,12,3,20.9
4,1,3,9,3,18,7,2,2,"35",2,0,19,5,1,2,1037918,"2023-12-15T00:00:00.000Z",4,FALSE,19,303,"G",19,19,"New Orleans Pelicans","CJ McCollum",2,24,28,23,9,35
1,0,1,2,1,4,1,0,0,"13",0,0,3,1,0,0,1037918,"2023-12-15T00:00:00.000Z",4,FALSE,19,3547293,"F",19,19,"New Orleans Pelicans","Naji Marshall",0,4,5,4,2,5.7
1,1,7,3,1,6,1,6,5,"21",1,3,8,8,1,1,1037918,"2023-12-15T00:00:00.000Z",4,FALSE,19,17896097,"G",19,19,"New Orleans Pelicans","Jose Alvarado",2,16,17,9,9,24.1
2,0,6,5,1,7,3,6,6,"25",0,2,13,6,0,0,1037918,"2023-12-15T00:00:00.000Z",4,FALSE,19,18677986,"F",19,19,"New Orleans Pelicans","Trey Murphy III",0,19,21,15,8,23.2
0,0,0,0,0,0,0,0,0,"15",0,1,0,0,1,0,1037918,"2023-12-15T00:00:00.000Z",4,FALSE,19,38017677,"G",19,19,"New Orleans Pelicans","Dyson Daniels",1,0,0,0,0,3
0,0,0,1,0,1,0,0,0,"04",0,0,0,0,0,0,1037918,"2023-12-15T00:00:00.000Z",4,FALSE,19,56677837,"G",19,19,"New Orleans Pelicans","Jordan Hawkins",0,0,0,0,0,0
0,0,0,0,0,0,0,0,0,"00",0,0,0,0,0,0,1037918,"2023-12-15T00:00:00.000Z",4,FALSE,19,17896021,"F",19,19,"New Orleans Pelicans","Jeremiah Robinson-Earl",0,0,0,0,0,0
0,0,0,0,0,0,0,0,0,"00",0,0,0,0,0,0,1037918,"2023-12-15T00:00:00.000Z",4,FALSE,19,491,"C",19,19,"New Orleans Pelicans","Cody Zeller",0,0,0,0,0,0
0,0,0,0,0,0,0,0,0,"00",0,0,0,0,0,0,1037918,"2023-12-15T00:00:00.000Z",4,FALSE,19,3547260,"G",19,19,"New Orleans Pelicans","Kira Lewis Jr.",0,0,0,0,0,0
4,0,3,1,0,4,2,0,0,"22",2,0,4,5,2,0,1037919,"2023-12-15T00:00:00.000Z",23,FALSE,9,33,"F-G",23,23,"Philadelphia 76ers","Nicolas Batum",2,9,13,8,9,22
2,1,5,3,1,8,4,4,4,"23",2,3,13,7,3,2,1037919,"2023-12-15T00:00:00.000Z",23,FALSE,9,200,"F",23,23,"Philadelphia 76ers","Tobias Harris",4,20,22,15,9,34.4
2,4,13,3,2,19,9,16,15,"29",0,2,35,13,2,4,1037919,"2023-12-15T00:00:00.000Z",23,FALSE,9,145,"F-C",23,23,"Philadelphia 76ers","Joel Embiid",6,48,50,37,15,67.6
1,1,1,3,0,6,1,2,2,"23",2,4,4,3,1,0,1037919,"2023-12-15T00:00:00.000Z",23,FALSE,9,313,"G",23,23,"Philadelphia 76ers","De'Anthony Melton",2,7,8,5,4,15.1
4,0,1,6,1,16,7,5,4,"27",0,1,19,1,2,1,1037919,"2023-12-15T00:00:00.000Z",23,FALSE,9,3547254,"G",23,23,"Philadelphia 76ers","Tyrese Maxey",2,20,24,23,5,31.2
0,1,3,1,1,2,1,0,0,"09",1,2,3,4,0,0,1037919,"2023-12-15T00:00:00.000Z",23,FALSE,9,28,"C",23,23,"Philadelphia 76ers","Mo Bamba",1,7,7,3,4,10.8
0,0,0,0,0,1,0,2,1,"12",0,0,1,0,3,0,1037919,"2023-12-15T00:00:00.000Z",23,FALSE,9,45,"G",23,23,"Philadelphia 76ers","Patrick Beverley",3,1,1,1,0,10
0,0,2,1,0,2,0,0,0,"13",1,0,0,3,1,1,1037919,"2023-12-15T00:00:00.000Z",23,FALSE,9,108,"F",23,23,"Philadelphia 76ers","Robert Covington",1,3,3,0,3,5.6
2,0,1,3,1,5,1,0,0,"12",3,2,3,4,0,0,1037919,"2023-12-15T00:00:00.000Z",23,FALSE,9,2175,"",23,23,"Philadelphia 76ers","Danuel House Jr.",0,7,9,5,6,10.8
1,0,2,5,1,11,4,2,2,"17",1,3,11,3,0,0,1037919,"2023-12-15T00:00:00.000Z",23,FALSE,9,360,"F",23,23,"Philadelphia 76ers","Kelly Oubre Jr.",0,14,15,12,4,16.1
2,0,3,0,0,1,0,0,0,"12",2,1,0,5,0,2,1037919,"2023-12-15T00:00:00.000Z",23,FALSE,9,3547270,"F",23,23,"Philadelphia 76ers","Paul Reed",0,5,7,2,7,7
3,1,1,3,1,9,4,0,0,"12",1,3,9,2,2,0,1037919,"2023-12-15T00:00:00.000Z",23,FALSE,9,17896025,"G",23,23,"Philadelphia 76ers","Jaden Springer",3,11,14,12,5,24.9
0,0,0,0,0,0,0,0,0,"00",0,0,0,0,0,0,1037919,"2023-12-15T00:00:00.000Z",23,FALSE,9,56913527,"G",23,23,"Philadelphia 76ers","Ricky Council IV",0,0,0,0,0,0
0,0,0,0,0,0,0,0,0,"00",0,0,0,0,0,0,1037919,"2023-12-15T00:00:00.000Z",23,FALSE,9,17554001,"G",23,23,"Philadelphia 76ers","Javonte Smart",0,0,0,0,0,0
0,0,0,0,0,0,0,0,0,"00",0,0,0,0,0,0,1037919,"2023-12-15T00:00:00.000Z",23,FALSE,9,56677788,"G",23,23,"Philadelphia 76ers","Terquavion Smith",0,0,0,0,0,0
1,1,3,0,0,5,3,2,2,"22",0,2,8,3,0,1,1037919,"2023-12-15T00:00:00.000Z",23,FALSE,9,56677826,"G-F",9,9,"Detroit Pistons","Ausar Thompson",1,11,12,9,4,15.1
2,0,2,5,2,12,6,4,3,"26",1,1,17,3,0,3,1037919,"2023-12-15T00:00:00.000Z",23,FALSE,9,54,"F",9,9,"Detroit Pistons","Bojan Bogdanovic",0,20,22,19,5,20.6
0,1,3,1,0,6,2,0,0,"20",1,4,4,4,0,2,1037919,"2023-12-15T00:00:00.000Z",23,FALSE,9,3547267,"F-C",9,9,"Detroit Pistons","Isaiah Stewart",1,8,8,4,4,9.8
2,1,3,1,0,6,1,4,3,"21",1,3,5,4,0,3,1037919,"2023-12-15T00:00:00.000Z",23,FALSE,9,3547241,"G",9,9,"Detroit Pistons","Killian Hayes",1,9,11,7,6,12.8
2,1,3,2,0,9,2,0,0,"24",0,3,4,3,1,3,1037919,"2023-12-15T00:00:00.000Z",23,FALSE,9,17896075,"G-F",9,9,"Detroit Pistons","Cade Cunningham",2,7,9,6,5,13.6
0,0,0,0,0,0,0,0,0,"00",0,0,0,0,0,0,1037919,"2023-12-15T00:00:00.000Z",23,FALSE,9,24,"F",9,9,"Detroit Pistons","Marvin Bagley III",0,0,0,0,0,0
0,0,2,4,0,8,2,0,0,"17",0,1,4,2,0,0,1037919,"2023-12-15T00:00:00.000Z",23,FALSE,9,77,"G",9,9,"Detroit Pistons","Alec Burks",0,6,6,4,2,6.4
1,0,1,3,1,3,1,0,0,"11",0,1,3,1,0,0,1037919,"2023-12-15T00:00:00.000Z",23,FALSE,9,197,"F-G",9,9,"Detroit Pistons","Joe Harris",0,4,5,4,2,5.7
4,0,3,2,0,12,4,5,5,"29",1,3,13,4,0,5,1037919,"2023-12-15T00:00:00.000Z",23,FALSE,9,38017682,"G",9,9,"Detroit Pistons","Jaden Ivey",0,17,21,17,8,18.8
0,0,0,0,0,0,0,0,0,"00",0,0,0,0,0,0,1037919,"2023-12-15T00:00:00.000Z",23,FALSE,9,259,"F",9,9,"Detroit Pistons","Kevin Knox",0,0,0,0,0,0
2,1,3,2,0,4,1,2,1,"25",0,4,3,3,1,0,1037919,"2023-12-15T00:00:00.000Z",23,FALSE,9,17896071,"F",9,9,"Detroit Pistons","Isaiah Livers",2,6,8,5,5,15.6
1,0,1,3,1,3,1,0,0,"07",0,1,3,1,0,0,1037919,"2023-12-15T00:00:00.000Z",23,FALSE,9,260,"G-F",23,23,"Philadelphia 76ers","Furkan Korkmaz",0,4,5,4,2,5.7
1,0,0,0,0,3,2,0,0,"07",1,0,4,1,0,0,1037919,"2023-12-15T00:00:00.000Z",23,FALSE,9,3547294,"F",23,23,"Philadelphia 76ers","Kenyon Martin Jr.",0,5,6,5,2,6.7
1,0,2,5,5,8,5,0,0,"15",0,1,15,2,1,1,1037919,"2023-12-15T00:00:00.000Z",23,FALSE,9,328,"F",23,23,"Philadelphia 76ers","Marcus Morris",1,17,18,16,3,20.9
4,1,2,1,1,4,4,4,2,"17",0,1,11,2,1,2,1037919,"2023-12-15T00:00:00.000Z",23,FALSE,9,56677792,"G",9,9,"Detroit Pistons","Marcus Sasser",2,13,17,15,6,23.4
1,1,10,0,0,12,9,2,2,"28",3,2,20,13,0,2,1037919,"2023-12-15T00:00:00.000Z",23,FALSE,9,3547240,"C",9,9,"Detroit Pistons","James Wiseman",1,33,34,21,14,38.1
0,0,0,0,0,0,0,0,0,"00",0,0,0,0,0,0,1037919,"2023-12-15T00:00:00.000Z",23,FALSE,9,56677729,"G",9,9,"Detroit Pistons","Malcolm Cazalon",0,0,0,0,0,0
0,0,0,0,0,0,0,0,0,"00",0,0,0,0,0,0,1037919,"2023-12-15T00:00:00.000Z",23,FALSE,9,38017694,"C",9,9,"Detroit Pistons","Jalen Duren",0,0,0,0,0,0
0,0,0,0,0,0,0,0,0,"00",0,0,0,0,0,0,1037919,"2023-12-15T00:00:00.000Z",23,FALSE,9,330,"G",9,9,"Detroit Pistons","Monte Morris",0,0,0,0,0,0
0,0,0,0,0,0,0,0,0,"00",0,0,0,0,0,0,1037919,"2023-12-15T00:00:00.000Z",23,FALSE,9,42097199,"G",9,9,"Detroit Pistons","Jared Rhoden",0,0,0,0,0,0
0,0,0,0,0,0,0,0,0,"00",0,0,0,0,0,0,1037919,"2023-12-15T00:00:00.000Z",23,FALSE,9,44477024,"G",9,9,"Detroit Pistons","Stanley Umude",0,0,0,0,0,0
4,0,5,0,0,9,2,2,2,"25",1,0,6,6,0,1,1037920,"2023-12-15T00:00:00.000Z",30,FALSE,12,3547242,"F",30,30,"Washington Wizards","Deni Avdija",0,12,16,10,10,18.2
4,0,5,9,4,23,11,8,5,"30",0,3,31,5,1,3,1037920,"2023-12-15T00:00:00.000Z",30,FALSE,12,265,"F",30,30,"Washington Wizards","Kyle Kuzma",1,36,40,35,9,43
4,3,5,0,0,6,3,4,3,"28",5,4,9,10,0,2,1037920,"2023-12-15T00:00:00.000Z",30,FALSE,12,666577,"F",30,30,"Washington Wizards","Daniel Gafford",3,19,23,13,14,34
8,0,4,4,3,18,12,4,3,"32",0,4,30,4,1,2,1037920,"2023-12-15T00:00:00.000Z",30,FALSE,12,666848,"G",30,30,"Washington Wizards","Jordan Poole",1,34,42,38,12,47.8
11,2,10,2,1,7,6,0,0,"29",0,2,13,10,2,2,1037920,"2023-12-15T00:00:00.000Z",30,FALSE,12,249,"G",30,30,"Washington Wizards","Tyus Jones",4,23,34,24,21,51.5
0,0,1,0,0,2,1,0,0,"03",0,0,2,1,0,1,1037920,"2023-12-15T00:00:00.000Z",30,FALSE,12,38017704,"F",30,30,"Washington Wizards","Patrick Baldwin Jr.",0,3,3,2,1,2.2
1,0,0,0,0,1,1,0,0,"03",0,0,2,0,0,1,1037920,"2023-12-15T00:00:00.000Z",30,FALSE,12,18677954,"G",30,30,"Washington Wizards","Jared Butler",0,2,3,3,1,2.5
0,1,4,3,2,9,6,3,3,"30",1,2,17,5,2,4,1037920,"2023-12-15T00:00:00.000Z",30,FALSE,12,56677844,"G",30,30,"Washington Wizards","Bilal Coulibaly",3,22,22,17,5,28
1,0,4,1,0,2,1,2,2,"10",1,0,4,5,0,0,1037920,"2023-12-15T00:00:00.000Z",30,FALSE,12,167,"F",30,30,"Washington Wizards","Danilo Gallinari",0,9,10,5,6,11.5
0,0,0,0,0,0,0,0,0,"03",0,0,0,0,0,0,1037920,"2023-12-15T00:00:00.000Z",30,FALSE,12,3547302,"F",30,30,"Washington Wizards","Anthony Gill",0,0,0,0,0,0
1,1,1,7,3,14,9,3,2,"28",0,2,23,1,1,1,1037920,"2023-12-15T00:00:00.000Z",30,FALSE,12,17896045,"F",30,30,"Washington Wizards","Corey Kispert",2,24,25,24,2,30.7
2,1,0,1,0,1,0,0,0,"19",0,1,0,0,0,0,1037920,"2023-12-15T00:00:00.000Z",30,FALSE,12,337,"F-C",30,30,"Washington Wizards","Mike Muscala",1,0,2,2,2,6
0,0,0,0,0,0,0,0,0,"00",0,0,0,0,0,0,1037920,"2023-12-15T00:00:00.000Z",30,FALSE,12,414,"G",30,30,"Washington Wizards","Landry Shamet",0,0,0,0,0,0
0,0,0,0,0,0,0,0,0,"00",0,0,0,0,0,0,1037920,"2023-12-15T00:00:00.000Z",30,FALSE,12,NA,NA,NA,30,"Washington Wizards","NA NA",0,0,0,0,0,0
0,0,0,0,0,0,0,0,0,"00",0,0,0,0,0,0,1037920,"2023-12-15T00:00:00.000Z",30,FALSE,12,38017687,"G",30,30,"Washington Wizards","Johnny Davis",0,0,0,0,0,0
0,0,0,0,0,0,0,0,0,"00",0,0,0,0,0,0,1037920,"2023-12-15T00:00:00.000Z",30,FALSE,12,17896106,"F",30,30,"Washington Wizards","Eugene Omoruyi",0,0,0,0,0,0
0,0,0,0,0,0,0,0,0,"00",0,0,0,0,0,0,1037920,"2023-12-15T00:00:00.000Z",30,FALSE,12,38017712,"G",30,30,"Washington Wizards","Ryan Rollins",0,0,0,0,0,0
0,0,0,0,0,0,0,0,0,"00",0,0,0,0,0,0,1037920,"2023-12-15T00:00:00.000Z",30,FALSE,12,487,"G",30,30,"Washington Wizards","Delon Wright",0,0,0,0,0,0
3,3,3,11,3,14,4,0,0,"27",0,1,11,3,2,2,1037920,"2023-12-15T00:00:00.000Z",30,FALSE,12,210,"G",12,12,"Indiana Pacers","Buddy Hield",5,14,17,14,6,32.1
2,0,4,3,2,8,6,3,2,"26",1,2,16,5,0,1,1037920,"2023-12-15T00:00:00.000Z",30,FALSE,12,3547243,"F",12,12,"Indiana Pacers","Obi Toppin",0,21,23,18,7,24
1,3,2,4,1,10,2,2,1,"20",2,1,6,4,0,1,1037920,"2023-12-15T00:00:00.000Z",30,FALSE,12,452,"C-F",12,12,"Indiana Pacers","Myles Turner",3,10,11,7,5,20.3
1,0,2,2,0,7,2,0,0,"23",0,4,4,2,1,1,1037920,"2023-12-15T00:00:00.000Z",30,FALSE,12,69,"G",12,12,"Indiana Pacers","Bruce Brown",1,6,7,5,3,9.9
11,0,1,6,2,17,7,3,3,"28",1,2,19,2,0,4,1037920,"2023-12-15T00:00:00.000Z",30,FALSE,12,3547245,"G",12,12,"Indiana Pacers","Tyrese Haliburton",0,21,32,30,13,33.9
1,1,7,0,0,13,10,0,0,"20",6,5,20,13,0,1,1037920,"2023-12-15T00:00:00.000Z",30,FALSE,12,17896035,"F",12,12,"Indiana Pacers","Isaiah Jackson",1,33,34,21,14,39.1
2,0,2,1,1,9,4,4,4,"22",1,2,13,3,1,2,1037920,"2023-12-15T00:00:00.000Z",30,FALSE,12,38017686,"G-F",12,12,"Indiana Pacers","Bennedict Mathurin",1,16,18,15,5,20.6
1,1,1,8,3,10,4,3,1,"24",2,5,12,3,2,0,1037920,"2023-12-15T00:00:00.000Z",30,FALSE,12,3547250,"G-F",12,12,"Indiana Pacers","Aaron Nesmith",3,15,16,13,4,26.1
0,0,0,0,0,0,0,0,0,"00",0,0,0,0,0,0,1037920,"2023-12-15T00:00:00.000Z",30,FALSE,12,56677794,"G",12,12,"Indiana Pacers","Isaiah Wong",0,0,0,0,0,0
9,0,3,0,0,10,4,1,1,"20",0,0,9,3,1,2,1037920,"2023-12-15T00:00:00.000Z",30,FALSE,12,304,"G",12,12,"Indiana Pacers","T.J. McConnell",1,12,21,18,12,27.1
3,0,0,1,0,1,0,0,0,"09",0,2,0,0,0,0,1037920,"2023-12-15T00:00:00.000Z",30,FALSE,12,56677861,"G",12,12,"Indiana Pacers","Ben Sheppard",0,0,3,3,3,4.5
0,0,0,0,0,0,0,0,0,"00",0,0,0,0,0,0,1037920,"2023-12-15T00:00:00.000Z",30,FALSE,12,242,"F",12,12,"Indiana Pacers","James Johnson",0,0,0,0,0,0
0,0,1,2,2,3,2,0,0,"04",0,0,6,1,0,1,1037920,"2023-12-15T00:00:00.000Z",30,FALSE,12,3547207,"F",12,12,"Indiana Pacers","Jordan Nwora",0,7,7,6,1,6.2
1,0,0,0,0,1,1,0,0,"04",0,0,2,0,0,0,1037920,"2023-12-15T00:00:00.000Z",30,FALSE,12,56677778,"F-C",12,12,"Indiana Pacers","Oscar Tshiebwe",0,2,3,3,1,3.5
0,0,2,2,1,4,2,0,0,"13",0,1,5,2,0,0,1037920,"2023-12-15T00:00:00.000Z",30,FALSE,12,56677832,"F",12,12,"Indiana Pacers","Jarace Walker",0,7,7,5,2,7.4
0,0,0,0,0,0,0,0,0,"00",0,0,0,0,0,0,1037920,"2023-12-15T00:00:00.000Z",30,FALSE,12,38017701,"G",12,12,"Indiana Pacers","Kendall Brown",0,0,0,0,0,0
0,0,0,0,0,0,0,0,0,"00",0,0,0,0,0,0,1037920,"2023-12-15T00:00:00.000Z",30,FALSE,12,38017507,"G-F",12,12,"Indiana Pacers","Andrew Nembhard",0,0,0,0,0,0
0,0,0,0,0,0,0,0,0,"00",0,0,0,0,0,0,1037920,"2023-12-15T00:00:00.000Z",30,FALSE,12,3547264,"F-C",12,12,"Indiana Pacers","Jalen Smith",0,0,0,0,0,0
4,1,3,5,0,15,8,3,2,"30",0,0,18,3,0,2,1037921,"2023-12-15T00:00:00.000Z",2,FALSE,22,70,"G",2,2,"Boston Celtics","Jaylen Brown",1,21,25,22,7,28.6
4,0,6,9,2,22,11,9,6,"39",0,3,30,6,0,2,1037921,"2023-12-15T00:00:00.000Z",2,FALSE,22,434,"F",2,2,"Boston Celtics","Jayson Tatum",0,36,40,34,10,41.2
0,1,2,3,1,7,3,2,1,"14",1,2,8,3,2,1,1037921,"2023-12-15T00:00:00.000Z",2,FALSE,22,3547279,"F",2,2,"Boston Celtics","Lamar Stevens",3,11,11,8,3,19.6
8,1,3,7,3,15,7,2,2,"30",1,0,19,4,4,1,1037921,"2023-12-15T00:00:00.000Z",2,FALSE,22,473,"G",2,2,"Boston Celtics","Derrick White",5,23,31,27,12,49.8
4,1,3,3,2,7,2,0,0,"28",1,2,6,4,2,0,1037921,"2023-12-15T00:00:00.000Z",2,FALSE,22,214,"G",2,2,"Boston Celtics","Jrue Holiday",3,10,14,10,8,25.8
1,0,0,1,1,4,4,2,2,"16",1,4,11,1,0,2,1037921,"2023-12-15T00:00:00.000Z",2,FALSE,22,666468,"F",2,2,"Boston Celtics","Oshae Brissett",0,12,13,12,2,11.7
4,0,5,6,3,8,4,0,0,"32",2,1,11,7,4,1,1037921,"2023-12-15T00:00:00.000Z",2,FALSE,22,17896060,"F",2,2,"Boston Celtics","Sam Hauser",4,18,22,15,11,36.4
5,0,5,4,1,14,6,4,4,"34",0,4,17,5,2,6,1037921,"2023-12-15T00:00:00.000Z",2,FALSE,22,17896026,"F",22,22,"Orlando Magic","Franz Wagner",2,22,27,22,10,30.5
5,1,3,4,1,17,5,6,3,"32",1,1,14,4,0,5,1037921,"2023-12-15T00:00:00.000Z",2,FALSE,22,38017683,"F",22,22,"Orlando Magic","Paolo Banchero",1,18,23,19,9,24.3
1,0,6,0,0,8,7,2,1,"27",5,2,15,11,0,4,1037921,"2023-12-15T00:00:00.000Z",2,FALSE,22,666442,"C",22,22,"Orlando Magic","Goga Bitadze",0,26,27,16,12,25.7
4,0,6,5,3,8,5,0,0,"29",3,2,13,9,0,0,1037921,"2023-12-15T00:00:00.000Z",2,FALSE,22,56677827,"G",22,22,"Orlando Magic","Anthony Black",0,22,26,17,13,29.8
1,1,4,9,5,12,7,0,0,"26",0,2,19,4,0,1,1037921,"2023-12-15T00:00:00.000Z",2,FALSE,22,17896073,"G",22,22,"Orlando Magic","Jalen Suggs",1,23,24,20,5,27.3
2,0,1,0,0,1,0,0,0,"06",1,0,0,2,0,0,1037921,"2023-12-15T00:00:00.000Z",2,FALSE,22,226,"F",22,22,"Orlando Magic","Joe Ingles",0,2,4,2,4,5.4
0,0,0,1,0,1,0,0,0,"05",0,0,0,0,0,0,1037921,"2023-12-15T00:00:00.000Z",2,FALSE,22,338,"G",2,2,"Boston Celtics","Svi Mykhailiuk",0,0,0,0,0,0
0,0,0,0,0,0,0,0,0,"00",0,0,0,0,0,0,1037921,"2023-12-15T00:00:00.000Z",2,FALSE,22,378,"F-C",2,2,"Boston Celtics","Kristaps Porzingis",0,0,0,0,0,0
5,0,2,7,6,10,7,2,1,"28",1,4,21,3,1,0,1037921,"2023-12-15T00:00:00.000Z",2,FALSE,22,3547276,"G",2,2,"Boston Celtics","Payton Pritchard",1,24,29,26,8,35.1
1,3,1,0,0,3,2,0,0,"18",2,6,4,3,1,1,1037921,"2023-12-15T00:00:00.000Z",2,FALSE,22,17553967,"C",2,2,"Boston Celtics","Neemias Queta",4,7,8,5,4,20.1
0,0,0,0,0,0,0,0,0,"00",0,0,0,0,0,0,1037921,"2023-12-15T00:00:00.000Z",2,FALSE,22,17896094,"G",2,2,"Boston Celtics","Dalano Banton",0,0,0,0,0,0
0,0,0,0,0,0,0,0,0,"00",0,0,0,0,0,0,1037921,"2023-12-15T00:00:00.000Z",2,FALSE,22,38017707,"G",2,2,"Boston Celtics","JD Davison",0,0,0,0,0,0
0,0,0,0,0,0,0,0,0,"00",0,0,0,0,0,0,1037921,"2023-12-15T00:00:00.000Z",2,FALSE,22,219,"C-F",2,2,"Boston Celtics","Al Horford",0,0,0,0,0,0
0,0,0,0,0,0,0,0,0,"00",0,0,0,0,0,0,1037921,"2023-12-15T00:00:00.000Z",2,FALSE,22,261,"F-C",2,2,"Boston Celtics","Luke Kornet",0,0,0,0,0,0
0,0,0,0,0,0,0,0,0,"00",0,0,0,0,0,0,1037921,"2023-12-15T00:00:00.000Z",2,FALSE,22,NA,NA,NA,2,"Boston Celtics","NA NA",0,0,0,0,0,0
0,0,0,0,0,0,0,0,0,"00",0,0,0,0,0,0,1037921,"2023-12-15T00:00:00.000Z",2,FALSE,22,17553983,"G",22,22,"Orlando Magic","Trevelin Queen",0,0,0,0,0,0
0,0,3,2,1,5,3,0,0,"16",1,1,7,4,0,0,1037921,"2023-12-15T00:00:00.000Z",2,FALSE,22,229,"F",22,22,"Orlando Magic","Jonathan Isaac",0,11,11,7,4,11.8
1,0,1,4,1,5,2,0,0,"11",1,0,5,2,0,0,1037921,"2023-12-15T00:00:00.000Z",2,FALSE,22,38017724,"G",22,22,"Orlando Magic","Caleb Houstan",0,7,8,6,3,8.9
0,0,1,1,0,1,0,0,0,"03",0,0,0,1,0,0,1037921,"2023-12-15T00:00:00.000Z",2,FALSE,22,56677839,"G",22,22,"Orlando Magic","Jett Howard",0,1,1,0,1,1.2
0,0,0,0,0,1,0,0,0,"04",0,0,0,0,0,0,1037921,"2023-12-15T00:00:00.000Z",2,FALSE,22,666818,"F",22,22,"Orlando Magic","Chuma Okeke",0,0,0,0,0,0
0,0,2,0,0,1,0,0,0,"03",0,1,0,2,0,1,1037921,"2023-12-15T00:00:00.000Z",2,FALSE,22,666885,"F",22,22,"Orlando Magic","Admiral Schofield",0,2,2,0,2,1.4
0,0,0,0,0,0,0,0,0,"00",0,0,0,0,0,0,1037921,"2023-12-15T00:00:00.000Z",2,FALSE,22,56677864,"G",2,2,"Boston Celtics","Jordan Walsh",0,0,0,0,0,0
0,0,0,2,0,3,1,0,0,"16",0,3,2,0,2,0,1037921,"2023-12-15T00:00:00.000Z",2,FALSE,22,196,"G",22,22,"Orlando Magic","Gary Harris",2,2,2,2,0,8
4,0,0,3,2,8,5,6,5,"20",0,3,17,0,1,1,1037921,"2023-12-15T00:00:00.000Z",2,FALSE,22,3547251,"G",22,22,"Orlando Magic","Cole Anthony",1,17,21,21,4,25
2,0,0,1,0,3,1,0,0,"13",1,3,2,1,0,3,1037921,"2023-12-15T00:00:00.000Z",2,FALSE,22,462,"C",22,22,"Orlando Magic","Moritz Wagner",0,3,5,4,3,3.2
0,0,0,0,0,0,0,0,0,"00",0,0,0,0,0,0,1037921,"2023-12-15T00:00:00.000Z",2,FALSE,22,85,"F",22,22,"Orlando Magic","Wendell Carter Jr.",0,0,0,0,0,0
0,0,0,0,0,0,0,0,0,"00",0,0,0,0,0,0,1037921,"2023-12-15T00:00:00.000Z",2,FALSE,22,165,"G",22,22,"Orlando Magic","Markelle Fultz",0,0,0,0,0,0
0,0,0,0,0,0,0,0,0,"00",0,0,0,0,0,0,1037921,"2023-12-15T00:00:00.000Z",2,FALSE,22,38017607,"G",22,22,"Orlando Magic","Kevon Harris",0,0,0,0,0,0
8,2,3,5,1,15,9,8,4,"34",1,2,23,4,1,3,1037922,"2023-12-15T00:00:00.000Z",28,FALSE,1,17896055,"G-F",28,28,"Toronto Raptors","Scottie Barnes",3,27,35,31,12,45.8
4,0,5,3,2,11,5,4,3,"34",0,1,15,5,2,1,1037922,"2023-12-15T00:00:00.000Z",28,FALSE,1,416,"F",28,28,"Toronto Raptors","Pascal Siakam",2,20,24,19,9,32
0,1,6,0,0,7,7,2,1,"25",2,4,15,8,2,3,1037922,"2023-12-15T00:00:00.000Z",28,FALSE,1,373,"C",28,28,"Toronto Raptors","Jakob Poeltl",3,23,23,15,8,30.6
4,0,2,4,1,8,3,0,0,"33",0,0,7,2,0,2,1037922,"2023-12-15T00:00:00.000Z",28,FALSE,1,18,"F",28,28,"Toronto Raptors","OG Anunoby",0,9,13,11,6,13.4
4,0,2,2,0,7,3,0,0,"31",0,5,6,2,2,1,1037922,"2023-12-15T00:00:00.000Z",28,FALSE,1,409,"G",28,28,"Toronto Raptors","Dennis Schroder",2,8,12,10,6,19.4
5,0,2,2,0,7,4,2,1,"17",0,1,9,2,0,0,1037922,"2023-12-15T00:00:00.000Z",28,FALSE,1,3547249,"F",28,28,"Toronto Raptors","Precious Achiuwa",0,11,16,14,7,18.9
0,2,3,3,1,4,2,5,2,"15",0,1,7,3,1,1,1037922,"2023-12-15T00:00:00.000Z",28,FALSE,1,58,"F",28,28,"Toronto Raptors","Chris Boucher",3,10,10,7,3,18.6
0,0,0,0,0,0,0,0,0,"00",0,0,0,0,0,0,1037922,"2023-12-15T00:00:00.000Z",28,FALSE,1,2309958,"C-F",15,28,"Toronto Raptors","Jontay Porter",0,0,0,0,0,0
4,0,7,8,2,12,4,0,0,"38",3,3,10,10,0,1,1037922,"2023-12-15T00:00:00.000Z",28,FALSE,1,3547256,"F",1,1,"Atlanta Hawks","Saddiq Bey",0,20,24,14,14,27
0,1,7,2,1,7,6,1,1,"33",4,3,14,11,0,1,1037922,"2023-12-15T00:00:00.000Z",28,FALSE,1,3547244,"F-C",1,1,"Atlanta Hawks","Onyeka Okongwu",1,25,25,14,11,29.2
0,3,9,0,0,12,9,0,0,"35",6,2,18,15,0,1,1037922,"2023-12-15T00:00:00.000Z",28,FALSE,1,83,"C",1,1,"Atlanta Hawks","Clint Capela",3,33,33,18,15,44
9,0,6,6,1,18,8,0,0,"33",1,3,17,7,1,1,1037922,"2023-12-15T00:00:00.000Z",28,FALSE,1,334,"G",1,1,"Atlanta Hawks","Dejounte Murray",1,24,33,26,16,40.9
11,0,4,15,7,29,15,2,1,"36",1,2,38,5,1,8,1037922,"2023-12-15T00:00:00.000Z",28,FALSE,1,490,"G",1,1,"Atlanta Hawks","Trae Young",1,43,54,49,16,55.5
6,0,3,7,3,16,7,3,3,"33",0,2,20,3,0,0,1037922,"2023-12-15T00:00:00.000Z",28,FALSE,1,53,"G",1,1,"Atlanta Hawks","Bogdan Bogdanovic",0,23,29,26,9,32.6
0,0,0,0,0,0,0,0,0,"01",0,0,0,0,0,0,1037922,"2023-12-15T00:00:00.000Z",28,FALSE,1,666564,"F",1,1,"Atlanta Hawks","Bruno Fernando",0,0,0,0,0,0
4,0,2,1,0,4,0,0,0,"11",1,1,0,3,1,0,1037922,"2023-12-15T00:00:00.000Z",28,FALSE,1,3547297,"G",1,1,"Atlanta Hawks","Trent Forrest",1,3,7,4,7,12.6
0,0,0,0,0,1,1,0,0,"01",0,1,2,0,0,0,1037922,"2023-12-15T00:00:00.000Z",28,FALSE,1,56677855,"G",1,1,"Atlanta Hawks","Seth Lundy",0,2,2,2,0,2
0,0,1,2,2,2,2,0,0,"18",0,2,6,1,1,0,1037922,"2023-12-15T00:00:00.000Z",28,FALSE,1,666754,"G",1,1,"Atlanta Hawks","Garrison Mathews",1,7,7,6,1,10.2
0,0,0,3,1,3,1,0,0,"03",0,0,3,0,0,0,1037922,"2023-12-15T00:00:00.000Z",28,FALSE,1,56677828,"G",28,28,"Toronto Raptors","Gradey Dick",0,3,3,3,0,3
1,1,4,2,2,4,3,4,3,"19",0,4,11,4,0,2,1037922,"2023-12-15T00:00:00.000Z",28,FALSE,1,3547275,"G",28,28,"Toronto Raptors","Malachi Flynn",1,15,16,12,5,18.3
0,0,0,2,0,3,0,0,0,"03",0,0,0,0,0,0,1037922,"2023-12-15T00:00:00.000Z",28,FALSE,1,666762,"F",28,28,"Toronto Raptors","Jalen McDaniels",0,0,0,0,0,0
0,0,0,0,0,0,0,0,0,"00",0,0,0,0,0,0,1037922,"2023-12-15T00:00:00.000Z",28,FALSE,1,376,"F",28,28,"Toronto Raptors","Otto Porter Jr.",0,0,0,0,0,0
1,0,0,0,0,0,0,0,0,"03",0,0,0,0,0,0,1037922,"2023-12-15T00:00:00.000Z",28,FALSE,1,436,"G-F",28,28,"Toronto Raptors","Garrett Temple",0,0,1,1,1,1.5
3,0,2,5,2,8,3,0,0,"20",0,1,8,2,0,1,1037922,"2023-12-15T00:00:00.000Z",28,FALSE,1,3089,"",28,28,"Toronto Raptors","Gary Trent Jr.",0,10,13,11,5,13.9
0,0,0,0,0,0,0,0,0,"03",0,0,0,0,0,0,1037922,"2023-12-15T00:00:00.000Z",28,FALSE,1,489,"F",28,28,"Toronto Raptors","Thaddeus Young",0,0,0,0,0,0
0,0,0,0,0,0,0,0,0,"00",0,0,0,0,0,0,1037922,"2023-12-15T00:00:00.000Z",28,FALSE,1,56677805,"G",28,28,"Toronto Raptors","Javon Freeman-Liberty",0,0,0,0,0,0
0,0,0,0,0,0,0,0,0,"00",0,0,0,0,0,0,1037922,"2023-12-15T00:00:00.000Z",28,FALSE,1,38017710,"C",28,28,"Toronto Raptors","Christian Koloko",0,0,0,0,0,0
0,0,0,0,0,0,0,0,0,"00",0,0,0,0,0,0,1037922,"2023-12-15T00:00:00.000Z",28,FALSE,1,666656,"F",1,1,"Atlanta Hawks","De'Andre Hunter",0,0,0,0,0,0
0,0,0,0,0,0,0,0,0,"00",0,0,0,0,0,0,1037922,"2023-12-15T00:00:00.000Z",28,FALSE,1,17896040,"F",1,1,"Atlanta Hawks","Jalen Johnson",0,0,0,0,0,0
0,0,0,0,0,0,0,0,0,"00",0,0,0,0,0,0,1037922,"2023-12-15T00:00:00.000Z",28,FALSE,1,56677875,"F",1,1,"Atlanta Hawks","Miles Norris",0,0,0,0,0,0
0,0,0,0,0,0,0,0,0,"00",0,0,0,0,0,0,1037922,"2023-12-15T00:00:00.000Z",28,FALSE,1,56677806,"F",1,1,"Atlanta Hawks","Mouhamed Gueye",0,0,0,0,0,0
0,0,0,0,0,0,0,0,0,"00",0,0,0,0,0,0,1037922,"2023-12-15T00:00:00.000Z",28,FALSE,1,56677869,"G",28,28,"Toronto Raptors","Markquis Nowell",0,0,0,0,0,0
0,0,0,0,0,0,0,0,0,"00",0,0,0,0,0,0,1037922,"2023-12-15T00:00:00.000Z",28,FALSE,1,301,"G-F",1,1,"Atlanta Hawks","Wesley Matthews",0,0,0,0,0,0
0,0,0,0,0,0,0,0,0,"01",0,0,0,0,0,0,1037922,"2023-12-15T00:00:00.000Z",28,FALSE,1,319,"G",1,1,"Atlanta Hawks","Patty Mills",0,0,0,0,0,0
0,0,0,0,0,0,0,0,0,"00",0,0,0,0,0,0,1037922,"2023-12-15T00:00:00.000Z",28,FALSE,1,56677838,"G",1,1,"Atlanta Hawks","Kobe Bufkin",0,0,0,0,0,0
0,0,0,0,0,0,0,0,0,"00",0,0,0,0,0,0,1037922,"2023-12-15T00:00:00.000Z",28,FALSE,1,38017689,"F",1,1,"Atlanta Hawks","AJ Griffin",0,0,0,0,0,0
6,0,2,6,3,11,6,0,0,"25",0,2,15,2,0,0,1037923,"2023-12-15T00:00:00.000Z",27,FALSE,14,359,"F",27,27,"San Antonio Spurs","Cedi Osman",0,17,23,21,8,26.4
3,1,6,10,5,19,12,7,7,"35",0,1,36,6,1,1,1037923,"2023-12-15T00:00:00.000Z",27,FALSE,14,3547246,"G-F",27,27,"San Antonio Spurs","Devin Vassell",2,42,45,39,9,52.7
6,0,1,8,3,16,6,2,2,"31",1,1,17,2,0,2,1037923,"2023-12-15T00:00:00.000Z",27,FALSE,14,666682,"F",27,27,"San Antonio Spurs","Keldon Johnson",0,19,25,23,8,26.4
5,2,12,2,1,13,5,3,2,"31",3,3,13,15,2,2,1037923,"2023-12-15T00:00:00.000Z",27,FALSE,14,56677822,"F-C",27,27,"San Antonio Spurs","Victor Wembanyama",4,28,33,18,20,48.5
8,1,4,3,2,8,5,0,0,"32",0,3,12,4,1,0,1037923,"2023-12-15T00:00:00.000Z",27,FALSE,14,38017692,"F",27,27,"San Antonio Spurs","Malaki Branham",2,16,24,20,12,34.8
2,1,7,3,0,10,5,1,1,"27",1,3,11,8,1,1,1037923,"2023-12-15T00:00:00.000Z",27,FALSE,14,38017699,"F",27,27,"San Antonio Spurs","Jeremy Sochan",2,19,21,13,10,28.6
0,0,0,2,0,2,0,0,0,"09",0,1,0,0,0,0,1037923,"2023-12-15T00:00:00.000Z",27,FALSE,14,38017649,"F",27,27,"San Antonio Spurs","Julian Champagnie",0,0,0,0,0,0
1,0,2,2,1,9,5,6,5,"19",4,4,16,6,0,1,1037923,"2023-12-15T00:00:00.000Z",27,FALSE,14,102,"F-C",27,27,"San Antonio Spurs","Zach Collins",0,22,23,17,7,23.7
3,0,1,1,0,2,0,0,0,"10",0,0,0,1,0,0,1037923,"2023-12-15T00:00:00.000Z",27,FALSE,14,180,"G",27,27,"San Antonio Spurs","Devonte' Graham",0,1,4,3,4,5.7
0,0,0,0,0,0,0,0,0,"00",0,0,0,0,0,0,1037923,"2023-12-15T00:00:00.000Z",27,FALSE,14,3547274,"G",27,27,"San Antonio Spurs","Tre Jones",0,0,0,0,0,0
0,0,0,0,0,0,0,0,0,"00",0,0,0,0,0,0,1037923,"2023-12-15T00:00:00.000Z",27,FALSE,14,56677817,"G",27,27,"San Antonio Spurs","Sidy Cissoko",0,0,0,0,0,0
0,0,0,0,0,0,0,0,0,"00",0,0,0,0,0,0,1037923,"2023-12-15T00:00:00.000Z",27,FALSE,14,17896049,"G",3,27,"San Antonio Spurs","David Duke Jr.",0,0,0,0,0,0
1,1,3,6,2,10,5,0,0,"36",0,2,12,3,1,1,1037923,"2023-12-15T00:00:00.000Z",27,FALSE,14,383,"F",14,14,"Los Angeles Lakers","Taurean Prince",2,15,16,13,4,22.1
14,0,5,6,2,17,7,10,7,"36",2,1,23,7,2,2,1037923,"2023-12-15T00:00:00.000Z",27,FALSE,14,237,"F",14,14,"Los Angeles Lakers","LeBron James",2,30,44,37,21,56.4
0,1,4,0,0,4,3,3,2,"20",3,5,8,7,1,0,1037923,"2023-12-15T00:00:00.000Z",27,FALSE,14,666626,"C",14,14,"Los Angeles Lakers","Jaxson Hayes",2,15,15,8,7,22.4
4,0,5,10,4,18,8,2,2,"34",2,0,22,7,0,2,1037923,"2023-12-15T00:00:00.000Z",27,FALSE,14,17553995,"G",14,14,"Los Angeles Lakers","Austin Reaves",0,29,33,26,11,34.4
1,0,0,1,0,6,1,0,0,"23",0,1,2,0,0,1,1037923,"2023-12-15T00:00:00.000Z",27,FALSE,14,38017697,"G",14,14,"Los Angeles Lakers","Max Christie",0,2,3,3,1,2.5
1,0,1,0,0,3,3,0,0,"06",0,0,6,1,0,0,1037923,"2023-12-15T00:00:00.000Z",27,FALSE,14,56677738,"C",14,14,"Los Angeles Lakers","Colin Castleton",0,7,8,7,2,8.7
0,0,0,0,0,0,0,0,0,"00",0,0,0,0,0,0,1037923,"2023-12-15T00:00:00.000Z",27,FALSE,14,117,"F-C",14,14,"Los Angeles Lakers","Anthony Davis",0,0,0,0,0,0
4,1,5,5,0,15,8,5,4,"34",0,1,20,5,0,0,1037923,"2023-12-15T00:00:00.000Z",27,FALSE,14,666609,"F",14,14,"Los Angeles Lakers","Rui Hachimura",1,25,29,24,9,35
3,0,0,2,1,3,2,0,0,"08",0,0,5,0,0,0,1037923,"2023-12-15T00:00:00.000Z",27,FALSE,14,56677868,"G",14,14,"Los Angeles Lakers","D'Moi Hodge",0,5,8,8,3,9.5
1,0,5,1,0,3,0,0,0,"13",0,4,0,5,0,0,1037923,"2023-12-15T00:00:00.000Z",27,FALSE,14,457,"F",14,14,"Los Angeles Lakers","Jarred Vanderbilt",0,5,6,1,6,7.5
3,2,6,5,2,10,6,8,3,"30",2,1,17,8,1,0,1037923,"2023-12-15T00:00:00.000Z",27,FALSE,14,486,"F",14,14,"Los Angeles Lakers","Christian Wood",3,25,28,20,11,40.1
0,0,0,1,1,1,1,0,0,"02",0,0,3,0,0,0,1037923,"2023-12-15T00:00:00.000Z",27,FALSE,14,17896059,"F",27,27,"San Antonio Spurs","Sandro Mamukelashvili",0,3,3,3,0,3
0,0,1,4,2,4,2,0,0,"17",0,1,6,1,0,1,1037923,"2023-12-15T00:00:00.000Z",27,FALSE,14,305,"F",27,27,"San Antonio Spurs","Doug McDermott",0,7,7,6,1,6.2
1,0,0,0,0,0,0,0,0,"02",0,0,0,0,0,0,1037923,"2023-12-15T00:00:00.000Z",27,FALSE,14,38017693,"G",27,27,"San Antonio Spurs","Blake Wesley",0,0,1,1,1,1.5
0,0,0,0,0,0,0,0,0,"00",0,0,0,0,0,0,1037923,"2023-12-15T00:00:00.000Z",27,FALSE,14,38017730,"F",27,27,"San Antonio Spurs","Dominick Barlow",0,0,0,0,0,0
0,0,0,0,0,0,0,0,0,"00",0,0,0,0,0,0,1037923,"2023-12-15T00:00:00.000Z",27,FALSE,14,17895854,"G",27,27,"San Antonio Spurs","Charles Bassey",0,0,0,0,0,0
0,0,0,0,0,0,0,0,0,"00",0,0,0,0,0,0,1037923,"2023-12-15T00:00:00.000Z",27,FALSE,14,56677865,"C",27,27,"San Antonio Spurs","Charles Bediako",0,0,0,0,0,0
0,0,0,0,0,0,0,0,0,"00",0,0,0,0,0,0,1037923,"2023-12-15T00:00:00.000Z",27,FALSE,14,1603383,"G",14,14,"Los Angeles Lakers","Gabe Vincent",0,0,0,0,0,0
0,0,0,0,0,0,0,0,0,"00",0,0,0,0,0,0,1037923,"2023-12-15T00:00:00.000Z",27,FALSE,14,666860,"F-G",14,14,"Los Angeles Lakers","Cameron Reddish",0,0,0,0,0,0
0,0,0,0,0,0,0,0,0,"00",0,0,0,0,0,0,1037923,"2023-12-15T00:00:00.000Z",27,FALSE,14,405,"G",14,14,"Los Angeles Lakers","D'Angelo Russell",0,0,0,0,0,0
0,0,0,0,0,0,0,0,0,"00",0,0,0,0,0,0,1037923,"2023-12-15T00:00:00.000Z",27,FALSE,14,56677867,"F",14,14,"Los Angeles Lakers","Alex Fudge",0,0,0,0,0,0
0,0,0,0,0,0,0,0,0,"00",0,0,0,0,0,0,1037923,"2023-12-15T00:00:00.000Z",27,FALSE,14,56677835,"G",14,14,"Los Angeles Lakers","Jalen Hood-Schifino",0,0,0,0,0,0
0,0,0,0,0,0,0,0,0,"00",0,0,0,0,0,0,1037923,"2023-12-15T00:00:00.000Z",27,FALSE,14,56677836,"F",14,14,"Los Angeles Lakers","Maxwell Lewis",0,0,0,0,0,0
3,2,7,6,3,8,4,0,0,"30",1,2,11,8,1,3,1037924,"2023-12-15T00:00:00.000Z",15,FALSE,11,38017731,"G",15,15,"Memphis Grizzlies","Vince Williams Jr.",3,19,22,14,11,31.1
2,4,2,7,0,23,8,7,6,"33",1,5,22,3,0,1,1037924,"2023-12-15T00:00:00.000Z",15,FALSE,11,231,"F-C",15,15,"Memphis Grizzlies","Jaren Jackson Jr.",4,25,27,24,5,39.6
1,1,8,0,0,9,5,1,0,"33",1,2,10,9,0,2,1037924,"2023-12-15T00:00:00.000Z",15,FALSE,11,48,"C",15,15,"Memphis Grizzlies","Bismack Biyombo",1,19,20,11,10,23.3
3,0,7,12,4,25,11,3,2,"40",6,4,28,13,2,4,1037924,"2023-12-15T00:00:00.000Z",15,FALSE,11,3547287,"G",15,15,"Memphis Grizzlies","Desmond Bane",2,41,44,31,16,50.1
2,0,1,2,1,3,1,0,0,"09",0,0,3,1,0,0,1037924,"2023-12-15T00:00:00.000Z",15,FALSE,11,401,"G",15,15,"Memphis Grizzlies","Derrick Rose",0,4,6,5,3,7.2
0,0,2,4,2,8,4,2,1,"26",2,3,11,4,0,2,1037924,"2023-12-15T00:00:00.000Z",15,FALSE,11,17896067,"F",15,15,"Memphis Grizzlies","Santi Aldama",0,15,15,11,4,13.8
3,0,1,2,0,3,0,0,0,"16",0,1,0,1,1,2,1037924,"2023-12-15T00:00:00.000Z",15,FALSE,11,48248287,"G",15,15,"Memphis Grizzlies","Jacob Gilyard",1,1,4,3,4,6.7
2,1,9,4,1,9,1,2,2,"30",3,5,5,12,0,1,1037924,"2023-12-15T00:00:00.000Z",15,FALSE,11,38017684,"F",11,11,"Houston Rockets","Jabari Smith Jr.",1,17,19,7,14,24.4
1,3,3,0,0,12,4,7,7,"32",4,3,15,7,2,4,1037924,"2023-12-15T00:00:00.000Z",15,FALSE,11,17896062,"F-C",11,11,"Houston Rockets","Alperen Sengun",5,22,23,16,8,35.9
0,0,0,0,0,0,0,0,0,"00",0,0,0,0,0,0,1037924,"2023-12-15T00:00:00.000Z",15,FALSE,11,56677830,"F",15,15,"Memphis Grizzlies","GG Jackson",0,0,0,0,0,0
0,0,0,0,0,0,0,0,0,"00",0,0,0,0,0,0,1037924,"2023-12-15T00:00:00.000Z",15,FALSE,11,254,"G",15,15,"Memphis Grizzlies","Luke Kennard",0,0,0,0,0,0
0,0,0,0,0,0,0,0,0,"00",0,0,0,0,0,0,1037924,"2023-12-15T00:00:00.000Z",15,FALSE,11,666786,"G",15,15,"Memphis Grizzlies","Ja Morant",0,0,0,0,0,0
0,0,0,0,0,0,0,0,0,"00",0,0,0,0,0,0,1037924,"2023-12-15T00:00:00.000Z",15,FALSE,11,420,"G",15,15,"Memphis Grizzlies","Marcus Smart",0,0,0,0,0,0
1,0,6,9,3,20,10,4,3,"40",1,3,26,7,1,2,1037924,"2023-12-15T00:00:00.000Z",15,FALSE,11,66,"G-F",11,11,"Houston Rockets","Dillon Brooks",1,33,34,27,8,36.9
0,0,0,0,0,0,0,0,0,"00",0,0,0,0,0,0,1037924,"2023-12-15T00:00:00.000Z",15,FALSE,11,666703,"G-F",15,15,"Memphis Grizzlies","John Konchar",0,0,0,0,0,0
1,0,0,1,0,2,1,0,0,"10",0,4,2,0,0,1,1037924,"2023-12-15T00:00:00.000Z",15,FALSE,11,38017728,"F",15,15,"Memphis Grizzlies","Jake LaRavia",0,2,3,3,1,2.5
0,0,0,0,0,0,0,0,0,"00",0,0,0,0,0,0,1037924,"2023-12-15T00:00:00.000Z",15,FALSE,11,38017732,"F",15,15,"Memphis Grizzlies","Kenneth Lofton Jr.",0,0,0,0,0,0
2,1,4,6,1,10,3,2,2,"28",1,2,9,5,0,0,1037924,"2023-12-15T00:00:00.000Z",15,FALSE,11,38017729,"F",15,15,"Memphis Grizzlies","David Roddy",1,14,16,11,7,21
0,0,0,0,0,0,0,0,0,"00",0,0,0,0,0,0,1037924,"2023-12-15T00:00:00.000Z",15,FALSE,11,3547285,"F",15,15,"Memphis Grizzlies","Xavier Tillman",0,0,0,0,0,0
2,0,3,0,0,1,0,0,0,"15",1,1,0,4,0,2,1037924,"2023-12-15T00:00:00.000Z",15,FALSE,11,17896027,"G-F",15,15,"Memphis Grizzlies","Ziaire Williams",0,4,6,2,6,5.8
0,0,0,0,0,0,0,0,0,"00",0,0,0,0,0,0,1037924,"2023-12-15T00:00:00.000Z",15,FALSE,11,3,"C",15,15,"Memphis Grizzlies","Steven Adams",0,0,0,0,0,0
0,0,0,0,0,0,0,0,0,"00",0,0,0,0,0,0,1037924,"2023-12-15T00:00:00.000Z",15,FALSE,11,666505,"F",15,15,"Memphis Grizzlies","Brandon Clarke",0,0,0,0,0,0
4,1,3,7,3,12,4,4,3,"28",1,1,14,4,0,1,1037924,"2023-12-15T00:00:00.000Z",15,FALSE,11,17895966,"G",11,11,"Houston Rockets","Jalen Green",1,18,22,18,8,26.8
8,2,5,4,2,12,5,5,4,"36",1,2,16,6,4,0,1037924,"2023-12-15T00:00:00.000Z",15,FALSE,11,458,"G",11,11,"Houston Rockets","Fred VanVleet",6,22,30,24,14,53.2
0,0,0,0,0,1,0,0,0,"04",0,0,0,0,0,0,1037924,"2023-12-15T00:00:00.000Z",15,FALSE,11,75,"G-F",11,11,"Houston Rockets","Reggie Bullock",0,0,0,0,0,0
1,1,7,1,1,8,4,2,2,"23",1,2,11,8,2,2,1037924,"2023-12-15T00:00:00.000Z",15,FALSE,11,38017695,"F",11,11,"Houston Rockets","Tari Eason",3,19,20,12,9,29.1
1,1,2,1,0,9,3,7,6,"19",2,1,12,4,0,1,1037924,"2023-12-15T00:00:00.000Z",15,FALSE,11,188,"F",11,11,"Houston Rockets","Jeff Green",1,16,17,13,5,20.3
0,1,1,3,1,5,1,1,1,"20",1,1,4,2,1,0,1037924,"2023-12-15T00:00:00.000Z",15,FALSE,11,213,"G",11,11,"Houston Rockets","Aaron Holiday",2,6,6,4,2,12.4
0,0,0,0,0,0,0,0,0,"08",1,1,0,1,0,0,1037924,"2023-12-15T00:00:00.000Z",15,FALSE,11,19465326,"C",11,11,"Houston Rockets","Jock Landale",0,1,1,0,1,1.2
0,0,0,0,0,0,0,0,0,"00",0,0,0,0,0,0,1037924,"2023-12-15T00:00:00.000Z",15,FALSE,11,296,"C",11,11,"Houston Rockets","Boban Marjanovic",0,0,0,0,0,0
0,0,0,0,0,0,0,0,0,"00",0,0,0,0,0,0,1037924,"2023-12-15T00:00:00.000Z",15,FALSE,11,47738533,"G",11,11,"Houston Rockets","Jeenathan Williams",0,0,0,0,0,0
0,0,0,0,0,0,0,0,0,"00",0,0,0,0,0,0,1037924,"2023-12-15T00:00:00.000Z",15,FALSE,11,3547281,"G-F",11,11,"Houston Rockets","Nate Hinton",0,0,0,0,0,0
0,0,0,0,0,0,0,0,0,"00",0,0,0,0,0,0,1037924,"2023-12-15T00:00:00.000Z",15,FALSE,11,357,"G",11,11,"Houston Rockets","Victor Oladipo",0,0,0,0,0,0
0,0,0,0,0,0,0,0,0,"00",0,0,0,0,0,0,1037924,"2023-12-15T00:00:00.000Z",15,FALSE,11,56677809,"F",11,11,"Houston Rockets","Jermaine Samuels Jr.",0,0,0,0,0,0
0,0,0,0,0,0,0,0,0,"00",0,0,0,0,0,0,1037924,"2023-12-15T00:00:00.000Z",15,FALSE,11,3547301,"F",11,11,"Houston Rockets","Jae'Sean Tate",0,0,0,0,0,0
0,0,0,0,0,0,0,0,0,"00",0,0,0,0,0,0,1037924,"2023-12-15T00:00:00.000Z",15,FALSE,11,56677825,"G-F",11,11,"Houston Rockets","Amen Thompson",0,0,0,0,0,0
0,0,0,0,0,0,0,0,0,"00",0,0,0,0,0,0,1037924,"2023-12-15T00:00:00.000Z",15,FALSE,11,56677831,"F",11,11,"Houston Rockets","Cam Whitmore",0,0,0,0,0,0
1,1,0,2,2,5,5,1,1,"36",2,4,13,2,2,2,1037925,"2023-12-15T00:00:00.000Z",24,FALSE,20,8,"G",24,24,"Phoenix Suns","Grayson Allen",3,15,16,14,3,23.9
6,0,3,9,4,21,10,7,5,"36",0,1,29,3,0,0,1037925,"2023-12-15T00:00:00.000Z",24,FALSE,20,140,"F",24,24,"Phoenix Suns","Kevin Durant",0,32,38,35,9,41.6
2,0,8,2,1,13,9,2,2,"30",4,2,21,12,1,3,1037925,"2023-12-15T00:00:00.000Z",24,FALSE,20,349,"C",24,24,"Phoenix Suns","Jusuf Nurkic",1,33,35,23,14,38.4
1,0,0,1,1,2,2,1,1,"04",0,0,6,0,0,0,1037925,"2023-12-15T00:00:00.000Z",24,FALSE,20,37,"G",24,24,"Phoenix Suns","Bradley Beal",0,6,7,7,1,7.5
9,0,1,5,1,26,11,6,5,"37",1,4,28,2,0,3,1037925,"2023-12-15T00:00:00.000Z",24,FALSE,20,57,"G",24,24,"Phoenix Suns","Devin Booker",0,30,39,37,11,40.9
9,0,3,3,1,5,1,0,0,"23",0,3,3,3,0,1,1037925,"2023-12-15T00:00:00.000Z",24,FALSE,20,18678058,"",24,24,"Phoenix Suns","Jordan Goodwin",0,6,15,12,12,19.1
1,0,2,3,1,5,2,0,0,"26",2,2,5,4,0,0,1037925,"2023-12-15T00:00:00.000Z",24,FALSE,20,666729,"F",24,24,"Phoenix Suns","Nassir Little",0,9,10,6,5,11.3
0,2,2,0,0,4,3,2,2,"15",1,1,8,3,1,1,1037925,"2023-12-15T00:00:00.000Z",24,FALSE,20,147,"F",24,24,"Phoenix Suns","Drew Eubanks",3,11,11,8,3,19.6
0,0,0,0,0,0,0,0,0,"07",0,0,0,0,0,0,1037925,"2023-12-15T00:00:00.000Z",24,FALSE,20,470,"G",24,24,"Phoenix Suns","Yuta Watanabe",0,0,0,0,0,0
0,0,0,0,0,0,0,0,0,"00",0,0,0,0,0,0,1037925,"2023-12-15T00:00:00.000Z",24,FALSE,20,3547095,"C-F",24,24,"Phoenix Suns","Udoka Azubuike",0,0,0,0,0,0
0,0,0,0,0,0,0,0,0,"00",0,0,0,0,0,0,1037925,"2023-12-15T00:00:00.000Z",24,FALSE,20,178,"G",24,24,"Phoenix Suns","Eric Gordon",0,0,0,0,0,0
0,0,0,0,0,0,0,0,0,"00",0,0,0,0,0,0,1037925,"2023-12-15T00:00:00.000Z",24,FALSE,20,272,"G",24,24,"Phoenix Suns","Damion Lee",0,0,0,0,0,0
0,0,3,1,0,5,2,0,0,"14",0,0,4,3,0,0,1037925,"2023-12-15T00:00:00.000Z",24,FALSE,20,32,"F",24,24,"Phoenix Suns","Keita Bates-Diop",0,7,7,4,3,7.6
0,0,0,0,0,1,1,0,0,"02",0,0,2,0,0,0,1037925,"2023-12-15T00:00:00.000Z",24,FALSE,20,666451,"C",24,24,"Phoenix Suns","Bol Bol",0,2,2,2,0,2
1,0,1,2,0,3,1,2,1,"10",0,0,3,1,0,1,1037925,"2023-12-15T00:00:00.000Z",24,FALSE,20,314,"F",24,24,"Phoenix Suns","Chimezie Metu",0,4,5,4,2,4.7
0,0,0,0,0,0,0,0,0,"00",0,0,0,0,0,0,1037925,"2023-12-15T00:00:00.000Z",24,FALSE,20,3547298,"G",24,24,"Phoenix Suns","Saben Lee",0,0,0,0,0,0
0,0,0,0,0,0,0,0,0,"00",0,0,0,0,0,0,1037925,"2023-12-15T00:00:00.000Z",24,FALSE,20,356,"G",24,24,"Phoenix Suns","Josh Okogie",0,0,0,0,0,0
3,1,1,2,1,10,6,8,8,"29",1,2,21,2,0,1,1037925,"2023-12-15T00:00:00.000Z",24,FALSE,20,666423,"F-G",20,20,"New York Knicks","RJ Barrett",1,23,26,24,5,29.9
6,1,7,3,1,16,10,2,2,"35",1,4,23,8,0,5,1037925,"2023-12-15T00:00:00.000Z",24,FALSE,20,387,"F",20,20,"New York Knicks","Julius Randle",1,31,37,29,14,39.6
0,0,2,0,0,4,2,1,1,"18",1,3,5,3,0,0,1037925,"2023-12-15T00:00:00.000Z",24,FALSE,20,17896063,"F",20,20,"New York Knicks","Jericho Sims",0,8,8,5,3,8.6
1,0,1,2,1,3,2,0,0,"19",0,4,5,1,1,0,1037925,"2023-12-15T00:00:00.000Z",24,FALSE,20,131,"G",20,20,"New York Knicks","Donte DiVincenzo",1,6,7,6,2,10.7
9,0,5,9,9,23,17,9,7,"35",1,0,50,6,5,2,1037925,"2023-12-15T00:00:00.000Z",24,FALSE,20,73,"G",20,20,"New York Knicks","Jalen Brunson",5,56,65,59,15,83.7
2,0,0,3,0,8,3,0,0,"29",2,0,6,2,0,0,1037925,"2023-12-15T00:00:00.000Z",24,FALSE,20,202,"G",20,20,"New York Knicks","Josh Hart",0,8,10,8,4,11.4
2,3,7,0,0,2,2,4,3,"31",1,3,7,8,1,2,1037925,"2023-12-15T00:00:00.000Z",24,FALSE,20,201,"F-C",20,20,"New York Knicks","Isaiah Hartenstein",4,15,17,9,10,29.6
3,0,5,3,1,8,3,4,3,"24",0,2,10,5,2,1,1037925,"2023-12-15T00:00:00.000Z",24,FALSE,20,3547269,"G",20,20,"New York Knicks","Immanuel Quickley",2,15,18,13,8,25.5
0,0,0,0,0,0,0,0,0,"00",0,0,0,0,0,0,1037925,"2023-12-15T00:00:00.000Z",24,FALSE,20,399,"C",20,20,"New York Knicks","Mitchell Robinson",0,0,0,0,0,0
0,0,0,0,0,0,0,0,0,"00",0,0,0,0,0,0,1037925,"2023-12-15T00:00:00.000Z",24,FALSE,20,56677795,"F",20,20,"New York Knicks","Jacob Toppin",0,0,0,0,0,0
1,0,1,0,0,0,0,0,0,"01",0,0,0,1,0,0,1037925,"2023-12-15T00:00:00.000Z",24,FALSE,20,19,"G",20,20,"New York Knicks","Ryan Arcidiacono",0,1,2,1,2,2.7
0,0,0,0,0,0,0,0,0,"00",0,0,0,0,0,0,1037925,"2023-12-15T00:00:00.000Z",24,FALSE,20,160,"G-F",20,20,"New York Knicks","Evan Fournier",0,0,0,0,0,0
0,0,0,0,0,0,0,0,0,"01",0,0,0,0,0,0,1037925,"2023-12-15T00:00:00.000Z",24,FALSE,20,173,"F",30,20,"New York Knicks","Taj Gibson",0,0,0,0,0,0
0,0,0,0,0,0,0,0,0,"01",0,0,0,0,0,0,1037925,"2023-12-15T00:00:00.000Z",24,FALSE,20,666675,"F",20,20,"New York Knicks","DaQuan Jeffries",0,0,0,0,0,0
0,0,0,1,1,1,1,0,0,"02",0,0,3,0,0,0,1037925,"2023-12-15T00:00:00.000Z",24,FALSE,20,17896033,"G",20,20,"New York Knicks","Miles McBride",0,3,3,3,0,3
0,0,0,0,0,0,0,0,0,"00",0,0,0,0,0,0,1037925,"2023-12-15T00:00:00.000Z",24,FALSE,20,666474,"G",20,20,"New York Knicks","Charles Brown",0,0,0,0,0,0
0,0,0,0,0,0,0,0,0,"00",0,0,0,0,0,0,1037925,"2023-12-15T00:00:00.000Z",24,FALSE,20,59421201,"G",20,20,"New York Knicks","Jaylen Martin",0,0,0,0,0,0
1,0,0,6,3,7,3,0,0,"15",2,2,9,2,0,0,1037925,"2023-12-15T00:00:00.000Z",24,FALSE,20,17895858,"G",20,20,"New York Knicks","Quentin Grimes",0,11,12,10,3,12.9
1,0,7,5,2,8,4,0,0,"26",1,4,10,8,0,1,1037926,"2023-12-16T00:00:00.000Z",17,FALSE,9,56677852,"G",17,17,"Milwaukee Bucks","Andre Jackson Jr.",0,18,19,11,9,20.1
6,0,7,0,0,9,7,13,8,"26",1,1,22,8,1,0,1037926,"2023-12-16T00:00:00.000Z",17,FALSE,9,15,"F",17,17,"Milwaukee Bucks","Giannis Antetokounmpo",1,30,36,28,14,43.6
1,5,1,2,1,3,2,0,0,"26",0,3,5,1,0,2,1037926,"2023-12-16T00:00:00.000Z",17,FALSE,9,283,"C",17,17,"Milwaukee Bucks","Brook Lopez",5,6,7,6,2,20.7
1,0,5,2,1,8,4,2,2,"33",1,0,11,6,2,3,1037926,"2023-12-16T00:00:00.000Z",17,FALSE,9,38017676,"F",17,17,"Milwaukee Bucks","MarJon Beauchamp",2,17,18,12,7,22.7
5,1,4,14,6,22,11,5,5,"30",0,3,33,4,0,2,1037926,"2023-12-16T00:00:00.000Z",17,FALSE,9,278,"G",17,17,"Milwaukee Bucks","Damian Lillard",1,37,42,38,9,46.3
0,0,1,0,0,0,0,0,0,"05",0,0,0,1,0,0,1037926,"2023-12-16T00:00:00.000Z",17,FALSE,9,2148,"",17,17,"Milwaukee Bucks","Thanasis Antetokounmpo",0,1,1,0,1,1.2
2,1,3,1,1,2,2,1,1,"12",1,1,6,4,0,0,1037926,"2023-12-16T00:00:00.000Z",17,FALSE,9,105,"G",17,17,"Milwaukee Bucks","Pat Connaughton",1,10,12,8,6,16.8
1,0,0,6,3,6,3,0,0,"20",1,5,9,1,0,0,1037926,"2023-12-16T00:00:00.000Z",17,FALSE,9,38017733,"G",17,17,"Milwaukee Bucks","A.J. Green",0,10,11,10,2,11.7
0,0,3,0,0,1,1,0,0,"09",0,2,2,3,0,0,1037926,"2023-12-16T00:00:00.000Z",17,FALSE,9,56677854,"F",17,17,"Milwaukee Bucks","Chris Livingston",0,5,5,2,3,5.6
1,1,0,1,0,2,0,0,0,"06",0,0,0,0,0,0,1037926,"2023-12-16T00:00:00.000Z",17,FALSE,9,284,"C",17,17,"Milwaukee Bucks","Robin Lopez",1,0,1,1,1,4.5
5,0,1,3,1,5,3,4,4,"15",0,2,11,1,1,2,1037926,"2023-12-16T00:00:00.000Z",17,FALSE,9,368,"G",17,17,"Milwaukee Bucks","Cameron Payne",1,12,17,16,6,20.7
1,0,9,7,4,18,11,5,5,"27",3,3,31,12,1,4,1037926,"2023-12-16T00:00:00.000Z",17,FALSE,9,377,"F",17,17,"Milwaukee Bucks","Bobby Portis",1,43,44,32,13,45.9
0,0,0,1,0,4,2,2,2,"05",0,0,6,0,0,0,1037926,"2023-12-16T00:00:00.000Z",17,FALSE,9,666960,"G",17,17,"Milwaukee Bucks","Lindell Wigginton",0,6,6,6,0,6
0,0,0,0,0,0,0,0,0,"00",0,0,0,0,0,0,1037926,"2023-12-16T00:00:00.000Z",17,FALSE,9,38,"G",17,17,"Milwaukee Bucks","Malik Beasley",0,0,0,0,0,0
0,0,0,0,0,0,0,0,0,"00",0,0,0,0,0,0,1037926,"2023-12-16T00:00:00.000Z",17,FALSE,9,666453,"C",17,17,"Milwaukee Bucks","Marques Bolden",0,0,0,0,0,0
0,0,0,0,0,0,0,0,0,"00",0,0,0,0,0,0,1037926,"2023-12-16T00:00:00.000Z",17,FALSE,9,112,"F",17,17,"Milwaukee Bucks","Jae Crowder",0,0,0,0,0,0
2,0,1,6,2,15,8,6,6,"31",1,3,24,2,1,2,1037926,"2023-12-16T00:00:00.000Z",17,FALSE,9,54,"F",9,9,"Detroit Pistons","Bojan Bogdanovic",1,26,28,26,4,30.4
1,2,4,0,0,11,6,1,0,"22",3,3,12,7,1,0,1037926,"2023-12-16T00:00:00.000Z",17,FALSE,9,24,"F",9,9,"Detroit Pistons","Marvin Bagley III",3,19,20,13,8,30.9
5,0,4,0,0,4,1,0,0,"14",0,0,2,4,0,1,1037926,"2023-12-16T00:00:00.000Z",17,FALSE,9,3547241,"G",9,9,"Detroit Pistons","Killian Hayes",0,6,11,7,9,13.3
6,0,1,2,0,17,10,6,5,"31",0,3,25,1,1,2,1037926,"2023-12-16T00:00:00.000Z",17,FALSE,9,17896075,"G-F",9,9,"Detroit Pistons","Cade Cunningham",1,26,32,31,7,36.2
0,0,1,2,0,2,0,2,1,"04",0,0,1,1,0,0,1037926,"2023-12-16T00:00:00.000Z",17,FALSE,9,77,"G",9,9,"Detroit Pistons","Alec Burks",0,2,2,1,1,2.2
0,0,0,1,0,1,0,0,0,"07",0,1,0,0,0,0,1037926,"2023-12-16T00:00:00.000Z",17,FALSE,9,197,"F-G",9,9,"Detroit Pistons","Joe Harris",0,0,0,0,0,0
2,1,3,6,2,17,5,2,1,"28",1,0,13,4,1,1,1037926,"2023-12-16T00:00:00.000Z",17,FALSE,9,38017682,"G",9,9,"Detroit Pistons","Jaden Ivey",2,17,19,15,6,25.8
0,0,0,1,0,2,0,0,0,"09",0,2,0,0,0,0,1037926,"2023-12-16T00:00:00.000Z",17,FALSE,9,259,"F",9,9,"Detroit Pistons","Kevin Knox",0,0,0,0,0,0
0,0,0,0,0,0,0,0,0,"00",0,0,0,0,0,0,1037926,"2023-12-16T00:00:00.000Z",17,FALSE,9,315,"F",17,17,"Milwaukee Bucks","Khris Middleton",0,0,0,0,0,0
0,0,0,0,0,0,0,0,0,"00",0,0,0,0,0,0,1037926,"2023-12-16T00:00:00.000Z",17,FALSE,9,38017691,"G",17,17,"Milwaukee Bucks","TyTy Washington Jr.",0,0,0,0,0,0
1,0,6,3,1,6,3,0,0,"24",0,4,7,6,0,0,1037926,"2023-12-16T00:00:00.000Z",17,FALSE,9,56677826,"G-F",9,9,"Detroit Pistons","Ausar Thompson",0,13,14,8,7,15.7
1,1,2,5,0,8,1,0,0,"27",2,1,2,4,3,0,1037926,"2023-12-16T00:00:00.000Z",17,FALSE,9,17896071,"F",9,9,"Detroit Pistons","Isaiah Livers",4,6,7,3,5,20.3
2,0,1,2,1,4,2,6,6,"17",0,2,11,1,2,2,1037926,"2023-12-16T00:00:00.000Z",17,FALSE,9,56677792,"G",9,9,"Detroit Pistons","Marcus Sasser",2,12,14,13,3,19.2
0,0,0,0,0,0,0,0,0,"00",0,0,0,0,0,0,1037926,"2023-12-16T00:00:00.000Z",17,FALSE,9,3547267,"F-C",9,9,"Detroit Pistons","Isaiah Stewart",0,0,0,0,0,0
5,0,3,0,0,9,7,3,3,"26",3,4,17,6,1,0,1037926,"2023-12-16T00:00:00.000Z",17,FALSE,9,3547240,"C",9,9,"Detroit Pistons","James Wiseman",1,23,28,22,11,34.7
0,0,0,0,0,0,0,0,0,"00",0,0,0,0,0,0,1037926,"2023-12-16T00:00:00.000Z",17,FALSE,9,56677729,"G",9,9,"Detroit Pistons","Malcolm Cazalon",0,0,0,0,0,0
0,0,0,0,0,0,0,0,0,"00",0,0,0,0,0,0,1037926,"2023-12-16T00:00:00.000Z",17,FALSE,9,38017694,"C",9,9,"Detroit Pistons","Jalen Duren",0,0,0,0,0,0
0,0,0,0,0,0,0,0,0,"00",0,0,0,0,0,0,1037926,"2023-12-16T00:00:00.000Z",17,FALSE,9,330,"G",9,9,"Detroit Pistons","Monte Morris",0,0,0,0,0,0
0,0,0,0,0,0,0,0,0,"00",0,0,0,0,0,0,1037926,"2023-12-16T00:00:00.000Z",17,FALSE,9,42097199,"G",9,9,"Detroit Pistons","Jared Rhoden",0,0,0,0,0,0
0,0,0,0,0,0,0,0,0,"00",0,0,0,0,0,0,1037926,"2023-12-16T00:00:00.000Z",17,FALSE,9,44477024,"G",9,9,"Detroit Pistons","Stanley Umude",0,0,0,0,0,0
0,0,2,2,0,10,5,3,2,"24",0,1,12,2,0,0,1037927,"2023-12-16T00:00:00.000Z",4,FALSE,23,38017708,"G",4,4,"Charlotte Hornets","Bryce McGowens",0,14,14,12,2,14.4
0,0,10,7,1,14,3,2,2,"31",0,1,9,10,0,1,1037927,"2023-12-16T00:00:00.000Z",4,FALSE,23,62,"F",4,4,"Charlotte Hornets","Miles Bridges",0,19,19,9,10,20
1,2,2,0,0,6,4,0,0,"20",2,3,8,4,1,1,1037927,"2023-12-16T00:00:00.000Z",4,FALSE,23,3547282,"C",4,4,"Charlotte Hornets","Nick Richards",3,12,13,9,5,22.3
4,1,4,7,2,16,4,4,4,"29",0,0,14,4,0,3,1037927,"2023-12-16T00:00:00.000Z",4,FALSE,23,56677823,"F",4,4,"Charlotte Hornets","Brandon Miller",1,18,22,18,8,24.8
2,0,1,5,0,10,3,0,0,"20",1,2,6,2,0,2,1037927,"2023-12-16T00:00:00.000Z",4,FALSE,23,403,"G",4,4,"Charlotte Hornets","Terry Rozier",0,8,10,8,4,9.4
1,0,5,0,0,3,1,0,0,"29",3,3,2,8,0,1,1037927,"2023-12-16T00:00:00.000Z",4,FALSE,23,NA,NA,NA,4,"Charlotte Hornets","NA NA",0,10,11,3,9,12.1
0,0,1,3,0,8,1,0,0,"22",1,1,2,2,0,1,1037927,"2023-12-16T00:00:00.000Z",4,FALSE,23,18678001,"F",4,4,"Charlotte Hornets","JT Thor",0,4,4,2,2,3.4
3,2,15,1,0,23,18,6,6,"30",0,2,42,15,1,4,1037927,"2023-12-16T00:00:00.000Z",4,FALSE,23,145,"F-C",23,23,"Philadelphia 76ers","Joel Embiid",3,57,60,45,18,69.5
2,0,2,6,2,6,2,0,0,"25",0,2,6,2,4,1,1037927,"2023-12-16T00:00:00.000Z",4,FALSE,23,313,"G",23,23,"Philadelphia 76ers","De'Anthony Melton",4,8,10,8,4,22.4
7,1,2,8,5,13,8,0,0,"33",0,1,21,2,2,0,1037927,"2023-12-16T00:00:00.000Z",4,FALSE,23,3547254,"G",23,23,"Philadelphia 76ers","Tyrese Maxey",3,23,30,28,9,42.9
2,0,0,1,0,1,0,4,3,"08",0,1,3,0,0,0,1037927,"2023-12-16T00:00:00.000Z",4,FALSE,23,45,"G",23,23,"Philadelphia 76ers","Patrick Beverley",0,3,5,5,2,6
0,0,0,0,0,0,0,0,0,"00",0,0,0,0,0,0,1037927,"2023-12-16T00:00:00.000Z",4,FALSE,23,38017698,"C",4,4,"Charlotte Hornets","Mark Williams",0,0,0,0,0,0
3,0,3,2,1,3,1,0,0,"20",0,2,3,3,0,0,1037927,"2023-12-16T00:00:00.000Z",4,FALSE,23,33,"F-G",23,23,"Philadelphia 76ers","Nicolas Batum",0,6,9,6,6,11.1
4,1,4,3,1,10,6,2,2,"25",1,0,15,5,0,1,1037927,"2023-12-16T00:00:00.000Z",4,FALSE,23,200,"F",23,23,"Philadelphia 76ers","Tobias Harris",1,20,24,19,9,29
0,0,0,0,0,0,0,0,0,"00",0,0,0,0,0,0,1037927,"2023-12-16T00:00:00.000Z",4,FALSE,23,3547239,"G",4,4,"Charlotte Hornets","LaMelo Ball",0,0,0,0,0,0
0,0,0,0,0,0,0,0,0,"00",0,0,0,0,0,0,1037927,"2023-12-16T00:00:00.000Z",4,FALSE,23,204,"F",4,4,"Charlotte Hornets","Gordon Hayward",0,0,0,0,0,0
0,0,0,0,0,0,0,0,0,"00",0,0,0,0,0,0,1037927,"2023-12-16T00:00:00.000Z",4,FALSE,23,666748,"F",4,4,"Charlotte Hornets","Cody Martin",0,0,0,0,0,0
0,0,0,0,0,0,0,0,0,"00",0,0,0,0,0,0,1037927,"2023-12-16T00:00:00.000Z",4,FALSE,23,347,"G",4,4,"Charlotte Hornets","Frank Ntilikina",0,0,0,0,0,0
0,0,0,0,0,0,0,0,0,"00",0,0,0,0,0,0,1037927,"2023-12-16T00:00:00.000Z",4,FALSE,23,666950,"F",4,4,"Charlotte Hornets","P.J. Washington",0,0,0,0,0,0
0,0,0,0,0,0,0,0,0,"00",0,0,0,0,0,0,1037927,"2023-12-16T00:00:00.000Z",4,FALSE,23,56913527,"G",23,23,"Philadelphia 76ers","Ricky Council IV",0,0,0,0,0,0
0,0,0,0,0,0,0,0,0,"00",0,0,0,0,0,0,1037927,"2023-12-16T00:00:00.000Z",4,FALSE,23,17554001,"G",23,23,"Philadelphia 76ers","Javonte Smart",0,0,0,0,0,0
0,0,0,0,0,0,0,0,0,"00",0,0,0,0,0,0,1037927,"2023-12-16T00:00:00.000Z",4,FALSE,23,56677788,"G",23,23,"Philadelphia 76ers","Terquavion Smith",0,0,0,0,0,0
0,1,3,0,0,0,0,0,0,"14",0,2,0,3,0,1,1037927,"2023-12-16T00:00:00.000Z",4,FALSE,23,108,"F",23,23,"Philadelphia 76ers","Robert Covington",1,3,3,0,3,5.6
1,1,2,0,0,4,2,0,0,"14",1,1,4,3,0,0,1037927,"2023-12-16T00:00:00.000Z",4,FALSE,23,3547270,"F",23,23,"Philadelphia 76ers","Paul Reed",1,7,8,5,4,12.1
1,0,1,1,1,3,3,1,0,"07",0,2,7,1,0,0,1037927,"2023-12-16T00:00:00.000Z",4,FALSE,23,28,"C",23,23,"Philadelphia 76ers","Mo Bamba",0,8,9,8,2,9.7
2,0,1,2,2,3,3,2,2,"07",0,0,10,1,0,0,1037927,"2023-12-16T00:00:00.000Z",4,FALSE,23,2175,"",23,23,"Philadelphia 76ers","Danuel House Jr.",0,11,13,12,3,14.2
0,0,0,0,0,0,0,0,0,"04",0,0,0,0,0,0,1037927,"2023-12-16T00:00:00.000Z",4,FALSE,23,260,"G-F",23,23,"Philadelphia 76ers","Furkan Korkmaz",0,0,0,0,0,0
2,0,0,0,0,0,0,0,0,"04",0,1,0,0,2,0,1037927,"2023-12-16T00:00:00.000Z",4,FALSE,23,3547294,"F",23,23,"Philadelphia 76ers","Kenyon Martin Jr.",2,0,2,2,2,9
1,0,1,0,0,5,2,2,2,"12",1,0,6,2,1,2,1037927,"2023-12-16T00:00:00.000Z",4,FALSE,23,17896025,"G",23,23,"Philadelphia 76ers","Jaden Springer",1,8,9,7,3,10.9
0,0,2,5,2,10,5,0,0,"21",2,2,12,4,0,1,1037927,"2023-12-16T00:00:00.000Z",4,FALSE,23,360,"F",23,23,"Philadelphia 76ers","Kelly Oubre Jr.",0,16,16,12,4,15.8
1,0,4,2,0,7,3,0,0,"16",0,1,6,4,0,0,1037927,"2023-12-16T00:00:00.000Z",4,FALSE,23,328,"F",23,23,"Philadelphia 76ers","Marcus Morris",0,10,11,7,5,12.3
4,0,1,0,0,7,3,0,0,"18",0,0,6,1,1,0,1037927,"2023-12-16T00:00:00.000Z",4,FALSE,23,422,"G",4,4,"Charlotte Hornets","Ish Smith",1,7,11,10,5,16.2
1,0,0,4,1,8,4,0,0,"26",1,2,9,1,0,0,1037927,"2023-12-16T00:00:00.000Z",4,FALSE,23,56677846,"G",4,4,"Charlotte Hornets","Nick Smith Jr.",0,10,11,10,2,11.7
0,0,1,5,3,5,3,0,0,"07",0,1,9,1,0,0,1037927,"2023-12-16T00:00:00.000Z",4,FALSE,23,17896037,"G",4,4,"Charlotte Hornets","James Bouknight",0,10,10,9,1,10.2
0,0,0,2,0,3,1,2,1,"07",0,0,3,0,0,1,1037927,"2023-12-16T00:00:00.000Z",4,FALSE,23,56677848,"G",4,4,"Charlotte Hornets","Amari Bailey",0,3,3,3,0,2
2,1,1,0,0,1,1,0,0,"07",0,0,2,1,1,1,1037927,"2023-12-16T00:00:00.000Z",4,FALSE,23,56677866,"F",4,4,"Charlotte Hornets","Leaky Black",2,3,5,4,3,11.2
3,0,0,4,3,9,6,4,3,"32",3,2,18,3,1,0,1037928,"2023-12-16T00:00:00.000Z",6,FALSE,1,3547247,"F-G",6,6,"Cleveland Cavaliers","Isaac Okoro",1,21,24,21,6,29.1
3,0,4,7,4,8,5,2,2,"22",1,5,16,5,1,0,1037928,"2023-12-16T00:00:00.000Z",6,FALSE,1,666940,"F",6,6,"Cleveland Cavaliers","Dean Wade",1,21,24,19,8,29.5
1,1,10,0,0,14,12,1,1,"35",4,1,25,14,2,4,1037928,"2023-12-16T00:00:00.000Z",6,FALSE,1,9,"C",6,6,"Cleveland Cavaliers","Jarrett Allen",3,39,40,26,15,48.3
5,1,5,8,1,13,4,2,2,"34",1,2,11,6,1,1,1037928,"2023-12-16T00:00:00.000Z",6,FALSE,1,666908,"G",6,6,"Cleveland Cavaliers","Max Strus",2,17,22,16,11,30.7
13,0,2,9,4,21,7,4,4,"41",3,4,22,5,2,1,1037928,"2023-12-16T00:00:00.000Z",6,FALSE,1,322,"G",6,6,"Cleveland Cavaliers","Donovan Mitchell",2,27,40,35,18,52.5
0,0,0,0,0,0,0,0,0,"00",0,0,0,0,0,0,1037928,"2023-12-16T00:00:00.000Z",6,FALSE,1,248,"C",6,6,"Cleveland Cavaliers","Damian Jones",0,0,0,0,0,0
1,1,3,4,1,15,6,2,1,"25",2,1,14,5,1,3,1037928,"2023-12-16T00:00:00.000Z",6,FALSE,1,277,"G",6,6,"Cleveland Cavaliers","Caris LeVert",2,19,20,15,6,24.5
1,0,1,6,3,6,3,0,0,"08",0,1,9,1,0,0,1037928,"2023-12-16T00:00:00.000Z",6,FALSE,1,3547299,"G",6,6,"Cleveland Cavaliers","Sam Merrill",0,10,11,10,2,11.7
2,0,2,3,0,4,0,0,0,"15",1,2,0,3,0,0,1037928,"2023-12-16T00:00:00.000Z",6,FALSE,1,344,"F",6,6,"Cleveland Cavaliers","Georges Niang",0,3,5,2,5,6.6
3,0,1,1,0,8,3,0,0,"15",1,1,6,2,0,1,1037928,"2023-12-16T00:00:00.000Z",6,FALSE,1,56677872,"G",6,6,"Cleveland Cavaliers","Craig Porter",0,8,11,9,5,11.9
0,0,3,0,0,3,3,0,0,"13",2,3,6,5,0,0,1037928,"2023-12-16T00:00:00.000Z",6,FALSE,1,444,"C-F",6,6,"Cleveland Cavaliers","Tristan Thompson",0,11,11,6,5,12
1,1,2,4,2,12,7,0,0,"32",2,4,16,4,0,1,1037928,"2023-12-16T00:00:00.000Z",6,FALSE,1,3547244,"F-C",1,1,"Atlanta Hawks","Onyeka Okongwu",1,20,21,17,5,24.3
6,1,3,5,0,19,8,6,5,"37",0,2,21,3,1,0,1037928,"2023-12-16T00:00:00.000Z",6,FALSE,1,334,"G",1,1,"Atlanta Hawks","Dejounte Murray",2,24,30,27,9,39.6
0,0,0,0,0,0,0,0,0,"00",0,0,0,0,0,0,1037928,"2023-12-16T00:00:00.000Z",6,FALSE,1,666581,"G",6,6,"Cleveland Cavaliers","Darius Garland",0,0,0,0,0,0
0,0,0,0,0,0,0,0,0,"00",0,0,0,0,0,0,1037928,"2023-12-16T00:00:00.000Z",6,FALSE,1,666676,"G",6,6,"Cleveland Cavaliers","Ty Jerome",0,0,0,0,0,0
0,0,0,0,0,0,0,0,0,"00",0,0,0,0,0,0,1037928,"2023-12-16T00:00:00.000Z",6,FALSE,1,17896076,"F-C",6,6,"Cleveland Cavaliers","Evan Mobley",0,0,0,0,0,0
0,0,0,0,0,0,0,0,0,"00",0,0,0,0,0,0,1037928,"2023-12-16T00:00:00.000Z",6,FALSE,1,404,"G",6,6,"Cleveland Cavaliers","Ricky Rubio",0,0,0,0,0,0
0,0,2,2,2,7,5,6,6,"26",0,1,18,2,1,0,1037928,"2023-12-16T00:00:00.000Z",6,FALSE,1,666656,"F",1,1,"Atlanta Hawks","De'Andre Hunter",1,20,20,18,2,23.4
0,0,5,7,1,9,1,2,2,"36",1,0,5,6,2,2,1037928,"2023-12-16T00:00:00.000Z",6,FALSE,1,3547256,"F",1,1,"Atlanta Hawks","Saddiq Bey",2,11,11,5,6,16.2
10,1,4,12,7,21,11,6,6,"38",0,3,35,4,0,5,1037928,"2023-12-16T00:00:00.000Z",6,FALSE,1,490,"G",1,1,"Atlanta Hawks","Trae Young",1,39,49,45,14,52.8
0,0,0,0,0,0,0,0,0,"00",0,0,0,0,0,0,1037928,"2023-12-16T00:00:00.000Z",6,FALSE,1,53,"G",1,1,"Atlanta Hawks","Bogdan Bogdanovic",0,0,0,0,0,0
1,1,6,0,0,7,5,5,3,"16",2,2,13,8,0,0,1037928,"2023-12-16T00:00:00.000Z",6,FALSE,1,666564,"F",1,1,"Atlanta Hawks","Bruno Fernando",1,21,22,14,9,27.1
0,0,2,0,0,2,0,0,0,"07",1,0,0,3,1,1,1037928,"2023-12-16T00:00:00.000Z",6,FALSE,1,3547297,"G",1,1,"Atlanta Hawks","Trent Forrest",1,3,3,0,3,5.6
0,0,0,0,0,0,0,0,0,"00",0,0,0,0,0,0,1037928,"2023-12-16T00:00:00.000Z",6,FALSE,1,56677855,"G",1,1,"Atlanta Hawks","Seth Lundy",0,0,0,0,0,0
0,0,0,2,2,2,2,0,0,"14",0,4,6,0,0,1,1037928,"2023-12-16T00:00:00.000Z",6,FALSE,1,666754,"G",1,1,"Atlanta Hawks","Garrison Mathews",0,6,6,6,0,5
1,0,2,1,0,2,1,0,0,"21",0,3,2,2,0,0,1037928,"2023-12-16T00:00:00.000Z",6,FALSE,1,301,"G-F",1,1,"Atlanta Hawks","Wesley Matthews",0,4,5,3,3,5.9
2,0,2,3,1,4,1,0,0,"13",0,2,3,2,0,1,1037928,"2023-12-16T00:00:00.000Z",6,FALSE,1,319,"G",1,1,"Atlanta Hawks","Patty Mills",0,5,7,5,4,7.4
0,0,0,0,0,0,0,0,0,"00",0,0,0,0,0,0,1037928,"2023-12-16T00:00:00.000Z",6,FALSE,1,56677838,"G",1,1,"Atlanta Hawks","Kobe Bufkin",0,0,0,0,0,0
0,0,0,0,0,0,0,0,0,"00",0,0,0,0,0,0,1037928,"2023-12-16T00:00:00.000Z",6,FALSE,1,83,"C",1,1,"Atlanta Hawks","Clint Capela",0,0,0,0,0,0
0,0,0,0,0,0,0,0,0,"00",0,0,0,0,0,0,1037928,"2023-12-16T00:00:00.000Z",6,FALSE,1,17896040,"F",1,1,"Atlanta Hawks","Jalen Johnson",0,0,0,0,0,0
0,0,0,0,0,0,0,0,0,"00",0,0,0,0,0,0,1037928,"2023-12-16T00:00:00.000Z",6,FALSE,1,56677875,"F",1,1,"Atlanta Hawks","Miles Norris",0,0,0,0,0,0
0,0,0,0,0,0,0,0,0,"00",0,0,0,0,0,0,1037928,"2023-12-16T00:00:00.000Z",6,FALSE,1,38017689,"F",1,1,"Atlanta Hawks","AJ Griffin",0,0,0,0,0,0
0,0,0,0,0,0,0,0,0,"00",0,0,0,0,0,0,1037928,"2023-12-16T00:00:00.000Z",6,FALSE,1,56677806,"F",1,1,"Atlanta Hawks","Mouhamed Gueye",0,0,0,0,0,0
0,0,0,0,0,0,0,0,0,"00",0,0,0,0,0,0,1037928,"2023-12-16T00:00:00.000Z",6,FALSE,1,38017662,"F",6,6,"Cleveland Cavaliers","Isaiah Mobley",0,0,0,0,0,0
0,0,0,0,0,0,0,0,0,"00",0,0,0,0,0,0,1037928,"2023-12-16T00:00:00.000Z",6,FALSE,1,56677847,"F",6,6,"Cleveland Cavaliers","Emoni Bates",0,0,0,0,0,0
2,0,3,2,0,18,9,11,10,"35",1,3,28,4,2,2,1037929,"2023-12-16T00:00:00.000Z",16,FALSE,5,79,"G-F",16,16,"Miami Heat","Jimmy Butler",2,32,34,30,6,39.8
2,0,2,0,0,8,6,8,5,"37",2,4,17,4,2,2,1037929,"2023-12-16T00:00:00.000Z",16,FALSE,5,666747,"F",16,16,"Miami Heat","Caleb Martin",2,21,23,19,6,28.8
1,0,1,2,0,4,1,0,0,"11",1,2,2,2,0,0,1037929,"2023-12-16T00:00:00.000Z",16,FALSE,5,39398582,"C",16,16,"Miami Heat","Orlando Robinson",0,4,5,3,3,5.9
6,0,1,9,3,9,3,0,0,"24",0,0,9,1,0,2,1037929,"2023-12-16T00:00:00.000Z",16,FALSE,5,397,"F",16,16,"Miami Heat","Duncan Robinson",0,10,16,15,7,17.2
7,1,3,3,1,7,3,4,3,"32",0,2,10,3,0,0,1037929,"2023-12-16T00:00:00.000Z",16,FALSE,5,286,"G",16,16,"Miami Heat","Kyle Lowry",1,13,20,17,10,27.1
4,0,4,3,1,14,8,1,1,"35",1,1,18,5,2,2,1037929,"2023-12-16T00:00:00.000Z",16,FALSE,5,56677785,"G",16,16,"Miami Heat","Jaime Jaquez Jr.",2,23,27,22,9,34
1,0,6,10,6,12,8,0,0,"26",1,2,22,7,1,1,1037929,"2023-12-16T00:00:00.000Z",16,FALSE,5,285,"F-C",16,16,"Miami Heat","Kevin Love",1,29,30,23,8,33.9
5,0,6,10,4,15,7,4,4,"39",1,3,22,7,1,1,1037929,"2023-12-16T00:00:00.000Z",16,FALSE,5,666956,"G",5,5,"Chicago Bulls","Coby White",1,29,34,27,12,39.9
3,0,1,3,0,3,0,0,0,"12",0,2,0,1,0,1,1037929,"2023-12-16T00:00:00.000Z",16,FALSE,5,87,"G",5,5,"Chicago Bulls","Jevon Carter",0,1,4,3,4,4.7
0,0,0,0,0,0,0,0,0,"00",0,0,0,0,0,0,1037929,"2023-12-16T00:00:00.000Z",16,FALSE,5,89,"G",5,5,"Chicago Bulls","Alex Caruso",0,0,0,0,0,0
0,0,0,5,4,7,5,3,2,"13",2,0,16,2,0,0,1037929,"2023-12-16T00:00:00.000Z",16,FALSE,5,110,"F",5,5,"Chicago Bulls","Torrey Craig",0,18,18,16,2,18.4
0,0,4,0,0,2,1,2,2,"11",0,1,4,4,1,1,1037929,"2023-12-16T00:00:00.000Z",16,FALSE,5,137,"C",5,5,"Chicago Bulls","Andre Drummond",1,8,8,4,4,10.8
0,0,0,0,0,0,0,0,0,"01",0,0,0,0,0,0,1037929,"2023-12-16T00:00:00.000Z",16,FALSE,5,56677857,"F",5,5,"Chicago Bulls","Julian Phillips",0,0,0,0,0,0
0,0,0,0,0,0,0,0,0,"00",0,0,0,0,0,0,1037929,"2023-12-16T00:00:00.000Z",16,FALSE,5,17896116,"G",5,5,"Chicago Bulls","Terry Taylor",0,0,0,0,0,0
2,0,0,2,0,3,1,0,0,"16",1,4,2,1,1,1,1037929,"2023-12-16T00:00:00.000Z",16,FALSE,5,38017719,"F",5,5,"Chicago Bulls","Dalen Terry",1,3,5,4,3,8.2
0,0,0,0,0,0,0,0,0,"00",0,0,0,0,0,0,1037929,"2023-12-16T00:00:00.000Z",16,FALSE,5,56677874,"F",5,5,"Chicago Bulls","Onuralp Bitim",0,0,0,0,0,0
0,0,0,0,0,0,0,0,0,"00",0,0,0,0,0,0,1037929,"2023-12-16T00:00:00.000Z",16,FALSE,5,NA,NA,NA,5,"Chicago Bulls","NA NA",0,0,0,0,0,0
0,0,0,0,0,0,0,0,0,"00",0,0,0,0,0,0,1037929,"2023-12-16T00:00:00.000Z",16,FALSE,5,268,"G",5,5,"Chicago Bulls","Zach LaVine",0,0,0,0,0,0
0,0,0,0,0,0,0,0,0,"00",0,0,0,0,0,0,1037929,"2023-12-16T00:00:00.000Z",16,FALSE,5,56677860,"F",5,5,"Chicago Bulls","Adama Sanogo",0,0,0,0,0,0
0,0,0,0,0,0,0,0,0,"00",0,0,0,0,0,0,1037929,"2023-12-16T00:00:00.000Z",16,FALSE,5,19465585,"G",16,16,"Miami Heat","Dru Smith",0,0,0,0,0,0
0,0,0,0,0,0,0,0,0,"00",0,0,0,0,0,0,1037929,"2023-12-16T00:00:00.000Z",16,FALSE,5,38017736,"F",16,16,"Miami Heat","Cole Swider",0,0,0,0,0,0
5,3,2,2,1,13,9,9,8,"42",1,1,27,3,2,3,1037929,"2023-12-16T00:00:00.000Z",16,FALSE,5,125,"G",5,5,"Chicago Bulls","DeMar DeRozan",5,30,35,32,8,50.1
1,0,0,1,0,2,1,1,0,"14",1,2,2,1,0,0,1037929,"2023-12-16T00:00:00.000Z",16,FALSE,5,3092,"",16,16,"Miami Heat","Haywood Highsmith",0,3,4,3,2,4.7
0,1,2,0,0,2,1,0,0,"06",0,2,2,2,0,0,1037929,"2023-12-16T00:00:00.000Z",16,FALSE,5,74,"C",16,16,"Miami Heat","Thomas Bryant",1,4,4,2,2,7.4
0,0,0,0,0,0,0,0,0,"00",0,0,0,0,0,0,1037929,"2023-12-16T00:00:00.000Z",16,FALSE,5,38017734,"F",16,16,"Miami Heat","Jamal Cain",0,0,0,0,0,0
0,0,0,0,0,0,0,0,0,"00",0,0,0,0,0,0,1037929,"2023-12-16T00:00:00.000Z",16,FALSE,5,38017696,"F",16,16,"Miami Heat","Nikola Jovic",0,0,0,0,0,0
0,0,0,0,0,0,0,0,0,"00",0,0,0,0,0,0,1037929,"2023-12-16T00:00:00.000Z",16,FALSE,5,4,"C-F",16,16,"Miami Heat","Bam Adebayo",0,0,0,0,0,0
0,0,0,0,0,0,0,0,0,"00",0,0,0,0,0,0,1037929,"2023-12-16T00:00:00.000Z",16,FALSE,5,3547257,"G",16,16,"Miami Heat","R.J. Hampton",0,0,0,0,0,0
0,0,0,0,0,0,0,0,0,"00",0,0,0,0,0,0,1037929,"2023-12-16T00:00:00.000Z",16,FALSE,5,666633,"G",16,16,"Miami Heat","Tyler Herro",0,0,0,0,0,0
4,0,6,5,4,10,8,5,5,"33",1,3,25,7,0,3,1037929,"2023-12-16T00:00:00.000Z",16,FALSE,5,3547248,"F",5,5,"Chicago Bulls","Patrick Williams",0,32,36,29,11,36.4
3,0,7,4,1,13,3,6,5,"32",4,1,12,11,1,2,1037929,"2023-12-16T00:00:00.000Z",16,FALSE,5,460,"C",5,5,"Chicago Bulls","Nikola Vucevic",1,23,26,15,14,30.7
3,1,3,7,2,11,3,0,0,"41",1,4,8,4,2,2,1037929,"2023-12-16T00:00:00.000Z",16,FALSE,5,17895983,"G",5,5,"Chicago Bulls","Ayo Dosunmu",3,12,15,11,7,24.3
0,0,0,0,0,0,0,0,0,"00",0,0,0,0,0,0,1037929,"2023-12-16T00:00:00.000Z",16,FALSE,5,27,"G",5,5,"Chicago Bulls","Lonzo Ball",0,0,0,0,0,0
2,0,1,5,2,7,3,0,0,"20",1,1,8,2,0,1,1037929,"2023-12-16T00:00:00.000Z",16,FALSE,5,391,"G-F",16,16,"Miami Heat","Josh Richardson",0,10,12,10,4,12.4
0,0,1,1,1,4,2,0,0,"18",0,2,5,1,1,1,1037930,"2023-12-16T00:00:00.000Z",18,FALSE,12,3547259,"F",18,18,"Minnesota Timberwolves","Jaden McDaniels",1,6,6,5,1,8.2
4,2,7,3,2,25,15,8,8,"35",5,2,40,12,3,3,1037930,"2023-12-16T00:00:00.000Z",18,FALSE,12,447,"C",18,18,"Minnesota Timberwolves","Karl-Anthony Towns",5,52,56,44,16,72.4
1,1,5,0,0,3,2,4,1,"25",2,1,5,7,1,2,1037930,"2023-12-16T00:00:00.000Z",18,FALSE,12,176,"C",18,18,"Minnesota Timberwolves","Rudy Gobert",2,12,13,6,8,18.9
4,0,2,10,7,23,14,2,2,"34",0,3,37,2,3,4,1037930,"2023-12-16T00:00:00.000Z",18,FALSE,12,3547238,"G",18,18,"Minnesota Timberwolves","Anthony Edwards",3,39,43,41,6,50.4
9,0,2,3,1,5,2,0,0,"24",0,0,5,2,1,0,1037930,"2023-12-16T00:00:00.000Z",18,FALSE,12,104,"G",18,18,"Minnesota Timberwolves","Mike Conley",1,7,16,14,11,23.9
1,0,2,2,1,6,1,0,0,"26",0,0,3,2,1,1,1037930,"2023-12-16T00:00:00.000Z",18,FALSE,12,666400,"G",18,18,"Minnesota Timberwolves","Nickeil Alexander-Walker",1,5,6,4,3,8.9
10,0,3,0,0,4,2,0,0,"23",1,4,4,4,0,2,1037930,"2023-12-16T00:00:00.000Z",18,FALSE,12,12,"F",18,18,"Minnesota Timberwolves","Kyle Anderson",0,8,18,14,14,21.8
0,0,0,0,0,0,0,0,0,"00",0,0,0,0,0,0,1037930,"2023-12-16T00:00:00.000Z",18,FALSE,12,38017715,"F",18,18,"Minnesota Timberwolves","Josh Minott",0,0,0,0,0,0
0,0,0,0,0,0,0,0,0,"00",0,0,0,0,0,0,1037930,"2023-12-16T00:00:00.000Z",18,FALSE,12,17895968,"F",18,18,"Minnesota Timberwolves","Daishen Nix",0,0,0,0,0,0
2,0,1,3,0,4,0,0,0,"18",0,1,0,1,0,3,1037930,"2023-12-16T00:00:00.000Z",18,FALSE,12,210,"G",12,12,"Indiana Pacers","Buddy Hield",0,1,3,2,3,1.2
1,0,2,2,1,4,3,0,0,"17",2,2,7,4,0,1,1037930,"2023-12-16T00:00:00.000Z",18,FALSE,12,3547243,"F",12,12,"Indiana Pacers","Obi Toppin",0,11,12,8,5,12.3
0,0,3,2,1,7,2,8,7,"21",2,1,12,5,1,1,1037930,"2023-12-16T00:00:00.000Z",18,FALSE,12,452,"C-F",12,12,"Indiana Pacers","Myles Turner",1,17,17,12,5,20
2,1,4,3,1,14,8,0,0,"27",1,1,17,5,0,3,1037930,"2023-12-16T00:00:00.000Z",18,FALSE,12,69,"G",12,12,"Indiana Pacers","Bruce Brown",1,22,24,19,7,26
6,1,3,1,0,12,5,0,0,"26",1,1,10,4,2,1,1037930,"2023-12-16T00:00:00.000Z",18,FALSE,12,304,"G",12,12,"Indiana Pacers","T.J. McConnell",3,14,20,16,10,31.8
4,2,2,0,0,6,6,0,0,"20",1,3,12,3,3,1,1037930,"2023-12-16T00:00:00.000Z",18,FALSE,12,17896035,"F",12,12,"Indiana Pacers","Isaiah Jackson",5,15,19,16,7,35.6
3,1,1,1,0,11,3,0,0,"24",0,1,6,1,0,1,1037930,"2023-12-16T00:00:00.000Z",18,FALSE,12,38017686,"G-F",12,12,"Indiana Pacers","Bennedict Mathurin",1,7,10,9,4,13.7
0,0,2,2,0,5,3,4,2,"17",1,1,8,3,2,0,1037930,"2023-12-16T00:00:00.000Z",18,FALSE,12,56677861,"G",12,12,"Indiana Pacers","Ben Sheppard",2,11,11,8,3,17.6
0,0,0,0,0,0,0,0,0,"00",0,0,0,0,0,0,1037930,"2023-12-16T00:00:00.000Z",18,FALSE,12,38017507,"G-F",12,12,"Indiana Pacers","Andrew Nembhard",0,0,0,0,0,0
0,0,0,0,0,0,0,0,0,"00",0,0,0,0,0,0,1037930,"2023-12-16T00:00:00.000Z",18,FALSE,12,3547264,"F-C",12,12,"Indiana Pacers","Jalen Smith",0,0,0,0,0,0
0,0,0,0,0,0,0,0,0,"00",0,0,0,0,0,0,1037930,"2023-12-16T00:00:00.000Z",18,FALSE,12,56677794,"G",12,12,"Indiana Pacers","Isaiah Wong",0,0,0,0,0,0
0,0,0,0,0,0,0,0,0,"00",0,0,0,0,0,0,1037930,"2023-12-16T00:00:00.000Z",18,FALSE,12,56677851,"G",18,18,"Minnesota Timberwolves","Jaylen Clark",0,0,0,0,0,0
0,0,0,0,0,0,0,0,0,"00",0,0,0,0,0,0,1037930,"2023-12-16T00:00:00.000Z",18,FALSE,12,17896056,"C",18,18,"Minnesota Timberwolves","Luka Garza",0,0,0,0,0,0
0,0,0,0,0,0,0,0,0,"00",0,0,0,0,0,0,1037930,"2023-12-16T00:00:00.000Z",18,FALSE,12,56677782,"F",18,18,"Minnesota Timberwolves","Leonard Miller",0,0,0,0,0,0
0,0,5,5,3,8,6,2,2,"27",0,2,17,5,0,1,1037930,"2023-12-16T00:00:00.000Z",18,FALSE,12,667378,"F-C",18,18,"Minnesota Timberwolves","Naz Reid",0,22,22,17,5,22
4,0,1,5,3,6,4,0,0,"16",0,1,11,1,0,1,1037930,"2023-12-16T00:00:00.000Z",18,FALSE,12,68,"F",18,18,"Minnesota Timberwolves","Troy Brown Jr.",0,12,16,15,5,17.2
0,1,0,0,0,0,0,0,0,"04",0,0,0,0,0,0,1037930,"2023-12-16T00:00:00.000Z",18,FALSE,12,666767,"G",18,18,"Minnesota Timberwolves","Jordan McLaughlin",1,0,0,0,0,3
0,0,0,1,0,2,0,0,0,"05",0,1,0,0,0,0,1037930,"2023-12-16T00:00:00.000Z",18,FALSE,12,320,"G",18,18,"Minnesota Timberwolves","Shake Milton",0,0,0,0,0,0
0,0,0,0,0,0,0,0,0,"03",0,0,0,0,0,0,1037930,"2023-12-16T00:00:00.000Z",18,FALSE,12,38017700,"G",18,18,"Minnesota Timberwolves","Wendell Moore Jr.",0,0,0,0,0,0
0,1,2,4,2,14,7,1,1,"26",3,1,17,5,0,0,1037930,"2023-12-16T00:00:00.000Z",18,FALSE,12,3547250,"G-F",12,12,"Indiana Pacers","Aaron Nesmith",1,22,22,17,5,26
3,0,2,2,1,3,2,0,0,"24",0,2,5,2,2,1,1037930,"2023-12-16T00:00:00.000Z",18,FALSE,12,56677832,"F",12,12,"Indiana Pacers","Jarace Walker",2,7,10,8,5,16.9
3,0,1,1,0,4,3,1,1,"10",0,0,7,1,0,1,1037930,"2023-12-16T00:00:00.000Z",18,FALSE,12,3547207,"F",12,12,"Indiana Pacers","Jordan Nwora",0,8,11,10,4,11.7
1,0,2,0,0,6,3,2,2,"07",2,0,8,4,0,0,1037930,"2023-12-16T00:00:00.000Z",18,FALSE,12,56677778,"F-C",12,12,"Indiana Pacers","Oscar Tshiebwe",0,12,13,9,5,14.3
0,0,2,0,0,0,0,0,0,"03",0,1,0,2,0,0,1037930,"2023-12-16T00:00:00.000Z",18,FALSE,12,242,"F",12,12,"Indiana Pacers","James Johnson",0,2,2,0,2,2.4
0,0,0,0,0,0,0,0,0,"00",0,0,0,0,0,0,1037930,"2023-12-16T00:00:00.000Z",18,FALSE,12,38017701,"G",12,12,"Indiana Pacers","Kendall Brown",0,0,0,0,0,0
0,0,0,0,0,0,0,0,0,"00",0,0,0,0,0,0,1037930,"2023-12-16T00:00:00.000Z",18,FALSE,12,3547245,"G",12,12,"Indiana Pacers","Tyrese Haliburton",0,0,0,0,0,0
0,0,11,8,4,18,8,0,0,"32",0,0,20,11,0,1,1037932,"2023-12-16T00:00:00.000Z",8,FALSE,21,375,"F",8,8,"Denver Nuggets","Michael Porter Jr.",0,31,31,20,11,32.2
5,0,3,0,0,10,5,7,6,"33",6,2,16,9,2,0,1037932,"2023-12-16T00:00:00.000Z",8,FALSE,21,177,"F",8,8,"Denver Nuggets","Aaron Gordon",2,25,30,21,14,40.3
12,0,2,2,1,15,8,8,7,"37",4,3,24,6,2,3,1037932,"2023-12-16T00:00:00.000Z",8,FALSE,21,246,"C",8,8,"Denver Nuggets","Nikola Jokic",2,30,42,36,18,52.2
2,0,1,3,2,4,2,0,0,"26",0,0,6,1,0,1,1037932,"2023-12-16T00:00:00.000Z",8,FALSE,21,215,"F-G",8,8,"Denver Nuggets","Justin Holiday",0,7,9,8,3,9.2
5,0,1,6,0,13,5,5,5,"28",1,4,15,2,0,1,1037932,"2023-12-16T00:00:00.000Z",8,FALSE,21,335,"G",8,8,"Denver Nuggets","Jamal Murray",0,17,22,20,7,23.9
1,0,2,5,2,10,5,2,2,"25",0,3,14,2,1,1,1037932,"2023-12-16T00:00:00.000Z",8,FALSE,21,38017709,"G",8,8,"Denver Nuggets","Christian Braun",1,16,17,15,3,19.9
0,0,0,0,0,0,0,0,0,"00",0,0,0,0,0,0,1037932,"2023-12-16T00:00:00.000Z",8,FALSE,21,38017727,"G",8,8,"Denver Nuggets","Collin Gillespie",0,0,0,0,0,0
3,0,2,4,1,10,3,0,0,"22",1,4,7,3,0,1,1037932,"2023-12-16T00:00:00.000Z",8,FALSE,21,236,"G",8,8,"Denver Nuggets","Reggie Jackson",0,10,13,10,6,14.1
1,0,4,0,0,2,1,0,0,"06",3,1,2,7,0,0,1037932,"2023-12-16T00:00:00.000Z",8,FALSE,21,250,"C",8,8,"Denver Nuggets","DeAndre Jordan",0,9,10,3,8,11.9
0,0,0,0,0,0,0,0,0,"00",0,0,0,0,0,0,1037932,"2023-12-16T00:00:00.000Z",8,FALSE,21,17896007,"G",8,8,"Denver Nuggets","Braxton Key",0,0,0,0,0,0
0,0,0,0,0,0,0,0,0,"00",0,0,0,0,0,0,1037932,"2023-12-16T00:00:00.000Z",8,FALSE,21,3547268,"F-C",8,8,"Denver Nuggets","Zeke Nnaji",0,0,0,0,0,0
1,0,1,2,0,3,0,0,0,"15",0,0,0,1,0,0,1037932,"2023-12-16T00:00:00.000Z",8,FALSE,21,56677776,"G",8,8,"Denver Nuggets","Julian Strawther",0,1,2,1,2,2.7
0,0,3,2,2,9,5,2,1,"16",2,5,13,5,0,1,1037932,"2023-12-16T00:00:00.000Z",8,FALSE,21,38017721,"G",8,8,"Denver Nuggets","Peyton Watson",0,18,18,13,5,18
0,0,0,0,0,0,0,0,0,"00",0,0,0,0,0,0,1037932,"2023-12-16T00:00:00.000Z",8,FALSE,21,81,"G",8,8,"Denver Nuggets","Kentavious Caldwell-Pope",0,0,0,0,0,0
0,0,0,0,0,0,0,0,0,"00",0,0,0,0,0,0,1037932,"2023-12-16T00:00:00.000Z",8,FALSE,21,666489,"F",8,8,"Denver Nuggets","Vlatko Cancar",0,0,0,0,0,0
0,0,0,0,0,0,0,0,0,"00",0,0,0,0,0,0,1037932,"2023-12-16T00:00:00.000Z",8,FALSE,21,17896103,"F-C",8,8,"Denver Nuggets","Jay Huff",0,0,0,0,0,0
0,0,0,0,0,0,0,0,0,"00",0,0,0,0,0,0,1037932,"2023-12-16T00:00:00.000Z",8,FALSE,21,56677582,"G",8,8,"Denver Nuggets","Jalen Pickett",0,0,0,0,0,0
0,0,0,0,0,0,0,0,0,"00",0,0,0,0,0,0,1037932,"2023-12-16T00:00:00.000Z",8,FALSE,21,56677871,"F",8,8,"Denver Nuggets","Hunter Tyson",0,0,0,0,0,0
2,0,2,3,2,8,4,4,3,"26",2,4,13,4,0,0,1037932,"2023-12-16T00:00:00.000Z",8,FALSE,21,666541,"G",21,21,"Oklahoma City Thunder","Luguentz Dort",0,17,19,15,6,20.8
3,0,1,1,0,20,11,2,2,"33",0,1,24,1,1,2,1037932,"2023-12-16T00:00:00.000Z",8,FALSE,21,38017703,"G-F",21,21,"Oklahoma City Thunder","Jalen Williams",1,25,28,27,4,30.7
1,9,10,4,1,12,6,6,4,"32",1,3,17,11,0,1,1037932,"2023-12-16T00:00:00.000Z",8,FALSE,21,38017685,"C-F",21,21,"Oklahoma City Thunder","Chet Holmgren",9,28,29,18,12,57.7
4,0,2,1,0,4,2,0,0,"15",0,0,4,2,0,1,1037932,"2023-12-16T00:00:00.000Z",8,FALSE,21,17896065,"G",21,21,"Oklahoma City Thunder","Josh Giddey",0,6,10,8,6,11.4
8,0,6,2,0,20,9,8,7,"37",0,1,25,6,2,2,1037932,"2023-12-16T00:00:00.000Z",8,FALSE,21,175,"G",21,21,"Oklahoma City Thunder","Shai Gilgeous-Alexander",2,31,39,33,14,48.2
0,0,0,0,0,0,0,0,0,"00",0,0,0,0,0,0,1037932,"2023-12-16T00:00:00.000Z",8,FALSE,21,44,"F",21,21,"Oklahoma City Thunder","Davis Bertans",0,0,0,0,0,0
0,0,0,0,0,0,0,0,0,"00",0,0,0,0,0,0,1037932,"2023-12-16T00:00:00.000Z",8,FALSE,21,4197029,"G",21,21,"Oklahoma City Thunder","Vasilije Micic",0,0,0,0,0,0
0,0,0,0,0,0,0,0,0,"00",0,0,0,0,0,0,1037932,"2023-12-16T00:00:00.000Z",8,FALSE,21,24572055,"C",21,21,"Oklahoma City Thunder","Olivier Sarr",0,0,0,0,0,0
1,0,1,0,0,2,1,0,0,"18",1,0,2,2,0,1,1037932,"2023-12-16T00:00:00.000Z",8,FALSE,21,56677833,"G",21,21,"Oklahoma City Thunder","Cason Wallace",0,4,5,3,3,4.9
1,0,1,0,0,2,2,2,2,"12",1,1,6,2,0,0,1037932,"2023-12-16T00:00:00.000Z",8,FALSE,21,17896078,"G",21,21,"Oklahoma City Thunder","Aaron Wiggins",0,8,9,7,3,9.9
1,0,3,4,3,4,3,2,2,"22",1,4,11,4,0,0,1037932,"2023-12-16T00:00:00.000Z",8,FALSE,21,38017706,"F",21,21,"Oklahoma City Thunder","Jaylin Williams",0,15,16,12,5,17.3
0,0,2,1,0,4,1,0,0,"13",3,4,2,5,0,0,1037932,"2023-12-16T00:00:00.000Z",8,FALSE,21,480,"G-F",21,21,"Oklahoma City Thunder","Kenrich Williams",0,7,7,2,5,8
0,0,0,0,0,0,0,0,0,"00",0,0,0,0,0,0,1037932,"2023-12-16T00:00:00.000Z",8,FALSE,21,56677853,"F",21,21,"Oklahoma City Thunder","Keyontae Johnson",0,0,0,0,0,0
0,0,0,0,0,0,0,0,0,"00",0,0,0,0,0,0,1037932,"2023-12-16T00:00:00.000Z",8,FALSE,21,3547271,"C",21,21,"Oklahoma City Thunder","Aleksej Pokusevski",0,0,0,0,0,0
0,0,0,0,0,0,0,0,0,"00",0,0,0,0,0,0,1037932,"2023-12-16T00:00:00.000Z",8,FALSE,21,27924547,"F",21,21,"Oklahoma City Thunder","Lindy Waters III",0,0,0,0,0,0
0,0,1,1,0,1,0,2,2,"05",0,0,2,1,0,0,1037932,"2023-12-16T00:00:00.000Z",8,FALSE,21,38017716,"F",21,21,"Oklahoma City Thunder","Ousmane Dieng",0,3,3,2,1,3.2
1,1,2,4,1,7,4,4,3,"27",0,1,12,2,1,3,1037932,"2023-12-16T00:00:00.000Z",8,FALSE,21,3547272,"G",21,21,"Oklahoma City Thunder","Isaiah Joe",2,14,15,13,3,18.9
0,0,0,0,0,0,0,0,0,"00",0,0,0,0,0,0,1037932,"2023-12-16T00:00:00.000Z",8,FALSE,21,17896036,"G",21,21,"Oklahoma City Thunder","Tre Mann",0,0,0,0,0,0
1,0,3,4,0,7,3,2,2,"20",0,3,8,3,1,0,1037933,"2023-12-16T00:00:00.000Z",25,FALSE,7,56677850,"F",25,25,"Portland Trail Blazers","Toumani Camara",1,11,12,9,4,16.1
1,0,4,4,1,20,12,3,2,"39",1,2,27,5,0,0,1037933,"2023-12-16T00:00:00.000Z",25,FALSE,7,182,"F",25,25,"Portland Trail Blazers","Jerami Grant",0,32,33,28,6,34.5
2,0,7,0,0,5,3,2,1,"27",3,3,7,10,2,1,1037933,"2023-12-16T00:00:00.000Z",25,FALSE,7,22,"C",25,25,"Portland Trail Blazers","Deandre Ayton",2,17,19,9,12,27
2,0,2,3,1,7,2,3,2,"32",0,4,7,2,0,2,1037933,"2023-12-16T00:00:00.000Z",25,FALSE,7,38017690,"G",25,25,"Portland Trail Blazers","Shaedon Sharpe",0,9,11,9,4,10.4
6,0,6,8,2,22,13,5,5,"35",2,2,33,8,2,3,1037933,"2023-12-16T00:00:00.000Z",25,FALSE,7,419,"G",25,25,"Portland Trail Blazers","Anfernee Simons",2,41,47,39,14,54.6
2,0,2,4,1,7,4,0,0,"24",0,4,9,2,1,1,1037933,"2023-12-16T00:00:00.000Z",25,FALSE,7,65,"G",25,25,"Portland Trail Blazers","Malcolm Brogdon",1,11,13,11,4,16.4
0,0,0,0,0,0,0,0,0,"00",0,0,0,0,0,0,1037933,"2023-12-16T00:00:00.000Z",25,FALSE,7,666476,"C",25,25,"Portland Trail Blazers","Moses Brown",0,0,0,0,0,0
2,1,3,1,1,10,5,2,2,"24",0,3,13,3,0,3,1037933,"2023-12-16T00:00:00.000Z",25,FALSE,7,56677747,"G",25,25,"Portland Trail Blazers","Scoot Henderson",1,16,18,15,5,19.6
0,0,0,0,0,0,0,0,0,"00",0,0,0,0,0,0,1037933,"2023-12-16T00:00:00.000Z",25,FALSE,7,3547289,"G",25,25,"Portland Trail Blazers","Skylar Mays",0,0,0,0,0,0
1,0,2,3,0,9,3,5,5,"15",3,0,11,5,0,0,1037933,"2023-12-16T00:00:00.000Z",25,FALSE,7,56783340,"C",25,25,"Portland Trail Blazers","Duop Reath",0,16,17,12,6,18.5
0,1,3,4,1,6,2,0,0,"19",1,0,5,4,2,1,1037933,"2023-12-16T00:00:00.000Z",25,FALSE,7,666923,"G-F",25,25,"Portland Trail Blazers","Matisse Thybulle",3,9,9,5,4,17.8
0,0,2,1,0,1,0,0,0,"05",0,0,0,2,0,0,1037933,"2023-12-16T00:00:00.000Z",25,FALSE,7,38017711,"F",25,25,"Portland Trail Blazers","Jabari Walker",0,2,2,0,2,2.4
10,0,10,12,4,28,15,6,6,"37",2,3,40,12,1,4,1037933,"2023-12-16T00:00:00.000Z",25,FALSE,7,132,"F-G",7,7,"Dallas Mavericks","Luka Doncic",1,52,62,50,22,68.4
0,0,0,0,0,0,0,0,0,"01",0,0,0,0,0,0,1037933,"2023-12-16T00:00:00.000Z",25,FALSE,7,17896028,"F",7,7,"Dallas Mavericks","Greg Brown III",0,0,0,0,0,0
1,0,2,3,2,6,2,1,1,"14",0,3,7,2,0,1,1037933,"2023-12-16T00:00:00.000Z",25,FALSE,7,114,"G",7,7,"Dallas Mavericks","Seth Curry",0,9,10,8,3,9.9
0,0,0,0,0,0,0,0,0,"00",0,0,0,0,0,0,1037933,"2023-12-16T00:00:00.000Z",25,FALSE,7,56677873,"G",7,7,"Dallas Mavericks","Dexter Dennis",0,0,0,0,0,0
1,0,6,15,5,21,8,4,4,"36",0,0,25,6,1,1,1037933,"2023-12-16T00:00:00.000Z",25,FALSE,7,191,"G",7,7,"Dallas Mavericks","Tim Hardaway Jr.",1,31,32,26,7,35.7
0,0,3,0,0,2,2,0,0,"06",0,1,4,3,0,0,1037933,"2023-12-16T00:00:00.000Z",25,FALSE,7,38017679,"G",7,7,"Dallas Mavericks","Jaden Hardy",0,7,7,4,3,7.6
0,0,0,0,0,0,0,0,0,"01",0,0,0,0,0,0,1037933,"2023-12-16T00:00:00.000Z",25,FALSE,7,17554004,"G",7,7,"Dallas Mavericks","AJ Lawson",0,0,0,0,0,0
4,0,5,5,2,9,4,0,0,"20",0,0,10,5,1,2,1037933,"2023-12-16T00:00:00.000Z",25,FALSE,7,329,"F",7,7,"Dallas Mavericks","Markieff Morris",1,15,19,14,9,23
0,1,1,0,0,3,2,3,2,"22",4,2,6,5,0,0,1037933,"2023-12-16T00:00:00.000Z",25,FALSE,7,379,"F-C",7,7,"Dallas Mavericks","Dwight Powell",1,11,11,6,5,15
1,0,3,1,0,1,0,0,0,"06",2,0,0,5,0,0,1037933,"2023-12-16T00:00:00.000Z",25,FALSE,7,56677859,"F",7,7,"Dallas Mavericks","Olivier-Maxence Prosper",0,5,6,1,6,7.5
0,0,0,0,0,0,0,0,0,"00",0,0,0,0,0,0,1037933,"2023-12-16T00:00:00.000Z",25,FALSE,7,3547258,"G",7,7,"Dallas Mavericks","Josh Green",0,0,0,0,0,0
0,0,0,0,0,0,0,0,0,"00",0,0,0,0,0,0,1037933,"2023-12-16T00:00:00.000Z",25,FALSE,7,217,"F-C",7,7,"Dallas Mavericks","Richaun Holmes",0,0,0,0,0,0
0,0,0,0,0,0,0,0,0,"00",0,0,0,0,0,0,1037933,"2023-12-16T00:00:00.000Z",25,FALSE,7,228,"G",7,7,"Dallas Mavericks","Kyrie Irving",0,0,0,0,0,0
0,0,0,0,0,0,0,0,0,"00",0,0,0,0,0,0,1037933,"2023-12-16T00:00:00.000Z",25,FALSE,7,257,"F",7,7,"Dallas Mavericks","Maxi Kleber",0,0,0,0,0,0
0,0,0,0,0,0,0,0,0,"00",0,0,0,0,0,0,1037933,"2023-12-16T00:00:00.000Z",25,FALSE,7,56677791,"F",25,25,"Portland Trail Blazers","Kris Murray",0,0,0,0,0,0
0,0,0,0,0,0,0,0,0,"00",0,0,0,0,0,0,1037933,"2023-12-16T00:00:00.000Z",25,FALSE,7,17896120,"F",25,25,"Portland Trail Blazers","Ish Wainright",0,0,0,0,0,0
0,0,0,0,0,0,0,0,0,"00",0,0,0,0,0,0,1037933,"2023-12-16T00:00:00.000Z",25,FALSE,7,39613724,"C",25,25,"Portland Trail Blazers","Ibou Badji",0,0,0,0,0,0
0,0,0,0,0,0,0,0,0,"00",0,0,0,0,0,0,1037933,"2023-12-16T00:00:00.000Z",25,FALSE,7,47957121,"F",25,25,"Portland Trail Blazers","Justin Minaya",0,0,0,0,0,0
0,0,0,0,0,0,0,0,0,"00",0,0,0,0,0,0,1037933,"2023-12-16T00:00:00.000Z",25,FALSE,7,56677829,"G-F",25,25,"Portland Trail Blazers","Rayan Rupert",0,0,0,0,0,0
0,0,0,0,0,0,0,0,0,"00",0,0,0,0,0,0,1037933,"2023-12-16T00:00:00.000Z",25,FALSE,7,476,"C-F",25,25,"Portland Trail Blazers","Robert Williams III",0,0,0,0,0,0
4,0,0,6,2,11,6,5,4,"33",1,1,18,1,2,1,1037933,"2023-12-16T00:00:00.000Z",25,FALSE,7,247,"F-G",7,7,"Dallas Mavericks","Derrick Jones Jr.",2,19,23,22,5,30.2
3,1,3,3,0,4,1,1,1,"31",1,4,3,4,1,1,1037933,"2023-12-16T00:00:00.000Z",25,FALSE,7,666965,"F",7,7,"Dallas Mavericks","Grant Williams",2,7,10,6,7,17.3
0,0,1,0,0,1,0,0,0,"06",1,0,0,2,0,0,1037933,"2023-12-16T00:00:00.000Z",25,FALSE,7,56677840,"C",7,7,"Dallas Mavericks","Dereck Lively II",0,2,2,0,2,2.4
3,0,2,2,1,11,8,1,1,"27",0,3,18,2,1,2,1037933,"2023-12-16T00:00:00.000Z",25,FALSE,7,151,"G",7,7,"Dallas Mavericks","Dante Exum",1,20,23,21,5,25.9
2,0,2,5,3,11,6,1,1,"33",2,1,16,4,1,0,1037934,"2023-12-16T00:00:00.000Z",26,FALSE,29,30,"F",26,26,"Sacramento Kings","Harrison Barnes",1,20,22,18,6,26.8
2,0,7,15,12,23,16,4,3,"36",1,1,47,8,2,0,1037934,"2023-12-16T00:00:00.000Z",26,FALSE,29,38017688,"F",26,26,"Sacramento Kings","Keegan Murray",2,55,57,49,10,65.6
8,0,8,1,0,10,9,4,2,"35",2,1,20,10,2,6,1037934,"2023-12-16T00:00:00.000Z",26,FALSE,29,406,"F",26,26,"Sacramento Kings","Domantas Sabonis",2,30,38,28,18,44
5,0,2,4,2,6,4,2,1,"25",1,4,11,3,0,0,1037934,"2023-12-16T00:00:00.000Z",26,FALSE,29,221,"G",26,26,"Sacramento Kings","Kevin Huerter",0,14,19,16,8,22.1
7,0,1,3,0,3,0,2,2,"26",0,2,2,1,1,3,1037934,"2023-12-16T00:00:00.000Z",26,FALSE,29,38017714,"G",26,26,"Sacramento Kings","Keon Ellis",1,3,10,9,8,13.7
0,0,1,0,0,2,0,0,0,"04",0,0,0,1,0,1,1037934,"2023-12-16T00:00:00.000Z",26,FALSE,29,17896030,"G",26,26,"Sacramento Kings","Chris Duarte",0,1,1,0,1,0.2
0,0,0,0,0,0,0,0,0,"02",0,0,0,0,0,0,1037934,"2023-12-16T00:00:00.000Z",26,FALSE,29,17896044,"F",26,26,"Sacramento Kings","Kessler Edwards",0,0,0,0,0,0
0,1,7,2,0,2,0,0,0,"18",1,4,0,8,0,2,1037934,"2023-12-16T00:00:00.000Z",26,FALSE,29,290,"F",26,26,"Sacramento Kings","Trey Lyles",1,8,8,0,8,10.6
0,0,0,0,0,3,2,0,0,"04",0,1,4,0,0,1,1037934,"2023-12-16T00:00:00.000Z",26,FALSE,29,306,"C",26,26,"Sacramento Kings","JaVale McGee",0,4,4,4,0,3
1,0,0,1,0,5,2,0,0,"18",0,3,4,0,0,0,1037934,"2023-12-16T00:00:00.000Z",26,FALSE,29,17553994,"G",26,26,"Sacramento Kings","Davion Mitchell",0,4,5,5,1,5.5
8,1,4,12,4,16,6,2,2,"26",0,0,18,4,0,1,1037934,"2023-12-16T00:00:00.000Z",26,FALSE,29,324,"G",26,26,"Sacramento Kings","Malik Monk",1,22,30,26,12,36.8
1,0,1,0,0,1,0,0,0,"02",1,0,0,2,0,0,1037934,"2023-12-16T00:00:00.000Z",26,FALSE,29,666925,"F",29,26,"Sacramento Kings","Juan Toscano-Anderson",0,2,3,1,3,3.9
2,0,4,2,1,3,1,0,0,"11",0,0,3,4,0,0,1037934,"2023-12-16T00:00:00.000Z",26,FALSE,29,4197162,"F",26,26,"Sacramento Kings","Aleksandar Vezenkov",0,7,9,5,6,10.8
0,0,0,0,0,0,0,0,0,"00",0,0,0,0,0,0,1037934,"2023-12-16T00:00:00.000Z",26,FALSE,29,17895990,"G",26,26,"Sacramento Kings","Jordan Ford",0,0,0,0,0,0
0,0,0,0,0,0,0,0,0,"00",0,0,0,0,0,0,1037934,"2023-12-16T00:00:00.000Z",26,FALSE,29,161,"G",26,26,"Sacramento Kings","De'Aaron Fox",0,0,0,0,0,0
0,0,0,0,0,0,0,0,0,"00",0,0,0,0,0,0,1037934,"2023-12-16T00:00:00.000Z",26,FALSE,29,56677845,"G",26,26,"Sacramento Kings","Colby Jones",0,0,0,0,0,0
0,0,0,0,0,0,0,0,0,"00",0,0,0,0,0,0,1037934,"2023-12-16T00:00:00.000Z",26,FALSE,29,273,"C",26,26,"Sacramento Kings","Alex Len",0,0,0,0,0,0
0,0,0,0,0,0,0,0,0,"00",0,0,0,0,0,0,1037934,"2023-12-16T00:00:00.000Z",26,FALSE,29,56677862,"F",26,26,"Sacramento Kings","Jalen Slawson",0,0,0,0,0,0
0,0,2,5,1,9,3,0,0,"25",0,0,7,2,0,0,1037934,"2023-12-16T00:00:00.000Z",26,FALSE,29,38017739,"F",29,29,"Utah Jazz","Simone Fontecchio",0,9,9,7,2,9.4
3,0,5,5,2,13,7,2,2,"28",1,2,18,6,0,2,1037934,"2023-12-16T00:00:00.000Z",26,FALSE,29,297,"F",29,29,"Utah Jazz","Lauri Markkanen",0,24,27,21,9,27.7
13,1,5,2,1,7,4,0,0,"29",0,3,9,5,1,1,1037934,"2023-12-16T00:00:00.000Z",26,FALSE,29,358,"F",29,29,"Utah Jazz","Kelly Olynyk",2,14,27,22,18,39.5
1,0,2,6,2,18,10,7,6,"33",1,2,28,3,1,1,1037934,"2023-12-16T00:00:00.000Z",26,FALSE,29,413,"G",29,29,"Utah Jazz","Collin Sexton",1,31,32,29,4,35.1
3,1,3,4,1,10,5,0,0,"27",1,1,11,4,1,6,1037934,"2023-12-16T00:00:00.000Z",26,FALSE,29,139,"G",29,29,"Utah Jazz","Kris Dunn",2,15,18,14,7,20.3
0,0,1,3,1,7,2,0,0,"23",3,2,5,4,1,0,1037934,"2023-12-16T00:00:00.000Z",26,FALSE,29,38017620,"G",29,29,"Utah Jazz","Ochai Agbaji",1,9,9,5,4,12.8
5,0,2,4,2,11,4,3,2,"26",1,0,12,3,3,1,1037934,"2023-12-16T00:00:00.000Z",26,FALSE,29,666650,"G",29,29,"Utah Jazz","Talen Horton-Tucker",3,15,20,17,8,31.1
1,1,2,0,0,0,0,4,2,"19",1,2,2,3,0,1,1037934,"2023-12-16T00:00:00.000Z",26,FALSE,29,38017705,"C",29,29,"Utah Jazz","Walker Kessler",1,5,6,3,4,9.1
0,0,4,1,0,1,0,0,0,"04",0,0,0,4,0,0,1037934,"2023-12-16T00:00:00.000Z",26,FALSE,29,19465584,"F",29,29,"Utah Jazz","Micah Potter",0,4,4,0,4,4.8
0,0,0,0,0,0,0,0,0,"00",0,0,0,0,0,0,1037934,"2023-12-16T00:00:00.000Z",26,FALSE,29,17896023,"G",29,29,"Utah Jazz","Josh Christopher",0,0,0,0,0,0
0,0,0,0,0,0,0,0,0,"00",0,0,0,0,0,0,1037934,"2023-12-16T00:00:00.000Z",26,FALSE,29,100,"G",29,29,"Utah Jazz","Jordan Clarkson",0,0,0,0,0,0
0,0,0,0,0,0,0,0,0,"00",0,0,0,0,0,0,1037934,"2023-12-16T00:00:00.000Z",26,FALSE,29,101,"F-C",29,29,"Utah Jazz","John Collins",0,0,0,0,0,0
0,0,0,0,0,0,0,0,0,"00",0,0,0,0,0,0,1037934,"2023-12-16T00:00:00.000Z",26,FALSE,29,56677834,"G",29,29,"Utah Jazz","Keyonte George",0,0,0,0,0,0
0,0,0,0,0,0,0,0,0,"00",0,0,0,0,0,0,1037934,"2023-12-16T00:00:00.000Z",26,FALSE,29,666881,"F",29,29,"Utah Jazz","Luka Samanic",0,0,0,0,0,0
0,0,0,0,0,0,0,0,0,"00",0,0,0,0,0,0,1037934,"2023-12-16T00:00:00.000Z",26,FALSE,29,56677842,"F",29,29,"Utah Jazz","Brice Sensabaugh",0,0,0,0,0,0
0,0,0,0,0,0,0,0,0,"00",0,0,0,0,0,0,1037934,"2023-12-16T00:00:00.000Z",26,FALSE,29,11891374,"C",29,29,"Utah Jazz","Omer Yurtseven",0,0,0,0,0,0
1,0,2,5,2,8,3,5,4,"22",1,0,12,3,1,0,1037934,"2023-12-16T00:00:00.000Z",26,FALSE,29,56677824,"F",29,29,"Utah Jazz","Taylor Hendricks",1,15,16,13,4,20.1
1,0,0,2,0,2,0,0,0,"04",0,0,0,0,0,0,1037934,"2023-12-16T00:00:00.000Z",26,FALSE,29,38017630,"G",29,29,"Utah Jazz","Johnny Juzang",0,0,1,1,1,1.5
4,0,6,6,5,16,12,7,7,"30",1,1,36,7,2,0,1037935,"2023-12-16T00:00:00.000Z",13,FALSE,20,274,"F",13,13,"LA Clippers","Kawhi Leonard",2,43,47,40,11,56.4
7,0,4,6,3,18,11,0,0,"31",0,4,25,4,2,2,1037935,"2023-12-16T00:00:00.000Z",13,FALSE,20,172,"F",13,13,"LA Clippers","Paul George",2,29,36,32,11,44.3
2,2,7,0,0,9,5,4,3,"28",4,2,13,11,1,0,1037935,"2023-12-16T00:00:00.000Z",13,FALSE,20,493,"C",13,13,"LA Clippers","Ivica Zubac",3,24,26,15,13,38.2
4,0,1,4,2,8,4,3,3,"27",0,1,13,1,0,0,1037935,"2023-12-16T00:00:00.000Z",13,FALSE,20,666743,"G",13,13,"LA Clippers","Terance Mann",0,14,18,17,5,20.2
12,2,4,4,1,6,2,7,5,"28",0,3,10,4,1,1,1037935,"2023-12-16T00:00:00.000Z",13,FALSE,20,192,"G",13,13,"LA Clippers","James Harden",3,14,26,22,16,40.8
2,0,2,3,1,3,1,0,0,"05",0,1,3,2,0,0,1037935,"2023-12-16T00:00:00.000Z",13,FALSE,20,17896022,"G",13,13,"LA Clippers","Brandon Boston Jr.",0,5,7,5,4,8.4
0,0,0,3,2,3,2,0,0,"05",0,0,6,0,0,0,1037935,"2023-12-16T00:00:00.000Z",13,FALSE,20,56677849,"F",13,13,"LA Clippers","Kobe Brown",0,6,6,6,0,6
0,0,1,3,1,3,1,0,0,"17",0,3,3,1,0,0,1037935,"2023-12-16T00:00:00.000Z",13,FALSE,20,666511,"G",13,13,"LA Clippers","Amir Coffey",0,4,4,3,1,4.2
0,0,1,0,0,0,0,0,0,"05",0,0,0,1,0,1,1037935,"2023-12-16T00:00:00.000Z",13,FALSE,20,56677856,"G",13,13,"LA Clippers","Jordan Miller",0,1,1,0,1,0.2
1,0,2,0,0,0,0,0,0,"05",0,0,0,2,0,0,1037935,"2023-12-16T00:00:00.000Z",13,FALSE,20,24417679,"G",13,13,"LA Clippers","Xavier Moon",0,2,3,1,3,3.9
0,1,2,2,1,10,6,3,3,"24",0,1,16,2,0,1,1037935,"2023-12-16T00:00:00.000Z",13,FALSE,20,380,"F-G",13,13,"LA Clippers","Norman Powell",1,18,18,16,2,20.4
0,1,0,1,0,2,1,0,0,"05",0,0,2,0,0,3,1037935,"2023-12-16T00:00:00.000Z",13,FALSE,20,17896051,"G",13,13,"LA Clippers","Joshua Primo",1,2,2,2,0,2
0,0,1,0,0,3,1,6,5,"15",0,4,7,1,1,0,1037935,"2023-12-16T00:00:00.000Z",13,FALSE,20,439,"F",13,13,"LA Clippers","Daniel Theis",1,8,8,7,1,11.2
0,0,0,0,0,0,0,0,0,"00",0,0,0,0,0,0,1037935,"2023-12-16T00:00:00.000Z",13,FALSE,20,371,"F-C",13,13,"LA Clippers","Mason Plumlee",0,0,0,0,0,0
0,1,4,7,2,15,7,2,2,"28",1,1,18,5,0,1,1037935,"2023-12-16T00:00:00.000Z",13,FALSE,20,666423,"F-G",20,20,"New York Knicks","RJ Barrett",1,23,23,18,5,26
3,0,2,3,0,17,8,6,6,"31",2,3,22,4,0,3,1037935,"2023-12-16T00:00:00.000Z",13,FALSE,20,387,"F",20,20,"New York Knicks","Julius Randle",0,26,29,25,7,28.3
1,0,2,0,0,4,3,1,1,"18",0,3,7,2,1,0,1037935,"2023-12-16T00:00:00.000Z",13,FALSE,20,17896063,"F",20,20,"New York Knicks","Jericho Sims",1,9,10,8,3,13.9
0,0,0,0,0,0,0,0,0,"00",0,0,0,0,0,0,1037935,"2023-12-16T00:00:00.000Z",13,FALSE,20,450,"F",13,13,"LA Clippers","PJ Tucker",0,0,0,0,0,0
4,0,3,1,0,7,4,4,2,"15",3,1,10,6,1,0,1037935,"2023-12-16T00:00:00.000Z",13,FALSE,20,472,"G",13,13,"LA Clippers","Russell Westbrook",1,16,20,14,10,26.2
0,0,0,0,0,0,0,0,0,"00",0,0,0,0,0,0,1037935,"2023-12-16T00:00:00.000Z",13,FALSE,20,38017725,"F",13,13,"LA Clippers","Moussa Diabate",0,0,0,0,0,0
0,0,0,0,0,0,0,0,0,"00",0,0,0,0,0,0,1037935,"2023-12-16T00:00:00.000Z",13,FALSE,20,17896031,"G",13,13,"LA Clippers","Nah'Shon Hyland",0,0,0,0,0,0
1,0,1,8,5,8,5,3,3,"22",0,3,18,1,1,0,1037935,"2023-12-16T00:00:00.000Z",13,FALSE,20,131,"G",20,20,"New York Knicks","Donte DiVincenzo",1,19,20,19,2,23.7
6,0,5,5,2,17,7,6,6,"34",2,2,22,7,0,2,1037935,"2023-12-16T00:00:00.000Z",13,FALSE,20,73,"G",20,20,"New York Knicks","Jalen Brunson",0,29,35,28,13,37.4
2,3,4,0,0,7,5,4,2,"30",6,3,12,10,0,3,1037935,"2023-12-16T00:00:00.000Z",13,FALSE,20,201,"F-C",20,20,"New York Knicks","Isaiah Hartenstein",3,22,24,14,12,33
1,0,1,0,0,1,0,0,0,"08",0,2,0,1,1,1,1037935,"2023-12-16T00:00:00.000Z",13,FALSE,20,202,"G",20,20,"New York Knicks","Josh Hart",1,1,2,1,2,4.7
3,0,4,3,0,8,3,4,3,"19",0,0,9,4,0,0,1037935,"2023-12-16T00:00:00.000Z",13,FALSE,20,3547269,"G",20,20,"New York Knicks","Immanuel Quickley",0,13,16,12,7,18.3
0,0,0,1,0,1,0,0,0,"03",0,0,0,0,0,0,1037935,"2023-12-16T00:00:00.000Z",13,FALSE,20,19,"G",20,20,"New York Knicks","Ryan Arcidiacono",0,0,0,0,0,0
0,0,0,0,0,0,0,0,0,"00",0,0,0,0,0,0,1037935,"2023-12-16T00:00:00.000Z",13,FALSE,20,160,"G-F",20,20,"New York Knicks","Evan Fournier",0,0,0,0,0,0
0,0,0,2,0,3,1,0,0,"06",1,0,2,1,1,0,1037935,"2023-12-16T00:00:00.000Z",13,FALSE,20,173,"F",30,20,"New York Knicks","Taj Gibson",1,3,3,2,1,6.2
0,0,1,5,2,8,3,0,0,"24",0,3,8,1,1,0,1037935,"2023-12-16T00:00:00.000Z",13,FALSE,20,17895858,"G",20,20,"New York Knicks","Quentin Grimes",1,9,9,8,1,12.2
1,0,2,1,0,1,0,0,0,"06",0,0,0,2,0,0,1037935,"2023-12-16T00:00:00.000Z",13,FALSE,20,666675,"F",20,20,"New York Knicks","DaQuan Jeffries",0,2,3,1,3,3.9
2,0,1,0,0,4,2,0,0,"11",0,2,4,1,2,0,1037935,"2023-12-16T00:00:00.000Z",13,FALSE,20,17896033,"G",20,20,"New York Knicks","Miles McBride",2,5,7,6,3,14.2
0,0,0,0,0,0,0,0,0,"00",0,0,0,0,0,0,1037935,"2023-12-16T00:00:00.000Z",13,FALSE,20,666474,"G",20,20,"New York Knicks","Charles Brown",0,0,0,0,0,0
0,0,0,0,0,0,0,0,0,"00",0,0,0,0,0,0,1037935,"2023-12-16T00:00:00.000Z",13,FALSE,20,59421201,"G",20,20,"New York Knicks","Jaylen Martin",0,0,0,0,0,0
0,0,0,0,0,0,0,0,0,"00",0,0,0,0,0,0,1037935,"2023-12-16T00:00:00.000Z",13,FALSE,20,399,"C",20,20,"New York Knicks","Mitchell Robinson",0,0,0,0,0,0
0,0,0,0,0,0,0,0,0,"00",0,0,0,0,0,0,1037935,"2023-12-16T00:00:00.000Z",13,FALSE,20,56677795,"F",20,20,"New York Knicks","Jacob Toppin",0,0,0,0,0,0
3,0,3,9,4,19,7,6,6,"36",2,2,24,5,1,0,1037931,"2023-12-16T00:00:00.000Z",10,FALSE,3,443,"G",10,10,"Golden State Warriors","Klay Thompson",1,29,32,27,8,37.5
2,1,2,0,0,6,3,4,4,"21",2,1,10,4,0,1,1037931,"2023-12-16T00:00:00.000Z",10,FALSE,3,17553979,"F",10,10,"Golden State Warriors","Jonathan Kuminga",1,14,16,12,6,19.8
3,0,6,0,0,5,2,0,0,"27",1,2,4,7,1,0,1037931,"2023-12-16T00:00:00.000Z",10,FALSE,3,282,"F",10,10,"Golden State Warriors","Kevon Looney",1,11,14,7,10,19.9
5,1,4,9,4,15,7,2,1,"32",1,4,19,5,3,5,1037931,"2023-12-16T00:00:00.000Z",10,FALSE,3,56677858,"G",10,10,"Golden State Warriors","Brandin Podziemski",4,24,29,24,10,39.5
1,3,3,8,6,22,14,3,3,"35",0,1,37,3,0,3,1037931,"2023-12-16T00:00:00.000Z",10,FALSE,3,115,"G",10,10,"Golden State Warriors","Stephen Curry",3,40,41,38,4,48.1
11,0,4,2,0,4,1,0,0,"30",0,2,2,4,0,3,1037931,"2023-12-16T00:00:00.000Z",10,FALSE,3,367,"G",10,10,"Golden State Warriors","Chris Paul",0,6,17,13,15,20.3
0,0,0,0,0,0,0,0,0,"00",0,0,0,0,0,0,1037931,"2023-12-16T00:00:00.000Z",10,FALSE,3,158,"F",3,3,"Brooklyn Nets","Dorian Finney-Smith",0,0,0,0,0,0
0,0,0,0,0,0,0,0,0,"00",0,0,0,0,0,0,1037931,"2023-12-16T00:00:00.000Z",10,FALSE,3,174,"F-C",3,3,"Brooklyn Nets","Harry Giles III",0,0,0,0,0,0
3,1,2,9,3,10,4,0,0,"34",3,4,11,5,1,3,1037931,"2023-12-16T00:00:00.000Z",10,FALSE,3,351,"F",3,3,"Brooklyn Nets","Royce O'Neale",2,16,19,14,8,24.5
2,2,1,0,0,3,0,0,0,"09",3,3,0,4,0,0,1037931,"2023-12-16T00:00:00.000Z",10,FALSE,3,17896038,"C",3,3,"Brooklyn Nets","Day'Ron Sharpe",2,4,6,2,6,13.8
0,0,0,0,0,0,0,0,0,"00",0,0,0,0,0,0,1037931,"2023-12-16T00:00:00.000Z",10,FALSE,3,421,"G",3,3,"Brooklyn Nets","Dennis Smith Jr.",0,0,0,0,0,0
2,0,2,0,0,1,0,0,0,"08",0,1,0,2,0,1,1037931,"2023-12-16T00:00:00.000Z",10,FALSE,3,17896058,"F",3,3,"Brooklyn Nets","Trendon Watford",0,2,4,2,4,4.4
0,0,0,0,0,1,1,0,0,"08",1,1,2,1,0,1,1037931,"2023-12-16T00:00:00.000Z",10,FALSE,3,56677722,"F",3,3,"Brooklyn Nets","Jalen Wilson",0,3,3,2,1,2.2
0,0,0,0,0,0,0,0,0,"00",0,0,0,0,0,0,1037931,"2023-12-16T00:00:00.000Z",10,FALSE,3,9051997,"G",3,3,"Brooklyn Nets","Armoni Brooks",0,0,0,0,0,0
0,0,0,0,0,0,0,0,0,"00",0,0,0,0,0,0,1037931,"2023-12-16T00:00:00.000Z",10,FALSE,3,56677843,"F",3,3,"Brooklyn Nets","Noah Clowney",0,0,0,0,0,0
0,0,0,0,0,0,0,0,0,"00",0,0,0,0,0,0,1037931,"2023-12-16T00:00:00.000Z",10,FALSE,3,17896041,"G",3,3,"Brooklyn Nets","Keon Johnson",0,0,0,0,0,0
0,0,0,0,0,0,0,0,0,"00",0,0,0,0,0,0,1037931,"2023-12-16T00:00:00.000Z",10,FALSE,3,417,"G-F",3,3,"Brooklyn Nets","Ben Simmons",0,0,0,0,0,0
0,0,0,0,0,0,0,0,0,"00",0,0,0,0,0,0,1037931,"2023-12-16T00:00:00.000Z",10,FALSE,3,464,"G",3,3,"Brooklyn Nets","Lonnie Walker IV",0,0,0,0,0,0
0,0,0,0,0,0,0,0,0,"00",0,0,0,0,0,0,1037931,"2023-12-16T00:00:00.000Z",10,FALSE,3,56677841,"F",3,3,"Brooklyn Nets","Dariq Whitehead",0,0,0,0,0,0
0,0,0,0,0,0,0,0,0,"00",0,0,0,0,0,0,1037931,"2023-12-16T00:00:00.000Z",10,FALSE,3,2189,"",10,10,"Golden State Warriors","Gary Payton II",0,0,0,0,0,0
0,0,0,0,0,0,0,0,0,"00",0,0,0,0,0,0,1037931,"2023-12-16T00:00:00.000Z",10,FALSE,3,17896070,"F",10,10,"Golden State Warriors","Usman Garuba",0,0,0,0,0,0
0,0,0,0,0,0,0,0,0,"00",0,0,0,0,0,0,1037931,"2023-12-16T00:00:00.000Z",10,FALSE,3,45658838,"G",10,10,"Golden State Warriors","Lester Quinones",0,0,0,0,0,0
0,0,0,0,0,0,0,0,0,"00",0,0,0,0,0,0,1037931,"2023-12-16T00:00:00.000Z",10,FALSE,3,398,"G",10,10,"Golden State Warriors","Jerome Robinson",0,0,0,0,0,0
0,0,0,0,0,0,0,0,0,"00",0,0,0,0,0,0,1037931,"2023-12-16T00:00:00.000Z",10,FALSE,3,57875092,"F",10,10,"Golden State Warriors","Gui Santos",0,0,0,0,0,0
2,0,5,4,3,17,6,3,3,"42",1,1,18,6,1,2,1037931,"2023-12-16T00:00:00.000Z",10,FALSE,3,61,"F",3,3,"Brooklyn Nets","Mikal Bridges",1,24,26,20,8,29.2
5,0,2,7,3,12,5,1,0,"29",0,4,13,2,0,0,1037931,"2023-12-16T00:00:00.000Z",10,FALSE,3,666679,"F",3,3,"Brooklyn Nets","Cameron Johnson",0,15,20,18,7,22.9
2,0,3,3,2,8,5,0,0,"21",3,3,12,6,1,2,1037931,"2023-12-16T00:00:00.000Z",10,FALSE,3,407,"F",10,10,"Golden State Warriors","Dario Saric",1,18,20,14,8,23.2
1,0,3,1,1,9,4,5,5,"26",2,0,14,5,1,0,1037931,"2023-12-16T00:00:00.000Z",10,FALSE,3,475,"F-G",10,10,"Golden State Warriors","Andrew Wiggins",1,19,20,15,6,24.5
1,0,1,0,0,3,1,0,0,"12",2,0,2,3,0,0,1037931,"2023-12-16T00:00:00.000Z",10,FALSE,3,17553992,"G",10,10,"Golden State Warriors","Moses Moody",0,5,6,3,4,7.1
0,0,0,0,0,0,0,0,0,"00",0,0,0,0,0,0,1037931,"2023-12-16T00:00:00.000Z",10,FALSE,3,185,"F",10,10,"Golden State Warriors","Draymond Green",0,0,0,0,0,0
0,0,0,0,0,0,0,0,0,"00",0,0,0,0,0,0,1037931,"2023-12-16T00:00:00.000Z",10,FALSE,3,56677799,"F",10,10,"Golden State Warriors","Trayce Jackson-Davis",0,0,0,0,0,0
0,0,0,0,0,0,0,0,0,"00",0,0,0,0,0,0,1037931,"2023-12-16T00:00:00.000Z",10,FALSE,3,251,"G",10,10,"Golden State Warriors","Cory Joseph",0,0,0,0,0,0
1,4,7,0,0,12,8,3,3,"33",5,1,19,12,0,2,1037931,"2023-12-16T00:00:00.000Z",10,FALSE,3,666508,"F-C",3,3,"Brooklyn Nets","Nicolas Claxton",4,31,32,20,13,44.9
2,0,5,13,5,24,15,6,6,"37",0,5,41,5,1,5,1037931,"2023-12-16T00:00:00.000Z",10,FALSE,3,17896048,"G",3,3,"Brooklyn Nets","Cam Thomas",1,46,48,43,7,48
14,1,4,10,3,13,6,2,1,"40",1,1,16,5,3,2,1037931,"2023-12-16T00:00:00.000Z",10,FALSE,3,130,"G",3,3,"Brooklyn Nets","Spencer Dinwiddie",4,21,35,30,19,53
1,0,5,2,1,3,2,0,0,"23",2,2,5,7,0,1,1037939,"2023-12-17T00:00:00.000Z",24,FALSE,30,666729,"F",24,24,"Phoenix Suns","Nassir Little",0,12,13,6,8,13.9
5,1,2,2,0,24,11,9,6,"35",3,1,28,5,1,2,1037939,"2023-12-17T00:00:00.000Z",24,FALSE,30,140,"F",24,24,"Phoenix Suns","Kevin Durant",2,33,38,33,10,45.5
5,1,14,1,0,7,2,4,2,"30",3,5,6,17,1,2,1037939,"2023-12-17T00:00:00.000Z",24,FALSE,30,349,"C",24,24,"Phoenix Suns","Jusuf Nurkic",2,23,28,11,22,37.9
3,2,3,6,1,8,2,6,6,"33",1,2,11,4,2,1,1037939,"2023-12-17T00:00:00.000Z",24,FALSE,30,8,"G",24,24,"Phoenix Suns","Grayson Allen",4,15,18,14,7,31.3
8,1,4,11,3,24,10,5,4,"42",0,4,27,4,1,5,1037939,"2023-12-17T00:00:00.000Z",24,FALSE,30,57,"G",24,24,"Phoenix Suns","Devin Booker",2,31,39,35,12,44.8
1,0,2,6,2,9,5,2,1,"30",0,0,13,2,1,1,1037939,"2023-12-17T00:00:00.000Z",24,FALSE,30,178,"G",24,24,"Phoenix Suns","Eric Gordon",1,15,16,14,3,18.9
6,0,5,3,0,7,3,0,0,"20",3,2,6,8,0,2,1037939,"2023-12-17T00:00:00.000Z",24,FALSE,30,18678058,"",24,24,"Phoenix Suns","Jordan Goodwin",0,14,20,12,14,22.6
0,1,4,0,0,7,5,2,2,"18",1,0,12,5,1,2,1037939,"2023-12-17T00:00:00.000Z",24,FALSE,30,147,"F",24,24,"Phoenix Suns","Drew Eubanks",2,17,17,12,5,22
0,0,2,0,0,1,1,2,2,"09",0,0,4,2,1,1,1037939,"2023-12-17T00:00:00.000Z",24,FALSE,30,314,"F",24,24,"Phoenix Suns","Chimezie Metu",1,6,6,4,2,8.4
0,0,0,0,0,0,0,0,0,"00",0,0,0,0,0,0,1037939,"2023-12-17T00:00:00.000Z",24,FALSE,30,32,"F",24,24,"Phoenix Suns","Keita Bates-Diop",0,0,0,0,0,0
0,0,0,0,0,0,0,0,0,"00",0,0,0,0,0,0,1037939,"2023-12-17T00:00:00.000Z",24,FALSE,30,666451,"C",24,24,"Phoenix Suns","Bol Bol",0,0,0,0,0,0
0,0,0,0,0,0,0,0,0,"00",0,0,0,0,0,0,1037939,"2023-12-17T00:00:00.000Z",24,FALSE,30,470,"G",24,24,"Phoenix Suns","Yuta Watanabe",0,0,0,0,0,0
0,0,0,0,0,0,0,0,0,"00",0,0,0,0,0,0,1037939,"2023-12-17T00:00:00.000Z",24,FALSE,30,3547095,"C-F",24,24,"Phoenix Suns","Udoka Azubuike",0,0,0,0,0,0
0,0,0,0,0,0,0,0,0,"00",0,0,0,0,0,0,1037939,"2023-12-17T00:00:00.000Z",24,FALSE,30,37,"G",24,24,"Phoenix Suns","Bradley Beal",0,0,0,0,0,0
0,0,0,0,0,0,0,0,0,"00",0,0,0,0,0,0,1037939,"2023-12-17T00:00:00.000Z",24,FALSE,30,272,"G",24,24,"Phoenix Suns","Damion Lee",0,0,0,0,0,0
0,0,0,0,0,0,0,0,0,"00",0,0,0,0,0,0,1037939,"2023-12-17T00:00:00.000Z",24,FALSE,30,3547298,"G",24,24,"Phoenix Suns","Saben Lee",0,0,0,0,0,0
0,0,0,0,0,0,0,0,0,"00",0,0,0,0,0,0,1037939,"2023-12-17T00:00:00.000Z",24,FALSE,30,3547253,"G",4,24,"Phoenix Suns","Theo Maledon",0,0,0,0,0,0
0,0,0,0,0,0,0,0,0,"00",0,0,0,0,0,0,1037939,"2023-12-17T00:00:00.000Z",24,FALSE,30,356,"G",24,24,"Phoenix Suns","Josh Okogie",0,0,0,0,0,0
2,0,6,1,0,6,2,4,3,"32",0,5,7,6,0,2,1037939,"2023-12-17T00:00:00.000Z",24,FALSE,30,3547242,"F",30,30,"Washington Wizards","Deni Avdija",0,13,15,9,8,15.2
2,2,6,13,3,22,7,2,0,"34",1,6,17,7,0,2,1037939,"2023-12-17T00:00:00.000Z",24,FALSE,30,265,"F",30,30,"Washington Wizards","Kyle Kuzma",2,24,26,19,9,32.4
3,2,10,0,0,13,10,7,6,"35",7,4,26,17,0,1,1037939,"2023-12-17T00:00:00.000Z",24,FALSE,30,666577,"F",30,30,"Washington Wizards","Daniel Gafford",2,43,46,29,20,55.9
4,0,4,9,2,17,5,2,2,"32",0,4,14,4,1,4,1037939,"2023-12-17T00:00:00.000Z",24,FALSE,30,666848,"G",30,30,"Washington Wizards","Jordan Poole",1,18,22,18,8,23.8
11,1,4,6,4,15,9,0,0,"38",0,0,22,4,6,1,1037939,"2023-12-17T00:00:00.000Z",24,FALSE,30,249,"G",30,30,"Washington Wizards","Tyus Jones",7,26,37,33,15,63.3
1,0,1,6,2,7,2,0,0,"20",0,3,6,1,0,0,1037939,"2023-12-17T00:00:00.000Z",24,FALSE,30,56677844,"G",30,30,"Washington Wizards","Bilal Coulibaly",0,7,8,7,2,8.7
1,1,0,7,2,9,2,0,0,"25",0,2,6,0,0,0,1037939,"2023-12-17T00:00:00.000Z",24,FALSE,30,17896045,"F",30,30,"Washington Wizards","Corey Kispert",1,6,7,7,1,10.5
0,0,1,2,1,2,1,3,3,"12",0,0,6,1,1,0,1037939,"2023-12-17T00:00:00.000Z",24,FALSE,30,167,"F",30,30,"Washington Wizards","Danilo Gallinari",1,7,7,6,1,10.2
0,0,2,2,0,4,1,2,2,"10",2,1,4,4,0,0,1037939,"2023-12-17T00:00:00.000Z",24,FALSE,30,337,"F-C",30,30,"Washington Wizards","Mike Muscala",0,8,8,4,4,8.8
0,0,0,0,0,0,0,0,0,"00",0,0,0,0,0,0,1037939,"2023-12-17T00:00:00.000Z",24,FALSE,30,NA,NA,NA,30,"Washington Wizards","NA NA",0,0,0,0,0,0
0,0,0,0,0,0,0,0,0,"00",0,0,0,0,0,0,1037939,"2023-12-17T00:00:00.000Z",24,FALSE,30,18677954,"G",30,30,"Washington Wizards","Jared Butler",0,0,0,0,0,0
0,0,0,0,0,0,0,0,0,"01",0,0,0,0,0,0,1037939,"2023-12-17T00:00:00.000Z",24,FALSE,30,3547302,"F",30,30,"Washington Wizards","Anthony Gill",0,0,0,0,0,0
0,0,0,0,0,0,0,0,0,"01",0,0,0,0,0,0,1037939,"2023-12-17T00:00:00.000Z",24,FALSE,30,17896106,"F",30,30,"Washington Wizards","Eugene Omoruyi",0,0,0,0,0,0
0,0,0,0,0,0,0,0,0,"00",0,0,0,0,0,0,1037939,"2023-12-17T00:00:00.000Z",24,FALSE,30,38017704,"F",30,30,"Washington Wizards","Patrick Baldwin Jr.",0,0,0,0,0,0
0,0,0,0,0,0,0,0,0,"00",0,0,0,0,0,0,1037939,"2023-12-17T00:00:00.000Z",24,FALSE,30,38017712,"G",30,30,"Washington Wizards","Ryan Rollins",0,0,0,0,0,0
0,0,0,0,0,0,0,0,0,"00",0,0,0,0,0,0,1037939,"2023-12-17T00:00:00.000Z",24,FALSE,30,414,"G",30,30,"Washington Wizards","Landry Shamet",0,0,0,0,0,0
0,0,0,0,0,0,0,0,0,"00",0,0,0,0,0,0,1037939,"2023-12-17T00:00:00.000Z",24,FALSE,30,487,"G",30,30,"Washington Wizards","Delon Wright",0,0,0,0,0,0
0,0,0,0,0,0,0,0,0,"00",0,0,0,0,0,0,1037939,"2023-12-17T00:00:00.000Z",24,FALSE,30,38017687,"G",30,30,"Washington Wizards","Johnny Davis",0,0,0,0,0,0
0,0,2,3,3,4,3,4,2,"22",1,2,11,3,2,1,1037940,"2023-12-17T00:00:00.000Z",25,FALSE,10,56677850,"F",25,25,"Portland Trail Blazers","Toumani Camara",2,14,14,11,3,19.6
6,0,6,9,3,19,11,5,5,"41",1,4,30,7,1,3,1037940,"2023-12-17T00:00:00.000Z",25,FALSE,10,182,"F",25,25,"Portland Trail Blazers","Jerami Grant",1,37,43,36,13,47.4
1,1,5,0,0,8,4,0,0,"33",3,0,8,8,0,1,1037940,"2023-12-17T00:00:00.000Z",25,FALSE,10,22,"C",25,25,"Portland Trail Blazers","Deandre Ayton",1,16,17,9,9,21.1
1,0,4,5,3,10,4,1,1,"27",1,3,12,5,1,2,1037940,"2023-12-17T00:00:00.000Z",25,FALSE,10,38017690,"G",25,25,"Portland Trail Blazers","Shaedon Sharpe",1,17,18,13,6,20.5
7,0,3,5,0,20,9,6,6,"35",0,3,24,3,1,4,1037940,"2023-12-17T00:00:00.000Z",25,FALSE,10,419,"G",25,25,"Portland Trail Blazers","Anfernee Simons",1,27,34,31,10,37.1
5,0,1,5,2,8,3,0,0,"27",0,1,8,1,0,0,1037940,"2023-12-17T00:00:00.000Z",25,FALSE,10,65,"G",25,25,"Portland Trail Blazers","Malcolm Brogdon",0,9,14,13,6,16.7
0,0,0,0,0,0,0,0,0,"00",0,0,0,0,0,0,1037940,"2023-12-17T00:00:00.000Z",25,FALSE,10,666476,"C",25,25,"Portland Trail Blazers","Moses Brown",0,0,0,0,0,0
2,0,1,4,1,9,4,5,5,"22",0,2,14,1,1,1,1037940,"2023-12-17T00:00:00.000Z",25,FALSE,10,56677747,"G",25,25,"Portland Trail Blazers","Scoot Henderson",1,15,17,16,3,20.2
0,0,0,0,0,0,0,0,0,"00",0,0,0,0,0,0,1037940,"2023-12-17T00:00:00.000Z",25,FALSE,10,3547289,"G",25,25,"Portland Trail Blazers","Skylar Mays",0,0,0,0,0,0
0,0,0,0,0,0,0,0,0,"00",0,0,0,0,0,0,1037940,"2023-12-17T00:00:00.000Z",25,FALSE,10,56677791,"F",25,25,"Portland Trail Blazers","Kris Murray",0,0,0,0,0,0
0,0,0,0,0,0,0,0,0,"00",0,0,0,0,0,0,1037940,"2023-12-17T00:00:00.000Z",25,FALSE,10,56783340,"C",25,25,"Portland Trail Blazers","Duop Reath",0,0,0,0,0,0
1,2,3,4,1,4,1,0,0,"18",1,1,3,4,3,0,1037940,"2023-12-17T00:00:00.000Z",25,FALSE,10,666923,"G-F",25,25,"Portland Trail Blazers","Matisse Thybulle",5,7,8,4,5,24.3
0,0,0,0,0,0,0,0,0,"00",0,0,0,0,0,0,1037940,"2023-12-17T00:00:00.000Z",25,FALSE,10,17896120,"F",25,25,"Portland Trail Blazers","Ish Wainright",0,0,0,0,0,0
0,1,3,0,0,3,1,2,2,"15",2,4,4,5,1,1,1037940,"2023-12-17T00:00:00.000Z",25,FALSE,10,38017711,"F",25,25,"Portland Trail Blazers","Jabari Walker",2,9,9,4,5,15
0,0,0,0,0,0,0,0,0,"00",0,0,0,0,0,0,1037940,"2023-12-17T00:00:00.000Z",25,FALSE,10,39613724,"C",25,25,"Portland Trail Blazers","Ibou Badji",0,0,0,0,0,0
0,0,0,0,0,0,0,0,0,"00",0,0,0,0,0,0,1037940,"2023-12-17T00:00:00.000Z",25,FALSE,10,47957121,"F",25,25,"Portland Trail Blazers","Justin Minaya",0,0,0,0,0,0
0,0,0,0,0,0,0,0,0,"00",0,0,0,0,0,0,1037940,"2023-12-17T00:00:00.000Z",25,FALSE,10,56677829,"G-F",25,25,"Portland Trail Blazers","Rayan Rupert",0,0,0,0,0,0
0,0,0,0,0,0,0,0,0,"00",0,0,0,0,0,0,1037940,"2023-12-17T00:00:00.000Z",25,FALSE,10,476,"C-F",25,25,"Portland Trail Blazers","Robert Williams III",0,0,0,0,0,0
1,0,4,10,5,16,11,1,1,"29",0,3,28,4,1,1,1037940,"2023-12-17T00:00:00.000Z",25,FALSE,10,443,"G",10,10,"Golden State Warriors","Klay Thompson",1,32,33,29,5,36.3
0,0,2,3,2,7,5,4,0,"19",2,3,12,4,1,1,1037940,"2023-12-17T00:00:00.000Z",25,FALSE,10,17553979,"F",10,10,"Golden State Warriors","Jonathan Kuminga",1,16,16,12,4,18.8
2,1,3,0,0,5,2,0,0,"15",1,2,4,4,1,0,1037940,"2023-12-17T00:00:00.000Z",25,FALSE,10,282,"F",10,10,"Golden State Warriors","Kevon Looney",2,8,10,6,6,17.8
5,0,5,2,0,8,4,2,2,"33",0,3,10,5,1,1,1037940,"2023-12-17T00:00:00.000Z",25,FALSE,10,56677858,"G",10,10,"Golden State Warriors","Brandin Podziemski",1,15,20,15,10,25.5
8,1,2,8,0,12,2,4,3,"31",0,1,7,2,1,4,1037940,"2023-12-17T00:00:00.000Z",25,FALSE,10,115,"G",10,10,"Golden State Warriors","Stephen Curry",2,9,17,15,10,23.4
0,0,0,0,0,0,0,0,0,"00",0,0,0,0,0,0,1037940,"2023-12-17T00:00:00.000Z",25,FALSE,10,185,"F",10,10,"Golden State Warriors","Draymond Green",0,0,0,0,0,0
3,1,3,0,0,9,6,2,2,"18",5,2,14,8,2,2,1037940,"2023-12-17T00:00:00.000Z",25,FALSE,10,56677799,"F",10,10,"Golden State Warriors","Trayce Jackson-Davis",3,22,25,17,11,35.1
0,0,0,0,0,0,0,0,0,"00",0,0,0,0,0,0,1037940,"2023-12-17T00:00:00.000Z",25,FALSE,10,251,"G",10,10,"Golden State Warriors","Cory Joseph",0,0,0,0,0,0
1,0,2,2,0,7,3,0,0,"19",2,0,6,4,1,1,1037940,"2023-12-17T00:00:00.000Z",25,FALSE,10,17553992,"G",10,10,"Golden State Warriors","Moses Moody",1,10,11,7,5,14.3
8,0,3,4,0,7,2,0,0,"32",1,1,4,4,1,2,1037940,"2023-12-17T00:00:00.000Z",25,FALSE,10,367,"G",10,10,"Golden State Warriors","Chris Paul",1,8,16,12,12,21.8
0,0,0,0,0,0,0,0,0,"00",0,0,0,0,0,0,1037940,"2023-12-17T00:00:00.000Z",25,FALSE,10,2189,"",10,10,"Golden State Warriors","Gary Payton II",0,0,0,0,0,0
1,0,1,3,2,4,2,2,2,"15",0,3,8,1,0,2,1037940,"2023-12-17T00:00:00.000Z",25,FALSE,10,407,"F",10,10,"Golden State Warriors","Dario Saric",0,9,10,9,2,8.7
2,1,7,6,4,12,9,4,3,"29",0,2,25,7,1,0,1037940,"2023-12-17T00:00:00.000Z",25,FALSE,10,475,"F-G",10,10,"Golden State Warriors","Andrew Wiggins",2,32,34,27,9,42.4
0,0,0,0,0,0,0,0,0,"00",0,0,0,0,0,0,1037940,"2023-12-17T00:00:00.000Z",25,FALSE,10,398,"G",10,10,"Golden State Warriors","Jerome Robinson",0,0,0,0,0,0
0,0,0,0,0,0,0,0,0,"00",0,0,0,0,0,0,1037940,"2023-12-17T00:00:00.000Z",25,FALSE,10,57875092,"F",10,10,"Golden State Warriors","Gui Santos",0,0,0,0,0,0
0,0,0,0,0,0,0,0,0,"00",0,0,0,0,0,0,1037940,"2023-12-17T00:00:00.000Z",25,FALSE,10,17896070,"F",10,10,"Golden State Warriors","Usman Garuba",0,0,0,0,0,0
0,0,0,0,0,0,0,0,0,"00",0,0,0,0,0,0,1037940,"2023-12-17T00:00:00.000Z",25,FALSE,10,45658838,"G",10,10,"Golden State Warriors","Lester Quinones",0,0,0,0,0,0
6,1,4,8,5,20,12,2,2,"34",1,4,31,5,1,2,1037936,"2023-12-17T00:00:00.000Z",2,FALSE,22,70,"G",2,2,"Boston Celtics","Jaylen Brown",2,36,42,37,11,50
3,1,5,6,4,21,8,4,3,"31",3,3,23,8,0,1,1037936,"2023-12-17T00:00:00.000Z",2,FALSE,22,434,"F",2,2,"Boston Celtics","Jayson Tatum",1,31,34,26,11,39.1
0,1,9,4,2,12,6,1,1,"29",1,2,15,10,1,4,1037936,"2023-12-17T00:00:00.000Z",2,FALSE,22,378,"F-C",2,2,"Boston Celtics","Kristaps Porzingis",2,25,25,15,10,29
4,3,5,5,1,9,4,1,1,"27",0,1,10,5,1,2,1037936,"2023-12-17T00:00:00.000Z",2,FALSE,22,473,"G",2,2,"Boston Celtics","Derrick White",4,15,19,14,9,32
0,2,5,5,2,12,6,0,0,"34",1,2,14,6,0,3,1037936,"2023-12-17T00:00:00.000Z",2,FALSE,22,214,"G",2,2,"Boston Celtics","Jrue Holiday",2,20,20,14,6,24.2
0,0,0,1,0,2,1,0,0,"02",0,0,2,0,0,0,1037936,"2023-12-17T00:00:00.000Z",2,FALSE,22,17896094,"G",2,2,"Boston Celtics","Dalano Banton",0,2,2,2,0,2
0,0,2,0,0,0,0,0,0,"03",0,0,0,2,0,0,1037936,"2023-12-17T00:00:00.000Z",2,FALSE,22,666468,"F",2,2,"Boston Celtics","Oshae Brissett",0,2,2,0,2,2.4
0,0,1,3,0,5,2,0,0,"17",1,0,4,2,1,1,1037936,"2023-12-17T00:00:00.000Z",2,FALSE,22,17896060,"F",2,2,"Boston Celtics","Sam Hauser",1,6,6,4,2,8.4
2,1,7,3,2,7,3,0,0,"24",1,2,8,8,0,0,1037936,"2023-12-17T00:00:00.000Z",2,FALSE,22,219,"C-F",2,2,"Boston Celtics","Al Horford",1,16,18,10,10,23.6
0,0,0,0,0,0,0,0,0,"00",0,0,0,0,0,0,1037936,"2023-12-17T00:00:00.000Z",2,FALSE,22,338,"G",2,2,"Boston Celtics","Svi Mykhailiuk",0,0,0,0,0,0
3,1,4,1,1,5,2,0,0,"21",2,3,5,6,0,1,1037936,"2023-12-17T00:00:00.000Z",2,FALSE,22,3547276,"G",2,2,"Boston Celtics","Payton Pritchard",1,11,14,8,9,18.7
0,0,3,0,0,2,1,0,0,"16",0,1,2,3,0,0,1037936,"2023-12-17T00:00:00.000Z",2,FALSE,22,17553967,"C",2,2,"Boston Celtics","Neemias Queta",0,5,5,2,3,5.6
0,0,0,0,0,0,0,0,0,"02",0,1,0,0,0,0,1037936,"2023-12-17T00:00:00.000Z",2,FALSE,22,3547279,"F",2,2,"Boston Celtics","Lamar Stevens",0,0,0,0,0,0
0,0,0,0,0,0,0,0,0,"00",0,0,0,0,0,0,1037936,"2023-12-17T00:00:00.000Z",2,FALSE,22,38017707,"G",2,2,"Boston Celtics","JD Davison",0,0,0,0,0,0
0,0,0,0,0,0,0,0,0,"00",0,0,0,0,0,0,1037936,"2023-12-17T00:00:00.000Z",2,FALSE,22,261,"F-C",2,2,"Boston Celtics","Luke Kornet",0,0,0,0,0,0
0,0,0,0,0,0,0,0,0,"00",0,0,0,0,0,0,1037936,"2023-12-17T00:00:00.000Z",2,FALSE,22,NA,NA,NA,2,"Boston Celtics","NA NA",0,0,0,0,0,0
0,0,0,0,0,0,0,0,0,"00",0,0,0,0,0,0,1037936,"2023-12-17T00:00:00.000Z",2,FALSE,22,56677864,"G",2,2,"Boston Celtics","Jordan Walsh",0,0,0,0,0,0
6,0,6,4,0,14,3,2,2,"37",2,2,8,8,0,0,1037936,"2023-12-17T00:00:00.000Z",2,FALSE,22,17896026,"F",22,22,"Orlando Magic","Franz Wagner",0,16,22,14,14,26.6
1,0,8,10,4,30,14,6,4,"36",2,0,36,10,2,4,1037936,"2023-12-17T00:00:00.000Z",2,FALSE,22,38017683,"F",22,22,"Orlando Magic","Paolo Banchero",2,46,47,37,11,51.5
1,3,6,0,0,6,2,0,0,"26",2,3,4,8,2,1,1037936,"2023-12-17T00:00:00.000Z",2,FALSE,22,666442,"C",22,22,"Orlando Magic","Goga Bitadze",5,12,13,5,9,29.1
0,0,5,4,1,9,5,2,2,"28",0,4,13,5,1,2,1037936,"2023-12-17T00:00:00.000Z",2,FALSE,22,17896073,"G",22,22,"Orlando Magic","Jalen Suggs",1,18,18,13,5,20
3,0,1,3,1,5,2,3,0,"17",1,1,5,2,1,0,1037936,"2023-12-17T00:00:00.000Z",2,FALSE,22,56677827,"G",22,22,"Orlando Magic","Anthony Black",1,7,10,8,5,14.9
4,0,0,2,0,8,2,2,2,"19",1,0,6,1,0,1,1037936,"2023-12-17T00:00:00.000Z",2,FALSE,22,3547251,"G",22,22,"Orlando Magic","Cole Anthony",0,7,11,10,5,12.2
2,0,1,3,0,3,0,0,0,"26",0,1,0,1,0,0,1037936,"2023-12-17T00:00:00.000Z",2,FALSE,22,196,"G",22,22,"Orlando Magic","Gary Harris",0,1,3,2,3,4.2
0,0,1,3,1,4,2,3,3,"16",2,2,8,3,0,0,1037936,"2023-12-17T00:00:00.000Z",2,FALSE,22,38017724,"G",22,22,"Orlando Magic","Caleb Houstan",0,11,11,8,3,11.6
0,0,0,1,1,2,1,0,0,"02",0,0,3,0,0,0,1037936,"2023-12-17T00:00:00.000Z",2,FALSE,22,56677839,"G",22,22,"Orlando Magic","Jett Howard",0,3,3,3,0,3
0,0,0,0,0,0,0,0,0,"00",0,0,0,0,0,0,1037936,"2023-12-17T00:00:00.000Z",2,FALSE,22,226,"F",22,22,"Orlando Magic","Joe Ingles",0,0,0,0,0,0
0,1,2,4,2,5,2,2,2,"17",0,0,8,2,1,0,1037936,"2023-12-17T00:00:00.000Z",2,FALSE,22,229,"F",22,22,"Orlando Magic","Jonathan Isaac",2,10,10,8,2,16.4
0,0,1,0,0,0,0,0,0,"02",0,0,0,1,0,0,1037936,"2023-12-17T00:00:00.000Z",2,FALSE,22,666818,"F",22,22,"Orlando Magic","Chuma Okeke",0,1,1,0,1,1.2
0,0,2,2,1,3,1,4,3,"12",0,3,6,2,0,0,1037936,"2023-12-17T00:00:00.000Z",2,FALSE,22,462,"C",22,22,"Orlando Magic","Moritz Wagner",0,8,8,6,2,8.4
0,0,0,0,0,0,0,0,0,"00",0,0,0,0,0,0,1037936,"2023-12-17T00:00:00.000Z",2,FALSE,22,85,"F",22,22,"Orlando Magic","Wendell Carter Jr.",0,0,0,0,0,0
0,0,0,0,0,0,0,0,0,"00",0,0,0,0,0,0,1037936,"2023-12-17T00:00:00.000Z",2,FALSE,22,165,"G",22,22,"Orlando Magic","Markelle Fultz",0,0,0,0,0,0
0,0,0,0,0,0,0,0,0,"00",0,0,0,0,0,0,1037936,"2023-12-17T00:00:00.000Z",2,FALSE,22,38017607,"G",22,22,"Orlando Magic","Kevon Harris",0,0,0,0,0,0
0,0,0,0,0,0,0,0,0,"00",0,0,0,0,0,0,1037936,"2023-12-17T00:00:00.000Z",2,FALSE,22,17553983,"G",22,22,"Orlando Magic","Trevelin Queen",0,0,0,0,0,0
1,0,0,0,0,0,0,0,0,"02",0,0,0,0,0,0,1037936,"2023-12-17T00:00:00.000Z",2,FALSE,22,666885,"F",22,22,"Orlando Magic","Admiral Schofield",0,0,1,1,1,1.5
3,0,2,7,3,13,5,1,0,"30",0,2,13,2,0,1,1037937,"2023-12-17T00:00:00.000Z",27,FALSE,19,3547246,"G-F",27,27,"San Antonio Spurs","Devin Vassell",0,15,18,16,5,18.9
3,0,4,4,0,18,6,2,1,"31",4,2,13,8,4,5,1037937,"2023-12-17T00:00:00.000Z",27,FALSE,19,666682,"F",27,27,"San Antonio Spurs","Keldon Johnson",4,21,24,16,11,34.1
4,4,12,6,2,13,6,4,3,"31",1,2,17,13,1,3,1037937,"2023-12-17T00:00:00.000Z",27,FALSE,19,56677822,"F-C",27,27,"San Antonio Spurs","Victor Wembanyama",5,30,34,21,17,50.6
2,0,2,3,1,8,4,2,2,"30",0,1,11,2,0,2,1037937,"2023-12-17T00:00:00.000Z",27,FALSE,19,38017692,"F",27,27,"San Antonio Spurs","Malaki Branham",0,13,15,13,4,14.4
4,0,2,0,0,7,1,4,3,"25",1,1,5,3,1,0,1037937,"2023-12-17T00:00:00.000Z",27,FALSE,19,38017699,"F",27,27,"San Antonio Spurs","Jeremy Sochan",1,8,12,9,7,17.6
1,2,0,6,5,6,5,0,0,"14",1,0,15,1,0,0,1037937,"2023-12-17T00:00:00.000Z",27,FALSE,19,38017649,"F",27,27,"San Antonio Spurs","Julian Champagnie",2,16,17,16,2,23.7
2,0,4,1,0,3,1,0,0,"16",1,2,2,5,0,0,1037937,"2023-12-17T00:00:00.000Z",27,FALSE,19,102,"F-C",27,27,"San Antonio Spurs","Zach Collins",0,7,9,4,7,11
2,0,0,3,2,3,2,2,1,"07",0,1,7,0,0,0,1037937,"2023-12-17T00:00:00.000Z",27,FALSE,19,180,"G",27,27,"San Antonio Spurs","Devonte' Graham",0,7,9,9,2,10
5,0,0,2,0,5,2,0,0,"16",0,1,4,0,0,0,1037937,"2023-12-17T00:00:00.000Z",27,FALSE,19,3547274,"G",27,27,"San Antonio Spurs","Tre Jones",0,4,9,9,5,11.5
2,0,0,3,0,4,1,0,0,"08",0,0,2,0,0,1,1037937,"2023-12-17T00:00:00.000Z",27,FALSE,19,17896059,"F",27,27,"San Antonio Spurs","Sandro Mamukelashvili",0,2,4,4,2,4
1,0,1,5,1,7,2,2,2,"15",1,1,7,2,0,0,1037937,"2023-12-17T00:00:00.000Z",27,FALSE,19,305,"F",27,27,"San Antonio Spurs","Doug McDermott",0,9,10,8,3,10.9
0,0,3,2,1,7,5,4,3,"17",0,2,14,3,0,1,1037937,"2023-12-17T00:00:00.000Z",27,FALSE,19,359,"F",27,27,"San Antonio Spurs","Cedi Osman",0,17,17,14,3,16.6
0,0,0,0,0,0,0,0,0,"00",0,0,0,0,0,0,1037937,"2023-12-17T00:00:00.000Z",27,FALSE,19,38017730,"F",27,27,"San Antonio Spurs","Dominick Barlow",0,0,0,0,0,0
0,0,0,0,0,0,0,0,0,"00",0,0,0,0,0,0,1037937,"2023-12-17T00:00:00.000Z",27,FALSE,19,17895854,"G",27,27,"San Antonio Spurs","Charles Bassey",0,0,0,0,0,0
0,0,0,0,0,0,0,0,0,"00",0,0,0,0,0,0,1037937,"2023-12-17T00:00:00.000Z",27,FALSE,19,56677865,"C",27,27,"San Antonio Spurs","Charles Bediako",0,0,0,0,0,0
0,0,0,0,0,0,0,0,0,"00",0,0,0,0,0,0,1037937,"2023-12-17T00:00:00.000Z",27,FALSE,19,56677817,"G",27,27,"San Antonio Spurs","Sidy Cissoko",0,0,0,0,0,0
0,0,0,0,0,0,0,0,0,"00",0,0,0,0,0,0,1037937,"2023-12-17T00:00:00.000Z",27,FALSE,19,17896049,"G",3,27,"San Antonio Spurs","David Duke Jr.",0,0,0,0,0,0
0,0,0,0,0,0,0,0,0,"00",0,0,0,0,0,0,1037937,"2023-12-17T00:00:00.000Z",27,FALSE,19,38017693,"G",27,27,"San Antonio Spurs","Blake Wesley",0,0,0,0,0,0
3,1,3,1,0,12,7,4,1,"26",5,2,15,8,2,1,1037937,"2023-12-17T00:00:00.000Z",27,FALSE,19,666969,"F",19,19,"New Orleans Pelicans","Zion Williamson",3,23,26,18,11,37.1
3,1,12,4,1,13,6,3,2,"23",4,3,15,16,1,1,1037937,"2023-12-17T00:00:00.000Z",27,FALSE,19,455,"C",19,19,"New Orleans Pelicans","Jonas Valanciunas",2,31,34,18,19,43.7
3,0,0,3,0,5,0,2,2,"19",1,3,2,1,1,2,1037937,"2023-12-17T00:00:00.000Z",27,FALSE,19,17896024,"F",19,19,"New Orleans Pelicans","Herbert Jones",1,3,6,5,4,8.7
2,0,2,7,6,15,10,3,3,"26",0,2,29,2,1,3,1037937,"2023-12-17T00:00:00.000Z",27,FALSE,19,303,"G",19,19,"New Orleans Pelicans","CJ McCollum",1,31,33,31,4,34.4
4,0,3,5,3,7,5,4,3,"22",0,0,16,3,1,1,1037937,"2023-12-17T00:00:00.000Z",27,FALSE,19,17896097,"G",19,19,"New Orleans Pelicans","Jose Alvarado",1,19,23,20,7,27.6
4,0,3,2,1,4,2,0,0,"18",1,0,5,4,1,1,1037937,"2023-12-17T00:00:00.000Z",27,FALSE,19,38017677,"G",19,19,"New Orleans Pelicans","Dyson Daniels",1,9,13,9,8,17.8
0,0,2,4,1,6,3,0,0,"12",0,0,7,2,0,0,1037937,"2023-12-17T00:00:00.000Z",27,FALSE,19,56677837,"G",19,19,"New Orleans Pelicans","Jordan Hawkins",0,9,9,7,2,9.4
7,0,3,4,3,6,4,2,0,"20",0,3,11,3,2,2,1037937,"2023-12-17T00:00:00.000Z",27,FALSE,19,3547293,"F",19,19,"New Orleans Pelicans","Naji Marshall",2,14,21,18,10,29.1
4,0,4,5,2,10,5,3,2,"25",0,1,14,4,1,0,1037937,"2023-12-17T00:00:00.000Z",27,FALSE,19,18677986,"F",19,19,"New Orleans Pelicans","Trey Murphy III",1,18,22,18,8,27.8
0,0,1,0,0,2,2,0,0,"04",0,0,4,1,0,0,1037937,"2023-12-17T00:00:00.000Z",27,FALSE,19,17896021,"F",19,19,"New Orleans Pelicans","Jeremiah Robinson-Earl",0,5,5,4,1,5.2
4,0,4,0,0,2,1,0,0,"18",1,4,2,5,0,1,1037937,"2023-12-17T00:00:00.000Z",27,FALSE,19,491,"C",19,19,"New Orleans Pelicans","Cody Zeller",0,7,11,6,9,13
0,0,0,0,0,0,0,0,0,"00",0,0,0,0,0,0,1037937,"2023-12-17T00:00:00.000Z",27,FALSE,19,3547260,"G",19,19,"New Orleans Pelicans","Kira Lewis Jr.",0,0,0,0,0,0
0,0,0,0,0,0,0,0,0,"00",0,0,0,0,0,0,1037937,"2023-12-17T00:00:00.000Z",27,FALSE,19,38017663,"F",19,19,"New Orleans Pelicans","E.J. Liddell",0,0,0,0,0,0
0,0,0,0,0,0,0,0,0,"00",0,0,0,0,0,0,1037937,"2023-12-17T00:00:00.000Z",27,FALSE,19,340,"F",19,19,"New Orleans Pelicans","Larry Nance Jr.",0,0,0,0,0,0
0,0,0,0,0,0,0,0,0,"00",0,0,0,0,0,0,1037937,"2023-12-17T00:00:00.000Z",27,FALSE,19,17896017,"F",19,19,"New Orleans Pelicans","Matt Ryan",0,0,0,0,0,0
4,1,3,7,5,17,10,1,1,"27",0,1,26,3,1,1,1037937,"2023-12-17T00:00:00.000Z",27,FALSE,19,227,"F",19,19,"New Orleans Pelicans","Brandon Ingram",2,29,33,30,7,40.6
0,0,0,0,0,0,0,0,0,"00",0,0,0,0,0,0,1037937,"2023-12-17T00:00:00.000Z",27,FALSE,19,38017726,"G",19,19,"New Orleans Pelicans","Dereon Seabron",0,0,0,0,0,0
2,0,3,5,1,15,7,5,5,"29",0,3,20,3,0,4,1037938,"2023-12-17T00:00:00.000Z",17,FALSE,11,315,"F",17,17,"Milwaukee Bucks","Khris Middleton",0,23,25,22,5,22.6
3,0,11,3,1,22,10,11,5,"39",6,3,26,17,0,6,1037938,"2023-12-17T00:00:00.000Z",17,FALSE,11,15,"F",17,17,"Milwaukee Bucks","Giannis Antetokounmpo",0,43,46,29,20,44.9
0,1,5,8,3,13,6,3,3,"31",1,2,18,6,0,0,1037938,"2023-12-17T00:00:00.000Z",17,FALSE,11,283,"C",17,17,"Milwaukee Bucks","Brook Lopez",1,24,24,18,6,28.2
4,0,2,3,1,6,4,0,0,"36",4,6,9,6,0,1,1037938,"2023-12-17T00:00:00.000Z",17,FALSE,11,56677852,"G",17,17,"Milwaukee Bucks","Andre Jackson Jr.",0,15,19,13,10,21.2
11,0,5,8,5,19,11,13,12,"36",0,2,39,5,3,3,1037938,"2023-12-17T00:00:00.000Z",17,FALSE,11,278,"G",17,17,"Milwaukee Bucks","Damian Lillard",3,44,55,50,16,67.5
0,0,0,0,0,0,0,0,0,"01",0,0,0,0,0,0,1037938,"2023-12-17T00:00:00.000Z",17,FALSE,11,2148,"",17,17,"Milwaukee Bucks","Thanasis Antetokounmpo",0,0,0,0,0,0
0,0,1,0,0,0,0,0,0,"12",0,2,0,1,0,0,1037938,"2023-12-17T00:00:00.000Z",17,FALSE,11,38017676,"F",17,17,"Milwaukee Bucks","MarJon Beauchamp",0,1,1,0,1,1.2
0,0,0,0,0,0,0,0,0,"01",0,0,0,0,0,0,1037938,"2023-12-17T00:00:00.000Z",17,FALSE,11,666453,"C",17,17,"Milwaukee Bucks","Marques Bolden",0,0,0,0,0,0
4,0,1,3,1,4,2,0,0,"17",1,0,5,2,1,1,1037938,"2023-12-17T00:00:00.000Z",17,FALSE,11,105,"G",17,17,"Milwaukee Bucks","Pat Connaughton",1,7,11,9,6,15.4
0,0,0,0,0,0,0,0,0,"01",0,0,0,0,0,0,1037938,"2023-12-17T00:00:00.000Z",17,FALSE,11,38017733,"G",17,17,"Milwaukee Bucks","A.J. Green",0,0,0,0,0,0
0,0,0,0,0,0,0,0,0,"01",0,0,0,0,0,0,1037938,"2023-12-17T00:00:00.000Z",17,FALSE,11,56677854,"F",17,17,"Milwaukee Bucks","Chris Livingston",0,0,0,0,0,0
0,0,0,0,0,0,0,0,0,"00",0,0,0,0,0,0,1037938,"2023-12-17T00:00:00.000Z",17,FALSE,11,284,"C",17,17,"Milwaukee Bucks","Robin Lopez",0,0,0,0,0,0
1,0,0,4,0,4,0,0,0,"11",0,2,0,0,0,0,1037938,"2023-12-17T00:00:00.000Z",17,FALSE,11,368,"G",17,17,"Milwaukee Bucks","Cameron Payne",0,0,1,1,1,1.5
0,0,2,2,1,7,5,0,0,"24",4,3,11,6,0,0,1037938,"2023-12-17T00:00:00.000Z",17,FALSE,11,377,"F",17,17,"Milwaukee Bucks","Bobby Portis",0,17,17,11,6,18.2
0,0,0,0,0,0,0,0,0,"01",0,0,0,0,0,0,1037938,"2023-12-17T00:00:00.000Z",17,FALSE,11,666960,"G",17,17,"Milwaukee Bucks","Lindell Wigginton",0,0,0,0,0,0
0,0,0,0,0,0,0,0,0,"00",0,0,0,0,0,0,1037938,"2023-12-17T00:00:00.000Z",17,FALSE,11,38,"G",17,17,"Milwaukee Bucks","Malik Beasley",0,0,0,0,0,0
0,0,0,0,0,0,0,0,0,"00",0,0,0,0,0,0,1037938,"2023-12-17T00:00:00.000Z",17,FALSE,11,112,"F",17,17,"Milwaukee Bucks","Jae Crowder",0,0,0,0,0,0
0,0,0,0,0,0,0,0,0,"00",0,0,0,0,0,0,1037938,"2023-12-17T00:00:00.000Z",17,FALSE,11,38017691,"G",17,17,"Milwaukee Bucks","TyTy Washington Jr.",0,0,0,0,0,0
1,0,3,4,2,12,7,2,2,"35",1,4,18,4,2,2,1037938,"2023-12-17T00:00:00.000Z",17,FALSE,11,66,"G-F",11,11,"Houston Rockets","Dillon Brooks",2,22,23,19,5,28.3
2,1,5,4,1,13,7,1,1,"28",0,5,16,5,0,0,1037938,"2023-12-17T00:00:00.000Z",17,FALSE,11,38017684,"F",11,11,"Houston Rockets","Jabari Smith Jr.",1,21,23,18,7,28
5,1,6,3,0,15,8,6,4,"31",2,4,20,8,1,0,1037938,"2023-12-17T00:00:00.000Z",17,FALSE,11,17896062,"F-C",11,11,"Houston Rockets","Alperen Sengun",2,28,33,25,13,43.1
7,0,2,4,2,11,6,2,2,"29",0,0,16,2,0,1,1037938,"2023-12-17T00:00:00.000Z",17,FALSE,11,17895966,"G",11,11,"Houston Rockets","Jalen Green",0,18,25,23,9,27.9
6,2,1,8,4,16,8,2,2,"39",1,2,22,2,1,1,1037938,"2023-12-17T00:00:00.000Z",17,FALSE,11,458,"G",11,11,"Houston Rockets","Fred VanVleet",3,24,30,28,8,41.4
0,0,0,0,0,0,0,0,0,"00",0,0,0,0,0,0,1037938,"2023-12-17T00:00:00.000Z",17,FALSE,11,75,"G-F",11,11,"Houston Rockets","Reggie Bullock",0,0,0,0,0,0
1,0,6,2,1,8,5,0,0,"30",0,2,11,6,2,0,1037938,"2023-12-17T00:00:00.000Z",17,FALSE,11,38017695,"F",11,11,"Houston Rockets","Tari Eason",2,17,18,12,7,25.7
1,0,0,1,1,5,4,8,7,"17",0,0,16,0,0,1,1037938,"2023-12-17T00:00:00.000Z",17,FALSE,11,188,"F",11,11,"Houston Rockets","Jeff Green",0,16,17,17,1,16.5
2,0,1,1,0,3,0,0,0,"12",0,2,0,1,1,2,1037938,"2023-12-17T00:00:00.000Z",17,FALSE,11,213,"G",11,11,"Houston Rockets","Aaron Holiday",1,1,3,2,3,5.2
0,0,0,0,0,0,0,0,0,"00",0,0,0,0,0,0,1037938,"2023-12-17T00:00:00.000Z",17,FALSE,11,19465326,"C",11,11,"Houston Rockets","Jock Landale",0,0,0,0,0,0
0,0,0,0,0,0,0,0,0,"00",0,0,0,0,0,0,1037938,"2023-12-17T00:00:00.000Z",17,FALSE,11,296,"C",11,11,"Houston Rockets","Boban Marjanovic",0,0,0,0,0,0
1,0,1,0,0,2,0,0,0,"19",2,2,0,3,1,2,1037938,"2023-12-17T00:00:00.000Z",17,FALSE,11,3547301,"F",11,11,"Houston Rockets","Jae'Sean Tate",1,3,4,1,4,6.1
0,0,0,0,0,0,0,0,0,"00",0,0,0,0,0,0,1037938,"2023-12-17T00:00:00.000Z",17,FALSE,11,47738533,"G",11,11,"Houston Rockets","Jeenathan Williams",0,0,0,0,0,0
0,0,0,0,0,0,0,0,0,"00",0,0,0,0,0,0,1037938,"2023-12-17T00:00:00.000Z",17,FALSE,11,3547281,"G-F",11,11,"Houston Rockets","Nate Hinton",0,0,0,0,0,0
0,0,0,0,0,0,0,0,0,"00",0,0,0,0,0,0,1037938,"2023-12-17T00:00:00.000Z",17,FALSE,11,357,"G",11,11,"Houston Rockets","Victor Oladipo",0,0,0,0,0,0
0,0,0,0,0,0,0,0,0,"00",0,0,0,0,0,0,1037938,"2023-12-17T00:00:00.000Z",17,FALSE,11,56677809,"F",11,11,"Houston Rockets","Jermaine Samuels Jr.",0,0,0,0,0,0
0,0,0,0,0,0,0,0,0,"00",0,0,0,0,0,0,1037938,"2023-12-17T00:00:00.000Z",17,FALSE,11,56677825,"G-F",11,11,"Houston Rockets","Amen Thompson",0,0,0,0,0,0
0,0,0,0,0,0,0,0,0,"00",0,0,0,0,0,0,1037938,"2023-12-17T00:00:00.000Z",17,FALSE,11,56677831,"F",11,11,"Houston Rockets","Cam Whitmore",0,0,0,0,0,0
6,1,3,2,1,7,4,3,2,"32",4,1,11,7,0,0,1037941,"2023-12-18T00:00:00.000Z",6,FALSE,11,3547247,"F-G",6,6,"Cleveland Cavaliers","Isaac Okoro",1,18,24,17,13,31.4
1,2,1,3,2,5,4,2,2,"22",2,3,12,3,1,2,1037941,"2023-12-18T00:00:00.000Z",6,FALSE,11,666940,"F",6,6,"Cleveland Cavaliers","Dean Wade",3,15,16,13,4,24.1
2,2,4,0,0,7,3,7,4,"29",2,5,10,6,0,1,1037941,"2023-12-18T00:00:00.000Z",6,FALSE,11,9,"C",6,6,"Cleveland Cavaliers","Jarrett Allen",2,16,18,12,8,25.2
2,0,3,9,3,13,5,5,4,"34",0,3,17,3,0,0,1037941,"2023-12-18T00:00:00.000Z",6,FALSE,11,666908,"G",6,6,"Cleveland Cavaliers","Max Strus",0,20,22,19,5,23.6
6,2,1,11,4,27,14,5,5,"45",0,5,37,1,0,2,1037941,"2023-12-18T00:00:00.000Z",6,FALSE,11,322,"G",6,6,"Cleveland Cavaliers","Donovan Mitchell",2,38,44,43,7,51.2
0,0,0,0,0,0,0,0,0,"00",0,0,0,0,0,0,1037941,"2023-12-18T00:00:00.000Z",6,FALSE,11,56677847,"F",6,6,"Cleveland Cavaliers","Emoni Bates",0,0,0,0,0,0
0,0,0,0,0,0,0,0,0,"00",0,0,0,0,0,0,1037941,"2023-12-18T00:00:00.000Z",6,FALSE,11,248,"C",6,6,"Cleveland Cavaliers","Damian Jones",0,0,0,0,0,0
5,0,6,6,1,13,5,2,1,"27",1,0,12,7,2,3,1037941,"2023-12-18T00:00:00.000Z",6,FALSE,11,277,"G",6,6,"Cleveland Cavaliers","Caris LeVert",2,19,24,17,12,30.9
3,1,3,10,5,11,6,2,2,"24",1,1,19,4,1,0,1037941,"2023-12-18T00:00:00.000Z",6,FALSE,11,3547299,"G",6,6,"Cleveland Cavaliers","Sam Merrill",2,23,26,22,7,34.3
3,0,0,1,1,2,1,0,0,"09",0,0,3,0,1,0,1037941,"2023-12-18T00:00:00.000Z",6,FALSE,11,56677872,"G",6,6,"Cleveland Cavaliers","Craig Porter",1,3,6,6,3,10.5
1,0,2,0,0,1,1,8,2,"18",2,2,4,4,0,0,1037941,"2023-12-18T00:00:00.000Z",6,FALSE,11,444,"C-F",6,6,"Cleveland Cavaliers","Tristan Thompson",0,8,9,5,5,10.3
0,0,0,0,0,0,0,0,0,"00",0,0,0,0,0,0,1037941,"2023-12-18T00:00:00.000Z",6,FALSE,11,666581,"G",6,6,"Cleveland Cavaliers","Darius Garland",0,0,0,0,0,0
0,0,0,0,0,0,0,0,0,"00",0,0,0,0,0,0,1037941,"2023-12-18T00:00:00.000Z",6,FALSE,11,666676,"G",6,6,"Cleveland Cavaliers","Ty Jerome",0,0,0,0,0,0
0,0,0,0,0,0,0,0,0,"00",0,0,0,0,0,0,1037941,"2023-12-18T00:00:00.000Z",6,FALSE,11,17896076,"F-C",6,6,"Cleveland Cavaliers","Evan Mobley",0,0,0,0,0,0
0,0,0,0,0,0,0,0,0,"00",0,0,0,0,0,0,1037941,"2023-12-18T00:00:00.000Z",6,FALSE,11,38017662,"F",6,6,"Cleveland Cavaliers","Isaiah Mobley",0,0,0,0,0,0
0,0,0,0,0,0,0,0,0,"00",0,0,0,0,0,0,1037941,"2023-12-18T00:00:00.000Z",6,FALSE,11,404,"G",6,6,"Cleveland Cavaliers","Ricky Rubio",0,0,0,0,0,0
2,0,2,7,3,12,6,2,1,"38",1,3,16,3,0,0,1037941,"2023-12-18T00:00:00.000Z",6,FALSE,11,66,"G-F",11,11,"Houston Rockets","Dillon Brooks",0,19,21,18,5,22.6
0,0,4,4,1,7,2,0,0,"23",3,4,5,7,0,2,1037941,"2023-12-18T00:00:00.000Z",6,FALSE,11,38017684,"F",11,11,"Houston Rockets","Jabari Smith Jr.",0,12,12,5,7,11.4
6,0,4,3,1,20,11,2,1,"31",4,5,24,8,1,4,1037941,"2023-12-18T00:00:00.000Z",6,FALSE,11,17896062,"F-C",11,11,"Houston Rockets","Alperen Sengun",1,32,38,30,14,41.6
3,2,6,4,1,12,2,7,7,"34",0,2,12,6,1,2,1037941,"2023-12-18T00:00:00.000Z",6,FALSE,11,17895966,"G",11,11,"Houston Rockets","Jalen Green",3,18,21,15,9,30.7
3,1,1,0,0,6,6,3,3,"24",0,3,15,1,0,1,1037941,"2023-12-18T00:00:00.000Z",6,FALSE,11,188,"F",11,11,"Houston Rockets","Jeff Green",1,16,19,18,4,22.7
0,0,1,5,2,9,5,2,2,"17",1,4,14,2,0,0,1037941,"2023-12-18T00:00:00.000Z",6,FALSE,11,213,"G",11,11,"Houston Rockets","Aaron Holiday",0,16,16,14,2,16.4
0,0,1,0,0,0,0,0,0,"04",0,1,0,1,1,0,1037941,"2023-12-18T00:00:00.000Z",6,FALSE,11,19465326,"C",11,11,"Houston Rockets","Jock Landale",1,1,1,0,1,4.2
1,0,1,0,0,4,1,1,1,"16",2,2,3,3,0,0,1037941,"2023-12-18T00:00:00.000Z",6,FALSE,11,3547301,"F",11,11,"Houston Rockets","Jae'Sean Tate",0,6,7,4,4,8.1
17,1,8,8,4,19,9,5,5,"45",0,4,27,8,2,2,1037941,"2023-12-18T00:00:00.000Z",6,FALSE,11,458,"G",11,11,"Houston Rockets","Fred VanVleet",3,35,52,44,25,69.1
0,0,0,0,0,0,0,0,0,"00",0,0,0,0,0,0,1037941,"2023-12-18T00:00:00.000Z",6,FALSE,11,75,"G-F",11,11,"Houston Rockets","Reggie Bullock",0,0,0,0,0,0
2,1,4,2,0,13,5,5,4,"33",4,4,14,8,4,2,1037941,"2023-12-18T00:00:00.000Z",6,FALSE,11,38017695,"F",11,11,"Houston Rockets","Tari Eason",5,22,24,16,10,39.6
0,0,0,0,0,0,0,0,0,"00",0,0,0,0,0,0,1037941,"2023-12-18T00:00:00.000Z",6,FALSE,11,56677825,"G-F",11,11,"Houston Rockets","Amen Thompson",0,0,0,0,0,0
0,0,0,0,0,0,0,0,0,"00",0,0,0,0,0,0,1037941,"2023-12-18T00:00:00.000Z",6,FALSE,11,56677831,"F",11,11,"Houston Rockets","Cam Whitmore",0,0,0,0,0,0
0,0,0,0,0,0,0,0,0,"00",0,0,0,0,0,0,1037941,"2023-12-18T00:00:00.000Z",6,FALSE,11,357,"G",11,11,"Houston Rockets","Victor Oladipo",0,0,0,0,0,0
0,0,0,0,0,0,0,0,0,"00",0,0,0,0,0,0,1037941,"2023-12-18T00:00:00.000Z",6,FALSE,11,56677809,"F",11,11,"Houston Rockets","Jermaine Samuels Jr.",0,0,0,0,0,0
0,0,1,6,2,10,4,0,0,"25",1,5,10,2,2,3,1037941,"2023-12-18T00:00:00.000Z",6,FALSE,11,344,"F",6,6,"Cleveland Cavaliers","Georges Niang",2,12,12,10,2,15.4
0,0,0,0,0,0,0,0,0,"00",0,0,0,0,0,0,1037941,"2023-12-18T00:00:00.000Z",6,FALSE,11,296,"C",11,11,"Houston Rockets","Boban Marjanovic",0,0,0,0,0,0
0,0,0,0,0,0,0,0,0,"00",0,0,0,0,0,0,1037941,"2023-12-18T00:00:00.000Z",6,FALSE,11,47738533,"G",11,11,"Houston Rockets","Jeenathan Williams",0,0,0,0,0,0
0,0,0,0,0,0,0,0,0,"00",0,0,0,0,0,0,1037941,"2023-12-18T00:00:00.000Z",6,FALSE,11,3547281,"G-F",11,11,"Houston Rockets","Nate Hinton",0,0,0,0,0,0
4,1,0,7,3,9,5,2,1,"30",0,2,14,0,0,2,1037942,"2023-12-18T00:00:00.000Z",12,FALSE,13,210,"G",12,12,"Indiana Pacers","Buddy Hield",1,14,18,18,4,21
4,2,2,3,2,8,6,0,0,"31",1,3,14,3,0,0,1037942,"2023-12-18T00:00:00.000Z",12,FALSE,13,3547243,"F",12,12,"Indiana Pacers","Obi Toppin",2,17,21,18,7,29.6
2,1,2,0,0,9,6,5,3,"25",2,1,15,4,0,0,1037942,"2023-12-18T00:00:00.000Z",12,FALSE,13,17896035,"F",12,12,"Indiana Pacers","Isaiah Jackson",1,19,21,17,6,25.8
3,0,1,4,0,11,4,3,3,"20",3,4,11,4,1,2,1037942,"2023-12-18T00:00:00.000Z",12,FALSE,13,69,"G",12,12,"Indiana Pacers","Bruce Brown",1,15,18,14,7,21.3
11,0,2,5,1,12,3,2,1,"31",0,1,8,2,0,4,1037942,"2023-12-18T00:00:00.000Z",12,FALSE,13,3547245,"G",12,12,"Indiana Pacers","Tyrese Haliburton",0,10,21,19,13,22.9
2,0,0,0,0,1,0,0,0,"06",1,1,0,1,1,1,1037942,"2023-12-18T00:00:00.000Z",12,FALSE,13,242,"F",12,12,"Indiana Pacers","James Johnson",1,1,3,2,3,6.2
2,0,4,7,3,20,12,7,7,"35",2,3,34,6,1,1,1037942,"2023-12-18T00:00:00.000Z",12,FALSE,13,38017686,"G-F",12,12,"Indiana Pacers","Bennedict Mathurin",1,40,42,36,8,46.2
8,0,4,0,0,10,5,0,0,"20",1,2,10,5,1,0,1037942,"2023-12-18T00:00:00.000Z",12,FALSE,13,304,"G",12,12,"Indiana Pacers","T.J. McConnell",1,15,23,18,13,31
2,3,5,3,2,7,4,2,2,"26",1,3,12,6,2,1,1037942,"2023-12-18T00:00:00.000Z",12,FALSE,13,3547250,"G-F",12,12,"Indiana Pacers","Aaron Nesmith",5,18,20,14,8,36.2
0,0,3,4,1,8,4,0,0,"16",0,1,9,3,0,0,1037942,"2023-12-18T00:00:00.000Z",12,FALSE,13,3547207,"F",12,12,"Indiana Pacers","Jordan Nwora",0,12,12,9,3,12.6
0,0,0,0,0,0,0,0,0,"00",0,0,0,0,0,0,1037942,"2023-12-18T00:00:00.000Z",12,FALSE,13,452,"C-F",12,12,"Indiana Pacers","Myles Turner",0,0,0,0,0,0
1,0,1,5,2,18,12,2,2,"27",1,2,28,2,1,3,1037942,"2023-12-18T00:00:00.000Z",12,FALSE,13,274,"F",13,13,"LA Clippers","Kawhi Leonard",1,30,31,29,3,31.9
3,3,12,0,0,10,7,5,4,"26",4,2,18,16,0,0,1037942,"2023-12-18T00:00:00.000Z",12,FALSE,13,493,"C",13,13,"LA Clippers","Ivica Zubac",3,34,37,21,19,50.7
1,1,1,3,0,5,2,0,0,"28",1,0,4,2,0,1,1037942,"2023-12-18T00:00:00.000Z",12,FALSE,13,666743,"G",13,13,"LA Clippers","Terance Mann",1,6,7,5,3,9.9
9,1,3,11,8,16,12,3,3,"28",0,2,35,3,1,1,1037942,"2023-12-18T00:00:00.000Z",12,FALSE,13,192,"G",13,13,"LA Clippers","James Harden",2,38,47,44,12,57.1
0,0,0,0,0,4,3,0,0,"06",0,2,6,0,0,1,1037942,"2023-12-18T00:00:00.000Z",12,FALSE,13,17896022,"G",13,13,"LA Clippers","Brandon Boston Jr.",0,6,6,6,0,5
1,0,1,1,0,2,0,0,0,"06",0,1,0,1,0,1,1037942,"2023-12-18T00:00:00.000Z",12,FALSE,13,56677849,"F",13,13,"LA Clippers","Kobe Brown",0,1,2,1,2,1.7
2,0,3,1,0,1,0,0,0,"18",0,2,0,3,0,0,1037942,"2023-12-18T00:00:00.000Z",12,FALSE,13,666511,"G",13,13,"LA Clippers","Amir Coffey",0,3,5,2,5,6.6
0,0,3,6,4,11,6,3,3,"30",0,1,19,3,0,0,1037942,"2023-12-18T00:00:00.000Z",12,FALSE,13,380,"F-G",13,13,"LA Clippers","Norman Powell",0,22,22,19,3,22.6
0,2,4,0,0,4,1,2,2,"22",5,2,4,9,0,2,1037942,"2023-12-18T00:00:00.000Z",12,FALSE,13,439,"F",13,13,"LA Clippers","Daniel Theis",2,13,13,4,9,18.8
0,0,0,0,0,0,0,0,0,"00",0,0,0,0,0,0,1037942,"2023-12-18T00:00:00.000Z",12,FALSE,13,450,"F",13,13,"LA Clippers","PJ Tucker",0,0,0,0,0,0
0,0,0,0,0,0,0,0,0,"00",0,0,0,0,0,0,1037942,"2023-12-18T00:00:00.000Z",12,FALSE,13,56677778,"F-C",12,12,"Indiana Pacers","Oscar Tshiebwe",0,0,0,0,0,0
0,0,0,0,0,0,0,0,0,"00",0,0,0,0,0,0,1037942,"2023-12-18T00:00:00.000Z",12,FALSE,13,56677832,"F",12,12,"Indiana Pacers","Jarace Walker",0,0,0,0,0,0
0,0,0,0,0,0,0,0,0,"00",0,0,0,0,0,0,1037942,"2023-12-18T00:00:00.000Z",12,FALSE,13,56677794,"G",12,12,"Indiana Pacers","Isaiah Wong",0,0,0,0,0,0
4,1,3,11,5,21,9,4,4,"32",0,3,27,3,1,1,1037942,"2023-12-18T00:00:00.000Z",12,FALSE,13,172,"F",13,13,"LA Clippers","Paul George",2,30,34,31,7,41.6
5,1,1,0,0,6,4,4,2,"17",3,2,10,4,1,1,1037942,"2023-12-18T00:00:00.000Z",12,FALSE,13,472,"G",13,13,"LA Clippers","Russell Westbrook",2,14,19,15,9,27.3
0,0,0,0,0,0,0,0,0,"00",0,0,0,0,0,0,1037942,"2023-12-18T00:00:00.000Z",12,FALSE,13,38017725,"F",13,13,"LA Clippers","Moussa Diabate",0,0,0,0,0,0
0,0,0,0,0,0,0,0,0,"00",0,0,0,0,0,0,1037942,"2023-12-18T00:00:00.000Z",12,FALSE,13,17896031,"G",13,13,"LA Clippers","Nah'Shon Hyland",0,0,0,0,0,0
0,0,0,0,0,0,0,0,0,"00",0,0,0,0,0,0,1037942,"2023-12-18T00:00:00.000Z",12,FALSE,13,56677856,"G",13,13,"LA Clippers","Jordan Miller",0,0,0,0,0,0
0,0,0,0,0,0,0,0,0,"00",0,0,0,0,0,0,1037942,"2023-12-18T00:00:00.000Z",12,FALSE,13,24417679,"G",13,13,"LA Clippers","Xavier Moon",0,0,0,0,0,0
0,0,0,0,0,0,0,0,0,"00",0,0,0,0,0,0,1037942,"2023-12-18T00:00:00.000Z",12,FALSE,13,371,"F-C",13,13,"LA Clippers","Mason Plumlee",0,0,0,0,0,0
0,0,0,0,0,0,0,0,0,"00",0,0,0,0,0,0,1037942,"2023-12-18T00:00:00.000Z",12,FALSE,13,17896051,"G",13,13,"LA Clippers","Joshua Primo",0,0,0,0,0,0
0,0,0,0,0,0,0,0,0,"00",0,0,0,0,0,0,1037942,"2023-12-18T00:00:00.000Z",12,FALSE,13,38017701,"G",12,12,"Indiana Pacers","Kendall Brown",0,0,0,0,0,0
0,0,0,0,0,0,0,0,0,"00",0,0,0,0,0,0,1037942,"2023-12-18T00:00:00.000Z",12,FALSE,13,38017507,"G-F",12,12,"Indiana Pacers","Andrew Nembhard",0,0,0,0,0,0
0,0,0,0,0,0,0,0,0,"00",0,0,0,0,0,0,1037942,"2023-12-18T00:00:00.000Z",12,FALSE,13,56677861,"G",12,12,"Indiana Pacers","Ben Sheppard",0,0,0,0,0,0
0,0,0,0,0,0,0,0,0,"00",0,0,0,0,0,0,1037942,"2023-12-18T00:00:00.000Z",12,FALSE,13,3547264,"F-C",12,12,"Indiana Pacers","Jalen Smith",0,0,0,0,0,0
3,0,3,4,1,4,1,0,0,"27",1,0,3,4,0,2,1037943,"2023-12-18T00:00:00.000Z",23,FALSE,5,33,"F-G",23,23,"Philadelphia 76ers","Nicolas Batum",0,7,10,6,7,10.3
2,3,5,1,1,3,1,0,0,"32",0,1,3,5,0,2,1037943,"2023-12-18T00:00:00.000Z",23,FALSE,5,200,"F",23,23,"Philadelphia 76ers","Tobias Harris",3,8,10,5,7,19
6,2,13,6,2,28,15,9,8,"37",1,5,40,14,0,4,1037943,"2023-12-18T00:00:00.000Z",23,FALSE,5,145,"F-C",23,23,"Philadelphia 76ers","Joel Embiid",2,54,60,46,20,67.8
2,1,2,1,0,5,3,0,0,"29",2,0,6,4,3,0,1037943,"2023-12-18T00:00:00.000Z",23,FALSE,5,313,"G",23,23,"Philadelphia 76ers","De'Anthony Melton",4,10,12,8,6,25.8
8,0,3,11,5,23,9,6,6,"39",2,3,29,5,1,3,1037943,"2023-12-18T00:00:00.000Z",23,FALSE,5,3547254,"G",23,23,"Philadelphia 76ers","Tyrese Maxey",1,34,42,37,13,47
0,0,0,0,0,0,0,0,0,"00",0,0,0,0,0,0,1037943,"2023-12-18T00:00:00.000Z",23,FALSE,5,28,"C",23,23,"Philadelphia 76ers","Mo Bamba",0,0,0,0,0,0
1,0,3,2,0,6,2,0,0,"19",0,1,4,3,0,1,1037943,"2023-12-18T00:00:00.000Z",23,FALSE,5,45,"G",23,23,"Philadelphia 76ers","Patrick Beverley",0,7,8,5,4,8.1
0,1,1,0,0,3,1,0,0,"14",1,2,2,2,2,0,1037943,"2023-12-18T00:00:00.000Z",23,FALSE,5,108,"F",23,23,"Philadelphia 76ers","Robert Covington",3,4,4,2,2,13.4
0,0,0,1,1,1,1,0,0,"07",0,0,3,0,0,0,1037943,"2023-12-18T00:00:00.000Z",23,FALSE,5,2175,"",23,23,"Philadelphia 76ers","Danuel House Jr.",0,3,3,3,0,3
0,0,0,0,0,0,0,0,0,"00",0,0,0,0,0,0,1037943,"2023-12-18T00:00:00.000Z",23,FALSE,5,260,"G-F",23,23,"Philadelphia 76ers","Furkan Korkmaz",0,0,0,0,0,0
4,2,4,3,0,8,5,1,0,"31",0,5,10,4,1,2,1037943,"2023-12-18T00:00:00.000Z",23,FALSE,5,89,"G",5,5,"Chicago Bulls","Alex Caruso",3,14,18,14,8,27.8
0,0,0,0,0,0,0,0,0,"00",0,0,0,0,0,0,1037943,"2023-12-18T00:00:00.000Z",23,FALSE,5,110,"F",5,5,"Chicago Bulls","Torrey Craig",0,0,0,0,0,0
0,1,5,0,0,3,2,2,1,"14",3,0,5,8,1,0,1037943,"2023-12-18T00:00:00.000Z",23,FALSE,5,137,"C",5,5,"Chicago Bulls","Andre Drummond",2,13,13,5,8,20.6
0,0,0,0,0,0,0,0,0,"00",0,0,0,0,0,0,1037943,"2023-12-18T00:00:00.000Z",23,FALSE,5,56677857,"F",5,5,"Chicago Bulls","Julian Phillips",0,0,0,0,0,0
0,0,0,0,0,0,0,0,0,"00",0,0,0,0,0,0,1037943,"2023-12-18T00:00:00.000Z",23,FALSE,5,17896116,"G",5,5,"Chicago Bulls","Terry Taylor",0,0,0,0,0,0
1,0,2,0,0,1,1,0,0,"10",1,2,2,3,0,0,1037943,"2023-12-18T00:00:00.000Z",23,FALSE,5,38017719,"F",5,5,"Chicago Bulls","Dalen Terry",0,5,6,3,4,7.1
0,0,0,0,0,0,0,0,0,"00",0,0,0,0,0,0,1037943,"2023-12-18T00:00:00.000Z",23,FALSE,5,27,"G",5,5,"Chicago Bulls","Lonzo Ball",0,0,0,0,0,0
0,0,0,0,0,0,0,0,0,"00",0,0,0,0,0,0,1037943,"2023-12-18T00:00:00.000Z",23,FALSE,5,56677874,"F",5,5,"Chicago Bulls","Onuralp Bitim",0,0,0,0,0,0
0,0,0,0,0,0,0,0,0,"00",0,0,0,0,0,0,1037943,"2023-12-18T00:00:00.000Z",23,FALSE,5,NA,NA,NA,5,"Chicago Bulls","NA NA",0,0,0,0,0,0
0,0,0,0,0,0,0,0,0,"00",0,0,0,0,0,0,1037943,"2023-12-18T00:00:00.000Z",23,FALSE,5,268,"G",5,5,"Chicago Bulls","Zach LaVine",0,0,0,0,0,0
0,0,0,0,0,0,0,0,0,"00",0,0,0,0,0,0,1037943,"2023-12-18T00:00:00.000Z",23,FALSE,5,56677860,"F",5,5,"Chicago Bulls","Adama Sanogo",0,0,0,0,0,0
0,0,0,0,0,0,0,0,0,"00",0,0,0,0,0,0,1037943,"2023-12-18T00:00:00.000Z",23,FALSE,5,3547294,"F",23,23,"Philadelphia 76ers","Kenyon Martin Jr.",0,0,0,0,0,0
0,0,3,5,1,10,2,2,1,"24",0,3,6,3,1,0,1037943,"2023-12-18T00:00:00.000Z",23,FALSE,5,360,"F",23,23,"Philadelphia 76ers","Kelly Oubre Jr.",1,9,9,6,3,12.6
1,1,2,1,0,5,3,2,2,"12",2,2,8,4,1,0,1037943,"2023-12-18T00:00:00.000Z",23,FALSE,5,3547270,"F",23,23,"Philadelphia 76ers","Paul Reed",2,12,13,9,5,20.3
0,0,0,0,0,0,0,0,0,"00",0,0,0,0,0,0,1037943,"2023-12-18T00:00:00.000Z",23,FALSE,5,17896025,"G",23,23,"Philadelphia 76ers","Jaden Springer",0,0,0,0,0,0
0,0,0,0,0,0,0,0,0,"00",0,0,0,0,0,0,1037943,"2023-12-18T00:00:00.000Z",23,FALSE,5,56913527,"G",23,23,"Philadelphia 76ers","Ricky Council IV",0,0,0,0,0,0
0,0,0,0,0,0,0,0,0,"00",0,0,0,0,0,0,1037943,"2023-12-18T00:00:00.000Z",23,FALSE,5,328,"F",23,23,"Philadelphia 76ers","Marcus Morris",0,0,0,0,0,0
0,0,0,0,0,0,0,0,0,"00",0,0,0,0,0,0,1037943,"2023-12-18T00:00:00.000Z",23,FALSE,5,17554001,"G",23,23,"Philadelphia 76ers","Javonte Smart",0,0,0,0,0,0
0,0,0,0,0,0,0,0,0,"00",0,0,0,0,0,0,1037943,"2023-12-18T00:00:00.000Z",23,FALSE,5,56677788,"G",23,23,"Philadelphia 76ers","Terquavion Smith",0,0,0,0,0,0
5,1,4,0,0,15,5,6,5,"37",0,1,15,4,4,2,1037943,"2023-12-18T00:00:00.000Z",23,FALSE,5,125,"G",5,5,"Chicago Bulls","DeMar DeRozan",5,19,24,20,9,40.3
0,1,6,4,3,13,5,0,0,"37",0,1,13,6,0,0,1037943,"2023-12-18T00:00:00.000Z",23,FALSE,5,3547248,"F",5,5,"Chicago Bulls","Patrick Williams",1,19,19,13,6,23.2
4,2,5,7,3,18,10,0,0,"34",3,4,23,8,0,2,1037943,"2023-12-18T00:00:00.000Z",23,FALSE,5,460,"C",5,5,"Chicago Bulls","Nikola Vucevic",2,31,35,27,12,42.6
1,1,1,1,0,3,1,2,2,"19",3,1,4,4,1,2,1037943,"2023-12-18T00:00:00.000Z",23,FALSE,5,17895983,"G",5,5,"Chicago Bulls","Ayo Dosunmu",2,8,9,5,5,14.3
0,0,0,8,4,11,4,0,0,"18",0,1,12,0,0,0,1037943,"2023-12-18T00:00:00.000Z",23,FALSE,5,87,"G",5,5,"Chicago Bulls","Jevon Carter",0,12,12,12,0,12
9,1,7,6,2,17,9,4,4,"40",1,0,24,8,0,2,1037943,"2023-12-18T00:00:00.000Z",23,FALSE,5,666956,"G",5,5,"Chicago Bulls","Coby White",1,32,41,33,17,48.1
2,1,2,6,3,7,4,0,0,"21",0,2,11,2,0,0,1037947,"2023-12-18T00:00:00.000Z",21,FALSE,15,666541,"G",21,21,"Oklahoma City Thunder","Luguentz Dort",1,13,15,13,4,19.4
5,1,4,3,1,9,3,4,3,"28",0,2,10,4,2,0,1037947,"2023-12-18T00:00:00.000Z",21,FALSE,15,38017703,"G-F",21,21,"Oklahoma City Thunder","Jalen Williams",3,14,19,15,9,31.3
2,7,4,4,2,14,7,1,1,"25",2,2,17,6,1,2,1037947,"2023-12-18T00:00:00.000Z",21,FALSE,15,38017685,"C-F",21,21,"Oklahoma City Thunder","Chet Holmgren",8,23,25,19,8,49.2
4,0,9,4,0,12,6,4,4,"24",3,0,16,12,1,1,1037947,"2023-12-18T00:00:00.000Z",21,FALSE,15,17896065,"G",21,21,"Oklahoma City Thunder","Josh Giddey",1,28,32,20,16,38.4
5,0,9,3,1,18,8,14,13,"28",0,4,30,9,4,2,1037947,"2023-12-18T00:00:00.000Z",21,FALSE,15,175,"G",21,21,"Oklahoma City Thunder","Shai Gilgeous-Alexander",4,39,44,35,14,58.3
0,0,0,0,0,0,0,0,0,"00",0,0,0,0,0,0,1037947,"2023-12-18T00:00:00.000Z",21,FALSE,15,44,"F",21,21,"Oklahoma City Thunder","Davis Bertans",0,0,0,0,0,0
2,0,0,0,0,0,0,0,0,"07",0,0,0,0,0,1,1037947,"2023-12-18T00:00:00.000Z",21,FALSE,15,17896036,"G",21,21,"Oklahoma City Thunder","Tre Mann",0,0,2,2,2,2
2,0,2,4,1,6,3,0,0,"17",0,1,7,2,0,1,1037947,"2023-12-18T00:00:00.000Z",21,FALSE,15,56677833,"G",21,21,"Oklahoma City Thunder","Cason Wallace",0,9,11,9,4,11.4
0,0,2,1,0,3,1,0,0,"09",1,2,2,3,1,2,1037947,"2023-12-18T00:00:00.000Z",21,FALSE,15,38017706,"F",21,21,"Oklahoma City Thunder","Jaylin Williams",1,5,5,2,3,6.6
2,1,8,3,0,8,0,0,0,"25",0,1,0,8,1,1,1037947,"2023-12-18T00:00:00.000Z",21,FALSE,15,3547285,"F",15,15,"Memphis Grizzlies","Xavier Tillman",2,8,10,2,10,17.6
5,1,1,9,4,14,6,2,1,"28",0,1,17,1,0,5,1037947,"2023-12-18T00:00:00.000Z",21,FALSE,15,3547287,"G",15,15,"Memphis Grizzlies","Desmond Bane",1,18,23,22,6,23.7
7,0,1,6,4,9,4,0,0,"34",0,2,12,1,1,3,1037947,"2023-12-18T00:00:00.000Z",21,FALSE,15,48248287,"G",15,15,"Memphis Grizzlies","Jacob Gilyard",1,13,20,19,8,23.7
0,0,0,0,0,0,0,0,0,"00",0,0,0,0,0,0,1037947,"2023-12-18T00:00:00.000Z",21,FALSE,15,27924547,"F",21,21,"Oklahoma City Thunder","Lindy Waters III",0,0,0,0,0,0
1,0,3,5,1,7,2,0,0,"23",2,3,5,5,0,1,1037947,"2023-12-18T00:00:00.000Z",21,FALSE,15,38017731,"G",15,15,"Memphis Grizzlies","Vince Williams Jr.",0,10,11,6,6,11.5
1,0,5,4,1,7,3,5,4,"25",0,3,11,5,1,2,1037947,"2023-12-18T00:00:00.000Z",21,FALSE,15,231,"F-C",15,15,"Memphis Grizzlies","Jaren Jackson Jr.",1,16,17,12,6,19.5
0,0,0,0,0,0,0,0,0,"00",0,0,0,0,0,0,1037947,"2023-12-18T00:00:00.000Z",21,FALSE,15,666786,"G",15,15,"Memphis Grizzlies","Ja Morant",0,0,0,0,0,0
0,0,0,0,0,0,0,0,0,"00",0,0,0,0,0,0,1037947,"2023-12-18T00:00:00.000Z",21,FALSE,15,401,"G",15,15,"Memphis Grizzlies","Derrick Rose",0,0,0,0,0,0
0,1,0,1,0,1,0,0,0,"07",0,0,0,0,0,1,1037947,"2023-12-18T00:00:00.000Z",21,FALSE,15,4197029,"G",21,21,"Oklahoma City Thunder","Vasilije Micic",1,0,0,0,0,2
0,0,2,2,0,5,3,0,0,"07",1,3,6,3,0,0,1037947,"2023-12-18T00:00:00.000Z",21,FALSE,15,24572055,"C",21,21,"Oklahoma City Thunder","Olivier Sarr",0,9,9,6,3,9.6
1,0,1,0,0,4,1,0,0,"12",1,0,2,2,1,1,1037947,"2023-12-18T00:00:00.000Z",21,FALSE,15,17896078,"G",21,21,"Oklahoma City Thunder","Aaron Wiggins",1,4,5,3,3,7.9
0,0,0,0,0,0,0,0,0,"00",0,0,0,0,0,0,1037947,"2023-12-18T00:00:00.000Z",21,FALSE,15,56677853,"F",21,21,"Oklahoma City Thunder","Keyontae Johnson",0,0,0,0,0,0
0,0,0,0,0,0,0,0,0,"00",0,0,0,0,0,0,1037947,"2023-12-18T00:00:00.000Z",21,FALSE,15,3547271,"C",21,21,"Oklahoma City Thunder","Aleksej Pokusevski",0,0,0,0,0,0
1,0,7,7,2,10,2,4,3,"20",2,1,9,9,0,1,1037947,"2023-12-18T00:00:00.000Z",21,FALSE,15,17896067,"F",15,15,"Memphis Grizzlies","Santi Aldama",0,18,19,10,10,20.3
2,0,1,3,1,3,1,2,2,"17",1,2,5,2,2,2,1037947,"2023-12-18T00:00:00.000Z",21,FALSE,15,666703,"G-F",15,15,"Memphis Grizzlies","John Konchar",2,7,9,7,4,14.4
1,0,4,3,1,5,2,3,3,"22",0,1,8,4,1,3,1037947,"2023-12-18T00:00:00.000Z",21,FALSE,15,38017729,"F",15,15,"Memphis Grizzlies","David Roddy",1,12,13,9,5,14.3
5,0,7,7,2,12,6,5,5,"22",0,3,19,7,0,4,1037947,"2023-12-18T00:00:00.000Z",21,FALSE,15,17896027,"G-F",15,15,"Memphis Grizzlies","Ziaire Williams",0,26,31,24,12,30.9
0,0,0,0,0,0,0,0,0,"00",0,0,0,0,0,0,1037947,"2023-12-18T00:00:00.000Z",21,FALSE,15,48,"C",15,15,"Memphis Grizzlies","Bismack Biyombo",0,0,0,0,0,0
0,1,0,3,2,6,3,0,0,"12",0,2,8,0,0,0,1037947,"2023-12-18T00:00:00.000Z",21,FALSE,15,56677830,"F",15,15,"Memphis Grizzlies","GG Jackson",1,8,8,8,0,11
0,0,1,4,1,4,1,0,0,"12",2,0,3,3,0,0,1037947,"2023-12-18T00:00:00.000Z",21,FALSE,15,38017728,"F",15,15,"Memphis Grizzlies","Jake LaRavia",0,6,6,3,3,6.6
0,0,0,0,0,0,0,0,0,"00",0,0,0,0,0,0,1037947,"2023-12-18T00:00:00.000Z",21,FALSE,15,3,"C",15,15,"Memphis Grizzlies","Steven Adams",0,0,0,0,0,0
0,0,0,0,0,0,0,0,0,"00",0,0,0,0,0,0,1037947,"2023-12-18T00:00:00.000Z",21,FALSE,15,666505,"F",15,15,"Memphis Grizzlies","Brandon Clarke",0,0,0,0,0,0
0,0,0,0,0,0,0,0,0,"00",0,0,0,0,0,0,1037947,"2023-12-18T00:00:00.000Z",21,FALSE,15,254,"G",15,15,"Memphis Grizzlies","Luke Kennard",0,0,0,0,0,0
0,0,0,0,0,0,0,0,0,"00",0,0,0,0,0,0,1037947,"2023-12-18T00:00:00.000Z",21,FALSE,15,38017732,"F",15,15,"Memphis Grizzlies","Kenneth Lofton Jr.",0,0,0,0,0,0
0,0,0,0,0,0,0,0,0,"00",0,0,0,0,0,0,1037947,"2023-12-18T00:00:00.000Z",21,FALSE,15,420,"G",15,15,"Memphis Grizzlies","Marcus Smart",0,0,0,0,0,0
3,0,4,3,2,3,2,0,0,"16",0,0,6,4,0,1,1037947,"2023-12-18T00:00:00.000Z",21,FALSE,15,480,"G-F",21,21,"Oklahoma City Thunder","Kenrich Williams",0,10,13,9,7,14.3
3,0,3,3,1,5,2,0,0,"20",1,1,5,4,1,0,1037947,"2023-12-18T00:00:00.000Z",21,FALSE,15,3547272,"G",21,21,"Oklahoma City Thunder","Isaiah Joe",1,9,12,8,7,17.3
2,0,1,2,0,5,2,0,0,"19",1,1,4,2,0,0,1037947,"2023-12-18T00:00:00.000Z",21,FALSE,15,38017716,"F",21,21,"Oklahoma City Thunder","Ousmane Dieng",0,6,8,6,4,9.4
1,0,2,3,2,8,3,0,0,"23",2,1,8,4,0,2,1037948,"2023-12-18T00:00:00.000Z",8,FALSE,7,375,"F",8,8,"Denver Nuggets","Michael Porter Jr.",0,12,13,9,5,12.3
5,0,4,3,2,9,7,6,5,"24",1,1,21,5,1,0,1037948,"2023-12-18T00:00:00.000Z",8,FALSE,7,177,"F",8,8,"Denver Nuggets","Aaron Gordon",1,26,31,26,10,37.5
7,0,8,1,0,8,3,2,2,"28",1,2,8,9,2,2,1037948,"2023-12-18T00:00:00.000Z",8,FALSE,7,246,"C",8,8,"Denver Nuggets","Nikola Jokic",2,17,24,15,16,33.3
2,0,2,2,1,6,4,0,0,"26",1,0,9,3,0,0,1037948,"2023-12-18T00:00:00.000Z",8,FALSE,7,81,"G",8,8,"Denver Nuggets","Kentavious Caldwell-Pope",0,12,14,11,5,15.6
2,1,4,4,4,14,8,2,2,"25",0,1,22,4,1,2,1037948,"2023-12-18T00:00:00.000Z",8,FALSE,7,335,"G",8,8,"Denver Nuggets","Jamal Murray",2,26,28,24,6,33.8
1,0,4,1,0,5,3,3,2,"20",0,4,8,4,0,1,1037948,"2023-12-18T00:00:00.000Z",8,FALSE,7,38017709,"G",8,8,"Denver Nuggets","Christian Braun",0,12,13,9,5,13.3
0,0,0,0,0,1,0,0,0,"05",1,1,0,1,0,0,1037948,"2023-12-18T00:00:00.000Z",8,FALSE,7,38017727,"G",8,8,"Denver Nuggets","Collin Gillespie",0,1,1,0,1,1.2
0,1,1,0,0,2,0,0,0,"05",0,1,0,1,0,0,1037948,"2023-12-18T00:00:00.000Z",8,FALSE,7,215,"F-G",8,8,"Denver Nuggets","Justin Holiday",1,1,1,0,1,4.2
4,0,1,3,1,11,8,1,1,"19",0,2,18,1,0,0,1037948,"2023-12-18T00:00:00.000Z",8,FALSE,7,236,"G",8,8,"Denver Nuggets","Reggie Jackson",0,19,23,22,5,25.2
0,0,0,0,0,0,0,0,0,"00",0,0,0,0,0,0,1037948,"2023-12-18T00:00:00.000Z",8,FALSE,7,250,"C",8,8,"Denver Nuggets","DeAndre Jordan",0,0,0,0,0,0
2,1,2,2,0,8,5,4,4,"20",2,4,14,4,1,1,1037948,"2023-12-18T00:00:00.000Z",8,FALSE,7,3547268,"F-C",8,8,"Denver Nuggets","Zeke Nnaji",2,18,20,16,6,26.8
2,0,3,4,2,10,5,0,0,"21",0,1,12,3,0,0,1037948,"2023-12-18T00:00:00.000Z",8,FALSE,7,56677776,"G",8,8,"Denver Nuggets","Julian Strawther",0,15,17,14,5,18.6
3,1,6,3,2,5,3,4,2,"24",1,1,10,7,2,0,1037948,"2023-12-18T00:00:00.000Z",8,FALSE,7,38017721,"G",8,8,"Denver Nuggets","Peyton Watson",3,17,20,13,10,31.9
0,0,0,0,0,0,0,0,0,"00",0,0,0,0,0,0,1037948,"2023-12-18T00:00:00.000Z",8,FALSE,7,666489,"F",8,8,"Denver Nuggets","Vlatko Cancar",0,0,0,0,0,0
0,0,0,0,0,0,0,0,0,"00",0,0,0,0,0,0,1037948,"2023-12-18T00:00:00.000Z",8,FALSE,7,17896103,"F-C",8,8,"Denver Nuggets","Jay Huff",0,0,0,0,0,0
0,0,0,0,0,0,0,0,0,"00",0,0,0,0,0,0,1037948,"2023-12-18T00:00:00.000Z",8,FALSE,7,17896007,"G",8,8,"Denver Nuggets","Braxton Key",0,0,0,0,0,0
0,0,0,0,0,0,0,0,0,"00",0,0,0,0,0,0,1037948,"2023-12-18T00:00:00.000Z",8,FALSE,7,56677582,"G",8,8,"Denver Nuggets","Jalen Pickett",0,0,0,0,0,0
0,0,0,0,0,0,0,0,0,"00",0,0,0,0,0,0,1037948,"2023-12-18T00:00:00.000Z",8,FALSE,7,56677871,"F",8,8,"Denver Nuggets","Hunter Tyson",0,0,0,0,0,0
1,0,1,5,0,9,3,0,0,"24",0,0,6,1,2,1,1037948,"2023-12-18T00:00:00.000Z",8,FALSE,7,247,"F-G",7,7,"Dallas Mavericks","Derrick Jones Jr.",2,7,8,7,2,13.7
0,0,2,2,1,8,3,0,0,"22",1,2,7,3,0,0,1037948,"2023-12-18T00:00:00.000Z",8,FALSE,7,666965,"F",7,7,"Dallas Mavericks","Grant Williams",0,10,10,7,3,10.6
0,0,2,0,0,6,4,0,0,"23",6,4,8,8,0,1,1037948,"2023-12-18T00:00:00.000Z",8,FALSE,7,379,"F-C",7,7,"Dallas Mavericks","Dwight Powell",0,16,16,8,8,16.6
2,0,1,1,1,5,5,0,0,"23",0,3,11,1,0,1,1037948,"2023-12-18T00:00:00.000Z",8,FALSE,7,151,"G",7,7,"Dallas Mavericks","Dante Exum",0,12,14,13,3,14.2
8,0,8,12,6,24,13,10,6,"36",3,1,38,11,0,3,1037948,"2023-12-18T00:00:00.000Z",8,FALSE,7,132,"F-G",7,7,"Dallas Mavericks","Luka Doncic",0,49,57,46,19,60.2
1,0,2,9,2,12,3,0,0,"22",0,2,8,2,0,2,1037948,"2023-12-18T00:00:00.000Z",8,FALSE,7,191,"G",7,7,"Dallas Mavericks","Tim Hardaway Jr.",0,10,11,9,3,9.9
3,0,3,2,0,5,1,0,0,"20",1,1,2,4,0,0,1037948,"2023-12-18T00:00:00.000Z",8,FALSE,7,56677859,"F",7,7,"Dallas Mavericks","Olivier-Maxence Prosper",0,6,9,5,7,11.3
0,0,3,2,0,3,1,0,0,"13",0,1,2,3,0,0,1037948,"2023-12-18T00:00:00.000Z",8,FALSE,7,329,"F",7,7,"Dallas Mavericks","Markieff Morris",0,5,5,2,3,5.6
0,0,1,0,0,3,2,5,1,"09",1,1,5,2,0,1,1037948,"2023-12-18T00:00:00.000Z",8,FALSE,7,17896028,"F",7,7,"Dallas Mavericks","Greg Brown III",0,7,7,5,2,6.4
0,0,0,0,0,0,0,0,0,"07",0,2,0,0,0,0,1037948,"2023-12-18T00:00:00.000Z",8,FALSE,7,114,"G",7,7,"Dallas Mavericks","Seth Curry",0,0,0,0,0,0
0,0,0,0,0,0,0,0,0,"00",0,0,0,0,0,0,1037948,"2023-12-18T00:00:00.000Z",8,FALSE,7,56677873,"G",7,7,"Dallas Mavericks","Dexter Dennis",0,0,0,0,0,0
3,1,1,3,2,9,3,2,1,"19",0,1,9,1,0,1,1037948,"2023-12-18T00:00:00.000Z",8,FALSE,7,38017679,"G",7,7,"Dallas Mavericks","Jaden Hardy",1,10,13,12,4,16.7
0,0,3,0,0,4,1,0,0,"07",1,0,2,4,0,0,1037948,"2023-12-18T00:00:00.000Z",8,FALSE,7,217,"F-C",7,7,"Dallas Mavericks","Richaun Holmes",0,6,6,2,4,6.8
0,0,1,2,1,4,2,2,1,"15",1,2,6,2,0,1,1037948,"2023-12-18T00:00:00.000Z",8,FALSE,7,17554004,"G",7,7,"Dallas Mavericks","AJ Lawson",0,8,8,6,2,7.4
0,0,0,0,0,0,0,0,0,"00",0,0,0,0,0,0,1037948,"2023-12-18T00:00:00.000Z",8,FALSE,7,3547258,"G",7,7,"Dallas Mavericks","Josh Green",0,0,0,0,0,0
0,0,0,0,0,0,0,0,0,"00",0,0,0,0,0,0,1037948,"2023-12-18T00:00:00.000Z",8,FALSE,7,228,"G",7,7,"Dallas Mavericks","Kyrie Irving",0,0,0,0,0,0
0,0,0,0,0,0,0,0,0,"00",0,0,0,0,0,0,1037948,"2023-12-18T00:00:00.000Z",8,FALSE,7,257,"F",7,7,"Dallas Mavericks","Maxi Kleber",0,0,0,0,0,0
0,0,0,0,0,0,0,0,0,"00",0,0,0,0,0,0,1037948,"2023-12-18T00:00:00.000Z",8,FALSE,7,56677840,"C",7,7,"Dallas Mavericks","Dereck Lively II",0,0,0,0,0,0
7,3,12,2,1,14,7,7,7,"39",5,3,22,17,0,5,1037946,"2023-12-18T00:00:00.000Z",28,FALSE,4,17896055,"G-F",28,28,"Toronto Raptors","Scottie Barnes",3,39,46,29,24,56.9
8,0,4,1,0,16,11,6,5,"36",4,1,27,8,1,2,1037946,"2023-12-18T00:00:00.000Z",28,FALSE,4,416,"F",28,28,"Toronto Raptors","Pascal Siakam",1,35,43,35,16,49.6
2,0,1,0,0,2,2,0,0,"15",0,3,4,1,0,4,1037946,"2023-12-18T00:00:00.000Z",28,FALSE,4,373,"C",28,28,"Toronto Raptors","Jakob Poeltl",0,5,7,6,3,4.2
2,0,2,5,0,10,2,1,1,"32",0,3,5,2,1,2,1037946,"2023-12-18T00:00:00.000Z",28,FALSE,4,18,"F",28,28,"Toronto Raptors","OG Anunoby",1,7,9,7,4,11.4
5,0,0,5,3,6,4,2,2,"34",0,2,13,0,0,3,1037946,"2023-12-18T00:00:00.000Z",28,FALSE,4,409,"G",28,28,"Toronto Raptors","Dennis Schroder",0,13,18,18,5,17.5
1,0,2,1,0,9,5,4,2,"18",5,1,12,7,1,0,1037946,"2023-12-18T00:00:00.000Z",28,FALSE,4,3547249,"F",28,28,"Toronto Raptors","Precious Achiuwa",1,19,20,13,8,24.9
0,1,2,1,0,6,3,2,1,"15",1,1,7,3,0,0,1037946,"2023-12-18T00:00:00.000Z",28,FALSE,4,58,"F",28,28,"Toronto Raptors","Chris Boucher",1,10,10,7,3,13.6
0,0,0,0,0,0,0,0,0,"00",0,0,0,0,0,0,1037946,"2023-12-18T00:00:00.000Z",28,FALSE,4,56677828,"G",28,28,"Toronto Raptors","Gradey Dick",0,0,0,0,0,0
2,0,3,4,0,6,1,0,0,"16",0,1,2,3,0,0,1037946,"2023-12-18T00:00:00.000Z",28,FALSE,4,3547275,"G",28,28,"Toronto Raptors","Malachi Flynn",0,5,7,4,5,8.6
0,0,0,0,0,0,0,0,0,"00",0,0,0,0,0,0,1037946,"2023-12-18T00:00:00.000Z",28,FALSE,4,666762,"F",28,28,"Toronto Raptors","Jalen McDaniels",0,0,0,0,0,0
3,0,10,10,4,17,9,0,0,"35",0,1,22,10,1,1,1037946,"2023-12-18T00:00:00.000Z",28,FALSE,4,3089,"",28,28,"Toronto Raptors","Gary Trent Jr.",1,32,35,25,13,40.5
0,0,0,0,0,0,0,0,0,"00",0,0,0,0,0,0,1037946,"2023-12-18T00:00:00.000Z",28,FALSE,4,489,"F",28,28,"Toronto Raptors","Thaddeus Young",0,0,0,0,0,0
0,0,0,0,0,0,0,0,0,"00",0,0,0,0,0,0,1037946,"2023-12-18T00:00:00.000Z",28,FALSE,4,56677805,"G",28,28,"Toronto Raptors","Javon Freeman-Liberty",0,0,0,0,0,0
0,0,0,0,0,0,0,0,0,"00",0,0,0,0,0,0,1037946,"2023-12-18T00:00:00.000Z",28,FALSE,4,38017710,"C",28,28,"Toronto Raptors","Christian Koloko",0,0,0,0,0,0
0,0,0,0,0,0,0,0,0,"00",0,0,0,0,0,0,1037946,"2023-12-18T00:00:00.000Z",28,FALSE,4,56677869,"G",28,28,"Toronto Raptors","Markquis Nowell",0,0,0,0,0,0
0,0,0,0,0,0,0,0,0,"00",0,0,0,0,0,0,1037946,"2023-12-18T00:00:00.000Z",28,FALSE,4,2309958,"C-F",15,28,"Toronto Raptors","Jontay Porter",0,0,0,0,0,0
1,1,5,5,2,9,4,4,4,"32",0,1,14,5,1,2,1037946,"2023-12-18T00:00:00.000Z",28,FALSE,4,38017708,"G",4,4,"Charlotte Hornets","Bryce McGowens",2,19,20,15,6,25.5
5,0,6,9,3,16,5,2,2,"39",1,5,15,7,4,2,1037946,"2023-12-18T00:00:00.000Z",28,FALSE,4,666950,"F",4,4,"Charlotte Hornets","P.J. Washington",4,22,27,20,12,40.9
3,0,6,0,0,5,4,2,2,"32",4,2,10,10,0,0,1037946,"2023-12-18T00:00:00.000Z",28,FALSE,4,3547282,"C",4,4,"Charlotte Hornets","Nick Richards",0,20,23,13,13,26.5
0,1,3,5,0,16,6,2,2,"37",0,3,14,3,0,3,1037946,"2023-12-18T00:00:00.000Z",28,FALSE,4,56677823,"F",4,4,"Charlotte Hornets","Brandon Miller",1,17,17,14,3,17.6
7,1,2,8,2,20,9,2,2,"32",1,4,22,3,3,3,1037946,"2023-12-18T00:00:00.000Z",28,FALSE,4,403,"G",4,4,"Charlotte Hornets","Terry Rozier",4,25,32,29,10,45.1
1,0,2,0,0,2,2,0,0,"11",2,1,4,4,0,0,1037946,"2023-12-18T00:00:00.000Z",28,FALSE,4,56677866,"F",4,4,"Charlotte Hornets","Leaky Black",0,8,9,5,5,10.3
0,0,0,0,0,0,0,0,0,"00",0,0,0,0,0,0,1037946,"2023-12-18T00:00:00.000Z",28,FALSE,4,17896037,"G",4,4,"Charlotte Hornets","James Bouknight",0,0,0,0,0,0
0,0,0,0,0,0,0,0,0,"00",0,0,0,0,0,0,1037946,"2023-12-18T00:00:00.000Z",28,FALSE,4,666748,"F",4,4,"Charlotte Hornets","Cody Martin",0,0,0,0,0,0
0,1,1,0,0,2,2,1,1,"14",2,0,5,3,0,0,1037946,"2023-12-18T00:00:00.000Z",28,FALSE,4,18678001,"F",4,4,"Charlotte Hornets","JT Thor",1,8,8,5,3,11.6
0,0,0,0,0,0,0,0,0,"00",0,0,0,0,0,0,1037946,"2023-12-18T00:00:00.000Z",28,FALSE,4,376,"F",28,28,"Toronto Raptors","Otto Porter Jr.",0,0,0,0,0,0
0,0,0,0,0,0,0,0,0,"00",0,0,0,0,0,0,1037946,"2023-12-18T00:00:00.000Z",28,FALSE,4,436,"G-F",28,28,"Toronto Raptors","Garrett Temple",0,0,0,0,0,0
0,0,0,0,0,0,0,0,0,"00",0,0,0,0,0,0,1037946,"2023-12-18T00:00:00.000Z",28,FALSE,4,347,"G",4,4,"Charlotte Hornets","Frank Ntilikina",0,0,0,0,0,0
1,1,0,0,0,10,4,0,0,"23",0,1,8,0,0,1,1037946,"2023-12-18T00:00:00.000Z",28,FALSE,4,422,"G",4,4,"Charlotte Hornets","Ish Smith",1,8,9,9,1,11.5
0,1,1,5,1,9,3,0,0,"20",0,2,7,1,0,1,1037946,"2023-12-18T00:00:00.000Z",28,FALSE,4,56677846,"G",4,4,"Charlotte Hornets","Nick Smith Jr.",1,8,8,7,1,10.2
0,0,0,0,0,0,0,0,0,"00",0,0,0,0,0,0,1037946,"2023-12-18T00:00:00.000Z",28,FALSE,4,56677848,"G",4,4,"Charlotte Hornets","Amari Bailey",0,0,0,0,0,0
0,0,0,0,0,0,0,0,0,"00",0,0,0,0,0,0,1037946,"2023-12-18T00:00:00.000Z",28,FALSE,4,3547239,"G",4,4,"Charlotte Hornets","LaMelo Ball",0,0,0,0,0,0
0,0,0,0,0,0,0,0,0,"00",0,0,0,0,0,0,1037946,"2023-12-18T00:00:00.000Z",28,FALSE,4,62,"F",4,4,"Charlotte Hornets","Miles Bridges",0,0,0,0,0,0
0,0,0,0,0,0,0,0,0,"00",0,0,0,0,0,0,1037946,"2023-12-18T00:00:00.000Z",28,FALSE,4,204,"F",4,4,"Charlotte Hornets","Gordon Hayward",0,0,0,0,0,0
0,0,0,0,0,0,0,0,0,"00",0,0,0,0,0,0,1037946,"2023-12-18T00:00:00.000Z",28,FALSE,4,NA,NA,NA,4,"Charlotte Hornets","NA NA",0,0,0,0,0,0
0,0,0,0,0,0,0,0,0,"00",0,0,0,0,0,0,1037946,"2023-12-18T00:00:00.000Z",28,FALSE,4,38017698,"C",4,4,"Charlotte Hornets","Mark Williams",0,0,0,0,0,0
2,2,5,6,5,15,7,0,0,"29",1,5,19,6,1,4,1037944,"2023-12-18T00:00:00.000Z",1,FALSE,9,666656,"F",1,1,"Atlanta Hawks","De'Andre Hunter",3,25,27,21,8,34.2
1,0,2,7,2,15,8,5,3,"42",2,1,21,4,2,1,1037944,"2023-12-18T00:00:00.000Z",1,FALSE,9,3547256,"F",1,1,"Atlanta Hawks","Saddiq Bey",2,25,26,22,5,32.3
2,3,8,0,0,11,7,3,3,"28",7,3,17,15,1,1,1037944,"2023-12-18T00:00:00.000Z",1,FALSE,9,83,"C",1,1,"Atlanta Hawks","Clint Capela",4,32,34,19,17,49
3,1,3,5,3,13,8,2,1,"33",0,2,20,3,1,1,1037944,"2023-12-18T00:00:00.000Z",1,FALSE,9,334,"G",1,1,"Atlanta Hawks","Dejounte Murray",2,23,26,23,6,33.1
15,0,4,11,4,17,8,12,11,"38",0,3,31,4,0,5,1037944,"2023-12-18T00:00:00.000Z",1,FALSE,9,490,"G",1,1,"Atlanta Hawks","Trae Young",0,35,50,46,19,53.3
0,0,0,0,0,0,0,0,0,"00",0,0,0,0,0,0,1037944,"2023-12-18T00:00:00.000Z",1,FALSE,9,53,"G",1,1,"Atlanta Hawks","Bogdan Bogdanovic",0,0,0,0,0,0
0,0,0,0,0,0,0,0,0,"00",0,0,0,0,0,0,1037944,"2023-12-18T00:00:00.000Z",1,FALSE,9,666564,"F",1,1,"Atlanta Hawks","Bruno Fernando",0,0,0,0,0,0
0,0,0,0,0,0,0,0,0,"00",0,0,0,0,0,0,1037944,"2023-12-18T00:00:00.000Z",1,FALSE,9,3547297,"G",1,1,"Atlanta Hawks","Trent Forrest",0,0,0,0,0,0
0,0,1,1,0,1,0,0,0,"09",0,2,0,1,0,0,1037944,"2023-12-18T00:00:00.000Z",1,FALSE,9,56677855,"G",1,1,"Atlanta Hawks","Seth Lundy",0,1,1,0,1,1.2
0,2,2,5,2,5,2,1,0,"23",1,5,6,3,0,2,1037944,"2023-12-18T00:00:00.000Z",1,FALSE,9,666754,"G",1,1,"Atlanta Hawks","Garrison Mathews",2,9,9,6,3,13.6
1,1,2,1,0,2,1,0,0,"15",0,1,2,2,1,1,1037944,"2023-12-18T00:00:00.000Z",1,FALSE,9,301,"G-F",1,1,"Atlanta Hawks","Wesley Matthews",2,4,5,3,3,10.9
0,0,0,0,0,0,0,0,0,"00",0,0,0,0,0,0,1037944,"2023-12-18T00:00:00.000Z",1,FALSE,9,319,"G",1,1,"Atlanta Hawks","Patty Mills",0,0,0,0,0,0
0,0,0,0,0,0,0,0,0,"00",0,0,0,0,0,0,1037944,"2023-12-18T00:00:00.000Z",1,FALSE,9,56677875,"F",1,1,"Atlanta Hawks","Miles Norris",0,0,0,0,0,0
1,1,2,0,0,6,5,4,4,"23",0,2,14,2,0,2,1037944,"2023-12-18T00:00:00.000Z",1,FALSE,9,3547244,"F-C",1,1,"Atlanta Hawks","Onyeka Okongwu",1,16,17,15,3,18.9
0,0,0,0,0,0,0,0,0,"00",0,0,0,0,0,0,1037944,"2023-12-18T00:00:00.000Z",1,FALSE,9,56677838,"G",1,1,"Atlanta Hawks","Kobe Bufkin",0,0,0,0,0,0
0,0,0,0,0,0,0,0,0,"00",0,0,0,0,0,0,1037944,"2023-12-18T00:00:00.000Z",1,FALSE,9,38017689,"F",1,1,"Atlanta Hawks","AJ Griffin",0,0,0,0,0,0
0,0,0,0,0,0,0,0,0,"00",0,0,0,0,0,0,1037944,"2023-12-18T00:00:00.000Z",1,FALSE,9,56677806,"F",1,1,"Atlanta Hawks","Mouhamed Gueye",0,0,0,0,0,0
0,0,0,0,0,0,0,0,0,"00",0,0,0,0,0,0,1037944,"2023-12-18T00:00:00.000Z",1,FALSE,9,17896040,"F",1,1,"Atlanta Hawks","Jalen Johnson",0,0,0,0,0,0
3,0,5,1,0,5,1,0,0,"19",3,2,2,8,1,2,1037944,"2023-12-18T00:00:00.000Z",1,FALSE,9,56677826,"G-F",9,9,"Detroit Pistons","Ausar Thompson",1,10,13,5,11,17.1
2,0,1,9,5,17,9,3,2,"39",1,3,25,2,0,2,1037944,"2023-12-18T00:00:00.000Z",1,FALSE,9,54,"F",9,9,"Detroit Pistons","Bojan Bogdanovic",0,27,29,27,4,28.4
2,0,1,2,0,11,2,2,2,"23",1,3,6,2,1,0,1037944,"2023-12-18T00:00:00.000Z",1,FALSE,9,77,"G",9,9,"Detroit Pistons","Alec Burks",1,8,10,8,4,14.4
2,1,1,1,0,1,0,2,1,"12",1,1,1,2,1,0,1037944,"2023-12-18T00:00:00.000Z",1,FALSE,9,197,"F-G",9,9,"Detroit Pistons","Joe Harris",2,3,5,3,4,12.4
0,0,0,0,0,0,0,0,0,"00",0,0,0,0,0,0,1037944,"2023-12-18T00:00:00.000Z",1,FALSE,9,44477024,"G",9,9,"Detroit Pistons","Stanley Umude",0,0,0,0,0,0
0,0,0,0,0,0,0,0,0,"00",0,0,0,0,0,0,1037944,"2023-12-18T00:00:00.000Z",1,FALSE,9,3547241,"G",9,9,"Detroit Pistons","Killian Hayes",0,0,0,0,0,0
0,0,0,0,0,0,0,0,0,"00",0,0,0,0,0,0,1037944,"2023-12-18T00:00:00.000Z",1,FALSE,9,259,"F",9,9,"Detroit Pistons","Kevin Knox",0,0,0,0,0,0
0,0,0,1,0,3,0,0,0,"05",0,0,0,0,0,0,1037944,"2023-12-18T00:00:00.000Z",1,FALSE,9,17896071,"F",9,9,"Detroit Pistons","Isaiah Livers",0,0,0,0,0,0
1,1,1,1,1,3,2,0,0,"21",0,6,5,1,1,0,1037944,"2023-12-18T00:00:00.000Z",1,FALSE,9,56677792,"G",9,9,"Detroit Pistons","Marcus Sasser",2,6,7,6,2,13.7
0,0,0,0,0,0,0,0,0,"00",0,0,0,0,0,0,1037944,"2023-12-18T00:00:00.000Z",1,FALSE,9,3547267,"F-C",9,9,"Detroit Pistons","Isaiah Stewart",0,0,0,0,0,0
2,0,5,0,0,5,5,2,0,"25",2,2,10,7,0,2,1037944,"2023-12-18T00:00:00.000Z",1,FALSE,9,3547240,"C",9,9,"Detroit Pistons","James Wiseman",0,17,19,12,9,19.4
0,0,0,0,0,0,0,0,0,"00",0,0,0,0,0,0,1037944,"2023-12-18T00:00:00.000Z",1,FALSE,9,56677729,"G",9,9,"Detroit Pistons","Malcolm Cazalon",0,0,0,0,0,0
0,0,0,0,0,0,0,0,0,"00",0,0,0,0,0,0,1037944,"2023-12-18T00:00:00.000Z",1,FALSE,9,38017694,"C",9,9,"Detroit Pistons","Jalen Duren",0,0,0,0,0,0
0,0,0,0,0,0,0,0,0,"00",0,0,0,0,0,0,1037944,"2023-12-18T00:00:00.000Z",1,FALSE,9,330,"G",9,9,"Detroit Pistons","Monte Morris",0,0,0,0,0,0
0,0,0,0,0,0,0,0,0,"00",0,0,0,0,0,0,1037944,"2023-12-18T00:00:00.000Z",1,FALSE,9,42097199,"G",9,9,"Detroit Pistons","Jared Rhoden",0,0,0,0,0,0
7,1,4,5,3,24,16,9,8,"44",1,1,43,5,3,3,1037944,"2023-12-18T00:00:00.000Z",1,FALSE,9,17896075,"G-F",9,9,"Detroit Pistons","Cade Cunningham",4,48,55,50,12,68.5
0,0,0,0,0,12,7,4,3,"23",1,2,17,1,0,2,1037944,"2023-12-18T00:00:00.000Z",1,FALSE,9,24,"F",9,9,"Detroit Pistons","Marvin Bagley III",0,18,18,17,1,16.2
4,0,6,2,0,13,6,5,3,"29",2,6,15,8,0,2,1037944,"2023-12-18T00:00:00.000Z",1,FALSE,9,38017682,"G",9,9,"Detroit Pistons","Jaden Ivey",0,23,27,19,12,28.6
3,0,2,3,0,7,1,0,0,"25",2,3,2,4,2,1,1037949,"2023-12-18T00:00:00.000Z",29,FALSE,3,38017739,"F",29,29,"Utah Jazz","Simone Fontecchio",2,6,9,5,7,16.3
4,1,9,5,1,14,6,7,7,"29",1,1,20,10,0,2,1037949,"2023-12-18T00:00:00.000Z",29,FALSE,3,297,"F",29,29,"Utah Jazz","Lauri Markkanen",1,30,34,24,14,39
0,5,11,0,0,8,6,4,2,"32",3,1,14,14,0,1,1037949,"2023-12-18T00:00:00.000Z",29,FALSE,3,38017705,"C",29,29,"Utah Jazz","Walker Kessler",5,28,28,14,14,44.8
6,0,2,7,3,17,6,13,12,"35",1,3,27,3,0,2,1037949,"2023-12-18T00:00:00.000Z",29,FALSE,3,413,"G",29,29,"Utah Jazz","Collin Sexton",0,30,36,33,9,37.6
6,0,3,7,5,19,11,0,0,"31",0,2,27,3,2,1,1037949,"2023-12-18T00:00:00.000Z",29,FALSE,3,666650,"G",29,29,"Utah Jazz","Talen Horton-Tucker",2,30,36,33,9,44.6
2,1,2,5,1,10,6,0,0,"23",1,1,13,3,1,2,1037949,"2023-12-18T00:00:00.000Z",29,FALSE,3,38017620,"G",29,29,"Utah Jazz","Ochai Agbaji",2,16,18,15,5,23.6
5,0,1,0,0,2,2,0,0,"16",2,1,4,3,0,0,1037949,"2023-12-18T00:00:00.000Z",29,FALSE,3,139,"G",29,29,"Utah Jazz","Kris Dunn",0,7,12,9,8,15.1
3,0,4,1,0,2,1,0,0,"20",1,4,2,5,1,0,1037949,"2023-12-18T00:00:00.000Z",29,FALSE,3,358,"F",29,29,"Utah Jazz","Kelly Olynyk",1,7,10,5,8,15.5
0,0,0,0,0,0,0,0,0,"03",0,0,0,0,0,0,1037949,"2023-12-18T00:00:00.000Z",29,FALSE,3,174,"F-C",3,3,"Brooklyn Nets","Harry Giles III",0,0,0,0,0,0
1,0,1,6,2,6,2,0,0,"23",0,2,6,1,1,1,1037949,"2023-12-18T00:00:00.000Z",29,FALSE,3,351,"F",3,3,"Brooklyn Nets","Royce O'Neale",1,7,8,7,2,10.7
0,1,2,0,0,5,3,1,0,"17",3,1,6,5,0,1,1037949,"2023-12-18T00:00:00.000Z",29,FALSE,3,17896038,"C",3,3,"Brooklyn Nets","Day'Ron Sharpe",1,11,11,6,5,14
0,0,0,0,0,0,0,0,0,"00",0,0,0,0,0,0,1037949,"2023-12-18T00:00:00.000Z",29,FALSE,3,421,"G",3,3,"Brooklyn Nets","Dennis Smith Jr.",0,0,0,0,0,0
1,1,3,1,1,3,2,0,0,"07",0,0,5,3,0,0,1037949,"2023-12-18T00:00:00.000Z",29,FALSE,3,17896058,"F",3,3,"Brooklyn Nets","Trendon Watford",1,8,9,6,4,13.1
0,0,0,1,1,1,1,2,2,"08",0,2,5,0,0,1,1037949,"2023-12-18T00:00:00.000Z",29,FALSE,3,56677722,"F",3,3,"Brooklyn Nets","Jalen Wilson",0,5,5,5,0,4
0,0,0,0,0,0,0,0,0,"00",0,0,0,0,0,0,1037949,"2023-12-18T00:00:00.000Z",29,FALSE,3,9051997,"G",3,3,"Brooklyn Nets","Armoni Brooks",0,0,0,0,0,0
0,0,0,0,0,0,0,0,0,"00",0,0,0,0,0,0,1037949,"2023-12-18T00:00:00.000Z",29,FALSE,3,56677843,"F",3,3,"Brooklyn Nets","Noah Clowney",0,0,0,0,0,0
0,0,0,0,0,0,0,0,0,"00",0,0,0,0,0,0,1037949,"2023-12-18T00:00:00.000Z",29,FALSE,3,17896041,"G",3,3,"Brooklyn Nets","Keon Johnson",0,0,0,0,0,0
0,0,0,0,0,0,0,0,0,"00",0,0,0,0,0,0,1037949,"2023-12-18T00:00:00.000Z",29,FALSE,3,417,"G-F",3,3,"Brooklyn Nets","Ben Simmons",0,0,0,0,0,0
0,0,0,0,0,0,0,0,0,"00",0,0,0,0,0,0,1037949,"2023-12-18T00:00:00.000Z",29,FALSE,3,464,"G",3,3,"Brooklyn Nets","Lonnie Walker IV",0,0,0,0,0,0
0,0,0,0,0,0,0,0,0,"00",0,0,0,0,0,0,1037949,"2023-12-18T00:00:00.000Z",29,FALSE,3,56677841,"F",3,3,"Brooklyn Nets","Dariq Whitehead",0,0,0,0,0,0
0,1,2,4,3,9,4,0,0,"20",1,2,11,3,0,4,1037949,"2023-12-18T00:00:00.000Z",29,FALSE,3,101,"F-C",29,29,"Utah Jazz","John Collins",1,14,14,11,3,13.6
1,0,2,1,0,1,0,0,0,"07",0,1,0,2,0,1,1037949,"2023-12-18T00:00:00.000Z",29,FALSE,3,56677824,"F",29,29,"Utah Jazz","Taylor Hendricks",0,2,3,1,3,2.9
0,0,0,0,0,0,0,0,0,"00",0,0,0,0,0,0,1037949,"2023-12-18T00:00:00.000Z",29,FALSE,3,56677834,"G",29,29,"Utah Jazz","Keyonte George",0,0,0,0,0,0
0,0,1,1,1,2,2,0,0,"02",0,1,5,1,0,0,1037949,"2023-12-18T00:00:00.000Z",29,FALSE,3,666881,"F",29,29,"Utah Jazz","Luka Samanic",0,6,6,5,1,6.2
0,0,0,0,0,0,0,0,0,"00",0,0,0,0,0,0,1037949,"2023-12-18T00:00:00.000Z",29,FALSE,3,17896023,"G",29,29,"Utah Jazz","Josh Christopher",0,0,0,0,0,0
0,0,0,0,0,0,0,0,0,"00",0,0,0,0,0,0,1037949,"2023-12-18T00:00:00.000Z",29,FALSE,3,100,"G",29,29,"Utah Jazz","Jordan Clarkson",0,0,0,0,0,0
0,0,0,0,0,0,0,0,0,"00",0,0,0,0,0,0,1037949,"2023-12-18T00:00:00.000Z",29,FALSE,3,38017630,"G",29,29,"Utah Jazz","Johnny Juzang",0,0,0,0,0,0
0,0,0,0,0,0,0,0,0,"00",0,0,0,0,0,0,1037949,"2023-12-18T00:00:00.000Z",29,FALSE,3,19465584,"F",29,29,"Utah Jazz","Micah Potter",0,0,0,0,0,0
5,0,1,8,3,16,4,5,2,"35",0,3,13,1,0,2,1037949,"2023-12-18T00:00:00.000Z",29,FALSE,3,61,"F",3,3,"Brooklyn Nets","Mikal Bridges",0,14,19,18,6,19.7
1,0,4,5,1,9,2,2,2,"27",1,1,7,5,1,1,1037949,"2023-12-18T00:00:00.000Z",29,FALSE,3,666679,"F",3,3,"Brooklyn Nets","Cameron Johnson",1,12,13,8,6,16.5
0,3,5,0,0,5,4,4,3,"26",2,3,11,7,0,3,1037949,"2023-12-18T00:00:00.000Z",29,FALSE,3,666508,"F-C",3,3,"Brooklyn Nets","Nicolas Claxton",3,18,18,11,7,25.4
3,1,2,7,5,23,12,3,3,"37",2,1,32,4,1,3,1037949,"2023-12-18T00:00:00.000Z",29,FALSE,3,17896048,"G",3,3,"Brooklyn Nets","Cam Thomas",2,36,39,35,7,44.3
11,2,7,6,1,15,7,3,2,"36",1,0,17,8,0,1,1037949,"2023-12-18T00:00:00.000Z",29,FALSE,3,130,"G",3,3,"Brooklyn Nets","Spencer Dinwiddie",2,25,36,28,19,48.1
3,0,0,5,2,7,2,0,0,"21",2,4,6,2,1,0,1037949,"2023-12-18T00:00:00.000Z",29,FALSE,3,158,"F",3,3,"Brooklyn Nets","Dorian Finney-Smith",1,8,11,9,5,15.9
0,0,0,0,0,0,0,0,0,"00",0,0,0,0,0,0,1037949,"2023-12-18T00:00:00.000Z",29,FALSE,3,56677842,"F",29,29,"Utah Jazz","Brice Sensabaugh",0,0,0,0,0,0
0,0,0,0,0,0,0,0,0,"00",0,0,0,0,0,0,1037949,"2023-12-18T00:00:00.000Z",29,FALSE,3,11891374,"C",29,29,"Utah Jazz","Omer Yurtseven",0,0,0,0,0,0
0,0,0,4,2,11,8,1,1,"33",0,1,19,0,1,1,1037950,"2023-12-18T00:00:00.000Z",26,FALSE,30,30,"F",26,26,"Sacramento Kings","Harrison Barnes",1,19,19,19,0,21
4,0,4,7,4,17,9,3,3,"32",1,4,25,5,1,0,1037950,"2023-12-18T00:00:00.000Z",26,FALSE,30,38017688,"F",26,26,"Sacramento Kings","Keegan Murray",1,30,34,29,9,40
12,1,10,1,1,16,11,6,5,"32",3,1,28,13,0,2,1037950,"2023-12-18T00:00:00.000Z",26,FALSE,30,406,"F",26,26,"Sacramento Kings","Domantas Sabonis",1,41,53,40,25,62.6
2,1,4,4,1,8,4,2,2,"23",0,4,11,4,0,0,1037950,"2023-12-18T00:00:00.000Z",26,FALSE,30,221,"G",26,26,"Sacramento Kings","Kevin Huerter",1,15,17,13,6,21.8
6,1,5,7,2,19,10,12,8,"33",0,2,30,5,3,1,1037950,"2023-12-18T00:00:00.000Z",26,FALSE,30,161,"G",26,26,"Sacramento Kings","De'Aaron Fox",4,35,41,36,11,56
0,0,0,1,0,1,0,0,0,"04",0,0,0,0,0,0,1037950,"2023-12-18T00:00:00.000Z",26,FALSE,30,17896030,"G",26,26,"Sacramento Kings","Chris Duarte",0,0,0,0,0,0
1,0,1,2,1,2,1,0,0,"04",0,0,3,1,0,1,1037950,"2023-12-18T00:00:00.000Z",26,FALSE,30,17896044,"F",26,26,"Sacramento Kings","Kessler Edwards",0,4,5,4,2,4.7
2,1,1,5,1,5,1,0,0,"15",0,4,3,1,1,0,1037950,"2023-12-18T00:00:00.000Z",26,FALSE,30,38017714,"G",26,26,"Sacramento Kings","Keon Ellis",2,4,6,5,3,13.2
0,0,0,0,0,3,1,0,0,"04",1,1,2,1,0,0,1037950,"2023-12-18T00:00:00.000Z",26,FALSE,30,56677845,"G",26,26,"Sacramento Kings","Colby Jones",0,3,3,2,1,3.2
0,0,2,3,0,3,0,0,0,"18",0,0,0,2,0,0,1037950,"2023-12-18T00:00:00.000Z",26,FALSE,30,290,"F",26,26,"Sacramento Kings","Trey Lyles",0,2,2,0,2,2.4
0,0,0,0,0,0,0,0,0,"00",0,0,0,0,0,0,1037950,"2023-12-18T00:00:00.000Z",26,FALSE,30,306,"C",26,26,"Sacramento Kings","JaVale McGee",0,0,0,0,0,0
1,0,1,0,0,2,1,0,0,"04",0,0,2,1,0,0,1037950,"2023-12-18T00:00:00.000Z",26,FALSE,30,17553994,"G",26,26,"Sacramento Kings","Davion Mitchell",0,3,4,3,2,4.7
6,1,1,6,3,7,3,2,1,"21",0,3,10,1,0,1,1037950,"2023-12-18T00:00:00.000Z",26,FALSE,30,324,"G",26,26,"Sacramento Kings","Malik Monk",1,11,17,16,7,22.2
0,0,1,0,0,1,1,0,0,"05",0,3,2,1,0,0,1037950,"2023-12-18T00:00:00.000Z",26,FALSE,30,666925,"F",29,26,"Sacramento Kings","Juan Toscano-Anderson",0,3,3,2,1,3.2
1,0,3,3,2,5,3,0,0,"12",4,1,8,7,2,1,1037950,"2023-12-18T00:00:00.000Z",26,FALSE,30,4197162,"F",26,26,"Sacramento Kings","Aleksandar Vezenkov",2,15,16,9,8,22.9
0,0,0,0,0,0,0,0,0,"00",0,0,0,0,0,0,1037950,"2023-12-18T00:00:00.000Z",26,FALSE,30,17895990,"G",26,26,"Sacramento Kings","Jordan Ford",0,0,0,0,0,0
0,0,0,0,0,0,0,0,0,"00",0,0,0,0,0,0,1037950,"2023-12-18T00:00:00.000Z",26,FALSE,30,273,"C",26,26,"Sacramento Kings","Alex Len",0,0,0,0,0,0
0,0,0,0,0,0,0,0,0,"00",0,0,0,0,0,0,1037950,"2023-12-18T00:00:00.000Z",26,FALSE,30,56677862,"F",26,26,"Sacramento Kings","Jalen Slawson",0,0,0,0,0,0
3,0,5,3,1,8,3,4,2,"23",0,5,9,5,1,2,1037950,"2023-12-18T00:00:00.000Z",26,FALSE,30,3547242,"F",30,30,"Washington Wizards","Deni Avdija",1,14,17,12,8,20.5
1,1,8,7,3,16,8,8,8,"29",0,1,27,8,0,3,1037950,"2023-12-18T00:00:00.000Z",26,FALSE,30,265,"F",30,30,"Washington Wizards","Kyle Kuzma",1,35,36,28,9,38.1
1,3,3,0,0,5,3,2,2,"25",2,4,8,5,0,0,1037950,"2023-12-18T00:00:00.000Z",26,FALSE,30,666577,"F",30,30,"Washington Wizards","Daniel Gafford",3,13,14,9,6,24.5
2,0,0,13,8,18,10,0,0,"29",0,4,28,0,0,1,1037950,"2023-12-18T00:00:00.000Z",26,FALSE,30,666848,"G",30,30,"Washington Wizards","Jordan Poole",0,28,30,30,2,30
9,0,1,2,2,10,7,0,0,"28",0,0,16,1,1,0,1037950,"2023-12-18T00:00:00.000Z",26,FALSE,30,249,"G",30,30,"Washington Wizards","Tyus Jones",1,17,26,25,10,33.7
2,1,3,2,0,7,3,7,5,"33",1,1,11,4,0,0,1037950,"2023-12-18T00:00:00.000Z",26,FALSE,30,56677844,"G",30,30,"Washington Wizards","Bilal Coulibaly",1,15,17,13,6,21.8
3,0,3,2,0,5,2,0,0,"20",1,1,4,4,0,1,1037950,"2023-12-18T00:00:00.000Z",26,FALSE,30,3547302,"F",30,30,"Washington Wizards","Anthony Gill",0,8,11,7,7,12.3
3,0,3,5,2,6,2,2,1,"20",0,1,7,3,0,2,1037950,"2023-12-18T00:00:00.000Z",26,FALSE,30,17896045,"F",30,30,"Washington Wizards","Corey Kispert",0,10,13,10,6,13.1
2,1,5,1,1,3,2,6,6,"23",1,3,11,6,1,2,1037950,"2023-12-18T00:00:00.000Z",26,FALSE,30,337,"F-C",30,30,"Washington Wizards","Mike Muscala",2,17,19,13,8,25.2
0,0,0,0,0,0,0,0,0,"00",0,0,0,0,0,0,1037950,"2023-12-18T00:00:00.000Z",26,FALSE,30,167,"F",30,30,"Washington Wizards","Danilo Gallinari",0,0,0,0,0,0
0,0,0,0,0,0,0,0,0,"00",0,0,0,0,0,0,1037950,"2023-12-18T00:00:00.000Z",26,FALSE,30,38017712,"G",30,30,"Washington Wizards","Ryan Rollins",0,0,0,0,0,0
0,0,0,0,0,0,0,0,0,"00",0,0,0,0,0,0,1037950,"2023-12-18T00:00:00.000Z",26,FALSE,30,414,"G",30,30,"Washington Wizards","Landry Shamet",0,0,0,0,0,0
0,0,0,0,0,0,0,0,0,"00",0,0,0,0,0,0,1037950,"2023-12-18T00:00:00.000Z",26,FALSE,30,487,"G",30,30,"Washington Wizards","Delon Wright",0,0,0,0,0,0
0,0,1,1,1,4,3,1,1,"05",0,0,8,1,0,0,1037950,"2023-12-18T00:00:00.000Z",26,FALSE,30,18677954,"G",30,30,"Washington Wizards","Jared Butler",0,9,9,8,1,9.2
0,0,2,1,0,3,1,0,0,"05",0,1,2,2,0,0,1037950,"2023-12-18T00:00:00.000Z",26,FALSE,30,17896106,"F",30,30,"Washington Wizards","Eugene Omoruyi",0,4,4,2,2,4.4
0,0,0,0,0,0,0,0,0,"00",0,0,0,0,0,0,1037950,"2023-12-18T00:00:00.000Z",26,FALSE,30,38017704,"F",30,30,"Washington Wizards","Patrick Baldwin Jr.",0,0,0,0,0,0
0,0,0,0,0,0,0,0,0,"00",0,0,0,0,0,0,1037950,"2023-12-18T00:00:00.000Z",26,FALSE,30,NA,NA,NA,30,"Washington Wizards","NA NA",0,0,0,0,0,0
0,0,0,0,0,0,0,0,0,"00",0,0,0,0,0,0,1037950,"2023-12-18T00:00:00.000Z",26,FALSE,30,38017687,"G",30,30,"Washington Wizards","Johnny Davis",0,0,0,0,0,0
1,0,1,4,0,9,2,0,0,"27",1,5,4,2,3,0,1037951,"2023-12-18T00:00:00.000Z",14,FALSE,20,666860,"F-G",14,14,"Los Angeles Lakers","Cameron Reddish",3,6,7,5,3,16.9
11,0,10,8,2,23,10,4,3,"39",1,1,25,11,1,2,1037951,"2023-12-18T00:00:00.000Z",14,FALSE,20,237,"F",14,14,"Los Angeles Lakers","LeBron James",1,36,47,36,22,55.7
2,2,12,1,1,22,14,3,3,"35",2,2,32,14,1,2,1037951,"2023-12-18T00:00:00.000Z",14,FALSE,20,117,"F-C",14,14,"Los Angeles Lakers","Anthony Davis",3,46,48,34,16,58.8
3,1,1,13,3,13,3,0,0,"39",1,1,9,2,0,1,1037951,"2023-12-18T00:00:00.000Z",14,FALSE,20,383,"F",14,14,"Los Angeles Lakers","Taurean Prince",1,11,14,12,5,17.9
4,0,3,6,3,10,3,0,0,"28",0,1,9,3,1,0,1037951,"2023-12-18T00:00:00.000Z",14,FALSE,20,405,"G",14,14,"Los Angeles Lakers","D'Angelo Russell",1,12,16,13,7,21.6
0,0,0,2,1,6,3,1,1,"17",2,1,8,2,2,0,1037951,"2023-12-18T00:00:00.000Z",14,FALSE,20,666609,"F",14,14,"Los Angeles Lakers","Rui Hachimura",2,10,10,8,2,16.4
7,0,3,7,3,15,6,5,5,"33",0,2,20,3,1,4,1037951,"2023-12-18T00:00:00.000Z",14,FALSE,20,17553995,"G",14,14,"Los Angeles Lakers","Austin Reaves",1,23,30,27,10,33.1
1,0,0,0,0,0,0,0,0,"14",2,3,0,2,0,1,1037951,"2023-12-18T00:00:00.000Z",14,FALSE,20,457,"F",14,14,"Los Angeles Lakers","Jarred Vanderbilt",0,2,3,1,3,2.9
0,0,0,0,0,0,0,0,0,"00",0,0,0,0,0,0,1037951,"2023-12-18T00:00:00.000Z",14,FALSE,20,56677867,"F",14,14,"Los Angeles Lakers","Alex Fudge",0,0,0,0,0,0
0,0,0,0,0,0,0,0,0,"00",0,0,0,0,0,0,1037951,"2023-12-18T00:00:00.000Z",14,FALSE,20,56677868,"G",14,14,"Los Angeles Lakers","D'Moi Hodge",0,0,0,0,0,0
0,0,0,0,0,0,0,0,0,"00",0,0,0,0,0,0,1037951,"2023-12-18T00:00:00.000Z",14,FALSE,20,56677835,"G",14,14,"Los Angeles Lakers","Jalen Hood-Schifino",0,0,0,0,0,0
0,0,0,0,0,0,0,0,0,"00",0,0,0,0,0,0,1037951,"2023-12-18T00:00:00.000Z",14,FALSE,20,1603383,"G",14,14,"Los Angeles Lakers","Gabe Vincent",0,0,0,0,0,0
4,1,4,2,0,10,3,6,6,"30",1,2,12,5,0,1,1037951,"2023-12-18T00:00:00.000Z",14,FALSE,20,666423,"F-G",20,20,"New York Knicks","RJ Barrett",1,17,21,16,9,26
3,0,13,4,1,22,12,2,2,"43",1,3,27,14,0,2,1037951,"2023-12-18T00:00:00.000Z",14,FALSE,20,387,"F",20,20,"New York Knicks","Julius Randle",0,41,44,30,17,46.3
0,0,0,0,0,0,0,0,0,"04",0,2,0,0,0,0,1037951,"2023-12-18T00:00:00.000Z",14,FALSE,20,17896063,"F",20,20,"New York Knicks","Jericho Sims",0,0,0,0,0,0
3,1,1,4,2,5,3,0,0,"19",0,1,8,1,0,1,1037951,"2023-12-18T00:00:00.000Z",14,FALSE,20,131,"G",20,20,"New York Knicks","Donte DiVincenzo",1,9,12,11,4,15.7
3,1,3,6,3,21,10,6,6,"37",1,0,29,4,1,4,1037951,"2023-12-18T00:00:00.000Z",14,FALSE,20,73,"G",20,20,"New York Knicks","Jalen Brunson",2,33,36,32,7,40.3
0,0,0,0,0,0,0,0,0,"00",0,0,0,0,0,0,1037951,"2023-12-18T00:00:00.000Z",14,FALSE,20,19,"G",20,20,"New York Knicks","Ryan Arcidiacono",0,0,0,0,0,0
0,0,0,0,0,0,0,0,0,"00",0,0,0,0,0,0,1037951,"2023-12-18T00:00:00.000Z",14,FALSE,20,160,"G-F",20,20,"New York Knicks","Evan Fournier",0,0,0,0,0,0
0,0,2,0,0,0,0,0,0,"06",1,2,0,3,0,1,1037951,"2023-12-18T00:00:00.000Z",14,FALSE,20,173,"F",30,20,"New York Knicks","Taj Gibson",0,3,3,0,3,2.6
2,0,0,4,1,5,1,0,0,"11",0,0,3,0,1,0,1037951,"2023-12-18T00:00:00.000Z",14,FALSE,20,17895858,"G",20,20,"New York Knicks","Quentin Grimes",1,3,5,5,2,9
2,1,5,3,0,6,2,2,2,"22",0,1,6,5,0,4,1037951,"2023-12-18T00:00:00.000Z",14,FALSE,20,202,"G",20,20,"New York Knicks","Josh Hart",1,11,13,8,7,14
2,2,10,0,0,4,3,6,3,"39",7,3,9,17,2,1,1037951,"2023-12-18T00:00:00.000Z",14,FALSE,20,201,"F-C",20,20,"New York Knicks","Isaiah Hartenstein",4,26,28,11,19,43.4
0,0,0,0,0,0,0,0,0,"00",0,0,0,0,0,0,1037951,"2023-12-18T00:00:00.000Z",14,FALSE,20,666675,"F",20,20,"New York Knicks","DaQuan Jeffries",0,0,0,0,0,0
0,0,0,0,0,0,0,0,0,"00",0,0,0,0,0,0,1037951,"2023-12-18T00:00:00.000Z",14,FALSE,20,17896033,"G",20,20,"New York Knicks","Miles McBride",0,0,0,0,0,0
2,0,3,7,3,15,8,1,1,"29",0,2,20,3,1,1,1037951,"2023-12-18T00:00:00.000Z",14,FALSE,20,3547269,"G",20,20,"New York Knicks","Immanuel Quickley",1,23,25,22,5,28.6
0,0,0,0,0,0,0,0,0,"00",0,0,0,0,0,0,1037951,"2023-12-18T00:00:00.000Z",14,FALSE,20,666474,"G",20,20,"New York Knicks","Charles Brown",0,0,0,0,0,0
0,0,0,0,0,0,0,0,0,"00",0,0,0,0,0,0,1037951,"2023-12-18T00:00:00.000Z",14,FALSE,20,486,"F",14,14,"Los Angeles Lakers","Christian Wood",0,0,0,0,0,0
0,0,0,0,0,0,0,0,0,"00",0,0,0,0,0,0,1037951,"2023-12-18T00:00:00.000Z",14,FALSE,20,56677738,"C",14,14,"Los Angeles Lakers","Colin Castleton",0,0,0,0,0,0
0,0,0,0,0,0,0,0,0,"00",0,0,0,0,0,0,1037951,"2023-12-18T00:00:00.000Z",14,FALSE,20,59421201,"G",20,20,"New York Knicks","Jaylen Martin",0,0,0,0,0,0
0,0,0,0,0,0,0,0,0,"00",0,0,0,0,0,0,1037951,"2023-12-18T00:00:00.000Z",14,FALSE,20,399,"C",20,20,"New York Knicks","Mitchell Robinson",0,0,0,0,0,0
0,0,0,0,0,0,0,0,0,"00",0,0,0,0,0,0,1037951,"2023-12-18T00:00:00.000Z",14,FALSE,20,56677795,"F",20,20,"New York Knicks","Jacob Toppin",0,0,0,0,0,0
0,0,2,0,0,1,1,0,0,"08",0,1,2,2,0,0,1037951,"2023-12-18T00:00:00.000Z",14,FALSE,20,666626,"C",14,14,"Los Angeles Lakers","Jaxson Hayes",0,4,4,2,2,4.4
0,0,0,0,0,0,0,0,0,"00",0,0,0,0,0,0,1037951,"2023-12-18T00:00:00.000Z",14,FALSE,20,38017697,"G",14,14,"Los Angeles Lakers","Max Christie",0,0,0,0,0,0
0,0,0,0,0,0,0,0,0,"00",0,0,0,0,0,0,1037951,"2023-12-18T00:00:00.000Z",14,FALSE,20,56677836,"F",14,14,"Los Angeles Lakers","Maxwell Lewis",0,0,0,0,0,0
5,0,3,3,1,12,5,6,4,"34",2,1,15,5,0,1,1037945,"2023-12-18T00:00:00.000Z",16,FALSE,18,79,"G-F",16,16,"Miami Heat","Jimmy Butler",0,20,25,20,10,27.5
4,0,10,7,3,7,3,0,0,"24",0,2,9,10,1,0,1037945,"2023-12-18T00:00:00.000Z",16,FALSE,18,285,"F-C",16,16,"Miami Heat","Kevin Love",1,19,23,13,14,30
6,1,3,0,0,22,10,3,2,"37",3,3,22,6,1,4,1037945,"2023-12-18T00:00:00.000Z",16,FALSE,18,4,"C-F",16,16,"Miami Heat","Bam Adebayo",2,28,34,28,12,40.2
3,0,2,1,0,5,1,0,0,"22",1,1,2,3,2,1,1037945,"2023-12-18T00:00:00.000Z",16,FALSE,18,666747,"F",16,16,"Miami Heat","Caleb Martin",2,5,8,5,6,15.1
2,0,2,6,1,18,10,4,4,"33",1,1,25,3,2,2,1037945,"2023-12-18T00:00:00.000Z",16,FALSE,18,666633,"G",16,16,"Miami Heat","Tyler Herro",2,28,30,27,5,35.6
0,0,0,0,0,0,0,0,0,"00",0,0,0,0,0,0,1037945,"2023-12-18T00:00:00.000Z",16,FALSE,18,74,"C",16,16,"Miami Heat","Thomas Bryant",0,0,0,0,0,0
0,0,0,0,0,0,0,0,0,"00",0,0,0,0,0,0,1037945,"2023-12-18T00:00:00.000Z",16,FALSE,18,3547257,"G",16,16,"Miami Heat","R.J. Hampton",0,0,0,0,0,0
1,1,0,0,0,0,0,0,0,"12",0,2,0,0,1,0,1037945,"2023-12-18T00:00:00.000Z",16,FALSE,18,3092,"",16,16,"Miami Heat","Haywood Highsmith",2,0,1,1,1,7.5
0,2,2,1,0,8,3,2,2,"30",1,4,8,3,2,3,1037945,"2023-12-18T00:00:00.000Z",16,FALSE,18,56677785,"G",16,16,"Miami Heat","Jaime Jaquez Jr.",4,11,11,8,3,20.6
0,0,0,0,0,0,0,0,0,"00",0,0,0,0,0,0,1037945,"2023-12-18T00:00:00.000Z",16,FALSE,18,38017696,"F",16,16,"Miami Heat","Nikola Jovic",0,0,0,0,0,0
3,0,4,4,2,6,4,3,3,"26",0,2,13,4,0,1,1037945,"2023-12-18T00:00:00.000Z",16,FALSE,18,391,"G-F",16,16,"Miami Heat","Josh Richardson",0,17,20,16,7,21.3
3,0,5,8,4,9,5,0,0,"22",0,2,14,5,1,2,1037945,"2023-12-18T00:00:00.000Z",16,FALSE,18,397,"F",16,16,"Miami Heat","Duncan Robinson",1,19,22,17,8,25.5
0,0,0,0,0,0,0,0,0,"00",0,0,0,0,0,0,1037945,"2023-12-18T00:00:00.000Z",16,FALSE,18,39398582,"C",16,16,"Miami Heat","Orlando Robinson",0,0,0,0,0,0
0,0,0,0,0,0,0,0,0,"00",0,0,0,0,0,0,1037945,"2023-12-18T00:00:00.000Z",16,FALSE,18,38017734,"F",16,16,"Miami Heat","Jamal Cain",0,0,0,0,0,0
0,0,0,0,0,0,0,0,0,"00",0,0,0,0,0,0,1037945,"2023-12-18T00:00:00.000Z",16,FALSE,18,286,"G",16,16,"Miami Heat","Kyle Lowry",0,0,0,0,0,0
0,0,0,0,0,0,0,0,0,"00",0,0,0,0,0,0,1037945,"2023-12-18T00:00:00.000Z",16,FALSE,18,19465585,"G",16,16,"Miami Heat","Dru Smith",0,0,0,0,0,0
0,0,0,0,0,0,0,0,0,"00",0,0,0,0,0,0,1037945,"2023-12-18T00:00:00.000Z",16,FALSE,18,38017736,"F",16,16,"Miami Heat","Cole Swider",0,0,0,0,0,0
2,3,2,0,0,10,5,0,0,"30",3,6,10,5,0,3,1037945,"2023-12-18T00:00:00.000Z",16,FALSE,18,3547259,"F",18,18,"Minnesota Timberwolves","Jaden McDaniels",3,15,17,12,7,25
2,0,4,4,1,14,7,3,3,"32",4,3,18,8,1,1,1037945,"2023-12-18T00:00:00.000Z",16,FALSE,18,447,"C",18,18,"Minnesota Timberwolves","Karl-Anthony Towns",1,26,28,20,10,32.6
2,2,13,0,0,8,3,4,3,"35",3,2,9,16,2,1,1037945,"2023-12-18T00:00:00.000Z",16,FALSE,18,176,"C",18,18,"Minnesota Timberwolves","Rudy Gobert",4,25,27,11,18,42.2
5,2,8,9,2,25,13,4,4,"40",0,1,32,8,3,1,1037945,"2023-12-18T00:00:00.000Z",16,FALSE,18,3547238,"G",18,18,"Minnesota Timberwolves","Anthony Edwards",5,40,45,37,13,63.1
6,0,1,5,4,5,4,0,0,"33",0,1,12,1,1,4,1037945,"2023-12-18T00:00:00.000Z",16,FALSE,18,104,"G",18,18,"Minnesota Timberwolves","Mike Conley",1,13,19,18,7,21.2
3,0,0,4,2,5,2,2,2,"22",1,2,8,1,1,0,1037945,"2023-12-18T00:00:00.000Z",16,FALSE,18,666400,"G",18,18,"Minnesota Timberwolves","Nickeil Alexander-Walker",1,9,12,11,4,16.7
5,1,2,0,0,4,2,2,1,"22",0,2,5,2,0,1,1037945,"2023-12-18T00:00:00.000Z",16,FALSE,18,12,"F",18,18,"Minnesota Timberwolves","Kyle Anderson",1,7,12,10,7,16.9
1,0,1,1,1,1,1,0,0,"05",0,0,3,1,0,1,1037945,"2023-12-18T00:00:00.000Z",16,FALSE,18,68,"F",18,18,"Minnesota Timberwolves","Troy Brown Jr.",0,4,5,4,2,4.7
0,0,0,0,0,0,0,0,0,"00",0,0,0,0,0,0,1037945,"2023-12-18T00:00:00.000Z",16,FALSE,18,666767,"G",18,18,"Minnesota Timberwolves","Jordan McLaughlin",0,0,0,0,0,0
0,0,0,0,0,0,0,0,0,"00",0,0,0,0,0,0,1037945,"2023-12-18T00:00:00.000Z",16,FALSE,18,320,"G",18,18,"Minnesota Timberwolves","Shake Milton",0,0,0,0,0,0
1,1,3,6,1,13,5,4,4,"21",1,2,15,4,1,1,1037945,"2023-12-18T00:00:00.000Z",16,FALSE,18,667378,"F-C",18,18,"Minnesota Timberwolves","Naz Reid",2,19,20,16,5,26.3
0,0,0,0,0,0,0,0,0,"00",0,0,0,0,0,0,1037945,"2023-12-18T00:00:00.000Z",16,FALSE,18,38017715,"F",18,18,"Minnesota Timberwolves","Josh Minott",0,0,0,0,0,0
0,0,0,0,0,0,0,0,0,"00",0,0,0,0,0,0,1037945,"2023-12-18T00:00:00.000Z",16,FALSE,18,38017700,"G",18,18,"Minnesota Timberwolves","Wendell Moore Jr.",0,0,0,0,0,0
0,0,0,0,0,0,0,0,0,"00",0,0,0,0,0,0,1037945,"2023-12-18T00:00:00.000Z",16,FALSE,18,56677851,"G",18,18,"Minnesota Timberwolves","Jaylen Clark",0,0,0,0,0,0
0,0,0,0,0,0,0,0,0,"00",0,0,0,0,0,0,1037945,"2023-12-18T00:00:00.000Z",16,FALSE,18,17896056,"C",18,18,"Minnesota Timberwolves","Luka Garza",0,0,0,0,0,0
0,0,0,0,0,0,0,0,0,"00",0,0,0,0,0,0,1037945,"2023-12-18T00:00:00.000Z",16,FALSE,18,56677782,"F",18,18,"Minnesota Timberwolves","Leonard Miller",0,0,0,0,0,0
0,0,0,0,0,0,0,0,0,"00",0,0,0,0,0,0,1037945,"2023-12-18T00:00:00.000Z",16,FALSE,18,17895968,"F",18,18,"Minnesota Timberwolves","Daishen Nix",0,0,0,0,0,0
0,1,6,1,1,4,2,0,0,"21",3,3,5,9,3,2,1037955,"2023-12-19T00:00:00.000Z",25,FALSE,24,56677850,"F",25,25,"Portland Trail Blazers","Toumani Camara",4,14,14,5,9,25.8
4,2,1,4,3,15,8,3,3,"36",0,2,22,1,0,2,1037955,"2023-12-19T00:00:00.000Z",25,FALSE,24,182,"F",25,25,"Portland Trail Blazers","Jerami Grant",2,23,27,26,5,33.2
3,0,11,0,0,18,6,4,4,"40",4,3,16,15,0,3,1037955,"2023-12-19T00:00:00.000Z",25,FALSE,24,22,"C",25,25,"Portland Trail Blazers","Deandre Ayton",0,31,34,19,18,35.5
0,0,1,0,0,1,0,0,0,"08",0,2,0,1,0,0,1037955,"2023-12-19T00:00:00.000Z",25,FALSE,24,38017690,"G",25,25,"Portland Trail Blazers","Shaedon Sharpe",0,1,1,0,1,1.2
7,0,3,7,2,23,9,5,3,"38",0,2,23,3,1,1,1037955,"2023-12-19T00:00:00.000Z",25,FALSE,24,419,"G",25,25,"Portland Trail Blazers","Anfernee Simons",1,26,33,30,10,39.1
4,0,4,9,4,10,5,0,0,"32",0,0,14,4,0,1,1037955,"2023-12-19T00:00:00.000Z",25,FALSE,24,65,"G",25,25,"Portland Trail Blazers","Malcolm Brogdon",0,18,22,18,8,23.8
0,0,0,0,0,0,0,0,0,"00",0,0,0,0,0,0,1037955,"2023-12-19T00:00:00.000Z",25,FALSE,24,666476,"C",25,25,"Portland Trail Blazers","Moses Brown",0,0,0,0,0,0
0,0,0,0,0,0,0,0,0,"00",0,0,0,0,0,0,1037955,"2023-12-19T00:00:00.000Z",25,FALSE,24,39613724,"C",25,25,"Portland Trail Blazers","Ibou Badji",0,0,0,0,0,0
0,0,0,0,0,0,0,0,0,"00",0,0,0,0,0,0,1037955,"2023-12-19T00:00:00.000Z",25,FALSE,24,47957121,"F",25,25,"Portland Trail Blazers","Justin Minaya",0,0,0,0,0,0
0,0,0,0,0,0,0,0,0,"00",0,0,0,0,0,0,1037955,"2023-12-19T00:00:00.000Z",25,FALSE,24,56677829,"G-F",25,25,"Portland Trail Blazers","Rayan Rupert",0,0,0,0,0,0
0,0,0,0,0,0,0,0,0,"00",0,0,0,0,0,0,1037955,"2023-12-19T00:00:00.000Z",25,FALSE,24,476,"C-F",25,25,"Portland Trail Blazers","Robert Williams III",0,0,0,0,0,0
0,0,2,1,1,2,1,2,1,"19",0,1,4,2,0,0,1037955,"2023-12-19T00:00:00.000Z",25,FALSE,24,666729,"F",24,24,"Phoenix Suns","Nassir Little",0,6,6,4,2,6.4
5,0,4,3,1,28,16,8,7,"38",0,1,40,4,2,5,1037955,"2023-12-19T00:00:00.000Z",25,FALSE,24,140,"F",24,24,"Phoenix Suns","Kevin Durant",2,44,49,45,9,53.3
3,2,8,2,0,11,4,2,1,"31",5,3,9,13,2,4,1037955,"2023-12-19T00:00:00.000Z",25,FALSE,24,349,"C",24,24,"Phoenix Suns","Jusuf Nurkic",4,22,25,12,16,37.1
0,0,7,5,1,10,5,1,0,"33",2,3,11,9,2,0,1037955,"2023-12-19T00:00:00.000Z",25,FALSE,24,8,"G",24,24,"Phoenix Suns","Grayson Allen",2,20,20,11,9,27.8
7,0,3,5,1,25,11,4,3,"38",0,3,26,3,0,1,1037955,"2023-12-19T00:00:00.000Z",25,FALSE,24,57,"G",24,24,"Phoenix Suns","Devin Booker",0,29,36,33,10,39.1
0,0,0,0,0,0,0,0,0,"00",0,0,0,0,0,0,1037955,"2023-12-19T00:00:00.000Z",25,FALSE,24,32,"F",24,24,"Phoenix Suns","Keita Bates-Diop",0,0,0,0,0,0
0,0,0,0,0,0,0,0,0,"00",0,0,0,0,0,0,1037955,"2023-12-19T00:00:00.000Z",25,FALSE,24,666451,"C",24,24,"Phoenix Suns","Bol Bol",0,0,0,0,0,0
1,3,3,0,0,2,2,2,1,"17",3,1,5,6,1,1,1037955,"2023-12-19T00:00:00.000Z",25,FALSE,24,147,"F",24,24,"Phoenix Suns","Drew Eubanks",4,11,12,6,7,24.7
0,0,0,0,0,0,0,0,0,"00",0,0,0,0,0,0,1037955,"2023-12-19T00:00:00.000Z",25,FALSE,24,3547298,"G",24,24,"Phoenix Suns","Saben Lee",0,0,0,0,0,0
1,0,1,1,0,2,1,0,0,"15",0,0,2,1,1,1,1037955,"2023-12-19T00:00:00.000Z",25,FALSE,24,314,"F",24,24,"Phoenix Suns","Chimezie Metu",1,3,4,3,2,6.7
0,0,0,0,0,0,0,0,0,"00",0,0,0,0,0,0,1037955,"2023-12-19T00:00:00.000Z",25,FALSE,24,470,"G",24,24,"Phoenix Suns","Yuta Watanabe",0,0,0,0,0,0
0,0,0,0,0,0,0,0,0,"00",0,0,0,0,0,0,1037955,"2023-12-19T00:00:00.000Z",25,FALSE,24,3547095,"C-F",24,24,"Phoenix Suns","Udoka Azubuike",0,0,0,0,0,0
0,0,0,0,0,0,0,0,0,"00",0,0,0,0,0,0,1037955,"2023-12-19T00:00:00.000Z",25,FALSE,24,37,"G",24,24,"Phoenix Suns","Bradley Beal",0,0,0,0,0,0
0,0,0,0,0,0,0,0,0,"00",0,0,0,0,0,0,1037955,"2023-12-19T00:00:00.000Z",25,FALSE,24,272,"G",24,24,"Phoenix Suns","Damion Lee",0,0,0,0,0,0
0,0,0,0,0,0,0,0,0,"00",0,0,0,0,0,0,1037955,"2023-12-19T00:00:00.000Z",25,FALSE,24,3547253,"G",4,24,"Phoenix Suns","Theo Maledon",0,0,0,0,0,0
0,0,0,0,0,0,0,0,0,"00",0,0,0,0,0,0,1037955,"2023-12-19T00:00:00.000Z",25,FALSE,24,356,"G",24,24,"Phoenix Suns","Josh Okogie",0,0,0,0,0,0
4,0,2,4,1,7,1,2,2,"29",1,1,5,3,2,0,1037955,"2023-12-19T00:00:00.000Z",25,FALSE,24,178,"G",24,24,"Phoenix Suns","Eric Gordon",2,8,12,9,7,20.6
2,1,3,2,0,7,1,0,0,"20",3,2,2,6,0,1,1037955,"2023-12-19T00:00:00.000Z",25,FALSE,24,18678058,"",24,24,"Phoenix Suns","Jordan Goodwin",1,8,10,4,8,14.2
5,0,3,2,0,9,3,3,3,"30",1,4,9,4,0,5,1037955,"2023-12-19T00:00:00.000Z",25,FALSE,24,56677747,"G",25,25,"Portland Trail Blazers","Scoot Henderson",0,13,18,14,9,16.3
0,0,0,0,0,0,0,0,0,"00",0,0,0,0,0,0,1037955,"2023-12-19T00:00:00.000Z",25,FALSE,24,3547289,"G",25,25,"Portland Trail Blazers","Skylar Mays",0,0,0,0,0,0
0,0,0,0,0,0,0,0,0,"00",0,0,0,0,0,0,1037955,"2023-12-19T00:00:00.000Z",25,FALSE,24,56677791,"F",25,25,"Portland Trail Blazers","Kris Murray",0,0,0,0,0,0
0,0,1,1,1,1,1,0,0,"04",1,0,3,2,1,1,1037955,"2023-12-19T00:00:00.000Z",25,FALSE,24,56783340,"C",25,25,"Portland Trail Blazers","Duop Reath",1,5,5,3,2,7.4
0,1,1,3,2,3,2,2,2,"21",0,0,8,1,3,0,1037955,"2023-12-19T00:00:00.000Z",25,FALSE,24,666923,"G-F",25,25,"Portland Trail Blazers","Matisse Thybulle",4,9,9,8,1,21.2
0,0,0,0,0,0,0,0,0,"00",0,0,0,0,0,0,1037955,"2023-12-19T00:00:00.000Z",25,FALSE,24,17896120,"F",25,25,"Portland Trail Blazers","Ish Wainright",0,0,0,0,0,0
0,0,1,1,1,3,3,2,2,"10",1,2,9,2,0,0,1037955,"2023-12-19T00:00:00.000Z",25,FALSE,24,38017711,"F",25,25,"Portland Trail Blazers","Jabari Walker",0,11,11,9,2,11.4
4,1,4,15,6,21,9,0,0,"40",0,0,24,4,1,1,1037954,"2023-12-19T00:00:00.000Z",10,FALSE,2,443,"G",10,10,"Golden State Warriors","Klay Thompson",2,28,32,28,8,39.8
2,0,3,4,1,13,8,2,0,"34",4,0,17,7,2,1,1037954,"2023-12-19T00:00:00.000Z",10,FALSE,2,17553979,"F",10,10,"Golden State Warriors","Jonathan Kuminga",2,24,26,19,9,33.4
2,0,5,0,0,2,1,1,1,"14",1,0,3,6,0,1,1037954,"2023-12-19T00:00:00.000Z",10,FALSE,2,282,"F",10,10,"Golden State Warriors","Kevon Looney",0,9,11,5,8,12.2
1,0,4,3,1,4,2,0,0,"16",1,2,5,5,1,1,1037954,"2023-12-19T00:00:00.000Z",10,FALSE,2,56677858,"G",10,10,"Golden State Warriors","Brandin Podziemski",1,10,11,6,6,14.5
6,0,3,11,6,21,11,5,5,"38",0,5,33,3,0,4,1037954,"2023-12-19T00:00:00.000Z",10,FALSE,2,115,"G",10,10,"Golden State Warriors","Stephen Curry",0,36,42,39,9,41.6
0,0,0,0,0,0,0,0,0,"00",0,0,0,0,0,0,1037954,"2023-12-19T00:00:00.000Z",10,FALSE,2,185,"F",10,10,"Golden State Warriors","Draymond Green",0,0,0,0,0,0
1,3,9,0,0,7,5,0,0,"28",4,3,10,13,0,1,1037954,"2023-12-19T00:00:00.000Z",10,FALSE,2,56677799,"F",10,10,"Golden State Warriors","Trayce Jackson-Davis",3,23,24,11,14,35.1
0,1,1,1,0,3,2,0,0,"06",0,0,4,1,0,0,1037954,"2023-12-19T00:00:00.000Z",10,FALSE,2,251,"G",10,10,"Golden State Warriors","Cory Joseph",1,5,5,4,1,8.2
0,0,0,6,2,9,3,2,2,"17",0,0,10,0,0,0,1037954,"2023-12-19T00:00:00.000Z",10,FALSE,2,17553992,"G",10,10,"Golden State Warriors","Moses Moody",0,10,10,10,0,10
12,0,6,5,1,12,4,0,0,"35",1,2,9,7,0,0,1037954,"2023-12-19T00:00:00.000Z",10,FALSE,2,367,"G",10,10,"Golden State Warriors","Chris Paul",0,16,28,21,19,35.4
0,0,0,0,0,0,0,0,0,"00",0,0,0,0,0,0,1037954,"2023-12-19T00:00:00.000Z",10,FALSE,2,2189,"",10,10,"Golden State Warriors","Gary Payton II",0,0,0,0,0,0
0,0,4,4,3,6,3,2,2,"15",2,2,11,6,0,1,1037954,"2023-12-19T00:00:00.000Z",10,FALSE,2,407,"F",10,10,"Golden State Warriors","Dario Saric",0,17,17,11,6,17.2
1,0,2,1,0,11,2,2,2,"22",5,1,6,7,0,0,1037954,"2023-12-19T00:00:00.000Z",10,FALSE,2,475,"F-G",10,10,"Golden State Warriors","Andrew Wiggins",0,13,14,7,8,15.9
0,0,0,0,0,0,0,0,0,"00",0,0,0,0,0,0,1037954,"2023-12-19T00:00:00.000Z",10,FALSE,2,17896070,"F",10,10,"Golden State Warriors","Usman Garuba",0,0,0,0,0,0
0,0,0,0,0,0,0,0,0,"00",0,0,0,0,0,0,1037954,"2023-12-19T00:00:00.000Z",10,FALSE,2,45658838,"G",10,10,"Golden State Warriors","Lester Quinones",0,0,0,0,0,0
0,0,0,0,0,0,0,0,0,"00",0,0,0,0,0,0,1037954,"2023-12-19T00:00:00.000Z",10,FALSE,2,398,"G",10,10,"Golden State Warriors","Jerome Robinson",0,0,0,0,0,0
0,0,0,0,0,0,0,0,0,"00",0,0,0,0,0,0,1037954,"2023-12-19T00:00:00.000Z",10,FALSE,2,57875092,"F",10,10,"Golden State Warriors","Gui Santos",0,0,0,0,0,0
7,1,5,4,1,22,10,8,7,"41",3,2,28,8,0,4,1037954,"2023-12-19T00:00:00.000Z",10,FALSE,2,70,"G",2,2,"Boston Celtics","Jaylen Brown",1,36,43,35,15,47.1
7,0,5,9,2,17,5,3,3,"41",3,0,15,8,2,0,1037954,"2023-12-19T00:00:00.000Z",10,FALSE,2,434,"F",2,2,"Boston Celtics","Jayson Tatum",2,23,30,22,15,41.1
6,1,10,10,3,14,4,2,2,"38",2,1,13,12,0,2,1037954,"2023-12-19T00:00:00.000Z",10,FALSE,2,219,"C-F",2,2,"Boston Celtics","Al Horford",1,25,31,19,18,37.4
3,3,5,18,7,24,11,2,1,"40",2,2,30,7,0,0,1037954,"2023-12-19T00:00:00.000Z",10,FALSE,2,473,"G",2,2,"Boston Celtics","Derrick White",3,37,40,33,10,51.9
1,0,6,5,1,12,5,2,2,"36",1,5,13,7,2,1,1037954,"2023-12-19T00:00:00.000Z",10,FALSE,2,214,"G",2,2,"Boston Celtics","Jrue Holiday",2,20,21,14,8,27.9
0,0,0,0,0,0,0,0,0,"00",0,0,0,0,0,0,1037954,"2023-12-19T00:00:00.000Z",10,FALSE,2,17896094,"G",2,2,"Boston Celtics","Dalano Banton",0,0,0,0,0,0
0,0,0,0,0,3,3,0,0,"06",0,0,6,0,1,0,1037954,"2023-12-19T00:00:00.000Z",10,FALSE,2,666468,"F",2,2,"Boston Celtics","Oshae Brissett",1,6,6,6,0,9
1,0,2,6,0,7,0,0,0,"21",1,2,0,3,0,0,1037954,"2023-12-19T00:00:00.000Z",10,FALSE,2,17896060,"F",2,2,"Boston Celtics","Sam Hauser",0,3,4,1,4,5.1
0,0,0,1,0,1,0,0,0,"02",0,0,0,0,0,0,1037954,"2023-12-19T00:00:00.000Z",10,FALSE,2,338,"G",2,2,"Boston Celtics","Svi Mykhailiuk",0,0,0,0,0,0
2,0,0,5,3,6,4,0,0,"19",0,1,11,0,0,1,1037954,"2023-12-19T00:00:00.000Z",10,FALSE,2,3547276,"G",2,2,"Boston Celtics","Payton Pritchard",0,11,13,13,2,13
1,0,4,0,0,8,5,0,0,"21",6,0,10,10,1,0,1037954,"2023-12-19T00:00:00.000Z",10,FALSE,2,17553967,"C",2,2,"Boston Celtics","Neemias Queta",1,20,21,11,11,26.5
0,0,0,0,0,0,0,0,0,"00",0,0,0,0,0,0,1037954,"2023-12-19T00:00:00.000Z",10,FALSE,2,3547279,"F",2,2,"Boston Celtics","Lamar Stevens",0,0,0,0,0,0
0,0,0,0,0,0,0,0,0,"00",0,0,0,0,0,0,1037954,"2023-12-19T00:00:00.000Z",10,FALSE,2,38017707,"G",2,2,"Boston Celtics","JD Davison",0,0,0,0,0,0
0,0,0,0,0,0,0,0,0,"00",0,0,0,0,0,0,1037954,"2023-12-19T00:00:00.000Z",10,FALSE,2,261,"F-C",2,2,"Boston Celtics","Luke Kornet",0,0,0,0,0,0
0,0,0,0,0,0,0,0,0,"00",0,0,0,0,0,0,1037954,"2023-12-19T00:00:00.000Z",10,FALSE,2,NA,NA,NA,2,"Boston Celtics","NA NA",0,0,0,0,0,0
0,0,0,0,0,0,0,0,0,"00",0,0,0,0,0,0,1037954,"2023-12-19T00:00:00.000Z",10,FALSE,2,378,"F-C",2,2,"Boston Celtics","Kristaps Porzingis",0,0,0,0,0,0
0,0,0,0,0,0,0,0,0,"00",0,0,0,0,0,0,1037954,"2023-12-19T00:00:00.000Z",10,FALSE,2,56677864,"G",2,2,"Boston Celtics","Jordan Walsh",0,0,0,0,0,0
4,0,3,6,3,15,7,0,0,"28",0,2,17,3,1,1,1037953,"2023-12-19T00:00:00.000Z",17,FALSE,27,315,"F",17,17,"Milwaukee Bucks","Khris Middleton",1,20,24,21,7,28.6
16,1,12,2,0,12,4,6,3,"34",2,1,11,14,2,3,1037953,"2023-12-19T00:00:00.000Z",17,FALSE,27,15,"F",17,17,"Milwaukee Bucks","Giannis Antetokounmpo",3,25,41,27,30,57.8
1,6,0,5,0,14,6,2,2,"32",5,3,14,5,0,0,1037953,"2023-12-19T00:00:00.000Z",17,FALSE,27,283,"C",17,17,"Milwaukee Bucks","Brook Lopez",6,19,20,15,6,39.5
2,0,3,5,1,7,3,0,0,"28",1,1,7,4,1,0,1037953,"2023-12-19T00:00:00.000Z",17,FALSE,27,38,"G",17,17,"Milwaukee Bucks","Malik Beasley",1,11,13,9,6,17.8
4,0,3,12,7,22,14,5,5,"35",0,0,40,3,3,1,1037953,"2023-12-19T00:00:00.000Z",17,FALSE,27,278,"G",17,17,"Milwaukee Bucks","Damian Lillard",3,43,47,44,7,57.6
1,0,0,0,0,0,0,0,0,"01",0,0,0,0,0,0,1037953,"2023-12-19T00:00:00.000Z",17,FALSE,27,2148,"",17,17,"Milwaukee Bucks","Thanasis Antetokounmpo",0,0,1,1,1,1.5
0,0,1,0,0,0,0,0,0,"06",0,0,0,1,0,0,1037953,"2023-12-19T00:00:00.000Z",17,FALSE,27,38017676,"F",17,17,"Milwaukee Bucks","MarJon Beauchamp",0,1,1,0,1,1.2
2,0,3,6,1,8,1,0,0,"18",0,2,3,3,1,0,1037953,"2023-12-19T00:00:00.000Z",17,FALSE,27,105,"G",17,17,"Milwaukee Bucks","Pat Connaughton",1,6,8,5,5,12.6
0,0,0,1,0,1,0,0,0,"02",0,0,0,0,0,0,1037953,"2023-12-19T00:00:00.000Z",17,FALSE,27,38017733,"G",17,17,"Milwaukee Bucks","A.J. Green",0,0,0,0,0,0
2,0,1,3,2,4,2,2,1,"15",2,2,7,3,1,1,1037953,"2023-12-19T00:00:00.000Z",17,FALSE,27,56677852,"G",17,17,"Milwaukee Bucks","Andre Jackson Jr.",1,10,12,9,5,15.6
0,0,1,1,1,1,1,0,0,"02",0,0,3,1,0,0,1037953,"2023-12-19T00:00:00.000Z",17,FALSE,27,284,"C",17,17,"Milwaukee Bucks","Robin Lopez",0,4,4,3,1,4.2
0,0,0,2,0,6,2,3,3,"13",0,1,7,0,0,0,1037953,"2023-12-19T00:00:00.000Z",17,FALSE,27,368,"G",17,17,"Milwaukee Bucks","Cameron Payne",0,7,7,7,0,7
2,0,9,6,3,16,10,0,0,"26",1,3,23,10,2,0,1037953,"2023-12-19T00:00:00.000Z",17,FALSE,27,377,"F",17,17,"Milwaukee Bucks","Bobby Portis",2,33,35,25,12,44
0,0,0,0,0,0,0,0,0,"00",0,0,0,0,0,0,1037953,"2023-12-19T00:00:00.000Z",17,FALSE,27,666453,"C",17,17,"Milwaukee Bucks","Marques Bolden",0,0,0,0,0,0
0,0,0,0,0,0,0,0,0,"00",0,0,0,0,0,0,1037953,"2023-12-19T00:00:00.000Z",17,FALSE,27,112,"F",17,17,"Milwaukee Bucks","Jae Crowder",0,0,0,0,0,0
0,0,0,0,0,0,0,0,0,"00",0,0,0,0,0,0,1037953,"2023-12-19T00:00:00.000Z",17,FALSE,27,56677854,"F",17,17,"Milwaukee Bucks","Chris Livingston",0,0,0,0,0,0
0,0,0,0,0,0,0,0,0,"00",0,0,0,0,0,0,1037953,"2023-12-19T00:00:00.000Z",17,FALSE,27,38017691,"G",17,17,"Milwaukee Bucks","TyTy Washington Jr.",0,0,0,0,0,0
0,0,0,0,0,0,0,0,0,"00",0,0,0,0,0,0,1037953,"2023-12-19T00:00:00.000Z",17,FALSE,27,666960,"G",17,17,"Milwaukee Bucks","Lindell Wigginton",0,0,0,0,0,0
0,0,0,0,0,1,1,0,0,"02",0,0,2,0,0,0,1037953,"2023-12-19T00:00:00.000Z",17,FALSE,27,38017649,"F",27,27,"San Antonio Spurs","Julian Champagnie",0,2,2,2,0,2
0,0,0,0,0,0,0,0,0,"00",0,0,0,0,0,0,1037953,"2023-12-19T00:00:00.000Z",17,FALSE,27,180,"G",27,27,"San Antonio Spurs","Devonte' Graham",0,0,0,0,0,0
5,0,1,1,0,11,7,0,0,"24",0,1,14,1,1,2,1037953,"2023-12-19T00:00:00.000Z",17,FALSE,27,3547274,"G",27,27,"San Antonio Spurs","Tre Jones",1,15,20,19,6,23.7
3,2,7,4,1,5,1,0,0,"15",1,1,3,8,1,2,1037953,"2023-12-19T00:00:00.000Z",17,FALSE,27,17896059,"F",27,27,"San Antonio Spurs","Sandro Mamukelashvili",3,11,14,6,11,24.1
2,0,2,1,0,2,0,0,0,"13",0,3,0,2,0,0,1037953,"2023-12-19T00:00:00.000Z",17,FALSE,27,305,"F",27,27,"San Antonio Spurs","Doug McDermott",0,2,4,2,4,5.4
1,0,2,2,0,6,3,4,4,"19",0,1,10,2,0,0,1037953,"2023-12-19T00:00:00.000Z",17,FALSE,27,359,"F",27,27,"San Antonio Spurs","Cedi Osman",0,12,13,11,3,13.9
0,0,0,0,0,0,0,0,0,"00",0,0,0,0,0,0,1037953,"2023-12-19T00:00:00.000Z",17,FALSE,27,17895854,"G",27,27,"San Antonio Spurs","Charles Bassey",0,0,0,0,0,0
0,0,0,0,0,0,0,0,0,"00",0,0,0,0,0,0,1037953,"2023-12-19T00:00:00.000Z",17,FALSE,27,56677865,"C",27,27,"San Antonio Spurs","Charles Bediako",0,0,0,0,0,0
0,0,0,0,0,0,0,0,0,"00",0,0,0,0,0,0,1037953,"2023-12-19T00:00:00.000Z",17,FALSE,27,56677817,"G",27,27,"San Antonio Spurs","Sidy Cissoko",0,0,0,0,0,0
0,0,0,0,0,0,0,0,0,"00",0,0,0,0,0,0,1037953,"2023-12-19T00:00:00.000Z",17,FALSE,27,17896049,"G",3,27,"San Antonio Spurs","David Duke Jr.",0,0,0,0,0,0
0,0,0,0,0,0,0,0,0,"00",0,0,0,0,0,0,1037953,"2023-12-19T00:00:00.000Z",17,FALSE,27,56677822,"F-C",27,27,"San Antonio Spurs","Victor Wembanyama",0,0,0,0,0,0
3,0,2,4,2,11,5,0,0,"27",0,1,12,2,0,1,1037953,"2023-12-19T00:00:00.000Z",17,FALSE,27,38017692,"F",27,27,"San Antonio Spurs","Malaki Branham",0,14,17,15,5,17.9
0,0,3,3,0,3,0,2,2,"10",0,2,2,3,1,0,1037953,"2023-12-19T00:00:00.000Z",17,FALSE,27,38017730,"F",27,27,"San Antonio Spurs","Dominick Barlow",1,5,5,2,3,8.6
0,0,0,0,0,0,0,0,0,"00",0,0,0,0,0,0,1037953,"2023-12-19T00:00:00.000Z",17,FALSE,27,38017693,"G",27,27,"San Antonio Spurs","Blake Wesley",0,0,0,0,0,0
8,0,8,2,0,11,4,2,1,"33",3,3,9,11,0,0,1037953,"2023-12-19T00:00:00.000Z",17,FALSE,27,38017699,"F",27,27,"San Antonio Spurs","Jeremy Sochan",0,20,28,17,19,34.2
1,0,10,1,0,13,9,12,10,"35",2,2,28,12,0,5,1037953,"2023-12-19T00:00:00.000Z",17,FALSE,27,666682,"F",27,27,"San Antonio Spurs","Keldon Johnson",0,40,41,29,13,38.9
2,2,6,7,4,16,9,0,0,"29",2,3,22,8,1,4,1037953,"2023-12-19T00:00:00.000Z",17,FALSE,27,102,"F-C",27,27,"San Antonio Spurs","Zach Collins",3,30,32,24,10,39.6
2,0,3,5,2,17,7,1,1,"33",0,0,17,3,0,2,1037953,"2023-12-19T00:00:00.000Z",17,FALSE,27,3547246,"G-F",27,27,"San Antonio Spurs","Devin Vassell",0,20,22,19,5,21.6
6,0,3,1,1,18,11,12,11,"37",1,4,34,4,2,2,1037952,"2023-12-19T00:00:00.000Z",19,FALSE,15,227,"F",19,19,"New Orleans Pelicans","Brandon Ingram",2,38,44,40,10,51.8
4,0,3,0,0,12,5,4,3,"25",0,4,13,3,0,2,1037952,"2023-12-19T00:00:00.000Z",19,FALSE,15,666969,"F",19,19,"New Orleans Pelicans","Zion Williamson",0,16,20,17,7,20.6
1,1,10,1,1,12,9,3,3,"33",4,5,22,14,1,2,1037952,"2023-12-19T00:00:00.000Z",19,FALSE,15,455,"C",19,19,"New Orleans Pelicans","Jonas Valanciunas",2,36,37,23,15,44.3
2,0,1,5,1,10,3,0,0,"30",0,3,7,1,0,1,1037952,"2023-12-19T00:00:00.000Z",19,FALSE,15,17896024,"F",19,19,"New Orleans Pelicans","Herbert Jones",0,8,10,9,3,10.2
6,1,3,9,6,11,6,0,0,"41",0,2,18,3,1,1,1037952,"2023-12-19T00:00:00.000Z",19,FALSE,15,303,"G",19,19,"New Orleans Pelicans","CJ McCollum",2,21,27,24,9,35.6
0,0,1,2,0,4,1,0,0,"09",1,1,2,2,0,0,1037952,"2023-12-19T00:00:00.000Z",19,FALSE,15,17896097,"G",19,19,"New Orleans Pelicans","Jose Alvarado",0,4,4,2,2,4.4
2,0,1,2,1,2,1,0,0,"14",0,1,3,1,0,0,1037952,"2023-12-19T00:00:00.000Z",19,FALSE,15,38017677,"G",19,19,"New Orleans Pelicans","Dyson Daniels",0,4,6,5,3,7.2
0,0,0,0,0,0,0,0,0,"00",0,0,0,0,0,0,1037952,"2023-12-19T00:00:00.000Z",19,FALSE,15,56677837,"G",19,19,"New Orleans Pelicans","Jordan Hawkins",0,0,0,0,0,0
1,0,1,4,1,7,1,0,0,"17",1,0,3,2,0,1,1037952,"2023-12-19T00:00:00.000Z",19,FALSE,15,3547293,"F",19,19,"New Orleans Pelicans","Naji Marshall",0,5,6,4,3,5.9
0,0,3,1,0,6,2,3,3,"21",0,2,7,3,0,1,1037952,"2023-12-19T00:00:00.000Z",19,FALSE,15,18677986,"F",19,19,"New Orleans Pelicans","Trey Murphy III",0,10,10,7,3,9.6
0,0,0,0,0,0,0,0,0,"00",0,0,0,0,0,0,1037952,"2023-12-19T00:00:00.000Z",19,FALSE,15,17896021,"F",19,19,"New Orleans Pelicans","Jeremiah Robinson-Earl",0,0,0,0,0,0
1,1,2,0,0,3,1,2,2,"13",4,1,4,6,0,1,1037952,"2023-12-19T00:00:00.000Z",19,FALSE,15,491,"C",19,19,"New Orleans Pelicans","Cody Zeller",1,10,11,5,7,14.7
0,0,0,0,0,0,0,0,0,"00",0,0,0,0,0,0,1037952,"2023-12-19T00:00:00.000Z",19,FALSE,15,3547260,"G",19,19,"New Orleans Pelicans","Kira Lewis Jr.",0,0,0,0,0,0
0,0,0,0,0,0,0,0,0,"00",0,0,0,0,0,0,1037952,"2023-12-19T00:00:00.000Z",19,FALSE,15,38017663,"F",19,19,"New Orleans Pelicans","E.J. Liddell",0,0,0,0,0,0
0,0,0,0,0,0,0,0,0,"00",0,0,0,0,0,0,1037952,"2023-12-19T00:00:00.000Z",19,FALSE,15,340,"F",19,19,"New Orleans Pelicans","Larry Nance Jr.",0,0,0,0,0,0
3,1,6,5,3,6,3,0,0,"34",1,1,9,7,0,1,1037952,"2023-12-19T00:00:00.000Z",19,FALSE,15,38017731,"G",15,15,"Memphis Grizzlies","Vince Williams Jr.",1,16,19,12,10,23.9
0,0,0,0,0,0,0,0,0,"00",0,0,0,0,0,0,1037952,"2023-12-19T00:00:00.000Z",19,FALSE,15,17896017,"F",19,19,"New Orleans Pelicans","Matt Ryan",0,0,0,0,0,0
0,0,0,0,0,0,0,0,0,"00",0,0,0,0,0,0,1037952,"2023-12-19T00:00:00.000Z",19,FALSE,15,38017726,"G",19,19,"New Orleans Pelicans","Dereon Seabron",0,0,0,0,0,0
0,3,5,3,1,10,6,15,11,"29",1,4,24,6,0,2,1037952,"2023-12-19T00:00:00.000Z",19,FALSE,15,231,"F-C",15,15,"Memphis Grizzlies","Jaren Jackson Jr.",3,30,30,24,6,38.2
0,1,2,0,0,5,4,0,0,"22",0,3,8,2,1,1,1037952,"2023-12-19T00:00:00.000Z",19,FALSE,15,48,"C",15,15,"Memphis Grizzlies","Bismack Biyombo",2,10,10,8,2,15.4
5,0,0,9,3,19,8,2,2,"35",1,1,21,1,0,4,1037952,"2023-12-19T00:00:00.000Z",19,FALSE,15,3547287,"G",15,15,"Memphis Grizzlies","Desmond Bane",0,22,27,26,6,25.7
8,1,3,5,0,24,12,12,10,"35",3,2,34,6,2,5,1037952,"2023-12-19T00:00:00.000Z",19,FALSE,15,666786,"G",15,15,"Memphis Grizzlies","Ja Morant",3,40,48,42,14,57.2
0,0,7,2,0,2,0,0,0,"22",1,3,0,8,0,1,1037952,"2023-12-19T00:00:00.000Z",19,FALSE,15,666703,"G-F",15,15,"Memphis Grizzlies","John Konchar",0,8,8,0,8,8.6
0,1,1,2,2,4,3,0,0,"16",2,1,8,3,1,0,1037952,"2023-12-19T00:00:00.000Z",19,FALSE,15,17896067,"F",15,15,"Memphis Grizzlies","Santi Aldama",2,11,11,8,3,17.6
0,0,1,3,0,5,2,0,0,"18",1,1,4,2,0,1,1037952,"2023-12-19T00:00:00.000Z",19,FALSE,15,17896027,"G-F",15,15,"Memphis Grizzlies","Ziaire Williams",0,6,6,4,2,5.4
1,0,4,1,1,5,3,0,0,"20",2,3,7,6,1,1,1037952,"2023-12-19T00:00:00.000Z",19,FALSE,15,3547285,"F",15,15,"Memphis Grizzlies","Xavier Tillman",1,13,14,8,7,17.7
2,0,0,1,0,2,0,0,0,"09",1,0,0,1,0,1,1037952,"2023-12-19T00:00:00.000Z",19,FALSE,15,38017729,"F",15,15,"Memphis Grizzlies","David Roddy",0,1,3,2,3,3.2
0,0,0,0,0,0,0,0,0,"00",0,0,0,0,0,0,1037952,"2023-12-19T00:00:00.000Z",19,FALSE,15,48248287,"G",15,15,"Memphis Grizzlies","Jacob Gilyard",0,0,0,0,0,0
0,0,0,0,0,0,0,0,0,"00",0,0,0,0,0,0,1037952,"2023-12-19T00:00:00.000Z",19,FALSE,15,401,"G",15,15,"Memphis Grizzlies","Derrick Rose",0,0,0,0,0,0
0,0,0,0,0,0,0,0,0,"00",0,0,0,0,0,0,1037952,"2023-12-19T00:00:00.000Z",19,FALSE,15,3,"C",15,15,"Memphis Grizzlies","Steven Adams",0,0,0,0,0,0
0,0,0,0,0,0,0,0,0,"00",0,0,0,0,0,0,1037952,"2023-12-19T00:00:00.000Z",19,FALSE,15,420,"G",15,15,"Memphis Grizzlies","Marcus Smart",0,0,0,0,0,0
0,0,0,0,0,0,0,0,0,"00",0,0,0,0,0,0,1037952,"2023-12-19T00:00:00.000Z",19,FALSE,15,666505,"F",15,15,"Memphis Grizzlies","Brandon Clarke",0,0,0,0,0,0
0,0,0,0,0,0,0,0,0,"00",0,0,0,0,0,0,1037952,"2023-12-19T00:00:00.000Z",19,FALSE,15,56677830,"F",15,15,"Memphis Grizzlies","GG Jackson",0,0,0,0,0,0
0,0,0,0,0,0,0,0,0,"00",0,0,0,0,0,0,1037952,"2023-12-19T00:00:00.000Z",19,FALSE,15,254,"G",15,15,"Memphis Grizzlies","Luke Kennard",0,0,0,0,0,0
0,0,0,0,0,0,0,0,0,"00",0,0,0,0,0,0,1037952,"2023-12-19T00:00:00.000Z",19,FALSE,15,38017728,"F",15,15,"Memphis Grizzlies","Jake LaRavia",0,0,0,0,0,0
0,0,0,0,0,0,0,0,0,"00",0,0,0,0,0,0,1037952,"2023-12-19T00:00:00.000Z",19,FALSE,15,38017732,"F",15,15,"Memphis Grizzlies","Kenneth Lofton Jr.",0,0,0,0,0,0
3,0,3,2,2,5,3,4,2,"30",1,1,10,4,0,0,1037965,"2023-12-20T00:00:00.000Z",26,FALSE,2,30,"F",26,26,"Sacramento Kings","Harrison Barnes",0,14,17,13,7,19.3
0,0,0,7,3,11,5,0,0,"26",1,4,13,1,0,1,1037965,"2023-12-20T00:00:00.000Z",26,FALSE,2,38017688,"F",26,26,"Sacramento Kings","Keegan Murray",0,14,14,13,1,13.2
8,1,5,1,0,14,6,4,1,"26",5,2,13,10,0,1,1037965,"2023-12-20T00:00:00.000Z",26,FALSE,2,406,"F",26,26,"Sacramento Kings","Domantas Sabonis",1,23,31,21,18,39
0,0,1,2,1,5,3,1,0,"16",0,1,7,1,0,0,1037965,"2023-12-20T00:00:00.000Z",26,FALSE,2,221,"G",26,26,"Sacramento Kings","Kevin Huerter",0,8,8,7,1,8.2
3,0,1,8,6,16,9,6,5,"27",2,4,29,3,3,3,1037965,"2023-12-20T00:00:00.000Z",26,FALSE,2,161,"G",26,26,"Sacramento Kings","De'Aaron Fox",3,32,35,32,6,43.1
0,0,1,1,0,2,0,0,0,"05",0,0,0,1,0,0,1037965,"2023-12-20T00:00:00.000Z",26,FALSE,2,17896030,"G",26,26,"Sacramento Kings","Chris Duarte",0,1,1,0,1,1.2
0,0,2,2,1,5,3,0,0,"06",0,0,7,2,0,0,1037965,"2023-12-20T00:00:00.000Z",26,FALSE,2,17896044,"F",26,26,"Sacramento Kings","Kessler Edwards",0,9,9,7,2,9.4
4,2,2,7,4,7,4,0,0,"19",0,1,12,2,1,0,1037965,"2023-12-20T00:00:00.000Z",26,FALSE,2,38017714,"G",26,26,"Sacramento Kings","Keon Ellis",3,14,18,16,6,29.4
3,1,4,6,3,7,4,0,0,"27",1,1,11,5,0,0,1037965,"2023-12-20T00:00:00.000Z",26,FALSE,2,290,"F",26,26,"Sacramento Kings","Trey Lyles",1,16,19,14,8,24.5
5,0,2,4,0,10,3,4,4,"25",0,1,10,2,0,1,1037965,"2023-12-20T00:00:00.000Z",26,FALSE,2,324,"G",26,26,"Sacramento Kings","Malik Monk",0,12,17,15,7,18.9
0,0,1,3,1,4,1,0,0,"13",2,0,3,3,0,0,1037965,"2023-12-20T00:00:00.000Z",26,FALSE,2,4197162,"F",26,26,"Sacramento Kings","Aleksandar Vezenkov",0,6,6,3,3,6.6
0,0,0,0,0,0,0,0,0,"00",0,0,0,0,0,0,1037965,"2023-12-20T00:00:00.000Z",26,FALSE,2,NA,NA,NA,2,"Boston Celtics","NA NA",0,0,0,0,0,0
0,0,0,0,0,0,0,0,0,"00",0,0,0,0,0,0,1037965,"2023-12-20T00:00:00.000Z",26,FALSE,2,434,"F",2,2,"Boston Celtics","Jayson Tatum",0,0,0,0,0,0
0,0,0,0,0,0,0,0,0,"00",0,0,0,0,0,0,1037965,"2023-12-20T00:00:00.000Z",26,FALSE,2,56677864,"G",2,2,"Boston Celtics","Jordan Walsh",0,0,0,0,0,0
1,4,3,0,0,3,2,2,0,"12",0,0,4,3,0,1,1037965,"2023-12-20T00:00:00.000Z",26,FALSE,2,306,"C",26,26,"Sacramento Kings","JaVale McGee",4,7,8,5,4,20.1
1,0,0,0,0,1,0,2,0,"05",0,0,0,0,0,0,1037965,"2023-12-20T00:00:00.000Z",26,FALSE,2,17553994,"G",26,26,"Sacramento Kings","Davion Mitchell",0,0,1,1,1,1.5
1,0,0,1,0,1,0,0,0,"03",0,0,0,0,0,0,1037965,"2023-12-20T00:00:00.000Z",26,FALSE,2,666925,"F",29,26,"Sacramento Kings","Juan Toscano-Anderson",0,0,1,1,1,1.5
0,0,0,0,0,0,0,0,0,"00",0,0,0,0,0,0,1037965,"2023-12-20T00:00:00.000Z",26,FALSE,2,17895990,"G",26,26,"Sacramento Kings","Jordan Ford",0,0,0,0,0,0
0,0,0,0,0,0,0,0,0,"00",0,0,0,0,0,0,1037965,"2023-12-20T00:00:00.000Z",26,FALSE,2,56677845,"G",26,26,"Sacramento Kings","Colby Jones",0,0,0,0,0,0
0,0,0,0,0,0,0,0,0,"00",0,0,0,0,0,0,1037965,"2023-12-20T00:00:00.000Z",26,FALSE,2,273,"C",26,26,"Sacramento Kings","Alex Len",0,0,0,0,0,0
0,0,0,0,0,0,0,0,0,"00",0,0,0,0,0,0,1037965,"2023-12-20T00:00:00.000Z",26,FALSE,2,56677862,"F",26,26,"Sacramento Kings","Jalen Slawson",0,0,0,0,0,0
1,0,5,4,2,6,4,0,0,"35",0,3,10,5,0,0,1037965,"2023-12-20T00:00:00.000Z",26,FALSE,2,17896060,"F",2,2,"Boston Celtics","Sam Hauser",0,15,16,11,6,17.5
6,0,4,3,0,21,11,7,6,"29",1,2,28,5,0,0,1037965,"2023-12-20T00:00:00.000Z",26,FALSE,2,70,"G",2,2,"Boston Celtics","Jaylen Brown",0,33,39,34,11,43
2,6,7,4,3,11,7,8,7,"29",2,3,24,9,0,3,1037965,"2023-12-20T00:00:00.000Z",26,FALSE,2,378,"F-C",2,2,"Boston Celtics","Kristaps Porzingis",6,33,35,26,11,52.8
7,3,1,9,6,13,10,3,2,"29",1,1,28,2,1,1,1037965,"2023-12-20T00:00:00.000Z",26,FALSE,2,473,"G",2,2,"Boston Celtics","Derrick White",4,30,37,35,9,51.9
10,1,6,6,4,13,7,3,3,"34",2,1,21,8,2,3,1037965,"2023-12-20T00:00:00.000Z",26,FALSE,2,214,"G",2,2,"Boston Celtics","Jrue Holiday",3,29,39,31,18,51.6
0,0,0,0,0,0,0,0,0,"00",0,0,0,0,0,0,1037965,"2023-12-20T00:00:00.000Z",26,FALSE,2,261,"F-C",2,2,"Boston Celtics","Luke Kornet",0,0,0,0,0,0
0,0,4,0,0,8,3,0,0,"19",4,5,6,8,1,1,1037965,"2023-12-20T00:00:00.000Z",26,FALSE,2,17553967,"C",2,2,"Boston Celtics","Neemias Queta",1,14,14,6,8,17.6
3,0,2,4,0,6,1,0,0,"16",2,1,2,4,1,0,1037965,"2023-12-20T00:00:00.000Z",26,FALSE,2,338,"G",2,2,"Boston Celtics","Svi Mykhailiuk",1,6,9,5,7,14.3
0,0,0,0,0,0,0,0,0,"00",0,0,0,0,0,0,1037965,"2023-12-20T00:00:00.000Z",26,FALSE,2,17896094,"G",2,2,"Boston Celtics","Dalano Banton",0,0,0,0,0,0
0,0,0,0,0,1,1,0,0,"02",0,0,2,0,0,0,1037965,"2023-12-20T00:00:00.000Z",26,FALSE,2,3547279,"F",2,2,"Boston Celtics","Lamar Stevens",0,2,2,2,0,2
0,0,0,0,0,0,0,0,0,"00",0,0,0,0,0,0,1037965,"2023-12-20T00:00:00.000Z",26,FALSE,2,38017707,"G",2,2,"Boston Celtics","JD Davison",0,0,0,0,0,0
0,0,0,0,0,0,0,0,0,"00",0,0,0,0,0,0,1037965,"2023-12-20T00:00:00.000Z",26,FALSE,2,219,"C-F",2,2,"Boston Celtics","Al Horford",0,0,0,0,0,0
4,0,4,11,6,12,6,3,2,"30",0,1,20,4,1,1,1037965,"2023-12-20T00:00:00.000Z",26,FALSE,2,3547276,"G",2,2,"Boston Celtics","Payton Pritchard",1,24,28,24,8,32.8
2,0,3,1,1,1,1,0,0,"17",2,0,3,5,0,0,1037965,"2023-12-20T00:00:00.000Z",26,FALSE,2,666468,"F",2,2,"Boston Celtics","Oshae Brissett",0,8,10,5,7,12
5,0,3,3,1,7,2,2,0,"25",3,2,5,6,0,1,1037956,"2023-12-20T00:00:00.000Z",6,FALSE,29,3547247,"F-G",6,6,"Cleveland Cavaliers","Isaac Okoro",0,11,16,10,11,18.7
2,0,5,3,1,3,1,0,0,"30",2,4,3,7,0,0,1037956,"2023-12-20T00:00:00.000Z",6,FALSE,29,666940,"F",6,6,"Cleveland Cavaliers","Dean Wade",0,10,12,5,9,14.4
3,0,5,0,0,13,8,2,1,"29",3,1,17,8,2,2,1037956,"2023-12-20T00:00:00.000Z",6,FALSE,29,9,"C",6,6,"Cleveland Cavaliers","Jarrett Allen",2,25,28,20,11,35.1
4,0,3,12,6,15,6,0,0,"33",1,3,18,4,0,5,1037956,"2023-12-20T00:00:00.000Z",6,FALSE,29,666908,"G",6,6,"Cleveland Cavaliers","Max Strus",0,22,26,22,8,23.8
6,3,4,2,0,7,2,2,2,"25",3,0,6,7,0,0,1037956,"2023-12-20T00:00:00.000Z",6,FALSE,29,56677872,"G",6,6,"Cleveland Cavaliers","Craig Porter",3,13,19,12,13,32.4
0,0,0,0,0,0,0,0,0,"00",0,0,0,0,0,0,1037956,"2023-12-20T00:00:00.000Z",6,FALSE,29,56677847,"F",6,6,"Cleveland Cavaliers","Emoni Bates",0,0,0,0,0,0
0,0,0,0,0,0,0,0,0,"00",0,0,0,0,0,0,1037956,"2023-12-20T00:00:00.000Z",6,FALSE,29,248,"C",6,6,"Cleveland Cavaliers","Damian Jones",0,0,0,0,0,0
7,0,3,7,4,15,6,8,7,"27",0,3,23,3,1,0,1037956,"2023-12-20T00:00:00.000Z",6,FALSE,29,277,"G",6,6,"Cleveland Cavaliers","Caris LeVert",1,26,33,30,10,40.1
2,0,3,14,8,16,9,2,1,"30",0,4,27,3,1,2,1037956,"2023-12-20T00:00:00.000Z",6,FALSE,29,3547299,"G",6,6,"Cleveland Cavaliers","Sam Merrill",1,30,32,29,5,34.6
0,0,0,0,0,0,0,0,0,"00",0,0,0,0,0,0,1037956,"2023-12-20T00:00:00.000Z",6,FALSE,29,38017662,"F",6,6,"Cleveland Cavaliers","Isaiah Mobley",0,0,0,0,0,0
1,0,1,10,3,13,6,0,0,"23",0,4,15,1,0,1,1037956,"2023-12-20T00:00:00.000Z",6,FALSE,29,344,"F",6,6,"Cleveland Cavaliers","Georges Niang",0,16,17,16,2,16.7
4,0,3,0,0,7,5,0,0,"18",2,2,10,5,4,0,1037956,"2023-12-20T00:00:00.000Z",6,FALSE,29,444,"C-F",6,6,"Cleveland Cavaliers","Tristan Thompson",4,15,19,14,9,34
0,0,0,0,0,0,0,0,0,"00",0,0,0,0,0,0,1037956,"2023-12-20T00:00:00.000Z",6,FALSE,29,666581,"G",6,6,"Cleveland Cavaliers","Darius Garland",0,0,0,0,0,0
0,0,0,0,0,0,0,0,0,"00",0,0,0,0,0,0,1037956,"2023-12-20T00:00:00.000Z",6,FALSE,29,666676,"G",6,6,"Cleveland Cavaliers","Ty Jerome",0,0,0,0,0,0
0,0,0,0,0,0,0,0,0,"00",0,0,0,0,0,0,1037956,"2023-12-20T00:00:00.000Z",6,FALSE,29,322,"G",6,6,"Cleveland Cavaliers","Donovan Mitchell",0,0,0,0,0,0
0,0,0,0,0,0,0,0,0,"00",0,0,0,0,0,0,1037956,"2023-12-20T00:00:00.000Z",6,FALSE,29,17896076,"F-C",6,6,"Cleveland Cavaliers","Evan Mobley",0,0,0,0,0,0
0,0,0,0,0,0,0,0,0,"00",0,0,0,0,0,0,1037956,"2023-12-20T00:00:00.000Z",6,FALSE,29,404,"G",6,6,"Cleveland Cavaliers","Ricky Rubio",0,0,0,0,0,0
2,0,6,5,2,7,3,2,1,"36",1,3,9,7,0,2,1037956,"2023-12-20T00:00:00.000Z",6,FALSE,29,38017739,"F",29,29,"Utah Jazz","Simone Fontecchio",0,16,18,11,9,18.4
1,1,2,1,1,1,1,0,0,"16",1,1,3,3,0,0,1037956,"2023-12-20T00:00:00.000Z",6,FALSE,29,38017620,"G",29,29,"Utah Jazz","Ochai Agbaji",1,6,7,4,4,11.1
0,1,5,4,2,8,5,4,4,"22",0,1,16,5,1,2,1037956,"2023-12-20T00:00:00.000Z",6,FALSE,29,101,"F-C",29,29,"Utah Jazz","John Collins",2,21,21,16,5,26
1,0,2,2,2,3,3,0,0,"16",0,4,8,2,0,4,1037956,"2023-12-20T00:00:00.000Z",6,FALSE,29,139,"G",29,29,"Utah Jazz","Kris Dunn",0,10,11,9,3,7.9
0,0,0,0,0,0,0,0,0,"00",0,0,0,0,0,0,1037956,"2023-12-20T00:00:00.000Z",6,FALSE,29,56677824,"F",29,29,"Utah Jazz","Taylor Hendricks",0,0,0,0,0,0
6,2,1,1,0,3,2,2,1,"20",1,0,5,2,1,3,1037956,"2023-12-20T00:00:00.000Z",6,FALSE,29,358,"F",29,29,"Utah Jazz","Kelly Olynyk",3,7,13,11,8,22.4
0,0,0,0,0,0,0,0,0,"00",0,0,0,0,0,0,1037956,"2023-12-20T00:00:00.000Z",6,FALSE,29,666881,"F",29,29,"Utah Jazz","Luka Samanic",0,0,0,0,0,0
0,0,0,0,0,0,0,0,0,"00",0,0,0,0,0,0,1037956,"2023-12-20T00:00:00.000Z",6,FALSE,29,11891374,"C",29,29,"Utah Jazz","Omer Yurtseven",0,0,0,0,0,0
0,0,0,0,0,0,0,0,0,"00",0,0,0,0,0,0,1037956,"2023-12-20T00:00:00.000Z",6,FALSE,29,17896023,"G",29,29,"Utah Jazz","Josh Christopher",0,0,0,0,0,0
0,0,0,0,0,0,0,0,0,"00",0,0,0,0,0,0,1037956,"2023-12-20T00:00:00.000Z",6,FALSE,29,100,"G",29,29,"Utah Jazz","Jordan Clarkson",0,0,0,0,0,0
0,0,0,0,0,0,0,0,0,"00",0,0,0,0,0,0,1037956,"2023-12-20T00:00:00.000Z",6,FALSE,29,56677834,"G",29,29,"Utah Jazz","Keyonte George",0,0,0,0,0,0
0,0,0,0,0,0,0,0,0,"00",0,0,0,0,0,0,1037956,"2023-12-20T00:00:00.000Z",6,FALSE,29,38017630,"G",29,29,"Utah Jazz","Johnny Juzang",0,0,0,0,0,0
0,0,0,0,0,0,0,0,0,"00",0,0,0,0,0,0,1037956,"2023-12-20T00:00:00.000Z",6,FALSE,29,19465584,"F",29,29,"Utah Jazz","Micah Potter",0,0,0,0,0,0
0,0,0,0,0,0,0,0,0,"00",0,0,0,0,0,0,1037956,"2023-12-20T00:00:00.000Z",6,FALSE,29,56677842,"F",29,29,"Utah Jazz","Brice Sensabaugh",0,0,0,0,0,0
0,1,4,1,0,8,5,0,0,"30",1,2,10,5,2,2,1037956,"2023-12-20T00:00:00.000Z",6,FALSE,29,38017705,"C",29,29,"Utah Jazz","Walker Kessler",3,15,15,10,5,23
2,1,3,6,3,17,7,4,3,"34",0,5,20,3,0,2,1037956,"2023-12-20T00:00:00.000Z",6,FALSE,29,413,"G",29,29,"Utah Jazz","Collin Sexton",1,23,25,22,5,27.6
11,0,1,1,0,13,6,8,7,"30",0,3,19,1,1,1,1037956,"2023-12-20T00:00:00.000Z",6,FALSE,29,666650,"G",29,29,"Utah Jazz","Talen Horton-Tucker",1,20,31,30,12,38.7
1,0,8,9,3,18,8,8,7,"36",2,3,26,10,0,0,1037956,"2023-12-20T00:00:00.000Z",6,FALSE,29,297,"F",29,29,"Utah Jazz","Lauri Markkanen",0,36,37,27,11,39.5
3,3,2,8,4,13,8,5,5,"26",2,2,25,4,1,2,1037957,"2023-12-20T00:00:00.000Z",12,FALSE,4,210,"G",12,12,"Indiana Pacers","Buddy Hield",4,29,32,28,7,44.3
0,0,4,3,0,5,2,2,2,"23",0,1,6,4,0,1,1037957,"2023-12-20T00:00:00.000Z",12,FALSE,4,3547243,"F",12,12,"Indiana Pacers","Obi Toppin",0,10,10,6,4,9.8
0,2,5,4,1,9,5,7,7,"25",1,2,18,6,0,1,1037957,"2023-12-20T00:00:00.000Z",12,FALSE,4,452,"C-F",12,12,"Indiana Pacers","Myles Turner",2,24,24,18,6,30.2
6,0,5,1,0,6,3,0,0,"28",0,3,6,5,0,0,1037957,"2023-12-20T00:00:00.000Z",12,FALSE,4,69,"G",12,12,"Indiana Pacers","Bruce Brown",0,11,17,12,11,21
13,1,2,9,3,14,6,4,4,"28",1,0,19,3,1,4,1037957,"2023-12-20T00:00:00.000Z",12,FALSE,4,3547245,"G",12,12,"Indiana Pacers","Tyrese Haliburton",2,22,35,32,16,44.1
1,2,2,1,0,7,4,3,2,"15",1,3,10,3,1,1,1037957,"2023-12-20T00:00:00.000Z",12,FALSE,4,17896035,"F",12,12,"Indiana Pacers","Isaiah Jackson",3,13,14,11,4,23.1
2,0,0,0,0,1,1,0,0,"06",0,0,2,0,0,0,1037957,"2023-12-20T00:00:00.000Z",12,FALSE,4,242,"F",12,12,"Indiana Pacers","James Johnson",0,2,4,4,2,5
1,0,2,6,4,7,5,0,0,"29",0,2,14,2,1,2,1037957,"2023-12-20T00:00:00.000Z",12,FALSE,4,38017686,"G-F",12,12,"Indiana Pacers","Bennedict Mathurin",1,16,17,15,3,18.9
9,0,4,0,0,3,3,4,3,"20",1,1,9,5,1,1,1037957,"2023-12-20T00:00:00.000Z",12,FALSE,4,304,"G",12,12,"Indiana Pacers","T.J. McConnell",1,14,23,18,14,30.5
0,0,0,0,0,0,0,0,0,"00",0,0,0,0,0,0,1037957,"2023-12-20T00:00:00.000Z",12,FALSE,4,38017507,"G-F",12,12,"Indiana Pacers","Andrew Nembhard",0,0,0,0,0,0
1,0,2,4,4,6,6,3,3,"23",0,1,19,2,1,1,1037957,"2023-12-20T00:00:00.000Z",12,FALSE,4,3547250,"G-F",12,12,"Indiana Pacers","Aaron Nesmith",1,21,22,20,3,24.9
1,0,0,1,0,5,2,2,2,"09",0,3,6,0,0,0,1037957,"2023-12-20T00:00:00.000Z",12,FALSE,4,3547207,"F",12,12,"Indiana Pacers","Jordan Nwora",0,6,7,7,1,7.5
0,0,2,2,2,4,4,0,0,"08",2,2,10,4,0,0,1037957,"2023-12-20T00:00:00.000Z",12,FALSE,4,3547264,"F-C",12,12,"Indiana Pacers","Jalen Smith",0,14,14,10,4,14.8
0,0,0,0,0,0,0,0,0,"00",0,0,0,0,0,0,1037957,"2023-12-20T00:00:00.000Z",12,FALSE,4,38017701,"G",12,12,"Indiana Pacers","Kendall Brown",0,0,0,0,0,0
0,0,0,0,0,0,0,0,0,"00",0,0,0,0,0,0,1037957,"2023-12-20T00:00:00.000Z",12,FALSE,4,56677778,"F-C",12,12,"Indiana Pacers","Oscar Tshiebwe",0,0,0,0,0,0
0,0,0,0,0,0,0,0,0,"00",0,0,0,0,0,0,1037957,"2023-12-20T00:00:00.000Z",12,FALSE,4,56677832,"F",12,12,"Indiana Pacers","Jarace Walker",0,0,0,0,0,0
0,0,0,0,0,0,0,0,0,"00",0,0,0,0,0,0,1037957,"2023-12-20T00:00:00.000Z",12,FALSE,4,56677794,"G",12,12,"Indiana Pacers","Isaiah Wong",0,0,0,0,0,0
3,0,1,1,1,5,3,6,4,"24",0,0,11,1,0,2,1037957,"2023-12-20T00:00:00.000Z",12,FALSE,4,204,"F",4,4,"Charlotte Hornets","Gordon Hayward",0,12,15,14,4,14.7
3,0,3,2,0,17,8,4,3,"37",1,2,19,4,3,0,1037957,"2023-12-20T00:00:00.000Z",12,FALSE,4,62,"F",4,4,"Charlotte Hornets","Miles Bridges",3,23,26,22,7,37.3
0,0,2,0,0,4,2,0,0,"19",6,3,4,8,0,0,1037957,"2023-12-20T00:00:00.000Z",12,FALSE,4,3547282,"C",4,4,"Charlotte Hornets","Nick Richards",0,12,12,4,8,13.6
3,0,4,4,2,17,9,2,1,"33",2,4,21,6,1,1,1037957,"2023-12-20T00:00:00.000Z",12,FALSE,4,56677823,"F",4,4,"Charlotte Hornets","Brandon Miller",1,27,30,24,9,34.7
0,0,0,0,0,0,0,0,0,"04",0,0,0,0,0,0,1037957,"2023-12-20T00:00:00.000Z",12,FALSE,4,56677866,"F",4,4,"Charlotte Hornets","Leaky Black",0,0,0,0,0,0
0,0,2,3,1,3,1,0,0,"06",0,0,3,2,0,1,1037957,"2023-12-20T00:00:00.000Z",12,FALSE,4,17896037,"G",4,4,"Charlotte Hornets","James Bouknight",0,5,5,3,2,4.4
1,0,0,1,0,2,1,0,0,"21",0,5,2,0,0,2,1037957,"2023-12-20T00:00:00.000Z",12,FALSE,4,38017708,"G",4,4,"Charlotte Hornets","Bryce McGowens",0,2,3,3,1,1.5
0,0,1,0,0,2,2,0,0,"07",1,0,4,2,1,0,1037957,"2023-12-20T00:00:00.000Z",12,FALSE,4,NA,NA,NA,4,"Charlotte Hornets","NA NA",1,6,6,4,2,9.4
6,0,0,0,0,3,2,0,0,"16",0,1,4,0,0,1,1037957,"2023-12-20T00:00:00.000Z",12,FALSE,4,422,"G",4,4,"Charlotte Hornets","Ish Smith",0,4,10,10,6,12
0,0,0,3,0,6,3,0,0,"06",0,0,6,0,0,1,1037957,"2023-12-20T00:00:00.000Z",12,FALSE,4,56677846,"G",4,4,"Charlotte Hornets","Nick Smith Jr.",0,6,6,6,0,5
0,0,0,0,0,0,0,2,2,"06",1,2,2,1,0,0,1037957,"2023-12-20T00:00:00.000Z",12,FALSE,4,18678001,"F",4,4,"Charlotte Hornets","JT Thor",0,3,3,2,1,3.2
0,0,1,7,2,10,4,2,2,"27",3,1,12,4,0,1,1037957,"2023-12-20T00:00:00.000Z",12,FALSE,4,666950,"F",4,4,"Charlotte Hornets","P.J. Washington",0,16,16,12,4,15.8
0,0,0,0,0,0,0,0,0,"00",0,0,0,0,0,0,1037957,"2023-12-20T00:00:00.000Z",12,FALSE,4,56677848,"G",4,4,"Charlotte Hornets","Amari Bailey",0,0,0,0,0,0
0,0,0,0,0,0,0,0,0,"00",0,0,0,0,0,0,1037957,"2023-12-20T00:00:00.000Z",12,FALSE,4,3547239,"G",4,4,"Charlotte Hornets","LaMelo Ball",0,0,0,0,0,0
0,0,0,0,0,0,0,0,0,"00",0,0,0,0,0,0,1037957,"2023-12-20T00:00:00.000Z",12,FALSE,4,666748,"F",4,4,"Charlotte Hornets","Cody Martin",0,0,0,0,0,0
0,0,0,0,0,0,0,0,0,"00",0,0,0,0,0,0,1037957,"2023-12-20T00:00:00.000Z",12,FALSE,4,347,"G",4,4,"Charlotte Hornets","Frank Ntilikina",0,0,0,0,0,0
0,0,0,0,0,0,0,0,0,"00",0,0,0,0,0,0,1037957,"2023-12-20T00:00:00.000Z",12,FALSE,4,38017698,"C",4,4,"Charlotte Hornets","Mark Williams",0,0,0,0,0,0
7,0,7,10,2,26,10,3,3,"34",2,0,25,9,1,1,1037957,"2023-12-20T00:00:00.000Z",12,FALSE,4,403,"G",4,4,"Charlotte Hornets","Terry Rozier",1,34,41,32,16,48.3
0,0,0,0,0,0,0,0,0,"00",0,0,0,0,0,0,1037957,"2023-12-20T00:00:00.000Z",12,FALSE,4,56677861,"G",12,12,"Indiana Pacers","Ben Sheppard",0,0,0,0,0,0
5,1,6,4,0,14,5,6,5,"32",0,1,15,6,2,0,1037958,"2023-12-20T00:00:00.000Z",22,FALSE,16,17896026,"F",22,22,"Orlando Magic","Franz Wagner",3,21,26,20,11,38.7
8,0,8,3,0,12,2,8,6,"34",0,1,10,8,1,3,1037958,"2023-12-20T00:00:00.000Z",22,FALSE,16,38017683,"F",22,22,"Orlando Magic","Paolo Banchero",1,18,26,18,16,31.6
1,0,5,2,1,4,3,2,1,"23",1,3,8,6,0,0,1037958,"2023-12-20T00:00:00.000Z",22,FALSE,16,85,"F",22,22,"Orlando Magic","Wendell Carter Jr.",0,14,15,9,7,16.7
3,1,1,5,1,9,5,0,0,"21",0,0,11,1,0,1,1037958,"2023-12-20T00:00:00.000Z",22,FALSE,16,17896073,"G",22,22,"Orlando Magic","Jalen Suggs",1,12,15,14,4,18.7
4,0,1,1,0,4,2,0,0,"22",1,3,4,2,0,0,1037958,"2023-12-20T00:00:00.000Z",22,FALSE,16,56677827,"G",22,22,"Orlando Magic","Anthony Black",0,6,10,8,6,12.4
3,1,3,5,2,13,8,2,2,"26",1,4,20,4,1,3,1037958,"2023-12-20T00:00:00.000Z",22,FALSE,16,3547251,"G",22,22,"Orlando Magic","Cole Anthony",2,24,27,23,7,32.3
1,2,3,0,0,3,2,0,0,"12",3,0,4,6,0,1,1037958,"2023-12-20T00:00:00.000Z",22,FALSE,16,666442,"C",22,22,"Orlando Magic","Goga Bitadze",2,10,11,5,7,17.7
1,0,0,2,0,2,0,0,0,"20",3,3,0,3,2,0,1037958,"2023-12-20T00:00:00.000Z",22,FALSE,16,196,"G",22,22,"Orlando Magic","Gary Harris",2,3,4,1,4,11.1
0,0,0,10,3,10,3,0,0,"15",0,0,9,0,0,0,1037958,"2023-12-20T00:00:00.000Z",22,FALSE,16,38017724,"G",22,22,"Orlando Magic","Caleb Houstan",0,9,9,9,0,9
0,0,0,0,0,0,0,0,0,"00",0,0,0,0,0,0,1037958,"2023-12-20T00:00:00.000Z",22,FALSE,16,56677839,"G",22,22,"Orlando Magic","Jett Howard",0,0,0,0,0,0
0,0,0,0,0,0,0,0,0,"00",0,0,0,0,0,0,1037958,"2023-12-20T00:00:00.000Z",22,FALSE,16,666885,"F",22,22,"Orlando Magic","Admiral Schofield",0,0,0,0,0,0
0,0,5,1,1,3,1,2,2,"18",0,2,5,5,1,1,1037958,"2023-12-20T00:00:00.000Z",22,FALSE,16,666747,"F",16,16,"Miami Heat","Caleb Martin",1,10,10,5,5,13
1,1,1,3,0,10,3,6,4,"34",2,1,10,3,1,1,1037958,"2023-12-20T00:00:00.000Z",22,FALSE,16,56677785,"G",16,16,"Miami Heat","Jaime Jaquez Jr.",2,13,14,11,4,20.1
2,0,7,0,0,15,7,5,4,"30",0,4,18,7,1,1,1037958,"2023-12-20T00:00:00.000Z",22,FALSE,16,4,"C-F",16,16,"Miami Heat","Bam Adebayo",1,25,27,20,9,31.4
7,0,7,5,4,17,10,4,4,"36",1,1,28,8,0,4,1037958,"2023-12-20T00:00:00.000Z",22,FALSE,16,666633,"G",16,16,"Miami Heat","Tyler Herro",0,36,43,35,15,44.1
2,0,0,2,1,2,1,0,0,"17",0,1,3,0,0,0,1037958,"2023-12-20T00:00:00.000Z",22,FALSE,16,286,"G",16,16,"Miami Heat","Kyle Lowry",0,3,5,5,2,6
0,0,0,0,0,0,0,0,0,"00",0,0,0,0,0,0,1037958,"2023-12-20T00:00:00.000Z",22,FALSE,16,226,"F",22,22,"Orlando Magic","Joe Ingles",0,0,0,0,0,0
0,0,0,0,0,0,0,0,0,"00",0,0,0,0,0,0,1037958,"2023-12-20T00:00:00.000Z",22,FALSE,16,17553983,"G",22,22,"Orlando Magic","Trevelin Queen",0,0,0,0,0,0
1,0,3,2,1,7,4,0,0,"12",1,3,9,4,1,1,1037958,"2023-12-20T00:00:00.000Z",22,FALSE,16,229,"F",22,22,"Orlando Magic","Jonathan Isaac",1,13,14,10,5,17.3
1,0,2,2,1,3,2,0,0,"05",0,1,5,2,1,0,1037958,"2023-12-20T00:00:00.000Z",22,FALSE,16,666818,"F",22,22,"Orlando Magic","Chuma Okeke",1,7,8,6,3,11.9
1,0,2,0,0,8,5,1,1,"18",5,5,11,7,0,2,1037958,"2023-12-20T00:00:00.000Z",22,FALSE,16,462,"C",22,22,"Orlando Magic","Moritz Wagner",0,18,19,12,8,18.9
0,0,0,0,0,0,0,0,0,"00",0,0,0,0,0,0,1037958,"2023-12-20T00:00:00.000Z",22,FALSE,16,165,"G",22,22,"Orlando Magic","Markelle Fultz",0,0,0,0,0,0
0,0,0,0,0,0,0,0,0,"00",0,0,0,0,0,0,1037958,"2023-12-20T00:00:00.000Z",22,FALSE,16,38017607,"G",22,22,"Orlando Magic","Kevon Harris",0,0,0,0,0,0
0,0,0,0,0,0,0,0,0,"00",0,0,0,0,0,0,1037958,"2023-12-20T00:00:00.000Z",22,FALSE,16,79,"G-F",16,16,"Miami Heat","Jimmy Butler",0,0,0,0,0,0
0,0,0,0,0,0,0,0,0,"00",0,0,0,0,0,0,1037958,"2023-12-20T00:00:00.000Z",22,FALSE,16,3547257,"G",16,16,"Miami Heat","R.J. Hampton",0,0,0,0,0,0
0,0,0,0,0,0,0,0,0,"00",0,0,0,0,0,0,1037958,"2023-12-20T00:00:00.000Z",22,FALSE,16,285,"F-C",16,16,"Miami Heat","Kevin Love",0,0,0,0,0,0
0,0,0,0,0,0,0,0,0,"00",0,0,0,0,0,0,1037958,"2023-12-20T00:00:00.000Z",22,FALSE,16,19465585,"G",16,16,"Miami Heat","Dru Smith",0,0,0,0,0,0
0,0,0,0,0,0,0,0,0,"00",0,0,0,0,0,0,1037958,"2023-12-20T00:00:00.000Z",22,FALSE,16,38017736,"F",16,16,"Miami Heat","Cole Swider",0,0,0,0,0,0
4,1,2,8,4,12,4,0,0,"34",0,1,12,2,1,0,1037958,"2023-12-20T00:00:00.000Z",22,FALSE,16,391,"G-F",16,16,"Miami Heat","Josh Richardson",2,14,18,16,6,26.4
1,0,2,0,0,7,5,2,2,"17",3,1,12,5,0,2,1037958,"2023-12-20T00:00:00.000Z",22,FALSE,16,74,"C",16,16,"Miami Heat","Thomas Bryant",0,17,18,13,6,17.5
6,0,3,1,1,5,4,3,3,"23",0,3,12,3,0,1,1037958,"2023-12-20T00:00:00.000Z",22,FALSE,16,397,"F",16,16,"Miami Heat","Duncan Robinson",0,15,21,18,9,23.6
2,0,2,9,4,12,5,2,1,"30",4,3,15,6,2,1,1037958,"2023-12-20T00:00:00.000Z",22,FALSE,16,3092,"",16,16,"Miami Heat","Haywood Highsmith",2,21,23,17,8,30.2
0,0,0,0,0,0,0,0,0,"00",0,0,0,0,0,0,1037958,"2023-12-20T00:00:00.000Z",22,FALSE,16,38017734,"F",16,16,"Miami Heat","Jamal Cain",0,0,0,0,0,0
0,0,0,0,0,0,0,0,0,"00",0,0,0,0,0,0,1037958,"2023-12-20T00:00:00.000Z",22,FALSE,16,38017696,"F",16,16,"Miami Heat","Nikola Jovic",0,0,0,0,0,0
0,0,0,0,0,0,0,0,0,"01",0,0,0,0,0,0,1037958,"2023-12-20T00:00:00.000Z",22,FALSE,16,39398582,"C",16,16,"Miami Heat","Orlando Robinson",0,0,0,0,0,0
0,0,2,3,1,6,3,1,0,"29",0,3,7,2,2,1,1037959,"2023-12-20T00:00:00.000Z",23,FALSE,18,360,"F",23,23,"Philadelphia 76ers","Kelly Oubre Jr.",2,9,9,7,2,14.4
3,0,4,1,0,10,4,1,1,"37",1,5,9,5,1,1,1037959,"2023-12-20T00:00:00.000Z",23,FALSE,18,200,"F",23,23,"Philadelphia 76ers","Tobias Harris",1,14,17,12,8,21.5
3,1,10,1,0,25,17,18,17,"36",2,5,51,12,2,2,1037959,"2023-12-20T00:00:00.000Z",23,FALSE,18,145,"F-C",23,23,"Philadelphia 76ers","Joel Embiid",3,63,66,54,15,76.9
2,0,3,1,0,2,1,2,2,"16",0,1,4,3,0,1,1037959,"2023-12-20T00:00:00.000Z",23,FALSE,18,313,"G",23,23,"Philadelphia 76ers","De'Anthony Melton",0,7,9,6,5,9.6
5,0,1,12,5,24,12,6,6,"37",0,4,35,1,0,5,1037959,"2023-12-20T00:00:00.000Z",23,FALSE,18,3547254,"G",23,23,"Philadelphia 76ers","Tyrese Maxey",0,36,41,40,6,38.7
0,0,0,0,0,0,0,0,0,"02",0,0,0,0,0,0,1037959,"2023-12-20T00:00:00.000Z",23,FALSE,18,28,"C",23,23,"Philadelphia 76ers","Mo Bamba",0,0,0,0,0,0
3,1,3,2,1,5,2,0,0,"18",0,0,5,3,0,0,1037959,"2023-12-20T00:00:00.000Z",23,FALSE,18,45,"G",23,23,"Philadelphia 76ers","Patrick Beverley",1,8,11,8,6,16.1
0,0,1,0,0,1,0,0,0,"17",0,1,0,1,0,0,1037959,"2023-12-20T00:00:00.000Z",23,FALSE,18,2175,"",23,23,"Philadelphia 76ers","Danuel House Jr.",0,1,1,0,1,1.2
0,0,0,0,0,1,0,0,0,"02",0,0,0,0,0,0,1037959,"2023-12-20T00:00:00.000Z",23,FALSE,18,260,"G-F",23,23,"Philadelphia 76ers","Furkan Korkmaz",0,0,0,0,0,0
0,0,0,0,0,1,1,2,1,"07",0,1,3,0,0,0,1037959,"2023-12-20T00:00:00.000Z",23,FALSE,18,3547294,"F",23,23,"Philadelphia 76ers","Kenyon Martin Jr.",0,3,3,3,0,3
0,0,0,0,0,0,0,0,0,"00",0,0,0,0,0,0,1037959,"2023-12-20T00:00:00.000Z",23,FALSE,18,56913527,"G",23,23,"Philadelphia 76ers","Ricky Council IV",0,0,0,0,0,0
0,0,0,0,0,0,0,0,0,"00",0,0,0,0,0,0,1037959,"2023-12-20T00:00:00.000Z",23,FALSE,18,108,"F",23,23,"Philadelphia 76ers","Robert Covington",0,0,0,0,0,0
0,0,0,0,0,0,0,0,0,"00",0,0,0,0,0,0,1037959,"2023-12-20T00:00:00.000Z",23,FALSE,18,17554001,"G",23,23,"Philadelphia 76ers","Javonte Smart",0,0,0,0,0,0
0,0,0,0,0,0,0,0,0,"00",0,0,0,0,0,0,1037959,"2023-12-20T00:00:00.000Z",23,FALSE,18,56677788,"G",23,23,"Philadelphia 76ers","Terquavion Smith",0,0,0,0,0,0
0,0,2,3,2,12,8,5,3,"38",1,3,21,3,1,0,1037959,"2023-12-20T00:00:00.000Z",23,FALSE,18,3547259,"F",18,18,"Minnesota Timberwolves","Jaden McDaniels",1,24,24,21,3,27.6
2,0,10,2,1,14,9,5,4,"38",3,4,23,13,0,4,1037959,"2023-12-20T00:00:00.000Z",23,FALSE,18,447,"C",18,18,"Minnesota Timberwolves","Karl-Anthony Towns",0,36,38,25,15,37.6
1,0,7,0,0,4,3,2,2,"24",2,4,8,9,2,0,1037959,"2023-12-20T00:00:00.000Z",23,FALSE,18,176,"C",18,18,"Minnesota Timberwolves","Rudy Gobert",2,17,18,9,10,26.3
5,0,6,6,2,20,9,8,7,"36",1,2,27,7,0,1,1037959,"2023-12-20T00:00:00.000Z",23,FALSE,18,3547238,"G",18,18,"Minnesota Timberwolves","Anthony Edwards",0,34,39,32,12,41.9
4,0,0,4,1,7,3,2,2,"26",0,1,9,0,0,2,1037959,"2023-12-20T00:00:00.000Z",23,FALSE,18,104,"G",18,18,"Minnesota Timberwolves","Mike Conley",0,9,13,13,4,13
2,1,2,1,0,3,2,0,0,"16",0,1,4,2,0,0,1037959,"2023-12-20T00:00:00.000Z",23,FALSE,18,666400,"G",18,18,"Minnesota Timberwolves","Nickeil Alexander-Walker",1,6,8,6,4,12.4
1,0,0,0,0,5,1,0,0,"13",0,0,2,0,0,2,1037959,"2023-12-20T00:00:00.000Z",23,FALSE,18,12,"F",18,18,"Minnesota Timberwolves","Kyle Anderson",0,2,3,3,1,1.5
1,0,1,2,1,4,2,0,0,"10",1,0,5,2,0,3,1037959,"2023-12-20T00:00:00.000Z",23,FALSE,18,68,"F",18,18,"Minnesota Timberwolves","Troy Brown Jr.",0,7,8,6,3,5.9
1,0,1,1,0,1,0,0,0,"02",0,2,0,1,0,0,1037959,"2023-12-20T00:00:00.000Z",23,FALSE,18,17896056,"C",18,18,"Minnesota Timberwolves","Luka Garza",0,1,2,1,2,2.7
1,0,0,0,0,0,0,0,0,"02",0,0,0,0,0,0,1037959,"2023-12-20T00:00:00.000Z",23,FALSE,18,666767,"G",18,18,"Minnesota Timberwolves","Jordan McLaughlin",0,0,1,1,1,1.5
0,0,0,0,0,0,0,0,0,"00",0,0,0,0,0,0,1037959,"2023-12-20T00:00:00.000Z",23,FALSE,18,56677782,"F",18,18,"Minnesota Timberwolves","Leonard Miller",0,0,0,0,0,0
3,0,0,0,0,2,0,2,2,"13",0,2,2,0,0,1,1037959,"2023-12-20T00:00:00.000Z",23,FALSE,18,320,"G",18,18,"Minnesota Timberwolves","Shake Milton",0,2,5,5,3,5.5
0,0,0,0,0,1,1,0,0,"02",0,0,2,0,1,1,1037959,"2023-12-20T00:00:00.000Z",23,FALSE,18,38017700,"G",18,18,"Minnesota Timberwolves","Wendell Moore Jr.",1,2,2,2,0,4
1,1,1,6,2,9,4,0,0,"20",1,3,10,2,0,4,1037959,"2023-12-20T00:00:00.000Z",23,FALSE,18,667378,"F-C",18,18,"Minnesota Timberwolves","Naz Reid",1,12,13,11,3,12.9
0,0,0,0,0,0,0,0,0,"00",0,0,0,0,0,0,1037959,"2023-12-20T00:00:00.000Z",23,FALSE,18,56677851,"G",18,18,"Minnesota Timberwolves","Jaylen Clark",0,0,0,0,0,0
0,0,0,0,0,0,0,0,0,"00",0,0,0,0,0,0,1037959,"2023-12-20T00:00:00.000Z",23,FALSE,18,38017715,"F",18,18,"Minnesota Timberwolves","Josh Minott",0,0,0,0,0,0
0,0,0,0,0,0,0,0,0,"00",0,0,0,0,0,0,1037959,"2023-12-20T00:00:00.000Z",23,FALSE,18,17895968,"F",18,18,"Minnesota Timberwolves","Daishen Nix",0,0,0,0,0,0
0,0,1,2,1,4,2,0,0,"25",0,2,5,1,1,0,1037959,"2023-12-20T00:00:00.000Z",23,FALSE,18,328,"F",23,23,"Philadelphia 76ers","Marcus Morris",1,6,6,5,1,9.2
3,1,4,0,0,5,3,2,2,"12",4,3,8,8,3,2,1037959,"2023-12-20T00:00:00.000Z",23,FALSE,18,3547270,"F",23,23,"Philadelphia 76ers","Paul Reed",4,16,19,11,11,32.1
1,0,0,0,0,0,0,0,0,"02",0,0,0,0,0,0,1037959,"2023-12-20T00:00:00.000Z",23,FALSE,18,17896025,"G",23,23,"Philadelphia 76ers","Jaden Springer",0,0,1,1,1,1.5
0,0,0,0,0,0,0,0,0,"00",0,0,0,0,0,0,1037959,"2023-12-20T00:00:00.000Z",23,FALSE,18,33,"F-G",23,23,"Philadelphia 76ers","Nicolas Batum",0,0,0,0,0,0
2,0,3,8,1,21,4,6,6,"33",2,0,15,5,2,2,1037960,"2023-12-20T00:00:00.000Z",3,FALSE,20,61,"F",3,3,"Brooklyn Nets","Mikal Bridges",2,20,22,17,7,28
2,0,4,6,4,14,8,1,0,"28",0,3,20,4,0,0,1037960,"2023-12-20T00:00:00.000Z",3,FALSE,20,666679,"F",3,3,"Brooklyn Nets","Cameron Johnson",0,24,26,22,6,27.8
2,4,4,0,0,5,3,0,0,"26",4,5,6,8,0,0,1037960,"2023-12-20T00:00:00.000Z",3,FALSE,20,666508,"F-C",3,3,"Brooklyn Nets","Nicolas Claxton",4,14,16,8,10,30.6
5,0,1,7,4,18,8,1,0,"32",1,2,20,2,0,1,1037960,"2023-12-20T00:00:00.000Z",3,FALSE,20,17896048,"G",3,3,"Brooklyn Nets","Cam Thomas",0,22,27,25,7,28.9
2,0,2,8,2,11,3,2,2,"30",0,0,10,2,1,2,1037960,"2023-12-20T00:00:00.000Z",3,FALSE,20,130,"G",3,3,"Brooklyn Nets","Spencer Dinwiddie",1,12,14,12,4,16.4
0,0,3,6,2,8,3,2,2,"24",0,2,10,3,0,1,1037960,"2023-12-20T00:00:00.000Z",3,FALSE,20,158,"F",3,3,"Brooklyn Nets","Dorian Finney-Smith",0,13,13,10,3,12.6
0,1,0,0,0,1,0,0,0,"04",0,1,0,0,0,1,1037960,"2023-12-20T00:00:00.000Z",3,FALSE,20,174,"F-C",3,3,"Brooklyn Nets","Harry Giles III",1,0,0,0,0,2
6,3,5,10,2,11,2,0,0,"28",1,2,6,6,1,2,1037960,"2023-12-20T00:00:00.000Z",3,FALSE,20,351,"F",3,3,"Brooklyn Nets","Royce O'Neale",4,12,18,12,12,32.2
0,2,2,0,0,2,1,0,0,"13",0,3,2,2,0,0,1037960,"2023-12-20T00:00:00.000Z",3,FALSE,20,173,"F",30,20,"New York Knicks","Taj Gibson",2,4,4,2,2,10.4
0,1,1,4,1,7,2,0,0,"18",0,1,5,1,1,0,1037960,"2023-12-20T00:00:00.000Z",3,FALSE,20,17895858,"G",20,20,"New York Knicks","Quentin Grimes",2,6,6,5,1,12.2
3,0,11,3,2,5,2,4,4,"31",2,2,10,13,1,2,1037960,"2023-12-20T00:00:00.000Z",3,FALSE,20,202,"G",20,20,"New York Knicks","Josh Hart",1,23,26,13,16,31.1
0,0,0,0,0,3,2,0,0,"03",0,1,4,0,0,0,1037960,"2023-12-20T00:00:00.000Z",3,FALSE,20,666675,"F",20,20,"New York Knicks","DaQuan Jeffries",0,4,4,4,0,4
0,0,0,1,0,1,0,0,0,"03",0,0,0,0,0,0,1037960,"2023-12-20T00:00:00.000Z",3,FALSE,20,17896033,"G",20,20,"New York Knicks","Miles McBride",0,0,0,0,0,0
2,1,0,6,4,12,7,4,1,"24",0,0,19,0,1,1,1037960,"2023-12-20T00:00:00.000Z",3,FALSE,20,3547269,"G",20,20,"New York Knicks","Immanuel Quickley",2,19,21,21,2,27
0,0,0,0,0,0,0,0,0,"00",0,0,0,0,0,0,1037960,"2023-12-20T00:00:00.000Z",3,FALSE,20,666474,"G",20,20,"New York Knicks","Charles Brown",0,0,0,0,0,0
0,0,0,0,0,0,0,0,0,"00",0,0,0,0,0,0,1037960,"2023-12-20T00:00:00.000Z",3,FALSE,20,59421201,"G",20,20,"New York Knicks","Jaylen Martin",0,0,0,0,0,0
0,0,0,0,0,0,0,0,0,"00",0,0,0,0,0,0,1037960,"2023-12-20T00:00:00.000Z",3,FALSE,20,399,"C",20,20,"New York Knicks","Mitchell Robinson",0,0,0,0,0,0
0,0,0,0,0,0,0,0,0,"00",0,0,0,0,0,0,1037960,"2023-12-20T00:00:00.000Z",3,FALSE,20,17896063,"F",20,20,"New York Knicks","Jericho Sims",0,0,0,0,0,0
0,0,0,0,0,0,0,0,0,"00",0,0,0,0,0,0,1037960,"2023-12-20T00:00:00.000Z",3,FALSE,20,56677795,"F",20,20,"New York Knicks","Jacob Toppin",0,0,0,0,0,0
3,0,6,0,0,7,3,4,3,"18",9,4,9,15,1,1,1037960,"2023-12-20T00:00:00.000Z",3,FALSE,20,17896038,"C",3,3,"Brooklyn Nets","Day'Ron Sharpe",1,24,27,12,18,33.5
0,0,0,0,0,0,0,0,0,"00",0,0,0,0,0,0,1037960,"2023-12-20T00:00:00.000Z",3,FALSE,20,421,"G",3,3,"Brooklyn Nets","Dennis Smith Jr.",0,0,0,0,0,0
1,1,3,1,0,3,2,1,0,"11",0,1,4,3,0,1,1037960,"2023-12-20T00:00:00.000Z",3,FALSE,20,17896058,"F",3,3,"Brooklyn Nets","Trendon Watford",1,7,8,5,4,11.1
2,0,1,1,0,2,1,0,0,"06",0,0,2,1,1,0,1037960,"2023-12-20T00:00:00.000Z",3,FALSE,20,56677722,"F",3,3,"Brooklyn Nets","Jalen Wilson",1,3,5,4,3,9.2
0,0,0,0,0,0,0,0,0,"00",0,0,0,0,0,0,1037960,"2023-12-20T00:00:00.000Z",3,FALSE,20,9051997,"G",3,3,"Brooklyn Nets","Armoni Brooks",0,0,0,0,0,0
0,0,0,0,0,0,0,0,0,"00",0,0,0,0,0,0,1037960,"2023-12-20T00:00:00.000Z",3,FALSE,20,56677843,"F",3,3,"Brooklyn Nets","Noah Clowney",0,0,0,0,0,0
0,0,0,0,0,0,0,0,0,"00",0,0,0,0,0,0,1037960,"2023-12-20T00:00:00.000Z",3,FALSE,20,17896041,"G",3,3,"Brooklyn Nets","Keon Johnson",0,0,0,0,0,0
0,0,0,0,0,0,0,0,0,"00",0,0,0,0,0,0,1037960,"2023-12-20T00:00:00.000Z",3,FALSE,20,417,"G-F",3,3,"Brooklyn Nets","Ben Simmons",0,0,0,0,0,0
0,0,0,0,0,0,0,0,0,"00",0,0,0,0,0,0,1037960,"2023-12-20T00:00:00.000Z",3,FALSE,20,464,"G",3,3,"Brooklyn Nets","Lonnie Walker IV",0,0,0,0,0,0
1,0,1,1,0,1,0,0,0,"02",0,0,0,1,0,0,1037960,"2023-12-20T00:00:00.000Z",3,FALSE,20,19,"G",20,20,"New York Knicks","Ryan Arcidiacono",0,1,2,1,2,2.7
0,0,0,0,0,0,0,0,0,"00",0,0,0,0,0,0,1037960,"2023-12-20T00:00:00.000Z",3,FALSE,20,160,"G-F",20,20,"New York Knicks","Evan Fournier",0,0,0,0,0,0
4,0,5,4,0,20,9,9,8,"34",2,3,26,7,0,1,1037960,"2023-12-20T00:00:00.000Z",3,FALSE,20,387,"F",20,20,"New York Knicks","Julius Randle",0,33,37,30,11,39.4
3,2,5,0,0,3,1,0,0,"30",5,1,2,10,0,0,1037960,"2023-12-20T00:00:00.000Z",3,FALSE,20,201,"F-C",20,20,"New York Knicks","Isaiah Hartenstein",2,12,15,5,13,24.5
1,0,6,10,5,15,9,0,0,"23",2,2,23,8,3,2,1037960,"2023-12-20T00:00:00.000Z",3,FALSE,20,131,"G",20,20,"New York Knicks","Donte DiVincenzo",3,31,32,24,9,41.1
8,0,6,3,1,15,6,4,3,"32",1,0,16,7,1,3,1037960,"2023-12-20T00:00:00.000Z",3,FALSE,20,73,"G",20,20,"New York Knicks","Jalen Brunson",1,23,31,24,15,36.4
0,0,0,0,0,0,0,0,0,"00",0,0,0,0,0,0,1037960,"2023-12-20T00:00:00.000Z",3,FALSE,20,56677841,"F",3,3,"Brooklyn Nets","Dariq Whitehead",0,0,0,0,0,0
2,1,5,1,0,11,5,4,4,"27",0,2,14,5,1,2,1037960,"2023-12-20T00:00:00.000Z",3,FALSE,20,666423,"F-G",20,20,"New York Knicks","RJ Barrett",2,19,21,16,7,27
0,0,0,0,0,0,0,0,0,"00",0,0,0,0,0,0,1037961,"2023-12-20T00:00:00.000Z",28,FALSE,8,376,"F",28,28,"Toronto Raptors","Otto Porter Jr.",0,0,0,0,0,0
0,0,0,0,0,0,0,0,0,"00",0,0,0,0,0,0,1037961,"2023-12-20T00:00:00.000Z",28,FALSE,8,436,"G-F",28,28,"Toronto Raptors","Garrett Temple",0,0,0,0,0,0
4,0,3,5,1,9,4,3,3,"29",0,0,12,3,0,1,1037961,"2023-12-20T00:00:00.000Z",28,FALSE,8,3089,"",28,28,"Toronto Raptors","Gary Trent Jr.",0,15,19,16,7,20.6
0,0,0,0,0,0,0,0,0,"00",0,0,0,0,0,0,1037961,"2023-12-20T00:00:00.000Z",28,FALSE,8,489,"F",28,28,"Toronto Raptors","Thaddeus Young",0,0,0,0,0,0
0,0,0,0,0,0,0,0,0,"00",0,0,0,0,0,0,1037961,"2023-12-20T00:00:00.000Z",28,FALSE,8,56677805,"G",28,28,"Toronto Raptors","Javon Freeman-Liberty",0,0,0,0,0,0
0,0,0,0,0,0,0,0,0,"00",0,0,0,0,0,0,1037961,"2023-12-20T00:00:00.000Z",28,FALSE,8,38017710,"C",28,28,"Toronto Raptors","Christian Koloko",0,0,0,0,0,0
0,0,0,0,0,0,0,0,0,"00",0,0,0,0,0,0,1037961,"2023-12-20T00:00:00.000Z",28,FALSE,8,56677869,"G",28,28,"Toronto Raptors","Markquis Nowell",0,0,0,0,0,0
0,0,0,0,0,0,0,0,0,"00",0,0,0,0,0,0,1037961,"2023-12-20T00:00:00.000Z",28,FALSE,8,2309958,"C-F",15,28,"Toronto Raptors","Jontay Porter",0,0,0,0,0,0
2,0,5,7,2,13,5,0,0,"32",1,1,12,6,1,0,1037961,"2023-12-20T00:00:00.000Z",28,FALSE,8,375,"F",8,8,"Denver Nuggets","Michael Porter Jr.",1,18,20,14,8,25.2
0,0,0,0,0,0,0,0,0,"00",0,0,0,0,0,0,1037961,"2023-12-20T00:00:00.000Z",28,FALSE,8,38017727,"G",8,8,"Denver Nuggets","Collin Gillespie",0,0,0,0,0,0
0,0,0,0,0,0,0,0,0,"00",0,0,0,0,0,0,1037961,"2023-12-20T00:00:00.000Z",28,FALSE,8,215,"F-G",8,8,"Denver Nuggets","Justin Holiday",0,0,0,0,0,0
5,1,9,5,1,21,13,4,3,"33",1,0,30,10,0,3,1037961,"2023-12-20T00:00:00.000Z",28,FALSE,8,17896055,"G-F",28,28,"Toronto Raptors","Scottie Barnes",1,40,45,35,15,49.5
1,0,4,5,1,16,7,5,3,"35",1,2,18,5,0,1,1037961,"2023-12-20T00:00:00.000Z",28,FALSE,8,416,"F",28,28,"Toronto Raptors","Pascal Siakam",0,23,24,19,6,24.5
3,2,3,0,0,5,2,0,0,"19",2,2,4,5,0,1,1037961,"2023-12-20T00:00:00.000Z",28,FALSE,8,373,"C",28,28,"Toronto Raptors","Jakob Poeltl",2,9,12,7,8,19.5
3,0,1,4,1,9,4,0,0,"40",0,2,9,1,0,1,1037961,"2023-12-20T00:00:00.000Z",28,FALSE,8,18,"F",28,28,"Toronto Raptors","OG Anunoby",0,10,13,12,4,13.7
7,0,2,2,1,8,3,0,0,"31",0,2,7,2,1,2,1037961,"2023-12-20T00:00:00.000Z",28,FALSE,8,409,"G",28,28,"Toronto Raptors","Dennis Schroder",1,9,16,14,9,20.9
1,1,1,2,1,10,6,1,0,"25",4,2,13,5,1,1,1037961,"2023-12-20T00:00:00.000Z",28,FALSE,8,3547249,"F",28,28,"Toronto Raptors","Precious Achiuwa",2,18,19,14,6,25.5
0,1,5,1,1,3,2,0,0,"12",2,1,5,7,0,1,1037961,"2023-12-20T00:00:00.000Z",28,FALSE,8,58,"F",28,28,"Toronto Raptors","Chris Boucher",1,12,12,5,7,15.4
0,0,0,0,0,0,0,0,0,"00",0,0,0,0,0,0,1037961,"2023-12-20T00:00:00.000Z",28,FALSE,8,56677828,"G",28,28,"Toronto Raptors","Gradey Dick",0,0,0,0,0,0
2,0,3,3,2,8,2,0,0,"16",0,1,6,3,1,1,1037961,"2023-12-20T00:00:00.000Z",28,FALSE,8,3547275,"G",28,28,"Toronto Raptors","Malachi Flynn",1,9,11,8,5,14.6
0,0,0,0,0,0,0,0,0,"00",0,0,0,0,0,0,1037961,"2023-12-20T00:00:00.000Z",28,FALSE,8,666762,"F",28,28,"Toronto Raptors","Jalen McDaniels",0,0,0,0,0,0
0,0,0,0,0,0,0,0,0,"00",0,0,0,0,0,0,1037961,"2023-12-20T00:00:00.000Z",28,FALSE,8,56677871,"F",8,8,"Denver Nuggets","Hunter Tyson",0,0,0,0,0,0
0,0,0,0,0,0,0,0,0,"00",0,0,0,0,0,0,1037961,"2023-12-20T00:00:00.000Z",28,FALSE,8,250,"C",8,8,"Denver Nuggets","DeAndre Jordan",0,0,0,0,0,0
1,2,1,0,0,3,0,2,0,"10",2,1,0,3,1,2,1037961,"2023-12-20T00:00:00.000Z",28,FALSE,8,3547268,"F-C",8,8,"Denver Nuggets","Zeke Nnaji",3,3,4,1,4,12.1
2,0,1,4,1,6,3,0,0,"14",0,2,7,1,2,0,1037961,"2023-12-20T00:00:00.000Z",28,FALSE,8,56677776,"G",8,8,"Denver Nuggets","Julian Strawther",2,8,10,9,3,17.2
1,1,3,1,1,6,5,0,0,"18",1,1,11,4,1,0,1037961,"2023-12-20T00:00:00.000Z",28,FALSE,8,38017721,"G",8,8,"Denver Nuggets","Peyton Watson",2,15,16,12,5,23.3
0,0,0,0,0,0,0,0,0,"00",0,0,0,0,0,0,1037961,"2023-12-20T00:00:00.000Z",28,FALSE,8,666489,"F",8,8,"Denver Nuggets","Vlatko Cancar",0,0,0,0,0,0
0,0,0,0,0,0,0,0,0,"00",0,0,0,0,0,0,1037961,"2023-12-20T00:00:00.000Z",28,FALSE,8,17896103,"F-C",8,8,"Denver Nuggets","Jay Huff",0,0,0,0,0,0
0,0,0,0,0,0,0,0,0,"00",0,0,0,0,0,0,1037961,"2023-12-20T00:00:00.000Z",28,FALSE,8,17896007,"G",8,8,"Denver Nuggets","Braxton Key",0,0,0,0,0,0
0,0,0,0,0,0,0,0,0,"00",0,0,0,0,0,0,1037961,"2023-12-20T00:00:00.000Z",28,FALSE,8,56677582,"G",8,8,"Denver Nuggets","Jalen Pickett",0,0,0,0,0,0
3,1,2,3,2,5,4,0,0,"32",0,2,10,2,3,0,1037961,"2023-12-20T00:00:00.000Z",28,FALSE,8,81,"G",8,8,"Denver Nuggets","Kentavious Caldwell-Pope",4,12,15,13,5,28.9
6,2,3,7,2,22,9,0,0,"32",1,2,20,4,1,2,1037961,"2023-12-20T00:00:00.000Z",28,FALSE,8,335,"G",8,8,"Denver Nuggets","Jamal Murray",3,24,30,26,10,40.8
2,0,2,2,1,4,1,0,0,"17",1,0,3,3,1,0,1037961,"2023-12-20T00:00:00.000Z",28,FALSE,8,38017709,"G",8,8,"Denver Nuggets","Christian Braun",1,6,8,5,5,12.6
4,0,1,3,0,7,3,2,1,"17",1,1,7,2,0,1,1037961,"2023-12-20T00:00:00.000Z",28,FALSE,8,236,"G",8,8,"Denver Nuggets","Reggie Jackson",0,9,13,11,6,14.4
2,0,2,1,0,9,6,0,0,"30",3,1,12,5,0,1,1037961,"2023-12-20T00:00:00.000Z",28,FALSE,8,177,"F",8,8,"Denver Nuggets","Aaron Gordon",0,17,19,14,7,20
6,2,10,5,3,23,13,3,2,"38",5,2,31,15,0,2,1037961,"2023-12-20T00:00:00.000Z",28,FALSE,8,246,"C",8,8,"Denver Nuggets","Nikola Jokic",2,46,52,37,21,62
1,0,1,6,5,9,7,0,0,"30",0,5,19,1,2,0,1037963,"2023-12-20T00:00:00.000Z",11,FALSE,1,66,"G-F",11,11,"Houston Rockets","Dillon Brooks",2,20,21,20,2,27.7
1,4,8,7,4,14,8,14,14,"42",5,3,34,13,0,0,1037963,"2023-12-20T00:00:00.000Z",11,FALSE,1,38017684,"F",11,11,"Houston Rockets","Jabari Smith Jr.",4,47,48,35,14,63.1
5,1,7,0,0,12,7,0,0,"27",2,2,14,9,0,0,1037963,"2023-12-20T00:00:00.000Z",11,FALSE,1,17896062,"F-C",11,11,"Houston Rockets","Alperen Sengun",1,23,28,19,14,35.3
2,1,3,7,2,19,7,0,0,"32",1,1,16,4,1,1,1037963,"2023-12-20T00:00:00.000Z",11,FALSE,1,17895966,"G",11,11,"Houston Rockets","Jalen Green",2,20,22,18,6,28.8
15,0,4,7,3,20,10,9,9,"44",0,3,32,4,1,2,1037963,"2023-12-20T00:00:00.000Z",11,FALSE,1,458,"G",11,11,"Houston Rockets","Fred VanVleet",1,36,51,47,19,60.3
0,0,2,0,0,2,1,0,0,"08",0,1,2,2,0,0,1037963,"2023-12-20T00:00:00.000Z",11,FALSE,1,56677825,"G-F",11,11,"Houston Rockets","Amen Thompson",0,4,4,2,2,4.4
0,0,0,0,0,0,0,0,0,"00",0,0,0,0,0,0,1037963,"2023-12-20T00:00:00.000Z",11,FALSE,1,17896040,"F",1,1,"Atlanta Hawks","Jalen Johnson",0,0,0,0,0,0
0,0,0,0,0,0,0,0,0,"00",0,0,0,0,0,0,1037963,"2023-12-20T00:00:00.000Z",11,FALSE,1,56677855,"G",1,1,"Atlanta Hawks","Seth Lundy",0,0,0,0,0,0
0,0,0,0,0,0,0,0,0,"00",0,0,0,0,0,0,1037963,"2023-12-20T00:00:00.000Z",11,FALSE,1,56677875,"F",1,1,"Atlanta Hawks","Miles Norris",0,0,0,0,0,0
0,0,0,0,0,0,0,0,0,"00",0,0,0,0,0,0,1037963,"2023-12-20T00:00:00.000Z",11,FALSE,1,38017695,"F",11,11,"Houston Rockets","Tari Eason",0,0,0,0,0,0
0,0,2,5,2,8,3,0,0,"26",0,1,8,2,0,2,1037963,"2023-12-20T00:00:00.000Z",11,FALSE,1,213,"G",11,11,"Houston Rockets","Aaron Holiday",0,10,10,8,2,8.4
0,0,1,1,0,2,1,0,0,"12",0,4,2,1,0,3,1037963,"2023-12-20T00:00:00.000Z",11,FALSE,1,188,"F",11,11,"Houston Rockets","Jeff Green",0,3,3,2,1,0.2
0,0,0,0,0,0,0,0,0,"00",0,0,0,0,0,0,1037963,"2023-12-20T00:00:00.000Z",11,FALSE,1,75,"G-F",11,11,"Houston Rockets","Reggie Bullock",0,0,0,0,0,0
0,0,0,0,0,0,0,0,0,"00",0,0,0,0,0,0,1037963,"2023-12-20T00:00:00.000Z",11,FALSE,1,19465326,"C",11,11,"Houston Rockets","Jock Landale",0,0,0,0,0,0
0,0,0,0,0,0,0,0,0,"00",0,0,0,0,0,0,1037963,"2023-12-20T00:00:00.000Z",11,FALSE,1,296,"C",11,11,"Houston Rockets","Boban Marjanovic",0,0,0,0,0,0
0,0,0,0,0,0,0,0,0,"00",0,0,0,0,0,0,1037963,"2023-12-20T00:00:00.000Z",11,FALSE,1,47738533,"G",11,11,"Houston Rockets","Jeenathan Williams",0,0,0,0,0,0
0,0,1,4,2,4,2,0,0,"17",0,1,6,1,0,1,1037963,"2023-12-20T00:00:00.000Z",11,FALSE,1,666754,"G",1,1,"Atlanta Hawks","Garrison Mathews",0,7,7,6,1,6.2
0,0,0,0,0,0,0,0,0,"00",0,0,0,0,0,0,1037963,"2023-12-20T00:00:00.000Z",11,FALSE,1,666564,"F",1,1,"Atlanta Hawks","Bruno Fernando",0,0,0,0,0,0
0,0,0,0,0,0,0,0,0,"00",0,0,0,0,0,0,1037963,"2023-12-20T00:00:00.000Z",11,FALSE,1,3547297,"G",1,1,"Atlanta Hawks","Trent Forrest",0,0,0,0,0,0
0,0,0,0,0,0,0,0,0,"00",0,0,0,0,0,0,1037963,"2023-12-20T00:00:00.000Z",11,FALSE,1,319,"G",1,1,"Atlanta Hawks","Patty Mills",0,0,0,0,0,0
0,0,0,0,0,0,0,0,0,"00",0,0,0,0,0,0,1037963,"2023-12-20T00:00:00.000Z",11,FALSE,1,56677838,"G",1,1,"Atlanta Hawks","Kobe Bufkin",0,0,0,0,0,0
0,0,0,0,0,0,0,0,0,"00",0,0,0,0,0,0,1037963,"2023-12-20T00:00:00.000Z",11,FALSE,1,38017689,"F",1,1,"Atlanta Hawks","AJ Griffin",0,0,0,0,0,0
0,0,0,0,0,0,0,0,0,"00",0,0,0,0,0,0,1037963,"2023-12-20T00:00:00.000Z",11,FALSE,1,56677806,"F",1,1,"Atlanta Hawks","Mouhamed Gueye",0,0,0,0,0,0
0,0,0,0,0,0,0,0,0,"00",0,0,0,0,0,0,1037963,"2023-12-20T00:00:00.000Z",11,FALSE,1,3547281,"G-F",11,11,"Houston Rockets","Nate Hinton",0,0,0,0,0,0
0,0,0,0,0,0,0,0,0,"00",0,0,0,0,0,0,1037963,"2023-12-20T00:00:00.000Z",11,FALSE,1,357,"G",11,11,"Houston Rockets","Victor Oladipo",0,0,0,0,0,0
0,0,0,0,0,0,0,0,0,"00",0,0,0,0,0,0,1037963,"2023-12-20T00:00:00.000Z",11,FALSE,1,56677809,"F",11,11,"Houston Rockets","Jermaine Samuels Jr.",0,0,0,0,0,0
0,0,0,0,0,0,0,0,0,"00",0,0,0,0,0,0,1037963,"2023-12-20T00:00:00.000Z",11,FALSE,1,56677831,"F",11,11,"Houston Rockets","Cam Whitmore",0,0,0,0,0,0
3,0,1,4,1,10,5,0,0,"28",0,2,11,1,0,0,1037963,"2023-12-20T00:00:00.000Z",11,FALSE,1,666656,"F",1,1,"Atlanta Hawks","De'Andre Hunter",0,12,15,14,4,16.7
0,0,5,6,2,11,3,1,1,"32",4,1,9,9,0,1,1037963,"2023-12-20T00:00:00.000Z",11,FALSE,1,3547256,"F",1,1,"Atlanta Hawks","Saddiq Bey",0,18,18,9,9,18.8
2,1,4,0,0,6,4,7,7,"21",5,3,15,9,2,0,1037963,"2023-12-20T00:00:00.000Z",11,FALSE,1,83,"C",1,1,"Atlanta Hawks","Clint Capela",3,24,26,17,11,37.8
5,1,1,8,3,15,7,5,4,"35",2,2,21,3,0,3,1037963,"2023-12-20T00:00:00.000Z",11,FALSE,1,334,"G",1,1,"Atlanta Hawks","Dejounte Murray",1,24,29,26,8,32.1
1,0,0,1,0,3,0,0,0,"19",0,3,0,0,0,0,1037963,"2023-12-20T00:00:00.000Z",11,FALSE,1,3547301,"F",11,11,"Houston Rockets","Jae'Sean Tate",0,0,1,1,1,1.5
14,0,4,8,5,18,10,7,5,"36",0,4,30,4,1,4,1037963,"2023-12-20T00:00:00.000Z",11,FALSE,1,490,"G",1,1,"Atlanta Hawks","Trae Young",1,34,48,44,18,54.8
2,0,10,1,0,11,8,4,3,"33",1,1,19,11,0,0,1037963,"2023-12-20T00:00:00.000Z",11,FALSE,1,3547244,"F-C",1,1,"Atlanta Hawks","Onyeka Okongwu",0,30,32,21,13,35.2
5,1,4,8,4,14,8,2,2,"30",0,3,22,4,1,0,1037963,"2023-12-20T00:00:00.000Z",11,FALSE,1,53,"G",1,1,"Atlanta Hawks","Bogdan Bogdanovic",2,26,31,27,9,40.3
0,0,2,1,0,2,0,2,1,"08",0,1,1,2,0,0,1037963,"2023-12-20T00:00:00.000Z",11,FALSE,1,301,"G-F",1,1,"Atlanta Hawks","Wesley Matthews",0,3,3,1,2,3.4
9,1,7,2,0,16,12,3,3,"36",0,3,27,7,1,3,1037962,"2023-12-20T00:00:00.000Z",5,FALSE,14,125,"G",5,5,"Chicago Bulls","DeMar DeRozan",2,34,43,36,16,51.9
2,1,1,3,3,10,6,0,0,"34",2,2,15,3,1,0,1037962,"2023-12-20T00:00:00.000Z",5,FALSE,14,3547248,"F",5,5,"Chicago Bulls","Patrick Williams",2,18,20,17,5,27.6
2,1,9,5,3,13,4,2,2,"31",1,2,13,10,1,1,1037962,"2023-12-20T00:00:00.000Z",5,FALSE,14,460,"C",5,5,"Chicago Bulls","Nikola Vucevic",2,23,25,15,12,33
2,1,4,4,3,7,5,2,2,"28",2,2,15,6,0,4,1037962,"2023-12-20T00:00:00.000Z",5,FALSE,14,89,"G",5,5,"Chicago Bulls","Alex Caruso",1,21,23,17,8,24.2
5,0,6,6,3,18,7,0,0,"33",1,2,17,7,0,3,1037962,"2023-12-20T00:00:00.000Z",5,FALSE,14,666956,"G",5,5,"Chicago Bulls","Coby White",0,24,29,22,12,29.9
0,0,1,7,2,9,4,0,0,"17",0,1,10,1,1,0,1037962,"2023-12-20T00:00:00.000Z",5,FALSE,14,87,"G",5,5,"Chicago Bulls","Jevon Carter",1,11,11,10,1,14.2
0,0,0,0,0,0,0,0,0,"00",0,0,0,0,0,0,1037962,"2023-12-20T00:00:00.000Z",5,FALSE,14,110,"F",5,5,"Chicago Bulls","Torrey Craig",0,0,0,0,0,0
1,2,1,6,4,8,5,0,0,"22",1,1,14,2,2,1,1037962,"2023-12-20T00:00:00.000Z",5,FALSE,14,17895983,"G",5,5,"Chicago Bulls","Ayo Dosunmu",4,16,17,15,3,28.9
1,0,7,0,0,5,4,4,3,"16",0,2,11,7,1,2,1037962,"2023-12-20T00:00:00.000Z",5,FALSE,14,137,"C",5,5,"Chicago Bulls","Andre Drummond",1,18,19,12,8,21.9
0,0,0,0,0,0,0,0,0,"01",0,0,0,0,0,0,1037962,"2023-12-20T00:00:00.000Z",5,FALSE,14,56677857,"F",5,5,"Chicago Bulls","Julian Phillips",0,0,0,0,0,0
0,0,0,0,0,0,0,0,0,"01",0,0,0,0,0,0,1037962,"2023-12-20T00:00:00.000Z",5,FALSE,14,17896116,"G",5,5,"Chicago Bulls","Terry Taylor",0,0,0,0,0,0
3,0,5,1,0,2,1,0,0,"21",0,0,2,5,0,1,1037962,"2023-12-20T00:00:00.000Z",5,FALSE,14,38017719,"F",5,5,"Chicago Bulls","Dalen Terry",0,7,10,5,8,11.5
0,0,0,0,0,0,0,0,0,"00",0,0,0,0,0,0,1037962,"2023-12-20T00:00:00.000Z",5,FALSE,14,27,"G",5,5,"Chicago Bulls","Lonzo Ball",0,0,0,0,0,0
0,0,0,0,0,0,0,0,0,"00",0,0,0,0,0,0,1037962,"2023-12-20T00:00:00.000Z",5,FALSE,14,56677874,"F",5,5,"Chicago Bulls","Onuralp Bitim",0,0,0,0,0,0
0,0,0,0,0,0,0,0,0,"00",0,0,0,0,0,0,1037962,"2023-12-20T00:00:00.000Z",5,FALSE,14,NA,NA,NA,5,"Chicago Bulls","NA NA",0,0,0,0,0,0
3,0,1,3,1,4,1,0,0,"14",0,2,3,1,0,0,1037962,"2023-12-20T00:00:00.000Z",5,FALSE,14,1603383,"G",14,14,"Los Angeles Lakers","Gabe Vincent",0,4,7,6,4,8.7
1,0,2,2,1,9,2,0,0,"16",3,0,5,5,0,0,1037962,"2023-12-20T00:00:00.000Z",5,FALSE,14,666609,"F",14,14,"Los Angeles Lakers","Rui Hachimura",0,10,11,6,6,12.5
0,0,0,0,0,0,0,0,0,"01",0,0,0,0,0,0,1037962,"2023-12-20T00:00:00.000Z",5,FALSE,14,38017697,"G",14,14,"Los Angeles Lakers","Max Christie",0,0,0,0,0,0
0,0,1,0,0,1,1,0,0,"01",0,0,2,1,0,0,1037962,"2023-12-20T00:00:00.000Z",5,FALSE,14,666626,"C",14,14,"Los Angeles Lakers","Jaxson Hayes",0,3,3,2,1,3.2
0,0,0,0,0,0,0,0,0,"01",0,0,0,0,0,0,1037962,"2023-12-20T00:00:00.000Z",5,FALSE,14,56677836,"F",14,14,"Los Angeles Lakers","Maxwell Lewis",0,0,0,0,0,0
2,0,3,8,3,14,5,0,0,"28",1,1,13,4,2,1,1037962,"2023-12-20T00:00:00.000Z",5,FALSE,14,666860,"F-G",14,14,"Los Angeles Lakers","Cameron Reddish",2,17,19,15,6,25.8
9,2,8,3,1,18,10,4,4,"37",2,0,25,10,1,5,1037962,"2023-12-20T00:00:00.000Z",5,FALSE,14,237,"F",14,14,"Los Angeles Lakers","LeBron James",3,35,44,34,19,54.5
3,2,12,2,0,15,7,8,5,"38",2,1,19,14,2,1,1037962,"2023-12-20T00:00:00.000Z",5,FALSE,14,117,"F-C",14,14,"Los Angeles Lakers","Anthony Davis",4,33,36,22,17,51.3
4,1,4,8,4,10,5,2,2,"34",0,3,16,4,1,1,1037962,"2023-12-20T00:00:00.000Z",5,FALSE,14,383,"F",14,14,"Los Angeles Lakers","Taurean Prince",2,20,24,20,8,31.8
2,0,1,4,0,6,1,0,0,"28",0,2,2,1,0,1,1037962,"2023-12-20T00:00:00.000Z",5,FALSE,14,405,"G",14,14,"Los Angeles Lakers","D'Angelo Russell",0,3,5,4,3,5.2
3,1,0,5,2,14,9,1,1,"28",0,1,21,0,1,3,1037962,"2023-12-20T00:00:00.000Z",5,FALSE,14,17553995,"G",14,14,"Los Angeles Lakers","Austin Reaves",2,21,24,24,3,28.5
0,0,0,2,0,3,1,0,0,"13",0,1,2,0,0,0,1037962,"2023-12-20T00:00:00.000Z",5,FALSE,14,457,"F",14,14,"Los Angeles Lakers","Jarred Vanderbilt",0,2,2,2,0,2
0,0,0,0,0,0,0,0,0,"00",0,0,0,0,0,0,1037962,"2023-12-20T00:00:00.000Z",5,FALSE,14,56677860,"F",5,5,"Chicago Bulls","Adama Sanogo",0,0,0,0,0,0
0,1,0,0,0,0,0,0,0,"01",0,0,0,0,0,1,1037962,"2023-12-20T00:00:00.000Z",5,FALSE,14,486,"F",14,14,"Los Angeles Lakers","Christian Wood",1,0,0,0,0,2
0,0,0,0,0,0,0,0,0,"00",0,0,0,0,0,0,1037962,"2023-12-20T00:00:00.000Z",5,FALSE,14,56677738,"C",14,14,"Los Angeles Lakers","Colin Castleton",0,0,0,0,0,0
0,0,0,0,0,0,0,0,0,"00",0,0,0,0,0,0,1037962,"2023-12-20T00:00:00.000Z",5,FALSE,14,56677867,"F",14,14,"Los Angeles Lakers","Alex Fudge",0,0,0,0,0,0
0,0,0,0,0,0,0,0,0,"00",0,0,0,0,0,0,1037962,"2023-12-20T00:00:00.000Z",5,FALSE,14,56677868,"G",14,14,"Los Angeles Lakers","D'Moi Hodge",0,0,0,0,0,0
0,0,0,0,0,0,0,0,0,"00",0,0,0,0,0,0,1037962,"2023-12-20T00:00:00.000Z",5,FALSE,14,56677835,"G",14,14,"Los Angeles Lakers","Jalen Hood-Schifino",0,0,0,0,0,0
0,0,0,0,0,0,0,0,0,"00",0,0,0,0,0,0,1037962,"2023-12-20T00:00:00.000Z",5,FALSE,14,268,"G",5,5,"Chicago Bulls","Zach LaVine",0,0,0,0,0,0
3,0,6,2,0,9,5,0,0,"23",0,3,10,6,2,2,1037964,"2023-12-20T00:00:00.000Z",7,FALSE,13,472,"G",13,13,"LA Clippers","Russell Westbrook",2,16,19,13,9,25.7
0,0,0,0,0,0,0,0,0,"00",0,0,0,0,0,0,1037964,"2023-12-20T00:00:00.000Z",7,FALSE,13,38017725,"F",13,13,"LA Clippers","Moussa Diabate",0,0,0,0,0,0
0,0,0,0,0,0,0,0,0,"00",0,0,0,0,0,0,1037964,"2023-12-20T00:00:00.000Z",7,FALSE,13,172,"F",13,13,"LA Clippers","Paul George",0,0,0,0,0,0
0,0,0,0,0,0,0,0,0,"00",0,0,0,0,0,0,1037964,"2023-12-20T00:00:00.000Z",7,FALSE,13,56677856,"G",13,13,"LA Clippers","Jordan Miller",0,0,0,0,0,0
0,0,0,0,0,0,0,0,0,"00",0,0,0,0,0,0,1037964,"2023-12-20T00:00:00.000Z",7,FALSE,13,24417679,"G",13,13,"LA Clippers","Xavier Moon",0,0,0,0,0,0
0,0,0,0,0,0,0,0,0,"00",0,0,0,0,0,0,1037964,"2023-12-20T00:00:00.000Z",7,FALSE,13,371,"F-C",13,13,"LA Clippers","Mason Plumlee",0,0,0,0,0,0
0,0,0,0,0,0,0,0,0,"00",0,0,0,0,0,0,1037964,"2023-12-20T00:00:00.000Z",7,FALSE,13,17896051,"G",13,13,"LA Clippers","Joshua Primo",0,0,0,0,0,0
0,0,0,0,0,0,0,0,0,"01",0,0,0,0,0,0,1037964,"2023-12-20T00:00:00.000Z",7,FALSE,13,17554004,"G",7,7,"Dallas Mavericks","AJ Lawson",0,0,0,0,0,0
0,0,0,0,0,0,0,0,0,"00",0,0,0,0,0,0,1037964,"2023-12-20T00:00:00.000Z",7,FALSE,13,17896028,"F",7,7,"Dallas Mavericks","Greg Brown III",0,0,0,0,0,0
0,0,0,0,0,0,0,0,0,"00",0,0,0,0,0,0,1037964,"2023-12-20T00:00:00.000Z",7,FALSE,13,56677873,"G",7,7,"Dallas Mavericks","Dexter Dennis",0,0,0,0,0,0
0,0,0,0,0,0,0,0,0,"00",0,0,0,0,0,0,1037964,"2023-12-20T00:00:00.000Z",7,FALSE,13,3547258,"G",7,7,"Dallas Mavericks","Josh Green",0,0,0,0,0,0
0,0,0,0,0,0,0,0,0,"00",0,0,0,0,0,0,1037964,"2023-12-20T00:00:00.000Z",7,FALSE,13,228,"G",7,7,"Dallas Mavericks","Kyrie Irving",0,0,0,0,0,0
0,0,0,0,0,0,0,0,0,"00",0,0,0,0,0,0,1037964,"2023-12-20T00:00:00.000Z",7,FALSE,13,257,"F",7,7,"Dallas Mavericks","Maxi Kleber",0,0,0,0,0,0
2,2,0,4,2,11,6,5,5,"39",3,2,19,3,1,0,1037964,"2023-12-20T00:00:00.000Z",7,FALSE,13,247,"F-G",7,7,"Dallas Mavericks","Derrick Jones Jr.",3,22,24,21,5,34.6
4,1,4,4,1,7,4,0,0,"31",5,6,9,9,0,0,1037964,"2023-12-20T00:00:00.000Z",7,FALSE,13,666965,"F",7,7,"Dallas Mavericks","Grant Williams",1,18,22,13,13,28.8
1,0,0,0,0,1,1,2,1,"17",1,2,3,1,0,0,1037964,"2023-12-20T00:00:00.000Z",7,FALSE,13,379,"F-C",7,7,"Dallas Mavericks","Dwight Powell",0,4,5,4,2,5.7
1,0,5,4,1,12,6,4,3,"40",1,2,16,6,2,0,1037964,"2023-12-20T00:00:00.000Z",7,FALSE,13,151,"G",7,7,"Dallas Mavericks","Dante Exum",2,22,23,17,7,30.7
10,0,9,11,2,25,9,14,8,"44",1,1,28,10,1,5,1037964,"2023-12-20T00:00:00.000Z",7,FALSE,13,132,"F-G",7,7,"Dallas Mavericks","Luka Doncic",1,38,48,38,20,53
3,0,1,11,3,21,8,2,2,"37",1,2,21,2,3,1,1037964,"2023-12-20T00:00:00.000Z",7,FALSE,13,191,"G",7,7,"Dallas Mavericks","Tim Hardaway Jr.",3,23,26,24,5,35.9
1,0,1,0,0,0,0,0,0,"03",0,0,0,1,0,0,1037964,"2023-12-20T00:00:00.000Z",7,FALSE,13,56677859,"F",7,7,"Dallas Mavericks","Olivier-Maxence Prosper",0,1,2,1,2,2.7
0,0,0,0,0,0,0,0,0,"00",0,0,0,0,0,0,1037964,"2023-12-20T00:00:00.000Z",7,FALSE,13,56677840,"C",7,7,"Dallas Mavericks","Dereck Lively II",0,0,0,0,0,0
3,0,5,5,2,6,3,4,4,"39",0,5,12,5,1,3,1037964,"2023-12-20T00:00:00.000Z",7,FALSE,13,666511,"G",13,13,"LA Clippers","Amir Coffey",1,17,20,15,8,22.5
5,1,7,6,1,22,12,5,5,"38",3,0,30,10,1,0,1037964,"2023-12-20T00:00:00.000Z",7,FALSE,13,274,"F",13,13,"LA Clippers","Kawhi Leonard",2,40,45,35,15,55.5
0,0,7,0,0,6,5,2,2,"25",2,2,12,9,1,1,1037964,"2023-12-20T00:00:00.000Z",7,FALSE,13,493,"C",13,13,"LA Clippers","Ivica Zubac",1,21,21,12,9,24.8
1,1,3,2,1,8,3,0,0,"29",1,3,7,4,0,1,1037964,"2023-12-20T00:00:00.000Z",7,FALSE,13,666743,"G",13,13,"LA Clippers","Terance Mann",1,11,12,8,5,15.3
11,2,5,8,2,12,4,8,7,"39",0,3,17,5,0,4,1037964,"2023-12-20T00:00:00.000Z",7,FALSE,13,192,"G",13,13,"LA Clippers","James Harden",2,22,33,28,16,41.5
0,0,0,0,0,0,0,0,0,"00",0,0,0,0,0,0,1037964,"2023-12-20T00:00:00.000Z",7,FALSE,13,17896022,"G",13,13,"LA Clippers","Brandon Boston Jr.",0,0,0,0,0,0
0,0,0,0,0,0,0,0,0,"00",0,0,0,0,0,0,1037964,"2023-12-20T00:00:00.000Z",7,FALSE,13,56677849,"F",13,13,"LA Clippers","Kobe Brown",0,0,0,0,0,0
0,0,0,0,0,0,0,0,0,"00",0,0,0,0,0,0,1037964,"2023-12-20T00:00:00.000Z",7,FALSE,13,17896031,"G",13,13,"LA Clippers","Nah'Shon Hyland",0,0,0,0,0,0
2,0,3,6,3,10,7,4,4,"31",0,2,21,3,1,1,1037964,"2023-12-20T00:00:00.000Z",7,FALSE,13,380,"F-G",13,13,"LA Clippers","Norman Powell",1,24,26,23,5,29.6
2,0,1,2,2,4,4,2,1,"16",1,4,11,2,0,0,1037964,"2023-12-20T00:00:00.000Z",7,FALSE,13,439,"F",13,13,"LA Clippers","Daniel Theis",0,13,15,13,4,16.4
0,0,0,0,0,0,0,0,0,"00",0,0,0,0,0,0,1037964,"2023-12-20T00:00:00.000Z",7,FALSE,13,450,"F",13,13,"LA Clippers","PJ Tucker",0,0,0,0,0,0
1,0,2,9,5,13,5,0,0,"23",0,3,15,2,1,0,1037964,"2023-12-20T00:00:00.000Z",7,FALSE,13,38017679,"G",7,7,"Dallas Mavericks","Jaden Hardy",1,17,18,16,3,21.9
0,0,0,0,0,0,0,0,0,"00",0,0,0,0,0,0,1037964,"2023-12-20T00:00:00.000Z",7,FALSE,13,114,"G",7,7,"Dallas Mavericks","Seth Curry",0,0,0,0,0,0
0,0,0,0,0,0,0,0,0,"00",0,0,0,0,0,0,1037964,"2023-12-20T00:00:00.000Z",7,FALSE,13,217,"F-C",7,7,"Dallas Mavericks","Richaun Holmes",0,0,0,0,0,0
0,0,1,0,0,1,0,0,0,"05",1,1,0,2,0,0,1037964,"2023-12-20T00:00:00.000Z",7,FALSE,13,329,"F",7,7,"Dallas Mavericks","Markieff Morris",0,2,2,0,2,2.4
2,0,0,3,2,5,2,0,0,"12",0,1,6,0,0,0,1037967,"2023-12-21T00:00:00.000Z",6,FALSE,19,56677837,"G",19,19,"New Orleans Pelicans","Jordan Hawkins",0,6,8,8,2,9
3,0,3,4,1,11,4,7,5,"22",3,1,14,6,1,1,1037967,"2023-12-21T00:00:00.000Z",6,FALSE,19,3547293,"F",19,19,"New Orleans Pelicans","Naji Marshall",1,20,23,17,9,27.7
1,0,5,2,1,6,5,0,0,"20",0,1,11,5,0,0,1037967,"2023-12-21T00:00:00.000Z",6,FALSE,19,17896021,"F",19,19,"New Orleans Pelicans","Jeremiah Robinson-Earl",0,16,17,12,6,18.5
0,0,0,0,0,0,0,0,0,"00",0,0,0,0,0,0,1037967,"2023-12-21T00:00:00.000Z",6,FALSE,19,666969,"F",19,19,"New Orleans Pelicans","Zion Williamson",0,0,0,0,0,0
0,0,0,0,0,0,0,0,0,"00",0,0,0,0,0,0,1037967,"2023-12-21T00:00:00.000Z",6,FALSE,19,491,"C",19,19,"New Orleans Pelicans","Cody Zeller",0,0,0,0,0,0
0,0,0,0,0,0,0,0,0,"00",0,0,0,0,0,0,1037967,"2023-12-21T00:00:00.000Z",6,FALSE,19,3547260,"G",19,19,"New Orleans Pelicans","Kira Lewis Jr.",0,0,0,0,0,0
0,0,0,0,0,0,0,0,0,"00",0,0,0,0,0,0,1037967,"2023-12-21T00:00:00.000Z",6,FALSE,19,38017663,"F",19,19,"New Orleans Pelicans","E.J. Liddell",0,0,0,0,0,0
0,0,0,0,0,0,0,0,0,"00",0,0,0,0,0,0,1037967,"2023-12-21T00:00:00.000Z",6,FALSE,19,340,"F",19,19,"New Orleans Pelicans","Larry Nance Jr.",0,0,0,0,0,0
0,0,0,0,0,0,0,0,0,"00",0,0,0,0,0,0,1037967,"2023-12-21T00:00:00.000Z",6,FALSE,19,17896017,"F",19,19,"New Orleans Pelicans","Matt Ryan",0,0,0,0,0,0
4,0,2,5,2,10,7,1,0,"32",1,2,16,3,1,0,1037967,"2023-12-21T00:00:00.000Z",6,FALSE,19,3547247,"F-G",6,6,"Cleveland Cavaliers","Isaac Okoro",1,19,23,20,7,28.6
0,2,9,8,6,11,7,0,0,"26",0,3,20,9,0,0,1037967,"2023-12-21T00:00:00.000Z",6,FALSE,19,666940,"F",6,6,"Cleveland Cavaliers","Dean Wade",2,29,29,20,9,36.8
3,0,6,0,0,8,7,0,0,"27",1,0,14,7,1,1,1037967,"2023-12-21T00:00:00.000Z",6,FALSE,19,9,"C",6,6,"Cleveland Cavaliers","Jarrett Allen",1,21,24,17,10,28.9
5,0,3,12,2,16,4,5,3,"33",0,2,13,3,0,3,1037967,"2023-12-21T00:00:00.000Z",6,FALSE,19,666908,"G",6,6,"Cleveland Cavaliers","Max Strus",0,16,21,18,8,21.1
11,0,3,1,1,9,3,0,0,"29",0,1,7,3,1,2,1037967,"2023-12-21T00:00:00.000Z",6,FALSE,19,56677872,"G",6,6,"Cleveland Cavaliers","Craig Porter",1,10,21,18,14,28.1
1,0,0,3,1,5,1,0,0,"09",0,1,3,0,0,0,1037967,"2023-12-21T00:00:00.000Z",6,FALSE,19,56677847,"F",6,6,"Cleveland Cavaliers","Emoni Bates",0,3,4,4,1,4.5
4,0,0,4,1,9,3,2,2,"23",0,1,9,0,1,1,1037967,"2023-12-21T00:00:00.000Z",6,FALSE,19,277,"G",6,6,"Cleveland Cavaliers","Caris LeVert",1,9,13,13,4,17
1,0,0,3,0,4,0,0,0,"13",0,0,0,0,0,1,1037967,"2023-12-21T00:00:00.000Z",6,FALSE,19,3547299,"G",6,6,"Cleveland Cavaliers","Sam Merrill",0,0,1,1,1,0.5
1,1,2,7,3,8,4,0,0,"19",0,1,11,2,0,3,1037967,"2023-12-21T00:00:00.000Z",6,FALSE,19,344,"F",6,6,"Cleveland Cavaliers","Georges Niang",1,13,14,12,3,14.9
3,0,3,0,0,5,3,0,0,"21",4,2,6,7,0,0,1037967,"2023-12-21T00:00:00.000Z",6,FALSE,19,444,"C-F",6,6,"Cleveland Cavaliers","Tristan Thompson",0,13,16,9,10,18.9
3,0,1,0,0,1,1,0,0,"18",1,2,2,2,0,0,1037967,"2023-12-21T00:00:00.000Z",6,FALSE,19,17896097,"G",19,19,"New Orleans Pelicans","Jose Alvarado",0,4,7,5,5,8.9
1,0,2,1,1,4,3,0,0,"20",0,1,7,2,0,0,1037967,"2023-12-21T00:00:00.000Z",6,FALSE,19,38017677,"G",19,19,"New Orleans Pelicans","Dyson Daniels",0,9,10,8,3,10.9
0,0,0,0,0,0,0,0,0,"00",0,0,0,0,0,0,1037967,"2023-12-21T00:00:00.000Z",6,FALSE,19,38017726,"G",19,19,"New Orleans Pelicans","Dereon Seabron",0,0,0,0,0,0
0,0,0,0,0,0,0,0,0,"00",0,0,0,0,0,0,1037967,"2023-12-21T00:00:00.000Z",6,FALSE,19,17896076,"F-C",6,6,"Cleveland Cavaliers","Evan Mobley",0,0,0,0,0,0
0,0,0,0,0,0,0,0,0,"00",0,0,0,0,0,0,1037967,"2023-12-21T00:00:00.000Z",6,FALSE,19,404,"G",6,6,"Cleveland Cavaliers","Ricky Rubio",0,0,0,0,0,0
6,0,6,3,1,12,6,4,4,"28",1,2,17,7,0,3,1037967,"2023-12-21T00:00:00.000Z",6,FALSE,19,227,"F",19,19,"New Orleans Pelicans","Brandon Ingram",0,24,30,23,13,31.4
3,1,4,10,6,16,10,2,2,"28",0,1,28,4,1,1,1037967,"2023-12-21T00:00:00.000Z",6,FALSE,19,18677986,"F",19,19,"New Orleans Pelicans","Trey Murphy III",2,32,35,31,7,42.3
5,1,6,3,1,9,6,0,0,"28",1,3,13,7,1,2,1037967,"2023-12-21T00:00:00.000Z",6,FALSE,19,455,"C",19,19,"New Orleans Pelicans","Jonas Valanciunas",2,20,25,18,12,32.9
4,1,0,1,0,7,3,1,1,"30",1,1,7,1,0,0,1037967,"2023-12-21T00:00:00.000Z",6,FALSE,19,17896024,"F",19,19,"New Orleans Pelicans","Herbert Jones",1,8,12,11,5,17.2
4,1,6,8,2,15,7,2,2,"34",0,2,18,6,4,2,1037967,"2023-12-21T00:00:00.000Z",6,FALSE,19,303,"G",19,19,"New Orleans Pelicans","CJ McCollum",5,24,28,22,10,44.2
0,0,1,0,0,1,1,0,0,"04",0,0,2,1,0,0,1037967,"2023-12-21T00:00:00.000Z",6,FALSE,19,248,"C",6,6,"Cleveland Cavaliers","Damian Jones",0,3,3,2,1,3.2
1,0,0,1,1,1,1,0,0,"04",0,0,3,0,0,0,1037967,"2023-12-21T00:00:00.000Z",6,FALSE,19,38017662,"F",6,6,"Cleveland Cavaliers","Isaiah Mobley",0,3,4,4,1,4.5
0,0,0,0,0,0,0,0,0,"00",0,0,0,0,0,0,1037967,"2023-12-21T00:00:00.000Z",6,FALSE,19,666581,"G",6,6,"Cleveland Cavaliers","Darius Garland",0,0,0,0,0,0
0,0,0,0,0,0,0,0,0,"00",0,0,0,0,0,0,1037967,"2023-12-21T00:00:00.000Z",6,FALSE,19,666676,"G",6,6,"Cleveland Cavaliers","Ty Jerome",0,0,0,0,0,0
0,0,0,0,0,0,0,0,0,"00",0,0,0,0,0,0,1037967,"2023-12-21T00:00:00.000Z",6,FALSE,19,322,"G",6,6,"Cleveland Cavaliers","Donovan Mitchell",0,0,0,0,0,0
0,0,0,0,0,0,0,0,0,"00",0,0,0,0,0,0,1037969,"2023-12-21T00:00:00.000Z",15,FALSE,12,38017729,"F",15,15,"Memphis Grizzlies","David Roddy",0,0,0,0,0,0
0,0,0,0,0,0,0,0,0,"00",0,0,0,0,0,0,1037969,"2023-12-21T00:00:00.000Z",15,FALSE,12,401,"G",15,15,"Memphis Grizzlies","Derrick Rose",0,0,0,0,0,0
2,1,2,0,0,3,2,4,1,"21",3,2,5,5,0,1,1037969,"2023-12-21T00:00:00.000Z",15,FALSE,12,3547285,"F",15,15,"Memphis Grizzlies","Xavier Tillman",1,10,12,7,7,16
2,2,1,4,3,9,6,2,1,"18",0,2,16,1,1,2,1037969,"2023-12-21T00:00:00.000Z",15,FALSE,12,17896027,"G-F",15,15,"Memphis Grizzlies","Ziaire Williams",3,17,19,18,3,27.2
0,0,0,0,0,0,0,0,0,"00",0,0,0,0,0,0,1037969,"2023-12-21T00:00:00.000Z",15,FALSE,12,3,"C",15,15,"Memphis Grizzlies","Steven Adams",0,0,0,0,0,0
0,0,0,0,0,0,0,0,0,"00",0,0,0,0,0,0,1037969,"2023-12-21T00:00:00.000Z",15,FALSE,12,666505,"F",15,15,"Memphis Grizzlies","Brandon Clarke",0,0,0,0,0,0
0,0,0,0,0,0,0,0,0,"00",0,0,0,0,0,0,1037969,"2023-12-21T00:00:00.000Z",15,FALSE,12,56677830,"F",15,15,"Memphis Grizzlies","GG Jackson",0,0,0,0,0,0
0,0,0,0,0,0,0,0,0,"00",0,0,0,0,0,0,1037969,"2023-12-21T00:00:00.000Z",15,FALSE,12,254,"G",15,15,"Memphis Grizzlies","Luke Kennard",0,0,0,0,0,0
0,0,0,0,0,0,0,0,0,"00",0,0,0,0,0,0,1037969,"2023-12-21T00:00:00.000Z",15,FALSE,12,38017728,"F",15,15,"Memphis Grizzlies","Jake LaRavia",0,0,0,0,0,0
0,0,0,0,0,0,0,0,0,"00",0,0,0,0,0,0,1037969,"2023-12-21T00:00:00.000Z",15,FALSE,12,420,"G",15,15,"Memphis Grizzlies","Marcus Smart",0,0,0,0,0,0
4,0,4,13,5,14,5,0,0,"32",2,2,15,6,2,2,1037969,"2023-12-21T00:00:00.000Z",15,FALSE,12,210,"G",12,12,"Indiana Pacers","Buddy Hield",2,21,25,19,10,32.2
1,0,3,9,5,14,8,2,1,"28",2,3,22,5,2,1,1037969,"2023-12-21T00:00:00.000Z",15,FALSE,12,3547243,"F",12,12,"Indiana Pacers","Obi Toppin",2,27,28,23,6,34.5
2,3,3,2,0,10,5,5,5,"36",3,5,15,6,1,4,1037969,"2023-12-21T00:00:00.000Z",15,FALSE,12,452,"C-F",12,12,"Indiana Pacers","Myles Turner",4,21,23,17,8,33.2
2,1,3,1,0,4,1,2,2,"28",1,4,4,4,0,0,1037969,"2023-12-21T00:00:00.000Z",15,FALSE,12,69,"G",12,12,"Indiana Pacers","Bruce Brown",1,8,10,6,6,14.8
14,0,4,12,2,19,7,2,1,"38",0,2,17,4,0,4,1037969,"2023-12-21T00:00:00.000Z",15,FALSE,12,3547245,"G",12,12,"Indiana Pacers","Tyrese Haliburton",0,21,35,31,18,38.8
0,1,2,0,0,2,1,0,0,"12",1,2,2,3,0,0,1037969,"2023-12-21T00:00:00.000Z",15,FALSE,12,17896035,"F",12,12,"Indiana Pacers","Isaiah Jackson",1,5,5,2,3,8.6
0,0,0,0,0,0,0,0,0,"00",0,0,0,0,0,0,1037969,"2023-12-21T00:00:00.000Z",15,FALSE,12,242,"F",12,12,"Indiana Pacers","James Johnson",0,0,0,0,0,0
1,0,1,0,0,1,1,0,0,"04",0,0,2,1,0,1,1037969,"2023-12-21T00:00:00.000Z",15,FALSE,12,304,"G",12,12,"Indiana Pacers","T.J. McConnell",0,3,4,3,2,3.7
0,0,0,0,0,0,0,0,0,"00",0,0,0,0,0,0,1037969,"2023-12-21T00:00:00.000Z",15,FALSE,12,3547207,"F",12,12,"Indiana Pacers","Jordan Nwora",0,0,0,0,0,0
0,0,0,0,0,0,0,0,0,"00",0,0,0,0,0,0,1037969,"2023-12-21T00:00:00.000Z",15,FALSE,12,38017701,"G",12,12,"Indiana Pacers","Kendall Brown",0,0,0,0,0,0
0,0,0,0,0,0,0,0,0,"00",0,0,0,0,0,0,1037969,"2023-12-21T00:00:00.000Z",15,FALSE,12,56677861,"G",12,12,"Indiana Pacers","Ben Sheppard",0,0,0,0,0,0
0,0,0,0,0,0,0,0,0,"00",0,0,0,0,0,0,1037969,"2023-12-21T00:00:00.000Z",15,FALSE,12,3547264,"F-C",12,12,"Indiana Pacers","Jalen Smith",0,0,0,0,0,0
3,1,3,3,0,5,1,0,0,"35",1,2,2,4,3,2,1037969,"2023-12-21T00:00:00.000Z",15,FALSE,12,38017731,"G",15,15,"Memphis Grizzlies","Vince Williams Jr.",4,6,9,5,7,21.3
1,0,6,4,2,10,8,3,3,"33",1,4,21,7,1,7,1037969,"2023-12-21T00:00:00.000Z",15,FALSE,12,231,"F-C",15,15,"Memphis Grizzlies","Jaren Jackson Jr.",1,28,29,22,8,26.9
1,1,2,0,0,4,1,1,0,"17",1,2,2,3,0,0,1037969,"2023-12-21T00:00:00.000Z",15,FALSE,12,48,"C",15,15,"Memphis Grizzlies","Bismack Biyombo",1,5,6,3,4,10.1
7,0,6,12,5,26,11,5,4,"36",0,1,31,6,1,2,1037969,"2023-12-21T00:00:00.000Z",15,FALSE,12,3547287,"G",15,15,"Memphis Grizzlies","Desmond Bane",1,37,44,38,13,49.7
8,0,5,3,1,15,7,6,5,"34",0,0,20,5,0,2,1037969,"2023-12-21T00:00:00.000Z",15,FALSE,12,666786,"G",15,15,"Memphis Grizzlies","Ja Morant",0,25,33,28,13,36
2,0,3,5,3,7,5,0,0,"25",0,0,13,3,1,2,1037969,"2023-12-21T00:00:00.000Z",15,FALSE,12,17896067,"F",15,15,"Memphis Grizzlies","Santi Aldama",1,16,18,15,5,20.6
0,0,0,0,0,0,0,0,0,"00",0,0,0,0,0,0,1037969,"2023-12-21T00:00:00.000Z",15,FALSE,12,48248287,"G",15,15,"Memphis Grizzlies","Jacob Gilyard",0,0,0,0,0,0
1,2,5,4,2,4,2,0,0,"21",1,1,6,6,1,0,1037969,"2023-12-21T00:00:00.000Z",15,FALSE,12,666703,"G-F",15,15,"Memphis Grizzlies","John Konchar",3,12,13,7,7,23.7
1,0,1,3,2,4,2,0,0,"16",0,2,6,1,2,1,1037969,"2023-12-21T00:00:00.000Z",15,FALSE,12,38017507,"G-F",12,12,"Indiana Pacers","Andrew Nembhard",2,7,8,7,2,13.7
0,3,4,8,4,12,5,0,0,"28",1,1,14,5,4,2,1037969,"2023-12-21T00:00:00.000Z",15,FALSE,12,3547250,"G-F",12,12,"Indiana Pacers","Aaron Nesmith",7,19,19,14,5,39
3,0,2,4,0,10,3,0,0,"18",2,0,6,4,1,1,1037969,"2023-12-21T00:00:00.000Z",15,FALSE,12,38017686,"G-F",12,12,"Indiana Pacers","Bennedict Mathurin",1,10,13,9,7,17.3
0,0,0,0,0,0,0,0,0,"00",0,0,0,0,0,0,1037969,"2023-12-21T00:00:00.000Z",15,FALSE,12,56677778,"F-C",12,12,"Indiana Pacers","Oscar Tshiebwe",0,0,0,0,0,0
0,0,0,0,0,0,0,0,0,"00",0,0,0,0,0,0,1037969,"2023-12-21T00:00:00.000Z",15,FALSE,12,56677832,"F",12,12,"Indiana Pacers","Jarace Walker",0,0,0,0,0,0
0,0,0,0,0,0,0,0,0,"00",0,0,0,0,0,0,1037969,"2023-12-21T00:00:00.000Z",15,FALSE,12,56677794,"G",12,12,"Indiana Pacers","Isaiah Wong",0,0,0,0,0,0
0,0,0,0,0,0,0,0,0,"00",0,0,0,0,0,0,1037970,"2023-12-21T00:00:00.000Z",17,FALSE,22,38017691,"G",17,17,"Milwaukee Bucks","TyTy Washington Jr.",0,0,0,0,0,0
0,0,0,0,0,0,0,0,0,"00",0,0,0,0,0,0,1037970,"2023-12-21T00:00:00.000Z",17,FALSE,22,666960,"G",17,17,"Milwaukee Bucks","Lindell Wigginton",0,0,0,0,0,0
6,0,5,6,1,23,13,4,2,"39",1,4,29,6,1,2,1037970,"2023-12-21T00:00:00.000Z",17,FALSE,22,17896026,"F",22,22,"Orlando Magic","Franz Wagner",1,35,41,35,12,46.2
4,1,7,5,3,17,6,10,8,"34",0,4,23,7,0,2,1037970,"2023-12-21T00:00:00.000Z",17,FALSE,22,38017683,"F",22,22,"Orlando Magic","Paolo Banchero",1,30,34,27,11,38.4
3,1,4,7,2,11,5,2,2,"29",0,2,14,4,0,1,1037970,"2023-12-21T00:00:00.000Z",17,FALSE,22,315,"F",17,17,"Milwaukee Bucks","Khris Middleton",1,18,21,17,7,25.3
6,2,8,3,0,25,11,19,15,"37",2,4,37,10,0,5,1037970,"2023-12-21T00:00:00.000Z",17,FALSE,22,15,"F",17,17,"Milwaukee Bucks","Giannis Antetokounmpo",2,47,53,43,16,59
0,2,7,4,2,7,5,2,2,"37",0,5,14,7,2,2,1037970,"2023-12-21T00:00:00.000Z",17,FALSE,22,283,"C",17,17,"Milwaukee Bucks","Brook Lopez",4,21,21,14,7,32.4
2,0,4,4,2,8,3,0,0,"29",1,1,8,5,0,0,1037970,"2023-12-21T00:00:00.000Z",17,FALSE,22,38,"G",17,17,"Milwaukee Bucks","Malik Beasley",0,13,15,10,7,17
8,0,5,8,4,17,5,10,10,"35",0,1,24,5,0,3,1037970,"2023-12-21T00:00:00.000Z",17,FALSE,22,278,"G",17,17,"Milwaukee Bucks","Damian Lillard",0,29,37,32,13,39
0,0,0,0,0,0,0,0,0,"00",0,0,0,0,0,0,1037970,"2023-12-21T00:00:00.000Z",17,FALSE,22,2148,"",17,17,"Milwaukee Bucks","Thanasis Antetokounmpo",0,0,0,0,0,0
0,0,3,2,1,3,2,0,0,"11",0,2,5,3,0,2,1037970,"2023-12-21T00:00:00.000Z",17,FALSE,22,38017676,"F",17,17,"Milwaukee Bucks","MarJon Beauchamp",0,8,8,5,3,6.6
2,0,6,3,0,6,3,2,2,"21",2,4,8,8,0,0,1037970,"2023-12-21T00:00:00.000Z",17,FALSE,22,105,"G",17,17,"Milwaukee Bucks","Pat Connaughton",0,16,18,10,10,20.6
0,0,0,0,0,0,0,0,0,"00",0,0,0,0,0,0,1037970,"2023-12-21T00:00:00.000Z",17,FALSE,22,38017733,"G",17,17,"Milwaukee Bucks","A.J. Green",0,0,0,0,0,0
0,0,0,1,0,1,0,0,0,"07",0,0,0,0,0,0,1037970,"2023-12-21T00:00:00.000Z",17,FALSE,22,56677852,"G",17,17,"Milwaukee Bucks","Andre Jackson Jr.",0,0,0,0,0,0
0,0,0,0,0,0,0,0,0,"00",0,0,0,0,0,0,1037970,"2023-12-21T00:00:00.000Z",17,FALSE,22,284,"C",17,17,"Milwaukee Bucks","Robin Lopez",0,0,0,0,0,0
4,0,1,3,0,4,1,0,0,"13",0,2,2,1,0,0,1037970,"2023-12-21T00:00:00.000Z",17,FALSE,22,368,"G",17,17,"Milwaukee Bucks","Cameron Payne",0,3,7,6,5,9.2
1,1,3,2,0,8,3,0,0,"21",5,1,6,8,1,0,1037970,"2023-12-21T00:00:00.000Z",17,FALSE,22,377,"F",17,17,"Milwaukee Bucks","Bobby Portis",2,14,15,7,9,23.1
0,0,0,0,0,0,0,0,0,"00",0,0,0,0,0,0,1037970,"2023-12-21T00:00:00.000Z",17,FALSE,22,666453,"C",17,17,"Milwaukee Bucks","Marques Bolden",0,0,0,0,0,0
0,0,0,0,0,0,0,0,0,"00",0,0,0,0,0,0,1037970,"2023-12-21T00:00:00.000Z",17,FALSE,22,112,"F",17,17,"Milwaukee Bucks","Jae Crowder",0,0,0,0,0,0
0,0,0,0,0,0,0,0,0,"00",0,0,0,0,0,0,1037970,"2023-12-21T00:00:00.000Z",17,FALSE,22,56677854,"F",17,17,"Milwaukee Bucks","Chris Livingston",0,0,0,0,0,0
2,1,3,3,0,6,2,0,0,"21",1,2,4,4,0,0,1037970,"2023-12-21T00:00:00.000Z",17,FALSE,22,85,"F",22,22,"Orlando Magic","Wendell Carter Jr.",1,8,10,6,6,14.8
5,0,1,6,2,11,5,3,2,"35",1,4,14,2,0,0,1037970,"2023-12-21T00:00:00.000Z",17,FALSE,22,196,"G",22,22,"Orlando Magic","Gary Harris",0,16,21,19,7,23.9
1,2,2,0,0,0,0,2,1,"19",0,2,1,2,1,1,1037970,"2023-12-21T00:00:00.000Z",17,FALSE,22,56677827,"G",22,22,"Orlando Magic","Anthony Black",3,3,4,2,3,12.9
2,1,5,4,1,15,10,0,0,"27",3,1,21,8,1,1,1037970,"2023-12-21T00:00:00.000Z",17,FALSE,22,462,"C",22,22,"Orlando Magic","Moritz Wagner",2,29,31,23,10,38.6
6,0,7,6,1,17,7,3,3,"33",4,2,18,11,2,0,1037970,"2023-12-21T00:00:00.000Z",17,FALSE,22,3547251,"G",22,22,"Orlando Magic","Cole Anthony",2,29,35,24,17,46.2
0,3,1,0,0,7,2,1,0,"14",3,2,4,4,1,1,1037970,"2023-12-21T00:00:00.000Z",17,FALSE,22,229,"F",22,22,"Orlando Magic","Jonathan Isaac",4,8,8,4,4,19.8
0,1,1,3,0,3,0,0,0,"18",0,2,0,1,0,0,1037970,"2023-12-21T00:00:00.000Z",17,FALSE,22,38017724,"G",22,22,"Orlando Magic","Caleb Houstan",1,1,1,0,1,4.2
0,0,0,0,0,0,0,0,0,"00",0,0,0,0,0,0,1037970,"2023-12-21T00:00:00.000Z",17,FALSE,22,666442,"C",22,22,"Orlando Magic","Goga Bitadze",0,0,0,0,0,0
0,0,0,0,0,0,0,0,0,"00",0,0,0,0,0,0,1037970,"2023-12-21T00:00:00.000Z",17,FALSE,22,666818,"F",22,22,"Orlando Magic","Chuma Okeke",0,0,0,0,0,0
0,0,0,0,0,0,0,0,0,"00",0,0,0,0,0,0,1037970,"2023-12-21T00:00:00.000Z",17,FALSE,22,666885,"F",22,22,"Orlando Magic","Admiral Schofield",0,0,0,0,0,0
0,0,0,0,0,0,0,0,0,"00",0,0,0,0,0,0,1037970,"2023-12-21T00:00:00.000Z",17,FALSE,22,165,"G",22,22,"Orlando Magic","Markelle Fultz",0,0,0,0,0,0
0,0,0,0,0,0,0,0,0,"00",0,0,0,0,0,0,1037970,"2023-12-21T00:00:00.000Z",17,FALSE,22,38017607,"G",22,22,"Orlando Magic","Kevon Harris",0,0,0,0,0,0
0,0,0,0,0,0,0,0,0,"00",0,0,0,0,0,0,1037970,"2023-12-21T00:00:00.000Z",17,FALSE,22,56677839,"G",22,22,"Orlando Magic","Jett Howard",0,0,0,0,0,0
0,0,0,0,0,0,0,0,0,"00",0,0,0,0,0,0,1037970,"2023-12-21T00:00:00.000Z",17,FALSE,22,226,"F",22,22,"Orlando Magic","Joe Ingles",0,0,0,0,0,0
0,0,0,0,0,0,0,0,0,"00",0,0,0,0,0,0,1037970,"2023-12-21T00:00:00.000Z",17,FALSE,22,17553983,"G",22,22,"Orlando Magic","Trevelin Queen",0,0,0,0,0,0
0,0,0,0,0,0,0,0,0,"00",0,0,0,0,0,0,1037970,"2023-12-21T00:00:00.000Z",17,FALSE,22,17896073,"G",22,22,"Orlando Magic","Jalen Suggs",0,0,0,0,0,0
4,1,4,8,5,14,7,3,3,"29",0,4,22,4,1,1,1037971,"2023-12-21T00:00:00.000Z",21,FALSE,13,172,"F",13,13,"LA Clippers","Paul George",2,26,30,26,8,37.8
1,0,2,4,1,7,4,0,0,"33",2,2,9,4,0,1,1037971,"2023-12-21T00:00:00.000Z",21,FALSE,13,666511,"G",13,13,"LA Clippers","Amir Coffey",0,13,14,10,5,14.3
3,0,1,0,0,4,3,0,0,"17",2,2,6,3,0,0,1037971,"2023-12-21T00:00:00.000Z",21,FALSE,13,493,"C",13,13,"LA Clippers","Ivica Zubac",0,9,12,9,6,14.1
1,1,1,4,1,8,2,0,0,"23",0,3,5,1,3,1,1037971,"2023-12-21T00:00:00.000Z",21,FALSE,13,666743,"G",13,13,"LA Clippers","Terance Mann",4,6,7,6,2,18.7
6,1,7,9,4,18,7,6,5,"34",2,1,23,9,3,3,1037971,"2023-12-21T00:00:00.000Z",21,FALSE,13,192,"G",13,13,"LA Clippers","James Harden",4,32,38,29,15,51.8
1,0,0,5,1,10,3,0,0,"16",1,1,7,1,1,0,1037971,"2023-12-21T00:00:00.000Z",21,FALSE,13,17896022,"G",13,13,"LA Clippers","Brandon Boston Jr.",1,8,9,8,2,12.7
0,0,0,2,0,3,1,0,0,"10",0,1,2,0,0,0,1037971,"2023-12-21T00:00:00.000Z",21,FALSE,13,56677849,"F",13,13,"LA Clippers","Kobe Brown",0,2,2,2,0,2
2,0,0,1,1,3,2,2,1,"10",0,0,6,0,1,1,1037971,"2023-12-21T00:00:00.000Z",21,FALSE,13,17896031,"G",13,13,"LA Clippers","Nah'Shon Hyland",1,6,8,8,2,11
1,1,3,8,4,11,6,0,0,"23",1,0,16,4,0,1,1037971,"2023-12-21T00:00:00.000Z",21,FALSE,13,380,"F-G",13,13,"LA Clippers","Norman Powell",1,20,21,17,5,24.3
0,1,1,0,0,2,2,0,0,"15",0,1,4,1,0,2,1037971,"2023-12-21T00:00:00.000Z",21,FALSE,13,439,"F",13,13,"LA Clippers","Daniel Theis",1,5,5,4,1,6.2
0,0,0,0,0,0,0,0,0,"00",0,0,0,0,0,0,1037971,"2023-12-21T00:00:00.000Z",21,FALSE,13,450,"F",13,13,"LA Clippers","PJ Tucker",0,0,0,0,0,0
4,0,9,2,0,12,7,1,1,"30",4,3,15,13,0,5,1037971,"2023-12-21T00:00:00.000Z",21,FALSE,13,472,"G",13,13,"LA Clippers","Russell Westbrook",0,28,32,19,17,31.6
0,0,0,0,0,0,0,0,0,"00",0,0,0,0,0,0,1037971,"2023-12-21T00:00:00.000Z",21,FALSE,13,38017725,"F",13,13,"LA Clippers","Moussa Diabate",0,0,0,0,0,0
0,0,0,0,0,0,0,0,0,"00",0,0,0,0,0,0,1037971,"2023-12-21T00:00:00.000Z",21,FALSE,13,274,"F",13,13,"LA Clippers","Kawhi Leonard",0,0,0,0,0,0
0,0,0,0,0,0,0,0,0,"00",0,0,0,0,0,0,1037971,"2023-12-21T00:00:00.000Z",21,FALSE,13,56677856,"G",13,13,"LA Clippers","Jordan Miller",0,0,0,0,0,0
0,0,0,0,0,0,0,0,0,"00",0,0,0,0,0,0,1037971,"2023-12-21T00:00:00.000Z",21,FALSE,13,24417679,"G",13,13,"LA Clippers","Xavier Moon",0,0,0,0,0,0
0,0,0,0,0,0,0,0,0,"00",0,0,0,0,0,0,1037971,"2023-12-21T00:00:00.000Z",21,FALSE,13,371,"F-C",13,13,"LA Clippers","Mason Plumlee",0,0,0,0,0,0
1,0,2,0,0,1,1,0,0,"06",0,0,2,2,0,0,1037971,"2023-12-21T00:00:00.000Z",21,FALSE,13,38017706,"F",21,21,"Oklahoma City Thunder","Jaylin Williams",0,4,5,3,3,5.9
3,0,2,1,1,2,2,0,0,"18",0,1,5,2,2,0,1037971,"2023-12-21T00:00:00.000Z",21,FALSE,13,480,"G-F",21,21,"Oklahoma City Thunder","Kenrich Williams",2,7,10,8,5,17.9
0,0,0,0,0,0,0,0,0,"00",0,0,0,0,0,0,1037971,"2023-12-21T00:00:00.000Z",21,FALSE,13,56677853,"F",21,21,"Oklahoma City Thunder","Keyontae Johnson",0,0,0,0,0,0
0,0,0,0,0,0,0,0,0,"00",0,0,0,0,0,0,1037971,"2023-12-21T00:00:00.000Z",21,FALSE,13,3547271,"C",21,21,"Oklahoma City Thunder","Aleksej Pokusevski",0,0,0,0,0,0
0,0,0,0,0,0,0,0,0,"00",0,0,0,0,0,0,1037971,"2023-12-21T00:00:00.000Z",21,FALSE,13,27924547,"F",21,21,"Oklahoma City Thunder","Lindy Waters III",0,0,0,0,0,0
4,1,2,6,3,12,8,2,2,"31",1,2,21,3,0,0,1037971,"2023-12-21T00:00:00.000Z",21,FALSE,13,666541,"G",21,21,"Oklahoma City Thunder","Luguentz Dort",1,24,28,25,7,33.6
7,0,3,3,1,11,6,0,0,"29",1,0,13,4,2,2,1037971,"2023-12-21T00:00:00.000Z",21,FALSE,13,38017703,"G-F",21,21,"Oklahoma City Thunder","Jalen Williams",2,17,24,20,11,32.3
7,0,6,3,2,11,9,3,3,"30",0,1,23,6,0,1,1037971,"2023-12-21T00:00:00.000Z",21,FALSE,13,38017685,"C-F",21,21,"Oklahoma City Thunder","Chet Holmgren",0,29,36,30,13,39.7
4,0,2,3,3,5,4,0,0,"14",1,0,11,3,0,5,1037971,"2023-12-21T00:00:00.000Z",21,FALSE,13,17896065,"G",21,21,"Oklahoma City Thunder","Josh Giddey",0,14,18,15,7,15.6
4,2,6,6,1,25,11,9,8,"32",2,0,31,8,4,1,1037971,"2023-12-21T00:00:00.000Z",21,FALSE,13,175,"G",21,21,"Oklahoma City Thunder","Shai Gilgeous-Alexander",6,39,43,35,12,63.6
0,0,1,1,1,2,2,2,2,"08",0,0,7,1,0,0,1037971,"2023-12-21T00:00:00.000Z",21,FALSE,13,38017716,"F",21,21,"Oklahoma City Thunder","Ousmane Dieng",0,8,8,7,1,8.2
0,1,1,7,3,8,4,0,0,"25",1,2,11,2,0,0,1037971,"2023-12-21T00:00:00.000Z",21,FALSE,13,3547272,"G",21,21,"Oklahoma City Thunder","Isaiah Joe",1,13,13,11,2,16.4
3,1,0,2,0,4,1,0,0,"20",0,2,2,0,0,1,1037971,"2023-12-21T00:00:00.000Z",21,FALSE,13,56677833,"G",21,21,"Oklahoma City Thunder","Cason Wallace",1,2,5,5,3,8.5
1,0,7,2,1,6,3,2,1,"25",0,3,8,7,1,1,1037971,"2023-12-21T00:00:00.000Z",21,FALSE,13,17896078,"G",21,21,"Oklahoma City Thunder","Aaron Wiggins",1,15,16,9,8,19.9
0,0,0,0,0,0,0,0,0,"00",0,0,0,0,0,0,1037971,"2023-12-21T00:00:00.000Z",21,FALSE,13,44,"F",21,21,"Oklahoma City Thunder","Davis Bertans",0,0,0,0,0,0
1,0,0,0,0,0,0,0,0,"02",0,0,0,0,0,0,1037971,"2023-12-21T00:00:00.000Z",21,FALSE,13,17896036,"G",21,21,"Oklahoma City Thunder","Tre Mann",0,0,1,1,1,1.5
0,0,0,0,0,0,0,0,0,"00",0,0,0,0,0,0,1037971,"2023-12-21T00:00:00.000Z",21,FALSE,13,4197029,"G",21,21,"Oklahoma City Thunder","Vasilije Micic",0,0,0,0,0,0
0,0,0,0,0,0,0,0,0,"00",0,0,0,0,0,0,1037971,"2023-12-21T00:00:00.000Z",21,FALSE,13,24572055,"C",21,21,"Oklahoma City Thunder","Olivier Sarr",0,0,0,0,0,0
0,0,0,0,0,0,0,0,0,"00",0,0,0,0,0,0,1037971,"2023-12-21T00:00:00.000Z",21,FALSE,13,17896051,"G",13,13,"LA Clippers","Joshua Primo",0,0,0,0,0,0
3,0,1,4,2,8,5,2,2,"36",0,2,14,1,1,2,1037972,"2023-12-21T00:00:00.000Z",18,FALSE,14,3547259,"F",18,18,"Minnesota Timberwolves","Jaden McDaniels",1,15,18,17,4,20.7
4,0,6,6,2,16,7,6,5,"34",0,3,21,6,1,0,1037972,"2023-12-21T00:00:00.000Z",18,FALSE,14,447,"C",18,18,"Minnesota Timberwolves","Karl-Anthony Towns",1,27,31,25,10,37.2
3,3,8,0,0,12,6,6,3,"37",5,3,15,13,1,2,1037972,"2023-12-21T00:00:00.000Z",18,FALSE,14,176,"C",18,18,"Minnesota Timberwolves","Rudy Gobert",4,28,31,18,16,45.1
5,1,7,6,2,19,9,8,7,"38",0,0,27,7,3,4,1037972,"2023-12-21T00:00:00.000Z",18,FALSE,14,3547238,"G",18,18,"Minnesota Timberwolves","Anthony Edwards",4,34,39,32,12,50.9
8,1,1,6,4,9,6,0,0,"30",0,1,16,1,2,1,1037972,"2023-12-21T00:00:00.000Z",18,FALSE,14,104,"G",18,18,"Minnesota Timberwolves","Mike Conley",3,17,25,24,9,37.2
3,0,1,5,1,6,2,0,0,"15",0,2,5,1,3,1,1037972,"2023-12-21T00:00:00.000Z",18,FALSE,14,666400,"G",18,18,"Minnesota Timberwolves","Nickeil Alexander-Walker",3,6,9,8,4,18.7
4,1,3,2,0,7,4,1,1,"23",2,0,9,5,1,1,1037972,"2023-12-21T00:00:00.000Z",18,FALSE,14,12,"F",18,18,"Minnesota Timberwolves","Kyle Anderson",2,14,18,13,9,26
0,0,1,1,0,1,0,2,2,"06",0,2,2,1,0,0,1037972,"2023-12-21T00:00:00.000Z",18,FALSE,14,68,"F",18,18,"Minnesota Timberwolves","Troy Brown Jr.",0,3,3,2,1,3.2
0,0,0,0,0,0,0,0,0,"00",0,0,0,0,0,0,1037972,"2023-12-21T00:00:00.000Z",18,FALSE,14,17896056,"C",18,18,"Minnesota Timberwolves","Luka Garza",0,0,0,0,0,0
0,0,0,0,0,0,0,0,0,"00",0,0,0,0,0,0,1037972,"2023-12-21T00:00:00.000Z",18,FALSE,14,56677782,"F",18,18,"Minnesota Timberwolves","Leonard Miller",0,0,0,0,0,0
0,0,0,0,0,0,0,0,0,"00",0,0,0,0,0,0,1037972,"2023-12-21T00:00:00.000Z",18,FALSE,14,38017715,"F",18,18,"Minnesota Timberwolves","Josh Minott",0,0,0,0,0,0
0,0,0,0,0,0,0,0,0,"00",0,0,0,0,0,0,1037972,"2023-12-21T00:00:00.000Z",18,FALSE,14,17895968,"F",18,18,"Minnesota Timberwolves","Daishen Nix",0,0,0,0,0,0
2,0,0,2,0,8,3,2,2,"37",1,1,8,1,1,1,1037972,"2023-12-21T00:00:00.000Z",18,FALSE,14,666860,"F-G",14,14,"Los Angeles Lakers","Cameron Reddish",1,9,11,10,3,14.2
0,0,4,5,2,12,7,6,2,"34",1,3,18,5,1,2,1037972,"2023-12-21T00:00:00.000Z",18,FALSE,14,666609,"F",14,14,"Los Angeles Lakers","Rui Hachimura",1,23,23,18,5,25
4,3,7,1,1,20,11,9,8,"39",1,2,31,8,0,1,1037972,"2023-12-21T00:00:00.000Z",18,FALSE,14,117,"F-C",14,14,"Los Angeles Lakers","Anthony Davis",3,39,43,35,12,54.6
1,0,5,4,4,6,5,0,0,"37",0,4,14,5,0,3,1037972,"2023-12-21T00:00:00.000Z",18,FALSE,14,383,"F",14,14,"Los Angeles Lakers","Taurean Prince",0,19,20,15,6,18.5
8,3,4,6,2,19,7,1,1,"38",0,1,17,4,2,4,1037972,"2023-12-21T00:00:00.000Z",18,FALSE,14,405,"G",14,14,"Los Angeles Lakers","D'Angelo Russell",5,21,29,25,12,44.8
5,0,5,4,1,14,7,5,5,"27",2,2,20,7,2,4,1037972,"2023-12-21T00:00:00.000Z",18,FALSE,14,17553995,"G",14,14,"Los Angeles Lakers","Austin Reaves",2,27,32,25,12,37.9
0,0,4,1,0,3,0,0,0,"14",1,3,0,5,0,0,1037972,"2023-12-21T00:00:00.000Z",18,FALSE,14,457,"F",14,14,"Los Angeles Lakers","Jarred Vanderbilt",0,5,5,0,5,6
0,0,0,0,0,0,0,0,0,"00",0,0,0,0,0,0,1037972,"2023-12-21T00:00:00.000Z",18,FALSE,14,666767,"G",18,18,"Minnesota Timberwolves","Jordan McLaughlin",0,0,0,0,0,0
0,0,0,0,0,0,0,0,0,"00",0,0,0,0,0,0,1037972,"2023-12-21T00:00:00.000Z",18,FALSE,14,320,"G",18,18,"Minnesota Timberwolves","Shake Milton",0,0,0,0,0,0
0,0,0,0,0,0,0,0,0,"00",0,0,0,0,0,0,1037972,"2023-12-21T00:00:00.000Z",18,FALSE,14,38017700,"G",18,18,"Minnesota Timberwolves","Wendell Moore Jr.",0,0,0,0,0,0
2,1,3,6,3,9,3,0,0,"21",2,6,9,5,1,3,1037972,"2023-12-21T00:00:00.000Z",18,FALSE,14,667378,"F-C",18,18,"Minnesota Timberwolves","Naz Reid",2,14,16,11,7,21
0,0,0,0,0,0,0,0,0,"00",0,0,0,0,0,0,1037972,"2023-12-21T00:00:00.000Z",18,FALSE,14,56677851,"G",18,18,"Minnesota Timberwolves","Jaylen Clark",0,0,0,0,0,0
0,0,0,0,0,0,0,0,0,"00",0,0,0,0,0,0,1037972,"2023-12-21T00:00:00.000Z",18,FALSE,14,1603383,"G",14,14,"Los Angeles Lakers","Gabe Vincent",0,0,0,0,0,0
0,0,0,0,0,0,0,0,0,"00",0,0,0,0,0,0,1037972,"2023-12-21T00:00:00.000Z",18,FALSE,14,56677836,"F",14,14,"Los Angeles Lakers","Maxwell Lewis",0,0,0,0,0,0
0,0,0,0,0,0,0,0,0,"00",0,0,0,0,0,0,1037972,"2023-12-21T00:00:00.000Z",18,FALSE,14,56677738,"C",14,14,"Los Angeles Lakers","Colin Castleton",0,0,0,0,0,0
0,0,0,0,0,0,0,0,0,"00",0,0,0,0,0,0,1037972,"2023-12-21T00:00:00.000Z",18,FALSE,14,56677867,"F",14,14,"Los Angeles Lakers","Alex Fudge",0,0,0,0,0,0
0,0,0,0,0,0,0,0,0,"00",0,0,0,0,0,0,1037972,"2023-12-21T00:00:00.000Z",18,FALSE,14,56677868,"G",14,14,"Los Angeles Lakers","D'Moi Hodge",0,0,0,0,0,0
0,0,0,0,0,0,0,0,0,"00",0,0,0,0,0,0,1037972,"2023-12-21T00:00:00.000Z",18,FALSE,14,237,"F",14,14,"Los Angeles Lakers","LeBron James",0,0,0,0,0,0
0,0,0,0,0,0,0,0,0,"03",0,0,0,0,0,1,1037972,"2023-12-21T00:00:00.000Z",18,FALSE,14,486,"F",14,14,"Los Angeles Lakers","Christian Wood",0,0,0,0,0,-1
1,0,2,0,0,1,1,1,1,"11",1,2,3,3,0,1,1037972,"2023-12-21T00:00:00.000Z",18,FALSE,14,666626,"C",14,14,"Los Angeles Lakers","Jaxson Hayes",0,6,7,4,4,7.1
0,0,0,0,0,0,0,0,0,"00",0,0,0,0,0,0,1037972,"2023-12-21T00:00:00.000Z",18,FALSE,14,38017697,"G",14,14,"Los Angeles Lakers","Max Christie",0,0,0,0,0,0
0,0,0,0,0,0,0,0,0,"00",0,0,0,0,0,0,1037972,"2023-12-21T00:00:00.000Z",18,FALSE,14,56677835,"G",14,14,"Los Angeles Lakers","Jalen Hood-Schifino",0,0,0,0,0,0
0,0,2,1,0,3,2,0,0,"18",1,3,4,3,1,0,1037973,"2023-12-21T00:00:00.000Z",25,FALSE,30,56677850,"F",25,25,"Portland Trail Blazers","Toumani Camara",1,7,7,4,3,10.6
4,0,1,7,4,14,6,7,4,"32",1,4,20,2,1,2,1037973,"2023-12-21T00:00:00.000Z",25,FALSE,30,182,"F",25,25,"Portland Trail Blazers","Jerami Grant",1,22,26,24,6,29.4
2,1,6,0,0,21,10,4,3,"35",10,3,23,16,0,5,1037973,"2023-12-21T00:00:00.000Z",25,FALSE,30,22,"C",25,25,"Portland Trail Blazers","Deandre Ayton",1,39,41,25,18,43.2
7,0,3,14,7,28,15,5,4,"38",1,2,41,4,0,3,1037973,"2023-12-21T00:00:00.000Z",25,FALSE,30,419,"G",25,25,"Portland Trail Blazers","Anfernee Simons",0,45,52,48,11,53.3
4,0,2,3,1,8,3,0,0,"28",0,3,7,2,1,1,1037973,"2023-12-21T00:00:00.000Z",25,FALSE,30,65,"G",25,25,"Portland Trail Blazers","Malcolm Brogdon",1,9,13,11,6,17.4
0,0,0,0,0,0,0,0,0,"00",0,0,0,0,0,0,1037973,"2023-12-21T00:00:00.000Z",25,FALSE,30,666476,"C",25,25,"Portland Trail Blazers","Moses Brown",0,0,0,0,0,0
1,0,1,3,1,5,2,2,0,"14",0,2,5,1,1,0,1037973,"2023-12-21T00:00:00.000Z",25,FALSE,30,337,"F-C",30,30,"Washington Wizards","Mike Muscala",1,6,7,6,2,10.7
0,0,0,0,0,0,0,0,0,"00",0,0,0,0,0,0,1037973,"2023-12-21T00:00:00.000Z",25,FALSE,30,17896106,"F",30,30,"Washington Wizards","Eugene Omoruyi",0,0,0,0,0,0
0,0,0,0,0,0,0,0,0,"00",0,0,0,0,0,0,1037973,"2023-12-21T00:00:00.000Z",25,FALSE,30,38017712,"G",30,30,"Washington Wizards","Ryan Rollins",0,0,0,0,0,0
0,0,0,0,0,0,0,0,0,"00",0,0,0,0,0,0,1037973,"2023-12-21T00:00:00.000Z",25,FALSE,30,NA,NA,NA,30,"Washington Wizards","NA NA",0,0,0,0,0,0
0,0,0,0,0,0,0,0,0,"00",0,0,0,0,0,0,1037973,"2023-12-21T00:00:00.000Z",25,FALSE,30,38017687,"G",30,30,"Washington Wizards","Johnny Davis",0,0,0,0,0,0
0,0,0,0,0,0,0,0,0,"00",0,0,0,0,0,0,1037973,"2023-12-21T00:00:00.000Z",25,FALSE,30,414,"G",30,30,"Washington Wizards","Landry Shamet",0,0,0,0,0,0
0,0,0,0,0,0,0,0,0,"00",0,0,0,0,0,0,1037973,"2023-12-21T00:00:00.000Z",25,FALSE,30,487,"G",30,30,"Washington Wizards","Delon Wright",0,0,0,0,0,0
2,0,4,0,0,5,0,4,4,"26",0,3,4,4,0,1,1037973,"2023-12-21T00:00:00.000Z",25,FALSE,30,56677747,"G",25,25,"Portland Trail Blazers","Scoot Henderson",0,8,10,6,6,10.8
0,0,0,0,0,0,0,0,0,"00",0,0,0,0,0,0,1037973,"2023-12-21T00:00:00.000Z",25,FALSE,30,3547289,"G",25,25,"Portland Trail Blazers","Skylar Mays",0,0,0,0,0,0
0,0,0,0,0,0,0,0,0,"00",0,0,0,0,0,0,1037973,"2023-12-21T00:00:00.000Z",25,FALSE,30,56677791,"F",25,25,"Portland Trail Blazers","Kris Murray",0,0,0,0,0,0
0,1,4,1,1,7,4,1,1,"10",1,4,10,5,0,1,1037973,"2023-12-21T00:00:00.000Z",25,FALSE,30,56783340,"C",25,25,"Portland Trail Blazers","Duop Reath",1,15,15,10,5,18
2,3,2,2,0,3,0,0,0,"30",2,2,0,4,3,0,1037973,"2023-12-21T00:00:00.000Z",25,FALSE,30,666923,"G-F",25,25,"Portland Trail Blazers","Matisse Thybulle",6,4,6,2,6,25.8
0,0,0,0,0,0,0,0,0,"00",0,0,0,0,0,0,1037973,"2023-12-21T00:00:00.000Z",25,FALSE,30,17896120,"F",25,25,"Portland Trail Blazers","Ish Wainright",0,0,0,0,0,0
3,1,7,2,1,6,3,2,1,"23",4,3,8,11,1,2,1037973,"2023-12-21T00:00:00.000Z",25,FALSE,30,38017711,"F",25,25,"Portland Trail Blazers","Jabari Walker",2,19,22,11,14,29.7
0,0,0,0,0,0,0,0,0,"00",0,0,0,0,0,0,1037973,"2023-12-21T00:00:00.000Z",25,FALSE,30,39613724,"C",25,25,"Portland Trail Blazers","Ibou Badji",0,0,0,0,0,0
0,0,0,0,0,0,0,0,0,"00",0,0,0,0,0,0,1037973,"2023-12-21T00:00:00.000Z",25,FALSE,30,47957121,"F",25,25,"Portland Trail Blazers","Justin Minaya",0,0,0,0,0,0
0,0,0,0,0,0,0,0,0,"00",0,0,0,0,0,0,1037973,"2023-12-21T00:00:00.000Z",25,FALSE,30,56677829,"G-F",25,25,"Portland Trail Blazers","Rayan Rupert",0,0,0,0,0,0
0,0,0,0,0,0,0,0,0,"00",0,0,0,0,0,0,1037973,"2023-12-21T00:00:00.000Z",25,FALSE,30,38017690,"G",25,25,"Portland Trail Blazers","Shaedon Sharpe",0,0,0,0,0,0
0,0,0,0,0,0,0,0,0,"00",0,0,0,0,0,0,1037973,"2023-12-21T00:00:00.000Z",25,FALSE,30,476,"C-F",25,25,"Portland Trail Blazers","Robert Williams III",0,0,0,0,0,0
6,0,9,1,0,7,4,7,5,"35",2,1,13,11,1,2,1037973,"2023-12-21T00:00:00.000Z",25,FALSE,30,3547242,"F",30,30,"Washington Wizards","Deni Avdija",1,24,30,19,17,36.2
6,0,6,7,3,22,11,10,7,"37",2,0,32,8,1,3,1037973,"2023-12-21T00:00:00.000Z",25,FALSE,30,265,"F",30,30,"Washington Wizards","Kyle Kuzma",1,40,46,38,14,50.6
0,6,5,0,0,10,7,3,2,"31",3,6,16,8,4,1,1037973,"2023-12-21T00:00:00.000Z",25,FALSE,30,666577,"F",30,30,"Washington Wizards","Daniel Gafford",10,24,24,16,8,54.6
6,0,2,4,0,13,4,5,5,"34",0,2,13,2,1,3,1037973,"2023-12-21T00:00:00.000Z",25,FALSE,30,666848,"G",30,30,"Washington Wizards","Jordan Poole",1,15,21,19,8,24.4
3,0,3,7,5,15,9,2,1,"35",0,1,24,3,1,2,1037973,"2023-12-21T00:00:00.000Z",25,FALSE,30,249,"G",30,30,"Washington Wizards","Tyus Jones",1,27,30,27,6,33.1
2,0,2,0,0,1,1,0,0,"18",0,5,2,2,0,0,1037973,"2023-12-21T00:00:00.000Z",25,FALSE,30,56677844,"G",30,30,"Washington Wizards","Bilal Coulibaly",0,4,6,4,4,7.4
2,0,0,6,2,8,3,1,1,"22",0,0,9,0,0,0,1037973,"2023-12-21T00:00:00.000Z",25,FALSE,30,17896045,"F",30,30,"Washington Wizards","Corey Kispert",0,9,11,11,2,12
0,0,2,2,1,3,1,2,1,"13",0,0,4,2,0,0,1037973,"2023-12-21T00:00:00.000Z",25,FALSE,30,167,"F",30,30,"Washington Wizards","Danilo Gallinari",0,6,6,4,2,6.4
0,0,0,0,0,0,0,0,0,"00",0,0,0,0,0,0,1037973,"2023-12-21T00:00:00.000Z",25,FALSE,30,38017704,"F",30,30,"Washington Wizards","Patrick Baldwin Jr.",0,0,0,0,0,0
0,0,0,0,0,0,0,0,0,"00",0,0,0,0,0,0,1037973,"2023-12-21T00:00:00.000Z",25,FALSE,30,18677954,"G",30,30,"Washington Wizards","Jared Butler",0,0,0,0,0,0
0,0,0,0,0,0,0,0,0,"01",0,0,0,0,0,0,1037973,"2023-12-21T00:00:00.000Z",25,FALSE,30,3547302,"F",30,30,"Washington Wizards","Anthony Gill",0,0,0,0,0,0
1,0,2,3,0,3,0,0,0,"13",1,2,0,3,0,1,1037966,"2023-12-21T00:00:00.000Z",9,FALSE,29,17896071,"F",9,9,"Detroit Pistons","Isaiah Livers",0,3,4,1,4,4.1
0,1,1,3,0,4,1,3,3,"08",0,1,5,1,0,0,1037966,"2023-12-21T00:00:00.000Z",9,FALSE,29,77,"G",9,9,"Detroit Pistons","Alec Burks",1,6,6,5,1,9.2
0,0,2,5,2,8,3,0,0,"13",1,0,8,3,0,2,1037966,"2023-12-21T00:00:00.000Z",9,FALSE,29,56677792,"G",9,9,"Detroit Pistons","Marcus Sasser",0,11,11,8,3,9.6
0,0,0,0,0,0,0,0,0,"00",0,0,0,0,0,0,1037966,"2023-12-21T00:00:00.000Z",9,FALSE,29,197,"F-G",9,9,"Detroit Pistons","Joe Harris",0,0,0,0,0,0
0,0,0,0,0,0,0,0,0,"00",0,0,0,0,0,0,1037966,"2023-12-21T00:00:00.000Z",9,FALSE,29,3547241,"G",9,9,"Detroit Pistons","Killian Hayes",0,0,0,0,0,0
0,0,0,0,0,0,0,0,0,"00",0,0,0,0,0,0,1037966,"2023-12-21T00:00:00.000Z",9,FALSE,29,259,"F",9,9,"Detroit Pistons","Kevin Knox",0,0,0,0,0,0
1,1,1,7,2,12,3,0,0,"35",0,4,8,1,0,1,1037966,"2023-12-21T00:00:00.000Z",9,FALSE,29,54,"F",9,9,"Detroit Pistons","Bojan Bogdanovic",1,9,10,9,2,12.7
4,1,7,1,1,4,3,1,0,"32",2,0,7,9,0,0,1037966,"2023-12-21T00:00:00.000Z",9,FALSE,29,3547267,"F-C",9,9,"Detroit Pistons","Isaiah Stewart",1,16,20,11,13,26.8
0,0,3,1,0,12,10,2,2,"31",2,3,22,5,0,0,1037966,"2023-12-21T00:00:00.000Z",9,FALSE,29,24,"F",9,9,"Detroit Pistons","Marvin Bagley III",0,27,27,22,5,28
7,2,3,5,2,16,9,4,4,"35",2,4,24,5,3,5,1037966,"2023-12-21T00:00:00.000Z",9,FALSE,29,38017682,"G",9,9,"Detroit Pistons","Jaden Ivey",5,29,36,31,12,50.5
10,1,6,6,2,22,10,7,6,"39",1,2,28,7,2,6,1037966,"2023-12-21T00:00:00.000Z",9,FALSE,29,17896075,"G-F",9,9,"Detroit Pistons","Cade Cunningham",3,35,45,38,17,54.4
1,2,1,0,0,3,3,2,1,"19",1,2,7,2,1,3,1037966,"2023-12-21T00:00:00.000Z",9,FALSE,29,56677826,"G-F",9,9,"Detroit Pistons","Ausar Thompson",3,9,10,8,3,16.9
0,1,3,0,0,2,1,0,0,"15",2,1,2,5,0,2,1037966,"2023-12-21T00:00:00.000Z",9,FALSE,29,3547240,"C",9,9,"Detroit Pistons","James Wiseman",1,7,7,2,5,9
0,0,0,0,0,0,0,0,0,"00",0,0,0,0,0,0,1037966,"2023-12-21T00:00:00.000Z",9,FALSE,29,44477024,"G",9,9,"Detroit Pistons","Stanley Umude",0,0,0,0,0,0
0,0,2,7,4,12,6,0,0,"29",0,1,16,2,1,0,1037966,"2023-12-21T00:00:00.000Z",9,FALSE,29,38017739,"F",29,29,"Utah Jazz","Simone Fontecchio",1,18,18,16,2,21.4
6,0,3,6,3,16,10,4,4,"35",0,2,27,3,4,4,1037966,"2023-12-21T00:00:00.000Z",9,FALSE,29,358,"F",29,29,"Utah Jazz","Kelly Olynyk",4,30,36,33,9,47.6
0,0,0,0,0,0,0,0,0,"00",0,0,0,0,0,0,1037966,"2023-12-21T00:00:00.000Z",9,FALSE,29,56677729,"G",9,9,"Detroit Pistons","Malcolm Cazalon",0,0,0,0,0,0
0,0,0,0,0,0,0,0,0,"00",0,0,0,0,0,0,1037966,"2023-12-21T00:00:00.000Z",9,FALSE,29,38017694,"C",9,9,"Detroit Pistons","Jalen Duren",0,0,0,0,0,0
0,0,0,0,0,0,0,0,0,"00",0,0,0,0,0,0,1037966,"2023-12-21T00:00:00.000Z",9,FALSE,29,330,"G",9,9,"Detroit Pistons","Monte Morris",0,0,0,0,0,0
0,0,0,0,0,0,0,0,0,"00",0,0,0,0,0,0,1037966,"2023-12-21T00:00:00.000Z",9,FALSE,29,42097199,"G",9,9,"Detroit Pistons","Jared Rhoden",0,0,0,0,0,0
1,1,7,3,0,12,4,5,5,"32",2,4,13,9,2,3,1037966,"2023-12-21T00:00:00.000Z",9,FALSE,29,101,"F-C",29,29,"Utah Jazz","John Collins",3,22,23,14,10,31.3
8,0,1,3,1,18,6,6,6,"32",3,3,19,4,4,3,1037966,"2023-12-21T00:00:00.000Z",9,FALSE,29,413,"G",29,29,"Utah Jazz","Collin Sexton",4,23,31,27,12,44.8
10,1,4,2,0,11,5,4,3,"33",1,2,13,5,2,1,1037966,"2023-12-21T00:00:00.000Z",9,FALSE,29,139,"G",29,29,"Utah Jazz","Kris Dunn",3,18,28,23,15,42
1,4,5,0,0,3,2,1,0,"20",5,1,4,10,0,1,1037966,"2023-12-21T00:00:00.000Z",9,FALSE,29,38017705,"C",29,29,"Utah Jazz","Walker Kessler",4,14,15,5,11,28.5
0,0,2,6,2,12,7,2,2,"33",0,4,18,2,2,0,1037966,"2023-12-21T00:00:00.000Z",9,FALSE,29,38017620,"G",29,29,"Utah Jazz","Ochai Agbaji",2,20,20,18,2,26.4
0,1,1,2,1,5,3,0,0,"16",3,0,7,4,0,0,1037966,"2023-12-21T00:00:00.000Z",9,FALSE,29,56677824,"F",29,29,"Utah Jazz","Taylor Hendricks",1,11,11,7,4,14.8
0,0,4,1,0,5,0,2,2,"10",1,1,2,5,0,0,1037966,"2023-12-21T00:00:00.000Z",9,FALSE,29,666881,"F",29,29,"Utah Jazz","Luka Samanic",0,7,7,2,5,8
0,0,0,0,0,0,0,0,0,"00",0,0,0,0,0,0,1037966,"2023-12-21T00:00:00.000Z",9,FALSE,29,56677834,"G",29,29,"Utah Jazz","Keyonte George",0,0,0,0,0,0
0,0,0,0,0,0,0,0,0,"00",0,0,0,0,0,0,1037966,"2023-12-21T00:00:00.000Z",9,FALSE,29,38017630,"G",29,29,"Utah Jazz","Johnny Juzang",0,0,0,0,0,0
0,0,0,0,0,0,0,0,0,"00",0,0,0,0,0,0,1037966,"2023-12-21T00:00:00.000Z",9,FALSE,29,11891374,"C",29,29,"Utah Jazz","Omer Yurtseven",0,0,0,0,0,0
0,0,0,0,0,0,0,0,0,"00",0,0,0,0,0,0,1037966,"2023-12-21T00:00:00.000Z",9,FALSE,29,17896023,"G",29,29,"Utah Jazz","Josh Christopher",0,0,0,0,0,0
0,0,0,0,0,0,0,0,0,"00",0,0,0,0,0,0,1037966,"2023-12-21T00:00:00.000Z",9,FALSE,29,100,"G",29,29,"Utah Jazz","Jordan Clarkson",0,0,0,0,0,0
0,0,0,0,0,0,0,0,0,"00",0,0,0,0,0,0,1037966,"2023-12-21T00:00:00.000Z",9,FALSE,29,666650,"G",29,29,"Utah Jazz","Talen Horton-Tucker",0,0,0,0,0,0
0,0,0,0,0,0,0,0,0,"00",0,0,0,0,0,0,1037966,"2023-12-21T00:00:00.000Z",9,FALSE,29,297,"F",29,29,"Utah Jazz","Lauri Markkanen",0,0,0,0,0,0
0,0,0,0,0,0,0,0,0,"00",0,0,0,0,0,0,1037966,"2023-12-21T00:00:00.000Z",9,FALSE,29,19465584,"F",29,29,"Utah Jazz","Micah Potter",0,0,0,0,0,0
0,0,0,0,0,0,0,0,0,"00",0,0,0,0,0,0,1037966,"2023-12-21T00:00:00.000Z",9,FALSE,29,56677842,"F",29,29,"Utah Jazz","Brice Sensabaugh",0,0,0,0,0,0
5,1,4,3,1,15,9,2,2,"36",0,1,21,4,0,0,1037968,"2023-12-21T00:00:00.000Z",5,FALSE,27,125,"G",5,5,"Chicago Bulls","DeMar DeRozan",1,25,30,26,9,36.3
2,1,4,4,2,11,7,2,2,"31",0,2,18,4,1,2,1037968,"2023-12-21T00:00:00.000Z",5,FALSE,27,3547248,"F",5,5,"Chicago Bulls","Patrick Williams",2,22,24,20,6,29.8
3,0,4,7,0,19,8,0,0,"27",1,2,16,5,1,2,1037968,"2023-12-21T00:00:00.000Z",5,FALSE,27,460,"C",5,5,"Chicago Bulls","Nikola Vucevic",1,21,24,19,8,27.5
3,0,3,0,0,6,4,0,0,"22",0,5,8,3,3,2,1037968,"2023-12-21T00:00:00.000Z",5,FALSE,27,89,"G",5,5,"Chicago Bulls","Alex Caruso",3,11,14,11,6,23.1
0,0,0,1,0,1,0,0,0,"04",0,1,0,0,0,0,1037968,"2023-12-21T00:00:00.000Z",5,FALSE,27,56677857,"F",5,5,"Chicago Bulls","Julian Phillips",0,0,0,0,0,0
0,0,0,0,0,0,0,0,0,"02",0,1,0,0,0,1,1037968,"2023-12-21T00:00:00.000Z",5,FALSE,27,17896116,"G",5,5,"Chicago Bulls","Terry Taylor",0,0,0,0,0,-1
3,0,3,2,0,2,0,2,1,"18",0,1,1,3,0,0,1037968,"2023-12-21T00:00:00.000Z",5,FALSE,27,38017719,"F",5,5,"Chicago Bulls","Dalen Terry",0,4,7,4,6,9.1
0,0,0,0,0,0,0,0,0,"00",0,0,0,0,0,0,1037968,"2023-12-21T00:00:00.000Z",5,FALSE,27,27,"G",5,5,"Chicago Bulls","Lonzo Ball",0,0,0,0,0,0
0,0,0,0,0,0,0,0,0,"00",0,0,0,0,0,0,1037968,"2023-12-21T00:00:00.000Z",5,FALSE,27,56677874,"F",5,5,"Chicago Bulls","Onuralp Bitim",0,0,0,0,0,0
0,0,0,0,0,0,0,0,0,"00",0,0,0,0,0,0,1037968,"2023-12-21T00:00:00.000Z",5,FALSE,27,NA,NA,NA,5,"Chicago Bulls","NA NA",0,0,0,0,0,0
0,0,0,0,0,0,0,0,0,"00",0,0,0,0,0,0,1037968,"2023-12-21T00:00:00.000Z",5,FALSE,27,268,"G",5,5,"Chicago Bulls","Zach LaVine",0,0,0,0,0,0
0,0,0,0,0,0,0,0,0,"00",0,0,0,0,0,0,1037968,"2023-12-21T00:00:00.000Z",5,FALSE,27,56677860,"F",5,5,"Chicago Bulls","Adama Sanogo",0,0,0,0,0,0
2,0,3,8,3,15,7,4,4,"31",1,0,21,4,1,1,1037968,"2023-12-21T00:00:00.000Z",5,FALSE,27,3547246,"G-F",27,27,"San Antonio Spurs","Devin Vassell",1,25,27,23,6,30.8
2,0,4,2,0,13,5,3,1,"32",2,3,11,6,0,3,1037968,"2023-12-21T00:00:00.000Z",5,FALSE,27,666682,"F",27,27,"San Antonio Spurs","Keldon Johnson",0,17,19,13,8,18.2
5,3,5,1,0,8,3,3,1,"22",0,0,7,5,2,2,1037968,"2023-12-21T00:00:00.000Z",5,FALSE,27,56677822,"F-C",27,27,"San Antonio Spurs","Victor Wembanyama",5,12,17,12,10,33.5
2,0,6,4,1,11,6,0,0,"29",0,1,13,6,0,3,1037968,"2023-12-21T00:00:00.000Z",5,FALSE,27,38017692,"F",27,27,"San Antonio Spurs","Malaki Branham",0,19,21,15,8,20.2
2,0,0,0,0,1,1,2,1,"03",0,0,3,0,0,0,1037968,"2023-12-21T00:00:00.000Z",5,FALSE,27,38017693,"G",27,27,"San Antonio Spurs","Blake Wesley",0,3,5,5,2,6
0,0,0,0,0,0,0,0,0,"00",0,0,0,0,0,0,1037968,"2023-12-21T00:00:00.000Z",5,FALSE,27,38017730,"F",27,27,"San Antonio Spurs","Dominick Barlow",0,0,0,0,0,0
0,0,0,0,0,0,0,0,0,"00",0,0,0,0,0,0,1037968,"2023-12-21T00:00:00.000Z",5,FALSE,27,17895854,"G",27,27,"San Antonio Spurs","Charles Bassey",0,0,0,0,0,0
0,0,0,0,0,0,0,0,0,"00",0,0,0,0,0,0,1037968,"2023-12-21T00:00:00.000Z",5,FALSE,27,56677865,"C",27,27,"San Antonio Spurs","Charles Bediako",0,0,0,0,0,0
0,0,0,0,0,0,0,0,0,"00",0,0,0,0,0,0,1037968,"2023-12-21T00:00:00.000Z",5,FALSE,27,17896049,"G",3,27,"San Antonio Spurs","David Duke Jr.",0,0,0,0,0,0
5,0,6,6,2,15,10,0,0,"36",0,2,22,6,0,3,1037968,"2023-12-21T00:00:00.000Z",5,FALSE,27,666956,"G",5,5,"Chicago Bulls","Coby White",0,28,33,27,11,33.7
0,0,2,4,1,8,5,0,0,"26",0,2,11,2,1,0,1037968,"2023-12-21T00:00:00.000Z",5,FALSE,27,17895983,"G",5,5,"Chicago Bulls","Ayo Dosunmu",1,13,13,11,2,16.4
1,2,4,0,0,10,5,3,2,"19",4,0,12,8,5,1,1037968,"2023-12-21T00:00:00.000Z",5,FALSE,27,137,"C",5,5,"Chicago Bulls","Andre Drummond",7,20,21,13,9,43.1
2,1,1,1,1,3,1,2,2,"19",0,1,5,1,0,0,1037968,"2023-12-21T00:00:00.000Z",5,FALSE,27,87,"G",5,5,"Chicago Bulls","Jevon Carter",1,6,8,7,3,12.2
0,0,0,0,0,0,0,0,0,"00",0,0,0,0,0,0,1037968,"2023-12-21T00:00:00.000Z",5,FALSE,27,110,"F",5,5,"Chicago Bulls","Torrey Craig",0,0,0,0,0,0
2,0,4,2,1,8,4,0,0,"34",3,0,9,7,1,1,1037968,"2023-12-21T00:00:00.000Z",5,FALSE,27,38017699,"F",27,27,"San Antonio Spurs","Jeremy Sochan",1,16,18,11,9,22.4
2,3,6,4,2,10,5,2,2,"28",3,2,14,9,0,1,1037968,"2023-12-21T00:00:00.000Z",5,FALSE,27,102,"F-C",27,27,"San Antonio Spurs","Zach Collins",3,23,25,16,11,35.8
2,0,1,1,1,6,4,0,0,"21",0,0,9,1,1,5,1037968,"2023-12-21T00:00:00.000Z",5,FALSE,27,3547274,"G",27,27,"San Antonio Spurs","Tre Jones",1,10,12,11,3,11.2
3,0,1,3,0,4,0,2,2,"11",0,1,2,1,0,2,1037968,"2023-12-21T00:00:00.000Z",5,FALSE,27,359,"F",27,27,"San Antonio Spurs","Cedi Osman",0,3,6,5,4,5.7
1,0,0,4,1,4,1,0,0,"12",0,3,3,0,1,0,1037968,"2023-12-21T00:00:00.000Z",5,FALSE,27,305,"F",27,27,"San Antonio Spurs","Doug McDermott",1,3,4,4,1,7.5
1,1,1,1,1,1,1,0,0,"11",0,1,3,1,0,1,1037968,"2023-12-21T00:00:00.000Z",5,FALSE,27,38017649,"F",27,27,"San Antonio Spurs","Julian Champagnie",1,4,5,4,2,7.7
0,0,0,0,0,0,0,0,0,"03",0,0,0,0,0,0,1037968,"2023-12-21T00:00:00.000Z",5,FALSE,27,56677817,"G",27,27,"San Antonio Spurs","Sidy Cissoko",0,0,0,0,0,0
0,0,0,0,0,0,0,0,0,"00",0,0,0,0,0,0,1037968,"2023-12-21T00:00:00.000Z",5,FALSE,27,180,"G",27,27,"San Antonio Spurs","Devonte' Graham",0,0,0,0,0,0
0,0,1,0,0,0,0,0,0,"03",0,0,0,1,0,0,1037968,"2023-12-21T00:00:00.000Z",5,FALSE,27,17896059,"F",27,27,"San Antonio Spurs","Sandro Mamukelashvili",0,1,1,0,1,1.2
1,0,3,5,2,9,4,0,0,"21",0,2,10,3,0,2,1037977,"2023-12-22T00:00:00.000Z",11,FALSE,7,66,"G-F",11,11,"Houston Rockets","Dillon Brooks",0,13,14,11,4,13.1
1,0,6,3,1,13,8,5,4,"31",2,0,21,8,0,1,1037977,"2023-12-22T00:00:00.000Z",11,FALSE,7,38017684,"F",11,11,"Houston Rockets","Jabari Smith Jr.",0,29,30,22,9,31.1
3,0,13,1,1,12,8,5,5,"25",2,2,22,15,0,0,1037977,"2023-12-22T00:00:00.000Z",11,FALSE,7,17896062,"F-C",11,11,"Houston Rockets","Alperen Sengun",0,37,40,25,18,44.5
4,0,5,7,3,14,5,4,4,"27",1,2,17,6,2,4,1037977,"2023-12-22T00:00:00.000Z",11,FALSE,7,17895966,"G",11,11,"Houston Rockets","Jalen Green",2,23,27,21,10,32.2
4,0,2,5,1,8,3,3,3,"26",0,2,10,2,1,0,1037977,"2023-12-22T00:00:00.000Z",11,FALSE,7,458,"G",11,11,"Houston Rockets","Fred VanVleet",1,12,16,14,6,21.4
0,2,1,0,0,2,1,0,0,"08",0,0,2,1,0,0,1037977,"2023-12-22T00:00:00.000Z",11,FALSE,7,188,"F",11,11,"Houston Rockets","Jeff Green",2,3,3,2,1,9.2
1,0,1,2,1,3,1,0,0,"10",1,3,3,2,0,1,1037977,"2023-12-22T00:00:00.000Z",11,FALSE,7,3547281,"G-F",11,11,"Houston Rockets","Nate Hinton",0,5,6,4,3,5.9
0,0,3,3,1,3,1,0,0,"15",0,0,3,3,0,2,1037977,"2023-12-22T00:00:00.000Z",11,FALSE,7,213,"G",11,11,"Houston Rockets","Aaron Holiday",0,6,6,3,3,4.6
2,1,1,3,0,5,1,2,1,"15",3,1,3,4,0,0,1037977,"2023-12-22T00:00:00.000Z",11,FALSE,7,19465326,"C",11,11,"Houston Rockets","Jock Landale",1,7,9,5,6,13.8
0,0,0,0,0,0,0,0,0,"00",0,0,0,0,0,0,1037977,"2023-12-22T00:00:00.000Z",11,FALSE,7,296,"C",11,11,"Houston Rockets","Boban Marjanovic",0,0,0,0,0,0
0,0,1,0,0,3,3,0,0,"09",0,0,6,1,1,0,1037977,"2023-12-22T00:00:00.000Z",11,FALSE,7,56677809,"F",11,11,"Houston Rockets","Jermaine Samuels Jr.",1,7,7,6,1,10.2
1,0,7,1,0,2,1,0,0,"17",1,4,2,8,0,3,1037977,"2023-12-22T00:00:00.000Z",11,FALSE,7,3547301,"F",11,11,"Houston Rockets","Jae'Sean Tate",0,10,11,3,9,10.1
4,0,6,2,0,9,4,2,1,"22",0,4,9,6,1,3,1037977,"2023-12-22T00:00:00.000Z",11,FALSE,7,56677825,"G-F",11,11,"Houston Rockets","Amen Thompson",1,15,19,13,10,22.2
0,0,2,6,1,12,6,2,1,"14",2,2,14,4,2,0,1037977,"2023-12-22T00:00:00.000Z",11,FALSE,7,56677831,"F",11,11,"Houston Rockets","Cam Whitmore",2,18,18,14,4,24.8
0,0,0,0,0,0,0,0,0,"00",0,0,0,0,0,0,1037977,"2023-12-22T00:00:00.000Z",11,FALSE,7,75,"G-F",11,11,"Houston Rockets","Reggie Bullock",0,0,0,0,0,0
0,0,0,0,0,0,0,0,0,"00",0,0,0,0,0,0,1037977,"2023-12-22T00:00:00.000Z",11,FALSE,7,38017695,"F",11,11,"Houston Rockets","Tari Eason",0,0,0,0,0,0
0,0,0,0,0,0,0,0,0,"00",0,0,0,0,0,0,1037977,"2023-12-22T00:00:00.000Z",11,FALSE,7,357,"G",11,11,"Houston Rockets","Victor Oladipo",0,0,0,0,0,0
4,0,2,12,2,17,3,0,0,"24",0,5,8,2,0,0,1037977,"2023-12-22T00:00:00.000Z",11,FALSE,7,38017679,"G",7,7,"Dallas Mavericks","Jaden Hardy",0,10,14,12,6,16.4
1,0,2,8,2,20,6,2,2,"26",1,0,16,3,0,1,1037977,"2023-12-22T00:00:00.000Z",11,FALSE,7,191,"G",7,7,"Dallas Mavericks","Tim Hardaway Jr.",0,19,20,17,4,20.1
2,0,4,1,0,3,0,4,3,"12",1,1,3,5,0,0,1037977,"2023-12-22T00:00:00.000Z",11,FALSE,7,17896028,"F",7,7,"Dallas Mavericks","Greg Brown III",0,8,10,5,7,12
0,0,2,2,0,7,0,0,0,"18",0,1,0,2,2,2,1037977,"2023-12-22T00:00:00.000Z",11,FALSE,7,114,"G",7,7,"Dallas Mavericks","Seth Curry",2,2,2,0,2,6.4
4,0,5,3,1,11,8,2,1,"17",0,0,18,5,0,0,1037977,"2023-12-22T00:00:00.000Z",11,FALSE,7,56677873,"G",7,7,"Dallas Mavericks","Dexter Dennis",0,23,27,22,9,30
1,0,3,0,0,12,7,3,2,"22",5,2,16,8,1,1,1037977,"2023-12-22T00:00:00.000Z",11,FALSE,7,217,"F-C",7,7,"Dallas Mavericks","Richaun Holmes",1,24,25,17,9,29.1
1,0,2,1,0,4,3,2,2,"23",0,0,8,2,4,3,1037977,"2023-12-22T00:00:00.000Z",11,FALSE,7,17554004,"G",7,7,"Dallas Mavericks","AJ Lawson",4,10,11,9,3,20.9
0,0,4,1,0,1,0,0,0,"08",0,1,0,4,0,0,1037977,"2023-12-22T00:00:00.000Z",11,FALSE,7,379,"F-C",7,7,"Dallas Mavericks","Dwight Powell",0,4,4,0,4,4.8
2,0,1,4,1,13,6,9,7,"30",5,2,20,6,1,3,1037977,"2023-12-22T00:00:00.000Z",11,FALSE,7,56677859,"F",7,7,"Dallas Mavericks","Olivier-Maxence Prosper",1,26,28,22,8,30.2
0,0,0,0,0,0,0,0,0,"00",0,0,0,0,0,0,1037977,"2023-12-22T00:00:00.000Z",11,FALSE,7,132,"F-G",7,7,"Dallas Mavericks","Luka Doncic",0,0,0,0,0,0
0,0,0,0,0,0,0,0,0,"00",0,0,0,0,0,0,1037977,"2023-12-22T00:00:00.000Z",11,FALSE,7,151,"G",7,7,"Dallas Mavericks","Dante Exum",0,0,0,0,0,0
0,0,0,0,0,0,0,0,0,"00",0,0,0,0,0,0,1037977,"2023-12-22T00:00:00.000Z",11,FALSE,7,3547258,"G",7,7,"Dallas Mavericks","Josh Green",0,0,0,0,0,0
0,0,0,0,0,0,0,0,0,"00",0,0,0,0,0,0,1037977,"2023-12-22T00:00:00.000Z",11,FALSE,7,228,"G",7,7,"Dallas Mavericks","Kyrie Irving",0,0,0,0,0,0
0,0,0,0,0,0,0,0,0,"00",0,0,0,0,0,0,1037977,"2023-12-22T00:00:00.000Z",11,FALSE,7,257,"F",7,7,"Dallas Mavericks","Maxi Kleber",0,0,0,0,0,0
0,0,0,0,0,0,0,0,0,"00",0,0,0,0,0,0,1037977,"2023-12-22T00:00:00.000Z",11,FALSE,7,56677840,"C",7,7,"Dallas Mavericks","Dereck Lively II",0,0,0,0,0,0
0,0,0,0,0,0,0,0,0,"00",0,0,0,0,0,0,1037977,"2023-12-22T00:00:00.000Z",11,FALSE,7,47738533,"G",11,11,"Houston Rockets","Jeenathan Williams",0,0,0,0,0,0
1,0,2,1,0,4,1,2,1,"22",2,3,3,4,0,1,1037977,"2023-12-22T00:00:00.000Z",11,FALSE,7,247,"F-G",7,7,"Dallas Mavericks","Derrick Jones Jr.",0,7,8,4,5,8.3
2,1,4,3,0,5,0,0,0,"26",0,2,0,4,2,0,1037977,"2023-12-22T00:00:00.000Z",11,FALSE,7,666965,"F",7,7,"Dallas Mavericks","Grant Williams",3,4,6,2,6,16.8
0,0,2,4,1,4,1,2,1,"12",0,0,4,2,0,0,1037977,"2023-12-22T00:00:00.000Z",11,FALSE,7,329,"F",7,7,"Dallas Mavericks","Markieff Morris",0,6,6,4,2,6.4
5,0,3,2,1,3,2,2,2,"30",1,3,7,4,0,0,1037974,"2023-12-22T00:00:00.000Z",23,FALSE,28,328,"F",23,23,"Philadelphia 76ers","Marcus Morris",0,11,16,12,9,19.3
7,0,8,9,5,23,12,4,4,"38",0,2,33,8,1,2,1037974,"2023-12-22T00:00:00.000Z",23,FALSE,28,200,"F",23,23,"Philadelphia 76ers","Tobias Harris",1,41,48,40,15,54.1
9,4,9,2,2,21,11,8,7,"35",1,1,31,10,2,6,1037974,"2023-12-22T00:00:00.000Z",23,FALSE,28,145,"F-C",23,23,"Philadelphia 76ers","Joel Embiid",6,41,50,40,19,68.5
0,0,3,6,2,9,3,0,0,"26",0,4,8,3,1,0,1037974,"2023-12-22T00:00:00.000Z",23,FALSE,28,360,"F",23,23,"Philadelphia 76ers","Kelly Oubre Jr.",1,11,11,8,3,14.6
10,0,4,10,4,22,13,3,3,"41",0,3,33,4,0,3,1037974,"2023-12-22T00:00:00.000Z",23,FALSE,28,3547254,"G",23,23,"Philadelphia 76ers","Tyrese Maxey",0,37,47,43,14,49.8
0,0,0,0,0,0,0,0,0,"00",0,0,0,0,0,0,1037974,"2023-12-22T00:00:00.000Z",23,FALSE,28,45,"G",23,23,"Philadelphia 76ers","Patrick Beverley",0,0,0,0,0,0
2,1,3,1,0,1,0,0,0,"24",0,4,0,3,1,0,1037974,"2023-12-22T00:00:00.000Z",23,FALSE,28,108,"F",23,23,"Philadelphia 76ers","Robert Covington",2,3,5,2,5,12.6
1,0,1,0,0,1,1,2,1,"23",0,2,3,1,0,2,1037974,"2023-12-22T00:00:00.000Z",23,FALSE,28,2175,"",23,23,"Philadelphia 76ers","Danuel House Jr.",0,4,5,4,2,3.7
0,0,1,0,0,1,1,0,0,"07",0,0,2,1,0,0,1037974,"2023-12-22T00:00:00.000Z",23,FALSE,28,260,"G-F",23,23,"Philadelphia 76ers","Furkan Korkmaz",0,3,3,2,1,3.2
0,0,0,0,0,0,0,0,0,"01",0,0,0,0,0,0,1037974,"2023-12-22T00:00:00.000Z",23,FALSE,28,3547294,"F",23,23,"Philadelphia 76ers","Kenyon Martin Jr.",0,0,0,0,0,0
0,0,0,0,0,0,0,0,0,"00",0,0,0,0,0,0,1037974,"2023-12-22T00:00:00.000Z",23,FALSE,28,313,"G",23,23,"Philadelphia 76ers","De'Anthony Melton",0,0,0,0,0,0
0,1,3,1,0,2,1,2,2,"13",1,2,4,4,1,0,1037974,"2023-12-22T00:00:00.000Z",23,FALSE,28,3547270,"F",23,23,"Philadelphia 76ers","Paul Reed",2,8,8,4,4,14.8
0,0,0,0,0,0,0,0,0,"01",0,0,0,0,0,0,1037974,"2023-12-22T00:00:00.000Z",23,FALSE,28,17554001,"G",23,23,"Philadelphia 76ers","Javonte Smart",0,0,0,0,0,0
0,0,0,0,0,0,0,0,0,"01",0,0,0,0,0,0,1037974,"2023-12-22T00:00:00.000Z",23,FALSE,28,17896025,"G",23,23,"Philadelphia 76ers","Jaden Springer",0,0,0,0,0,0
0,0,0,0,0,0,0,0,0,"00",0,0,0,0,0,0,1037974,"2023-12-22T00:00:00.000Z",23,FALSE,28,28,"C",23,23,"Philadelphia 76ers","Mo Bamba",0,0,0,0,0,0
0,0,0,0,0,0,0,0,0,"00",0,0,0,0,0,0,1037974,"2023-12-22T00:00:00.000Z",23,FALSE,28,33,"F-G",23,23,"Philadelphia 76ers","Nicolas Batum",0,0,0,0,0,0
0,0,0,0,0,0,0,0,0,"00",0,0,0,0,0,0,1037974,"2023-12-22T00:00:00.000Z",23,FALSE,28,56913527,"G",23,23,"Philadelphia 76ers","Ricky Council IV",0,0,0,0,0,0
0,0,0,0,0,0,0,0,0,"00",0,0,0,0,0,0,1037974,"2023-12-22T00:00:00.000Z",23,FALSE,28,56677788,"G",23,23,"Philadelphia 76ers","Terquavion Smith",0,0,0,0,0,0
8,4,6,7,2,11,3,4,4,"35",1,0,12,7,1,3,1037974,"2023-12-22T00:00:00.000Z",23,FALSE,28,17896055,"G-F",28,28,"Toronto Raptors","Scottie Barnes",5,19,27,20,15,44.4
5,1,4,4,0,16,10,12,11,"36",1,1,31,5,0,2,1037974,"2023-12-22T00:00:00.000Z",23,FALSE,28,416,"F",28,28,"Toronto Raptors","Pascal Siakam",1,36,41,36,10,45.5
2,0,6,0,0,15,9,2,1,"29",2,3,19,8,1,1,1037974,"2023-12-22T00:00:00.000Z",23,FALSE,28,373,"C",28,28,"Toronto Raptors","Jakob Poeltl",1,27,29,21,10,33.6
5,0,4,4,0,9,4,4,4,"35",0,4,12,4,1,2,1037974,"2023-12-22T00:00:00.000Z",23,FALSE,28,18,"F",28,28,"Toronto Raptors","OG Anunoby",1,16,21,17,9,25.3
6,0,2,2,0,8,2,2,2,"34",1,0,6,3,2,0,1037974,"2023-12-22T00:00:00.000Z",23,FALSE,28,409,"G",28,28,"Toronto Raptors","Dennis Schroder",2,9,15,12,9,24.6
1,0,3,2,0,9,2,2,0,"16",3,2,4,6,2,1,1037974,"2023-12-22T00:00:00.000Z",23,FALSE,28,3547249,"F",28,28,"Toronto Raptors","Precious Achiuwa",2,10,11,5,7,17.7
0,0,0,0,0,0,0,0,0,"00",0,0,0,0,0,0,1037974,"2023-12-22T00:00:00.000Z",23,FALSE,28,58,"F",28,28,"Toronto Raptors","Chris Boucher",0,0,0,0,0,0
0,0,0,0,0,0,0,0,0,"02",0,0,0,0,1,0,1037974,"2023-12-22T00:00:00.000Z",23,FALSE,28,56677828,"G",28,28,"Toronto Raptors","Gradey Dick",1,0,0,0,0,3
2,1,2,2,0,4,1,0,0,"10",2,0,2,4,0,3,1037974,"2023-12-22T00:00:00.000Z",23,FALSE,28,3547275,"G",28,28,"Toronto Raptors","Malachi Flynn",1,6,8,4,6,9.8
0,0,2,1,1,1,1,0,0,"02",0,0,3,2,0,0,1037974,"2023-12-22T00:00:00.000Z",23,FALSE,28,666762,"F",28,28,"Toronto Raptors","Jalen McDaniels",0,5,5,3,2,5.4
0,0,3,3,1,3,1,2,2,"15",0,3,5,3,0,0,1037974,"2023-12-22T00:00:00.000Z",23,FALSE,28,376,"F",28,28,"Toronto Raptors","Otto Porter Jr.",0,8,8,5,3,8.6
0,0,0,0,0,0,0,0,0,"00",0,0,0,0,0,0,1037974,"2023-12-22T00:00:00.000Z",23,FALSE,28,436,"G-F",28,28,"Toronto Raptors","Garrett Temple",0,0,0,0,0,0
1,0,3,8,5,11,6,0,0,"26",1,3,17,4,1,0,1037974,"2023-12-22T00:00:00.000Z",23,FALSE,28,3089,"",28,28,"Toronto Raptors","Gary Trent Jr.",1,21,22,18,5,26.3
0,0,0,0,0,0,0,0,0,"00",0,0,0,0,0,0,1037974,"2023-12-22T00:00:00.000Z",23,FALSE,28,489,"F",28,28,"Toronto Raptors","Thaddeus Young",0,0,0,0,0,0
0,0,0,0,0,0,0,0,0,"00",0,0,0,0,0,0,1037974,"2023-12-22T00:00:00.000Z",23,FALSE,28,56677805,"G",28,28,"Toronto Raptors","Javon Freeman-Liberty",0,0,0,0,0,0
0,0,0,0,0,0,0,0,0,"00",0,0,0,0,0,0,1037974,"2023-12-22T00:00:00.000Z",23,FALSE,28,38017710,"C",28,28,"Toronto Raptors","Christian Koloko",0,0,0,0,0,0
0,0,0,0,0,0,0,0,0,"00",0,0,0,0,0,0,1037974,"2023-12-22T00:00:00.000Z",23,FALSE,28,56677869,"G",28,28,"Toronto Raptors","Markquis Nowell",0,0,0,0,0,0
0,0,0,0,0,0,0,0,0,"00",0,0,0,0,0,0,1037974,"2023-12-22T00:00:00.000Z",23,FALSE,28,2309958,"C-F",15,28,"Toronto Raptors","Jontay Porter",0,0,0,0,0,0
6,0,1,3,0,16,7,1,0,"29",2,2,14,3,0,3,1037975,"2023-12-22T00:00:00.000Z",3,FALSE,8,61,"F",3,3,"Brooklyn Nets","Mikal Bridges",0,17,23,20,9,23.6
2,0,1,6,3,9,6,3,2,"26",0,2,17,1,1,1,1037975,"2023-12-22T00:00:00.000Z",3,FALSE,8,666679,"F",3,3,"Brooklyn Nets","Cameron Johnson",1,18,20,19,3,23.2
6,3,15,0,0,8,4,4,2,"28",1,1,10,16,0,1,1037975,"2023-12-22T00:00:00.000Z",3,FALSE,8,666508,"F-C",3,3,"Brooklyn Nets","Nicolas Claxton",3,26,32,16,22,46.2
2,0,0,6,1,21,8,6,6,"34",0,5,23,0,0,2,1037975,"2023-12-22T00:00:00.000Z",3,FALSE,8,17896048,"G",3,3,"Brooklyn Nets","Cam Thomas",0,23,25,25,2,24
3,0,0,4,2,4,2,0,0,"33",1,3,6,1,0,1,1037975,"2023-12-22T00:00:00.000Z",3,FALSE,8,130,"G",3,3,"Brooklyn Nets","Spencer Dinwiddie",0,7,10,9,4,10.7
1,0,2,5,4,9,5,0,0,"30",2,2,14,4,0,1,1037975,"2023-12-22T00:00:00.000Z",3,FALSE,8,158,"F",3,3,"Brooklyn Nets","Dorian Finney-Smith",0,18,19,15,5,19.3
0,0,0,0,0,0,0,0,0,"00",0,0,0,0,0,0,1037975,"2023-12-22T00:00:00.000Z",3,FALSE,8,174,"F-C",3,3,"Brooklyn Nets","Harry Giles III",0,0,0,0,0,0
3,2,4,5,2,7,4,4,3,"22",2,1,13,6,0,1,1037975,"2023-12-22T00:00:00.000Z",3,FALSE,8,351,"F",3,3,"Brooklyn Nets","Royce O'Neale",2,19,22,16,9,29.7
4,2,5,0,0,8,5,6,3,"19",5,2,13,10,2,0,1037975,"2023-12-22T00:00:00.000Z",3,FALSE,8,17896038,"C",3,3,"Brooklyn Nets","Day'Ron Sharpe",4,23,27,17,14,43
5,0,3,4,1,7,2,2,2,"19",1,5,7,4,1,0,1037975,"2023-12-22T00:00:00.000Z",3,FALSE,8,421,"G",3,3,"Brooklyn Nets","Dennis Smith Jr.",1,11,16,12,9,22.3
0,0,0,0,0,0,0,0,0,"00",0,0,0,0,0,0,1037975,"2023-12-22T00:00:00.000Z",3,FALSE,8,17896058,"F",3,3,"Brooklyn Nets","Trendon Watford",0,0,0,0,0,0
0,0,0,0,0,0,0,0,0,"00",0,0,0,0,0,0,1037975,"2023-12-22T00:00:00.000Z",3,FALSE,8,56677722,"F",3,3,"Brooklyn Nets","Jalen Wilson",0,0,0,0,0,0
0,0,0,0,0,0,0,0,0,"00",0,0,0,0,0,0,1037975,"2023-12-22T00:00:00.000Z",3,FALSE,8,9051997,"G",3,3,"Brooklyn Nets","Armoni Brooks",0,0,0,0,0,0
0,0,0,0,0,0,0,0,0,"00",0,0,0,0,0,0,1037975,"2023-12-22T00:00:00.000Z",3,FALSE,8,56677843,"F",3,3,"Brooklyn Nets","Noah Clowney",0,0,0,0,0,0
9,2,4,6,4,19,11,8,6,"34",1,0,32,5,0,1,1037975,"2023-12-22T00:00:00.000Z",3,FALSE,8,335,"G",8,8,"Denver Nuggets","Jamal Murray",2,37,46,41,14,56.5
1,0,0,1,0,3,0,2,2,"16",0,1,2,0,0,0,1037975,"2023-12-22T00:00:00.000Z",3,FALSE,8,38017709,"G",8,8,"Denver Nuggets","Christian Braun",0,2,3,3,1,3.5
0,0,0,0,0,0,0,0,0,"00",0,0,0,0,0,0,1037975,"2023-12-22T00:00:00.000Z",3,FALSE,8,215,"F-G",8,8,"Denver Nuggets","Justin Holiday",0,0,0,0,0,0
3,0,2,5,0,13,4,0,0,"16",0,4,8,2,0,1,1037975,"2023-12-22T00:00:00.000Z",3,FALSE,8,236,"G",8,8,"Denver Nuggets","Reggie Jackson",0,10,13,11,5,13.9
0,0,0,0,0,1,1,0,0,"06",0,0,2,0,0,0,1037975,"2023-12-22T00:00:00.000Z",3,FALSE,8,250,"C",8,8,"Denver Nuggets","DeAndre Jordan",0,2,2,2,0,2
0,0,0,0,0,0,0,0,0,"00",0,0,0,0,0,0,1037975,"2023-12-22T00:00:00.000Z",3,FALSE,8,17896007,"G",8,8,"Denver Nuggets","Braxton Key",0,0,0,0,0,0
0,0,2,0,0,2,1,0,0,"07",1,2,2,3,0,0,1037975,"2023-12-22T00:00:00.000Z",3,FALSE,8,3547268,"F-C",8,8,"Denver Nuggets","Zeke Nnaji",0,5,5,2,3,5.6
0,0,0,0,0,0,0,0,0,"00",0,0,0,0,0,0,1037975,"2023-12-22T00:00:00.000Z",3,FALSE,8,56677582,"G",8,8,"Denver Nuggets","Jalen Pickett",0,0,0,0,0,0
0,0,2,3,0,5,0,0,0,"11",1,1,0,3,0,1,1037975,"2023-12-22T00:00:00.000Z",3,FALSE,8,56677776,"G",8,8,"Denver Nuggets","Julian Strawther",0,3,3,0,3,2.6
0,0,0,0,0,0,0,0,0,"00",0,0,0,0,0,0,1037975,"2023-12-22T00:00:00.000Z",3,FALSE,8,56677871,"F",8,8,"Denver Nuggets","Hunter Tyson",0,0,0,0,0,0
0,0,3,2,1,5,4,1,0,"20",0,2,9,3,0,0,1037975,"2023-12-22T00:00:00.000Z",3,FALSE,8,38017721,"G",8,8,"Denver Nuggets","Peyton Watson",0,12,12,9,3,12.6
0,0,0,0,0,0,0,0,0,"00",0,0,0,0,0,0,1037975,"2023-12-22T00:00:00.000Z",3,FALSE,8,666489,"F",8,8,"Denver Nuggets","Vlatko Cancar",0,0,0,0,0,0
0,0,0,0,0,0,0,0,0,"00",0,0,0,0,0,0,1037975,"2023-12-22T00:00:00.000Z",3,FALSE,8,17896041,"G",3,3,"Brooklyn Nets","Keon Johnson",0,0,0,0,0,0
0,0,0,0,0,0,0,0,0,"00",0,0,0,0,0,0,1037975,"2023-12-22T00:00:00.000Z",3,FALSE,8,417,"G-F",3,3,"Brooklyn Nets","Ben Simmons",0,0,0,0,0,0
0,0,0,0,0,0,0,0,0,"00",0,0,0,0,0,0,1037975,"2023-12-22T00:00:00.000Z",3,FALSE,8,464,"G",3,3,"Brooklyn Nets","Lonnie Walker IV",0,0,0,0,0,0
0,0,0,0,0,0,0,0,0,"00",0,0,0,0,0,0,1037975,"2023-12-22T00:00:00.000Z",3,FALSE,8,56677841,"F",3,3,"Brooklyn Nets","Dariq Whitehead",0,0,0,0,0,0
3,1,4,5,3,10,6,0,0,"34",0,1,15,4,0,1,1037975,"2023-12-22T00:00:00.000Z",3,FALSE,8,375,"F",8,8,"Denver Nuggets","Michael Porter Jr.",1,19,22,18,7,26.3
2,0,3,0,0,6,5,9,8,"32",2,1,18,5,1,1,1037975,"2023-12-22T00:00:00.000Z",3,FALSE,8,177,"F",8,8,"Denver Nuggets","Aaron Gordon",1,23,25,20,7,29
7,2,9,2,2,17,12,5,5,"34",2,4,31,11,3,0,1037975,"2023-12-22T00:00:00.000Z",3,FALSE,8,246,"C",8,8,"Denver Nuggets","Nikola Jokic",5,42,49,38,18,69.7
4,0,4,2,1,6,1,0,0,"30",1,3,3,5,2,1,1037975,"2023-12-22T00:00:00.000Z",3,FALSE,8,81,"G",8,8,"Denver Nuggets","Kentavious Caldwell-Pope",2,8,12,7,9,20
0,0,0,0,0,0,0,0,0,"00",0,0,0,0,0,0,1037975,"2023-12-22T00:00:00.000Z",3,FALSE,8,38017727,"G",8,8,"Denver Nuggets","Collin Gillespie",0,0,0,0,0,0
0,0,0,0,0,0,0,0,0,"00",0,0,0,0,0,0,1037975,"2023-12-22T00:00:00.000Z",3,FALSE,8,17896103,"F-C",8,8,"Denver Nuggets","Jay Huff",0,0,0,0,0,0
2,0,3,10,4,17,8,0,0,"27",0,0,20,3,0,2,1037978,"2023-12-22T00:00:00.000Z",10,FALSE,30,443,"G",10,10,"Golden State Warriors","Klay Thompson",0,23,25,22,5,24.6
3,0,2,2,1,11,9,3,3,"27",2,2,22,4,1,1,1037978,"2023-12-22T00:00:00.000Z",10,FALSE,30,17553979,"F",10,10,"Golden State Warriors","Jonathan Kuminga",1,26,29,25,7,33.3
0,0,3,0,0,3,2,1,1,"11",2,2,5,5,0,0,1037978,"2023-12-22T00:00:00.000Z",10,FALSE,30,282,"F",10,10,"Golden State Warriors","Kevon Looney",0,10,10,5,5,11
5,0,4,5,2,9,3,2,2,"29",3,2,10,7,1,1,1037978,"2023-12-22T00:00:00.000Z",10,FALSE,30,56677858,"G",10,10,"Golden State Warriors","Brandin Podziemski",1,17,22,15,12,27.9
7,1,4,13,8,18,9,5,4,"27",0,0,30,4,0,2,1037978,"2023-12-22T00:00:00.000Z",10,FALSE,30,115,"G",10,10,"Golden State Warriors","Stephen Curry",1,34,41,37,11,46.3
1,0,0,0,0,1,0,0,0,"02",0,0,0,0,0,0,1037978,"2023-12-22T00:00:00.000Z",10,FALSE,30,17896070,"F",10,10,"Golden State Warriors","Usman Garuba",0,0,1,1,1,1.5
3,1,10,0,0,7,5,0,0,"25",5,2,10,15,0,1,1037978,"2023-12-22T00:00:00.000Z",10,FALSE,30,56677799,"F",10,10,"Golden State Warriors","Trayce Jackson-Davis",1,25,28,13,18,34.5
0,0,1,1,0,3,0,0,0,"14",0,3,0,1,1,1,1037978,"2023-12-22T00:00:00.000Z",10,FALSE,30,251,"G",10,10,"Golden State Warriors","Cory Joseph",1,1,1,0,1,3.2
0,0,2,3,0,4,1,4,3,"19",1,1,5,3,1,2,1037978,"2023-12-22T00:00:00.000Z",10,FALSE,30,17553992,"G",10,10,"Golden State Warriors","Moses Moody",1,8,8,5,3,9.6
10,0,7,3,0,7,2,1,0,"25",0,2,4,7,1,1,1037978,"2023-12-22T00:00:00.000Z",10,FALSE,30,367,"G",10,10,"Golden State Warriors","Chris Paul",1,11,21,14,17,29.4
1,0,3,2,1,3,1,0,0,"06",0,1,3,3,0,1,1037978,"2023-12-22T00:00:00.000Z",10,FALSE,30,45658838,"G",10,10,"Golden State Warriors","Lester Quinones",0,6,7,4,4,7.1
0,0,0,0,0,0,0,0,0,"02",0,0,0,0,0,0,1037978,"2023-12-22T00:00:00.000Z",10,FALSE,30,398,"G",10,10,"Golden State Warriors","Jerome Robinson",0,0,0,0,0,0
0,0,1,2,1,3,2,2,2,"06",1,1,7,2,0,0,1037978,"2023-12-22T00:00:00.000Z",10,FALSE,30,57875092,"F",10,10,"Golden State Warriors","Gui Santos",0,9,9,7,2,9.4
1,0,3,4,1,11,5,2,2,"20",0,1,13,3,0,0,1037978,"2023-12-22T00:00:00.000Z",10,FALSE,30,407,"F",10,10,"Golden State Warriors","Dario Saric",0,16,17,14,4,18.1
0,0,0,0,0,0,0,0,0,"00",0,0,0,0,0,0,1037978,"2023-12-22T00:00:00.000Z",10,FALSE,30,185,"F",10,10,"Golden State Warriors","Draymond Green",0,0,0,0,0,0
0,0,0,0,0,0,0,0,0,"00",0,0,0,0,0,0,1037978,"2023-12-22T00:00:00.000Z",10,FALSE,30,2189,"",10,10,"Golden State Warriors","Gary Payton II",0,0,0,0,0,0
3,0,9,5,1,11,3,1,0,"25",0,2,7,9,0,3,1037978,"2023-12-22T00:00:00.000Z",10,FALSE,30,265,"F",30,30,"Washington Wizards","Kyle Kuzma",0,16,19,10,12,19.3
1,0,3,0,0,7,5,6,5,"23",1,1,15,4,1,1,1037978,"2023-12-22T00:00:00.000Z",10,FALSE,30,666577,"F",30,30,"Washington Wizards","Daniel Gafford",1,19,20,16,5,23.3
3,0,2,12,3,21,7,9,8,"27",1,3,25,3,2,1,1037978,"2023-12-22T00:00:00.000Z",10,FALSE,30,666848,"G",30,30,"Washington Wizards","Jordan Poole",2,28,31,28,6,38.1
6,0,2,2,2,8,6,0,0,"25",1,0,14,3,1,0,1037978,"2023-12-22T00:00:00.000Z",10,FALSE,30,249,"G",30,30,"Washington Wizards","Tyus Jones",1,17,23,20,9,29.6
2,1,3,2,1,8,3,0,0,"32",0,1,7,3,1,2,1037978,"2023-12-22T00:00:00.000Z",10,FALSE,30,56677844,"G",30,30,"Washington Wizards","Bilal Coulibaly",2,10,12,9,5,17.6
0,0,0,0,0,0,0,0,0,"00",0,0,0,0,0,0,1037978,"2023-12-22T00:00:00.000Z",10,FALSE,30,475,"F-G",10,10,"Golden State Warriors","Andrew Wiggins",0,0,0,0,0,0
4,0,2,0,0,5,2,3,3,"20",2,1,7,4,1,0,1037978,"2023-12-22T00:00:00.000Z",10,FALSE,30,3547242,"F",30,30,"Washington Wizards","Deni Avdija",1,11,15,11,8,20.8
0,0,0,0,0,0,0,0,0,"00",0,0,0,0,0,0,1037978,"2023-12-22T00:00:00.000Z",10,FALSE,30,38017687,"G",30,30,"Washington Wizards","Johnny Davis",0,0,0,0,0,0
0,0,0,0,0,0,0,0,0,"00",0,0,0,0,0,0,1037978,"2023-12-22T00:00:00.000Z",10,FALSE,30,167,"F",30,30,"Washington Wizards","Danilo Gallinari",0,0,0,0,0,0
0,0,0,0,0,0,0,0,0,"00",0,0,0,0,0,0,1037978,"2023-12-22T00:00:00.000Z",10,FALSE,30,487,"G",30,30,"Washington Wizards","Delon Wright",0,0,0,0,0,0
0,1,1,7,2,15,7,2,2,"25",0,3,18,1,0,1,1037978,"2023-12-22T00:00:00.000Z",10,FALSE,30,17896045,"F",30,30,"Washington Wizards","Corey Kispert",1,19,19,18,1,21.2
0,0,4,1,0,5,1,0,0,"14",2,2,2,6,0,1,1037978,"2023-12-22T00:00:00.000Z",10,FALSE,30,337,"F-C",30,30,"Washington Wizards","Mike Muscala",0,8,8,2,6,8.2
1,0,0,1,0,2,0,0,0,"13",0,2,0,0,0,0,1037978,"2023-12-22T00:00:00.000Z",10,FALSE,30,414,"G",30,30,"Washington Wizards","Landry Shamet",0,0,1,1,1,1.5
0,0,1,0,0,1,0,0,0,"07",0,0,0,1,0,0,1037978,"2023-12-22T00:00:00.000Z",10,FALSE,30,38017704,"F",30,30,"Washington Wizards","Patrick Baldwin Jr.",0,1,1,0,1,1.2
4,0,1,3,1,5,3,2,1,"07",0,0,8,1,1,0,1037978,"2023-12-22T00:00:00.000Z",10,FALSE,30,18677954,"G",30,30,"Washington Wizards","Jared Butler",1,9,13,12,5,18.2
0,1,1,1,0,5,4,0,0,"11",2,0,8,3,0,0,1037978,"2023-12-22T00:00:00.000Z",10,FALSE,30,3547302,"F",30,30,"Washington Wizards","Anthony Gill",1,11,11,8,3,14.6
0,0,0,0,0,0,0,0,0,"00",0,0,0,0,0,0,1037978,"2023-12-22T00:00:00.000Z",10,FALSE,30,17896106,"F",30,30,"Washington Wizards","Eugene Omoruyi",0,0,0,0,0,0
1,1,1,1,1,4,3,1,0,"11",0,1,7,1,0,0,1037978,"2023-12-22T00:00:00.000Z",10,FALSE,30,38017712,"G",30,30,"Washington Wizards","Ryan Rollins",1,8,9,8,2,12.7
0,0,0,0,0,0,0,0,0,"00",0,0,0,0,0,0,1037978,"2023-12-22T00:00:00.000Z",10,FALSE,30,NA,NA,NA,30,"Washington Wizards","NA NA",0,0,0,0,0,0
1,1,3,1,1,14,7,5,4,"37",4,4,19,7,1,2,1037976,"2023-12-22T00:00:00.000Z",16,FALSE,1,56677785,"G",16,16,"Miami Heat","Jaime Jaquez Jr.",2,26,27,20,8,32.9
2,1,6,4,2,9,4,1,1,"35",2,4,11,8,1,0,1037976,"2023-12-22T00:00:00.000Z",16,FALSE,1,666747,"F",16,16,"Miami Heat","Caleb Martin",2,19,21,13,10,29.6
6,0,9,1,0,14,5,10,8,"38",2,2,18,11,2,6,1037976,"2023-12-22T00:00:00.000Z",16,FALSE,1,4,"C-F",16,16,"Miami Heat","Bam Adebayo",2,29,35,24,17,40.2
2,0,7,13,7,21,11,2,1,"34",0,1,30,7,1,4,1037976,"2023-12-22T00:00:00.000Z",16,FALSE,1,666633,"G",16,16,"Miami Heat","Tyler Herro",1,37,39,32,9,40.4
3,0,4,2,1,2,1,0,0,"22",0,2,3,4,0,2,1037976,"2023-12-22T00:00:00.000Z",16,FALSE,1,286,"G",16,16,"Miami Heat","Kyle Lowry",0,7,10,6,7,10.3
0,0,0,0,0,0,0,0,0,"00",0,0,0,0,0,0,1037976,"2023-12-22T00:00:00.000Z",16,FALSE,1,74,"C",16,16,"Miami Heat","Thomas Bryant",0,0,0,0,0,0
0,0,0,0,0,0,0,0,0,"00",0,0,0,0,0,0,1037976,"2023-12-22T00:00:00.000Z",16,FALSE,1,38017734,"F",16,16,"Miami Heat","Jamal Cain",0,0,0,0,0,0
2,0,2,3,1,6,2,0,0,"10",3,2,5,5,0,0,1037976,"2023-12-22T00:00:00.000Z",16,FALSE,1,3092,"",16,16,"Miami Heat","Haywood Highsmith",0,10,12,7,7,14
1,0,0,4,1,4,1,4,3,"10",0,3,6,0,0,0,1037976,"2023-12-22T00:00:00.000Z",16,FALSE,1,285,"F-C",16,16,"Miami Heat","Kevin Love",0,6,7,7,1,7.5
1,0,3,4,0,5,1,1,1,"29",0,0,3,3,1,1,1037976,"2023-12-22T00:00:00.000Z",16,FALSE,1,391,"G-F",16,16,"Miami Heat","Josh Richardson",1,6,7,4,4,10.1
3,0,2,7,4,11,8,7,7,"25",1,0,27,3,1,2,1037976,"2023-12-22T00:00:00.000Z",16,FALSE,1,397,"F",16,16,"Miami Heat","Duncan Robinson",1,30,33,30,6,36.1
0,0,0,0,0,0,0,0,0,"00",0,0,0,0,0,0,1037976,"2023-12-22T00:00:00.000Z",16,FALSE,1,39398582,"C",16,16,"Miami Heat","Orlando Robinson",0,0,0,0,0,0
0,0,0,0,0,0,0,0,0,"00",0,0,0,0,0,0,1037976,"2023-12-22T00:00:00.000Z",16,FALSE,1,79,"G-F",16,16,"Miami Heat","Jimmy Butler",0,0,0,0,0,0
0,0,0,0,0,0,0,0,0,"00",0,0,0,0,0,0,1037976,"2023-12-22T00:00:00.000Z",16,FALSE,1,3547257,"G",16,16,"Miami Heat","R.J. Hampton",0,0,0,0,0,0
0,0,0,0,0,0,0,0,0,"00",0,0,0,0,0,0,1037976,"2023-12-22T00:00:00.000Z",16,FALSE,1,38017696,"F",16,16,"Miami Heat","Nikola Jovic",0,0,0,0,0,0
0,0,0,0,0,0,0,0,0,"00",0,0,0,0,0,0,1037976,"2023-12-22T00:00:00.000Z",16,FALSE,1,19465585,"G",16,16,"Miami Heat","Dru Smith",0,0,0,0,0,0
0,0,0,0,0,0,0,0,0,"00",0,0,0,0,0,0,1037976,"2023-12-22T00:00:00.000Z",16,FALSE,1,38017736,"F",16,16,"Miami Heat","Cole Swider",0,0,0,0,0,0
1,0,1,3,0,3,0,0,0,"18",0,4,0,1,0,0,1037976,"2023-12-22T00:00:00.000Z",16,FALSE,1,666754,"G",1,1,"Atlanta Hawks","Garrison Mathews",0,1,2,1,2,2.7
2,0,8,8,2,14,6,2,2,"40",2,2,16,10,2,2,1037976,"2023-12-22T00:00:00.000Z",16,FALSE,1,3547256,"F",1,1,"Atlanta Hawks","Saddiq Bey",2,26,28,18,12,35
0,0,7,0,0,3,3,2,2,"28",3,5,8,10,0,2,1037976,"2023-12-22T00:00:00.000Z",16,FALSE,1,83,"C",1,1,"Atlanta Hawks","Clint Capela",0,18,18,8,10,18
6,0,7,9,3,20,10,3,1,"34",1,0,24,8,3,2,1037976,"2023-12-22T00:00:00.000Z",16,FALSE,1,334,"G",1,1,"Atlanta Hawks","Dejounte Murray",3,32,38,30,14,49.6
13,0,3,13,7,22,10,3,3,"40",0,1,30,3,2,6,1037976,"2023-12-22T00:00:00.000Z",16,FALSE,1,490,"G",1,1,"Atlanta Hawks","Trae Young",2,33,46,43,16,53.1
1,0,0,1,1,2,1,0,0,"12",1,4,3,1,0,1,1037976,"2023-12-22T00:00:00.000Z",16,FALSE,1,319,"G",1,1,"Atlanta Hawks","Patty Mills",0,4,5,4,2,4.7
5,0,1,18,6,24,8,2,1,"35",1,3,23,2,1,0,1037976,"2023-12-22T00:00:00.000Z",16,FALSE,1,53,"G",1,1,"Atlanta Hawks","Bogdan Bogdanovic",1,25,30,28,7,35.9
1,2,3,1,0,7,4,2,1,"26",4,3,9,7,1,0,1037976,"2023-12-22T00:00:00.000Z",16,FALSE,1,3547244,"F-C",1,1,"Atlanta Hawks","Onyeka Okongwu",3,16,17,10,8,27.9
0,0,1,1,0,1,0,0,0,"07",0,1,0,1,0,0,1037976,"2023-12-22T00:00:00.000Z",16,FALSE,1,301,"G-F",1,1,"Atlanta Hawks","Wesley Matthews",0,1,1,0,1,1.2
0,0,0,0,0,0,0,0,0,"00",0,0,0,0,0,0,1037976,"2023-12-22T00:00:00.000Z",16,FALSE,1,666564,"F",1,1,"Atlanta Hawks","Bruno Fernando",0,0,0,0,0,0
0,0,0,0,0,0,0,0,0,"00",0,0,0,0,0,0,1037976,"2023-12-22T00:00:00.000Z",16,FALSE,1,3547297,"G",1,1,"Atlanta Hawks","Trent Forrest",0,0,0,0,0,0
0,0,0,0,0,0,0,0,0,"00",0,0,0,0,0,0,1037976,"2023-12-22T00:00:00.000Z",16,FALSE,1,56677838,"G",1,1,"Atlanta Hawks","Kobe Bufkin",0,0,0,0,0,0
0,0,0,0,0,0,0,0,0,"00",0,0,0,0,0,0,1037976,"2023-12-22T00:00:00.000Z",16,FALSE,1,38017689,"F",1,1,"Atlanta Hawks","AJ Griffin",0,0,0,0,0,0
0,0,0,0,0,0,0,0,0,"00",0,0,0,0,0,0,1037976,"2023-12-22T00:00:00.000Z",16,FALSE,1,56677806,"F",1,1,"Atlanta Hawks","Mouhamed Gueye",0,0,0,0,0,0
0,0,0,0,0,0,0,0,0,"00",0,0,0,0,0,0,1037976,"2023-12-22T00:00:00.000Z",16,FALSE,1,666656,"F",1,1,"Atlanta Hawks","De'Andre Hunter",0,0,0,0,0,0
0,0,0,0,0,0,0,0,0,"00",0,0,0,0,0,0,1037976,"2023-12-22T00:00:00.000Z",16,FALSE,1,17896040,"F",1,1,"Atlanta Hawks","Jalen Johnson",0,0,0,0,0,0
0,0,0,0,0,0,0,0,0,"00",0,0,0,0,0,0,1037976,"2023-12-22T00:00:00.000Z",16,FALSE,1,4197387,"G",1,1,"Atlanta Hawks","Vit Krejci",0,0,0,0,0,0
0,0,0,0,0,0,0,0,0,"00",0,0,0,0,0,0,1037976,"2023-12-22T00:00:00.000Z",16,FALSE,1,56677855,"G",1,1,"Atlanta Hawks","Seth Lundy",0,0,0,0,0,0
0,1,1,8,4,10,5,6,5,"37",0,2,19,1,2,0,1037979,"2023-12-22T00:00:00.000Z",26,FALSE,24,30,"F",26,26,"Sacramento Kings","Harrison Barnes",3,20,20,19,1,29.2
2,0,4,7,3,13,8,2,2,"33",1,3,21,5,0,1,1037979,"2023-12-22T00:00:00.000Z",26,FALSE,24,38017688,"F",26,26,"Sacramento Kings","Keegan Murray",0,26,28,23,7,29
11,0,10,2,0,15,12,5,4,"35",1,3,28,11,0,3,1037979,"2023-12-22T00:00:00.000Z",26,FALSE,24,406,"F",26,26,"Sacramento Kings","Domantas Sabonis",0,39,50,39,22,54.7
5,0,1,6,2,9,5,1,1,"27",1,1,13,2,1,1,1037979,"2023-12-22T00:00:00.000Z",26,FALSE,24,221,"G",26,26,"Sacramento Kings","Kevin Huerter",1,15,20,18,7,24.9
7,2,6,6,2,17,9,4,3,"32",0,2,23,6,3,2,1037979,"2023-12-22T00:00:00.000Z",26,FALSE,24,161,"G",26,26,"Sacramento Kings","De'Aaron Fox",5,29,36,30,13,53.7
0,0,0,1,0,2,0,0,0,"02",1,0,0,1,0,0,1037979,"2023-12-22T00:00:00.000Z",26,FALSE,24,17896030,"G",26,26,"Sacramento Kings","Chris Duarte",0,1,1,0,1,1.2
0,0,0,1,0,1,0,0,0,"02",0,0,0,0,0,0,1037979,"2023-12-22T00:00:00.000Z",26,FALSE,24,17896044,"F",26,26,"Sacramento Kings","Kessler Edwards",0,0,0,0,0,0
1,1,2,2,0,3,0,2,1,"17",1,3,1,3,1,0,1037979,"2023-12-22T00:00:00.000Z",26,FALSE,24,38017714,"G",26,26,"Sacramento Kings","Keon Ellis",2,4,5,2,4,12.1
0,0,3,0,0,1,0,0,0,"12",1,1,0,4,0,1,1037979,"2023-12-22T00:00:00.000Z",26,FALSE,24,290,"F",26,26,"Sacramento Kings","Trey Lyles",0,4,4,0,4,3.8
0,0,1,0,0,2,1,4,3,"11",0,3,5,1,0,1,1037979,"2023-12-22T00:00:00.000Z",26,FALSE,24,306,"C",26,26,"Sacramento Kings","JaVale McGee",0,6,6,5,1,5.2
0,0,0,1,0,1,0,0,0,"02",0,0,0,0,0,0,1037979,"2023-12-22T00:00:00.000Z",26,FALSE,24,17553994,"G",26,26,"Sacramento Kings","Davion Mitchell",0,0,0,0,0,0
5,3,2,3,0,8,3,2,1,"21",0,4,7,2,0,2,1037979,"2023-12-22T00:00:00.000Z",26,FALSE,24,324,"G",26,26,"Sacramento Kings","Malik Monk",3,9,14,12,7,23.9
0,0,0,0,0,0,0,0,0,"03",0,1,0,0,0,0,1037979,"2023-12-22T00:00:00.000Z",26,FALSE,24,666925,"F",29,26,"Sacramento Kings","Juan Toscano-Anderson",0,0,0,0,0,0
0,0,0,1,1,1,1,0,0,"06",1,1,3,1,0,1,1037979,"2023-12-22T00:00:00.000Z",26,FALSE,24,4197162,"F",26,26,"Sacramento Kings","Aleksandar Vezenkov",0,4,4,3,1,3.2
0,0,0,0,0,0,0,0,0,"00",0,0,0,0,0,0,1037979,"2023-12-22T00:00:00.000Z",26,FALSE,24,17895990,"G",26,26,"Sacramento Kings","Jordan Ford",0,0,0,0,0,0
0,0,0,0,0,0,0,0,0,"00",0,0,0,0,0,0,1037979,"2023-12-22T00:00:00.000Z",26,FALSE,24,56677845,"G",26,26,"Sacramento Kings","Colby Jones",0,0,0,0,0,0
0,0,0,0,0,0,0,0,0,"00",0,0,0,0,0,0,1037979,"2023-12-22T00:00:00.000Z",26,FALSE,24,273,"C",26,26,"Sacramento Kings","Alex Len",0,0,0,0,0,0
0,0,0,0,0,0,0,0,0,"00",0,0,0,0,0,0,1037979,"2023-12-22T00:00:00.000Z",26,FALSE,24,56677862,"F",26,26,"Sacramento Kings","Jalen Slawson",0,0,0,0,0,0
2,1,4,1,0,2,0,0,0,"25",0,1,0,4,0,0,1037979,"2023-12-22T00:00:00.000Z",26,FALSE,24,178,"G",24,24,"Phoenix Suns","Eric Gordon",1,4,6,2,6,10.8
0,0,0,0,0,0,0,0,0,"00",0,0,0,0,0,0,1037979,"2023-12-22T00:00:00.000Z",26,FALSE,24,349,"C",24,24,"Phoenix Suns","Jusuf Nurkic",0,0,0,0,0,0
0,0,0,0,0,0,0,0,0,"00",0,0,0,0,0,0,1037979,"2023-12-22T00:00:00.000Z",26,FALSE,24,356,"G",24,24,"Phoenix Suns","Josh Okogie",0,0,0,0,0,0
0,1,6,0,0,5,5,2,1,"22",5,4,11,11,1,1,1037979,"2023-12-22T00:00:00.000Z",26,FALSE,24,3547095,"C-F",24,24,"Phoenix Suns","Udoka Azubuike",2,22,22,11,11,29.2
0,0,0,0,0,0,0,0,0,"00",0,0,0,0,0,0,1037979,"2023-12-22T00:00:00.000Z",26,FALSE,24,32,"F",24,24,"Phoenix Suns","Keita Bates-Diop",0,0,0,0,0,0
0,0,0,0,0,2,1,0,0,"03",1,0,2,1,0,0,1037979,"2023-12-22T00:00:00.000Z",26,FALSE,24,666451,"C",24,24,"Phoenix Suns","Bol Bol",0,3,3,2,1,3.2
0,0,1,1,0,6,1,2,1,"14",2,2,3,3,1,1,1037979,"2023-12-22T00:00:00.000Z",26,FALSE,24,18678058,"",24,24,"Phoenix Suns","Jordan Goodwin",1,6,6,3,3,8.6
4,1,2,3,0,8,2,2,2,"20",1,2,6,3,0,1,1037979,"2023-12-22T00:00:00.000Z",26,FALSE,24,3547298,"G",24,24,"Phoenix Suns","Saben Lee",1,9,13,10,7,17.6
0,0,0,3,0,8,3,0,0,"16",0,3,6,0,1,1,1037979,"2023-12-22T00:00:00.000Z",26,FALSE,24,666729,"F",24,24,"Phoenix Suns","Nassir Little",1,6,6,6,0,8
0,0,3,2,0,6,3,4,4,"13",1,1,10,4,0,1,1037979,"2023-12-22T00:00:00.000Z",26,FALSE,24,314,"F",24,24,"Phoenix Suns","Chimezie Metu",0,14,14,10,4,13.8
0,0,2,3,0,4,1,0,0,"12",0,2,2,2,0,0,1037979,"2023-12-22T00:00:00.000Z",26,FALSE,24,470,"G",24,24,"Phoenix Suns","Yuta Watanabe",0,4,4,2,2,4.4
0,0,0,0,0,0,0,0,0,"00",0,0,0,0,0,0,1037979,"2023-12-22T00:00:00.000Z",26,FALSE,24,37,"G",24,24,"Phoenix Suns","Bradley Beal",0,0,0,0,0,0
0,0,0,0,0,0,0,0,0,"00",0,0,0,0,0,0,1037979,"2023-12-22T00:00:00.000Z",26,FALSE,24,3547253,"G",4,24,"Phoenix Suns","Theo Maledon",0,0,0,0,0,0
0,0,0,0,0,0,0,0,0,"00",0,0,0,0,0,0,1037979,"2023-12-22T00:00:00.000Z",26,FALSE,24,272,"G",24,24,"Phoenix Suns","Damion Lee",0,0,0,0,0,0
2,0,7,3,2,14,9,9,8,"34",0,0,28,7,1,7,1037979,"2023-12-22T00:00:00.000Z",26,FALSE,24,140,"F",24,24,"Phoenix Suns","Kevin Durant",1,35,37,30,9,35.4
0,0,1,0,0,3,1,0,0,"15",1,2,2,2,1,2,1037979,"2023-12-22T00:00:00.000Z",26,FALSE,24,147,"F",24,24,"Phoenix Suns","Drew Eubanks",1,4,4,2,2,5.4
2,1,2,6,3,10,4,0,0,"30",2,1,11,4,3,1,1037979,"2023-12-22T00:00:00.000Z",26,FALSE,24,8,"G",24,24,"Phoenix Suns","Grayson Allen",4,15,17,13,6,29.8
7,0,2,3,0,20,9,9,6,"36",2,1,24,4,0,0,1037979,"2023-12-22T00:00:00.000Z",26,FALSE,24,57,"G",24,24,"Phoenix Suns","Devin Booker",0,28,35,31,11,39.3
4,2,6,0,0,7,4,0,0,"31",0,2,8,6,1,4,1037982,"2023-12-23T00:00:00.000Z",4,FALSE,8,204,"F",4,4,"Charlotte Hornets","Gordon Hayward",3,14,18,12,10,26.2
2,3,5,12,2,23,8,4,4,"38",3,2,22,8,2,1,1037982,"2023-12-23T00:00:00.000Z",4,FALSE,8,62,"F",4,4,"Charlotte Hornets","Miles Bridges",5,30,32,24,10,48.6
3,3,9,0,0,8,4,6,4,"38",6,1,12,15,1,3,1037982,"2023-12-23T00:00:00.000Z",4,FALSE,8,3547282,"C",4,4,"Charlotte Hornets","Nick Richards",4,27,30,15,18,43.5
2,0,1,2,0,5,2,0,0,"11",0,1,4,1,0,3,1037982,"2023-12-23T00:00:00.000Z",4,FALSE,8,56677823,"F",4,4,"Charlotte Hornets","Brandon Miller",0,5,7,6,3,5.2
8,0,2,0,0,4,1,2,2,"27",1,2,4,3,0,2,1037982,"2023-12-23T00:00:00.000Z",4,FALSE,8,422,"G",4,4,"Charlotte Hornets","Ish Smith",0,7,15,12,11,17.6
0,0,0,0,0,0,0,0,0,"00",0,0,0,0,0,0,1037982,"2023-12-23T00:00:00.000Z",4,FALSE,8,56677848,"G",4,4,"Charlotte Hornets","Amari Bailey",0,0,0,0,0,0
0,0,0,0,0,0,0,0,0,"00",0,0,0,0,0,0,1037982,"2023-12-23T00:00:00.000Z",4,FALSE,8,56677866,"F",4,4,"Charlotte Hornets","Leaky Black",0,0,0,0,0,0
0,0,0,0,0,0,0,0,0,"00",0,0,0,0,0,0,1037982,"2023-12-23T00:00:00.000Z",4,FALSE,8,17896037,"G",4,4,"Charlotte Hornets","James Bouknight",0,0,0,0,0,0
0,0,0,0,0,5,3,0,0,"17",0,1,6,0,0,1,1037982,"2023-12-23T00:00:00.000Z",4,FALSE,8,666748,"F",4,4,"Charlotte Hornets","Cody Martin",0,6,6,6,0,5
0,0,1,0,0,4,0,0,0,"18",2,1,0,3,0,0,1037982,"2023-12-23T00:00:00.000Z",4,FALSE,8,38017708,"G",4,4,"Charlotte Hornets","Bryce McGowens",0,3,3,0,3,3.6
0,1,1,0,0,0,0,0,0,"07",0,2,0,1,0,0,1037982,"2023-12-23T00:00:00.000Z",4,FALSE,8,NA,NA,NA,4,"Charlotte Hornets","NA NA",1,1,1,0,1,4.2
0,0,0,0,0,0,0,0,0,"00",0,0,0,0,0,0,1037982,"2023-12-23T00:00:00.000Z",4,FALSE,8,403,"G",4,4,"Charlotte Hornets","Terry Rozier",0,0,0,0,0,0
2,0,2,7,5,12,6,2,2,"25",1,2,19,3,0,1,1037982,"2023-12-23T00:00:00.000Z",4,FALSE,8,56677846,"G",4,4,"Charlotte Hornets","Nick Smith Jr.",0,22,24,21,5,24.6
0,0,0,0,0,0,0,0,0,"00",0,0,0,0,0,0,1037982,"2023-12-23T00:00:00.000Z",4,FALSE,8,18678001,"F",4,4,"Charlotte Hornets","JT Thor",0,0,0,0,0,0
0,0,0,0,0,0,0,0,0,"00",0,0,0,0,0,0,1037982,"2023-12-23T00:00:00.000Z",4,FALSE,8,56677871,"F",8,8,"Denver Nuggets","Hunter Tyson",0,0,0,0,0,0
0,1,3,1,0,2,1,0,0,"17",0,2,2,3,1,2,1037982,"2023-12-23T00:00:00.000Z",4,FALSE,8,38017721,"G",8,8,"Denver Nuggets","Peyton Watson",2,5,5,2,3,9.6
0,0,0,0,0,0,0,0,0,"00",0,0,0,0,0,0,1037982,"2023-12-23T00:00:00.000Z",4,FALSE,8,666489,"F",8,8,"Denver Nuggets","Vlatko Cancar",0,0,0,0,0,0
0,0,0,0,0,0,0,0,0,"00",0,0,0,0,0,0,1037982,"2023-12-23T00:00:00.000Z",4,FALSE,8,17896007,"G",8,8,"Denver Nuggets","Braxton Key",0,0,0,0,0,0
0,0,0,0,0,0,0,0,0,"00",0,0,0,0,0,0,1037982,"2023-12-23T00:00:00.000Z",4,FALSE,8,56677582,"G",8,8,"Denver Nuggets","Jalen Pickett",0,0,0,0,0,0
2,2,7,7,1,20,6,9,7,"28",1,1,20,8,4,2,1037982,"2023-12-23T00:00:00.000Z",4,FALSE,8,666950,"F",4,4,"Charlotte Hornets","P.J. Washington",6,28,30,22,10,48.6
0,0,0,0,0,0,0,0,0,"00",0,0,0,0,0,0,1037982,"2023-12-23T00:00:00.000Z",4,FALSE,8,3547239,"G",4,4,"Charlotte Hornets","LaMelo Ball",0,0,0,0,0,0
0,0,0,0,0,0,0,0,0,"00",0,0,0,0,0,0,1037982,"2023-12-23T00:00:00.000Z",4,FALSE,8,347,"G",4,4,"Charlotte Hornets","Frank Ntilikina",0,0,0,0,0,0
0,0,0,0,0,0,0,0,0,"00",0,0,0,0,0,0,1037982,"2023-12-23T00:00:00.000Z",4,FALSE,8,38017698,"C",4,4,"Charlotte Hornets","Mark Williams",0,0,0,0,0,0
1,2,4,8,5,14,8,2,1,"30",1,2,22,5,1,1,1037982,"2023-12-23T00:00:00.000Z",4,FALSE,8,375,"F",8,8,"Denver Nuggets","Michael Porter Jr.",3,27,28,23,6,37.5
1,1,0,0,0,11,5,5,4,"32",2,1,14,2,1,2,1037982,"2023-12-23T00:00:00.000Z",4,FALSE,8,177,"F",8,8,"Denver Nuggets","Aaron Gordon",2,16,17,15,3,21.9
9,1,8,2,0,14,8,2,2,"35",2,6,18,10,1,3,1037982,"2023-12-23T00:00:00.000Z",4,FALSE,8,246,"C",8,8,"Denver Nuggets","Nikola Jokic",2,28,37,27,19,46.5
2,4,3,2,1,3,1,0,0,"32",0,1,3,3,2,0,1037982,"2023-12-23T00:00:00.000Z",4,FALSE,8,81,"G",8,8,"Denver Nuggets","Kentavious Caldwell-Pope",6,6,8,5,5,27.6
5,0,10,6,2,19,8,2,2,"33",2,1,20,12,3,1,1037982,"2023-12-23T00:00:00.000Z",4,FALSE,8,335,"G",8,8,"Denver Nuggets","Jamal Murray",3,32,37,25,17,49.9
1,2,5,3,2,7,3,3,3,"18",2,1,11,7,0,1,1037982,"2023-12-23T00:00:00.000Z",4,FALSE,8,38017709,"G",8,8,"Denver Nuggets","Christian Braun",2,18,19,12,8,25.9
0,0,0,0,0,0,0,0,0,"00",0,0,0,0,0,0,1037982,"2023-12-23T00:00:00.000Z",4,FALSE,8,38017727,"G",8,8,"Denver Nuggets","Collin Gillespie",0,0,0,0,0,0
0,0,0,0,0,0,0,0,0,"00",0,0,0,0,0,0,1037982,"2023-12-23T00:00:00.000Z",4,FALSE,8,215,"F-G",8,8,"Denver Nuggets","Justin Holiday",0,0,0,0,0,0
0,0,0,0,0,0,0,0,0,"00",0,0,0,0,0,0,1037982,"2023-12-23T00:00:00.000Z",4,FALSE,8,17896103,"F-C",8,8,"Denver Nuggets","Jay Huff",0,0,0,0,0,0
4,0,3,3,0,9,1,0,0,"15",0,3,2,3,1,2,1037982,"2023-12-23T00:00:00.000Z",4,FALSE,8,236,"G",8,8,"Denver Nuggets","Reggie Jackson",1,5,9,6,7,12.6
0,0,0,0,0,0,0,0,0,"00",0,0,0,0,0,0,1037982,"2023-12-23T00:00:00.000Z",4,FALSE,8,250,"C",8,8,"Denver Nuggets","DeAndre Jordan",0,0,0,0,0,0
1,2,0,0,0,1,0,0,0,"12",2,4,0,2,0,1,1037982,"2023-12-23T00:00:00.000Z",4,FALSE,8,3547268,"F-C",8,8,"Denver Nuggets","Zeke Nnaji",2,2,3,1,3,8.9
1,0,0,5,2,10,4,0,0,"16",1,0,10,1,1,1,1037982,"2023-12-23T00:00:00.000Z",4,FALSE,8,56677776,"G",8,8,"Denver Nuggets","Julian Strawther",1,11,12,11,2,14.7
2,1,6,11,5,15,7,1,1,"38",1,4,20,7,1,2,1037983,"2023-12-23T00:00:00.000Z",12,FALSE,22,210,"G",12,12,"Indiana Pacers","Buddy Hield",2,27,29,22,9,35.4
0,1,6,3,0,6,1,2,1,"25",0,2,3,6,0,0,1037983,"2023-12-23T00:00:00.000Z",12,FALSE,22,3547243,"F",12,12,"Indiana Pacers","Obi Toppin",1,9,9,3,6,13.2
0,4,6,4,2,11,9,4,4,"29",1,4,24,7,1,1,1037983,"2023-12-23T00:00:00.000Z",12,FALSE,22,452,"C-F",12,12,"Indiana Pacers","Myles Turner",5,31,31,24,7,46.4
5,0,0,1,1,10,8,0,0,"36",1,2,17,1,0,1,1037983,"2023-12-23T00:00:00.000Z",12,FALSE,22,38017507,"G-F",12,12,"Indiana Pacers","Andrew Nembhard",0,18,23,22,6,24.7
14,0,2,5,3,22,12,3,2,"40",0,2,29,2,3,3,1037983,"2023-12-23T00:00:00.000Z",12,FALSE,22,3547245,"G",12,12,"Indiana Pacers","Tyrese Haliburton",3,31,45,43,16,58.4
0,0,0,0,0,0,0,0,0,"00",0,0,0,0,0,0,1037983,"2023-12-23T00:00:00.000Z",12,FALSE,22,69,"G",12,12,"Indiana Pacers","Bruce Brown",0,0,0,0,0,0
0,0,1,0,0,2,0,0,0,"06",2,4,0,3,0,0,1037983,"2023-12-23T00:00:00.000Z",12,FALSE,22,17896035,"F",12,12,"Indiana Pacers","Isaiah Jackson",0,3,3,0,3,3.6
0,0,0,0,0,0,0,0,0,"00",0,0,0,0,0,0,1037983,"2023-12-23T00:00:00.000Z",12,FALSE,22,242,"F",12,12,"Indiana Pacers","James Johnson",0,0,0,0,0,0
1,0,2,2,0,5,1,0,0,"16",0,1,2,2,0,1,1037983,"2023-12-23T00:00:00.000Z",12,FALSE,22,38017686,"G-F",12,12,"Indiana Pacers","Bennedict Mathurin",0,4,5,3,3,4.9
2,0,0,0,0,1,0,2,1,"07",0,0,1,0,0,1,1037983,"2023-12-23T00:00:00.000Z",12,FALSE,22,304,"G",12,12,"Indiana Pacers","T.J. McConnell",0,1,3,3,2,3
2,0,2,4,1,5,1,0,0,"28",1,6,3,3,2,4,1037983,"2023-12-23T00:00:00.000Z",12,FALSE,22,3547250,"G-F",12,12,"Indiana Pacers","Aaron Nesmith",2,6,8,5,5,11.6
4,0,5,1,0,6,2,0,0,"17",3,1,4,8,0,1,1037983,"2023-12-23T00:00:00.000Z",12,FALSE,22,85,"F",22,22,"Orlando Magic","Wendell Carter Jr.",0,12,16,8,12,18.6
3,0,1,4,2,9,5,3,3,"35",0,2,15,1,2,3,1037983,"2023-12-23T00:00:00.000Z",12,FALSE,22,196,"G",22,22,"Orlando Magic","Gary Harris",2,16,19,18,4,23.7
2,1,3,0,0,3,2,4,4,"28",0,2,8,3,1,2,1037983,"2023-12-23T00:00:00.000Z",12,FALSE,22,56677827,"G",22,22,"Orlando Magic","Anthony Black",2,11,13,10,5,18.6
3,0,5,6,2,11,4,4,2,"24",1,3,12,6,1,0,1037983,"2023-12-23T00:00:00.000Z",12,FALSE,22,3547251,"G",22,22,"Orlando Magic","Cole Anthony",1,18,21,15,9,26.7
2,1,0,0,0,0,0,2,1,"11",1,1,1,1,2,2,1037983,"2023-12-23T00:00:00.000Z",12,FALSE,22,666442,"C",22,22,"Orlando Magic","Goga Bitadze",3,2,4,3,3,12.2
0,0,2,4,2,4,2,0,0,"21",1,3,6,3,1,1,1037983,"2023-12-23T00:00:00.000Z",12,FALSE,22,38017724,"G",22,22,"Orlando Magic","Caleb Houstan",1,9,9,6,3,11.6
1,3,1,1,0,3,2,0,0,"12",0,0,4,1,0,0,1037983,"2023-12-23T00:00:00.000Z",12,FALSE,22,229,"F",22,22,"Orlando Magic","Jonathan Isaac",3,5,6,5,2,15.7
0,0,0,0,0,0,0,0,0,"00",0,0,0,0,0,0,1037983,"2023-12-23T00:00:00.000Z",12,FALSE,22,666818,"F",22,22,"Orlando Magic","Chuma Okeke",0,0,0,0,0,0
0,0,0,0,0,0,0,0,0,"00",0,0,0,0,0,0,1037983,"2023-12-23T00:00:00.000Z",12,FALSE,22,666885,"F",22,22,"Orlando Magic","Admiral Schofield",0,0,0,0,0,0
3,0,1,0,0,3,3,4,3,"20",2,1,9,3,0,0,1037983,"2023-12-23T00:00:00.000Z",12,FALSE,22,462,"C",22,22,"Orlando Magic","Moritz Wagner",0,12,15,12,6,17.1
0,0,0,0,0,0,0,0,0,"00",0,0,0,0,0,0,1037983,"2023-12-23T00:00:00.000Z",12,FALSE,22,165,"G",22,22,"Orlando Magic","Markelle Fultz",0,0,0,0,0,0
0,0,0,0,0,0,0,0,0,"00",0,0,0,0,0,0,1037983,"2023-12-23T00:00:00.000Z",12,FALSE,22,38017607,"G",22,22,"Orlando Magic","Kevon Harris",0,0,0,0,0,0
0,0,0,0,0,0,0,0,0,"00",0,0,0,0,0,0,1037983,"2023-12-23T00:00:00.000Z",12,FALSE,22,56677839,"G",22,22,"Orlando Magic","Jett Howard",0,0,0,0,0,0
0,0,0,0,0,0,0,0,0,"00",0,0,0,0,0,0,1037983,"2023-12-23T00:00:00.000Z",12,FALSE,22,226,"F",22,22,"Orlando Magic","Joe Ingles",0,0,0,0,0,0
0,0,0,0,0,0,0,0,0,"00",0,0,0,0,0,0,1037983,"2023-12-23T00:00:00.000Z",12,FALSE,22,3547207,"F",12,12,"Indiana Pacers","Jordan Nwora",0,0,0,0,0,0
0,0,0,0,0,0,0,0,0,"00",0,0,0,0,0,0,1037983,"2023-12-23T00:00:00.000Z",12,FALSE,22,56677861,"G",12,12,"Indiana Pacers","Ben Sheppard",0,0,0,0,0,0
1,0,1,4,3,5,4,1,0,"15",1,5,11,2,0,2,1037983,"2023-12-23T00:00:00.000Z",12,FALSE,22,3547264,"F-C",12,12,"Indiana Pacers","Jalen Smith",0,13,14,12,3,12.9
0,0,0,0,0,0,0,0,0,"00",0,0,0,0,0,0,1037983,"2023-12-23T00:00:00.000Z",12,FALSE,22,56677832,"F",12,12,"Indiana Pacers","Jarace Walker",0,0,0,0,0,0
0,0,0,0,0,0,0,0,0,"00",0,0,0,0,0,0,1037983,"2023-12-23T00:00:00.000Z",12,FALSE,22,38017701,"G",12,12,"Indiana Pacers","Kendall Brown",0,0,0,0,0,0
0,0,0,0,0,0,0,0,0,"00",0,0,0,0,0,0,1037983,"2023-12-23T00:00:00.000Z",12,FALSE,22,56677778,"F-C",12,12,"Indiana Pacers","Oscar Tshiebwe",0,0,0,0,0,0
0,0,0,0,0,0,0,0,0,"00",0,0,0,0,0,0,1037983,"2023-12-23T00:00:00.000Z",12,FALSE,22,56677794,"G",12,12,"Indiana Pacers","Isaiah Wong",0,0,0,0,0,0
0,0,5,2,0,14,8,8,8,"36",1,4,24,6,1,1,1037983,"2023-12-23T00:00:00.000Z",12,FALSE,22,17896026,"F",22,22,"Orlando Magic","Franz Wagner",1,30,30,24,6,33.2
4,0,6,0,0,20,11,16,12,"36",1,1,34,7,1,3,1037983,"2023-12-23T00:00:00.000Z",12,FALSE,22,38017683,"F",22,22,"Orlando Magic","Paolo Banchero",1,41,45,38,11,48.4
0,0,0,0,0,0,0,0,0,"00",0,0,0,0,0,0,1037983,"2023-12-23T00:00:00.000Z",12,FALSE,22,17553983,"G",22,22,"Orlando Magic","Trevelin Queen",0,0,0,0,0,0
0,0,0,0,0,0,0,0,0,"00",0,0,0,0,0,0,1037983,"2023-12-23T00:00:00.000Z",12,FALSE,22,17896073,"G",22,22,"Orlando Magic","Jalen Suggs",0,0,0,0,0,0
0,0,0,0,0,0,0,0,0,"00",0,0,0,0,0,0,1037984,"2023-12-23T00:00:00.000Z",19,FALSE,11,17896017,"F",19,19,"New Orleans Pelicans","Matt Ryan",0,0,0,0,0,0
0,0,2,2,0,11,4,0,0,"20",2,5,8,4,2,0,1037984,"2023-12-23T00:00:00.000Z",19,FALSE,11,38017695,"F",11,11,"Houston Rockets","Tari Eason",2,12,12,8,4,18.8
2,0,2,1,0,3,1,0,0,"21",1,1,2,3,0,0,1037984,"2023-12-23T00:00:00.000Z",19,FALSE,11,188,"F",11,11,"Houston Rockets","Jeff Green",0,5,7,4,5,8.6
0,0,0,0,0,0,0,0,0,"00",0,0,0,0,0,0,1037984,"2023-12-23T00:00:00.000Z",19,FALSE,11,3547281,"G-F",11,11,"Houston Rockets","Nate Hinton",0,0,0,0,0,0
1,0,1,2,1,2,1,2,2,"15",0,0,5,1,1,1,1037984,"2023-12-23T00:00:00.000Z",19,FALSE,11,213,"G",11,11,"Houston Rockets","Aaron Holiday",1,6,7,6,2,9.7
0,0,0,0,0,0,0,0,0,"00",0,0,0,0,0,0,1037984,"2023-12-23T00:00:00.000Z",19,FALSE,11,19465326,"C",11,11,"Houston Rockets","Jock Landale",0,0,0,0,0,0
5,2,2,2,0,12,6,9,7,"36",1,2,19,3,0,0,1037984,"2023-12-23T00:00:00.000Z",19,FALSE,11,227,"F",19,19,"New Orleans Pelicans","Brandon Ingram",2,22,27,24,8,36.1
4,1,6,2,1,16,11,10,5,"34",2,1,28,8,2,3,1037984,"2023-12-23T00:00:00.000Z",19,FALSE,11,666969,"F",19,19,"New Orleans Pelicans","Zion Williamson",3,36,40,32,12,49.6
5,1,9,2,0,11,5,0,0,"26",2,6,10,11,2,6,1037984,"2023-12-23T00:00:00.000Z",19,FALSE,11,455,"C",19,19,"New Orleans Pelicans","Jonas Valanciunas",3,21,26,15,16,33.7
1,0,0,4,2,8,2,0,0,"18",3,1,6,3,0,0,1037984,"2023-12-23T00:00:00.000Z",19,FALSE,11,17896024,"F",19,19,"New Orleans Pelicans","Herbert Jones",0,9,10,7,4,11.1
2,1,4,7,2,10,4,4,3,"34",1,4,13,5,1,4,1037984,"2023-12-23T00:00:00.000Z",19,FALSE,11,303,"G",19,19,"New Orleans Pelicans","CJ McCollum",2,18,20,15,7,24
0,1,2,2,0,4,2,0,0,"10",0,3,4,2,0,1,1037984,"2023-12-23T00:00:00.000Z",19,FALSE,11,17896097,"G",19,19,"New Orleans Pelicans","Jose Alvarado",1,6,6,4,2,8.4
0,0,1,2,0,3,0,0,0,"14",2,0,0,3,0,1,1037984,"2023-12-23T00:00:00.000Z",19,FALSE,11,38017677,"G",19,19,"New Orleans Pelicans","Dyson Daniels",0,3,3,0,3,2.6
0,0,0,0,0,0,0,0,0,"00",0,0,0,0,0,0,1037984,"2023-12-23T00:00:00.000Z",19,FALSE,11,56677837,"G",19,19,"New Orleans Pelicans","Jordan Hawkins",0,0,0,0,0,0
0,0,0,0,0,0,0,0,0,"00",0,0,0,0,0,0,1037984,"2023-12-23T00:00:00.000Z",19,FALSE,11,3547260,"G",19,19,"New Orleans Pelicans","Kira Lewis Jr.",0,0,0,0,0,0
2,0,1,0,0,2,2,3,2,"12",1,1,6,2,0,0,1037984,"2023-12-23T00:00:00.000Z",19,FALSE,11,3547293,"F",19,19,"New Orleans Pelicans","Naji Marshall",0,8,10,8,4,11.4
0,0,5,7,3,11,4,3,3,"34",1,2,14,6,2,1,1037984,"2023-12-23T00:00:00.000Z",19,FALSE,11,18677986,"F",19,19,"New Orleans Pelicans","Trey Murphy III",2,20,20,14,6,26.2
2,1,3,3,0,5,2,0,0,"22",0,2,4,3,2,0,1037984,"2023-12-23T00:00:00.000Z",19,FALSE,11,17896021,"F",19,19,"New Orleans Pelicans","Jeremiah Robinson-Earl",3,7,9,6,5,19.6
0,0,0,0,0,0,0,0,0,"00",0,0,0,0,0,0,1037984,"2023-12-23T00:00:00.000Z",19,FALSE,11,38017663,"F",19,19,"New Orleans Pelicans","E.J. Liddell",0,0,0,0,0,0
0,0,0,0,0,0,0,0,0,"00",0,0,0,0,0,0,1037984,"2023-12-23T00:00:00.000Z",19,FALSE,11,340,"F",19,19,"New Orleans Pelicans","Larry Nance Jr.",0,0,0,0,0,0
0,0,0,0,0,0,0,0,0,"00",0,0,0,0,0,0,1037984,"2023-12-23T00:00:00.000Z",19,FALSE,11,38017726,"G",19,19,"New Orleans Pelicans","Dereon Seabron",0,0,0,0,0,0
0,0,0,0,0,0,0,0,0,"00",0,0,0,0,0,0,1037984,"2023-12-23T00:00:00.000Z",19,FALSE,11,491,"C",19,19,"New Orleans Pelicans","Cody Zeller",0,0,0,0,0,0
5,0,5,4,1,7,2,0,0,"28",0,3,5,5,1,0,1037984,"2023-12-23T00:00:00.000Z",19,FALSE,11,66,"G-F",11,11,"Houston Rockets","Dillon Brooks",1,10,15,10,10,21.5
2,1,7,5,4,14,10,3,2,"37",4,3,26,11,1,1,1037984,"2023-12-23T00:00:00.000Z",19,FALSE,11,38017684,"F",11,11,"Houston Rockets","Jabari Smith Jr.",2,37,39,28,13,47.2
6,1,7,1,1,21,11,17,14,"38",4,4,37,11,1,2,1037984,"2023-12-23T00:00:00.000Z",19,FALSE,11,17896062,"F-C",11,11,"Houston Rockets","Alperen Sengun",2,48,54,43,17,63.2
2,0,4,4,0,8,2,6,5,"23",0,1,9,4,1,6,1037984,"2023-12-23T00:00:00.000Z",19,FALSE,11,17895966,"G",11,11,"Houston Rockets","Jalen Green",1,13,15,11,6,13.8
3,0,0,7,2,11,3,3,2,"36",0,1,10,0,1,1,1037984,"2023-12-23T00:00:00.000Z",19,FALSE,11,458,"G",11,11,"Houston Rockets","Fred VanVleet",1,10,13,13,3,16.5
0,0,0,0,0,0,0,0,0,"00",0,0,0,0,0,0,1037984,"2023-12-23T00:00:00.000Z",19,FALSE,11,296,"C",11,11,"Houston Rockets","Boban Marjanovic",0,0,0,0,0,0
0,0,0,0,0,0,0,0,0,"00",0,0,0,0,0,0,1037984,"2023-12-23T00:00:00.000Z",19,FALSE,11,56677809,"F",11,11,"Houston Rockets","Jermaine Samuels Jr.",0,0,0,0,0,0
0,0,3,2,0,4,1,0,0,"11",2,2,2,5,0,0,1037984,"2023-12-23T00:00:00.000Z",19,FALSE,11,3547301,"F",11,11,"Houston Rockets","Jae'Sean Tate",0,7,7,2,5,8
0,0,0,1,0,1,0,4,2,"11",0,0,2,0,1,0,1037984,"2023-12-23T00:00:00.000Z",19,FALSE,11,56677825,"G-F",11,11,"Houston Rockets","Amen Thompson",1,2,2,2,0,5
0,0,0,0,0,0,0,0,0,"00",0,0,0,0,0,0,1037984,"2023-12-23T00:00:00.000Z",19,FALSE,11,56677831,"F",11,11,"Houston Rockets","Cam Whitmore",0,0,0,0,0,0
0,0,0,0,0,0,0,0,0,"00",0,0,0,0,0,0,1037984,"2023-12-23T00:00:00.000Z",19,FALSE,11,75,"G-F",11,11,"Houston Rockets","Reggie Bullock",0,0,0,0,0,0
0,0,0,0,0,0,0,0,0,"00",0,0,0,0,0,0,1037984,"2023-12-23T00:00:00.000Z",19,FALSE,11,357,"G",11,11,"Houston Rockets","Victor Oladipo",0,0,0,0,0,0
0,0,0,0,0,0,0,0,0,"00",0,0,0,0,0,0,1037984,"2023-12-23T00:00:00.000Z",19,FALSE,11,47738533,"G",11,11,"Houston Rockets","Jeenathan Williams",0,0,0,0,0,0
1,0,1,2,0,3,0,0,0,"14",0,3,0,1,1,0,1037985,"2023-12-23T00:00:00.000Z",1,FALSE,15,666754,"G",1,1,"Atlanta Hawks","Garrison Mathews",1,1,2,1,2,5.7
2,0,5,9,3,11,4,4,3,"38",1,2,14,6,2,1,1037985,"2023-12-23T00:00:00.000Z",1,FALSE,15,3547256,"F",1,1,"Atlanta Hawks","Saddiq Bey",2,20,22,16,8,29.2
1,2,7,0,0,11,8,4,4,"30",5,2,20,12,0,1,1037985,"2023-12-23T00:00:00.000Z",1,FALSE,15,83,"C",1,1,"Atlanta Hawks","Clint Capela",2,32,33,21,13,40.9
4,0,3,6,4,15,10,2,2,"36",1,4,26,4,2,3,1037985,"2023-12-23T00:00:00.000Z",1,FALSE,15,334,"G",1,1,"Atlanta Hawks","Dejounte Murray",2,30,34,30,8,39.8
13,1,5,10,3,24,11,7,5,"41",0,3,30,5,1,2,1037985,"2023-12-23T00:00:00.000Z",1,FALSE,15,490,"G",1,1,"Atlanta Hawks","Trae Young",2,35,48,43,18,59.5
3,0,3,8,2,15,6,3,2,"34",1,2,16,4,0,0,1037985,"2023-12-23T00:00:00.000Z",1,FALSE,15,53,"G",1,1,"Atlanta Hawks","Bogdan Bogdanovic",0,20,23,19,7,25.3
0,0,0,0,0,0,0,0,0,"00",0,0,0,0,0,0,1037985,"2023-12-23T00:00:00.000Z",1,FALSE,15,56677838,"G",1,1,"Atlanta Hawks","Kobe Bufkin",0,0,0,0,0,0
0,0,0,0,0,0,0,0,0,"00",0,0,0,0,0,0,1037985,"2023-12-23T00:00:00.000Z",1,FALSE,15,666564,"F",1,1,"Atlanta Hawks","Bruno Fernando",0,0,0,0,0,0
0,0,1,6,1,7,1,0,0,"19",1,2,3,2,0,0,1037985,"2023-12-23T00:00:00.000Z",1,FALSE,15,56677855,"G",1,1,"Atlanta Hawks","Seth Lundy",0,5,5,3,2,5.4
4,2,3,2,0,10,5,0,0,"28",4,4,10,7,2,3,1037985,"2023-12-23T00:00:00.000Z",1,FALSE,15,3547244,"F-C",1,1,"Atlanta Hawks","Onyeka Okongwu",4,17,21,14,11,33.4
0,0,0,2,1,10,8,4,3,"24",2,5,20,2,0,2,1037985,"2023-12-23T00:00:00.000Z",1,FALSE,15,231,"F-C",15,15,"Memphis Grizzlies","Jaren Jackson Jr.",0,22,22,20,2,20.4
3,0,4,0,0,6,3,6,2,"29",7,2,8,11,1,1,1037985,"2023-12-23T00:00:00.000Z",1,FALSE,15,48,"C",15,15,"Memphis Grizzlies","Bismack Biyombo",1,19,22,11,14,27.7
6,0,6,14,5,25,13,6,6,"36",0,0,37,6,1,2,1037985,"2023-12-23T00:00:00.000Z",1,FALSE,15,3547287,"G",15,15,"Memphis Grizzlies","Desmond Bane",1,43,49,43,12,54.2
11,2,6,3,1,25,14,1,1,"36",0,1,30,6,1,3,1037985,"2023-12-23T00:00:00.000Z",1,FALSE,15,666786,"G",15,15,"Memphis Grizzlies","Ja Morant",3,36,47,41,17,59.7
3,1,4,4,1,7,2,2,1,"27",0,0,6,4,0,1,1037985,"2023-12-23T00:00:00.000Z",1,FALSE,15,17896067,"F",15,15,"Memphis Grizzlies","Santi Aldama",1,10,13,9,7,17.3
2,2,4,2,1,3,2,0,0,"13",1,1,5,5,0,0,1037985,"2023-12-23T00:00:00.000Z",1,FALSE,15,666703,"G-F",15,15,"Memphis Grizzlies","John Konchar",2,10,12,7,7,20
3,0,2,3,1,8,3,3,1,"24",1,3,8,3,0,1,1037985,"2023-12-23T00:00:00.000Z",1,FALSE,15,17896027,"G-F",15,15,"Memphis Grizzlies","Ziaire Williams",0,11,14,11,6,15.1
0,0,0,0,0,0,0,0,0,"00",0,0,0,0,0,0,1037985,"2023-12-23T00:00:00.000Z",1,FALSE,15,254,"G",15,15,"Memphis Grizzlies","Luke Kennard",0,0,0,0,0,0
0,0,0,0,0,0,0,0,0,"00",0,0,0,0,0,0,1037985,"2023-12-23T00:00:00.000Z",1,FALSE,15,401,"G",15,15,"Memphis Grizzlies","Derrick Rose",0,0,0,0,0,0
0,0,0,0,0,0,0,0,0,"00",0,0,0,0,0,0,1037985,"2023-12-23T00:00:00.000Z",1,FALSE,15,420,"G",15,15,"Memphis Grizzlies","Marcus Smart",0,0,0,0,0,0
0,0,0,0,0,0,0,0,0,"00",0,0,0,0,0,0,1037985,"2023-12-23T00:00:00.000Z",1,FALSE,15,56677830,"F",15,15,"Memphis Grizzlies","GG Jackson",0,0,0,0,0,0
0,0,0,0,0,0,0,0,0,"00",0,0,0,0,0,0,1037985,"2023-12-23T00:00:00.000Z",1,FALSE,15,38017728,"F",15,15,"Memphis Grizzlies","Jake LaRavia",0,0,0,0,0,0
0,0,0,0,0,0,0,0,0,"00",0,0,0,0,0,0,1037985,"2023-12-23T00:00:00.000Z",1,FALSE,15,38017729,"F",15,15,"Memphis Grizzlies","David Roddy",0,0,0,0,0,0
0,0,0,0,0,0,0,0,0,"00",0,0,0,0,0,0,1037985,"2023-12-23T00:00:00.000Z",1,FALSE,15,3,"C",15,15,"Memphis Grizzlies","Steven Adams",0,0,0,0,0,0
0,0,0,0,0,0,0,0,0,"00",0,0,0,0,0,0,1037985,"2023-12-23T00:00:00.000Z",1,FALSE,15,666505,"F",15,15,"Memphis Grizzlies","Brandon Clarke",0,0,0,0,0,0
0,2,1,0,0,7,3,0,0,"16",2,0,6,3,1,0,1037985,"2023-12-23T00:00:00.000Z",1,FALSE,15,3547285,"F",15,15,"Memphis Grizzlies","Xavier Tillman",3,9,9,6,3,18.6
0,0,0,0,0,0,0,0,0,"00",0,0,0,0,0,0,1037985,"2023-12-23T00:00:00.000Z",1,FALSE,15,48248287,"G",15,15,"Memphis Grizzlies","Jacob Gilyard",0,0,0,0,0,0
0,0,0,0,0,0,0,0,0,"00",0,0,0,0,0,0,1037985,"2023-12-23T00:00:00.000Z",1,FALSE,15,3547297,"G",1,1,"Atlanta Hawks","Trent Forrest",0,0,0,0,0,0
0,0,0,0,0,0,0,0,0,"00",0,0,0,0,0,0,1037985,"2023-12-23T00:00:00.000Z",1,FALSE,15,4197387,"G",1,1,"Atlanta Hawks","Vit Krejci",0,0,0,0,0,0
0,0,0,0,0,0,0,0,0,"00",0,0,0,0,0,0,1037985,"2023-12-23T00:00:00.000Z",1,FALSE,15,301,"G-F",1,1,"Atlanta Hawks","Wesley Matthews",0,0,0,0,0,0
0,0,0,0,0,0,0,0,0,"00",0,0,0,0,0,0,1037985,"2023-12-23T00:00:00.000Z",1,FALSE,15,319,"G",1,1,"Atlanta Hawks","Patty Mills",0,0,0,0,0,0
0,0,0,0,0,0,0,0,0,"00",0,0,0,0,0,0,1037985,"2023-12-23T00:00:00.000Z",1,FALSE,15,38017689,"F",1,1,"Atlanta Hawks","AJ Griffin",0,0,0,0,0,0
0,0,0,0,0,0,0,0,0,"00",0,0,0,0,0,0,1037985,"2023-12-23T00:00:00.000Z",1,FALSE,15,56677806,"F",1,1,"Atlanta Hawks","Mouhamed Gueye",0,0,0,0,0,0
0,0,0,0,0,0,0,0,0,"00",0,0,0,0,0,0,1037985,"2023-12-23T00:00:00.000Z",1,FALSE,15,666656,"F",1,1,"Atlanta Hawks","De'Andre Hunter",0,0,0,0,0,0
0,0,0,0,0,0,0,0,0,"00",0,0,0,0,0,0,1037985,"2023-12-23T00:00:00.000Z",1,FALSE,15,17896040,"F",1,1,"Atlanta Hawks","Jalen Johnson",0,0,0,0,0,0
1,0,9,5,1,6,2,0,0,"35",2,4,5,11,2,1,1037985,"2023-12-23T00:00:00.000Z",1,FALSE,15,38017731,"G",15,15,"Memphis Grizzlies","Vince Williams Jr.",2,16,17,6,12,24.7
7,1,4,4,1,17,9,10,10,"33",2,2,29,6,1,1,1037986,"2023-12-23T00:00:00.000Z",3,FALSE,9,61,"F",3,3,"Brooklyn Nets","Mikal Bridges",2,35,42,36,13,51.7
2,0,2,5,2,10,6,4,4,"28",0,3,18,2,2,1,1037986,"2023-12-23T00:00:00.000Z",3,FALSE,9,666679,"F",3,3,"Brooklyn Nets","Cameron Johnson",2,20,22,20,4,28.4
2,2,5,0,0,8,4,4,3,"30",2,2,11,7,2,2,1037986,"2023-12-23T00:00:00.000Z",3,FALSE,9,666508,"F-C",3,3,"Brooklyn Nets","Nicolas Claxton",4,18,20,13,9,32.4
3,0,2,3,1,16,7,5,5,"28",0,3,20,2,1,2,1037986,"2023-12-23T00:00:00.000Z",3,FALSE,9,17896048,"G",3,3,"Brooklyn Nets","Cam Thomas",1,22,25,23,5,27.9
7,0,3,5,2,12,5,4,2,"30",1,1,14,4,1,1,1037986,"2023-12-23T00:00:00.000Z",3,FALSE,9,130,"G",3,3,"Brooklyn Nets","Spencer Dinwiddie",1,18,25,21,11,31.3
1,0,6,4,2,6,4,0,0,"27",0,1,10,6,2,0,1037986,"2023-12-23T00:00:00.000Z",3,FALSE,9,158,"F",3,3,"Brooklyn Nets","Dorian Finney-Smith",2,16,17,11,7,24.7
0,0,0,0,0,0,0,0,0,"00",0,0,0,0,0,0,1037986,"2023-12-23T00:00:00.000Z",3,FALSE,9,56677843,"F",3,3,"Brooklyn Nets","Noah Clowney",0,0,0,0,0,0
0,0,0,0,0,0,0,0,0,"00",0,0,0,0,0,0,1037986,"2023-12-23T00:00:00.000Z",3,FALSE,9,17896041,"G",3,3,"Brooklyn Nets","Keon Johnson",0,0,0,0,0,0
0,0,0,0,0,0,0,0,0,"00",0,0,0,0,0,0,1037986,"2023-12-23T00:00:00.000Z",3,FALSE,9,417,"G-F",3,3,"Brooklyn Nets","Ben Simmons",0,0,0,0,0,0
0,0,0,0,0,0,0,0,0,"00",0,0,0,0,0,0,1037986,"2023-12-23T00:00:00.000Z",3,FALSE,9,464,"G",3,3,"Brooklyn Nets","Lonnie Walker IV",0,0,0,0,0,0
0,0,0,0,0,0,0,0,0,"00",0,0,0,0,0,0,1037986,"2023-12-23T00:00:00.000Z",3,FALSE,9,56677841,"F",3,3,"Brooklyn Nets","Dariq Whitehead",0,0,0,0,0,0
2,0,4,3,1,7,2,3,2,"31",1,2,7,5,1,0,1037986,"2023-12-23T00:00:00.000Z",3,FALSE,9,56677826,"G-F",9,9,"Detroit Pistons","Ausar Thompson",1,12,14,9,7,19
4,0,6,7,2,13,5,9,7,"39",2,4,19,8,2,4,1037986,"2023-12-23T00:00:00.000Z",3,FALSE,9,54,"F",9,9,"Detroit Pistons","Bojan Bogdanovic",2,27,31,23,12,36.6
0,0,3,0,0,4,2,2,1,"15",2,0,5,5,0,1,1037986,"2023-12-23T00:00:00.000Z",3,FALSE,9,24,"F",9,9,"Detroit Pistons","Marvin Bagley III",0,10,10,5,5,10
2,0,1,5,1,8,2,0,0,"17",0,2,5,1,1,1,1037986,"2023-12-23T00:00:00.000Z",3,FALSE,9,77,"G",9,9,"Detroit Pistons","Alec Burks",1,6,8,7,3,11.2
0,0,1,0,0,0,0,0,0,"07",0,0,0,1,0,0,1037986,"2023-12-23T00:00:00.000Z",3,FALSE,9,197,"F-G",9,9,"Detroit Pistons","Joe Harris",0,1,1,0,1,1.2
0,0,0,0,0,0,0,0,0,"00",0,0,0,0,0,0,1037986,"2023-12-23T00:00:00.000Z",3,FALSE,9,3547241,"G",9,9,"Detroit Pistons","Killian Hayes",0,0,0,0,0,0
0,0,0,0,0,0,0,0,0,"01",0,0,0,0,0,0,1037986,"2023-12-23T00:00:00.000Z",3,FALSE,9,174,"F-C",3,3,"Brooklyn Nets","Harry Giles III",0,0,0,0,0,0
5,0,6,1,1,3,2,0,0,"19",0,1,5,6,1,1,1037986,"2023-12-23T00:00:00.000Z",3,FALSE,9,351,"F",3,3,"Brooklyn Nets","Royce O'Neale",1,11,16,10,11,21.7
1,0,2,0,0,6,5,3,1,"18",1,4,11,3,0,1,1037986,"2023-12-23T00:00:00.000Z",3,FALSE,9,17896038,"C",3,3,"Brooklyn Nets","Day'Ron Sharpe",0,14,15,12,4,15.1
3,0,0,2,1,6,2,2,1,"19",0,3,6,0,0,1,1037986,"2023-12-23T00:00:00.000Z",3,FALSE,9,421,"G",3,3,"Brooklyn Nets","Dennis Smith Jr.",0,6,9,9,3,9.5
0,0,0,0,0,0,0,0,0,"01",0,0,0,0,0,0,1037986,"2023-12-23T00:00:00.000Z",3,FALSE,9,17896058,"F",3,3,"Brooklyn Nets","Trendon Watford",0,0,0,0,0,0
1,0,1,0,0,2,1,0,0,"06",1,2,2,2,0,0,1037986,"2023-12-23T00:00:00.000Z",3,FALSE,9,56677722,"F",3,3,"Brooklyn Nets","Jalen Wilson",0,4,5,3,3,5.9
0,0,0,0,0,0,0,0,0,"00",0,0,0,0,0,0,1037986,"2023-12-23T00:00:00.000Z",3,FALSE,9,9051997,"G",3,3,"Brooklyn Nets","Armoni Brooks",0,0,0,0,0,0
0,0,0,0,0,0,0,0,0,"00",0,0,0,0,0,0,1037986,"2023-12-23T00:00:00.000Z",3,FALSE,9,38017694,"C",9,9,"Detroit Pistons","Jalen Duren",0,0,0,0,0,0
0,0,0,0,0,0,0,0,0,"00",0,0,0,0,0,0,1037986,"2023-12-23T00:00:00.000Z",3,FALSE,9,330,"G",9,9,"Detroit Pistons","Monte Morris",0,0,0,0,0,0
0,0,0,0,0,0,0,0,0,"00",0,0,0,0,0,0,1037986,"2023-12-23T00:00:00.000Z",3,FALSE,9,42097199,"G",9,9,"Detroit Pistons","Jared Rhoden",0,0,0,0,0,0
0,0,0,0,0,0,0,0,0,"00",0,0,0,0,0,0,1037986,"2023-12-23T00:00:00.000Z",3,FALSE,9,44477024,"G",9,9,"Detroit Pistons","Stanley Umude",0,0,0,0,0,0
0,0,1,3,3,6,5,1,1,"24",0,2,14,1,0,0,1037986,"2023-12-23T00:00:00.000Z",3,FALSE,9,259,"F",9,9,"Detroit Pistons","Kevin Knox",0,15,15,14,1,15.2
0,0,0,0,0,0,0,0,0,"00",0,0,0,0,0,0,1037986,"2023-12-23T00:00:00.000Z",3,FALSE,9,17896071,"F",9,9,"Detroit Pistons","Isaiah Livers",0,0,0,0,0,0
0,0,1,1,0,1,0,0,0,"06",0,2,0,1,0,2,1037986,"2023-12-23T00:00:00.000Z",3,FALSE,9,56677792,"G",9,9,"Detroit Pistons","Marcus Sasser",0,1,1,0,1,-0.8
0,0,0,0,0,0,0,0,0,"00",0,0,0,0,0,0,1037986,"2023-12-23T00:00:00.000Z",3,FALSE,9,3547240,"C",9,9,"Detroit Pistons","James Wiseman",0,0,0,0,0,0
0,0,0,0,0,0,0,0,0,"00",0,0,0,0,0,0,1037986,"2023-12-23T00:00:00.000Z",3,FALSE,9,56677729,"G",9,9,"Detroit Pistons","Malcolm Cazalon",0,0,0,0,0,0
5,1,4,5,4,9,8,0,0,"33",1,5,20,5,1,0,1037986,"2023-12-23T00:00:00.000Z",3,FALSE,9,3547267,"F-C",9,9,"Detroit Pistons","Isaiah Stewart",2,25,30,25,10,39.5
7,2,6,6,3,11,6,10,8,"35",0,4,23,6,0,3,1037986,"2023-12-23T00:00:00.000Z",3,FALSE,9,38017682,"G",9,9,"Detroit Pistons","Jaden Ivey",2,29,36,30,13,43.7
6,0,3,5,1,20,9,4,3,"33",0,4,22,3,0,2,1037986,"2023-12-23T00:00:00.000Z",3,FALSE,9,17896075,"G-F",9,9,"Detroit Pistons","Cade Cunningham",0,25,31,28,9,32.6
6,0,2,3,1,3,1,0,0,"14",0,1,3,2,0,0,1037987,"2023-12-23T00:00:00.000Z",28,FALSE,29,3547275,"G",28,28,"Toronto Raptors","Malachi Flynn",0,5,11,9,8,14.4
0,0,0,0,0,0,0,0,0,"00",0,0,0,0,0,0,1037987,"2023-12-23T00:00:00.000Z",28,FALSE,29,666762,"F",28,28,"Toronto Raptors","Jalen McDaniels",0,0,0,0,0,0
0,0,0,0,0,0,0,0,0,"00",0,0,0,0,0,0,1037987,"2023-12-23T00:00:00.000Z",28,FALSE,29,2309958,"C-F",15,28,"Toronto Raptors","Jontay Porter",0,0,0,0,0,0
0,0,0,0,0,0,0,0,0,"00",0,0,0,0,0,0,1037987,"2023-12-23T00:00:00.000Z",28,FALSE,29,376,"F",28,28,"Toronto Raptors","Otto Porter Jr.",0,0,0,0,0,0
0,0,0,0,0,0,0,0,0,"00",0,0,0,0,0,0,1037987,"2023-12-23T00:00:00.000Z",28,FALSE,29,436,"G-F",28,28,"Toronto Raptors","Garrett Temple",0,0,0,0,0,0
0,0,0,9,4,12,6,0,0,"28",0,0,16,0,1,2,1037987,"2023-12-23T00:00:00.000Z",28,FALSE,29,3089,"",28,28,"Toronto Raptors","Gary Trent Jr.",1,16,16,16,0,17
0,0,0,0,0,0,0,0,0,"00",0,0,0,0,0,0,1037987,"2023-12-23T00:00:00.000Z",28,FALSE,29,489,"F",28,28,"Toronto Raptors","Thaddeus Young",0,0,0,0,0,0
0,0,0,0,0,0,0,0,0,"00",0,0,0,0,0,0,1037987,"2023-12-23T00:00:00.000Z",28,FALSE,29,56677805,"G",28,28,"Toronto Raptors","Javon Freeman-Liberty",0,0,0,0,0,0
0,0,0,0,0,0,0,0,0,"00",0,0,0,0,0,0,1037987,"2023-12-23T00:00:00.000Z",28,FALSE,29,38017710,"C",28,28,"Toronto Raptors","Christian Koloko",0,0,0,0,0,0
7,1,11,8,4,23,12,4,4,"38",3,4,32,14,0,4,1037987,"2023-12-23T00:00:00.000Z",28,FALSE,29,17896055,"G-F",28,28,"Toronto Raptors","Scottie Barnes",1,46,53,39,21,58.3
6,0,6,2,0,20,7,6,5,"36",3,4,19,9,1,1,1037987,"2023-12-23T00:00:00.000Z",28,FALSE,29,416,"F",28,28,"Toronto Raptors","Pascal Siakam",1,28,34,25,15,40.8
3,2,2,0,0,4,1,0,0,"21",2,2,2,4,0,0,1037987,"2023-12-23T00:00:00.000Z",28,FALSE,29,373,"C",28,28,"Toronto Raptors","Jakob Poeltl",2,6,9,5,7,17.3
4,0,1,3,2,13,8,1,1,"36",1,1,19,2,2,0,1037987,"2023-12-23T00:00:00.000Z",28,FALSE,29,18,"F",28,28,"Toronto Raptors","OG Anunoby",2,21,25,23,6,33.4
7,0,2,3,1,9,4,3,2,"33",1,2,11,3,3,4,1037987,"2023-12-23T00:00:00.000Z",28,FALSE,29,409,"G",28,28,"Toronto Raptors","Dennis Schroder",3,14,21,18,10,30.1
1,2,1,3,0,7,3,2,2,"21",1,1,8,2,0,0,1037987,"2023-12-23T00:00:00.000Z",28,FALSE,29,3547249,"F",28,28,"Toronto Raptors","Precious Achiuwa",2,10,11,9,3,17.9
1,0,2,1,1,3,3,3,2,"13",0,2,9,2,1,0,1037987,"2023-12-23T00:00:00.000Z",28,FALSE,29,58,"F",28,28,"Toronto Raptors","Chris Boucher",1,11,12,10,3,15.9
0,0,0,0,0,0,0,0,0,"00",0,0,0,0,0,0,1037987,"2023-12-23T00:00:00.000Z",28,FALSE,29,56677828,"G",28,28,"Toronto Raptors","Gradey Dick",0,0,0,0,0,0
0,0,0,0,0,0,0,0,0,"00",0,0,0,0,0,0,1037987,"2023-12-23T00:00:00.000Z",28,FALSE,29,56677869,"G",28,28,"Toronto Raptors","Markquis Nowell",0,0,0,0,0,0
5,0,7,10,4,21,12,2,2,"39",2,2,30,9,3,1,1037987,"2023-12-23T00:00:00.000Z",28,FALSE,29,297,"F",29,29,"Utah Jazz","Lauri Markkanen",3,39,44,35,14,56.3
7,1,4,3,1,5,3,0,0,"16",0,4,7,4,0,0,1037987,"2023-12-23T00:00:00.000Z",28,FALSE,29,358,"F",29,29,"Utah Jazz","Kelly Olynyk",1,11,18,14,11,25.3
0,0,4,2,2,7,4,0,0,"27",1,2,10,5,0,0,1037987,"2023-12-23T00:00:00.000Z",28,FALSE,29,101,"F-C",29,29,"Utah Jazz","John Collins",0,15,15,10,5,16
3,0,0,2,1,11,5,6,5,"25",0,0,16,0,1,1,1037987,"2023-12-23T00:00:00.000Z",28,FALSE,29,413,"G",29,29,"Utah Jazz","Collin Sexton",1,16,19,19,3,22.5
13,1,8,6,2,11,3,0,0,"34",0,1,8,8,1,2,1037987,"2023-12-23T00:00:00.000Z",28,FALSE,29,139,"G",29,29,"Utah Jazz","Kris Dunn",2,16,29,21,21,41.1
0,1,3,3,1,5,3,2,2,"24",0,2,9,3,0,1,1037987,"2023-12-23T00:00:00.000Z",28,FALSE,29,38017620,"G",29,29,"Utah Jazz","Ochai Agbaji",1,12,12,9,3,14.6
6,0,2,9,4,22,11,4,4,"30",1,1,30,3,1,2,1037987,"2023-12-23T00:00:00.000Z",28,FALSE,29,100,"G",29,29,"Utah Jazz","Jordan Clarkson",1,33,39,36,9,43.6
0,0,0,3,2,3,2,0,0,"20",1,3,6,1,1,3,1037987,"2023-12-23T00:00:00.000Z",28,FALSE,29,38017739,"F",29,29,"Utah Jazz","Simone Fontecchio",1,7,7,6,1,7.2
0,0,0,0,0,0,0,0,0,"00",0,0,0,0,0,0,1037987,"2023-12-23T00:00:00.000Z",28,FALSE,29,56677824,"F",29,29,"Utah Jazz","Taylor Hendricks",0,0,0,0,0,0
0,0,0,0,0,0,0,0,0,"00",0,0,0,0,0,0,1037987,"2023-12-23T00:00:00.000Z",28,FALSE,29,38017630,"G",29,29,"Utah Jazz","Johnny Juzang",0,0,0,0,0,0
1,2,6,0,0,6,5,0,0,"25",3,2,10,9,0,2,1037987,"2023-12-23T00:00:00.000Z",28,FALSE,29,38017705,"C",29,29,"Utah Jazz","Walker Kessler",2,19,20,11,10,26.3
0,0,0,0,0,0,0,0,0,"00",0,0,0,0,0,0,1037987,"2023-12-23T00:00:00.000Z",28,FALSE,29,666881,"F",29,29,"Utah Jazz","Luka Samanic",0,0,0,0,0,0
0,0,0,0,0,0,0,0,0,"00",0,0,0,0,0,0,1037987,"2023-12-23T00:00:00.000Z",28,FALSE,29,56677842,"F",29,29,"Utah Jazz","Brice Sensabaugh",0,0,0,0,0,0
0,0,0,0,0,0,0,0,0,"00",0,0,0,0,0,0,1037987,"2023-12-23T00:00:00.000Z",28,FALSE,29,11891374,"C",29,29,"Utah Jazz","Omer Yurtseven",0,0,0,0,0,0
0,0,0,0,0,0,0,0,0,"00",0,0,0,0,0,0,1037987,"2023-12-23T00:00:00.000Z",28,FALSE,29,17896023,"G",29,29,"Utah Jazz","Josh Christopher",0,0,0,0,0,0
0,0,0,0,0,0,0,0,0,"00",0,0,0,0,0,0,1037987,"2023-12-23T00:00:00.000Z",28,FALSE,29,56677834,"G",29,29,"Utah Jazz","Keyonte George",0,0,0,0,0,0
0,0,0,0,0,0,0,0,0,"00",0,0,0,0,0,0,1037987,"2023-12-23T00:00:00.000Z",28,FALSE,29,666650,"G",29,29,"Utah Jazz","Talen Horton-Tucker",0,0,0,0,0,0
0,0,0,0,0,0,0,0,0,"00",0,0,0,0,0,0,1037987,"2023-12-23T00:00:00.000Z",28,FALSE,29,19465584,"F",29,29,"Utah Jazz","Micah Potter",0,0,0,0,0,0
8,0,5,3,1,14,6,9,8,"40",0,4,21,5,3,2,1037988,"2023-12-23T00:00:00.000Z",5,FALSE,6,125,"G",5,5,"Chicago Bulls","DeMar DeRozan",3,26,34,29,13,46
2,1,2,5,2,11,5,1,1,"35",0,3,13,2,0,2,1037988,"2023-12-23T00:00:00.000Z",5,FALSE,6,3547248,"F",5,5,"Chicago Bulls","Patrick Williams",1,15,17,15,4,19.4
4,1,11,5,2,11,7,4,4,"34",1,1,20,12,1,1,1037988,"2023-12-23T00:00:00.000Z",5,FALSE,6,460,"C",5,5,"Chicago Bulls","Nikola Vucevic",2,32,36,24,16,45.4
1,1,3,5,2,9,4,0,0,"32",1,3,10,4,0,0,1037988,"2023-12-23T00:00:00.000Z",5,FALSE,6,89,"G",5,5,"Chicago Bulls","Alex Caruso",1,14,15,11,5,19.3
7,1,4,8,0,19,8,1,1,"40",0,2,17,4,0,4,1037988,"2023-12-23T00:00:00.000Z",5,FALSE,6,666956,"G",5,5,"Chicago Bulls","Coby White",1,21,28,24,11,31.3
0,1,0,5,1,7,1,0,0,"09",0,1,3,0,0,1,1037988,"2023-12-23T00:00:00.000Z",5,FALSE,6,87,"G",5,5,"Chicago Bulls","Jevon Carter",1,3,3,3,0,5
0,0,0,0,0,0,0,0,0,"00",0,0,0,0,0,0,1037988,"2023-12-23T00:00:00.000Z",5,FALSE,6,110,"F",5,5,"Chicago Bulls","Torrey Craig",0,0,0,0,0,0
1,0,2,3,0,6,2,0,0,"20",1,3,4,3,0,1,1037988,"2023-12-23T00:00:00.000Z",5,FALSE,6,17895983,"G",5,5,"Chicago Bulls","Ayo Dosunmu",0,7,8,5,4,8.1
0,0,4,0,0,0,0,2,1,"13",2,4,1,6,1,1,1037988,"2023-12-23T00:00:00.000Z",5,FALSE,6,137,"C",5,5,"Chicago Bulls","Andre Drummond",1,7,7,1,6,10.2
0,0,0,0,0,0,0,0,0,"00",0,0,0,0,0,0,1037988,"2023-12-23T00:00:00.000Z",5,FALSE,6,56677857,"F",5,5,"Chicago Bulls","Julian Phillips",0,0,0,0,0,0
0,0,0,0,0,0,0,0,0,"00",0,0,0,0,0,0,1037988,"2023-12-23T00:00:00.000Z",5,FALSE,6,17896116,"G",5,5,"Chicago Bulls","Terry Taylor",0,0,0,0,0,0
0,0,1,1,0,3,2,2,2,"17",0,1,6,1,1,0,1037988,"2023-12-23T00:00:00.000Z",5,FALSE,6,38017719,"F",5,5,"Chicago Bulls","Dalen Terry",1,7,7,6,1,10.2
0,0,0,0,0,0,0,0,0,"00",0,0,0,0,0,0,1037988,"2023-12-23T00:00:00.000Z",5,FALSE,6,27,"G",5,5,"Chicago Bulls","Lonzo Ball",0,0,0,0,0,0
0,0,0,0,0,0,0,0,0,"00",0,0,0,0,0,0,1037988,"2023-12-23T00:00:00.000Z",5,FALSE,6,56677874,"F",5,5,"Chicago Bulls","Onuralp Bitim",0,0,0,0,0,0
0,0,0,0,0,0,0,0,0,"00",0,0,0,0,0,0,1037988,"2023-12-23T00:00:00.000Z",5,FALSE,6,NA,NA,NA,5,"Chicago Bulls","NA NA",0,0,0,0,0,0
0,0,0,0,0,0,0,0,0,"00",0,0,0,0,0,0,1037988,"2023-12-23T00:00:00.000Z",5,FALSE,6,268,"G",5,5,"Chicago Bulls","Zach LaVine",0,0,0,0,0,0
0,0,0,0,0,0,0,0,0,"00",0,0,0,0,0,0,1037988,"2023-12-23T00:00:00.000Z",5,FALSE,6,56677860,"F",5,5,"Chicago Bulls","Adama Sanogo",0,0,0,0,0,0
3,0,3,5,0,9,3,7,6,"34",0,2,12,3,0,1,1037988,"2023-12-23T00:00:00.000Z",5,FALSE,6,3547247,"F-G",6,6,"Cleveland Cavaliers","Isaac Okoro",0,15,18,15,6,19.1
1,0,6,10,3,12,4,0,0,"36",1,1,11,7,2,1,1037988,"2023-12-23T00:00:00.000Z",5,FALSE,6,666940,"F",6,6,"Cleveland Cavaliers","Dean Wade",2,18,19,12,8,25.9
7,1,9,1,0,9,6,10,7,"35",8,0,19,17,1,0,1037988,"2023-12-23T00:00:00.000Z",5,FALSE,6,9,"C",6,6,"Cleveland Cavaliers","Jarrett Allen",2,36,43,26,24,55.9
7,1,1,17,5,22,9,3,3,"41",0,2,26,1,2,3,1037988,"2023-12-23T00:00:00.000Z",5,FALSE,6,666908,"G",6,6,"Cleveland Cavaliers","Max Strus",3,27,34,33,8,43.7
8,1,6,3,1,14,8,5,2,"39",1,1,19,7,1,3,1037988,"2023-12-23T00:00:00.000Z",5,FALSE,6,56677872,"G",6,6,"Cleveland Cavaliers","Craig Porter",2,26,34,27,15,42.4
0,1,0,2,1,2,1,0,0,"09",0,0,3,0,0,0,1037988,"2023-12-23T00:00:00.000Z",5,FALSE,6,56677847,"F",6,6,"Cleveland Cavaliers","Emoni Bates",1,3,3,3,0,6
1,0,2,2,1,4,2,1,1,"12",0,5,6,2,1,1,1037988,"2023-12-23T00:00:00.000Z",5,FALSE,6,248,"C",6,6,"Cleveland Cavaliers","Damian Jones",1,8,9,7,3,11.9
0,0,0,0,0,0,0,0,0,"00",0,0,0,0,0,0,1037988,"2023-12-23T00:00:00.000Z",5,FALSE,6,277,"G",6,6,"Cleveland Cavaliers","Caris LeVert",0,0,0,0,0,0
0,0,0,0,0,0,0,0,0,"00",0,0,0,0,0,0,1037988,"2023-12-23T00:00:00.000Z",5,FALSE,6,3547299,"G",6,6,"Cleveland Cavaliers","Sam Merrill",0,0,0,0,0,0
0,0,0,0,0,0,0,0,0,"00",0,0,0,0,0,0,1037988,"2023-12-23T00:00:00.000Z",5,FALSE,6,38017662,"F",6,6,"Cleveland Cavaliers","Isaiah Mobley",0,0,0,0,0,0
0,0,4,5,1,12,3,0,0,"21",1,4,7,5,0,2,1037988,"2023-12-23T00:00:00.000Z",5,FALSE,6,344,"F",6,6,"Cleveland Cavaliers","Georges Niang",0,12,12,7,5,11
0,0,0,0,0,0,0,0,0,"00",0,0,0,0,0,0,1037988,"2023-12-23T00:00:00.000Z",5,FALSE,6,666581,"G",6,6,"Cleveland Cavaliers","Darius Garland",0,0,0,0,0,0
0,0,0,0,0,0,0,0,0,"00",0,0,0,0,0,0,1037988,"2023-12-23T00:00:00.000Z",5,FALSE,6,666676,"G",6,6,"Cleveland Cavaliers","Ty Jerome",0,0,0,0,0,0
0,0,0,0,0,0,0,0,0,"00",0,0,0,0,0,0,1037988,"2023-12-23T00:00:00.000Z",5,FALSE,6,322,"G",6,6,"Cleveland Cavaliers","Donovan Mitchell",0,0,0,0,0,0
1,0,2,0,0,4,3,0,0,"13",4,1,6,6,0,1,1037988,"2023-12-23T00:00:00.000Z",5,FALSE,6,444,"C-F",6,6,"Cleveland Cavaliers","Tristan Thompson",0,12,13,7,7,13.7
0,0,0,0,0,0,0,0,0,"00",0,0,0,0,0,0,1037988,"2023-12-23T00:00:00.000Z",5,FALSE,6,17896076,"F-C",6,6,"Cleveland Cavaliers","Evan Mobley",0,0,0,0,0,0
0,0,0,0,0,0,0,0,0,"00",0,0,0,0,0,0,1037988,"2023-12-23T00:00:00.000Z",5,FALSE,6,404,"G",6,6,"Cleveland Cavaliers","Ricky Rubio",0,0,0,0,0,0
0,1,4,6,2,9,3,0,0,"30",1,2,8,5,0,2,1037989,"2023-12-23T00:00:00.000Z",21,FALSE,14,666541,"G",21,21,"Oklahoma City Thunder","Luguentz Dort",1,13,13,8,5,15
3,0,6,5,2,17,11,4,4,"34",0,3,28,6,0,1,1037989,"2023-12-23T00:00:00.000Z",21,FALSE,14,38017703,"G-F",21,21,"Oklahoma City Thunder","Jalen Williams",0,34,37,31,9,38.7
0,3,6,6,1,18,8,5,2,"34",4,1,19,10,1,0,1037989,"2023-12-23T00:00:00.000Z",21,FALSE,14,38017685,"C-F",21,21,"Oklahoma City Thunder","Chet Holmgren",4,29,29,19,10,43
4,0,2,4,1,6,2,0,0,"24",1,2,5,3,1,0,1037989,"2023-12-23T00:00:00.000Z",21,FALSE,14,56677833,"G",21,21,"Oklahoma City Thunder","Cason Wallace",1,8,12,9,7,17.6
7,0,4,5,1,21,12,10,9,"38",1,2,34,5,2,3,1037989,"2023-12-23T00:00:00.000Z",21,FALSE,14,175,"G",21,21,"Oklahoma City Thunder","Shai Gilgeous-Alexander",2,39,46,41,12,53.5
1,0,1,2,1,2,1,0,0,"11",0,0,3,1,0,0,1037989,"2023-12-23T00:00:00.000Z",21,FALSE,14,44,"F",21,21,"Oklahoma City Thunder","Davis Bertans",0,4,5,4,2,5.7
0,0,0,2,1,3,2,0,0,"11",0,2,5,0,0,0,1037989,"2023-12-23T00:00:00.000Z",21,FALSE,14,38017716,"F",21,21,"Oklahoma City Thunder","Ousmane Dieng",0,5,5,5,0,5
1,2,4,6,1,11,3,0,0,"20",1,1,7,5,1,1,1037989,"2023-12-23T00:00:00.000Z",21,FALSE,14,3547272,"G",21,21,"Oklahoma City Thunder","Isaiah Joe",3,12,13,8,6,22.5
0,0,0,0,0,0,0,0,0,"00",0,0,0,0,0,0,1037989,"2023-12-23T00:00:00.000Z",21,FALSE,14,17896036,"G",21,21,"Oklahoma City Thunder","Tre Mann",0,0,0,0,0,0
1,0,0,0,0,1,0,0,0,"06",1,0,0,1,0,1,1037989,"2023-12-23T00:00:00.000Z",21,FALSE,14,17896078,"G",21,21,"Oklahoma City Thunder","Aaron Wiggins",0,1,2,1,2,1.7
1,0,2,1,0,1,0,0,0,"06",0,1,0,2,0,0,1037989,"2023-12-23T00:00:00.000Z",21,FALSE,14,38017706,"F",21,21,"Oklahoma City Thunder","Jaylin Williams",0,2,3,1,3,3.9
5,1,1,4,3,6,4,0,0,"23",1,2,11,2,1,1,1037989,"2023-12-23T00:00:00.000Z",21,FALSE,14,480,"G-F",21,21,"Oklahoma City Thunder","Kenrich Williams",2,13,18,16,7,25.9
0,0,0,0,0,0,0,0,0,"00",0,0,0,0,0,0,1037989,"2023-12-23T00:00:00.000Z",21,FALSE,14,17896065,"G",21,21,"Oklahoma City Thunder","Josh Giddey",0,0,0,0,0,0
0,0,0,0,0,0,0,0,0,"00",0,0,0,0,0,0,1037989,"2023-12-23T00:00:00.000Z",21,FALSE,14,56677853,"F",21,21,"Oklahoma City Thunder","Keyontae Johnson",0,0,0,0,0,0
0,0,0,0,0,0,0,0,0,"00",0,0,0,0,0,0,1037989,"2023-12-23T00:00:00.000Z",21,FALSE,14,3547271,"C",21,21,"Oklahoma City Thunder","Aleksej Pokusevski",0,0,0,0,0,0
7,0,3,4,0,7,2,0,0,"28",1,2,4,4,0,0,1037989,"2023-12-23T00:00:00.000Z",21,FALSE,14,666860,"F-G",14,14,"Los Angeles Lakers","Cameron Reddish",0,8,15,11,11,19.3
0,1,5,1,0,4,1,0,0,"24",1,0,2,6,1,1,1037989,"2023-12-23T00:00:00.000Z",21,FALSE,14,457,"F",14,14,"Los Angeles Lakers","Jarred Vanderbilt",2,8,8,2,6,14.2
7,2,8,1,1,21,11,6,3,"42",3,2,26,11,1,3,1037989,"2023-12-23T00:00:00.000Z",21,FALSE,14,117,"F-C",14,14,"Los Angeles Lakers","Anthony Davis",3,37,44,33,18,55.7
1,2,5,5,2,7,3,2,2,"28",1,5,10,6,1,0,1037989,"2023-12-23T00:00:00.000Z",21,FALSE,14,383,"F",14,14,"Los Angeles Lakers","Taurean Prince",3,16,17,11,7,27.7
0,0,0,0,0,0,0,0,0,"00",0,0,0,0,0,0,1037989,"2023-12-23T00:00:00.000Z",21,FALSE,14,4197029,"G",21,21,"Oklahoma City Thunder","Vasilije Micic",0,0,0,0,0,0
1,0,1,0,0,0,0,0,0,"03",1,1,0,2,0,0,1037989,"2023-12-23T00:00:00.000Z",21,FALSE,14,24572055,"C",21,21,"Oklahoma City Thunder","Olivier Sarr",0,2,3,1,3,3.9
0,0,0,0,0,0,0,0,0,"00",0,0,0,0,0,0,1037989,"2023-12-23T00:00:00.000Z",21,FALSE,14,27924547,"F",21,21,"Oklahoma City Thunder","Lindy Waters III",0,0,0,0,0,0
7,2,5,5,5,20,13,9,9,"37",2,0,40,7,2,3,1037989,"2023-12-23T00:00:00.000Z",21,FALSE,14,237,"F",14,14,"Los Angeles Lakers","LeBron James",4,47,54,47,14,67.9
0,0,0,0,0,0,0,0,0,"00",0,0,0,0,0,0,1037989,"2023-12-23T00:00:00.000Z",21,FALSE,14,38017697,"G",14,14,"Los Angeles Lakers","Max Christie",0,0,0,0,0,0
2,0,6,5,3,14,8,2,2,"30",0,0,21,6,2,0,1037989,"2023-12-23T00:00:00.000Z",21,FALSE,14,666609,"F",14,14,"Los Angeles Lakers","Rui Hachimura",2,27,29,23,8,37.2
1,0,0,0,0,0,0,0,0,"06",0,0,0,0,0,0,1037989,"2023-12-23T00:00:00.000Z",21,FALSE,14,666626,"C",14,14,"Los Angeles Lakers","Jaxson Hayes",0,0,1,1,1,1.5
0,0,0,0,0,0,0,0,0,"00",0,0,0,0,0,0,1037989,"2023-12-23T00:00:00.000Z",21,FALSE,14,56677835,"G",14,14,"Los Angeles Lakers","Jalen Hood-Schifino",0,0,0,0,0,0
0,0,0,0,0,0,0,0,0,"00",0,0,0,0,0,0,1037989,"2023-12-23T00:00:00.000Z",21,FALSE,14,56677836,"F",14,14,"Los Angeles Lakers","Maxwell Lewis",0,0,0,0,0,0
10,0,3,5,2,8,4,1,1,"28",0,3,11,3,0,1,1037989,"2023-12-23T00:00:00.000Z",21,FALSE,14,17553995,"G",14,14,"Los Angeles Lakers","Austin Reaves",0,14,24,21,13,28.6
3,0,1,6,3,9,5,3,2,"17",0,1,15,1,0,1,1037989,"2023-12-23T00:00:00.000Z",21,FALSE,14,405,"G",14,14,"Los Angeles Lakers","D'Angelo Russell",0,16,19,18,4,19.7
0,0,0,0,0,0,0,0,0,"00",0,0,0,0,0,0,1037989,"2023-12-23T00:00:00.000Z",21,FALSE,14,486,"F",14,14,"Los Angeles Lakers","Christian Wood",0,0,0,0,0,0
0,0,0,0,0,0,0,0,0,"00",0,0,0,0,0,0,1037989,"2023-12-23T00:00:00.000Z",21,FALSE,14,56677738,"C",14,14,"Los Angeles Lakers","Colin Castleton",0,0,0,0,0,0
0,0,0,0,0,0,0,0,0,"00",0,0,0,0,0,0,1037989,"2023-12-23T00:00:00.000Z",21,FALSE,14,56677867,"F",14,14,"Los Angeles Lakers","Alex Fudge",0,0,0,0,0,0
0,0,0,0,0,0,0,0,0,"00",0,0,0,0,0,0,1037989,"2023-12-23T00:00:00.000Z",21,FALSE,14,56677868,"G",14,14,"Los Angeles Lakers","D'Moi Hodge",0,0,0,0,0,0
0,0,0,0,0,0,0,0,0,"00",0,0,0,0,0,0,1037989,"2023-12-23T00:00:00.000Z",21,FALSE,14,1603383,"G",14,14,"Los Angeles Lakers","Gabe Vincent",0,0,0,0,0,0
3,0,6,11,5,20,9,0,0,"30",0,1,23,6,0,0,1037990,"2023-12-23T00:00:00.000Z",7,FALSE,27,191,"G",7,7,"Dallas Mavericks","Tim Hardaway Jr.",0,29,32,26,9,34.7
1,0,2,5,3,7,4,0,0,"24",2,2,11,4,0,0,1037990,"2023-12-23T00:00:00.000Z",7,FALSE,27,247,"F-G",7,7,"Dallas Mavericks","Derrick Jones Jr.",0,15,16,12,5,17.3
3,0,2,6,4,8,5,0,0,"25",0,3,14,2,0,1,1037990,"2023-12-23T00:00:00.000Z",7,FALSE,27,666965,"F",7,7,"Dallas Mavericks","Grant Williams",0,16,19,17,5,19.9
4,1,5,2,2,10,8,2,2,"32",2,1,20,7,0,3,1037990,"2023-12-23T00:00:00.000Z",7,FALSE,27,151,"G",7,7,"Dallas Mavericks","Dante Exum",1,27,31,24,11,34.4
10,1,10,10,5,27,13,11,8,"32",2,1,39,12,1,2,1037990,"2023-12-23T00:00:00.000Z",7,FALSE,27,132,"F-G",7,7,"Dallas Mavericks","Luka Doncic",2,51,61,49,22,72.4
0,1,0,0,0,1,0,0,0,"05",0,1,0,0,0,2,1037990,"2023-12-23T00:00:00.000Z",7,FALSE,27,17896028,"F",7,7,"Dallas Mavericks","Greg Brown III",1,0,0,0,0,1
0,0,0,0,0,0,0,0,0,"00",0,0,0,0,0,0,1037990,"2023-12-23T00:00:00.000Z",7,FALSE,27,114,"G",7,7,"Dallas Mavericks","Seth Curry",0,0,0,0,0,0
0,1,2,2,0,2,0,0,0,"05",0,1,0,2,0,3,1037990,"2023-12-23T00:00:00.000Z",7,FALSE,27,56677873,"G",7,7,"Dallas Mavericks","Dexter Dennis",1,2,2,0,2,2.4
1,0,6,4,1,7,1,4,3,"22",0,1,6,6,3,0,1037990,"2023-12-23T00:00:00.000Z",7,FALSE,27,38017679,"G",7,7,"Dallas Mavericks","Jaden Hardy",3,12,13,7,7,23.7
0,0,0,0,0,0,0,0,0,"00",0,0,0,0,0,0,1037990,"2023-12-23T00:00:00.000Z",7,FALSE,27,217,"F-C",7,7,"Dallas Mavericks","Richaun Holmes",0,0,0,0,0,0
3,0,4,4,3,10,7,0,0,"31",3,2,17,7,2,1,1037990,"2023-12-23T00:00:00.000Z",7,FALSE,27,17554004,"G",7,7,"Dallas Mavericks","AJ Lawson",2,24,27,20,10,34.9
0,0,0,0,0,0,0,0,0,"00",0,0,0,0,0,0,1037990,"2023-12-23T00:00:00.000Z",7,FALSE,27,329,"F",7,7,"Dallas Mavericks","Markieff Morris",0,0,0,0,0,0
1,1,2,0,0,5,5,4,4,"22",2,4,14,4,1,0,1037990,"2023-12-23T00:00:00.000Z",7,FALSE,27,379,"F-C",7,7,"Dallas Mavericks","Dwight Powell",2,18,19,15,5,26.3
0,0,2,1,0,3,0,0,0,"12",0,1,0,2,0,0,1037990,"2023-12-23T00:00:00.000Z",7,FALSE,27,56677859,"F",7,7,"Dallas Mavericks","Olivier-Maxence Prosper",0,2,2,0,2,2.4
0,0,0,0,0,0,0,0,0,"00",0,0,0,0,0,0,1037990,"2023-12-23T00:00:00.000Z",7,FALSE,27,3547258,"G",7,7,"Dallas Mavericks","Josh Green",0,0,0,0,0,0
0,0,0,0,0,0,0,0,0,"00",0,0,0,0,0,0,1037990,"2023-12-23T00:00:00.000Z",7,FALSE,27,228,"G",7,7,"Dallas Mavericks","Kyrie Irving",0,0,0,0,0,0
0,0,0,0,0,0,0,0,0,"00",0,0,0,0,0,0,1037990,"2023-12-23T00:00:00.000Z",7,FALSE,27,257,"F",7,7,"Dallas Mavericks","Maxi Kleber",0,0,0,0,0,0
0,0,0,0,0,0,0,0,0,"00",0,0,0,0,0,0,1037990,"2023-12-23T00:00:00.000Z",7,FALSE,27,56677840,"C",7,7,"Dallas Mavericks","Dereck Lively II",0,0,0,0,0,0
1,0,5,4,2,6,4,2,2,"22",0,0,12,5,1,0,1037990,"2023-12-23T00:00:00.000Z",7,FALSE,27,38017649,"F",27,27,"San Antonio Spurs","Julian Champagnie",1,17,18,13,6,22.5
4,0,7,6,4,16,9,2,1,"30",2,2,23,9,0,3,1037990,"2023-12-23T00:00:00.000Z",7,FALSE,27,38017699,"F",27,27,"San Antonio Spurs","Jeremy Sochan",0,32,36,27,13,36.8
0,0,3,2,0,3,0,2,2,"14",0,2,2,3,2,0,1037990,"2023-12-23T00:00:00.000Z",7,FALSE,27,56677817,"G",27,27,"San Antonio Spurs","Sidy Cissoko",2,5,5,2,3,11.6
0,0,5,2,0,3,0,0,0,"08",0,0,0,5,0,0,1037990,"2023-12-23T00:00:00.000Z",7,FALSE,27,180,"G",27,27,"San Antonio Spurs","Devonte' Graham",0,5,5,0,5,6
2,0,3,8,2,16,6,4,2,"23",2,2,16,5,0,2,1037990,"2023-12-23T00:00:00.000Z",7,FALSE,27,666682,"F",27,27,"San Antonio Spurs","Keldon Johnson",0,21,23,18,7,23
4,0,1,4,1,8,4,0,0,"18",0,1,9,1,1,1,1037990,"2023-12-23T00:00:00.000Z",7,FALSE,27,3547274,"G",27,27,"San Antonio Spurs","Tre Jones",1,10,14,13,5,18.2
3,1,2,3,1,6,4,6,5,"15",3,1,14,5,0,1,1037990,"2023-12-23T00:00:00.000Z",7,FALSE,27,17896059,"F",27,27,"San Antonio Spurs","Sandro Mamukelashvili",1,19,22,17,8,26.5
0,0,0,0,0,0,0,2,0,"06",0,0,0,0,0,0,1037990,"2023-12-23T00:00:00.000Z",7,FALSE,27,305,"F",27,27,"San Antonio Spurs","Doug McDermott",0,0,0,0,0,0
2,0,0,2,1,3,1,0,0,"10",0,1,3,0,0,0,1037990,"2023-12-23T00:00:00.000Z",7,FALSE,27,359,"F",27,27,"San Antonio Spurs","Cedi Osman",0,3,5,5,2,6
0,0,0,0,0,0,0,0,0,"00",0,0,0,0,0,0,1037990,"2023-12-23T00:00:00.000Z",7,FALSE,27,56677822,"F-C",27,27,"San Antonio Spurs","Victor Wembanyama",0,0,0,0,0,0
3,0,1,0,0,3,2,2,1,"12",0,1,5,1,3,0,1037990,"2023-12-23T00:00:00.000Z",7,FALSE,27,38017693,"G",27,27,"San Antonio Spurs","Blake Wesley",3,6,9,8,4,19.7
0,0,0,0,0,0,0,0,0,"00",0,0,0,0,0,0,1037990,"2023-12-23T00:00:00.000Z",7,FALSE,27,38017730,"F",27,27,"San Antonio Spurs","Dominick Barlow",0,0,0,0,0,0
0,0,0,0,0,0,0,0,0,"00",0,0,0,0,0,0,1037990,"2023-12-23T00:00:00.000Z",7,FALSE,27,17895854,"G",27,27,"San Antonio Spurs","Charles Bassey",0,0,0,0,0,0
0,0,0,0,0,0,0,0,0,"00",0,0,0,0,0,0,1037990,"2023-12-23T00:00:00.000Z",7,FALSE,27,56677865,"C",27,27,"San Antonio Spurs","Charles Bediako",0,0,0,0,0,0
0,0,0,0,0,0,0,0,0,"00",0,0,0,0,0,0,1037990,"2023-12-23T00:00:00.000Z",7,FALSE,27,17896049,"G",3,27,"San Antonio Spurs","David Duke Jr.",0,0,0,0,0,0
4,2,4,4,2,10,6,0,0,"28",1,3,14,5,2,2,1037990,"2023-12-23T00:00:00.000Z",7,FALSE,27,102,"F-C",27,27,"San Antonio Spurs","Zach Collins",4,19,23,18,9,36
5,0,0,6,0,13,3,3,3,"30",0,1,9,0,0,0,1037990,"2023-12-23T00:00:00.000Z",7,FALSE,27,3547246,"G-F",27,27,"San Antonio Spurs","Devin Vassell",0,9,14,14,5,16.5
4,0,3,4,1,11,5,1,1,"24",0,2,12,3,0,1,1037990,"2023-12-23T00:00:00.000Z",7,FALSE,27,38017692,"F",27,27,"San Antonio Spurs","Malaki Branham",0,15,19,16,7,20.6
0,0,2,10,6,16,11,0,0,"31",1,1,28,3,0,3,1037991,"2023-12-23T00:00:00.000Z",10,FALSE,25,443,"G",10,10,"Golden State Warriors","Klay Thompson",0,31,31,28,3,28.6
5,0,5,2,0,7,3,5,5,"30",1,0,11,6,0,0,1037991,"2023-12-23T00:00:00.000Z",10,FALSE,25,17553979,"F",10,10,"Golden State Warriors","Jonathan Kuminga",0,17,22,16,11,25.7
7,0,5,0,0,3,2,2,2,"22",6,2,6,11,0,3,1037991,"2023-12-23T00:00:00.000Z",10,FALSE,25,282,"F",10,10,"Golden State Warriors","Kevon Looney",0,17,24,13,18,26.7
7,1,9,5,1,12,7,0,0,"32",1,1,15,10,1,2,1037991,"2023-12-23T00:00:00.000Z",10,FALSE,25,56677858,"G",10,10,"Golden State Warriors","Brandin Podziemski",2,25,32,22,17,41.5
2,0,3,7,2,18,11,3,3,"30",0,1,27,3,0,1,1037991,"2023-12-23T00:00:00.000Z",10,FALSE,25,115,"G",10,10,"Golden State Warriors","Stephen Curry",0,30,32,29,5,32.6
0,0,0,0,0,0,0,0,0,"04",0,1,0,0,1,0,1037991,"2023-12-23T00:00:00.000Z",10,FALSE,25,17896070,"F",10,10,"Golden State Warriors","Usman Garuba",1,0,0,0,0,3
0,0,0,0,0,0,0,0,0,"00",0,0,0,0,0,0,1037991,"2023-12-23T00:00:00.000Z",10,FALSE,25,185,"F",10,10,"Golden State Warriors","Draymond Green",0,0,0,0,0,0
3,0,4,0,0,7,6,4,1,"17",1,2,13,5,1,2,1037991,"2023-12-23T00:00:00.000Z",10,FALSE,25,56677799,"F",10,10,"Golden State Warriors","Trayce Jackson-Davis",1,18,21,16,8,24.5
1,0,0,1,0,1,0,0,0,"04",0,0,0,0,0,1,1037991,"2023-12-23T00:00:00.000Z",10,FALSE,25,251,"G",10,10,"Golden State Warriors","Cory Joseph",0,0,1,1,1,0.5
1,1,1,2,1,6,4,2,2,"17",0,3,11,1,1,2,1037991,"2023-12-23T00:00:00.000Z",10,FALSE,25,17553992,"G",10,10,"Golden State Warriors","Moses Moody",2,12,13,12,2,17.7
11,0,3,2,0,4,1,0,0,"26",0,1,2,3,3,1,1037991,"2023-12-23T00:00:00.000Z",10,FALSE,25,367,"G",10,10,"Golden State Warriors","Chris Paul",3,5,16,13,14,30.1
0,0,0,2,0,2,0,4,3,"04",0,0,3,0,0,0,1037991,"2023-12-23T00:00:00.000Z",10,FALSE,25,398,"G",10,10,"Golden State Warriors","Jerome Robinson",0,3,3,3,0,3
0,0,1,0,0,0,0,2,2,"04",1,0,2,2,0,0,1037991,"2023-12-23T00:00:00.000Z",10,FALSE,25,57875092,"F",10,10,"Golden State Warriors","Gui Santos",0,4,4,2,2,4.4
1,0,3,2,0,7,3,2,2,"19",2,2,8,5,1,1,1037991,"2023-12-23T00:00:00.000Z",10,FALSE,25,407,"F",10,10,"Golden State Warriors","Dario Saric",1,13,14,9,6,17.5
0,0,0,0,0,0,0,0,0,"00",0,0,0,0,0,0,1037991,"2023-12-23T00:00:00.000Z",10,FALSE,25,2189,"",10,10,"Golden State Warriors","Gary Payton II",0,0,0,0,0,0
0,0,0,0,0,0,0,0,0,"00",0,0,0,0,0,0,1037991,"2023-12-23T00:00:00.000Z",10,FALSE,25,45658838,"G",10,10,"Golden State Warriors","Lester Quinones",0,0,0,0,0,0
0,0,0,0,0,0,0,0,0,"00",0,0,0,0,0,0,1037991,"2023-12-23T00:00:00.000Z",10,FALSE,25,475,"F-G",10,10,"Golden State Warriors","Andrew Wiggins",0,0,0,0,0,0
0,1,2,0,0,3,2,2,2,"24",0,1,6,2,1,1,1037991,"2023-12-23T00:00:00.000Z",10,FALSE,25,56677850,"F",25,25,"Portland Trail Blazers","Toumani Camara",2,8,8,6,2,13.4
3,0,1,4,1,12,5,8,6,"32",1,3,17,2,0,2,1037991,"2023-12-23T00:00:00.000Z",10,FALSE,25,182,"F",25,25,"Portland Trail Blazers","Jerami Grant",0,19,22,20,5,21.9
2,0,5,0,0,12,6,3,1,"29",1,2,13,6,3,1,1037991,"2023-12-23T00:00:00.000Z",10,FALSE,25,22,"C",25,25,"Portland Trail Blazers","Deandre Ayton",3,19,21,15,8,31.2
2,0,2,13,7,17,7,4,4,"34",0,0,25,2,1,1,1037991,"2023-12-23T00:00:00.000Z",10,FALSE,25,419,"G",25,25,"Portland Trail Blazers","Anfernee Simons",1,27,29,27,4,32.4
12,1,4,4,1,14,8,0,0,"37",2,2,17,6,3,2,1037991,"2023-12-23T00:00:00.000Z",10,FALSE,25,65,"G",25,25,"Portland Trail Blazers","Malcolm Brogdon",4,23,35,29,18,52.2
0,0,0,0,0,0,0,0,0,"00",0,0,0,0,0,0,1037991,"2023-12-23T00:00:00.000Z",10,FALSE,25,666476,"C",25,25,"Portland Trail Blazers","Moses Brown",0,0,0,0,0,0
2,0,1,4,2,9,4,4,2,"23",0,4,12,1,3,2,1037991,"2023-12-23T00:00:00.000Z",10,FALSE,25,56677747,"G",25,25,"Portland Trail Blazers","Scoot Henderson",3,13,15,14,3,23.2
1,0,0,0,0,2,0,2,1,"05",0,0,1,0,0,1,1037991,"2023-12-23T00:00:00.000Z",10,FALSE,25,3547289,"G",25,25,"Portland Trail Blazers","Skylar Mays",0,1,2,2,1,1.5
0,0,1,0,0,1,1,0,0,"05",1,2,2,2,1,0,1037991,"2023-12-23T00:00:00.000Z",10,FALSE,25,56677791,"F",25,25,"Portland Trail Blazers","Kris Murray",1,4,4,2,2,7.4
0,0,1,2,0,2,0,0,0,"09",0,3,0,1,0,0,1037991,"2023-12-23T00:00:00.000Z",10,FALSE,25,56783340,"C",25,25,"Portland Trail Blazers","Duop Reath",0,1,1,0,1,1.2
2,0,0,0,0,1,0,0,0,"04",0,0,0,0,0,0,1037991,"2023-12-23T00:00:00.000Z",10,FALSE,25,56677829,"G-F",25,25,"Portland Trail Blazers","Rayan Rupert",0,0,2,2,2,3
2,0,1,5,1,6,2,0,0,"16",1,0,5,2,1,0,1037991,"2023-12-23T00:00:00.000Z",10,FALSE,25,666923,"G-F",25,25,"Portland Trail Blazers","Matisse Thybulle",1,7,9,7,4,13.4
0,0,1,1,1,1,1,0,0,"04",0,1,3,1,0,0,1037991,"2023-12-23T00:00:00.000Z",10,FALSE,25,17896120,"F",25,25,"Portland Trail Blazers","Ish Wainright",0,4,4,3,1,4.2
0,0,0,0,0,0,0,0,0,"00",0,0,0,0,0,0,1037991,"2023-12-23T00:00:00.000Z",10,FALSE,25,476,"C-F",25,25,"Portland Trail Blazers","Robert Williams III",0,0,0,0,0,0
0,1,3,2,0,4,2,2,1,"18",2,2,5,5,0,1,1037991,"2023-12-23T00:00:00.000Z",10,FALSE,25,38017711,"F",25,25,"Portland Trail Blazers","Jabari Walker",1,10,10,5,5,13
0,0,0,0,0,0,0,0,0,"00",0,0,0,0,0,0,1037991,"2023-12-23T00:00:00.000Z",10,FALSE,25,39613724,"C",25,25,"Portland Trail Blazers","Ibou Badji",0,0,0,0,0,0
0,0,0,0,0,0,0,0,0,"00",0,0,0,0,0,0,1037991,"2023-12-23T00:00:00.000Z",10,FALSE,25,47957121,"F",25,25,"Portland Trail Blazers","Justin Minaya",0,0,0,0,0,0
0,0,0,0,0,0,0,0,0,"00",0,0,0,0,0,0,1037991,"2023-12-23T00:00:00.000Z",10,FALSE,25,38017690,"G",25,25,"Portland Trail Blazers","Shaedon Sharpe",0,0,0,0,0,0
1,0,3,2,0,6,3,6,6,"31",0,3,12,3,0,0,1037992,"2023-12-23T00:00:00.000Z",26,FALSE,18,30,"F",26,26,"Sacramento Kings","Harrison Barnes",0,15,16,13,4,17.1
0,1,6,7,3,16,8,2,1,"40",1,4,20,7,3,1,1037992,"2023-12-23T00:00:00.000Z",26,FALSE,18,38017688,"F",26,26,"Sacramento Kings","Keegan Murray",4,27,27,20,7,39.4
10,0,9,1,0,12,7,5,3,"39",1,3,17,10,1,3,1037992,"2023-12-23T00:00:00.000Z",26,FALSE,18,406,"F",26,26,"Sacramento Kings","Domantas Sabonis",1,27,37,27,20,44
1,0,1,2,0,7,1,0,0,"15",0,3,2,1,0,1,1037992,"2023-12-23T00:00:00.000Z",26,FALSE,18,221,"G",26,26,"Sacramento Kings","Kevin Huerter",0,3,4,3,2,3.7
6,0,2,11,3,23,10,4,4,"39",2,1,27,4,2,3,1037992,"2023-12-23T00:00:00.000Z",26,FALSE,18,161,"G",26,26,"Sacramento Kings","De'Aaron Fox",2,31,37,33,10,43.8
0,0,3,3,1,3,1,0,0,"18",1,1,3,4,2,1,1037992,"2023-12-23T00:00:00.000Z",26,FALSE,18,17896030,"G",26,26,"Sacramento Kings","Chris Duarte",2,7,7,3,4,12.8
0,0,1,0,0,0,0,0,0,"02",0,0,0,1,0,0,1037992,"2023-12-23T00:00:00.000Z",26,FALSE,18,56677845,"G",26,26,"Sacramento Kings","Colby Jones",0,1,1,0,1,1.2
3,0,4,4,1,8,4,3,1,"27",3,1,10,7,0,1,1037992,"2023-12-23T00:00:00.000Z",26,FALSE,18,290,"F",26,26,"Sacramento Kings","Trey Lyles",0,17,20,13,10,21.9
1,1,2,0,0,6,3,1,1,"09",0,2,7,2,1,1,1037992,"2023-12-23T00:00:00.000Z",26,FALSE,18,306,"C",26,26,"Sacramento Kings","JaVale McGee",2,9,10,8,3,15.9
0,0,0,0,0,0,0,0,0,"00",0,0,0,0,0,0,1037992,"2023-12-23T00:00:00.000Z",26,FALSE,18,17553994,"G",26,26,"Sacramento Kings","Davion Mitchell",0,0,0,0,0,0
0,0,0,0,0,0,0,0,0,"00",0,0,0,0,0,0,1037992,"2023-12-23T00:00:00.000Z",26,FALSE,18,56677862,"F",26,26,"Sacramento Kings","Jalen Slawson",0,0,0,0,0,0
0,0,0,0,0,0,0,0,0,"00",0,0,0,0,0,0,1037992,"2023-12-23T00:00:00.000Z",26,FALSE,18,666925,"F",29,26,"Sacramento Kings","Juan Toscano-Anderson",0,0,0,0,0,0
0,0,1,1,0,1,0,0,0,"08",0,1,0,1,1,0,1037992,"2023-12-23T00:00:00.000Z",26,FALSE,18,4197162,"F",26,26,"Sacramento Kings","Aleksandar Vezenkov",1,1,1,0,1,4.2
0,0,0,0,0,0,0,0,0,"00",0,0,0,0,0,0,1037992,"2023-12-23T00:00:00.000Z",26,FALSE,18,17895990,"G",26,26,"Sacramento Kings","Jordan Ford",0,0,0,0,0,0
0,0,0,0,0,0,0,0,0,"00",0,0,0,0,0,0,1037992,"2023-12-23T00:00:00.000Z",26,FALSE,18,273,"C",26,26,"Sacramento Kings","Alex Len",0,0,0,0,0,0
0,0,0,0,0,0,0,0,0,"00",0,0,0,0,0,0,1037992,"2023-12-23T00:00:00.000Z",26,FALSE,18,324,"G",26,26,"Sacramento Kings","Malik Monk",0,0,0,0,0,0
1,1,5,9,3,16,8,2,1,"41",0,4,20,5,4,0,1037992,"2023-12-23T00:00:00.000Z",26,FALSE,18,3547259,"F",18,18,"Minnesota Timberwolves","Jaden McDaniels",5,25,26,21,6,42.5
5,1,4,0,0,9,4,2,2,"29",1,4,10,5,0,2,1037992,"2023-12-23T00:00:00.000Z",26,FALSE,18,12,"F",18,18,"Minnesota Timberwolves","Kyle Anderson",1,15,20,15,10,24.5
1,2,11,0,0,13,10,2,1,"39",6,3,21,17,0,1,1037992,"2023-12-23T00:00:00.000Z",26,FALSE,18,176,"C",18,18,"Minnesota Timberwolves","Rudy Gobert",2,38,39,22,18,47.9
10,1,5,12,3,27,13,5,5,"39",0,1,34,5,1,5,1037992,"2023-12-23T00:00:00.000Z",26,FALSE,18,3547238,"G",18,18,"Minnesota Timberwolves","Anthony Edwards",2,39,49,44,15,56
9,0,7,7,3,10,4,1,1,"32",0,1,12,7,2,2,1037992,"2023-12-23T00:00:00.000Z",26,FALSE,18,104,"G",18,18,"Minnesota Timberwolves","Mike Conley",2,19,28,21,16,37.9
0,0,0,2,0,4,1,0,0,"23",0,2,2,0,0,0,1037992,"2023-12-23T00:00:00.000Z",26,FALSE,18,666400,"G",18,18,"Minnesota Timberwolves","Nickeil Alexander-Walker",0,2,2,2,0,2
0,0,1,0,0,0,0,0,0,"03",0,3,0,1,0,0,1037992,"2023-12-23T00:00:00.000Z",26,FALSE,18,68,"F",18,18,"Minnesota Timberwolves","Troy Brown Jr.",0,1,1,0,1,1.2
0,0,0,0,0,0,0,0,0,"00",0,0,0,0,0,0,1037992,"2023-12-23T00:00:00.000Z",26,FALSE,18,17896056,"C",18,18,"Minnesota Timberwolves","Luka Garza",0,0,0,0,0,0
2,0,0,0,0,0,0,0,0,"01",0,0,0,0,0,0,1037992,"2023-12-23T00:00:00.000Z",26,FALSE,18,666767,"G",18,18,"Minnesota Timberwolves","Jordan McLaughlin",0,0,2,2,2,3
1,0,1,2,1,4,2,0,0,"14",0,0,5,1,0,1,1037992,"2023-12-23T00:00:00.000Z",26,FALSE,18,320,"G",18,18,"Minnesota Timberwolves","Shake Milton",0,6,7,6,2,6.7
0,0,0,0,0,0,0,0,0,"00",0,0,0,0,0,0,1037992,"2023-12-23T00:00:00.000Z",26,FALSE,18,38017700,"G",18,18,"Minnesota Timberwolves","Wendell Moore Jr.",0,0,0,0,0,0
2,0,2,1,0,4,2,2,2,"19",0,0,6,2,2,1,1037992,"2023-12-23T00:00:00.000Z",26,FALSE,18,667378,"F-C",18,18,"Minnesota Timberwolves","Naz Reid",2,8,10,8,4,16.4
0,0,0,0,0,0,0,0,0,"00",0,0,0,0,0,0,1037992,"2023-12-23T00:00:00.000Z",26,FALSE,18,56677851,"G",18,18,"Minnesota Timberwolves","Jaylen Clark",0,0,0,0,0,0
0,0,0,0,0,0,0,0,0,"00",0,0,0,0,0,0,1037992,"2023-12-23T00:00:00.000Z",26,FALSE,18,56677782,"F",18,18,"Minnesota Timberwolves","Leonard Miller",0,0,0,0,0,0
0,0,0,0,0,0,0,0,0,"00",0,0,0,0,0,0,1037992,"2023-12-23T00:00:00.000Z",26,FALSE,18,38017715,"F",18,18,"Minnesota Timberwolves","Josh Minott",0,0,0,0,0,0
0,0,0,0,0,0,0,0,0,"00",0,0,0,0,0,0,1037992,"2023-12-23T00:00:00.000Z",26,FALSE,18,17895968,"F",18,18,"Minnesota Timberwolves","Daishen Nix",0,0,0,0,0,0
0,0,0,0,0,0,0,0,0,"00",0,0,0,0,0,0,1037992,"2023-12-23T00:00:00.000Z",26,FALSE,18,447,"C",18,18,"Minnesota Timberwolves","Karl-Anthony Towns",0,0,0,0,0,0
0,0,0,0,0,0,0,0,0,"01",0,0,0,0,0,0,1037992,"2023-12-23T00:00:00.000Z",26,FALSE,18,17896044,"F",26,26,"Sacramento Kings","Kessler Edwards",0,0,0,0,0,0
1,0,0,2,0,3,0,0,0,"11",0,1,0,0,0,0,1037992,"2023-12-23T00:00:00.000Z",26,FALSE,18,38017714,"G",26,26,"Sacramento Kings","Keon Ellis",0,0,1,1,1,1.5
1,0,2,1,0,3,1,0,0,"17",0,0,2,2,0,1,1037981,"2023-12-23T00:00:00.000Z",13,FALSE,2,666511,"G",13,13,"LA Clippers","Amir Coffey",0,4,5,3,3,4.9
2,2,2,7,3,17,9,0,0,"30",1,1,21,3,1,1,1037981,"2023-12-23T00:00:00.000Z",13,FALSE,2,172,"F",13,13,"LA Clippers","Paul George",3,24,26,23,5,35.6
0,1,5,0,0,9,7,2,2,"27",5,3,16,10,0,2,1037981,"2023-12-23T00:00:00.000Z",13,FALSE,2,493,"C",13,13,"LA Clippers","Ivica Zubac",1,26,26,16,10,29
3,0,3,6,0,10,0,0,0,"24",1,2,0,4,0,0,1037981,"2023-12-23T00:00:00.000Z",13,FALSE,2,666743,"G",13,13,"LA Clippers","Terance Mann",0,4,7,3,7,9.3
9,0,4,5,2,13,6,0,0,"29",0,4,14,4,1,4,1037981,"2023-12-23T00:00:00.000Z",13,FALSE,2,192,"G",13,13,"LA Clippers","James Harden",1,18,27,23,13,31.3
0,0,2,4,1,6,3,6,6,"13",1,1,13,3,0,0,1037981,"2023-12-23T00:00:00.000Z",13,FALSE,2,17896022,"G",13,13,"LA Clippers","Brandon Boston Jr.",0,16,16,13,3,16.6
4,0,2,2,2,2,2,0,0,"25",0,3,6,2,1,0,1037981,"2023-12-23T00:00:00.000Z",13,FALSE,2,56677849,"F",13,13,"LA Clippers","Kobe Brown",1,8,12,10,6,17.4
0,0,0,2,0,4,1,0,0,"08",0,0,2,0,0,0,1037981,"2023-12-23T00:00:00.000Z",13,FALSE,2,17896031,"G",13,13,"LA Clippers","Nah'Shon Hyland",0,2,2,2,0,2
0,0,0,3,1,9,3,0,0,"25",0,5,7,0,0,1,1037981,"2023-12-23T00:00:00.000Z",13,FALSE,2,380,"F-G",13,13,"LA Clippers","Norman Powell",0,7,7,7,0,6
1,0,1,2,2,5,5,3,3,"21",0,2,15,1,1,0,1037981,"2023-12-23T00:00:00.000Z",13,FALSE,2,439,"F",13,13,"LA Clippers","Daniel Theis",1,16,17,16,2,20.7
0,0,1,1,0,1,0,0,0,"02",0,0,0,1,0,0,1037981,"2023-12-23T00:00:00.000Z",13,FALSE,2,38017707,"G",2,2,"Boston Celtics","JD Davison",0,1,1,0,1,1.2
4,0,2,5,1,5,1,0,0,"19",0,3,3,2,0,0,1037981,"2023-12-23T00:00:00.000Z",13,FALSE,2,17896060,"F",2,2,"Boston Celtics","Sam Hauser",0,5,9,7,6,11.4
1,0,0,1,1,1,1,0,0,"03",0,1,3,0,0,0,1037981,"2023-12-23T00:00:00.000Z",13,FALSE,2,NA,NA,NA,2,"Boston Celtics","NA NA",0,3,4,4,1,4.5
3,0,3,5,3,8,3,0,0,"23",1,3,9,4,0,0,1037981,"2023-12-23T00:00:00.000Z",13,FALSE,2,3547276,"G",2,2,"Boston Celtics","Payton Pritchard",0,13,16,12,7,18.3
3,0,6,0,0,7,4,8,6,"23",6,5,14,12,0,1,1037981,"2023-12-23T00:00:00.000Z",13,FALSE,2,17553967,"C",2,2,"Boston Celtics","Neemias Queta",0,26,29,17,15,31.9
1,0,1,0,0,3,2,0,0,"05",1,0,4,2,0,0,1037981,"2023-12-23T00:00:00.000Z",13,FALSE,2,3547279,"F",2,2,"Boston Celtics","Lamar Stevens",0,6,7,5,3,7.9
0,0,0,0,0,0,0,0,0,"00",0,0,0,0,0,0,1037981,"2023-12-23T00:00:00.000Z",13,FALSE,2,56677864,"G",2,2,"Boston Celtics","Jordan Walsh",0,0,0,0,0,0
0,0,0,0,0,0,0,0,0,"00",0,0,0,0,0,0,1037981,"2023-12-23T00:00:00.000Z",13,FALSE,2,261,"F-C",2,2,"Boston Celtics","Luke Kornet",0,0,0,0,0,0
0,0,0,0,0,0,0,0,0,"00",0,0,0,0,0,0,1037981,"2023-12-23T00:00:00.000Z",13,FALSE,2,338,"G",2,2,"Boston Celtics","Svi Mykhailiuk",0,0,0,0,0,0
0,0,0,0,0,0,0,0,0,"00",0,0,0,0,0,0,1037981,"2023-12-23T00:00:00.000Z",13,FALSE,2,378,"F-C",2,2,"Boston Celtics","Kristaps Porzingis",0,0,0,0,0,0
0,0,0,0,0,0,0,0,0,"00",0,0,0,0,0,0,1037981,"2023-12-23T00:00:00.000Z",13,FALSE,2,450,"F",13,13,"LA Clippers","PJ Tucker",0,0,0,0,0,0
5,1,4,2,0,11,4,4,4,"21",1,3,12,5,0,1,1037981,"2023-12-23T00:00:00.000Z",13,FALSE,2,472,"G",13,13,"LA Clippers","Russell Westbrook",1,17,22,17,10,27.5
0,0,0,0,0,0,0,0,0,"00",0,0,0,0,0,0,1037981,"2023-12-23T00:00:00.000Z",13,FALSE,2,38017725,"F",13,13,"LA Clippers","Moussa Diabate",0,0,0,0,0,0
0,0,0,0,0,0,0,0,0,"00",0,0,0,0,0,0,1037981,"2023-12-23T00:00:00.000Z",13,FALSE,2,274,"F",13,13,"LA Clippers","Kawhi Leonard",0,0,0,0,0,0
0,0,0,0,0,0,0,0,0,"00",0,0,0,0,0,0,1037981,"2023-12-23T00:00:00.000Z",13,FALSE,2,56677856,"G",13,13,"LA Clippers","Jordan Miller",0,0,0,0,0,0
0,0,0,0,0,0,0,0,0,"00",0,0,0,0,0,0,1037981,"2023-12-23T00:00:00.000Z",13,FALSE,2,24417679,"G",13,13,"LA Clippers","Xavier Moon",0,0,0,0,0,0
0,0,0,0,0,0,0,0,0,"00",0,0,0,0,0,0,1037981,"2023-12-23T00:00:00.000Z",13,FALSE,2,371,"F-C",13,13,"LA Clippers","Mason Plumlee",0,0,0,0,0,0
0,0,0,0,0,0,0,0,0,"00",0,0,0,0,0,0,1037981,"2023-12-23T00:00:00.000Z",13,FALSE,2,17896051,"G",13,13,"LA Clippers","Joshua Primo",0,0,0,0,0,0
2,0,5,10,5,16,9,9,7,"30",0,0,30,5,1,2,1037981,"2023-12-23T00:00:00.000Z",13,FALSE,2,434,"F",2,2,"Boston Celtics","Jayson Tatum",1,35,37,32,7,40
2,0,3,6,3,17,9,4,3,"29",3,2,24,6,1,3,1037981,"2023-12-23T00:00:00.000Z",13,FALSE,2,70,"G",2,2,"Boston Celtics","Jaylen Brown",1,30,32,26,8,34.2
5,2,7,5,2,6,2,0,0,"27",0,2,6,7,1,0,1037981,"2023-12-23T00:00:00.000Z",13,FALSE,2,219,"C-F",2,2,"Boston Celtics","Al Horford",3,13,18,11,12,30.9
3,3,3,10,3,12,5,5,5,"29",0,2,18,3,0,2,1037981,"2023-12-23T00:00:00.000Z",13,FALSE,2,473,"G",2,2,"Boston Celtics","Derrick White",3,21,24,21,6,33.1
7,0,3,6,4,12,8,0,0,"28",3,1,20,6,1,1,1037981,"2023-12-23T00:00:00.000Z",13,FALSE,2,214,"G",2,2,"Boston Celtics","Jrue Holiday",1,26,33,27,13,39.7
1,0,0,0,0,1,1,0,0,"04",0,0,2,0,0,0,1037981,"2023-12-23T00:00:00.000Z",13,FALSE,2,17896094,"G",2,2,"Boston Celtics","Dalano Banton",0,2,3,3,1,3.5
1,0,2,4,3,5,4,2,1,"18",1,0,12,3,0,0,1037981,"2023-12-23T00:00:00.000Z",13,FALSE,2,666468,"F",2,2,"Boston Celtics","Oshae Brissett",0,15,16,13,4,17.1
0,0,0,0,0,0,0,0,0,"01",0,1,0,0,0,0,1037980,"2023-12-23T00:00:00.000Z",20,FALSE,17,19,"G",20,20,"New York Knicks","Ryan Arcidiacono",0,0,0,0,0,0
0,0,0,1,0,1,0,0,0,"01",0,0,0,0,0,0,1037980,"2023-12-23T00:00:00.000Z",20,FALSE,17,666474,"G",20,20,"New York Knicks","Charles Brown",0,0,0,0,0,0
0,0,0,0,0,0,0,0,0,"00",0,0,0,0,0,0,1037980,"2023-12-23T00:00:00.000Z",20,FALSE,17,160,"G-F",20,20,"New York Knicks","Evan Fournier",0,0,0,0,0,0
0,0,2,1,0,3,1,0,0,"16",0,2,2,2,1,0,1037980,"2023-12-23T00:00:00.000Z",20,FALSE,17,17895858,"G",20,20,"New York Knicks","Quentin Grimes",1,4,4,2,2,7.4
3,0,2,3,0,6,1,0,0,"26",0,3,2,2,1,1,1037980,"2023-12-23T00:00:00.000Z",20,FALSE,17,202,"G",20,20,"New York Knicks","Josh Hart",1,4,7,5,5,10.9
0,0,1,0,0,0,0,0,0,"01",0,0,0,1,0,0,1037980,"2023-12-23T00:00:00.000Z",20,FALSE,17,17896033,"G",20,20,"New York Knicks","Miles McBride",0,1,1,0,1,1.2
1,0,2,5,1,8,2,2,2,"22",0,1,7,2,0,1,1037980,"2023-12-23T00:00:00.000Z",20,FALSE,17,3547269,"G",20,20,"New York Knicks","Immanuel Quickley",0,9,10,8,3,9.9
0,0,0,0,0,1,0,0,0,"01",0,0,0,0,0,0,1037980,"2023-12-23T00:00:00.000Z",20,FALSE,17,NA,NA,NA,20,"New York Knicks","NA NA",0,0,0,0,0,0
0,0,0,0,0,0,0,0,0,"01",0,0,0,0,0,0,1037980,"2023-12-23T00:00:00.000Z",20,FALSE,17,56677795,"F",20,20,"New York Knicks","Jacob Toppin",0,0,0,0,0,0
0,0,0,0,0,0,0,0,0,"00",0,0,0,0,0,0,1037980,"2023-12-23T00:00:00.000Z",20,FALSE,17,666675,"F",20,20,"New York Knicks","DaQuan Jeffries",0,0,0,0,0,0
0,0,0,0,0,0,0,0,0,"00",0,0,0,0,0,0,1037980,"2023-12-23T00:00:00.000Z",20,FALSE,17,399,"C",20,20,"New York Knicks","Mitchell Robinson",0,0,0,0,0,0
0,0,0,0,0,0,0,0,0,"00",0,0,0,0,0,0,1037980,"2023-12-23T00:00:00.000Z",20,FALSE,17,17896063,"F",20,20,"New York Knicks","Jericho Sims",0,0,0,0,0,0
7,1,5,0,0,17,11,8,6,"32",2,4,28,7,1,5,1037980,"2023-12-23T00:00:00.000Z",20,FALSE,17,15,"F",17,17,"Milwaukee Bucks","Giannis Antetokounmpo",2,35,42,35,14,47.9
5,0,4,4,2,16,9,0,0,"32",1,4,20,5,0,3,1037980,"2023-12-23T00:00:00.000Z",20,FALSE,17,315,"F",17,17,"Milwaukee Bucks","Khris Middleton",0,25,30,25,10,30.5
1,1,2,2,0,7,1,4,3,"35",1,3,5,3,0,0,1037980,"2023-12-23T00:00:00.000Z",20,FALSE,17,283,"C",17,17,"Milwaukee Bucks","Brook Lopez",1,8,9,6,4,13.1
1,0,5,9,5,13,7,0,0,"31",1,3,19,6,0,0,1037980,"2023-12-23T00:00:00.000Z",20,FALSE,17,38,"G",17,17,"Milwaukee Bucks","Malik Beasley",0,25,26,20,7,27.7
7,0,6,7,3,16,6,5,4,"33",3,3,19,9,1,3,1037980,"2023-12-23T00:00:00.000Z",20,FALSE,17,278,"G",17,17,"Milwaukee Bucks","Damian Lillard",1,28,35,26,16,40.3
0,0,0,0,0,0,0,0,0,"00",0,0,0,0,0,0,1037980,"2023-12-23T00:00:00.000Z",20,FALSE,17,2148,"",17,17,"Milwaukee Bucks","Thanasis Antetokounmpo",0,0,0,0,0,0
0,0,1,0,0,0,0,0,0,"01",0,0,0,1,0,0,1037980,"2023-12-23T00:00:00.000Z",20,FALSE,17,38017676,"F",17,17,"Milwaukee Bucks","MarJon Beauchamp",0,1,1,0,1,1.2
0,0,8,5,2,6,3,0,0,"22",0,0,8,8,0,0,1037980,"2023-12-23T00:00:00.000Z",20,FALSE,17,105,"G",17,17,"Milwaukee Bucks","Pat Connaughton",0,16,16,8,8,17.6
0,0,0,0,0,0,0,0,0,"01",0,0,0,0,0,0,1037980,"2023-12-23T00:00:00.000Z",20,FALSE,17,38017733,"G",17,17,"Milwaukee Bucks","A.J. Green",0,0,0,0,0,0
2,0,0,0,0,0,0,0,0,"11",2,1,0,2,0,1,1037980,"2023-12-23T00:00:00.000Z",20,FALSE,17,56677852,"G",17,17,"Milwaukee Bucks","Andre Jackson Jr.",0,2,4,2,4,4.4
0,0,0,0,0,0,0,0,0,"01",0,0,0,0,0,0,1037980,"2023-12-23T00:00:00.000Z",20,FALSE,17,56677854,"F",17,17,"Milwaukee Bucks","Chris Livingston",0,0,0,0,0,0
1,1,6,5,2,17,5,2,1,"29",1,1,13,7,0,1,1037980,"2023-12-23T00:00:00.000Z",20,FALSE,17,666423,"F-G",20,20,"New York Knicks","RJ Barrett",1,20,21,14,8,24.9
1,0,7,2,0,17,8,10,10,"34",1,3,26,8,1,3,1037980,"2023-12-23T00:00:00.000Z",20,FALSE,17,387,"F",20,20,"New York Knicks","Julius Randle",1,34,35,27,9,37.1
1,0,6,0,0,5,4,4,4,"33",7,4,12,13,1,1,1037980,"2023-12-23T00:00:00.000Z",20,FALSE,17,201,"F-C",20,20,"New York Knicks","Isaiah Hartenstein",1,25,26,13,14,31.1
7,1,3,5,3,26,15,3,3,"37",0,2,36,3,0,3,1037980,"2023-12-23T00:00:00.000Z",20,FALSE,17,73,"G",20,20,"New York Knicks","Jalen Brunson",1,39,46,43,10,50.1
2,0,1,6,3,7,4,0,0,"24",1,3,11,2,1,1,1037980,"2023-12-23T00:00:00.000Z",20,FALSE,17,131,"G",20,20,"New York Knicks","Donte DiVincenzo",1,13,15,13,4,18.4
1,0,0,1,0,2,1,0,0,"14",1,2,2,1,0,0,1037980,"2023-12-23T00:00:00.000Z",20,FALSE,17,173,"F",30,20,"New York Knicks","Taj Gibson",0,3,4,3,2,4.7
0,0,0,0,0,0,0,0,0,"00",0,0,0,0,0,0,1037980,"2023-12-23T00:00:00.000Z",20,FALSE,17,284,"C",17,17,"Milwaukee Bucks","Robin Lopez",0,0,0,0,0,0
1,0,1,1,1,2,2,4,3,"14",0,0,8,1,0,0,1037980,"2023-12-23T00:00:00.000Z",20,FALSE,17,368,"G",17,17,"Milwaukee Bucks","Cameron Payne",0,9,10,9,2,10.7
1,0,9,4,3,14,9,2,2,"27",2,4,23,11,2,2,1037980,"2023-12-23T00:00:00.000Z",20,FALSE,17,377,"F",17,17,"Milwaukee Bucks","Bobby Portis",2,34,35,24,12,41.7
0,0,0,0,0,0,0,0,0,"00",0,0,0,0,0,0,1037980,"2023-12-23T00:00:00.000Z",20,FALSE,17,666453,"C",17,17,"Milwaukee Bucks","Marques Bolden",0,0,0,0,0,0
0,0,0,0,0,0,0,0,0,"00",0,0,0,0,0,0,1037980,"2023-12-23T00:00:00.000Z",20,FALSE,17,112,"F",17,17,"Milwaukee Bucks","Jae Crowder",0,0,0,0,0,0
0,0,0,0,0,0,0,0,0,"00",0,0,0,0,0,0,1037980,"2023-12-23T00:00:00.000Z",20,FALSE,17,38017691,"G",17,17,"Milwaukee Bucks","TyTy Washington Jr.",0,0,0,0,0,0
0,0,0,0,0,0,0,0,0,"00",0,0,0,0,0,0,1037980,"2023-12-23T00:00:00.000Z",20,FALSE,17,666960,"G",17,17,"Milwaukee Bucks","Lindell Wigginton",0,0,0,0,0,0
2,0,1,7,2,12,6,0,0,"37",0,3,14,1,0,0,1037997,"2023-12-25T00:00:00.000Z",24,FALSE,7,178,"G",24,24,"Phoenix Suns","Eric Gordon",0,15,17,16,3,18.2
7,1,7,3,1,11,4,7,7,"43",1,2,16,8,0,6,1037997,"2023-12-25T00:00:00.000Z",24,FALSE,7,140,"F",24,24,"Phoenix Suns","Kevin Durant",1,24,31,23,15,33.1
0,0,5,0,0,3,1,0,0,"17",2,3,2,7,1,1,1037997,"2023-12-25T00:00:00.000Z",24,FALSE,7,147,"F",24,24,"Phoenix Suns","Drew Eubanks",1,9,9,2,7,12.4
4,0,3,17,8,22,12,0,0,"39",1,4,32,4,1,2,1037997,"2023-12-25T00:00:00.000Z",24,FALSE,7,8,"G",24,24,"Phoenix Suns","Grayson Allen",1,36,40,36,8,43.8
10,1,3,4,1,14,6,10,7,"40",0,5,20,3,1,3,1037997,"2023-12-25T00:00:00.000Z",24,FALSE,7,57,"G",24,24,"Phoenix Suns","Devin Booker",2,23,33,30,13,41.6
0,0,0,0,0,2,2,0,0,"04",0,0,4,0,0,0,1037997,"2023-12-25T00:00:00.000Z",24,FALSE,7,3547095,"C-F",24,24,"Phoenix Suns","Udoka Azubuike",0,4,4,4,0,4
0,0,0,0,0,0,0,0,0,"00",0,0,0,0,0,0,1037997,"2023-12-25T00:00:00.000Z",24,FALSE,7,32,"F",24,24,"Phoenix Suns","Keita Bates-Diop",0,0,0,0,0,0
0,0,0,0,0,0,0,0,0,"00",0,0,0,0,0,0,1037997,"2023-12-25T00:00:00.000Z",24,FALSE,7,666451,"C",24,24,"Phoenix Suns","Bol Bol",0,0,0,0,0,0
1,0,0,1,0,3,0,2,2,"11",3,0,2,3,0,0,1037997,"2023-12-25T00:00:00.000Z",24,FALSE,7,18678058,"",24,24,"Phoenix Suns","Jordan Goodwin",0,5,6,3,4,7.1
0,0,0,0,0,0,0,0,0,"00",0,0,0,0,0,0,1037997,"2023-12-25T00:00:00.000Z",24,FALSE,7,3547298,"G",24,24,"Phoenix Suns","Saben Lee",0,0,0,0,0,0
0,0,0,0,0,0,0,0,0,"03",0,1,0,0,0,0,1037997,"2023-12-25T00:00:00.000Z",24,FALSE,7,666729,"F",24,24,"Phoenix Suns","Nassir Little",0,0,0,0,0,0
2,0,13,6,2,18,9,4,3,"34",6,1,23,19,1,3,1037997,"2023-12-25T00:00:00.000Z",24,FALSE,7,314,"F",24,24,"Phoenix Suns","Chimezie Metu",1,42,44,25,21,48.8
2,0,1,3,0,5,0,2,1,"12",1,2,1,2,1,0,1037997,"2023-12-25T00:00:00.000Z",24,FALSE,7,356,"G",24,24,"Phoenix Suns","Josh Okogie",1,3,5,3,4,9.4
0,0,0,0,0,0,0,0,0,"00",0,0,0,0,0,0,1037997,"2023-12-25T00:00:00.000Z",24,FALSE,7,470,"G",24,24,"Phoenix Suns","Yuta Watanabe",0,0,0,0,0,0
0,0,0,0,0,0,0,0,0,"00",0,0,0,0,0,0,1037997,"2023-12-25T00:00:00.000Z",24,FALSE,7,37,"G",24,24,"Phoenix Suns","Bradley Beal",0,0,0,0,0,0
0,0,0,0,0,0,0,0,0,"00",0,0,0,0,0,0,1037997,"2023-12-25T00:00:00.000Z",24,FALSE,7,272,"G",24,24,"Phoenix Suns","Damion Lee",0,0,0,0,0,0
0,0,0,0,0,0,0,0,0,"00",0,0,0,0,0,0,1037997,"2023-12-25T00:00:00.000Z",24,FALSE,7,3547253,"G",4,24,"Phoenix Suns","Theo Maledon",0,0,0,0,0,0
0,0,0,0,0,0,0,0,0,"00",0,0,0,0,0,0,1037997,"2023-12-25T00:00:00.000Z",24,FALSE,7,349,"C",24,24,"Phoenix Suns","Jusuf Nurkic",0,0,0,0,0,0
2,0,7,9,3,14,6,3,3,"38",0,4,18,7,1,1,1037997,"2023-12-25T00:00:00.000Z",24,FALSE,7,191,"G",7,7,"Dallas Mavericks","Tim Hardaway Jr.",1,25,27,20,9,31.4
1,0,1,8,3,18,9,4,2,"35",2,3,23,3,1,0,1037997,"2023-12-25T00:00:00.000Z",24,FALSE,7,247,"F-G",7,7,"Dallas Mavericks","Derrick Jones Jr.",1,26,27,24,4,31.1
1,0,7,0,0,9,8,9,4,"32",3,3,20,10,0,1,1037997,"2023-12-25T00:00:00.000Z",24,FALSE,7,56677840,"C",7,7,"Dallas Mavericks","Dereck Lively II",0,30,31,21,11,32.5
5,0,3,4,1,7,3,0,0,"33",1,3,7,4,1,3,1037997,"2023-12-25T00:00:00.000Z",24,FALSE,7,151,"G",7,7,"Dallas Mavericks","Dante Exum",1,11,16,12,9,19.3
14,3,5,16,8,25,15,12,12,"43",1,2,50,6,4,4,1037997,"2023-12-25T00:00:00.000Z",24,FALSE,7,132,"F-G",7,7,"Dallas Mavericks","Luka Doncic",7,56,70,64,20,95.2
0,0,0,0,0,0,0,0,0,"06",1,0,0,1,0,0,1037997,"2023-12-25T00:00:00.000Z",24,FALSE,7,114,"G",7,7,"Dallas Mavericks","Seth Curry",0,1,1,0,1,1.2
1,0,2,3,1,4,1,0,0,"13",0,0,3,2,0,0,1037997,"2023-12-25T00:00:00.000Z",24,FALSE,7,38017679,"G",7,7,"Dallas Mavericks","Jaden Hardy",0,5,6,4,3,6.9
0,0,0,0,0,0,0,0,0,"00",0,0,0,0,0,0,1037997,"2023-12-25T00:00:00.000Z",24,FALSE,7,217,"F-C",7,7,"Dallas Mavericks","Richaun Holmes",0,0,0,0,0,0
0,0,1,2,0,2,0,0,0,"05",0,0,0,1,0,0,1037997,"2023-12-25T00:00:00.000Z",24,FALSE,7,17554004,"G",7,7,"Dallas Mavericks","AJ Lawson",0,1,1,0,1,1.2
0,0,0,0,0,0,0,0,0,"00",0,0,0,0,0,0,1037997,"2023-12-25T00:00:00.000Z",24,FALSE,7,329,"F",7,7,"Dallas Mavericks","Markieff Morris",0,0,0,0,0,0
2,0,1,0,0,2,2,0,0,"07",0,1,4,1,0,0,1037997,"2023-12-25T00:00:00.000Z",24,FALSE,7,379,"F-C",7,7,"Dallas Mavericks","Dwight Powell",0,5,7,6,3,8.2
0,0,0,0,0,0,0,0,0,"01",0,0,0,0,0,0,1037997,"2023-12-25T00:00:00.000Z",24,FALSE,7,56677859,"F",7,7,"Dallas Mavericks","Olivier-Maxence Prosper",0,0,0,0,0,0
1,3,3,2,0,3,1,2,1,"27",0,4,3,3,0,2,1037997,"2023-12-25T00:00:00.000Z",24,FALSE,7,666965,"F",7,7,"Dallas Mavericks","Grant Williams",3,6,7,4,4,15.1
0,0,0,0,0,0,0,0,0,"00",0,0,0,0,0,0,1037997,"2023-12-25T00:00:00.000Z",24,FALSE,7,17896028,"F",7,7,"Dallas Mavericks","Greg Brown III",0,0,0,0,0,0
0,0,0,0,0,0,0,0,0,"00",0,0,0,0,0,0,1037997,"2023-12-25T00:00:00.000Z",24,FALSE,7,56677873,"G",7,7,"Dallas Mavericks","Dexter Dennis",0,0,0,0,0,0
0,0,0,0,0,0,0,0,0,"00",0,0,0,0,0,0,1037997,"2023-12-25T00:00:00.000Z",24,FALSE,7,3547258,"G",7,7,"Dallas Mavericks","Josh Green",0,0,0,0,0,0
0,0,0,0,0,0,0,0,0,"00",0,0,0,0,0,0,1037997,"2023-12-25T00:00:00.000Z",24,FALSE,7,228,"G",7,7,"Dallas Mavericks","Kyrie Irving",0,0,0,0,0,0
0,0,0,0,0,0,0,0,0,"00",0,0,0,0,0,0,1037997,"2023-12-25T00:00:00.000Z",24,FALSE,7,257,"F",7,7,"Dallas Mavericks","Maxi Kleber",0,0,0,0,0,0
1,0,5,5,2,14,8,4,3,"28",1,3,21,6,1,3,1037993,"2023-12-25T00:00:00.000Z",20,FALSE,17,666423,"F-G",20,20,"New York Knicks","RJ Barrett",1,27,28,22,7,29.7
2,0,8,5,2,17,8,6,6,"41",1,3,24,9,1,4,1037993,"2023-12-25T00:00:00.000Z",20,FALSE,17,387,"F",20,20,"New York Knicks","Julius Randle",1,33,35,26,11,36.8
4,1,4,0,0,7,5,2,1,"33",4,4,11,8,0,0,1037993,"2023-12-25T00:00:00.000Z",20,FALSE,17,201,"F-C",20,20,"New York Knicks","Isaiah Hartenstein",1,19,23,15,12,29.6
6,0,3,3,1,28,15,9,7,"37",1,0,38,4,1,0,1037993,"2023-12-25T00:00:00.000Z",20,FALSE,17,73,"G",20,20,"New York Knicks","Jalen Brunson",1,42,48,44,10,54.8
4,0,1,5,1,6,1,0,0,"21",0,4,3,1,1,1,1037993,"2023-12-25T00:00:00.000Z",20,FALSE,17,131,"G",20,20,"New York Knicks","Donte DiVincenzo",1,4,8,7,5,12.2
0,0,0,0,0,0,0,0,0,"00",0,0,0,0,0,0,1037993,"2023-12-25T00:00:00.000Z",20,FALSE,17,19,"G",20,20,"New York Knicks","Ryan Arcidiacono",0,0,0,0,0,0
0,0,0,0,0,0,0,0,0,"00",0,0,0,0,0,0,1037993,"2023-12-25T00:00:00.000Z",20,FALSE,17,666474,"G",20,20,"New York Knicks","Charles Brown",0,0,0,0,0,0
0,0,0,0,0,0,0,0,0,"00",0,0,0,0,0,0,1037993,"2023-12-25T00:00:00.000Z",20,FALSE,17,160,"G-F",20,20,"New York Knicks","Evan Fournier",0,0,0,0,0,0
3,3,3,1,0,1,0,0,0,"15",0,2,0,3,0,0,1037993,"2023-12-25T00:00:00.000Z",20,FALSE,17,173,"F",30,20,"New York Knicks","Taj Gibson",3,3,6,3,6,17.1
2,0,1,1,0,2,1,1,0,"12",0,0,2,1,0,0,1037993,"2023-12-25T00:00:00.000Z",20,FALSE,17,17895858,"G",20,20,"New York Knicks","Quentin Grimes",0,3,5,4,3,6.2
4,0,9,2,0,7,5,0,0,"31",0,1,10,9,2,2,1037993,"2023-12-25T00:00:00.000Z",20,FALSE,17,202,"G",20,20,"New York Knicks","Josh Hart",2,19,23,14,13,30.8
0,0,0,0,0,0,0,0,0,"00",0,0,0,0,0,0,1037993,"2023-12-25T00:00:00.000Z",20,FALSE,17,666675,"F",20,20,"New York Knicks","DaQuan Jeffries",0,0,0,0,0,0
0,0,0,0,0,0,0,0,0,"00",0,0,0,0,0,0,1037993,"2023-12-25T00:00:00.000Z",20,FALSE,17,17896033,"G",20,20,"New York Knicks","Miles McBride",0,0,0,0,0,0
1,0,0,4,2,10,7,4,4,"22",0,1,20,0,1,1,1037993,"2023-12-25T00:00:00.000Z",20,FALSE,17,3547269,"G",20,20,"New York Knicks","Immanuel Quickley",1,20,21,21,1,23.5
0,0,0,0,0,0,0,0,0,"00",0,0,0,0,0,0,1037993,"2023-12-25T00:00:00.000Z",20,FALSE,17,NA,NA,NA,20,"New York Knicks","NA NA",0,0,0,0,0,0
0,0,0,0,0,0,0,0,0,"00",0,0,0,0,0,0,1037993,"2023-12-25T00:00:00.000Z",20,FALSE,17,399,"C",20,20,"New York Knicks","Mitchell Robinson",0,0,0,0,0,0
0,0,0,0,0,0,0,0,0,"00",0,0,0,0,0,0,1037993,"2023-12-25T00:00:00.000Z",20,FALSE,17,17896063,"F",20,20,"New York Knicks","Jericho Sims",0,0,0,0,0,0
0,0,0,0,0,0,0,0,0,"00",0,0,0,0,0,0,1037993,"2023-12-25T00:00:00.000Z",20,FALSE,17,56677795,"F",20,20,"New York Knicks","Jacob Toppin",0,0,0,0,0,0
6,2,8,2,1,24,13,9,5,"39",5,4,32,13,1,2,1037993,"2023-12-25T00:00:00.000Z",20,FALSE,17,15,"F",17,17,"Milwaukee Bucks","Giannis Antetokounmpo",3,45,51,38,19,63.6
6,0,2,9,4,20,10,0,0,"33",0,4,24,2,1,2,1037993,"2023-12-25T00:00:00.000Z",20,FALSE,17,315,"F",17,17,"Milwaukee Bucks","Khris Middleton",1,26,32,30,8,36.4
1,2,4,6,2,9,5,2,2,"27",2,2,14,6,1,0,1037993,"2023-12-25T00:00:00.000Z",20,FALSE,17,283,"C",17,17,"Milwaukee Bucks","Brook Lopez",3,20,21,15,7,31.7
2,0,3,1,0,2,0,0,0,"19",0,2,0,3,0,0,1037993,"2023-12-25T00:00:00.000Z",20,FALSE,17,38,"G",17,17,"Milwaukee Bucks","Malik Beasley",0,3,5,2,5,6.6
8,0,1,13,4,21,10,9,8,"38",0,2,32,1,1,4,1037993,"2023-12-25T00:00:00.000Z",20,FALSE,17,278,"G",17,17,"Milwaukee Bucks","Damian Lillard",1,33,41,40,9,44.2
0,0,0,0,0,0,0,0,0,"00",0,0,0,0,0,0,1037993,"2023-12-25T00:00:00.000Z",20,FALSE,17,2148,"",17,17,"Milwaukee Bucks","Thanasis Antetokounmpo",0,0,0,0,0,0
0,0,1,0,0,0,0,0,0,"06",0,0,0,1,1,0,1037993,"2023-12-25T00:00:00.000Z",20,FALSE,17,38017676,"F",17,17,"Milwaukee Bucks","MarJon Beauchamp",1,1,1,0,1,4.2
1,0,3,4,1,4,1,0,0,"24",4,3,3,7,1,0,1037993,"2023-12-25T00:00:00.000Z",20,FALSE,17,105,"G",17,17,"Milwaukee Bucks","Pat Connaughton",1,10,11,4,8,15.9
0,0,0,0,0,0,0,0,0,"00",0,0,0,0,0,0,1037993,"2023-12-25T00:00:00.000Z",20,FALSE,17,38017733,"G",17,17,"Milwaukee Bucks","A.J. Green",0,0,0,0,0,0
1,0,1,1,0,2,0,2,2,"14",1,2,2,2,1,0,1037993,"2023-12-25T00:00:00.000Z",20,FALSE,17,56677852,"G",17,17,"Milwaukee Bucks","Andre Jackson Jr.",1,4,5,3,3,8.9
0,0,0,0,0,0,0,0,0,"00",0,0,0,0,0,0,1037993,"2023-12-25T00:00:00.000Z",20,FALSE,17,56677854,"F",17,17,"Milwaukee Bucks","Chris Livingston",0,0,0,0,0,0
0,0,0,0,0,0,0,0,0,"00",0,0,0,0,0,0,1037993,"2023-12-25T00:00:00.000Z",20,FALSE,17,284,"C",17,17,"Milwaukee Bucks","Robin Lopez",0,0,0,0,0,0
1,0,0,2,1,2,1,0,0,"10",0,0,3,0,0,0,1037993,"2023-12-25T00:00:00.000Z",20,FALSE,17,368,"G",17,17,"Milwaukee Bucks","Cameron Payne",0,3,4,4,1,4.5
0,0,4,4,0,11,5,2,2,"30",5,4,12,9,0,3,1037993,"2023-12-25T00:00:00.000Z",20,FALSE,17,377,"F",17,17,"Milwaukee Bucks","Bobby Portis",0,21,21,12,9,19.8
0,0,0,0,0,0,0,0,0,"00",0,0,0,0,0,0,1037993,"2023-12-25T00:00:00.000Z",20,FALSE,17,666453,"C",17,17,"Milwaukee Bucks","Marques Bolden",0,0,0,0,0,0
0,0,0,0,0,0,0,0,0,"00",0,0,0,0,0,0,1037993,"2023-12-25T00:00:00.000Z",20,FALSE,17,112,"F",17,17,"Milwaukee Bucks","Jae Crowder",0,0,0,0,0,0
0,0,0,0,0,0,0,0,0,"00",0,0,0,0,0,0,1037993,"2023-12-25T00:00:00.000Z",20,FALSE,17,38017691,"G",17,17,"Milwaukee Bucks","TyTy Washington Jr.",0,0,0,0,0,0
0,0,0,0,0,0,0,0,0,"00",0,0,0,0,0,0,1037993,"2023-12-25T00:00:00.000Z",20,FALSE,17,666960,"G",17,17,"Milwaukee Bucks","Lindell Wigginton",0,0,0,0,0,0
1,4,10,10,3,17,8,0,0,"40",0,1,19,10,0,0,1037994,"2023-12-25T00:00:00.000Z",8,FALSE,10,375,"F",8,8,"Denver Nuggets","Michael Porter Jr.",4,29,30,20,11,44.5
3,0,6,4,1,10,7,4,1,"32",4,2,16,10,1,2,1037994,"2023-12-25T00:00:00.000Z",8,FALSE,10,177,"F",8,8,"Denver Nuggets","Aaron Gordon",1,26,29,19,13,33.5
8,0,10,2,0,12,4,18,18,"39",4,2,26,14,0,3,1037994,"2023-12-25T00:00:00.000Z",8,FALSE,10,246,"C",8,8,"Denver Nuggets","Nikola Jokic",0,40,48,34,22,51.8
5,0,3,9,4,13,6,0,0,"37",1,1,16,4,2,0,1037994,"2023-12-25T00:00:00.000Z",8,FALSE,10,81,"G",8,8,"Denver Nuggets","Kentavious Caldwell-Pope",2,20,25,21,9,34.3
3,0,4,5,3,18,10,5,5,"33",1,4,28,5,2,2,1037994,"2023-12-25T00:00:00.000Z",8,FALSE,10,335,"G",8,8,"Denver Nuggets","Jamal Murray",2,33,36,31,8,42.5
1,0,0,2,2,4,2,2,0,"11",0,3,6,0,0,1,1037994,"2023-12-25T00:00:00.000Z",8,FALSE,10,38017709,"G",8,8,"Denver Nuggets","Christian Braun",0,6,7,7,1,6.5
0,0,0,0,0,0,0,0,0,"00",0,0,0,0,0,0,1037994,"2023-12-25T00:00:00.000Z",8,FALSE,10,215,"F-G",8,8,"Denver Nuggets","Justin Holiday",0,0,0,0,0,0
3,0,0,0,0,2,0,2,2,"15",0,1,2,0,0,4,1037994,"2023-12-25T00:00:00.000Z",8,FALSE,10,236,"G",8,8,"Denver Nuggets","Reggie Jackson",0,2,5,5,3,2.5
0,0,0,0,0,0,0,0,0,"00",0,0,0,0,0,0,1037994,"2023-12-25T00:00:00.000Z",8,FALSE,10,250,"C",8,8,"Denver Nuggets","DeAndre Jordan",0,0,0,0,0,0
0,0,0,0,0,0,0,0,0,"00",0,0,0,0,0,0,1037994,"2023-12-25T00:00:00.000Z",8,FALSE,10,17896007,"G",8,8,"Denver Nuggets","Braxton Key",0,0,0,0,0,0
0,0,0,0,0,0,0,0,0,"05",0,1,0,0,1,0,1037994,"2023-12-25T00:00:00.000Z",8,FALSE,10,3547268,"F-C",8,8,"Denver Nuggets","Zeke Nnaji",1,0,0,0,0,3
0,0,0,0,0,0,0,0,0,"00",0,0,0,0,0,0,1037994,"2023-12-25T00:00:00.000Z",8,FALSE,10,56677582,"G",8,8,"Denver Nuggets","Jalen Pickett",0,0,0,0,0,0
0,0,0,0,0,1,1,1,0,"08",0,0,2,0,0,0,1037994,"2023-12-25T00:00:00.000Z",8,FALSE,10,56677776,"G",8,8,"Denver Nuggets","Julian Strawther",0,2,2,2,0,2
0,0,0,0,0,0,0,0,0,"00",0,0,0,0,0,0,1037994,"2023-12-25T00:00:00.000Z",8,FALSE,10,56677871,"F",8,8,"Denver Nuggets","Hunter Tyson",0,0,0,0,0,0
1,0,0,2,1,5,2,0,0,"20",0,2,5,0,0,2,1037994,"2023-12-25T00:00:00.000Z",8,FALSE,10,38017721,"G",8,8,"Denver Nuggets","Peyton Watson",0,5,6,6,1,4.5
0,0,0,0,0,0,0,0,0,"00",0,0,0,0,0,0,1037994,"2023-12-25T00:00:00.000Z",8,FALSE,10,666489,"F",8,8,"Denver Nuggets","Vlatko Cancar",0,0,0,0,0,0
0,0,0,0,0,0,0,0,0,"00",0,0,0,0,0,0,1037994,"2023-12-25T00:00:00.000Z",8,FALSE,10,17896103,"F-C",8,8,"Denver Nuggets","Jay Huff",0,0,0,0,0,0
1,1,6,10,3,12,3,0,0,"32",0,1,9,6,1,3,1037994,"2023-12-25T00:00:00.000Z",8,FALSE,10,443,"G",10,10,"Golden State Warriors","Klay Thompson",2,15,16,10,7,20.7
2,0,5,1,0,8,4,8,5,"23",0,1,13,5,0,1,1037994,"2023-12-25T00:00:00.000Z",8,FALSE,10,17553979,"F",10,10,"Golden State Warriors","Jonathan Kuminga",0,18,20,15,7,21
2,0,3,0,0,3,2,0,0,"22",0,3,4,3,0,1,1037994,"2023-12-25T00:00:00.000Z",8,FALSE,10,282,"F",10,10,"Golden State Warriors","Kevon Looney",0,7,9,6,5,9.6
6,0,5,4,3,7,4,2,2,"34",4,1,13,9,5,2,1037994,"2023-12-25T00:00:00.000Z",8,FALSE,10,56677858,"G",10,10,"Golden State Warriors","Brandin Podziemski",5,22,28,19,15,45.8
4,1,1,13,3,21,7,1,1,"34",1,4,18,2,1,3,1037994,"2023-12-25T00:00:00.000Z",8,FALSE,10,115,"G",10,10,"Golden State Warriors","Stephen Curry",2,20,24,22,6,29.4
0,0,0,0,0,0,0,0,0,"00",0,0,0,0,0,0,1037994,"2023-12-25T00:00:00.000Z",8,FALSE,10,17896070,"F",10,10,"Golden State Warriors","Usman Garuba",0,0,0,0,0,0
0,0,0,0,0,0,0,0,0,"00",0,0,0,0,0,0,1037994,"2023-12-25T00:00:00.000Z",8,FALSE,10,185,"F",10,10,"Golden State Warriors","Draymond Green",0,0,0,0,0,0
0,0,0,0,0,0,0,0,0,"00",0,0,0,0,0,0,1037994,"2023-12-25T00:00:00.000Z",8,FALSE,10,38017727,"G",8,8,"Denver Nuggets","Collin Gillespie",0,0,0,0,0,0
1,0,3,0,0,4,3,2,2,"15",0,5,8,3,0,0,1037994,"2023-12-25T00:00:00.000Z",8,FALSE,10,56677799,"F",10,10,"Golden State Warriors","Trayce Jackson-Davis",0,11,12,9,4,13.1
0,0,0,0,0,0,0,0,0,"00",0,0,0,0,0,0,1037994,"2023-12-25T00:00:00.000Z",8,FALSE,10,251,"G",10,10,"Golden State Warriors","Cory Joseph",0,0,0,0,0,0
0,0,0,0,0,0,0,0,0,"03",0,0,0,0,0,0,1037994,"2023-12-25T00:00:00.000Z",8,FALSE,10,17553992,"G",10,10,"Golden State Warriors","Moses Moody",0,0,0,0,0,0
3,0,2,5,3,10,5,0,0,"28",1,1,13,3,0,1,1037994,"2023-12-25T00:00:00.000Z",8,FALSE,10,367,"G",10,10,"Golden State Warriors","Chris Paul",0,16,19,16,6,20.1
0,0,0,0,0,0,0,0,0,"00",0,0,0,0,0,0,1037994,"2023-12-25T00:00:00.000Z",8,FALSE,10,57875092,"F",10,10,"Golden State Warriors","Gui Santos",0,0,0,0,0,0
2,0,3,3,0,11,5,4,4,"20",2,2,14,5,0,0,1037994,"2023-12-25T00:00:00.000Z",8,FALSE,10,407,"F",10,10,"Golden State Warriors","Dario Saric",0,19,21,16,7,23
2,1,2,4,2,11,7,6,6,"29",1,5,22,3,0,2,1037994,"2023-12-25T00:00:00.000Z",8,FALSE,10,475,"F-G",10,10,"Golden State Warriors","Andrew Wiggins",1,25,27,24,5,29.6
0,0,0,0,0,0,0,0,0,"00",0,0,0,0,0,0,1037994,"2023-12-25T00:00:00.000Z",8,FALSE,10,2189,"",10,10,"Golden State Warriors","Gary Payton II",0,0,0,0,0,0
0,0,0,0,0,0,0,0,0,"00",0,0,0,0,0,0,1037994,"2023-12-25T00:00:00.000Z",8,FALSE,10,45658838,"G",10,10,"Golden State Warriors","Lester Quinones",0,0,0,0,0,0
0,0,0,0,0,0,0,0,0,"00",0,0,0,0,0,0,1037994,"2023-12-25T00:00:00.000Z",8,FALSE,10,398,"G",10,10,"Golden State Warriors","Jerome Robinson",0,0,0,0,0,0
0,0,0,1,1,2,1,2,2,"18",0,2,5,0,0,2,1037995,"2023-12-25T00:00:00.000Z",14,FALSE,2,666860,"F-G",14,14,"Los Angeles Lakers","Cameron Reddish",0,5,5,5,0,3
0,0,2,0,0,5,3,0,0,"23",4,4,6,6,1,0,1037995,"2023-12-25T00:00:00.000Z",14,FALSE,2,457,"F",14,14,"Los Angeles Lakers","Jarred Vanderbilt",1,12,12,6,6,16.2
4,1,8,4,2,26,15,10,8,"39",5,2,40,13,0,2,1037995,"2023-12-25T00:00:00.000Z",14,FALSE,2,117,"F-C",14,14,"Los Angeles Lakers","Anthony Davis",1,53,57,44,17,62.6
3,0,4,12,5,13,6,0,0,"39",0,4,17,4,1,0,1037995,"2023-12-25T00:00:00.000Z",14,FALSE,2,383,"F",14,14,"Los Angeles Lakers","Taurean Prince",1,21,24,20,7,29.3
8,0,9,2,1,14,5,6,5,"37",0,1,16,9,0,3,1037995,"2023-12-25T00:00:00.000Z",14,FALSE,2,237,"F",14,14,"Los Angeles Lakers","LeBron James",0,25,33,24,17,35.8
0,0,0,0,0,0,0,0,0,"00",0,0,0,0,0,0,1037995,"2023-12-25T00:00:00.000Z",14,FALSE,2,38017697,"G",14,14,"Los Angeles Lakers","Max Christie",0,0,0,0,0,0
0,0,3,9,2,14,5,0,0,"29",0,2,12,3,0,1,1037995,"2023-12-25T00:00:00.000Z",14,FALSE,2,666609,"F",14,14,"Los Angeles Lakers","Rui Hachimura",0,15,15,12,3,14.6
0,0,1,0,0,1,0,2,0,"09",0,0,0,1,0,0,1037995,"2023-12-25T00:00:00.000Z",14,FALSE,2,666626,"C",14,14,"Los Angeles Lakers","Jaxson Hayes",0,1,1,0,1,1.2
0,0,0,0,0,0,0,0,0,"00",0,0,0,0,0,0,1037995,"2023-12-25T00:00:00.000Z",14,FALSE,2,56677835,"G",14,14,"Los Angeles Lakers","Jalen Hood-Schifino",0,0,0,0,0,0
0,0,0,0,0,0,0,0,0,"00",0,0,0,0,0,0,1037995,"2023-12-25T00:00:00.000Z",14,FALSE,2,56677836,"F",14,14,"Los Angeles Lakers","Maxwell Lewis",0,0,0,0,0,0
3,0,2,3,2,9,4,1,1,"28",4,3,11,6,1,2,1037995,"2023-12-25T00:00:00.000Z",14,FALSE,2,17553995,"G",14,14,"Los Angeles Lakers","Austin Reaves",1,17,20,14,9,23.7
6,0,1,1,0,6,4,0,0,"18",0,1,8,1,1,2,1037995,"2023-12-25T00:00:00.000Z",14,FALSE,2,405,"G",14,14,"Los Angeles Lakers","D'Angelo Russell",1,9,15,14,7,19.2
0,0,0,0,0,0,0,0,0,"00",0,0,0,0,0,0,1037995,"2023-12-25T00:00:00.000Z",14,FALSE,2,486,"F",14,14,"Los Angeles Lakers","Christian Wood",0,0,0,0,0,0
0,0,0,0,0,0,0,0,0,"00",0,0,0,0,0,0,1037995,"2023-12-25T00:00:00.000Z",14,FALSE,2,56677738,"C",14,14,"Los Angeles Lakers","Colin Castleton",0,0,0,0,0,0
0,0,0,0,0,0,0,0,0,"00",0,0,0,0,0,0,1037995,"2023-12-25T00:00:00.000Z",14,FALSE,2,56677867,"F",14,14,"Los Angeles Lakers","Alex Fudge",0,0,0,0,0,0
0,0,0,0,0,0,0,0,0,"00",0,0,0,0,0,0,1037995,"2023-12-25T00:00:00.000Z",14,FALSE,2,56677868,"G",14,14,"Los Angeles Lakers","D'Moi Hodge",0,0,0,0,0,0
0,0,0,0,0,0,0,0,0,"00",0,0,0,0,0,0,1037995,"2023-12-25T00:00:00.000Z",14,FALSE,2,1603383,"G",14,14,"Los Angeles Lakers","Gabe Vincent",0,0,0,0,0,0
2,0,2,5,1,17,7,7,4,"33",3,3,19,5,3,2,1037995,"2023-12-25T00:00:00.000Z",14,FALSE,2,70,"G",2,2,"Boston Celtics","Jaylen Brown",3,24,26,21,7,35
7,1,8,6,1,15,6,13,12,"41",0,0,25,8,0,1,1037995,"2023-12-25T00:00:00.000Z",14,FALSE,2,434,"F",2,2,"Boston Celtics","Jayson Tatum",1,33,40,32,15,47.1
1,0,1,0,0,0,0,0,0,"07",0,3,0,1,1,0,1037995,"2023-12-25T00:00:00.000Z",14,FALSE,2,17553967,"C",2,2,"Boston Celtics","Neemias Queta",1,1,2,1,2,5.7
2,2,8,8,2,19,11,7,4,"35",3,3,28,11,1,1,1037995,"2023-12-25T00:00:00.000Z",14,FALSE,2,378,"F-C",2,2,"Boston Celtics","Kristaps Porzingis",3,39,41,30,13,52.2
11,2,2,4,2,13,8,0,0,"35",0,3,18,2,2,2,1037995,"2023-12-25T00:00:00.000Z",14,FALSE,2,473,"G",2,2,"Boston Celtics","Derrick White",4,20,31,29,13,46.9
7,1,5,5,3,10,7,1,1,"38",2,1,18,7,1,2,1037995,"2023-12-25T00:00:00.000Z",14,FALSE,2,214,"G",2,2,"Boston Celtics","Jrue Holiday",2,25,32,25,14,40.9
0,0,0,0,0,0,0,0,0,"00",0,0,0,0,0,0,1037995,"2023-12-25T00:00:00.000Z",14,FALSE,2,17896094,"G",2,2,"Boston Celtics","Dalano Banton",0,0,0,0,0,0
0,0,1,4,0,5,1,0,0,"15",1,0,2,2,0,0,1037995,"2023-12-25T00:00:00.000Z",14,FALSE,2,17896060,"F",2,2,"Boston Celtics","Sam Hauser",0,4,4,2,2,4.4
1,1,6,4,2,4,2,0,0,"23",0,3,6,6,0,0,1037995,"2023-12-25T00:00:00.000Z",14,FALSE,2,219,"C-F",2,2,"Boston Celtics","Al Horford",1,12,13,7,7,17.7
0,0,0,6,2,8,4,0,0,"13",2,1,10,2,0,0,1037995,"2023-12-25T00:00:00.000Z",14,FALSE,2,3547276,"G",2,2,"Boston Celtics","Payton Pritchard",0,12,12,10,2,12.4
0,0,0,0,0,0,0,0,0,"00",0,0,0,0,0,0,1037995,"2023-12-25T00:00:00.000Z",14,FALSE,2,666468,"F",2,2,"Boston Celtics","Oshae Brissett",0,0,0,0,0,0
0,0,0,0,0,0,0,0,0,"00",0,0,0,0,0,0,1037995,"2023-12-25T00:00:00.000Z",14,FALSE,2,38017707,"G",2,2,"Boston Celtics","JD Davison",0,0,0,0,0,0
0,0,0,0,0,0,0,0,0,"00",0,0,0,0,0,0,1037995,"2023-12-25T00:00:00.000Z",14,FALSE,2,261,"F-C",2,2,"Boston Celtics","Luke Kornet",0,0,0,0,0,0
0,0,0,0,0,0,0,0,0,"00",0,0,0,0,0,0,1037995,"2023-12-25T00:00:00.000Z",14,FALSE,2,NA,NA,NA,2,"Boston Celtics","NA NA",0,0,0,0,0,0
0,0,0,0,0,0,0,0,0,"00",0,0,0,0,0,0,1037995,"2023-12-25T00:00:00.000Z",14,FALSE,2,56677864,"G",2,2,"Boston Celtics","Jordan Walsh",0,0,0,0,0,0
0,0,0,0,0,0,0,0,0,"00",0,0,0,0,0,0,1037995,"2023-12-25T00:00:00.000Z",14,FALSE,2,338,"G",2,2,"Boston Celtics","Svi Mykhailiuk",0,0,0,0,0,0
0,0,0,0,0,0,0,0,0,"00",0,0,0,0,0,0,1037995,"2023-12-25T00:00:00.000Z",14,FALSE,2,3547279,"F",2,2,"Boston Celtics","Lamar Stevens",0,0,0,0,0,0
1,0,5,3,1,15,11,8,8,"40",5,3,31,10,2,0,1037996,"2023-12-25T00:00:00.000Z",16,FALSE,23,56677785,"G",16,16,"Miami Heat","Jaime Jaquez Jr.",2,41,42,32,11,50.5
1,0,4,0,0,0,0,2,1,"09",1,1,1,5,0,2,1037996,"2023-12-25T00:00:00.000Z",16,FALSE,23,666747,"F",16,16,"Miami Heat","Caleb Martin",0,6,7,2,6,6.5
5,3,12,0,0,15,9,12,8,"36",3,1,26,15,0,4,1037996,"2023-12-25T00:00:00.000Z",16,FALSE,23,4,"C-F",16,16,"Miami Heat","Bam Adebayo",3,41,46,31,20,56.5
5,1,4,11,4,25,8,3,2,"38",2,1,22,6,1,4,1037996,"2023-12-25T00:00:00.000Z",16,FALSE,23,666633,"G",16,16,"Miami Heat","Tyler Herro",2,28,33,27,11,38.7
4,1,1,3,1,7,5,1,1,"33",0,4,12,1,1,3,1037996,"2023-12-25T00:00:00.000Z",16,FALSE,23,286,"G",16,16,"Miami Heat","Kyle Lowry",2,13,17,16,5,22.2
0,0,0,0,0,0,0,0,0,"00",0,0,0,0,0,0,1037996,"2023-12-25T00:00:00.000Z",16,FALSE,23,74,"C",16,16,"Miami Heat","Thomas Bryant",0,0,0,0,0,0
0,1,4,0,0,2,0,4,3,"17",1,4,3,5,0,0,1037996,"2023-12-25T00:00:00.000Z",16,FALSE,23,38017734,"F",16,16,"Miami Heat","Jamal Cain",1,8,8,3,5,12
4,0,0,3,0,4,0,0,0,"17",0,0,0,0,0,0,1037996,"2023-12-25T00:00:00.000Z",16,FALSE,23,3547257,"G",16,16,"Miami Heat","R.J. Hampton",0,0,4,4,4,6
0,0,0,0,0,0,0,0,0,"00",0,0,0,0,0,0,1037996,"2023-12-25T00:00:00.000Z",16,FALSE,23,38017696,"F",16,16,"Miami Heat","Nikola Jovic",0,0,0,0,0,0
5,0,9,2,1,3,2,4,3,"16",1,0,8,10,0,1,1037996,"2023-12-25T00:00:00.000Z",16,FALSE,23,285,"F-C",16,16,"Miami Heat","Kevin Love",0,18,23,13,15,26.5
2,0,4,10,5,13,5,1,1,"34",0,3,16,4,1,0,1037996,"2023-12-25T00:00:00.000Z",16,FALSE,23,397,"F",16,16,"Miami Heat","Duncan Robinson",1,20,22,18,6,26.8
0,0,0,0,0,0,0,0,0,"00",0,0,0,0,0,0,1037996,"2023-12-25T00:00:00.000Z",16,FALSE,23,39398582,"C",16,16,"Miami Heat","Orlando Robinson",0,0,0,0,0,0
0,0,0,0,0,0,0,0,0,"00",0,0,0,0,0,0,1037996,"2023-12-25T00:00:00.000Z",16,FALSE,23,38017736,"F",16,16,"Miami Heat","Cole Swider",0,0,0,0,0,0
0,0,0,0,0,0,0,0,0,"00",0,0,0,0,0,0,1037996,"2023-12-25T00:00:00.000Z",16,FALSE,23,79,"G-F",16,16,"Miami Heat","Jimmy Butler",0,0,0,0,0,0
0,0,0,0,0,0,0,0,0,"00",0,0,0,0,0,0,1037996,"2023-12-25T00:00:00.000Z",16,FALSE,23,3092,"",16,16,"Miami Heat","Haywood Highsmith",0,0,0,0,0,0
0,0,0,0,0,0,0,0,0,"00",0,0,0,0,0,0,1037996,"2023-12-25T00:00:00.000Z",16,FALSE,23,391,"G-F",16,16,"Miami Heat","Josh Richardson",0,0,0,0,0,0
0,0,0,0,0,0,0,0,0,"00",0,0,0,0,0,0,1037996,"2023-12-25T00:00:00.000Z",16,FALSE,23,19465585,"G",16,16,"Miami Heat","Dru Smith",0,0,0,0,0,0
3,1,6,9,6,16,9,3,1,"40",1,3,25,7,1,1,1037996,"2023-12-25T00:00:00.000Z",16,FALSE,23,360,"F",23,23,"Philadelphia 76ers","Kelly Oubre Jr.",2,32,35,28,10,42.9
6,0,6,7,4,18,10,3,3,"42",1,3,27,7,1,2,1037996,"2023-12-25T00:00:00.000Z",16,FALSE,23,200,"F",23,23,"Philadelphia 76ers","Tobias Harris",1,34,40,33,13,45.4
1,1,2,1,0,3,2,2,0,"17",0,5,4,2,0,0,1037996,"2023-12-25T00:00:00.000Z",16,FALSE,23,3547270,"F",23,23,"Philadelphia 76ers","Paul Reed",1,6,7,5,3,10.9
5,1,5,9,2,17,5,3,3,"36",2,2,15,7,4,0,1037996,"2023-12-25T00:00:00.000Z",16,FALSE,23,313,"G",23,23,"Philadelphia 76ers","De'Anthony Melton",5,22,27,20,12,45.9
5,1,3,8,1,20,4,6,3,"43",0,4,12,3,1,0,1037996,"2023-12-25T00:00:00.000Z",16,FALSE,23,3547254,"G",23,23,"Philadelphia 76ers","Tyrese Maxey",2,15,20,17,8,29.1
2,0,5,3,3,8,7,2,1,"25",1,2,18,6,2,1,1037996,"2023-12-25T00:00:00.000Z",16,FALSE,23,28,"C",23,23,"Philadelphia 76ers","Mo Bamba",2,24,26,20,8,33.2
0,0,3,3,1,4,2,4,4,"13",0,2,9,3,0,2,1037996,"2023-12-25T00:00:00.000Z",16,FALSE,23,45,"G",23,23,"Philadelphia 76ers","Patrick Beverley",0,12,12,9,3,10.6
0,0,0,0,0,0,0,0,0,"00",0,0,0,0,0,0,1037996,"2023-12-25T00:00:00.000Z",16,FALSE,23,108,"F",23,23,"Philadelphia 76ers","Robert Covington",0,0,0,0,0,0
0,0,0,2,0,3,0,2,1,"06",0,0,1,0,1,1,1037996,"2023-12-25T00:00:00.000Z",16,FALSE,23,2175,"",23,23,"Philadelphia 76ers","Danuel House Jr.",1,1,1,1,0,3
0,0,0,0,0,0,0,0,0,"00",0,0,0,0,0,0,1037996,"2023-12-25T00:00:00.000Z",16,FALSE,23,260,"G-F",23,23,"Philadelphia 76ers","Furkan Korkmaz",0,0,0,0,0,0
0,0,0,0,0,0,0,0,0,"00",0,0,0,0,0,0,1037996,"2023-12-25T00:00:00.000Z",16,FALSE,23,38017732,"F",15,23,"Philadelphia 76ers","Kenneth Lofton Jr.",0,0,0,0,0,0
1,0,0,0,0,1,1,0,0,"06",0,0,2,0,1,0,1037996,"2023-12-25T00:00:00.000Z",16,FALSE,23,3547294,"F",23,23,"Philadelphia 76ers","Kenyon Martin Jr.",1,2,3,3,1,6.5
0,0,1,3,0,4,0,0,0,"11",0,1,0,1,0,0,1037996,"2023-12-25T00:00:00.000Z",16,FALSE,23,328,"F",23,23,"Philadelphia 76ers","Marcus Morris",0,1,1,0,1,1.2
0,0,0,0,0,0,0,0,0,"01",0,0,0,0,0,0,1037996,"2023-12-25T00:00:00.000Z",16,FALSE,23,17896025,"G",23,23,"Philadelphia 76ers","Jaden Springer",0,0,0,0,0,0
0,0,0,0,0,0,0,0,0,"00",0,0,0,0,0,0,1037996,"2023-12-25T00:00:00.000Z",16,FALSE,23,33,"F-G",23,23,"Philadelphia 76ers","Nicolas Batum",0,0,0,0,0,0
0,0,0,0,0,0,0,0,0,"00",0,0,0,0,0,0,1037996,"2023-12-25T00:00:00.000Z",16,FALSE,23,56913527,"G",23,23,"Philadelphia 76ers","Ricky Council IV",0,0,0,0,0,0
0,0,0,0,0,0,0,0,0,"00",0,0,0,0,0,0,1037996,"2023-12-25T00:00:00.000Z",16,FALSE,23,145,"F-C",23,23,"Philadelphia 76ers","Joel Embiid",0,0,0,0,0,0
0,0,0,0,0,0,0,0,0,"00",0,0,0,0,0,0,1037996,"2023-12-25T00:00:00.000Z",16,FALSE,23,56677788,"G",23,23,"Philadelphia 76ers","Terquavion Smith",0,0,0,0,0,0
6,0,2,3,2,17,8,7,7,"40",0,3,25,2,1,1,1038000,"2023-12-26T00:00:00.000Z",5,FALSE,1,125,"G",5,5,"Chicago Bulls","DeMar DeRozan",1,27,33,31,8,38.4
0,0,0,1,0,7,2,2,2,"25",1,2,6,1,1,1,1038000,"2023-12-26T00:00:00.000Z",5,FALSE,1,3547248,"F",5,5,"Chicago Bulls","Patrick Williams",1,7,7,6,1,9.2
1,2,15,0,0,13,11,2,2,"39",10,4,24,25,3,2,1038000,"2023-12-26T00:00:00.000Z",5,FALSE,1,137,"C",5,5,"Chicago Bulls","Andre Drummond",5,49,50,25,26,68.5
5,0,3,5,1,10,2,6,6,"29",2,2,11,5,2,1,1038000,"2023-12-26T00:00:00.000Z",5,FALSE,1,89,"G",5,5,"Chicago Bulls","Alex Caruso",2,16,21,16,10,29.5
5,0,5,7,0,22,7,8,5,"37",0,2,19,5,0,1,1038000,"2023-12-26T00:00:00.000Z",5,FALSE,1,666956,"G",5,5,"Chicago Bulls","Coby White",0,24,29,24,10,31.5
4,0,3,4,2,14,6,6,5,"35",4,1,19,7,3,0,1038000,"2023-12-26T00:00:00.000Z",5,FALSE,1,17895983,"G",5,5,"Chicago Bulls","Ayo Dosunmu",3,26,30,23,11,42.4
0,0,0,0,0,0,0,0,0,"00",0,0,0,0,0,0,1038000,"2023-12-26T00:00:00.000Z",5,FALSE,1,56677857,"F",5,5,"Chicago Bulls","Julian Phillips",0,0,0,0,0,0
0,0,0,0,0,0,0,0,0,"00",0,0,0,0,0,0,1038000,"2023-12-26T00:00:00.000Z",5,FALSE,1,56677860,"F",5,5,"Chicago Bulls","Adama Sanogo",0,0,0,0,0,0
0,0,0,0,0,2,2,0,0,"08",1,2,4,1,0,0,1038000,"2023-12-26T00:00:00.000Z",5,FALSE,1,17896116,"G",5,5,"Chicago Bulls","Terry Taylor",0,5,5,4,1,5.2
0,0,0,1,0,1,0,0,0,"07",0,1,0,0,0,1,1038000,"2023-12-26T00:00:00.000Z",5,FALSE,1,38017719,"F",5,5,"Chicago Bulls","Dalen Terry",0,0,0,0,0,-1
0,0,0,0,0,0,0,0,0,"00",0,0,0,0,0,0,1038000,"2023-12-26T00:00:00.000Z",5,FALSE,1,27,"G",5,5,"Chicago Bulls","Lonzo Ball",0,0,0,0,0,0
0,0,0,0,0,0,0,0,0,"00",0,0,0,0,0,0,1038000,"2023-12-26T00:00:00.000Z",5,FALSE,1,56677874,"F",5,5,"Chicago Bulls","Onuralp Bitim",0,0,0,0,0,0
0,0,0,0,0,0,0,0,0,"00",0,0,0,0,0,0,1038000,"2023-12-26T00:00:00.000Z",5,FALSE,1,NA,NA,NA,5,"Chicago Bulls","NA NA",0,0,0,0,0,0
0,0,0,0,0,0,0,0,0,"00",0,0,0,0,0,0,1038000,"2023-12-26T00:00:00.000Z",5,FALSE,1,268,"G",5,5,"Chicago Bulls","Zach LaVine",0,0,0,0,0,0
0,0,0,0,0,0,0,0,0,"00",0,0,0,0,0,0,1038000,"2023-12-26T00:00:00.000Z",5,FALSE,1,460,"C",5,5,"Chicago Bulls","Nikola Vucevic",0,0,0,0,0,0
4,0,6,1,0,8,5,0,0,"29",3,1,10,9,1,2,1038000,"2023-12-26T00:00:00.000Z",5,FALSE,1,17896040,"F",1,1,"Atlanta Hawks","Jalen Johnson",1,19,23,14,13,27.8
1,1,2,0,0,9,5,4,3,"27",3,3,13,5,0,1,1038000,"2023-12-26T00:00:00.000Z",5,FALSE,1,83,"C",1,1,"Atlanta Hawks","Clint Capela",1,18,19,14,6,22.5
4,1,6,9,2,15,6,4,3,"34",0,4,17,6,2,3,1038000,"2023-12-26T00:00:00.000Z",5,FALSE,1,334,"G",1,1,"Atlanta Hawks","Dejounte Murray",3,23,27,21,10,36.2
13,0,2,13,3,17,6,7,6,"40",0,3,21,2,1,6,1038000,"2023-12-26T00:00:00.000Z",5,FALSE,1,490,"G",1,1,"Atlanta Hawks","Trae Young",1,23,36,34,15,39.9
1,0,2,12,3,21,8,3,3,"31",1,2,22,3,0,0,1038000,"2023-12-26T00:00:00.000Z",5,FALSE,1,53,"G",1,1,"Atlanta Hawks","Bogdan Bogdanovic",0,25,26,23,4,27.1
0,0,0,0,0,0,0,0,0,"00",0,0,0,0,0,0,1038000,"2023-12-26T00:00:00.000Z",5,FALSE,1,666564,"F",1,1,"Atlanta Hawks","Bruno Fernando",0,0,0,0,0,0
0,0,0,0,0,0,0,0,0,"04",0,0,0,0,0,0,1038000,"2023-12-26T00:00:00.000Z",5,FALSE,1,3547297,"G",1,1,"Atlanta Hawks","Trent Forrest",0,0,0,0,0,0
0,0,0,1,0,1,0,0,0,"01",0,0,0,0,0,1,1038000,"2023-12-26T00:00:00.000Z",5,FALSE,1,56677855,"G",1,1,"Atlanta Hawks","Seth Lundy",0,0,0,0,0,-1
0,0,1,2,2,2,2,0,0,"13",0,3,6,1,0,0,1038000,"2023-12-26T00:00:00.000Z",5,FALSE,1,666754,"G",1,1,"Atlanta Hawks","Garrison Mathews",0,7,7,6,1,7.2
1,1,0,0,0,0,0,0,0,"06",0,1,0,0,0,1,1038000,"2023-12-26T00:00:00.000Z",5,FALSE,1,301,"G-F",1,1,"Atlanta Hawks","Wesley Matthews",1,0,1,1,1,3.5
0,0,0,0,0,0,0,0,0,"00",0,0,0,0,0,0,1038000,"2023-12-26T00:00:00.000Z",5,FALSE,1,319,"G",1,1,"Atlanta Hawks","Patty Mills",0,0,0,0,0,0
0,0,5,2,1,6,4,2,2,"21",1,3,11,6,1,1,1038000,"2023-12-26T00:00:00.000Z",5,FALSE,1,3547244,"F-C",1,1,"Atlanta Hawks","Onyeka Okongwu",1,17,17,11,6,20.2
0,0,0,0,0,0,0,0,0,"00",0,0,0,0,0,0,1038000,"2023-12-26T00:00:00.000Z",5,FALSE,1,56677838,"G",1,1,"Atlanta Hawks","Kobe Bufkin",0,0,0,0,0,0
0,0,0,0,0,0,0,0,0,"00",0,0,0,0,0,0,1038000,"2023-12-26T00:00:00.000Z",5,FALSE,1,38017689,"F",1,1,"Atlanta Hawks","AJ Griffin",0,0,0,0,0,0
2,0,2,4,2,6,4,0,0,"20",0,0,10,2,0,1,1038000,"2023-12-26T00:00:00.000Z",5,FALSE,1,87,"G",5,5,"Chicago Bulls","Jevon Carter",0,12,14,12,4,14.4
0,0,0,0,0,0,0,0,0,"00",0,0,0,0,0,0,1038000,"2023-12-26T00:00:00.000Z",5,FALSE,1,110,"F",5,5,"Chicago Bulls","Torrey Craig",0,0,0,0,0,0
0,0,0,0,0,0,0,0,0,"00",0,0,0,0,0,0,1038000,"2023-12-26T00:00:00.000Z",5,FALSE,1,56677806,"F",1,1,"Atlanta Hawks","Mouhamed Gueye",0,0,0,0,0,0
0,0,0,0,0,0,0,0,0,"00",0,0,0,0,0,0,1038000,"2023-12-26T00:00:00.000Z",5,FALSE,1,666656,"F",1,1,"Atlanta Hawks","De'Andre Hunter",0,0,0,0,0,0
0,0,0,0,0,0,0,0,0,"00",0,0,0,0,0,0,1038000,"2023-12-26T00:00:00.000Z",5,FALSE,1,4197387,"G",1,1,"Atlanta Hawks","Vit Krejci",0,0,0,0,0,0
0,0,4,6,2,10,5,1,1,"34",4,1,13,8,1,0,1038000,"2023-12-26T00:00:00.000Z",5,FALSE,1,3547256,"F",1,1,"Atlanta Hawks","Saddiq Bey",1,21,21,13,8,25.6
2,0,3,9,3,19,9,3,2,"39",0,6,23,3,0,4,1037998,"2023-12-26T00:00:00.000Z",9,FALSE,3,54,"F",9,9,"Detroit Pistons","Bojan Bogdanovic",0,26,28,25,5,25.6
4,0,7,2,1,7,2,4,2,"36",4,2,7,11,0,0,1037998,"2023-12-26T00:00:00.000Z",9,FALSE,3,3547267,"F-C",9,9,"Detroit Pistons","Isaiah Stewart",0,18,22,11,15,26.2
4,1,10,0,0,11,6,0,0,"33",5,3,12,15,1,1,1037998,"2023-12-26T00:00:00.000Z",9,FALSE,3,38017694,"C",9,9,"Detroit Pistons","Jalen Duren",2,27,31,16,19,41
4,1,1,2,0,12,3,6,3,"28",2,5,9,3,3,1,1037998,"2023-12-26T00:00:00.000Z",9,FALSE,3,38017682,"G",9,9,"Detroit Pistons","Jaden Ivey",4,12,16,13,7,29.6
5,1,8,4,3,21,15,10,8,"37",1,4,41,9,1,3,1037998,"2023-12-26T00:00:00.000Z",9,FALSE,3,17896075,"G-F",9,9,"Detroit Pistons","Cade Cunningham",2,50,55,46,14,62.3
0,0,0,0,0,0,0,0,0,"00",0,0,0,0,0,0,1037998,"2023-12-26T00:00:00.000Z",9,FALSE,3,24,"F",9,9,"Detroit Pistons","Marvin Bagley III",0,0,0,0,0,0
0,0,4,6,2,11,4,6,5,"25",1,1,15,5,0,2,1037998,"2023-12-26T00:00:00.000Z",9,FALSE,3,77,"G",9,9,"Detroit Pistons","Alec Burks",0,20,20,15,5,19
0,0,0,0,0,0,0,0,0,"00",0,0,0,0,0,0,1037998,"2023-12-26T00:00:00.000Z",9,FALSE,3,197,"F-G",9,9,"Detroit Pistons","Joe Harris",0,0,0,0,0,0
0,0,2,1,0,4,1,1,1,"12",1,2,3,3,0,1,1037998,"2023-12-26T00:00:00.000Z",9,FALSE,3,259,"F",9,9,"Detroit Pistons","Kevin Knox",0,6,6,3,3,5.6
0,0,0,0,0,0,0,0,0,"00",0,0,0,0,0,0,1037998,"2023-12-26T00:00:00.000Z",9,FALSE,3,17896071,"F",9,9,"Detroit Pistons","Isaiah Livers",0,0,0,0,0,0
0,0,0,1,0,1,0,0,0,"09",0,0,0,0,0,0,1037998,"2023-12-26T00:00:00.000Z",9,FALSE,3,56677792,"G",9,9,"Detroit Pistons","Marcus Sasser",0,0,0,0,0,0
1,1,1,0,0,2,0,2,2,"09",0,2,2,1,1,0,1037998,"2023-12-26T00:00:00.000Z",9,FALSE,3,56677826,"G-F",9,9,"Detroit Pistons","Ausar Thompson",2,3,4,3,2,10.7
0,0,0,0,0,2,0,0,0,"12",2,2,0,2,0,1,1037998,"2023-12-26T00:00:00.000Z",9,FALSE,3,3547240,"C",9,9,"Detroit Pistons","James Wiseman",0,2,2,0,2,1.4
0,0,0,0,0,0,0,0,0,"00",0,0,0,0,0,0,1037998,"2023-12-26T00:00:00.000Z",9,FALSE,3,56677729,"G",9,9,"Detroit Pistons","Malcolm Cazalon",0,0,0,0,0,0
0,0,0,0,0,0,0,0,0,"00",0,0,0,0,0,0,1037998,"2023-12-26T00:00:00.000Z",9,FALSE,3,330,"G",9,9,"Detroit Pistons","Monte Morris",0,0,0,0,0,0
0,0,0,0,0,0,0,0,0,"00",0,0,0,0,0,0,1037998,"2023-12-26T00:00:00.000Z",9,FALSE,3,42097199,"G",9,9,"Detroit Pistons","Jared Rhoden",0,0,0,0,0,0
0,0,0,0,0,0,0,0,0,"00",0,0,0,0,0,0,1037998,"2023-12-26T00:00:00.000Z",9,FALSE,3,44477024,"G",9,9,"Detroit Pistons","Stanley Umude",0,0,0,0,0,0
3,0,4,1,0,14,6,15,9,"40",0,2,21,4,0,3,1037998,"2023-12-26T00:00:00.000Z",9,FALSE,3,61,"F",3,3,"Brooklyn Nets","Mikal Bridges",0,25,28,24,7,27.3
1,0,2,6,4,13,9,4,2,"26",0,0,24,2,1,0,1037998,"2023-12-26T00:00:00.000Z",9,FALSE,3,666679,"F",3,3,"Brooklyn Nets","Cameron Johnson",1,26,27,25,3,30.9
2,3,9,0,0,5,5,3,1,"26",2,2,11,11,0,0,1037998,"2023-12-26T00:00:00.000Z",9,FALSE,3,666508,"F-C",3,3,"Brooklyn Nets","Nicolas Claxton",3,22,24,13,13,36.2
1,0,1,1,0,13,7,4,3,"23",0,4,17,1,0,2,1037998,"2023-12-26T00:00:00.000Z",9,FALSE,3,17896048,"G",3,3,"Brooklyn Nets","Cam Thomas",0,18,19,18,2,17.7
0,0,0,0,0,0,0,0,0,"00",0,0,0,0,0,0,1037998,"2023-12-26T00:00:00.000Z",9,FALSE,3,3547241,"G",9,9,"Detroit Pistons","Killian Hayes",0,0,0,0,0,0
6,0,4,3,0,11,2,8,5,"34",1,4,9,5,1,0,1037998,"2023-12-26T00:00:00.000Z",9,FALSE,3,130,"G",3,3,"Brooklyn Nets","Spencer Dinwiddie",1,14,20,15,11,27
1,0,3,7,3,8,3,2,2,"33",1,4,11,4,1,0,1037998,"2023-12-26T00:00:00.000Z",9,FALSE,3,158,"F",3,3,"Brooklyn Nets","Dorian Finney-Smith",1,15,16,12,5,20.3
0,0,0,0,0,0,0,0,0,"00",0,0,0,0,0,0,1037998,"2023-12-26T00:00:00.000Z",9,FALSE,3,174,"F-C",3,3,"Brooklyn Nets","Harry Giles III",0,0,0,0,0,0
2,0,2,3,2,6,3,0,0,"15",0,2,8,2,0,0,1037998,"2023-12-26T00:00:00.000Z",9,FALSE,3,351,"F",3,3,"Brooklyn Nets","Royce O'Neale",0,10,12,10,4,13.4
3,4,8,0,0,4,3,7,5,"22",3,1,11,11,2,1,1037998,"2023-12-26T00:00:00.000Z",9,FALSE,3,17896038,"C",3,3,"Brooklyn Nets","Day'Ron Sharpe",6,22,25,14,14,45.7
3,0,2,1,0,8,3,0,0,"21",0,3,6,2,1,3,1037998,"2023-12-26T00:00:00.000Z",9,FALSE,3,421,"G",3,3,"Brooklyn Nets","Dennis Smith Jr.",1,8,11,9,5,12.9
0,0,0,0,0,0,0,0,0,"00",0,0,0,0,0,0,1037998,"2023-12-26T00:00:00.000Z",9,FALSE,3,17896058,"F",3,3,"Brooklyn Nets","Trendon Watford",0,0,0,0,0,0
0,0,0,0,0,0,0,0,0,"00",0,0,0,0,0,0,1037998,"2023-12-26T00:00:00.000Z",9,FALSE,3,56677722,"F",3,3,"Brooklyn Nets","Jalen Wilson",0,0,0,0,0,0
0,0,0,0,0,0,0,0,0,"00",0,0,0,0,0,0,1037998,"2023-12-26T00:00:00.000Z",9,FALSE,3,9051997,"G",3,3,"Brooklyn Nets","Armoni Brooks",0,0,0,0,0,0
0,0,0,0,0,0,0,0,0,"00",0,0,0,0,0,0,1037998,"2023-12-26T00:00:00.000Z",9,FALSE,3,56677843,"F",3,3,"Brooklyn Nets","Noah Clowney",0,0,0,0,0,0
0,0,0,0,0,0,0,0,0,"00",0,0,0,0,0,0,1037998,"2023-12-26T00:00:00.000Z",9,FALSE,3,17896041,"G",3,3,"Brooklyn Nets","Keon Johnson",0,0,0,0,0,0
0,0,0,0,0,0,0,0,0,"00",0,0,0,0,0,0,1037998,"2023-12-26T00:00:00.000Z",9,FALSE,3,417,"G-F",3,3,"Brooklyn Nets","Ben Simmons",0,0,0,0,0,0
0,0,0,0,0,0,0,0,0,"00",0,0,0,0,0,0,1037998,"2023-12-26T00:00:00.000Z",9,FALSE,3,464,"G",3,3,"Brooklyn Nets","Lonnie Walker IV",0,0,0,0,0,0
0,0,0,0,0,0,0,0,0,"00",0,0,0,0,0,0,1037998,"2023-12-26T00:00:00.000Z",9,FALSE,3,56677841,"F",3,3,"Brooklyn Nets","Dariq Whitehead",0,0,0,0,0,0
3,1,5,4,0,7,1,0,0,"23",0,1,2,5,3,2,1037999,"2023-12-26T00:00:00.000Z",30,FALSE,22,3547242,"F",30,30,"Washington Wizards","Deni Avdija",4,7,10,5,8,22.5
6,1,3,8,2,18,6,3,3,"36",1,5,17,4,0,6,1037999,"2023-12-26T00:00:00.000Z",30,FALSE,22,265,"F",30,30,"Washington Wizards","Kyle Kuzma",1,21,27,23,10,27.8
3,3,7,0,0,7,6,2,1,"32",6,4,13,13,2,3,1037999,"2023-12-26T00:00:00.000Z",30,FALSE,22,666577,"F",30,30,"Washington Wizards","Daniel Gafford",5,26,29,16,16,45.1
3,0,2,11,6,20,11,2,2,"33",0,3,30,2,3,3,1037999,"2023-12-26T00:00:00.000Z",30,FALSE,22,666848,"G",30,30,"Washington Wizards","Jordan Poole",3,32,35,33,5,42.9
6,1,6,6,4,13,8,2,2,"34",0,0,22,6,1,2,1037999,"2023-12-26T00:00:00.000Z",30,FALSE,22,249,"G",30,30,"Washington Wizards","Tyus Jones",2,28,34,28,12,42.2
0,0,0,0,0,0,0,0,0,"00",0,0,0,0,0,0,1037999,"2023-12-26T00:00:00.000Z",30,FALSE,22,38017704,"F",30,30,"Washington Wizards","Patrick Baldwin Jr.",0,0,0,0,0,0
3,2,4,0,0,1,1,2,2,"26",2,4,4,6,0,2,1037999,"2023-12-26T00:00:00.000Z",30,FALSE,22,56677844,"G",30,30,"Washington Wizards","Bilal Coulibaly",2,10,13,7,9,19.7
0,0,0,0,0,0,0,0,0,"00",0,0,0,0,0,0,1037999,"2023-12-26T00:00:00.000Z",30,FALSE,22,38017687,"G",30,30,"Washington Wizards","Johnny Davis",0,0,0,0,0,0
1,0,2,3,1,5,2,5,4,"16",1,2,9,3,0,1,1037999,"2023-12-26T00:00:00.000Z",30,FALSE,22,167,"F",30,30,"Washington Wizards","Danilo Gallinari",0,12,13,10,4,13.1
0,0,0,0,0,0,0,0,0,"00",0,0,0,0,0,0,1037999,"2023-12-26T00:00:00.000Z",30,FALSE,22,3547302,"F",30,30,"Washington Wizards","Anthony Gill",0,0,0,0,0,0
1,0,4,5,3,8,6,2,0,"19",0,1,15,4,0,0,1037999,"2023-12-26T00:00:00.000Z",30,FALSE,22,17896045,"F",30,30,"Washington Wizards","Corey Kispert",0,19,20,16,5,21.3
0,0,0,0,0,0,0,0,0,"00",0,0,0,0,0,0,1037999,"2023-12-26T00:00:00.000Z",30,FALSE,22,337,"F-C",30,30,"Washington Wizards","Mike Muscala",0,0,0,0,0,0
0,0,0,0,0,0,0,0,0,"00",0,0,0,0,0,0,1037999,"2023-12-26T00:00:00.000Z",30,FALSE,22,38017712,"G",30,30,"Washington Wizards","Ryan Rollins",0,0,0,0,0,0
0,0,0,3,0,3,0,0,0,"08",0,0,0,0,0,0,1037999,"2023-12-26T00:00:00.000Z",30,FALSE,22,414,"G",30,30,"Washington Wizards","Landry Shamet",0,0,0,0,0,0
1,0,4,3,0,5,2,3,3,"13",0,1,7,4,1,2,1037999,"2023-12-26T00:00:00.000Z",30,FALSE,22,487,"G",30,30,"Washington Wizards","Delon Wright",1,11,12,8,5,14.3
0,0,0,0,0,0,0,0,0,"00",0,0,0,0,0,0,1037999,"2023-12-26T00:00:00.000Z",30,FALSE,22,NA,NA,NA,30,"Washington Wizards","NA NA",0,0,0,0,0,0
0,0,0,0,0,0,0,0,0,"00",0,0,0,0,0,0,1037999,"2023-12-26T00:00:00.000Z",30,FALSE,22,18677954,"G",30,30,"Washington Wizards","Jared Butler",0,0,0,0,0,0
0,0,0,0,0,0,0,0,0,"00",0,0,0,0,0,0,1037999,"2023-12-26T00:00:00.000Z",30,FALSE,22,17896106,"F",30,30,"Washington Wizards","Eugene Omoruyi",0,0,0,0,0,0
9,1,8,4,2,17,10,8,6,"38",0,3,28,8,1,2,1037999,"2023-12-26T00:00:00.000Z",30,FALSE,22,17896026,"F",22,22,"Orlando Magic","Franz Wagner",2,36,45,37,17,55.1
8,1,2,1,0,22,10,8,4,"38",1,1,24,3,1,3,1037999,"2023-12-26T00:00:00.000Z",30,FALSE,22,38017683,"F",22,22,"Orlando Magic","Paolo Banchero",2,27,35,32,11,42.6
2,1,4,1,1,3,2,2,1,"21",0,1,6,4,0,2,1037999,"2023-12-26T00:00:00.000Z",30,FALSE,22,85,"F",22,22,"Orlando Magic","Wendell Carter Jr.",1,10,12,8,6,14.8
1,1,2,10,3,11,4,0,0,"29",1,1,11,3,3,2,1037999,"2023-12-26T00:00:00.000Z",30,FALSE,22,17896073,"G",22,22,"Orlando Magic","Jalen Suggs",4,14,15,12,4,26.1
1,0,5,6,4,13,9,1,1,"33",1,4,23,6,4,5,1037999,"2023-12-26T00:00:00.000Z",30,FALSE,22,56677827,"G",22,22,"Orlando Magic","Anthony Black",4,29,30,24,7,38.7
1,0,0,1,1,2,1,0,0,"19",0,3,3,0,1,1,1037999,"2023-12-26T00:00:00.000Z",30,FALSE,22,196,"G",22,22,"Orlando Magic","Gary Harris",1,3,4,4,1,6.5
1,0,5,0,0,9,5,2,1,"15",0,1,11,5,0,0,1037999,"2023-12-26T00:00:00.000Z",30,FALSE,22,462,"C",22,22,"Orlando Magic","Moritz Wagner",0,16,17,12,6,18.5
4,0,3,3,1,11,4,2,2,"23",0,2,11,3,1,1,1037999,"2023-12-26T00:00:00.000Z",30,FALSE,22,3547251,"G",22,22,"Orlando Magic","Cole Anthony",1,14,18,15,7,22.6
3,1,3,0,0,5,4,2,2,"12",4,0,10,7,0,0,1037999,"2023-12-26T00:00:00.000Z",30,FALSE,22,666442,"C",22,22,"Orlando Magic","Goga Bitadze",1,17,20,13,10,25.9
0,0,1,0,0,0,0,0,0,"12",0,0,0,1,0,0,1037999,"2023-12-26T00:00:00.000Z",30,FALSE,22,38017724,"G",22,22,"Orlando Magic","Caleb Houstan",0,1,1,0,1,1.2
0,0,0,0,0,0,0,0,0,"00",0,0,0,0,0,0,1037999,"2023-12-26T00:00:00.000Z",30,FALSE,22,666818,"F",22,22,"Orlando Magic","Chuma Okeke",0,0,0,0,0,0
0,0,0,0,0,0,0,0,0,"00",0,0,0,0,0,0,1037999,"2023-12-26T00:00:00.000Z",30,FALSE,22,165,"G",22,22,"Orlando Magic","Markelle Fultz",0,0,0,0,0,0
0,0,0,0,0,0,0,0,0,"00",0,0,0,0,0,0,1037999,"2023-12-26T00:00:00.000Z",30,FALSE,22,38017607,"G",22,22,"Orlando Magic","Kevon Harris",0,0,0,0,0,0
0,0,0,0,0,0,0,0,0,"00",0,0,0,0,0,0,1037999,"2023-12-26T00:00:00.000Z",30,FALSE,22,666885,"F",22,22,"Orlando Magic","Admiral Schofield",0,0,0,0,0,0
0,0,0,0,0,0,0,0,0,"00",0,0,0,0,0,0,1037999,"2023-12-26T00:00:00.000Z",30,FALSE,22,56677839,"G",22,22,"Orlando Magic","Jett Howard",0,0,0,0,0,0
0,0,0,0,0,0,0,0,0,"00",0,0,0,0,0,0,1037999,"2023-12-26T00:00:00.000Z",30,FALSE,22,226,"F",22,22,"Orlando Magic","Joe Ingles",0,0,0,0,0,0
0,0,0,0,0,0,0,0,0,"00",0,0,0,0,0,0,1037999,"2023-12-26T00:00:00.000Z",30,FALSE,22,229,"F",22,22,"Orlando Magic","Jonathan Isaac",0,0,0,0,0,0
0,0,0,0,0,0,0,0,0,"00",0,0,0,0,0,0,1037999,"2023-12-26T00:00:00.000Z",30,FALSE,22,17553983,"G",22,22,"Orlando Magic","Trevelin Queen",0,0,0,0,0,0
1,0,0,1,0,9,4,1,1,"22",1,0,9,1,1,0,1038001,"2023-12-26T00:00:00.000Z",11,FALSE,12,66,"G-F",11,11,"Houston Rockets","Dillon Brooks",1,10,11,10,2,14.7
0,1,4,5,0,11,4,2,2,"34",2,4,10,6,1,0,1038001,"2023-12-26T00:00:00.000Z",11,FALSE,12,38017684,"F",11,11,"Houston Rockets","Jabari Smith Jr.",2,16,16,10,6,23.2
5,0,9,0,0,20,11,9,8,"37",7,2,30,16,4,4,1038001,"2023-12-26T00:00:00.000Z",11,FALSE,12,17896062,"F-C",11,11,"Houston Rockets","Alperen Sengun",4,46,51,35,21,64.7
2,0,1,3,0,7,2,2,1,"19",0,0,5,1,1,0,1038001,"2023-12-26T00:00:00.000Z",11,FALSE,12,17895966,"G",11,11,"Houston Rockets","Jalen Green",1,6,8,7,3,12.2
9,1,4,7,1,18,7,3,3,"40",0,2,18,4,2,3,1038001,"2023-12-26T00:00:00.000Z",11,FALSE,12,458,"G",11,11,"Houston Rockets","Fred VanVleet",3,22,31,27,13,42.3
0,0,0,0,0,0,0,0,0,"00",0,0,0,0,0,0,1038001,"2023-12-26T00:00:00.000Z",11,FALSE,12,75,"G-F",11,11,"Houston Rockets","Reggie Bullock",0,0,0,0,0,0
1,0,5,2,1,13,7,2,1,"26",3,3,16,8,2,0,1038001,"2023-12-26T00:00:00.000Z",11,FALSE,12,38017695,"F",11,11,"Houston Rockets","Tari Eason",2,24,25,17,9,33.1
0,0,0,0,0,1,1,0,0,"11",0,2,2,0,0,1,1038001,"2023-12-26T00:00:00.000Z",11,FALSE,12,188,"F",11,11,"Houston Rockets","Jeff Green",0,2,2,2,0,1
0,0,0,0,0,0,0,0,0,"00",0,0,0,0,0,0,1038001,"2023-12-26T00:00:00.000Z",11,FALSE,12,3547281,"G-F",11,11,"Houston Rockets","Nate Hinton",0,0,0,0,0,0
0,0,0,0,0,0,0,0,0,"00",0,0,0,0,0,0,1038001,"2023-12-26T00:00:00.000Z",11,FALSE,12,56677809,"F",11,11,"Houston Rockets","Jermaine Samuels Jr.",0,0,0,0,0,0
0,0,0,0,0,0,0,0,0,"00",0,0,0,0,0,0,1038001,"2023-12-26T00:00:00.000Z",11,FALSE,12,47738533,"G",11,11,"Houston Rockets","Jeenathan Williams",0,0,0,0,0,0
2,0,4,4,2,6,3,2,2,"30",1,5,10,5,0,3,1038001,"2023-12-26T00:00:00.000Z",11,FALSE,12,3547250,"G-F",12,12,"Indiana Pacers","Aaron Nesmith",0,15,17,12,7,16
1,2,6,4,1,11,5,1,1,"23",2,3,12,8,1,1,1038001,"2023-12-26T00:00:00.000Z",11,FALSE,12,3547264,"F-C",12,12,"Indiana Pacers","Jalen Smith",3,20,21,13,9,31.1
1,2,4,3,2,9,5,7,6,"24",1,5,18,5,0,0,1038001,"2023-12-26T00:00:00.000Z",11,FALSE,12,452,"C-F",12,12,"Indiana Pacers","Myles Turner",2,23,24,19,6,31.5
6,0,2,1,1,6,5,0,0,"34",0,1,11,2,0,6,1038001,"2023-12-26T00:00:00.000Z",11,FALSE,12,38017507,"G-F",12,12,"Indiana Pacers","Andrew Nembhard",0,13,19,17,8,16.4
1,0,3,6,3,10,6,0,0,"25",0,1,15,3,1,1,1038001,"2023-12-26T00:00:00.000Z",11,FALSE,12,213,"G",11,11,"Houston Rockets","Aaron Holiday",1,18,19,16,4,22.1
0,0,0,0,0,0,0,0,0,"00",0,0,0,0,0,0,1038001,"2023-12-26T00:00:00.000Z",11,FALSE,12,19465326,"C",11,11,"Houston Rockets","Jock Landale",0,0,0,0,0,0
0,0,0,0,0,0,0,0,0,"00",0,0,0,0,0,0,1038001,"2023-12-26T00:00:00.000Z",11,FALSE,12,296,"C",11,11,"Houston Rockets","Boban Marjanovic",0,0,0,0,0,0
0,0,1,0,0,3,2,2,1,"14",0,1,5,1,1,0,1038001,"2023-12-26T00:00:00.000Z",11,FALSE,12,3547301,"F",11,11,"Houston Rockets","Jae'Sean Tate",1,6,6,5,1,9.2
0,0,2,0,0,5,3,1,1,"12",2,1,7,4,2,1,1038001,"2023-12-26T00:00:00.000Z",11,FALSE,12,56677825,"G-F",11,11,"Houston Rockets","Amen Thompson",2,11,11,7,4,16.8
0,0,0,0,0,0,0,0,0,"00",0,0,0,0,0,0,1038001,"2023-12-26T00:00:00.000Z",11,FALSE,12,56677831,"F",11,11,"Houston Rockets","Cam Whitmore",0,0,0,0,0,0
0,0,0,0,0,0,0,0,0,"00",0,0,0,0,0,0,1038001,"2023-12-26T00:00:00.000Z",11,FALSE,12,357,"G",11,11,"Houston Rockets","Victor Oladipo",0,0,0,0,0,0
10,0,5,13,7,21,13,1,0,"38",1,0,33,6,1,3,1038001,"2023-12-26T00:00:00.000Z",11,FALSE,12,3547245,"G",12,12,"Indiana Pacers","Tyrese Haliburton",1,39,49,43,16,55.2
0,0,4,5,2,9,3,2,2,"24",0,2,10,4,1,3,1038001,"2023-12-26T00:00:00.000Z",11,FALSE,12,38017686,"G-F",12,12,"Indiana Pacers","Bennedict Mathurin",1,14,14,10,4,14.8
5,0,4,11,3,14,4,0,0,"33",1,1,11,5,0,0,1038001,"2023-12-26T00:00:00.000Z",11,FALSE,12,210,"G",12,12,"Indiana Pacers","Buddy Hield",0,16,21,16,10,24.5
3,0,1,2,1,3,2,3,2,"14",1,2,7,2,1,3,1038001,"2023-12-26T00:00:00.000Z",11,FALSE,12,3547243,"F",12,12,"Indiana Pacers","Obi Toppin",1,9,12,10,5,13.9
0,3,5,0,0,3,3,5,5,"20",3,3,11,8,1,1,1038001,"2023-12-26T00:00:00.000Z",11,FALSE,12,17896035,"F",12,12,"Indiana Pacers","Isaiah Jackson",4,19,19,11,8,31.6
0,0,0,0,0,0,0,0,0,"00",0,0,0,0,0,0,1038001,"2023-12-26T00:00:00.000Z",11,FALSE,12,242,"F",12,12,"Indiana Pacers","James Johnson",0,0,0,0,0,0
0,0,0,0,0,0,0,0,0,"00",0,0,0,0,0,0,1038001,"2023-12-26T00:00:00.000Z",11,FALSE,12,304,"G",12,12,"Indiana Pacers","T.J. McConnell",0,0,0,0,0,0
0,0,0,0,0,0,0,0,0,"00",0,0,0,0,0,0,1038001,"2023-12-26T00:00:00.000Z",11,FALSE,12,3547207,"F",12,12,"Indiana Pacers","Jordan Nwora",0,0,0,0,0,0
0,0,0,0,0,0,0,0,0,"00",0,0,0,0,0,0,1038001,"2023-12-26T00:00:00.000Z",11,FALSE,12,56677861,"G",12,12,"Indiana Pacers","Ben Sheppard",0,0,0,0,0,0
0,0,0,0,0,0,0,0,0,"00",0,0,0,0,0,0,1038001,"2023-12-26T00:00:00.000Z",11,FALSE,12,56677832,"F",12,12,"Indiana Pacers","Jarace Walker",0,0,0,0,0,0
0,0,0,0,0,0,0,0,0,"00",0,0,0,0,0,0,1038001,"2023-12-26T00:00:00.000Z",11,FALSE,12,69,"G",12,12,"Indiana Pacers","Bruce Brown",0,0,0,0,0,0
0,0,0,0,0,0,0,0,0,"00",0,0,0,0,0,0,1038001,"2023-12-26T00:00:00.000Z",11,FALSE,12,38017701,"G",12,12,"Indiana Pacers","Kendall Brown",0,0,0,0,0,0
0,0,0,0,0,0,0,0,0,"00",0,0,0,0,0,0,1038001,"2023-12-26T00:00:00.000Z",11,FALSE,12,56677778,"F-C",12,12,"Indiana Pacers","Oscar Tshiebwe",0,0,0,0,0,0
0,0,0,0,0,0,0,0,0,"00",0,0,0,0,0,0,1038001,"2023-12-26T00:00:00.000Z",11,FALSE,12,56677794,"G",12,12,"Indiana Pacers","Isaiah Wong",0,0,0,0,0,0
7,4,4,4,2,20,9,4,4,"42",2,3,24,6,3,3,1038002,"2023-12-26T00:00:00.000Z",19,FALSE,15,227,"F",19,19,"New Orleans Pelicans","Brandon Ingram",7,30,37,31,13,59.7
1,0,9,0,0,17,7,12,9,"36",2,5,23,11,1,6,1038002,"2023-12-26T00:00:00.000Z",19,FALSE,15,666969,"F",19,19,"New Orleans Pelicans","Zion Williamson",1,34,35,24,12,34.7
0,1,10,1,0,14,8,3,1,"36",3,5,17,13,1,1,1038002,"2023-12-26T00:00:00.000Z",19,FALSE,15,455,"C",19,19,"New Orleans Pelicans","Jonas Valanciunas",2,30,30,17,13,37.6
3,0,3,4,0,8,2,0,0,"31",0,1,4,3,1,0,1038002,"2023-12-26T00:00:00.000Z",19,FALSE,15,17896024,"F",19,19,"New Orleans Pelicans","Herbert Jones",1,7,10,7,6,15.1
2,1,2,8,3,14,6,4,1,"39",0,4,16,2,1,1,1038002,"2023-12-26T00:00:00.000Z",19,FALSE,15,303,"G",19,19,"New Orleans Pelicans","CJ McCollum",2,18,20,18,4,26.4
1,0,1,3,0,5,1,0,0,"14",0,2,2,1,0,1,1038002,"2023-12-26T00:00:00.000Z",19,FALSE,15,3547293,"F",19,19,"New Orleans Pelicans","Naji Marshall",0,3,4,3,2,3.7
0,0,0,0,0,0,0,0,0,"00",0,0,0,0,0,0,1038002,"2023-12-26T00:00:00.000Z",19,FALSE,15,666703,"G-F",15,15,"Memphis Grizzlies","John Konchar",0,0,0,0,0,0
1,0,3,5,2,7,3,0,0,"16",1,0,8,4,0,0,1038002,"2023-12-26T00:00:00.000Z",19,FALSE,15,38017729,"F",15,15,"Memphis Grizzlies","David Roddy",0,12,13,9,5,14.3
0,5,5,1,0,3,1,0,0,"28",3,1,2,8,1,0,1038002,"2023-12-26T00:00:00.000Z",19,FALSE,15,3547285,"F",15,15,"Memphis Grizzlies","Xavier Tillman",6,10,10,2,8,29.6
3,3,6,4,1,4,1,4,3,"27",2,0,6,8,1,2,1038002,"2023-12-26T00:00:00.000Z",19,FALSE,15,38017731,"G",15,15,"Memphis Grizzlies","Vince Williams Jr.",4,14,17,9,11,30.1
1,1,1,2,0,2,0,2,2,"12",0,1,2,1,1,2,1038002,"2023-12-26T00:00:00.000Z",19,FALSE,15,17896027,"G-F",15,15,"Memphis Grizzlies","Ziaire Williams",2,3,4,3,2,8.7
0,0,0,0,0,0,0,0,0,"00",0,0,0,0,0,0,1038002,"2023-12-26T00:00:00.000Z",19,FALSE,15,3,"C",15,15,"Memphis Grizzlies","Steven Adams",0,0,0,0,0,0
0,0,0,0,0,0,0,0,0,"00",0,0,0,0,0,0,1038002,"2023-12-26T00:00:00.000Z",19,FALSE,15,666505,"F",15,15,"Memphis Grizzlies","Brandon Clarke",0,0,0,0,0,0
0,0,0,0,0,0,0,0,0,"00",0,0,0,0,0,0,1038002,"2023-12-26T00:00:00.000Z",19,FALSE,15,56677830,"F",15,15,"Memphis Grizzlies","GG Jackson",0,0,0,0,0,0
0,0,0,0,0,0,0,0,0,"00",0,0,0,0,0,0,1038002,"2023-12-26T00:00:00.000Z",19,FALSE,15,254,"G",15,15,"Memphis Grizzlies","Luke Kennard",0,0,0,0,0,0
0,0,0,0,0,0,0,0,0,"00",0,0,0,0,0,0,1038002,"2023-12-26T00:00:00.000Z",19,FALSE,15,38017728,"F",15,15,"Memphis Grizzlies","Jake LaRavia",0,0,0,0,0,0
0,0,0,0,0,0,0,0,0,"00",0,0,0,0,0,0,1038002,"2023-12-26T00:00:00.000Z",19,FALSE,15,401,"G",15,15,"Memphis Grizzlies","Derrick Rose",0,0,0,0,0,0
7,2,4,7,1,24,12,8,6,"40",1,2,31,5,1,6,1038002,"2023-12-26T00:00:00.000Z",19,FALSE,15,666786,"G",15,15,"Memphis Grizzlies","Ja Morant",3,36,43,38,12,50.5
0,1,2,2,0,2,0,0,0,"09",0,2,0,2,0,0,1038002,"2023-12-26T00:00:00.000Z",19,FALSE,15,17896067,"F",15,15,"Memphis Grizzlies","Santi Aldama",1,2,2,0,2,5.4
0,0,0,0,0,0,0,0,0,"00",0,0,0,0,0,0,1038002,"2023-12-26T00:00:00.000Z",19,FALSE,15,48248287,"G",15,15,"Memphis Grizzlies","Jacob Gilyard",0,0,0,0,0,0
0,0,0,0,0,0,0,0,0,"01",0,0,0,0,0,0,1038002,"2023-12-26T00:00:00.000Z",19,FALSE,15,491,"C",19,19,"New Orleans Pelicans","Cody Zeller",0,0,0,0,0,0
0,0,0,0,0,0,0,0,0,"00",0,0,0,0,0,0,1038002,"2023-12-26T00:00:00.000Z",19,FALSE,15,38017663,"F",19,19,"New Orleans Pelicans","E.J. Liddell",0,0,0,0,0,0
0,0,0,0,0,0,0,0,0,"00",0,0,0,0,0,0,1038002,"2023-12-26T00:00:00.000Z",19,FALSE,15,340,"F",19,19,"New Orleans Pelicans","Larry Nance Jr.",0,0,0,0,0,0
0,0,0,0,0,0,0,0,0,"00",0,0,0,0,0,0,1038002,"2023-12-26T00:00:00.000Z",19,FALSE,15,17896017,"F",19,19,"New Orleans Pelicans","Matt Ryan",0,0,0,0,0,0
0,0,0,0,0,0,0,0,0,"00",0,0,0,0,0,0,1038002,"2023-12-26T00:00:00.000Z",19,FALSE,15,38017726,"G",19,19,"New Orleans Pelicans","Dereon Seabron",0,0,0,0,0,0
3,1,1,8,2,10,4,3,3,"29",0,4,13,1,5,3,1038002,"2023-12-26T00:00:00.000Z",19,FALSE,15,420,"G",15,15,"Memphis Grizzlies","Marcus Smart",6,14,17,16,4,33.7
1,1,9,3,0,11,5,10,9,"39",1,5,19,10,1,3,1038002,"2023-12-26T00:00:00.000Z",19,FALSE,15,231,"F-C",15,15,"Memphis Grizzlies","Jaren Jackson Jr.",2,29,30,20,11,35.5
1,2,7,0,0,5,4,0,0,"25",0,4,8,7,0,0,1038002,"2023-12-26T00:00:00.000Z",19,FALSE,15,48,"C",15,15,"Memphis Grizzlies","Bismack Biyombo",2,15,16,9,8,23.9
7,1,4,14,5,22,9,5,4,"40",0,5,27,4,0,1,1038002,"2023-12-26T00:00:00.000Z",19,FALSE,15,3547287,"G",15,15,"Memphis Grizzlies","Desmond Bane",1,31,38,34,11,44.3
0,0,0,0,0,0,0,0,0,"00",0,0,0,0,0,0,1038002,"2023-12-26T00:00:00.000Z",19,FALSE,15,56677837,"G",19,19,"New Orleans Pelicans","Jordan Hawkins",0,0,0,0,0,0
0,0,0,0,0,0,0,0,0,"00",0,0,0,0,0,0,1038002,"2023-12-26T00:00:00.000Z",19,FALSE,15,3547260,"G",19,19,"New Orleans Pelicans","Kira Lewis Jr.",0,0,0,0,0,0
0,0,0,0,0,0,0,0,0,"00",0,0,0,0,0,0,1038002,"2023-12-26T00:00:00.000Z",19,FALSE,15,17896021,"F",19,19,"New Orleans Pelicans","Jeremiah Robinson-Earl",0,0,0,0,0,0
1,0,5,6,3,8,3,2,1,"36",2,2,10,7,2,2,1038002,"2023-12-26T00:00:00.000Z",19,FALSE,15,18677986,"F",19,19,"New Orleans Pelicans","Trey Murphy III",2,17,18,11,8,23.9
2,0,2,4,1,8,3,2,1,"11",1,0,8,3,1,0,1038002,"2023-12-26T00:00:00.000Z",19,FALSE,15,17896097,"G",19,19,"New Orleans Pelicans","Jose Alvarado",1,11,13,10,5,17.6
1,0,0,1,1,3,3,6,4,"19",0,4,11,0,2,0,1038002,"2023-12-26T00:00:00.000Z",19,FALSE,15,38017677,"G",19,19,"New Orleans Pelicans","Dyson Daniels",2,11,12,12,1,18.5
0,2,4,6,5,9,7,2,1,"33",0,4,20,4,1,1,1038003,"2023-12-26T00:00:00.000Z",21,FALSE,18,666541,"G",21,21,"Oklahoma City Thunder","Luguentz Dort",3,24,24,20,4,32.8
3,2,1,6,4,11,7,3,3,"26",0,3,21,1,0,1,1038003,"2023-12-26T00:00:00.000Z",21,FALSE,18,38017703,"G-F",21,21,"Oklahoma City Thunder","Jalen Williams",2,22,25,24,4,31.7
5,1,4,6,3,13,8,2,1,"29",0,4,20,4,0,1,1038003,"2023-12-26T00:00:00.000Z",21,FALSE,18,38017685,"C-F",21,21,"Oklahoma City Thunder","Chet Holmgren",1,24,29,25,9,34.3
7,0,2,2,0,7,4,2,2,"25",0,3,10,2,0,2,1038003,"2023-12-26T00:00:00.000Z",21,FALSE,18,17896065,"G",21,21,"Oklahoma City Thunder","Josh Giddey",0,12,19,17,9,20.9
9,1,6,3,0,19,14,7,6,"33",0,3,34,6,2,3,1038003,"2023-12-26T00:00:00.000Z",21,FALSE,18,175,"G",21,21,"Oklahoma City Thunder","Shai Gilgeous-Alexander",3,40,49,43,15,60.7
0,0,0,0,0,0,0,0,0,"00",0,0,0,0,0,0,1038003,"2023-12-26T00:00:00.000Z",21,FALSE,18,44,"F",21,21,"Oklahoma City Thunder","Davis Bertans",0,0,0,0,0,0
0,0,0,0,0,0,0,0,0,"00",0,0,0,0,0,0,1038003,"2023-12-26T00:00:00.000Z",21,FALSE,18,38017716,"F",21,21,"Oklahoma City Thunder","Ousmane Dieng",0,0,0,0,0,0
2,0,1,3,2,4,3,0,0,"16",1,3,8,2,0,0,1038003,"2023-12-26T00:00:00.000Z",21,FALSE,18,3547272,"G",21,21,"Oklahoma City Thunder","Isaiah Joe",0,10,12,10,4,13.4
0,0,0,0,0,0,0,0,0,"02",0,0,0,0,0,0,1038003,"2023-12-26T00:00:00.000Z",21,FALSE,18,17896036,"G",21,21,"Oklahoma City Thunder","Tre Mann",0,0,0,0,0,0
4,0,0,4,0,7,1,0,0,"16",0,3,2,0,2,1,1038003,"2023-12-26T00:00:00.000Z",21,FALSE,18,4197029,"G",21,21,"Oklahoma City Thunder","Vasilije Micic",2,2,6,6,4,13
0,0,0,0,0,0,0,0,0,"00",0,0,0,0,0,0,1038003,"2023-12-26T00:00:00.000Z",21,FALSE,18,24572055,"C",21,21,"Oklahoma City Thunder","Olivier Sarr",0,0,0,0,0,0
1,0,0,4,1,5,2,0,0,"24",1,0,5,1,2,1,1038003,"2023-12-26T00:00:00.000Z",21,FALSE,18,56677833,"G",21,21,"Oklahoma City Thunder","Cason Wallace",2,6,7,6,2,12.7
1,0,4,2,1,2,1,0,0,"14",1,1,3,5,0,0,1038003,"2023-12-26T00:00:00.000Z",21,FALSE,18,17896078,"G",21,21,"Oklahoma City Thunder","Aaron Wiggins",0,8,9,4,6,10.5
1,1,1,0,0,0,0,0,0,"05",0,0,0,1,0,0,1038003,"2023-12-26T00:00:00.000Z",21,FALSE,18,38017706,"F",21,21,"Oklahoma City Thunder","Jaylin Williams",1,1,2,1,2,5.7
2,0,3,3,2,4,2,0,0,"17",0,0,6,3,1,0,1038003,"2023-12-26T00:00:00.000Z",21,FALSE,18,480,"G-F",21,21,"Oklahoma City Thunder","Kenrich Williams",1,9,11,8,5,15.6
0,0,0,0,0,0,0,0,0,"00",0,0,0,0,0,0,1038003,"2023-12-26T00:00:00.000Z",21,FALSE,18,56677853,"F",21,21,"Oklahoma City Thunder","Keyontae Johnson",0,0,0,0,0,0
0,0,0,0,0,0,0,0,0,"00",0,0,0,0,0,0,1038003,"2023-12-26T00:00:00.000Z",21,FALSE,18,3547271,"C",21,21,"Oklahoma City Thunder","Aleksej Pokusevski",0,0,0,0,0,0
0,0,0,0,0,0,0,0,0,"00",0,0,0,0,0,0,1038003,"2023-12-26T00:00:00.000Z",21,FALSE,18,27924547,"F",21,21,"Oklahoma City Thunder","Lindy Waters III",0,0,0,0,0,0
1,1,0,3,0,10,3,2,2,"27",1,5,8,1,1,2,1038003,"2023-12-26T00:00:00.000Z",21,FALSE,18,3547259,"F",18,18,"Minnesota Timberwolves","Jaden McDaniels",2,9,10,9,2,14.7
1,0,4,2,0,10,5,6,6,"29",2,2,16,6,0,5,1038003,"2023-12-26T00:00:00.000Z",21,FALSE,18,447,"C",18,18,"Minnesota Timberwolves","Karl-Anthony Towns",0,22,23,17,7,19.7
0,0,5,1,0,6,2,8,6,"29",0,1,10,5,0,1,1038003,"2023-12-26T00:00:00.000Z",21,FALSE,18,176,"C",18,18,"Minnesota Timberwolves","Rudy Gobert",0,15,15,10,5,15
6,0,6,5,2,16,7,13,9,"34",1,3,25,7,1,4,1038003,"2023-12-26T00:00:00.000Z",21,FALSE,18,3547238,"G",18,18,"Minnesota Timberwolves","Anthony Edwards",1,32,38,31,13,41.4
4,0,2,7,5,10,6,0,0,"25",0,0,17,2,2,0,1038003,"2023-12-26T00:00:00.000Z",21,FALSE,18,104,"G",18,18,"Minnesota Timberwolves","Mike Conley",2,19,23,21,6,31.4
3,0,0,2,2,3,3,0,0,"19",1,3,8,1,1,0,1038003,"2023-12-26T00:00:00.000Z",21,FALSE,18,666400,"G",18,18,"Minnesota Timberwolves","Nickeil Alexander-Walker",1,9,12,11,4,16.7
1,0,0,1,0,4,2,3,3,"23",0,1,7,0,0,1,1038003,"2023-12-26T00:00:00.000Z",21,FALSE,18,12,"F",18,18,"Minnesota Timberwolves","Kyle Anderson",0,7,8,8,1,7.5
0,0,6,3,2,4,2,0,0,"19",1,1,6,7,0,4,1038003,"2023-12-26T00:00:00.000Z",21,FALSE,18,667378,"F-C",18,18,"Minnesota Timberwolves","Naz Reid",0,13,13,6,7,10.4
1,0,0,1,0,1,0,0,0,"02",0,0,0,0,0,0,1038003,"2023-12-26T00:00:00.000Z",21,FALSE,18,68,"F",18,18,"Minnesota Timberwolves","Troy Brown Jr.",0,0,1,1,1,1.5
2,0,2,1,0,5,1,0,0,"14",2,0,2,4,3,1,1038003,"2023-12-26T00:00:00.000Z",21,FALSE,18,666767,"G",18,18,"Minnesota Timberwolves","Jordan McLaughlin",3,6,8,4,6,17.8
0,0,1,1,1,3,3,0,0,"04",0,0,7,1,0,0,1038003,"2023-12-26T00:00:00.000Z",21,FALSE,18,56677782,"F",18,18,"Minnesota Timberwolves","Leonard Miller",0,8,8,7,1,8.2
1,0,0,0,0,0,0,0,0,"05",0,0,0,0,0,0,1038003,"2023-12-26T00:00:00.000Z",21,FALSE,18,320,"G",18,18,"Minnesota Timberwolves","Shake Milton",0,0,1,1,1,1.5
2,0,0,0,0,1,0,0,0,"05",0,0,0,0,0,1,1038003,"2023-12-26T00:00:00.000Z",21,FALSE,18,38017715,"F",18,18,"Minnesota Timberwolves","Josh Minott",0,0,2,2,2,2
0,0,0,0,0,0,0,0,0,"05",0,0,0,0,0,1,1038003,"2023-12-26T00:00:00.000Z",21,FALSE,18,38017700,"G",18,18,"Minnesota Timberwolves","Wendell Moore Jr.",0,0,0,0,0,-1
0,0,0,0,0,0,0,0,0,"00",0,0,0,0,0,0,1038003,"2023-12-26T00:00:00.000Z",21,FALSE,18,56677851,"G",18,18,"Minnesota Timberwolves","Jaylen Clark",0,0,0,0,0,0
0,0,0,0,0,0,0,0,0,"00",0,0,0,0,0,0,1038003,"2023-12-26T00:00:00.000Z",21,FALSE,18,17896056,"C",18,18,"Minnesota Timberwolves","Luka Garza",0,0,0,0,0,0
0,0,0,0,0,0,0,0,0,"00",0,0,0,0,0,0,1038003,"2023-12-26T00:00:00.000Z",21,FALSE,18,17895968,"F",18,18,"Minnesota Timberwolves","Daishen Nix",0,0,0,0,0,0
1,1,3,6,4,9,6,0,0,"25",1,5,16,4,2,0,1038004,"2023-12-26T00:00:00.000Z",27,FALSE,29,38017649,"F",27,27,"San Antonio Spurs","Julian Champagnie",3,20,21,17,5,31.3
3,0,3,4,3,10,7,2,2,"27",2,2,19,5,0,0,1038004,"2023-12-26T00:00:00.000Z",27,FALSE,29,38017699,"F",27,27,"San Antonio Spurs","Jeremy Sochan",0,24,27,22,8,29.5
4,5,5,4,1,15,6,3,2,"24",2,1,15,7,1,4,1038004,"2023-12-26T00:00:00.000Z",27,FALSE,29,56677822,"F-C",27,27,"San Antonio Spurs","Victor Wembanyama",6,22,26,19,11,43.4
3,0,3,10,5,18,8,1,1,"34",1,2,22,4,3,1,1038004,"2023-12-26T00:00:00.000Z",27,FALSE,29,3547246,"G-F",27,27,"San Antonio Spurs","Devin Vassell",3,26,29,25,7,39.3
4,0,4,0,0,3,0,0,0,"17",0,1,0,4,0,2,1038004,"2023-12-26T00:00:00.000Z",27,FALSE,29,38017692,"F",27,27,"San Antonio Spurs","Malaki Branham",0,4,8,4,8,8.8
4,2,3,0,0,6,3,0,0,"18",1,4,6,4,0,1,1038004,"2023-12-26T00:00:00.000Z",27,FALSE,29,102,"F-C",27,27,"San Antonio Spurs","Zach Collins",2,10,14,10,8,21.8
3,0,2,7,3,20,9,6,5,"30",2,0,26,4,0,1,1038004,"2023-12-26T00:00:00.000Z",27,FALSE,29,666682,"F",27,27,"San Antonio Spurs","Keldon Johnson",0,30,33,29,7,34.3
1,0,3,4,2,6,4,0,0,"20",1,0,10,4,0,0,1038004,"2023-12-26T00:00:00.000Z",27,FALSE,29,38017620,"G",29,29,"Utah Jazz","Ochai Agbaji",0,14,15,11,5,16.3
8,0,5,8,2,17,7,8,8,"27",1,6,24,6,0,3,1038004,"2023-12-26T00:00:00.000Z",27,FALSE,29,100,"G",29,29,"Utah Jazz","Jordan Clarkson",0,30,38,32,14,40.2
0,0,2,4,2,5,3,0,0,"23",1,1,8,3,0,1,1038004,"2023-12-26T00:00:00.000Z",27,FALSE,29,38017739,"F",29,29,"Utah Jazz","Simone Fontecchio",0,11,11,8,3,10.6
4,0,0,5,2,11,4,1,0,"24",0,3,10,0,1,2,1038004,"2023-12-26T00:00:00.000Z",27,FALSE,29,56677834,"G",29,29,"Utah Jazz","Keyonte George",1,10,14,14,4,17
0,0,1,2,0,3,0,0,0,"02",0,0,0,1,0,1,1038004,"2023-12-26T00:00:00.000Z",27,FALSE,29,56677824,"F",29,29,"Utah Jazz","Taylor Hendricks",0,1,1,0,1,0.2
0,0,0,0,0,0,0,0,0,"00",0,0,0,0,0,0,1038004,"2023-12-26T00:00:00.000Z",27,FALSE,29,666650,"G",29,29,"Utah Jazz","Talen Horton-Tucker",0,0,0,0,0,0
1,4,4,1,1,10,5,0,0,"18",3,2,11,7,1,1,1038004,"2023-12-26T00:00:00.000Z",27,FALSE,29,38017705,"C",29,29,"Utah Jazz","Walker Kessler",5,18,19,12,8,34.9
0,0,0,0,0,0,0,0,0,"00",0,0,0,0,0,0,1038004,"2023-12-26T00:00:00.000Z",27,FALSE,29,38017730,"F",27,27,"San Antonio Spurs","Dominick Barlow",0,0,0,0,0,0
0,0,0,0,0,0,0,0,0,"00",0,0,0,0,0,0,1038004,"2023-12-26T00:00:00.000Z",27,FALSE,29,17895854,"G",27,27,"San Antonio Spurs","Charles Bassey",0,0,0,0,0,0
0,0,0,0,0,0,0,0,0,"00",0,0,0,0,0,0,1038004,"2023-12-26T00:00:00.000Z",27,FALSE,29,56677865,"C",27,27,"San Antonio Spurs","Charles Bediako",0,0,0,0,0,0
0,0,0,0,0,0,0,0,0,"00",0,0,0,0,0,0,1038004,"2023-12-26T00:00:00.000Z",27,FALSE,29,17896049,"G",3,27,"San Antonio Spurs","David Duke Jr.",0,0,0,0,0,0
6,1,3,3,1,6,2,2,2,"23",2,1,7,5,0,0,1038004,"2023-12-26T00:00:00.000Z",27,FALSE,29,358,"F",29,29,"Utah Jazz","Kelly Olynyk",1,12,18,13,11,25
2,0,9,9,5,17,12,2,2,"31",3,3,31,12,1,1,1038004,"2023-12-26T00:00:00.000Z",27,FALSE,29,297,"F",29,29,"Utah Jazz","Lauri Markkanen",1,43,45,33,14,50.4
0,1,4,4,1,7,2,2,2,"18",0,1,7,4,0,3,1038004,"2023-12-26T00:00:00.000Z",27,FALSE,29,101,"F-C",29,29,"Utah Jazz","John Collins",1,11,11,7,4,11.8
6,0,5,1,0,2,0,2,2,"19",2,0,2,7,0,1,1038004,"2023-12-26T00:00:00.000Z",27,FALSE,29,139,"G",29,29,"Utah Jazz","Kris Dunn",0,9,15,8,13,18.4
6,1,3,2,0,10,8,5,4,"29",0,4,20,3,1,1,1038004,"2023-12-26T00:00:00.000Z",27,FALSE,29,413,"G",29,29,"Utah Jazz","Collin Sexton",2,23,29,26,9,37.6
0,0,0,0,0,0,0,0,0,"00",0,0,0,0,0,0,1038004,"2023-12-26T00:00:00.000Z",27,FALSE,29,17896023,"G",29,29,"Utah Jazz","Josh Christopher",0,0,0,0,0,0
0,0,0,0,0,0,0,0,0,"00",0,0,0,0,0,0,1038004,"2023-12-26T00:00:00.000Z",27,FALSE,29,38017630,"G",29,29,"Utah Jazz","Johnny Juzang",0,0,0,0,0,0
0,0,2,0,0,1,1,2,2,"02",0,0,4,2,0,0,1038004,"2023-12-26T00:00:00.000Z",27,FALSE,29,56677817,"G",27,27,"San Antonio Spurs","Sidy Cissoko",0,6,6,4,2,6.4
0,0,0,0,0,0,0,0,0,"00",0,0,0,0,0,0,1038004,"2023-12-26T00:00:00.000Z",27,FALSE,29,180,"G",27,27,"San Antonio Spurs","Devonte' Graham",0,0,0,0,0,0
0,0,1,0,0,1,0,0,0,"02",0,0,0,1,0,0,1038004,"2023-12-26T00:00:00.000Z",27,FALSE,29,17896059,"F",27,27,"San Antonio Spurs","Sandro Mamukelashvili",0,1,1,0,1,1.2
4,0,1,0,0,4,1,2,1,"10",1,2,3,2,0,0,1038004,"2023-12-26T00:00:00.000Z",27,FALSE,29,38017693,"G",27,27,"San Antonio Spurs","Blake Wesley",0,5,9,7,6,11.4
0,0,0,0,0,0,0,0,0,"02",0,0,0,0,0,0,1038004,"2023-12-26T00:00:00.000Z",27,FALSE,29,666881,"F",29,29,"Utah Jazz","Luka Samanic",0,0,0,0,0,0
0,0,1,0,0,0,0,0,0,"02",0,0,0,1,0,0,1038004,"2023-12-26T00:00:00.000Z",27,FALSE,29,56677842,"F",29,29,"Utah Jazz","Brice Sensabaugh",0,1,1,0,1,1.2
0,0,0,0,0,1,0,0,0,"02",0,0,0,0,0,0,1038004,"2023-12-26T00:00:00.000Z",27,FALSE,29,11891374,"C",29,29,"Utah Jazz","Omer Yurtseven",0,0,0,0,0,0
0,0,0,0,0,0,0,0,0,"00",0,0,0,0,0,0,1038004,"2023-12-26T00:00:00.000Z",27,FALSE,29,19465584,"F",29,29,"Utah Jazz","Micah Potter",0,0,0,0,0,0
7,0,1,1,0,7,3,1,0,"27",3,1,6,4,2,0,1038004,"2023-12-26T00:00:00.000Z",27,FALSE,29,3547274,"G",27,27,"San Antonio Spurs","Tre Jones",2,10,17,13,11,27.3
3,0,2,1,0,2,0,4,1,"13",0,0,1,2,0,0,1038004,"2023-12-26T00:00:00.000Z",27,FALSE,29,359,"F",27,27,"San Antonio Spurs","Cedi Osman",0,3,6,4,5,7.9
0,0,0,2,0,2,0,0,0,"11",0,0,0,0,0,0,1038004,"2023-12-26T00:00:00.000Z",27,FALSE,29,305,"F",27,27,"San Antonio Spurs","Doug McDermott",0,0,0,0,0,0
1,0,1,1,0,5,2,0,0,"18",2,1,4,3,0,1,1038005,"2023-12-26T00:00:00.000Z",25,FALSE,26,56677850,"F",25,25,"Portland Trail Blazers","Toumani Camara",0,7,8,5,4,8.1
2,1,2,3,1,10,5,3,2,"28",0,1,13,2,0,0,1038005,"2023-12-26T00:00:00.000Z",25,FALSE,26,182,"F",25,25,"Portland Trail Blazers","Jerami Grant",1,15,17,15,4,21.4
0,1,6,0,0,1,0,2,0,"14",5,3,0,11,1,1,1038005,"2023-12-26T00:00:00.000Z",25,FALSE,26,666476,"C",25,25,"Portland Trail Blazers","Moses Brown",2,11,11,0,11,18.2
3,0,4,12,5,25,12,0,0,"34",0,2,29,4,1,2,1038005,"2023-12-26T00:00:00.000Z",25,FALSE,26,419,"G",25,25,"Portland Trail Blazers","Anfernee Simons",1,33,36,32,7,39.3
6,0,5,8,3,13,7,2,2,"30",0,1,19,5,0,0,1038005,"2023-12-26T00:00:00.000Z",25,FALSE,26,65,"G",25,25,"Portland Trail Blazers","Malcolm Brogdon",0,24,30,25,11,34
0,0,0,0,0,0,0,0,0,"02",0,0,0,0,0,0,1038005,"2023-12-26T00:00:00.000Z",25,FALSE,26,39613724,"C",25,25,"Portland Trail Blazers","Ibou Badji",0,0,0,0,0,0
11,0,0,3,1,15,6,4,4,"28",1,2,17,1,0,1,1038005,"2023-12-26T00:00:00.000Z",25,FALSE,26,56677747,"G",25,25,"Portland Trail Blazers","Scoot Henderson",0,18,29,28,12,33.7
1,0,4,2,1,8,6,5,4,"22",2,1,17,6,0,0,1038005,"2023-12-26T00:00:00.000Z",25,FALSE,26,38017711,"F",25,25,"Portland Trail Blazers","Jabari Walker",0,23,24,18,7,25.7
0,0,0,0,0,0,0,0,0,"00",0,0,0,0,0,0,1038005,"2023-12-26T00:00:00.000Z",25,FALSE,26,22,"C",25,25,"Portland Trail Blazers","Deandre Ayton",0,0,0,0,0,0
0,0,0,0,0,0,0,0,0,"00",0,0,0,0,0,0,1038005,"2023-12-26T00:00:00.000Z",25,FALSE,26,47957121,"F",25,25,"Portland Trail Blazers","Justin Minaya",0,0,0,0,0,0
0,0,0,0,0,0,0,0,0,"00",0,0,0,0,0,0,1038005,"2023-12-26T00:00:00.000Z",25,FALSE,26,56677829,"G-F",25,25,"Portland Trail Blazers","Rayan Rupert",0,0,0,0,0,0
0,0,0,0,0,0,0,0,0,"02",0,0,0,0,0,0,1038005,"2023-12-26T00:00:00.000Z",25,FALSE,26,3547289,"G",25,25,"Portland Trail Blazers","Skylar Mays",0,0,0,0,0,0
0,0,0,0,0,0,0,0,0,"02",0,0,0,0,0,0,1038005,"2023-12-26T00:00:00.000Z",25,FALSE,26,56677791,"F",25,25,"Portland Trail Blazers","Kris Murray",0,0,0,0,0,0
0,1,4,6,3,15,9,4,4,"32",5,3,25,9,1,1,1038005,"2023-12-26T00:00:00.000Z",25,FALSE,26,56783340,"C",25,25,"Portland Trail Blazers","Duop Reath",2,34,34,25,9,40.8
4,2,3,4,2,5,2,0,0,"26",1,3,6,4,2,1,1038005,"2023-12-26T00:00:00.000Z",25,FALSE,26,666923,"G-F",25,25,"Portland Trail Blazers","Matisse Thybulle",4,10,14,10,8,27.8
0,0,1,1,0,1,0,0,0,"02",0,0,0,1,0,0,1038005,"2023-12-26T00:00:00.000Z",25,FALSE,26,17896120,"F",25,25,"Portland Trail Blazers","Ish Wainright",0,1,1,0,1,1.2
1,0,0,3,0,3,0,0,0,"09",1,1,0,1,0,0,1038005,"2023-12-26T00:00:00.000Z",25,FALSE,26,4197162,"F",26,26,"Sacramento Kings","Aleksandar Vezenkov",0,1,2,1,2,2.7
0,0,0,0,0,0,0,0,0,"00",0,0,0,0,0,0,1038005,"2023-12-26T00:00:00.000Z",25,FALSE,26,17895990,"G",26,26,"Sacramento Kings","Jordan Ford",0,0,0,0,0,0
0,0,0,0,0,0,0,0,0,"00",0,0,0,0,0,0,1038005,"2023-12-26T00:00:00.000Z",25,FALSE,26,56677845,"G",26,26,"Sacramento Kings","Colby Jones",0,0,0,0,0,0
0,0,0,0,0,0,0,0,0,"00",0,0,0,0,0,0,1038005,"2023-12-26T00:00:00.000Z",25,FALSE,26,56677862,"F",26,26,"Sacramento Kings","Jalen Slawson",0,0,0,0,0,0
0,0,0,0,0,0,0,0,0,"00",0,0,0,0,0,0,1038005,"2023-12-26T00:00:00.000Z",25,FALSE,26,38017690,"G",25,25,"Portland Trail Blazers","Shaedon Sharpe",0,0,0,0,0,0
0,0,0,0,0,0,0,0,0,"00",0,0,0,0,0,0,1038005,"2023-12-26T00:00:00.000Z",25,FALSE,26,476,"C-F",25,25,"Portland Trail Blazers","Robert Williams III",0,0,0,0,0,0
1,0,3,3,0,8,3,3,3,"36",2,2,9,5,1,2,1038005,"2023-12-26T00:00:00.000Z",25,FALSE,26,30,"F",26,26,"Sacramento Kings","Harrison Barnes",1,14,15,10,6,17.5
2,1,3,7,1,11,2,0,0,"36",1,1,5,4,0,0,1038005,"2023-12-26T00:00:00.000Z",25,FALSE,26,38017688,"F",26,26,"Sacramento Kings","Keegan Murray",1,9,11,7,6,15.8
5,0,9,0,0,19,14,7,6,"36",3,4,34,12,0,2,1038005,"2023-12-26T00:00:00.000Z",25,FALSE,26,406,"F",26,26,"Sacramento Kings","Domantas Sabonis",0,46,51,39,17,53.9
2,1,1,5,1,8,2,0,0,"22",1,1,5,2,0,0,1038005,"2023-12-26T00:00:00.000Z",25,FALSE,26,221,"G",26,26,"Sacramento Kings","Kevin Huerter",1,7,9,7,4,13.4
4,1,6,15,7,26,16,6,4,"38",2,2,43,8,2,5,1038005,"2023-12-26T00:00:00.000Z",25,FALSE,26,161,"G",26,26,"Sacramento Kings","De'Aaron Fox",3,51,55,47,12,62.6
1,0,3,0,0,2,2,0,0,"08",0,0,4,3,1,0,1038005,"2023-12-26T00:00:00.000Z",25,FALSE,26,17896030,"G",26,26,"Sacramento Kings","Chris Duarte",1,7,8,5,4,12.1
0,0,0,0,0,0,0,0,0,"02",0,0,0,0,0,0,1038005,"2023-12-26T00:00:00.000Z",25,FALSE,26,17896044,"F",26,26,"Sacramento Kings","Kessler Edwards",0,0,0,0,0,0
0,0,0,0,0,0,0,0,0,"02",0,0,0,0,0,0,1038005,"2023-12-26T00:00:00.000Z",25,FALSE,26,273,"C",26,26,"Sacramento Kings","Alex Len",0,0,0,0,0,0
1,0,0,0,0,2,2,0,0,"05",1,1,4,1,0,1,1038005,"2023-12-26T00:00:00.000Z",25,FALSE,26,306,"C",26,26,"Sacramento Kings","JaVale McGee",0,5,6,5,2,5.7
0,0,1,2,0,3,1,0,0,"02",0,0,2,1,0,0,1038005,"2023-12-26T00:00:00.000Z",25,FALSE,26,17553994,"G",26,26,"Sacramento Kings","Davion Mitchell",0,3,3,2,1,3.2
4,1,1,7,1,11,3,0,0,"19",0,2,7,1,0,0,1038005,"2023-12-26T00:00:00.000Z",25,FALSE,26,324,"G",26,26,"Sacramento Kings","Malik Monk",1,8,12,11,5,17.2
0,0,0,0,0,0,0,0,0,"02",0,0,0,0,1,0,1038005,"2023-12-26T00:00:00.000Z",25,FALSE,26,666925,"F",29,26,"Sacramento Kings","Juan Toscano-Anderson",1,0,0,0,0,3
2,1,0,0,0,0,0,0,0,"09",0,1,0,0,0,0,1038005,"2023-12-26T00:00:00.000Z",25,FALSE,26,38017714,"G",26,26,"Sacramento Kings","Keon Ellis",1,0,2,2,2,6
2,2,2,0,0,0,0,0,0,"14",0,1,0,2,0,0,1038005,"2023-12-26T00:00:00.000Z",25,FALSE,26,290,"F",26,26,"Sacramento Kings","Trey Lyles",2,2,4,2,4,11.4
0,0,2,1,0,3,1,2,2,"23",0,0,4,2,0,0,1038006,"2023-12-26T00:00:00.000Z",13,FALSE,4,666511,"G",13,13,"LA Clippers","Amir Coffey",0,6,6,4,2,6.4
4,0,2,11,5,25,10,0,0,"37",2,4,25,4,0,3,1038006,"2023-12-26T00:00:00.000Z",13,FALSE,4,172,"F",13,13,"LA Clippers","Paul George",0,29,33,29,8,32.8
4,1,9,0,0,11,7,8,4,"31",5,3,18,14,1,2,1038006,"2023-12-26T00:00:00.000Z",13,FALSE,4,493,"C",13,13,"LA Clippers","Ivica Zubac",2,32,36,22,18,44.8
0,0,0,1,0,4,1,2,2,"21",1,2,4,1,0,1,1038006,"2023-12-26T00:00:00.000Z",13,FALSE,4,666743,"G",13,13,"LA Clippers","Terance Mann",0,5,5,4,1,4.2
8,1,6,12,6,16,8,8,7,"40",0,2,29,6,2,4,1038006,"2023-12-26T00:00:00.000Z",13,FALSE,4,192,"G",13,13,"LA Clippers","James Harden",3,35,43,37,14,53.2
0,0,0,0,0,0,0,0,0,"00",0,0,0,0,0,0,1038006,"2023-12-26T00:00:00.000Z",13,FALSE,4,17896022,"G",13,13,"LA Clippers","Brandon Boston Jr.",0,0,0,0,0,0
2,0,0,2,0,4,1,0,0,"17",0,0,2,0,2,0,1038006,"2023-12-26T00:00:00.000Z",13,FALSE,4,56677849,"F",13,13,"LA Clippers","Kobe Brown",2,2,4,4,2,11
0,0,3,5,1,7,2,2,2,"28",0,1,7,3,0,0,1038006,"2023-12-26T00:00:00.000Z",13,FALSE,4,380,"F-G",13,13,"LA Clippers","Norman Powell",0,10,10,7,3,10.6
0,0,2,0,0,7,5,0,0,"15",2,0,10,4,0,1,1038006,"2023-12-26T00:00:00.000Z",13,FALSE,4,439,"F",13,13,"LA Clippers","Daniel Theis",0,14,14,10,4,13.8
6,1,10,2,2,8,5,3,2,"28",1,2,14,11,2,2,1038006,"2023-12-26T00:00:00.000Z",13,FALSE,4,472,"G",13,13,"LA Clippers","Russell Westbrook",3,25,31,20,17,43.2
1,0,0,4,1,5,2,0,0,"12",0,3,5,0,0,0,1038006,"2023-12-26T00:00:00.000Z",13,FALSE,4,56677846,"G",4,4,"Charlotte Hornets","Nick Smith Jr.",0,5,6,6,1,6.5
2,0,3,1,0,6,4,3,2,"22",0,3,10,3,0,0,1038006,"2023-12-26T00:00:00.000Z",13,FALSE,4,38017708,"G",4,4,"Charlotte Hornets","Bryce McGowens",0,13,15,12,5,16.6
7,0,4,8,1,23,8,3,1,"39",0,2,18,4,1,4,1038006,"2023-12-26T00:00:00.000Z",13,FALSE,4,403,"G",4,4,"Charlotte Hornets","Terry Rozier",1,22,29,25,11,32.3
0,0,0,0,0,0,0,0,0,"00",0,0,0,0,0,0,1038006,"2023-12-26T00:00:00.000Z",13,FALSE,4,17896037,"G",4,4,"Charlotte Hornets","James Bouknight",0,0,0,0,0,0
2,1,2,2,1,8,3,0,0,"25",0,2,7,2,4,0,1038006,"2023-12-26T00:00:00.000Z",13,FALSE,4,666748,"F",4,4,"Charlotte Hornets","Cody Martin",5,9,11,9,4,27.4
0,2,1,0,0,0,0,0,0,"04",0,0,0,1,0,0,1038006,"2023-12-26T00:00:00.000Z",13,FALSE,4,NA,NA,NA,4,"Charlotte Hornets","NA NA",2,1,1,0,1,7.2
1,1,8,0,0,6,5,4,3,"33",2,2,13,10,0,1,1038006,"2023-12-26T00:00:00.000Z",13,FALSE,4,3547282,"C",4,4,"Charlotte Hornets","Nick Richards",1,23,24,14,11,28.5
4,0,1,0,0,4,2,0,0,"16",0,1,4,1,0,1,1038006,"2023-12-26T00:00:00.000Z",13,FALSE,4,422,"G",4,4,"Charlotte Hornets","Ish Smith",0,5,9,8,5,10.2
0,0,0,0,0,0,0,0,0,"00",0,0,0,0,0,0,1038006,"2023-12-26T00:00:00.000Z",13,FALSE,4,18678001,"F",4,4,"Charlotte Hornets","JT Thor",0,0,0,0,0,0
3,0,4,2,0,10,7,4,4,"27",4,3,18,8,2,2,1038006,"2023-12-26T00:00:00.000Z",13,FALSE,4,666950,"F",4,4,"Charlotte Hornets","P.J. Washington",2,26,29,21,11,36.1
0,0,0,0,0,0,0,0,0,"00",0,0,0,0,0,0,1038006,"2023-12-26T00:00:00.000Z",13,FALSE,4,56677848,"G",4,4,"Charlotte Hornets","Amari Bailey",0,0,0,0,0,0
0,0,0,0,0,0,0,0,0,"00",0,0,0,0,0,0,1038006,"2023-12-26T00:00:00.000Z",13,FALSE,4,3547239,"G",4,4,"Charlotte Hornets","LaMelo Ball",0,0,0,0,0,0
0,0,0,0,0,0,0,0,0,"00",0,0,0,0,0,0,1038006,"2023-12-26T00:00:00.000Z",13,FALSE,4,56677866,"F",4,4,"Charlotte Hornets","Leaky Black",0,0,0,0,0,0
0,0,0,0,0,0,0,0,0,"00",0,0,0,0,0,0,1038006,"2023-12-26T00:00:00.000Z",13,FALSE,4,56677823,"F",4,4,"Charlotte Hornets","Brandon Miller",0,0,0,0,0,0
0,0,0,0,0,0,0,0,0,"00",0,0,0,0,0,0,1038006,"2023-12-26T00:00:00.000Z",13,FALSE,4,347,"G",4,4,"Charlotte Hornets","Frank Ntilikina",0,0,0,0,0,0
0,0,0,0,0,0,0,0,0,"00",0,0,0,0,0,0,1038006,"2023-12-26T00:00:00.000Z",13,FALSE,4,38017698,"C",4,4,"Charlotte Hornets","Mark Williams",0,0,0,0,0,0
0,0,0,0,0,0,0,0,0,"00",0,0,0,0,0,0,1038006,"2023-12-26T00:00:00.000Z",13,FALSE,4,17896031,"G",13,13,"LA Clippers","Nah'Shon Hyland",0,0,0,0,0,0
0,0,0,0,0,0,0,0,0,"00",0,0,0,0,0,0,1038006,"2023-12-26T00:00:00.000Z",13,FALSE,4,56677856,"G",13,13,"LA Clippers","Jordan Miller",0,0,0,0,0,0
0,0,0,0,0,0,0,0,0,"00",0,0,0,0,0,0,1038006,"2023-12-26T00:00:00.000Z",13,FALSE,4,24417679,"G",13,13,"LA Clippers","Xavier Moon",0,0,0,0,0,0
0,0,0,0,0,0,0,0,0,"00",0,0,0,0,0,0,1038006,"2023-12-26T00:00:00.000Z",13,FALSE,4,450,"F",13,13,"LA Clippers","PJ Tucker",0,0,0,0,0,0
0,0,0,0,0,0,0,0,0,"00",0,0,0,0,0,0,1038006,"2023-12-26T00:00:00.000Z",13,FALSE,4,38017725,"F",13,13,"LA Clippers","Moussa Diabate",0,0,0,0,0,0
0,0,0,0,0,0,0,0,0,"00",0,0,0,0,0,0,1038006,"2023-12-26T00:00:00.000Z",13,FALSE,4,274,"F",13,13,"LA Clippers","Kawhi Leonard",0,0,0,0,0,0
0,0,0,0,0,0,0,0,0,"00",0,0,0,0,0,0,1038006,"2023-12-26T00:00:00.000Z",13,FALSE,4,371,"F-C",13,13,"LA Clippers","Mason Plumlee",0,0,0,0,0,0
0,0,0,0,0,0,0,0,0,"00",0,0,0,0,0,0,1038006,"2023-12-26T00:00:00.000Z",13,FALSE,4,17896051,"G",13,13,"LA Clippers","Joshua Primo",0,0,0,0,0,0
5,0,1,2,0,8,3,2,2,"24",1,2,8,2,1,1,1038006,"2023-12-26T00:00:00.000Z",13,FALSE,4,204,"F",4,4,"Charlotte Hornets","Gordon Hayward",1,10,15,13,7,19.9
5,2,10,10,3,23,9,0,0,"38",1,5,21,11,0,2,1038006,"2023-12-26T00:00:00.000Z",13,FALSE,4,62,"F",4,4,"Charlotte Hornets","Miles Bridges",2,32,37,26,16,45.7
1,0,1,1,1,3,3,0,0,"24",1,3,7,2,1,0,1038010,"2023-12-27T00:00:00.000Z",11,FALSE,24,3547301,"F",11,11,"Houston Rockets","Jae'Sean Tate",1,9,10,8,3,13.9
0,0,3,3,1,5,2,4,4,"22",0,1,9,3,2,1,1038010,"2023-12-27T00:00:00.000Z",11,FALSE,24,38017684,"F",11,11,"Houston Rockets","Jabari Smith Jr.",2,12,12,9,3,17.6
1,0,4,4,1,18,9,6,5,"29",1,3,24,5,2,0,1038010,"2023-12-27T00:00:00.000Z",11,FALSE,24,17896062,"F-C",11,11,"Houston Rockets","Alperen Sengun",2,29,30,25,6,37.5
3,0,4,12,6,20,8,2,1,"26",1,0,23,5,1,2,1038010,"2023-12-27T00:00:00.000Z",11,FALSE,24,17895966,"G",11,11,"Houston Rockets","Jalen Green",1,28,31,26,8,34.5
6,0,1,3,1,11,4,2,1,"29",1,2,10,2,0,1,1038010,"2023-12-27T00:00:00.000Z",11,FALSE,24,458,"G",11,11,"Houston Rockets","Fred VanVleet",0,12,18,16,8,20.4
2,0,3,4,1,6,2,2,1,"25",0,2,6,3,5,1,1038010,"2023-12-27T00:00:00.000Z",11,FALSE,24,38017695,"F",11,11,"Houston Rockets","Tari Eason",5,9,11,8,5,26.6
1,1,1,1,0,3,1,0,0,"07",0,2,2,1,0,1,1038010,"2023-12-27T00:00:00.000Z",11,FALSE,24,188,"F",11,11,"Houston Rockets","Jeff Green",1,3,4,3,2,6.7
0,0,0,0,0,0,0,0,0,"00",0,0,0,0,0,0,1038010,"2023-12-27T00:00:00.000Z",11,FALSE,24,47738533,"G",11,11,"Houston Rockets","Jeenathan Williams",0,0,0,0,0,0
1,3,0,11,7,15,10,0,0,"39",0,1,27,0,0,0,1038010,"2023-12-27T00:00:00.000Z",11,FALSE,24,178,"G",24,24,"Phoenix Suns","Eric Gordon",3,27,28,28,1,37.5
16,1,10,7,3,16,9,8,6,"41",0,2,27,10,2,3,1038010,"2023-12-27T00:00:00.000Z",11,FALSE,24,140,"F",24,24,"Phoenix Suns","Kevin Durant",3,37,53,43,26,69
0,2,9,1,1,6,3,2,1,"14",1,4,8,10,0,3,1038010,"2023-12-27T00:00:00.000Z",11,FALSE,24,349,"C",24,24,"Phoenix Suns","Jusuf Nurkic",2,18,18,8,10,23
3,1,3,4,2,7,5,4,4,"33",1,1,16,4,0,3,1038010,"2023-12-27T00:00:00.000Z",11,FALSE,24,8,"G",24,24,"Phoenix Suns","Grayson Allen",1,20,23,19,7,25.3
7,0,3,6,1,19,9,1,1,"36",1,2,20,4,2,4,1038010,"2023-12-27T00:00:00.000Z",11,FALSE,24,57,"G",24,24,"Phoenix Suns","Devin Booker",2,24,31,27,11,37.3
0,2,2,0,0,7,5,3,1,"19",3,4,11,5,0,0,1038010,"2023-12-27T00:00:00.000Z",11,FALSE,24,3547095,"C-F",24,24,"Phoenix Suns","Udoka Azubuike",2,16,16,11,5,23
0,0,0,0,0,0,0,0,0,"00",0,0,0,0,0,0,1038010,"2023-12-27T00:00:00.000Z",11,FALSE,24,32,"F",24,24,"Phoenix Suns","Keita Bates-Diop",0,0,0,0,0,0
0,2,0,0,0,0,0,0,0,"02",0,0,0,0,0,0,1038010,"2023-12-27T00:00:00.000Z",11,FALSE,24,666451,"C",24,24,"Phoenix Suns","Bol Bol",2,0,0,0,0,6
0,0,0,0,0,0,0,0,0,"00",0,0,0,0,0,0,1038010,"2023-12-27T00:00:00.000Z",11,FALSE,24,147,"F",24,24,"Phoenix Suns","Drew Eubanks",0,0,0,0,0,0
1,0,2,0,0,2,2,5,5,"12",0,1,9,2,0,2,1038010,"2023-12-27T00:00:00.000Z",11,FALSE,24,3547298,"G",24,24,"Phoenix Suns","Saben Lee",0,11,12,10,3,10.9
0,0,6,3,0,6,3,1,1,"16",0,1,7,6,0,1,1038010,"2023-12-27T00:00:00.000Z",11,FALSE,24,666729,"F",24,24,"Phoenix Suns","Nassir Little",0,13,13,7,6,13.2
0,0,1,0,0,1,1,2,2,"16",1,0,4,2,0,3,1038010,"2023-12-27T00:00:00.000Z",11,FALSE,24,314,"F",24,24,"Phoenix Suns","Chimezie Metu",0,6,6,4,2,3.4
0,0,0,1,0,2,0,0,0,"10",1,1,0,1,0,0,1038010,"2023-12-27T00:00:00.000Z",11,FALSE,24,356,"G",24,24,"Phoenix Suns","Josh Okogie",0,1,1,0,1,1.2
0,0,0,0,0,0,0,0,0,"00",0,0,0,0,0,0,1038010,"2023-12-27T00:00:00.000Z",11,FALSE,24,66,"G-F",11,11,"Houston Rockets","Dillon Brooks",0,0,0,0,0,0
0,0,0,0,0,0,0,0,0,"00",0,0,0,0,0,0,1038010,"2023-12-27T00:00:00.000Z",11,FALSE,24,3547281,"G-F",11,11,"Houston Rockets","Nate Hinton",0,0,0,0,0,0
0,0,0,0,0,0,0,0,0,"00",0,0,0,0,0,0,1038010,"2023-12-27T00:00:00.000Z",11,FALSE,24,357,"G",11,11,"Houston Rockets","Victor Oladipo",0,0,0,0,0,0
0,0,0,0,0,0,0,0,0,"00",0,0,0,0,0,0,1038010,"2023-12-27T00:00:00.000Z",11,FALSE,24,56677809,"F",11,11,"Houston Rockets","Jermaine Samuels Jr.",0,0,0,0,0,0
2,0,2,8,3,13,4,2,2,"24",0,2,13,2,0,2,1038010,"2023-12-27T00:00:00.000Z",11,FALSE,24,213,"G",11,11,"Houston Rockets","Aaron Holiday",0,15,17,15,4,16.4
3,1,2,1,0,6,1,0,0,"17",2,2,2,4,0,0,1038010,"2023-12-27T00:00:00.000Z",11,FALSE,24,56677825,"G-F",11,11,"Houston Rockets","Amen Thompson",1,6,9,5,7,14.3
0,1,1,4,3,7,4,2,1,"18",0,2,12,1,0,1,1038010,"2023-12-27T00:00:00.000Z",11,FALSE,24,56677831,"F",11,11,"Houston Rockets","Cam Whitmore",1,13,13,12,1,15.2
1,0,0,0,0,0,0,0,0,"07",0,0,0,0,0,0,1038010,"2023-12-27T00:00:00.000Z",11,FALSE,24,75,"G-F",11,11,"Houston Rockets","Reggie Bullock",0,0,1,1,1,1.5
0,0,2,0,0,4,2,2,1,"12",3,2,5,5,0,0,1038010,"2023-12-27T00:00:00.000Z",11,FALSE,24,19465326,"C",11,11,"Houston Rockets","Jock Landale",0,10,10,5,5,11
0,0,0,0,0,0,0,0,0,"00",0,0,0,0,0,0,1038010,"2023-12-27T00:00:00.000Z",11,FALSE,24,296,"C",11,11,"Houston Rockets","Boban Marjanovic",0,0,0,0,0,0
0,0,0,0,0,0,0,0,0,"00",0,0,0,0,0,0,1038010,"2023-12-27T00:00:00.000Z",11,FALSE,24,18678058,"",24,24,"Phoenix Suns","Jordan Goodwin",0,0,0,0,0,0
0,0,0,0,0,1,0,0,0,"02",0,0,0,0,0,0,1038010,"2023-12-27T00:00:00.000Z",11,FALSE,24,470,"G",24,24,"Phoenix Suns","Yuta Watanabe",0,0,0,0,0,0
0,0,0,0,0,0,0,0,0,"00",0,0,0,0,0,0,1038010,"2023-12-27T00:00:00.000Z",11,FALSE,24,37,"G",24,24,"Phoenix Suns","Bradley Beal",0,0,0,0,0,0
0,0,0,0,0,0,0,0,0,"00",0,0,0,0,0,0,1038010,"2023-12-27T00:00:00.000Z",11,FALSE,24,272,"G",24,24,"Phoenix Suns","Damion Lee",0,0,0,0,0,0
0,0,0,0,0,0,0,0,0,"00",0,0,0,0,0,0,1038010,"2023-12-27T00:00:00.000Z",11,FALSE,24,3547253,"G",4,24,"Phoenix Suns","Theo Maledon",0,0,0,0,0,0
2,0,2,4,1,9,2,0,0,"27",0,4,5,2,0,0,1038011,"2023-12-27T00:00:00.000Z",21,FALSE,20,666541,"G",21,21,"Oklahoma City Thunder","Luguentz Dort",0,7,9,7,4,10.4
3,1,0,5,5,17,13,7,5,"33",0,4,36,0,1,0,1038011,"2023-12-27T00:00:00.000Z",21,FALSE,20,38017703,"G-F",21,21,"Oklahoma City Thunder","Jalen Williams",2,36,39,39,3,46.5
1,4,4,4,1,14,9,4,3,"30",1,4,22,5,0,0,1038011,"2023-12-27T00:00:00.000Z",21,FALSE,20,38017685,"C-F",21,21,"Oklahoma City Thunder","Chet Holmgren",4,27,28,23,6,41.5
2,2,6,0,0,4,3,2,1,"29",0,1,7,6,0,2,1038011,"2023-12-27T00:00:00.000Z",21,FALSE,20,17896065,"G",21,21,"Oklahoma City Thunder","Josh Giddey",2,13,15,9,8,21.2
8,2,6,5,2,23,13,9,8,"36",1,0,36,7,2,1,1038011,"2023-12-27T00:00:00.000Z",21,FALSE,20,175,"G",21,21,"Oklahoma City Thunder","Shai Gilgeous-Alexander",4,43,51,44,15,67.4
0,0,0,1,1,2,1,0,0,"01",1,0,3,1,0,0,1038011,"2023-12-27T00:00:00.000Z",21,FALSE,20,44,"F",21,21,"Oklahoma City Thunder","Davis Bertans",0,4,4,3,1,4.2
0,0,0,0,0,0,0,0,0,"00",0,0,0,0,0,0,1038011,"2023-12-27T00:00:00.000Z",21,FALSE,20,666675,"F",20,20,"New York Knicks","DaQuan Jeffries",0,0,0,0,0,0
0,0,0,0,0,0,0,0,0,"00",0,0,0,0,0,0,1038011,"2023-12-27T00:00:00.000Z",21,FALSE,20,17896033,"G",20,20,"New York Knicks","Miles McBride",0,0,0,0,0,0
2,0,0,5,4,10,7,4,4,"25",0,0,22,0,0,1,1038011,"2023-12-27T00:00:00.000Z",21,FALSE,20,3547269,"G",20,20,"New York Knicks","Immanuel Quickley",0,22,24,24,2,24
0,0,0,0,0,0,0,0,0,"00",0,0,0,0,0,0,1038011,"2023-12-27T00:00:00.000Z",21,FALSE,20,399,"C",20,20,"New York Knicks","Mitchell Robinson",0,0,0,0,0,0
0,0,0,0,0,0,0,0,0,"00",0,0,0,0,0,0,1038011,"2023-12-27T00:00:00.000Z",21,FALSE,20,17896063,"F",20,20,"New York Knicks","Jericho Sims",0,0,0,0,0,0
0,0,0,0,0,0,0,0,0,"00",0,0,0,0,0,0,1038011,"2023-12-27T00:00:00.000Z",21,FALSE,20,NA,NA,NA,20,"New York Knicks","NA NA",0,0,0,0,0,0
0,0,0,0,0,0,0,0,0,"00",0,0,0,0,0,0,1038011,"2023-12-27T00:00:00.000Z",21,FALSE,20,56677795,"F",20,20,"New York Knicks","Jacob Toppin",0,0,0,0,0,0
0,0,2,4,2,6,3,0,0,"16",0,1,8,2,0,0,1038011,"2023-12-27T00:00:00.000Z",21,FALSE,20,3547272,"G",21,21,"Oklahoma City Thunder","Isaiah Joe",0,10,10,8,2,10.4
0,0,1,2,0,6,2,0,0,"22",0,1,4,1,1,1,1038011,"2023-12-27T00:00:00.000Z",21,FALSE,20,56677833,"G",21,21,"Oklahoma City Thunder","Cason Wallace",1,5,5,4,1,7.2
2,1,0,3,1,4,2,0,0,"12",0,4,5,0,0,0,1038011,"2023-12-27T00:00:00.000Z",21,FALSE,20,17896078,"G",21,21,"Oklahoma City Thunder","Aaron Wiggins",1,5,7,7,2,11
1,0,1,1,1,1,1,0,0,"21",0,1,3,1,2,0,1038011,"2023-12-27T00:00:00.000Z",21,FALSE,20,480,"G-F",21,21,"Oklahoma City Thunder","Kenrich Williams",2,4,5,4,2,11.7
0,0,0,0,0,0,0,0,0,"00",0,0,0,0,0,0,1038011,"2023-12-27T00:00:00.000Z",21,FALSE,20,666474,"G",20,20,"New York Knicks","Charles Brown",0,0,0,0,0,0
0,0,2,1,0,1,0,0,0,"07",0,1,0,2,0,0,1038011,"2023-12-27T00:00:00.000Z",21,FALSE,20,38017706,"F",21,21,"Oklahoma City Thunder","Jaylin Williams",0,2,2,0,2,2.4
1,0,0,2,0,3,0,0,0,"06",0,0,0,0,0,0,1038011,"2023-12-27T00:00:00.000Z",21,FALSE,20,17896036,"G",21,21,"Oklahoma City Thunder","Tre Mann",0,0,1,1,1,1.5
0,0,0,0,0,0,0,0,0,"00",0,0,0,0,0,0,1038011,"2023-12-27T00:00:00.000Z",21,FALSE,20,4197029,"G",21,21,"Oklahoma City Thunder","Vasilije Micic",0,0,0,0,0,0
0,0,0,0,0,0,0,0,0,"00",0,0,0,0,0,0,1038011,"2023-12-27T00:00:00.000Z",21,FALSE,20,3547271,"C",21,21,"Oklahoma City Thunder","Aleksej Pokusevski",0,0,0,0,0,0
0,0,0,0,0,0,0,0,0,"00",0,0,0,0,0,0,1038011,"2023-12-27T00:00:00.000Z",21,FALSE,20,38017716,"F",21,21,"Oklahoma City Thunder","Ousmane Dieng",0,0,0,0,0,0
0,0,0,0,0,0,0,0,0,"00",0,0,0,0,0,0,1038011,"2023-12-27T00:00:00.000Z",21,FALSE,20,56677853,"F",21,21,"Oklahoma City Thunder","Keyontae Johnson",0,0,0,0,0,0
0,0,0,0,0,0,0,0,0,"00",0,0,0,0,0,0,1038011,"2023-12-27T00:00:00.000Z",21,FALSE,20,24572055,"C",21,21,"Oklahoma City Thunder","Olivier Sarr",0,0,0,0,0,0
0,0,0,0,0,0,0,0,0,"00",0,0,0,0,0,0,1038011,"2023-12-27T00:00:00.000Z",21,FALSE,20,27924547,"F",21,21,"Oklahoma City Thunder","Lindy Waters III",0,0,0,0,0,0
4,0,4,7,1,14,5,6,3,"30",0,5,14,4,0,5,1038011,"2023-12-27T00:00:00.000Z",21,FALSE,20,666423,"F-G",20,20,"New York Knicks","RJ Barrett",0,18,22,18,8,19.8
2,0,8,4,1,15,7,13,10,"36",1,3,25,9,0,3,1038011,"2023-12-27T00:00:00.000Z",21,FALSE,20,387,"F",20,20,"New York Knicks","Julius Randle",0,34,36,27,11,35.8
2,1,6,0,0,6,2,0,0,"37",3,3,4,9,0,2,1038011,"2023-12-27T00:00:00.000Z",21,FALSE,20,201,"F-C",20,20,"New York Knicks","Isaiah Hartenstein",1,13,15,6,11,18.8
0,0,2,9,5,10,6,0,0,"20",0,2,17,2,0,1,1038011,"2023-12-27T00:00:00.000Z",21,FALSE,20,131,"G",20,20,"New York Knicks","Donte DiVincenzo",0,19,19,17,2,18.4
7,1,2,5,1,19,9,5,5,"37",2,4,24,4,2,5,1038011,"2023-12-27T00:00:00.000Z",21,FALSE,20,73,"G",20,20,"New York Knicks","Jalen Brunson",3,28,35,31,11,43.3
0,0,1,0,0,2,2,0,0,"10",1,2,4,2,0,0,1038011,"2023-12-27T00:00:00.000Z",21,FALSE,20,173,"F",30,20,"New York Knicks","Taj Gibson",0,6,6,4,2,6.4
6,0,5,2,0,4,1,2,2,"34",2,1,4,7,0,1,1038011,"2023-12-27T00:00:00.000Z",21,FALSE,20,202,"G",20,20,"New York Knicks","Josh Hart",0,11,17,10,13,20.4
1,0,3,2,2,2,2,0,0,"11",0,1,6,3,0,0,1038011,"2023-12-27T00:00:00.000Z",21,FALSE,20,17895858,"G",20,20,"New York Knicks","Quentin Grimes",0,9,10,7,4,11.1
0,0,0,0,0,0,0,0,0,"00",0,0,0,0,0,0,1038011,"2023-12-27T00:00:00.000Z",21,FALSE,20,160,"G-F",20,20,"New York Knicks","Evan Fournier",0,0,0,0,0,0
0,0,0,0,0,0,0,0,0,"00",0,0,0,0,0,0,1038011,"2023-12-27T00:00:00.000Z",21,FALSE,20,19,"G",20,20,"New York Knicks","Ryan Arcidiacono",0,0,0,0,0,0
1,0,4,5,1,13,4,6,5,"30",0,2,14,4,0,0,1038012,"2023-12-27T00:00:00.000Z",7,FALSE,6,191,"G",7,7,"Dallas Mavericks","Tim Hardaway Jr.",0,18,19,15,5,20.3
1,3,3,4,0,13,5,2,2,"36",2,3,12,5,1,2,1038012,"2023-12-27T00:00:00.000Z",7,FALSE,6,247,"F-G",7,7,"Dallas Mavericks","Derrick Jones Jr.",4,17,18,13,6,29.5
1,2,2,0,0,2,2,1,0,"25",2,4,4,4,0,1,1038012,"2023-12-27T00:00:00.000Z",7,FALSE,6,56677840,"C",7,7,"Dallas Mavericks","Dereck Lively II",2,8,9,5,5,15.3
6,0,4,3,1,8,4,4,4,"33",0,4,13,4,3,0,1038012,"2023-12-27T00:00:00.000Z",7,FALSE,6,151,"G",7,7,"Dallas Mavericks","Dante Exum",3,17,23,19,10,35.8
6,2,7,10,3,29,14,10,8,"37",0,0,39,7,2,5,1038012,"2023-12-27T00:00:00.000Z",7,FALSE,6,132,"F-G",7,7,"Dallas Mavericks","Luka Doncic",4,46,52,45,13,63.4
1,0,3,9,5,11,6,2,2,"27",1,1,19,4,2,0,1038012,"2023-12-27T00:00:00.000Z",7,FALSE,6,114,"G",7,7,"Dallas Mavericks","Seth Curry",2,23,24,20,5,31.3
5,0,3,2,0,4,1,0,0,"21",0,1,2,3,2,1,1038012,"2023-12-27T00:00:00.000Z",7,FALSE,6,3547258,"G",7,7,"Dallas Mavericks","Josh Green",2,5,10,7,8,18.1
0,0,0,0,0,0,0,0,0,"00",0,0,0,0,0,0,1038012,"2023-12-27T00:00:00.000Z",7,FALSE,6,38017679,"G",7,7,"Dallas Mavericks","Jaden Hardy",0,0,0,0,0,0
0,0,0,0,0,0,0,0,0,"00",0,0,0,0,0,0,1038012,"2023-12-27T00:00:00.000Z",7,FALSE,6,217,"F-C",7,7,"Dallas Mavericks","Richaun Holmes",0,0,0,0,0,0
0,0,0,0,0,0,0,0,0,"00",0,0,0,0,0,0,1038012,"2023-12-27T00:00:00.000Z",7,FALSE,6,17554004,"G",7,7,"Dallas Mavericks","AJ Lawson",0,0,0,0,0,0
0,0,0,0,0,0,0,0,0,"00",0,0,0,0,0,0,1038012,"2023-12-27T00:00:00.000Z",7,FALSE,6,329,"F",7,7,"Dallas Mavericks","Markieff Morris",0,0,0,0,0,0
0,0,0,0,0,1,1,1,1,"05",0,1,3,0,0,1,1038012,"2023-12-27T00:00:00.000Z",7,FALSE,6,379,"F-C",7,7,"Dallas Mavericks","Dwight Powell",0,3,3,3,0,2
0,0,0,0,0,0,0,0,0,"00",0,0,0,0,0,0,1038012,"2023-12-27T00:00:00.000Z",7,FALSE,6,56677859,"F",7,7,"Dallas Mavericks","Olivier-Maxence Prosper",0,0,0,0,0,0
0,0,4,4,0,7,2,0,0,"26",2,5,4,6,2,0,1038012,"2023-12-27T00:00:00.000Z",7,FALSE,6,666965,"F",7,7,"Dallas Mavericks","Grant Williams",2,10,10,4,6,17.2
0,0,0,0,0,0,0,0,0,"00",0,0,0,0,0,0,1038012,"2023-12-27T00:00:00.000Z",7,FALSE,6,17896028,"F",7,7,"Dallas Mavericks","Greg Brown III",0,0,0,0,0,0
0,0,0,0,0,0,0,0,0,"00",0,0,0,0,0,0,1038012,"2023-12-27T00:00:00.000Z",7,FALSE,6,56677873,"G",7,7,"Dallas Mavericks","Dexter Dennis",0,0,0,0,0,0
0,0,0,0,0,0,0,0,0,"00",0,0,0,0,0,0,1038012,"2023-12-27T00:00:00.000Z",7,FALSE,6,228,"G",7,7,"Dallas Mavericks","Kyrie Irving",0,0,0,0,0,0
0,0,0,0,0,0,0,0,0,"00",0,0,0,0,0,0,1038012,"2023-12-27T00:00:00.000Z",7,FALSE,6,257,"F",7,7,"Dallas Mavericks","Maxi Kleber",0,0,0,0,0,0
1,1,1,7,4,13,7,5,4,"39",2,2,22,3,0,2,1038012,"2023-12-27T00:00:00.000Z",7,FALSE,6,3547247,"F-G",6,6,"Cleveland Cavaliers","Isaac Okoro",1,25,26,23,4,28.1
0,0,7,5,1,5,1,0,0,"32",1,2,3,8,0,0,1038012,"2023-12-27T00:00:00.000Z",7,FALSE,6,666940,"F",6,6,"Cleveland Cavaliers","Dean Wade",0,11,11,3,8,12.6
6,0,14,0,0,17,9,6,6,"35",9,1,24,23,2,4,1038012,"2023-12-27T00:00:00.000Z",7,FALSE,6,9,"C",6,6,"Cleveland Cavaliers","Jarrett Allen",2,47,53,30,29,62.6
6,1,4,8,2,10,3,0,0,"33",1,3,8,5,1,2,1038012,"2023-12-27T00:00:00.000Z",7,FALSE,6,666908,"G",6,6,"Cleveland Cavaliers","Max Strus",2,13,19,14,11,27
7,1,8,1,0,11,4,2,1,"30",4,4,9,12,3,2,1038012,"2023-12-27T00:00:00.000Z",7,FALSE,6,56677872,"G",6,6,"Cleveland Cavaliers","Craig Porter",4,21,28,16,19,43.9
3,0,1,3,0,3,0,0,0,"06",0,2,0,1,0,0,1038012,"2023-12-27T00:00:00.000Z",7,FALSE,6,56677847,"F",6,6,"Cleveland Cavaliers","Emoni Bates",0,1,4,3,4,5.7
0,0,0,0,0,0,0,0,0,"00",0,0,0,0,0,0,1038012,"2023-12-27T00:00:00.000Z",7,FALSE,6,248,"C",6,6,"Cleveland Cavaliers","Damian Jones",0,0,0,0,0,0
7,0,2,11,6,19,9,8,5,"28",0,3,29,2,0,2,1038012,"2023-12-27T00:00:00.000Z",7,FALSE,6,277,"G",6,6,"Cleveland Cavaliers","Caris LeVert",0,31,38,36,9,39.9
0,0,0,0,0,0,0,0,0,"00",0,0,0,0,0,0,1038012,"2023-12-27T00:00:00.000Z",7,FALSE,6,3547299,"G",6,6,"Cleveland Cavaliers","Sam Merrill",0,0,0,0,0,0
0,0,0,0,0,0,0,0,0,"00",0,0,0,0,0,0,1038012,"2023-12-27T00:00:00.000Z",7,FALSE,6,38017662,"F",6,6,"Cleveland Cavaliers","Isaiah Mobley",0,0,0,0,0,0
3,1,2,8,4,11,6,2,0,"24",0,0,16,2,1,2,1038012,"2023-12-27T00:00:00.000Z",7,FALSE,6,344,"F",6,6,"Cleveland Cavaliers","Georges Niang",2,18,21,19,5,26.9
0,0,0,0,0,3,1,0,0,"13",1,4,2,1,0,2,1038012,"2023-12-27T00:00:00.000Z",7,FALSE,6,444,"C-F",6,6,"Cleveland Cavaliers","Tristan Thompson",0,3,3,2,1,1.2
0,0,0,0,0,0,0,0,0,"00",0,0,0,0,0,0,1038012,"2023-12-27T00:00:00.000Z",7,FALSE,6,666581,"G",6,6,"Cleveland Cavaliers","Darius Garland",0,0,0,0,0,0
0,0,0,0,0,0,0,0,0,"00",0,0,0,0,0,0,1038012,"2023-12-27T00:00:00.000Z",7,FALSE,6,666676,"G",6,6,"Cleveland Cavaliers","Ty Jerome",0,0,0,0,0,0
0,0,0,0,0,0,0,0,0,"00",0,0,0,0,0,0,1038012,"2023-12-27T00:00:00.000Z",7,FALSE,6,322,"G",6,6,"Cleveland Cavaliers","Donovan Mitchell",0,0,0,0,0,0
0,0,0,0,0,0,0,0,0,"00",0,0,0,0,0,0,1038012,"2023-12-27T00:00:00.000Z",7,FALSE,6,17896076,"F-C",6,6,"Cleveland Cavaliers","Evan Mobley",0,0,0,0,0,0
0,0,0,0,0,0,0,0,0,"00",0,0,0,0,0,0,1038012,"2023-12-27T00:00:00.000Z",7,FALSE,6,404,"G",6,6,"Cleveland Cavaliers","Ricky Rubio",0,0,0,0,0,0
1,0,3,1,0,4,3,0,0,"12",0,0,6,3,1,1,1038009,"2023-12-27T00:00:00.000Z",3,FALSE,17,61,"F",3,3,"Brooklyn Nets","Mikal Bridges",1,9,10,7,4,13.1
2,0,1,3,1,4,1,0,0,"10",0,1,3,1,0,0,1038009,"2023-12-27T00:00:00.000Z",3,FALSE,17,351,"F",3,3,"Brooklyn Nets","Royce O'Neale",0,4,6,5,3,7.2
4,1,2,1,1,6,5,2,1,"16",2,3,12,4,0,0,1038009,"2023-12-27T00:00:00.000Z",3,FALSE,17,17896038,"C",3,3,"Brooklyn Nets","Day'Ron Sharpe",1,16,20,16,8,25.8
0,0,0,2,0,9,4,0,0,"12",0,1,8,0,1,0,1038009,"2023-12-27T00:00:00.000Z",3,FALSE,17,17896048,"G",3,3,"Brooklyn Nets","Cam Thomas",1,8,8,8,0,11
8,0,6,4,0,17,7,0,0,"30",1,0,14,7,1,2,1038009,"2023-12-27T00:00:00.000Z",3,FALSE,17,421,"G",3,3,"Brooklyn Nets","Dennis Smith Jr.",1,21,29,22,15,35.4
2,0,2,9,3,14,4,2,1,"29",2,1,12,4,1,1,1038009,"2023-12-27T00:00:00.000Z",3,FALSE,17,9051997,"G",3,3,"Brooklyn Nets","Armoni Brooks",1,16,18,14,6,21.8
2,0,1,1,0,9,6,2,2,"24",3,3,14,4,0,1,1038009,"2023-12-27T00:00:00.000Z",3,FALSE,17,56677843,"F",3,3,"Brooklyn Nets","Noah Clowney",0,18,20,16,6,20.8
0,0,2,0,0,3,0,2,1,"07",2,2,1,4,0,1,1038009,"2023-12-27T00:00:00.000Z",3,FALSE,17,174,"F-C",3,3,"Brooklyn Nets","Harry Giles III",0,5,5,1,4,4.8
1,1,1,4,2,8,3,4,4,"21",0,1,12,1,1,1,1038009,"2023-12-27T00:00:00.000Z",3,FALSE,17,17896041,"G",3,3,"Brooklyn Nets","Keon Johnson",2,13,14,13,2,19.7
4,0,5,1,0,9,6,6,5,"28",0,1,17,5,2,1,1038009,"2023-12-27T00:00:00.000Z",3,FALSE,17,17896058,"F",3,3,"Brooklyn Nets","Trendon Watford",2,22,26,21,9,34
3,0,4,3,0,5,1,0,0,"21",0,0,2,4,0,0,1038009,"2023-12-27T00:00:00.000Z",3,FALSE,17,56677841,"F",3,3,"Brooklyn Nets","Dariq Whitehead",0,6,9,5,7,11.3
2,0,3,3,0,13,5,11,11,"30",7,4,21,10,0,1,1038009,"2023-12-27T00:00:00.000Z",3,FALSE,17,56677722,"F",3,3,"Brooklyn Nets","Jalen Wilson",0,31,33,23,12,35
0,0,0,0,0,0,0,0,0,"00",0,0,0,0,0,0,1038009,"2023-12-27T00:00:00.000Z",3,FALSE,17,666508,"F-C",3,3,"Brooklyn Nets","Nicolas Claxton",0,0,0,0,0,0
0,0,0,0,0,0,0,0,0,"00",0,0,0,0,0,0,1038009,"2023-12-27T00:00:00.000Z",3,FALSE,17,130,"G",3,3,"Brooklyn Nets","Spencer Dinwiddie",0,0,0,0,0,0
0,0,0,0,0,0,0,0,0,"00",0,0,0,0,0,0,1038009,"2023-12-27T00:00:00.000Z",3,FALSE,17,158,"F",3,3,"Brooklyn Nets","Dorian Finney-Smith",0,0,0,0,0,0
0,0,0,0,0,0,0,0,0,"00",0,0,0,0,0,0,1038009,"2023-12-27T00:00:00.000Z",3,FALSE,17,666679,"F",3,3,"Brooklyn Nets","Cameron Johnson",0,0,0,0,0,0
0,0,0,0,0,0,0,0,0,"00",0,0,0,0,0,0,1038009,"2023-12-27T00:00:00.000Z",3,FALSE,17,417,"G-F",3,3,"Brooklyn Nets","Ben Simmons",0,0,0,0,0,0
0,0,0,0,0,0,0,0,0,"00",0,0,0,0,0,0,1038009,"2023-12-27T00:00:00.000Z",3,FALSE,17,464,"G",3,3,"Brooklyn Nets","Lonnie Walker IV",0,0,0,0,0,0
2,2,4,6,0,7,1,0,0,"25",2,3,2,6,0,0,1038009,"2023-12-27T00:00:00.000Z",3,FALSE,17,283,"C",17,17,"Milwaukee Bucks","Brook Lopez",2,8,10,4,8,18.2
1,0,0,8,5,9,6,0,0,"22",1,0,17,1,1,0,1038009,"2023-12-27T00:00:00.000Z",3,FALSE,17,38,"G",17,17,"Milwaukee Bucks","Malik Beasley",1,18,19,18,2,22.7
4,0,3,9,3,10,4,1,1,"29",0,0,12,3,0,4,1038009,"2023-12-27T00:00:00.000Z",3,FALSE,17,278,"G",17,17,"Milwaukee Bucks","Damian Lillard",0,15,19,16,7,17.6
2,0,0,0,0,0,0,0,0,"01",0,0,0,0,0,0,1038009,"2023-12-27T00:00:00.000Z",3,FALSE,17,2148,"",17,17,"Milwaukee Bucks","Thanasis Antetokounmpo",0,0,2,2,2,3
2,0,5,3,2,6,4,2,1,"21",0,2,11,5,1,0,1038009,"2023-12-27T00:00:00.000Z",3,FALSE,17,38017676,"F",17,17,"Milwaukee Bucks","MarJon Beauchamp",1,16,18,13,7,23
1,0,0,3,1,3,1,0,0,"18",1,0,3,1,0,0,1038009,"2023-12-27T00:00:00.000Z",3,FALSE,17,105,"G",17,17,"Milwaukee Bucks","Pat Connaughton",0,4,5,4,2,5.7
0,0,1,2,1,2,1,0,0,"04",0,2,3,1,0,0,1038009,"2023-12-27T00:00:00.000Z",3,FALSE,17,38017733,"G",17,17,"Milwaukee Bucks","A.J. Green",0,4,4,3,1,4.2
0,0,0,1,0,2,0,0,0,"02",0,2,0,0,0,0,1038009,"2023-12-27T00:00:00.000Z",3,FALSE,17,56677852,"G",17,17,"Milwaukee Bucks","Andre Jackson Jr.",0,0,0,0,0,0
6,0,3,8,5,9,6,1,1,"23",1,4,18,4,2,0,1038009,"2023-12-27T00:00:00.000Z",3,FALSE,17,368,"G",17,17,"Milwaukee Bucks","Cameron Payne",2,22,28,24,10,37.8
4,2,6,3,2,9,6,0,0,"31",0,1,14,6,2,1,1038009,"2023-12-27T00:00:00.000Z",3,FALSE,17,377,"F",17,17,"Milwaukee Bucks","Bobby Portis",4,20,24,18,10,38.2
1,0,1,0,0,1,1,0,0,"01",0,0,2,1,0,0,1038009,"2023-12-27T00:00:00.000Z",3,FALSE,17,56677854,"F",17,17,"Milwaukee Bucks","Chris Livingston",0,3,4,3,2,4.7
0,0,0,1,1,1,1,0,0,"01",0,0,3,0,0,0,1038009,"2023-12-27T00:00:00.000Z",3,FALSE,17,284,"C",17,17,"Milwaukee Bucks","Robin Lopez",0,3,3,3,0,3
0,0,0,0,0,0,0,0,0,"00",0,0,0,0,0,0,1038009,"2023-12-27T00:00:00.000Z",3,FALSE,17,666960,"G",17,17,"Milwaukee Bucks","Lindell Wigginton",0,0,0,0,0,0
0,0,0,0,0,0,0,0,0,"00",0,0,0,0,0,0,1038009,"2023-12-27T00:00:00.000Z",3,FALSE,17,666453,"C",17,17,"Milwaukee Bucks","Marques Bolden",0,0,0,0,0,0
0,0,0,0,0,0,0,0,0,"00",0,0,0,0,0,0,1038009,"2023-12-27T00:00:00.000Z",3,FALSE,17,112,"F",17,17,"Milwaukee Bucks","Jae Crowder",0,0,0,0,0,0
0,0,0,0,0,0,0,0,0,"00",0,0,0,0,0,0,1038009,"2023-12-27T00:00:00.000Z",3,FALSE,17,38017691,"G",17,17,"Milwaukee Bucks","TyTy Washington Jr.",0,0,0,0,0,0
10,1,2,7,3,18,11,2,2,"32",1,2,27,3,0,3,1038009,"2023-12-27T00:00:00.000Z",3,FALSE,17,315,"F",17,17,"Milwaukee Bucks","Khris Middleton",1,30,40,37,13,45.6
8,2,8,0,0,12,10,17,12,"30",2,2,32,10,0,2,1038009,"2023-12-27T00:00:00.000Z",3,FALSE,17,15,"F",17,17,"Milwaukee Bucks","Giannis Antetokounmpo",2,42,50,40,18,60
1,0,2,1,1,8,5,2,1,"24",0,1,12,2,2,0,1038008,"2023-12-27T00:00:00.000Z",30,FALSE,28,3547242,"F",30,30,"Washington Wizards","Deni Avdija",2,14,15,13,3,21.9
7,0,2,5,1,13,6,2,1,"30",2,3,14,4,0,5,1038008,"2023-12-27T00:00:00.000Z",30,FALSE,28,265,"F",30,30,"Washington Wizards","Kyle Kuzma",0,18,25,21,11,24.3
1,1,6,0,0,9,5,2,2,"30",2,2,12,8,4,0,1038008,"2023-12-27T00:00:00.000Z",30,FALSE,28,666577,"F",30,30,"Washington Wizards","Daniel Gafford",5,20,21,13,9,38.1
4,1,2,7,1,12,5,4,3,"27",2,1,14,4,0,2,1038008,"2023-12-27T00:00:00.000Z",30,FALSE,28,666848,"G",30,30,"Washington Wizards","Jordan Poole",1,18,22,18,8,25.8
5,0,1,6,1,12,5,0,0,"31",1,2,11,2,2,1,1038008,"2023-12-27T00:00:00.000Z",30,FALSE,28,249,"G",30,30,"Washington Wizards","Tyus Jones",2,13,18,16,7,25.9
0,0,0,2,0,2,0,0,0,"06",0,1,0,0,0,0,1038008,"2023-12-27T00:00:00.000Z",30,FALSE,28,38017704,"F",30,30,"Washington Wizards","Patrick Baldwin Jr.",0,0,0,0,0,0
2,0,4,4,1,8,4,2,1,"25",0,2,10,4,0,1,1038008,"2023-12-27T00:00:00.000Z",30,FALSE,28,56677844,"G",30,30,"Washington Wizards","Bilal Coulibaly",0,14,16,12,6,16.8
0,0,0,0,0,1,0,0,0,"06",0,1,0,0,0,0,1038008,"2023-12-27T00:00:00.000Z",30,FALSE,28,38017687,"G",30,30,"Washington Wizards","Johnny Davis",0,0,0,0,0,0
0,0,1,1,0,2,0,0,0,"05",0,0,0,1,0,0,1038008,"2023-12-27T00:00:00.000Z",30,FALSE,28,167,"F",30,30,"Washington Wizards","Danilo Gallinari",0,1,1,0,1,1.2
0,1,0,0,0,0,0,0,0,"05",0,0,0,0,0,0,1038008,"2023-12-27T00:00:00.000Z",30,FALSE,28,3547302,"F",30,30,"Washington Wizards","Anthony Gill",1,0,0,0,0,3
2,0,1,5,2,8,5,1,1,"21",1,2,13,2,1,2,1038008,"2023-12-27T00:00:00.000Z",30,FALSE,28,17896045,"F",30,30,"Washington Wizards","Corey Kispert",1,15,17,15,4,19.4
0,0,4,0,0,3,0,0,0,"07",2,0,0,6,0,1,1038008,"2023-12-27T00:00:00.000Z",30,FALSE,28,337,"F-C",30,30,"Washington Wizards","Mike Muscala",0,6,6,0,6,6.2
1,0,1,1,0,4,3,2,1,"06",0,2,7,1,2,1,1038008,"2023-12-27T00:00:00.000Z",30,FALSE,28,17896106,"F",30,30,"Washington Wizards","Eugene Omoruyi",2,8,9,8,2,14.7
0,0,0,0,0,3,1,0,0,"06",0,0,2,0,0,0,1038008,"2023-12-27T00:00:00.000Z",30,FALSE,28,38017712,"G",30,30,"Washington Wizards","Ryan Rollins",0,2,2,2,0,2
1,0,0,1,1,5,3,0,0,"11",0,0,7,0,0,3,1038008,"2023-12-27T00:00:00.000Z",30,FALSE,28,414,"G",30,30,"Washington Wizards","Landry Shamet",0,7,8,8,1,5.5
0,0,0,0,0,0,0,0,0,"00",0,0,0,0,0,0,1038008,"2023-12-27T00:00:00.000Z",30,FALSE,28,NA,NA,NA,30,"Washington Wizards","NA NA",0,0,0,0,0,0
0,0,0,0,0,0,0,0,0,"00",0,0,0,0,0,0,1038008,"2023-12-27T00:00:00.000Z",30,FALSE,28,18677954,"G",30,30,"Washington Wizards","Jared Butler",0,0,0,0,0,0
0,0,0,0,0,0,0,0,0,"00",0,0,0,0,0,0,1038008,"2023-12-27T00:00:00.000Z",30,FALSE,28,487,"G",30,30,"Washington Wizards","Delon Wright",0,0,0,0,0,0
11,0,5,2,0,15,9,5,4,"32",1,3,22,6,1,4,1038008,"2023-12-27T00:00:00.000Z",30,FALSE,28,416,"F",28,28,"Toronto Raptors","Pascal Siakam",1,28,39,33,17,44.7
2,0,4,7,3,16,11,2,1,"29",2,1,26,6,0,1,1038008,"2023-12-27T00:00:00.000Z",30,FALSE,28,18,"F",28,28,"Toronto Raptors","OG Anunoby",0,32,34,28,8,35.2
2,1,5,0,0,6,4,4,2,"21",3,4,10,8,2,2,1038008,"2023-12-27T00:00:00.000Z",30,FALSE,28,373,"C",28,28,"Toronto Raptors","Jakob Poeltl",3,18,20,12,10,29.6
8,2,7,8,4,16,8,0,0,"34",5,0,20,12,3,2,1038008,"2023-12-27T00:00:00.000Z",30,FALSE,28,17896055,"G-F",28,28,"Toronto Raptors","Scottie Barnes",5,32,40,28,20,59.4
4,0,2,8,3,10,4,2,1,"26",0,1,12,2,2,1,1038008,"2023-12-27T00:00:00.000Z",30,FALSE,28,3089,"",28,28,"Toronto Raptors","Gary Trent Jr.",2,14,18,16,6,25.4
0,1,0,0,0,2,1,2,1,"11",0,0,3,0,1,1,1038008,"2023-12-27T00:00:00.000Z",30,FALSE,28,3547249,"F",28,28,"Toronto Raptors","Precious Achiuwa",2,3,3,3,0,8
10,0,4,2,1,6,4,0,0,"28",0,1,9,4,0,3,1038008,"2023-12-27T00:00:00.000Z",30,FALSE,28,409,"G",28,28,"Toronto Raptors","Dennis Schroder",0,13,23,19,14,25.8
3,0,2,0,0,1,1,1,1,"05",1,0,3,3,0,1,1038008,"2023-12-27T00:00:00.000Z",30,FALSE,28,489,"F",28,28,"Toronto Raptors","Thaddeus Young",0,6,9,6,6,10.1
0,0,3,4,2,5,2,0,0,"12",1,3,6,4,0,0,1038008,"2023-12-27T00:00:00.000Z",30,FALSE,28,58,"F",28,28,"Toronto Raptors","Chris Boucher",0,10,10,6,4,10.8
0,0,1,0,0,1,1,1,1,"05",0,0,3,1,1,0,1038008,"2023-12-27T00:00:00.000Z",30,FALSE,28,56677828,"G",28,28,"Toronto Raptors","Gradey Dick",1,4,4,3,1,7.2
0,0,0,3,2,3,2,0,0,"05",1,1,6,1,0,2,1038008,"2023-12-27T00:00:00.000Z",30,FALSE,28,3547275,"G",28,28,"Toronto Raptors","Malachi Flynn",0,7,7,6,1,5.2
1,0,4,4,0,7,2,2,2,"19",0,2,6,4,1,0,1038008,"2023-12-27T00:00:00.000Z",30,FALSE,28,666762,"F",28,28,"Toronto Raptors","Jalen McDaniels",1,10,11,7,5,15.3
2,1,2,0,0,3,3,0,0,"13",0,2,6,2,1,0,1038008,"2023-12-27T00:00:00.000Z",30,FALSE,28,376,"F",28,28,"Toronto Raptors","Otto Porter Jr.",2,8,10,8,4,17.4
0,0,0,0,0,0,0,0,0,"00",0,0,0,0,0,0,1038008,"2023-12-27T00:00:00.000Z",30,FALSE,28,56677805,"G",28,28,"Toronto Raptors","Javon Freeman-Liberty",0,0,0,0,0,0
0,0,0,0,0,0,0,0,0,"00",0,0,0,0,0,0,1038008,"2023-12-27T00:00:00.000Z",30,FALSE,28,38017710,"C",28,28,"Toronto Raptors","Christian Koloko",0,0,0,0,0,0
0,0,0,0,0,0,0,0,0,"00",0,0,0,0,0,0,1038008,"2023-12-27T00:00:00.000Z",30,FALSE,28,56677869,"G",28,28,"Toronto Raptors","Markquis Nowell",0,0,0,0,0,0
0,0,0,0,0,0,0,0,0,"00",0,0,0,0,0,0,1038008,"2023-12-27T00:00:00.000Z",30,FALSE,28,2309958,"C-F",15,28,"Toronto Raptors","Jontay Porter",0,0,0,0,0,0
0,0,0,0,0,0,0,0,0,"00",0,0,0,0,0,0,1038008,"2023-12-27T00:00:00.000Z",30,FALSE,28,436,"G-F",28,28,"Toronto Raptors","Garrett Temple",0,0,0,0,0,0
3,0,5,5,1,16,8,8,7,"36",0,4,24,5,1,4,1038007,"2023-12-27T00:00:00.000Z",22,FALSE,23,17896026,"F",22,22,"Orlando Magic","Franz Wagner",1,29,32,27,8,33.5
4,1,9,8,1,21,6,7,6,"38",0,0,19,9,1,1,1038007,"2023-12-27T00:00:00.000Z",22,FALSE,23,38017683,"F",22,22,"Orlando Magic","Paolo Banchero",2,28,32,23,13,40.8
1,2,2,2,0,4,1,2,2,"22",2,0,4,4,0,1,1038007,"2023-12-27T00:00:00.000Z",22,FALSE,23,85,"F",22,22,"Orlando Magic","Wendell Carter Jr.",2,8,9,5,5,15.3
1,1,1,2,1,12,8,3,3,"28",1,5,20,2,1,3,1038007,"2023-12-27T00:00:00.000Z",22,FALSE,23,17896073,"G",22,22,"Orlando Magic","Jalen Suggs",2,22,23,21,3,26.9
4,1,3,3,1,6,1,0,0,"24",1,2,3,4,1,0,1038007,"2023-12-27T00:00:00.000Z",22,FALSE,23,56677827,"G",22,22,"Orlando Magic","Anthony Black",2,7,11,7,8,19.8
1,0,4,4,1,7,2,1,0,"23",2,1,5,6,0,4,1038007,"2023-12-27T00:00:00.000Z",22,FALSE,23,3547251,"G",22,22,"Orlando Magic","Cole Anthony",0,11,12,6,7,9.7
0,4,1,0,0,1,1,0,0,"09",0,0,2,1,0,0,1038007,"2023-12-27T00:00:00.000Z",22,FALSE,23,666442,"C",22,22,"Orlando Magic","Goga Bitadze",4,3,3,2,1,15.2
2,0,4,4,2,4,2,1,1,"26",2,2,7,6,0,2,1038007,"2023-12-27T00:00:00.000Z",22,FALSE,23,38017724,"G",22,22,"Orlando Magic","Caleb Houstan",0,13,15,9,8,15.2
0,0,0,1,1,1,1,0,0,"01",0,0,3,0,0,0,1038007,"2023-12-27T00:00:00.000Z",22,FALSE,23,56677839,"G",22,22,"Orlando Magic","Jett Howard",0,3,3,3,0,3
0,1,3,2,1,3,1,0,0,"15",1,2,3,4,0,0,1038007,"2023-12-27T00:00:00.000Z",22,FALSE,23,666818,"F",22,22,"Orlando Magic","Chuma Okeke",1,7,7,3,4,10.8
0,0,0,1,0,1,0,0,0,"01",0,0,0,0,1,0,1038007,"2023-12-27T00:00:00.000Z",22,FALSE,23,17553983,"G",22,22,"Orlando Magic","Trevelin Queen",1,0,0,0,0,3
0,0,0,0,0,0,0,0,0,"01",0,0,0,0,0,0,1038007,"2023-12-27T00:00:00.000Z",22,FALSE,23,666885,"F",22,22,"Orlando Magic","Admiral Schofield",0,0,0,0,0,0
1,0,2,1,0,3,0,2,2,"16",0,2,2,2,0,1,1038007,"2023-12-27T00:00:00.000Z",22,FALSE,23,462,"C",22,22,"Orlando Magic","Moritz Wagner",0,4,5,3,3,4.9
0,0,0,0,0,0,0,0,0,"00",0,0,0,0,0,0,1038007,"2023-12-27T00:00:00.000Z",22,FALSE,23,165,"G",22,22,"Orlando Magic","Markelle Fultz",0,0,0,0,0,0
0,0,0,0,0,0,0,0,0,"00",0,0,0,0,0,0,1038007,"2023-12-27T00:00:00.000Z",22,FALSE,23,196,"G",22,22,"Orlando Magic","Gary Harris",0,0,0,0,0,0
0,0,0,0,0,0,0,0,0,"00",0,0,0,0,0,0,1038007,"2023-12-27T00:00:00.000Z",22,FALSE,23,38017607,"G",22,22,"Orlando Magic","Kevon Harris",0,0,0,0,0,0
0,0,0,0,0,0,0,0,0,"00",0,0,0,0,0,0,1038007,"2023-12-27T00:00:00.000Z",22,FALSE,23,226,"F",22,22,"Orlando Magic","Joe Ingles",0,0,0,0,0,0
0,0,0,0,0,0,0,0,0,"00",0,0,0,0,0,0,1038007,"2023-12-27T00:00:00.000Z",22,FALSE,23,229,"F",22,22,"Orlando Magic","Jonathan Isaac",0,0,0,0,0,0
1,2,3,4,1,7,1,2,1,"29",1,1,4,4,2,1,1038007,"2023-12-27T00:00:00.000Z",22,FALSE,23,360,"F",23,23,"Philadelphia 76ers","Kelly Oubre Jr.",4,8,9,5,5,21.3
2,0,6,5,1,23,10,1,1,"33",1,0,22,7,1,0,1038007,"2023-12-27T00:00:00.000Z",22,FALSE,23,200,"F",23,23,"Philadelphia 76ers","Tobias Harris",1,29,31,24,9,36.4
0,0,0,0,0,0,0,0,0,"00",0,0,0,0,0,0,1038007,"2023-12-27T00:00:00.000Z",22,FALSE,23,145,"F-C",23,23,"Philadelphia 76ers","Joel Embiid",0,0,0,0,0,0
0,0,0,0,0,0,0,0,0,"00",0,0,0,0,0,0,1038007,"2023-12-27T00:00:00.000Z",22,FALSE,23,38017732,"F",15,23,"Philadelphia 76ers","Kenneth Lofton Jr.",0,0,0,0,0,0
0,0,0,0,0,0,0,0,0,"00",0,0,0,0,0,0,1038007,"2023-12-27T00:00:00.000Z",22,FALSE,23,56677788,"G",23,23,"Philadelphia 76ers","Terquavion Smith",0,0,0,0,0,0
1,1,5,0,0,1,0,0,0,"16",2,2,0,7,1,1,1038007,"2023-12-27T00:00:00.000Z",22,FALSE,23,28,"C",23,23,"Philadelphia 76ers","Mo Bamba",2,7,8,1,8,14.9
2,0,1,1,0,2,1,1,0,"11",0,2,2,1,2,1,1038007,"2023-12-27T00:00:00.000Z",22,FALSE,23,108,"F",23,23,"Philadelphia 76ers","Robert Covington",2,3,5,4,3,11.2
0,0,0,0,0,0,0,0,0,"00",0,0,0,0,0,0,1038007,"2023-12-27T00:00:00.000Z",22,FALSE,23,260,"G-F",23,23,"Philadelphia 76ers","Furkan Korkmaz",0,0,0,0,0,0
0,0,0,0,0,0,0,0,0,"01",0,0,0,0,0,0,1038007,"2023-12-27T00:00:00.000Z",22,FALSE,23,3547294,"F",23,23,"Philadelphia 76ers","Kenyon Martin Jr.",0,0,0,0,0,0
0,0,3,3,0,14,6,3,2,"22",0,3,14,3,0,0,1038007,"2023-12-27T00:00:00.000Z",22,FALSE,23,328,"F",23,23,"Philadelphia 76ers","Marcus Morris",0,17,17,14,3,17.6
0,0,0,0,0,0,0,0,0,"01",0,0,0,0,0,1,1038007,"2023-12-27T00:00:00.000Z",22,FALSE,23,17896025,"G",23,23,"Philadelphia 76ers","Jaden Springer",0,0,0,0,0,-1
0,0,0,0,0,0,0,0,0,"00",0,0,0,0,0,0,1038007,"2023-12-27T00:00:00.000Z",22,FALSE,23,33,"F-G",23,23,"Philadelphia 76ers","Nicolas Batum",0,0,0,0,0,0
0,0,0,0,0,0,0,0,0,"00",0,0,0,0,0,0,1038007,"2023-12-27T00:00:00.000Z",22,FALSE,23,56913527,"G",23,23,"Philadelphia 76ers","Ricky Council IV",0,0,0,0,0,0
3,3,5,1,1,11,6,3,2,"32",5,4,15,10,1,2,1038007,"2023-12-27T00:00:00.000Z",22,FALSE,23,3547270,"F",23,23,"Philadelphia 76ers","Paul Reed",4,25,28,18,13,41.5
1,0,4,7,4,13,8,2,2,"37",1,3,22,5,2,1,1038007,"2023-12-27T00:00:00.000Z",22,FALSE,23,313,"G",23,23,"Philadelphia 76ers","De'Anthony Melton",2,27,28,23,6,34.5
2,1,5,6,3,18,9,3,2,"34",1,2,23,6,0,1,1038007,"2023-12-27T00:00:00.000Z",22,FALSE,23,3547254,"G",23,23,"Philadelphia 76ers","Tyrese Maxey",1,29,31,25,8,35.2
2,1,4,1,0,7,4,2,2,"17",0,2,10,4,1,1,1038007,"2023-12-27T00:00:00.000Z",22,FALSE,23,45,"G",23,23,"Philadelphia 76ers","Patrick Beverley",2,14,16,12,6,22.8
0,0,0,0,0,0,0,0,0,"07",1,0,0,1,0,1,1038007,"2023-12-27T00:00:00.000Z",22,FALSE,23,2175,"",23,23,"Philadelphia 76ers","Danuel House Jr.",0,1,1,0,1,0.2
10,0,5,11,2,31,11,8,7,"43",2,4,31,7,5,3,1038013,"2023-12-28T00:00:00.000Z",2,FALSE,9,434,"F",2,2,"Boston Celtics","Jayson Tatum",5,38,48,41,17,66.4
3,1,3,3,2,4,3,0,0,"37",2,1,8,5,1,1,1038013,"2023-12-28T00:00:00.000Z",2,FALSE,9,219,"C-F",2,2,"Boston Celtics","Al Horford",2,13,16,11,8,23.5
1,0,8,9,3,21,13,7,6,"36",0,4,35,8,1,1,1038013,"2023-12-28T00:00:00.000Z",2,FALSE,9,378,"F-C",2,2,"Boston Celtics","Kristaps Porzingis",1,43,44,36,9,48.1
5,2,3,4,2,15,9,3,3,"38",1,1,23,4,0,2,1038013,"2023-12-28T00:00:00.000Z",2,FALSE,9,473,"G",2,2,"Boston Celtics","Derrick White",2,27,32,28,9,39.3
3,1,7,2,0,9,4,5,4,"44",2,1,12,9,1,3,1038013,"2023-12-28T00:00:00.000Z",2,FALSE,9,214,"G",2,2,"Boston Celtics","Jrue Holiday",2,21,24,15,12,30.3
0,0,0,0,0,0,0,0,0,"00",0,0,0,0,0,0,1038013,"2023-12-28T00:00:00.000Z",2,FALSE,9,17896094,"G",2,2,"Boston Celtics","Dalano Banton",0,0,0,0,0,0
0,0,0,0,0,0,0,0,0,"06",1,0,0,1,0,0,1038013,"2023-12-28T00:00:00.000Z",2,FALSE,9,666468,"F",2,2,"Boston Celtics","Oshae Brissett",0,1,1,0,1,1.2
2,1,1,6,2,7,3,4,1,"23",0,2,9,1,0,3,1038013,"2023-12-28T00:00:00.000Z",2,FALSE,9,17896071,"F",9,9,"Detroit Pistons","Isaiah Livers",1,10,12,11,3,13.2
0,0,2,6,0,9,3,0,0,"18",0,3,6,2,1,0,1038013,"2023-12-28T00:00:00.000Z",2,FALSE,9,259,"F",9,9,"Detroit Pistons","Kevin Knox",1,8,8,6,2,11.4
2,0,6,0,0,6,5,6,5,"40",8,1,15,14,0,0,1038013,"2023-12-28T00:00:00.000Z",2,FALSE,9,38017694,"C",9,9,"Detroit Pistons","Jalen Duren",0,29,31,17,16,34.8
4,1,5,5,3,15,8,5,3,"33",5,6,22,10,0,3,1038013,"2023-12-28T00:00:00.000Z",2,FALSE,9,38017682,"G",9,9,"Detroit Pistons","Jaden Ivey",1,32,36,26,14,40
9,2,5,6,4,22,12,4,3,"42",1,3,31,6,3,6,1038013,"2023-12-28T00:00:00.000Z",2,FALSE,9,17896075,"G-F",9,9,"Detroit Pistons","Cade Cunningham",5,37,46,40,15,60.7
0,0,0,0,0,0,0,0,0,"00",0,0,0,0,0,0,1038013,"2023-12-28T00:00:00.000Z",2,FALSE,9,24,"F",9,9,"Detroit Pistons","Marvin Bagley III",0,0,0,0,0,0
1,0,1,12,4,13,4,0,0,"30",1,2,12,2,2,0,1038013,"2023-12-28T00:00:00.000Z",2,FALSE,9,77,"G",9,9,"Detroit Pistons","Alec Burks",2,14,15,13,3,21.9
0,0,0,0,0,0,0,0,0,"00",0,0,0,0,0,0,1038013,"2023-12-28T00:00:00.000Z",2,FALSE,9,197,"F-G",9,9,"Detroit Pistons","Joe Harris",0,0,0,0,0,0
0,0,2,0,0,3,1,0,0,"10",0,0,2,2,1,3,1038013,"2023-12-28T00:00:00.000Z",2,FALSE,9,3547241,"G",9,9,"Detroit Pistons","Killian Hayes",1,4,4,2,2,4.4
1,0,2,4,1,6,2,0,0,"18",1,0,5,3,0,1,1038013,"2023-12-28T00:00:00.000Z",2,FALSE,9,17896060,"F",2,2,"Boston Celtics","Sam Hauser",0,8,9,6,4,9.1
0,0,0,0,0,0,0,0,0,"00",0,0,0,0,0,0,1038013,"2023-12-28T00:00:00.000Z",2,FALSE,9,261,"F-C",2,2,"Boston Celtics","Luke Kornet",0,0,0,0,0,0
0,0,0,0,0,0,0,0,0,"00",0,0,0,0,0,0,1038013,"2023-12-28T00:00:00.000Z",2,FALSE,9,338,"G",2,2,"Boston Celtics","Svi Mykhailiuk",0,0,0,0,0,0
2,0,2,6,1,11,4,0,0,"23",2,0,9,4,1,1,1038013,"2023-12-28T00:00:00.000Z",2,FALSE,9,3547276,"G",2,2,"Boston Celtics","Payton Pritchard",1,13,15,11,6,18.8
0,0,2,0,0,2,2,2,1,"20",0,4,5,2,1,0,1038013,"2023-12-28T00:00:00.000Z",2,FALSE,9,17553967,"C",2,2,"Boston Celtics","Neemias Queta",1,7,7,5,2,10.4
0,0,0,0,0,0,0,0,0,"00",0,0,0,0,0,0,1038013,"2023-12-28T00:00:00.000Z",2,FALSE,9,3547279,"F",2,2,"Boston Celtics","Lamar Stevens",0,0,0,0,0,0
0,0,0,0,0,0,0,0,0,"00",0,0,0,0,0,0,1038013,"2023-12-28T00:00:00.000Z",2,FALSE,9,70,"G",2,2,"Boston Celtics","Jaylen Brown",0,0,0,0,0,0
0,0,0,0,0,0,0,0,0,"00",0,0,0,0,0,0,1038013,"2023-12-28T00:00:00.000Z",2,FALSE,9,38017707,"G",2,2,"Boston Celtics","JD Davison",0,0,0,0,0,0
0,0,0,0,0,0,0,0,0,"00",0,0,0,0,0,0,1038013,"2023-12-28T00:00:00.000Z",2,FALSE,9,NA,NA,NA,2,"Boston Celtics","NA NA",0,0,0,0,0,0
0,0,0,0,0,0,0,0,0,"00",0,0,0,0,0,0,1038013,"2023-12-28T00:00:00.000Z",2,FALSE,9,56677864,"G",2,2,"Boston Celtics","Jordan Walsh",0,0,0,0,0,0
6,0,10,7,1,21,8,0,0,"44",2,3,17,12,0,2,1038013,"2023-12-28T00:00:00.000Z",2,FALSE,9,54,"F",9,9,"Detroit Pistons","Bojan Bogdanovic",0,29,35,23,18,38.4
0,0,0,0,0,0,0,0,0,"00",0,0,0,0,0,0,1038013,"2023-12-28T00:00:00.000Z",2,FALSE,9,56677792,"G",9,9,"Detroit Pistons","Marcus Sasser",0,0,0,0,0,0
2,0,3,1,0,2,1,0,0,"12",0,1,2,3,0,0,1038013,"2023-12-28T00:00:00.000Z",2,FALSE,9,56677826,"G-F",9,9,"Detroit Pistons","Ausar Thompson",0,5,7,4,5,8.6
1,0,3,0,0,3,3,0,0,"13",2,0,6,5,0,1,1038013,"2023-12-28T00:00:00.000Z",2,FALSE,9,3547240,"C",9,9,"Detroit Pistons","James Wiseman",0,11,12,7,6,12.5
0,0,0,0,0,0,0,0,0,"00",0,0,0,0,0,0,1038013,"2023-12-28T00:00:00.000Z",2,FALSE,9,56677729,"G",9,9,"Detroit Pistons","Malcolm Cazalon",0,0,0,0,0,0
0,0,0,0,0,0,0,0,0,"00",0,0,0,0,0,0,1038013,"2023-12-28T00:00:00.000Z",2,FALSE,9,330,"G",9,9,"Detroit Pistons","Monte Morris",0,0,0,0,0,0
0,0,0,0,0,0,0,0,0,"00",0,0,0,0,0,0,1038013,"2023-12-28T00:00:00.000Z",2,FALSE,9,42097199,"G",9,9,"Detroit Pistons","Jared Rhoden",0,0,0,0,0,0
0,0,0,0,0,0,0,0,0,"00",0,0,0,0,0,0,1038013,"2023-12-28T00:00:00.000Z",2,FALSE,9,3547267,"F-C",9,9,"Detroit Pistons","Isaiah Stewart",0,0,0,0,0,0
0,0,0,0,0,0,0,0,0,"00",0,0,0,0,0,0,1038013,"2023-12-28T00:00:00.000Z",2,FALSE,9,44477024,"G",9,9,"Detroit Pistons","Stanley Umude",0,0,0,0,0,0
5,0,5,3,0,19,7,8,7,"37",0,1,21,5,2,1,1038014,"2023-12-28T00:00:00.000Z",5,FALSE,12,125,"G",5,5,"Chicago Bulls","DeMar DeRozan",2,26,31,26,10,39.5
3,0,4,5,2,14,9,2,2,"38",1,3,22,5,2,0,1038014,"2023-12-28T00:00:00.000Z",5,FALSE,12,3547248,"F",5,5,"Chicago Bulls","Patrick Williams",2,27,30,25,8,38.5
0,0,9,0,0,9,3,4,1,"21",7,4,7,16,1,1,1038014,"2023-12-28T00:00:00.000Z",5,FALSE,12,137,"C",5,5,"Chicago Bulls","Andre Drummond",1,23,23,7,16,28.2
2,0,5,7,3,11,6,0,0,"32",2,1,15,7,1,1,1038014,"2023-12-28T00:00:00.000Z",5,FALSE,12,89,"G",5,5,"Chicago Bulls","Alex Caruso",1,22,24,17,9,28.4
2,0,5,6,2,19,5,4,4,"33",0,3,16,5,0,2,1038014,"2023-12-28T00:00:00.000Z",5,FALSE,12,666956,"G",5,5,"Chicago Bulls","Coby White",0,21,23,18,7,23
2,1,0,3,0,5,0,0,0,"12",0,1,0,0,0,0,1038014,"2023-12-28T00:00:00.000Z",5,FALSE,12,87,"G",5,5,"Chicago Bulls","Jevon Carter",1,0,2,2,2,6
0,0,0,0,0,0,0,0,0,"00",0,0,0,0,0,0,1038014,"2023-12-28T00:00:00.000Z",5,FALSE,12,110,"F",5,5,"Chicago Bulls","Torrey Craig",0,0,0,0,0,0
3,0,4,2,0,15,7,2,1,"33",1,3,15,5,0,0,1038014,"2023-12-28T00:00:00.000Z",5,FALSE,12,17895983,"G",5,5,"Chicago Bulls","Ayo Dosunmu",0,20,23,18,8,25.5
2,1,6,10,5,13,7,0,0,"33",0,3,19,6,1,3,1038014,"2023-12-28T00:00:00.000Z",5,FALSE,12,210,"G",12,12,"Indiana Pacers","Buddy Hield",2,25,27,21,8,32.2
1,0,0,0,0,1,1,3,1,"11",0,0,3,0,1,1,1038014,"2023-12-28T00:00:00.000Z",5,FALSE,12,17896035,"F",12,12,"Indiana Pacers","Isaiah Jackson",1,3,4,4,1,6.5
0,0,0,0,0,0,0,0,0,"00",0,0,0,0,0,0,1038014,"2023-12-28T00:00:00.000Z",5,FALSE,12,242,"F",12,12,"Indiana Pacers","James Johnson",0,0,0,0,0,0
1,1,3,3,1,9,5,5,4,"26",2,1,15,5,0,3,1038014,"2023-12-28T00:00:00.000Z",5,FALSE,12,38017686,"G-F",12,12,"Indiana Pacers","Bennedict Mathurin",1,20,21,16,6,22.5
0,0,0,0,0,0,0,0,0,"00",0,0,0,0,0,0,1038014,"2023-12-28T00:00:00.000Z",5,FALSE,12,304,"G",12,12,"Indiana Pacers","T.J. McConnell",0,0,0,0,0,0
0,0,0,0,0,0,0,0,0,"00",0,0,0,0,0,0,1038014,"2023-12-28T00:00:00.000Z",5,FALSE,12,3547207,"F",12,12,"Indiana Pacers","Jordan Nwora",0,0,0,0,0,0
0,0,0,0,0,0,0,0,0,"00",0,0,0,0,0,0,1038014,"2023-12-28T00:00:00.000Z",5,FALSE,12,56677861,"G",12,12,"Indiana Pacers","Ben Sheppard",0,0,0,0,0,0
0,1,11,3,1,4,1,0,0,"25",1,0,3,12,0,1,1038014,"2023-12-28T00:00:00.000Z",5,FALSE,12,3547243,"F",12,12,"Indiana Pacers","Obi Toppin",1,15,15,3,12,19.4
0,0,0,0,0,0,0,0,0,"00",0,0,0,0,0,0,1038014,"2023-12-28T00:00:00.000Z",5,FALSE,12,56677832,"F",12,12,"Indiana Pacers","Jarace Walker",0,0,0,0,0,0
0,0,0,0,0,0,0,0,0,"00",0,0,0,0,0,0,1038014,"2023-12-28T00:00:00.000Z",5,FALSE,12,69,"G",12,12,"Indiana Pacers","Bruce Brown",0,0,0,0,0,0
0,0,0,0,0,0,0,0,0,"00",0,0,0,0,0,0,1038014,"2023-12-28T00:00:00.000Z",5,FALSE,12,27,"G",5,5,"Chicago Bulls","Lonzo Ball",0,0,0,0,0,0
0,0,0,0,0,0,0,0,0,"00",0,0,0,0,0,0,1038014,"2023-12-28T00:00:00.000Z",5,FALSE,12,56677874,"F",5,5,"Chicago Bulls","Onuralp Bitim",0,0,0,0,0,0
0,0,0,0,0,0,0,0,0,"00",0,0,0,0,0,0,1038014,"2023-12-28T00:00:00.000Z",5,FALSE,12,NA,NA,NA,5,"Chicago Bulls","NA NA",0,0,0,0,0,0
0,0,0,0,0,0,0,0,0,"00",0,0,0,0,0,0,1038014,"2023-12-28T00:00:00.000Z",5,FALSE,12,268,"G",5,5,"Chicago Bulls","Zach LaVine",0,0,0,0,0,0
0,0,0,0,0,0,0,0,0,"00",0,0,0,0,0,0,1038014,"2023-12-28T00:00:00.000Z",5,FALSE,12,460,"C",5,5,"Chicago Bulls","Nikola Vucevic",0,0,0,0,0,0
1,2,5,6,4,9,4,0,0,"34",0,4,12,5,1,1,1038014,"2023-12-28T00:00:00.000Z",5,FALSE,12,3547250,"G-F",12,12,"Indiana Pacers","Aaron Nesmith",3,17,18,13,6,27.5
1,0,5,2,1,7,6,5,2,"24",2,3,15,7,0,0,1038014,"2023-12-28T00:00:00.000Z",5,FALSE,12,3547264,"F-C",12,12,"Indiana Pacers","Jalen Smith",0,22,23,16,8,24.9
0,3,6,2,1,12,8,7,7,"26",0,5,24,6,0,3,1038014,"2023-12-28T00:00:00.000Z",5,FALSE,12,452,"C-F",12,12,"Indiana Pacers","Myles Turner",3,30,30,24,6,37.2
0,0,0,0,0,0,0,0,0,"01",0,0,0,0,0,0,1038014,"2023-12-28T00:00:00.000Z",5,FALSE,12,56677857,"F",5,5,"Chicago Bulls","Julian Phillips",0,0,0,0,0,0
0,0,0,0,0,0,0,0,0,"01",0,0,0,0,0,0,1038014,"2023-12-28T00:00:00.000Z",5,FALSE,12,56677860,"F",5,5,"Chicago Bulls","Adama Sanogo",0,0,0,0,0,0
4,0,2,3,0,13,4,0,0,"24",1,3,8,3,1,1,1038014,"2023-12-28T00:00:00.000Z",5,FALSE,12,38017507,"G-F",12,12,"Indiana Pacers","Andrew Nembhard",1,11,15,12,7,19.6
20,1,3,13,6,17,7,2,1,"37",0,2,21,3,2,0,1038014,"2023-12-28T00:00:00.000Z",5,FALSE,12,3547245,"G",12,12,"Indiana Pacers","Tyrese Haliburton",3,24,44,41,23,63.6
0,0,0,0,0,0,0,0,0,"00",0,0,0,0,0,0,1038014,"2023-12-28T00:00:00.000Z",5,FALSE,12,38017701,"G",12,12,"Indiana Pacers","Kendall Brown",0,0,0,0,0,0
0,0,0,0,0,0,0,0,0,"00",0,0,0,0,0,0,1038014,"2023-12-28T00:00:00.000Z",5,FALSE,12,56677778,"F-C",12,12,"Indiana Pacers","Oscar Tshiebwe",0,0,0,0,0,0
0,0,0,0,0,0,0,0,0,"00",0,0,0,0,0,0,1038014,"2023-12-28T00:00:00.000Z",5,FALSE,12,56677794,"G",12,12,"Indiana Pacers","Isaiah Wong",0,0,0,0,0,0
1,0,0,1,0,2,1,0,0,"14",1,3,2,1,0,0,1038014,"2023-12-28T00:00:00.000Z",5,FALSE,12,17896116,"G",5,5,"Chicago Bulls","Terry Taylor",0,3,4,3,2,4.7
1,3,2,0,0,3,2,2,2,"18",1,1,6,3,1,2,1038014,"2023-12-28T00:00:00.000Z",5,FALSE,12,38017719,"F",5,5,"Chicago Bulls","Dalen Terry",4,9,10,7,4,21.1
0,4,0,3,2,8,5,1,0,"34",0,3,12,0,1,2,1038015,"2023-12-28T00:00:00.000Z",18,FALSE,7,3547259,"F",18,18,"Minnesota Timberwolves","Jaden McDaniels",5,12,12,12,0,25
3,0,6,6,2,12,3,4,2,"27",2,5,10,8,0,5,1038015,"2023-12-28T00:00:00.000Z",18,FALSE,7,447,"C",18,18,"Minnesota Timberwolves","Karl-Anthony Towns",0,18,21,13,11,19.1
2,3,9,0,0,7,7,7,6,"38",2,2,20,11,0,2,1038015,"2023-12-28T00:00:00.000Z",18,FALSE,7,176,"C",18,18,"Minnesota Timberwolves","Rudy Gobert",3,31,33,22,13,43.2
4,1,3,11,6,23,12,18,14,"38",0,2,44,3,3,6,1038015,"2023-12-28T00:00:00.000Z",18,FALSE,7,3547238,"G",18,18,"Minnesota Timberwolves","Anthony Edwards",4,47,51,48,7,59.6
6,1,1,4,2,7,3,2,2,"28",1,5,10,2,0,1,1038015,"2023-12-28T00:00:00.000Z",18,FALSE,7,104,"G",18,18,"Minnesota Timberwolves","Mike Conley",1,12,18,16,8,23.4
3,1,0,3,1,3,1,0,0,"24",0,0,3,0,4,0,1038015,"2023-12-28T00:00:00.000Z",18,FALSE,7,666400,"G",18,18,"Minnesota Timberwolves","Nickeil Alexander-Walker",5,3,6,6,3,22.5
3,0,9,1,1,8,3,2,1,"27",1,0,8,10,0,3,1038015,"2023-12-28T00:00:00.000Z",18,FALSE,7,12,"F",18,18,"Minnesota Timberwolves","Kyle Anderson",0,18,21,11,13,21.5
0,0,0,0,0,1,1,0,0,"06",0,0,2,0,1,0,1038015,"2023-12-28T00:00:00.000Z",18,FALSE,7,68,"F",18,18,"Minnesota Timberwolves","Troy Brown Jr.",1,2,2,2,0,5
0,0,0,0,0,0,0,0,0,"00",0,0,0,0,0,0,1038015,"2023-12-28T00:00:00.000Z",18,FALSE,7,666767,"G",18,18,"Minnesota Timberwolves","Jordan McLaughlin",0,0,0,0,0,0
0,0,0,0,0,0,0,0,0,"00",0,0,0,0,0,0,1038015,"2023-12-28T00:00:00.000Z",18,FALSE,7,17895968,"F",18,18,"Minnesota Timberwolves","Daishen Nix",0,0,0,0,0,0
2,0,4,5,3,5,3,0,0,"18",0,4,9,4,0,3,1038015,"2023-12-28T00:00:00.000Z",18,FALSE,7,667378,"F-C",18,18,"Minnesota Timberwolves","Naz Reid",0,13,15,11,6,13.8
0,0,0,0,0,0,0,0,0,"00",0,0,0,0,0,0,1038015,"2023-12-28T00:00:00.000Z",18,FALSE,7,56677851,"G",18,18,"Minnesota Timberwolves","Jaylen Clark",0,0,0,0,0,0
0,0,0,0,0,0,0,0,0,"00",0,0,0,0,0,0,1038015,"2023-12-28T00:00:00.000Z",18,FALSE,7,17896056,"C",18,18,"Minnesota Timberwolves","Luka Garza",0,0,0,0,0,0
0,0,0,0,0,0,0,0,0,"00",0,0,0,0,0,0,1038015,"2023-12-28T00:00:00.000Z",18,FALSE,7,56677782,"F",18,18,"Minnesota Timberwolves","Leonard Miller",0,0,0,0,0,0
0,0,0,0,0,0,0,0,0,"00",0,0,0,0,0,0,1038015,"2023-12-28T00:00:00.000Z",18,FALSE,7,38017700,"G",18,18,"Minnesota Timberwolves","Wendell Moore Jr.",0,0,0,0,0,0
0,1,6,3,1,9,3,8,8,"30",3,5,15,9,3,1,1038015,"2023-12-28T00:00:00.000Z",18,FALSE,7,247,"F-G",7,7,"Dallas Mavericks","Derrick Jones Jr.",4,24,24,15,9,36.8
1,1,2,8,3,18,7,0,0,"31",0,2,17,2,1,0,1038015,"2023-12-28T00:00:00.000Z",18,FALSE,7,38017679,"G",7,7,"Dallas Mavericks","Jaden Hardy",2,19,20,18,3,26.9
6,0,2,1,1,11,5,0,0,"24",0,4,11,2,0,4,1038015,"2023-12-28T00:00:00.000Z",18,FALSE,7,151,"G",7,7,"Dallas Mavericks","Dante Exum",0,13,19,17,8,18.4
3,0,2,4,2,8,3,4,3,"30",0,2,11,2,0,3,1038015,"2023-12-28T00:00:00.000Z",18,FALSE,7,114,"G",7,7,"Dallas Mavericks","Seth Curry",0,13,16,14,5,14.9
5,0,0,1,0,3,1,0,0,"15",0,0,2,0,0,1,1038015,"2023-12-28T00:00:00.000Z",18,FALSE,7,3547258,"G",7,7,"Dallas Mavericks","Josh Green",0,2,7,7,5,8.5
3,0,3,11,5,19,11,7,5,"32",0,2,32,3,2,1,1038015,"2023-12-28T00:00:00.000Z",18,FALSE,7,191,"G",7,7,"Dallas Mavericks","Tim Hardaway Jr.",2,35,38,35,6,45.1
0,0,0,0,0,0,0,0,0,"00",0,0,0,0,0,0,1038015,"2023-12-28T00:00:00.000Z",18,FALSE,7,217,"F-C",7,7,"Dallas Mavericks","Richaun Holmes",0,0,0,0,0,0
0,0,0,0,0,0,0,0,0,"00",0,0,0,0,0,0,1038015,"2023-12-28T00:00:00.000Z",18,FALSE,7,17554004,"G",7,7,"Dallas Mavericks","AJ Lawson",0,0,0,0,0,0
0,0,0,0,0,0,0,0,0,"00",0,0,0,0,0,0,1038015,"2023-12-28T00:00:00.000Z",18,FALSE,7,320,"G",18,18,"Minnesota Timberwolves","Shake Milton",0,0,0,0,0,0
0,0,0,0,0,0,0,0,0,"00",0,0,0,0,0,0,1038015,"2023-12-28T00:00:00.000Z",18,FALSE,7,38017715,"F",18,18,"Minnesota Timberwolves","Josh Minott",0,0,0,0,0,0
0,0,0,0,0,1,0,0,0,"03",0,0,0,0,0,1,1038015,"2023-12-28T00:00:00.000Z",18,FALSE,7,329,"F",7,7,"Dallas Mavericks","Markieff Morris",0,0,0,0,0,-1
6,1,7,0,0,8,6,0,0,"30",7,3,12,14,2,1,1038015,"2023-12-28T00:00:00.000Z",18,FALSE,7,379,"F-C",7,7,"Dallas Mavericks","Dwight Powell",3,26,32,18,20,45.8
0,0,0,0,0,0,0,0,0,"00",0,0,0,0,0,0,1038015,"2023-12-28T00:00:00.000Z",18,FALSE,7,56677859,"F",7,7,"Dallas Mavericks","Olivier-Maxence Prosper",0,0,0,0,0,0
0,0,0,0,0,0,0,0,0,"00",0,0,0,0,0,0,1038015,"2023-12-28T00:00:00.000Z",18,FALSE,7,24489167,"G",25,7,"Dallas Mavericks","Brandon Williams",0,0,0,0,0,0
0,0,0,0,0,0,0,0,0,"00",0,0,0,0,0,0,1038015,"2023-12-28T00:00:00.000Z",18,FALSE,7,17896028,"F",7,7,"Dallas Mavericks","Greg Brown III",0,0,0,0,0,0
0,0,0,0,0,0,0,0,0,"00",0,0,0,0,0,0,1038015,"2023-12-28T00:00:00.000Z",18,FALSE,7,132,"F-G",7,7,"Dallas Mavericks","Luka Doncic",0,0,0,0,0,0
0,0,0,0,0,0,0,0,0,"00",0,0,0,0,0,0,1038015,"2023-12-28T00:00:00.000Z",18,FALSE,7,228,"G",7,7,"Dallas Mavericks","Kyrie Irving",0,0,0,0,0,0
0,0,0,0,0,0,0,0,0,"00",0,0,0,0,0,0,1038015,"2023-12-28T00:00:00.000Z",18,FALSE,7,257,"F",7,7,"Dallas Mavericks","Maxi Kleber",0,0,0,0,0,0
3,0,3,5,2,9,3,0,0,"30",0,4,8,3,1,2,1038015,"2023-12-28T00:00:00.000Z",18,FALSE,7,666965,"F",7,7,"Dallas Mavericks","Grant Williams",1,11,14,11,6,17.1
2,0,1,0,0,4,1,0,0,"15",3,5,2,4,0,2,1038015,"2023-12-28T00:00:00.000Z",18,FALSE,7,56677840,"C",7,7,"Dallas Mavericks","Dereck Lively II",0,6,8,4,6,7.8
5,2,2,2,1,18,9,7,7,"36",1,3,26,3,1,1,1038016,"2023-12-28T00:00:00.000Z",19,FALSE,29,227,"F",19,19,"New Orleans Pelicans","Brandon Ingram",3,29,34,31,8,45.1
8,1,9,0,0,14,10,3,1,"30",1,2,21,10,0,0,1038016,"2023-12-28T00:00:00.000Z",19,FALSE,29,666969,"F",19,19,"New Orleans Pelicans","Zion Williamson",1,31,39,29,18,48
1,1,2,1,0,6,2,2,2,"23",2,1,6,4,0,2,1038016,"2023-12-28T00:00:00.000Z",19,FALSE,29,455,"C",19,19,"New Orleans Pelicans","Jonas Valanciunas",1,10,11,7,5,13.3
1,1,3,1,0,4,3,0,0,"29",0,4,6,3,0,1,1038016,"2023-12-28T00:00:00.000Z",19,FALSE,29,17896024,"F",19,19,"New Orleans Pelicans","Herbert Jones",1,9,10,7,4,13.1
6,0,2,10,4,16,8,3,2,"32",1,2,22,3,2,2,1038016,"2023-12-28T00:00:00.000Z",19,FALSE,29,303,"G",19,19,"New Orleans Pelicans","CJ McCollum",2,25,31,28,9,38.6
0,0,0,2,1,4,3,0,0,"12",0,2,7,0,0,1,1038016,"2023-12-28T00:00:00.000Z",19,FALSE,29,17896097,"G",19,19,"New Orleans Pelicans","Jose Alvarado",0,7,7,7,0,6
2,1,2,1,0,1,0,0,0,"14",0,2,0,2,2,1,1038016,"2023-12-28T00:00:00.000Z",19,FALSE,29,38017677,"G",19,19,"New Orleans Pelicans","Dyson Daniels",3,2,4,2,4,13.4
0,0,0,0,0,0,0,0,0,"00",0,0,0,0,0,0,1038016,"2023-12-28T00:00:00.000Z",19,FALSE,29,3547260,"G",19,19,"New Orleans Pelicans","Kira Lewis Jr.",0,0,0,0,0,0
2,0,2,1,1,5,4,0,0,"16",0,1,9,2,0,3,1038016,"2023-12-28T00:00:00.000Z",19,FALSE,29,3547293,"F",19,19,"New Orleans Pelicans","Naji Marshall",0,11,13,11,4,11.4
2,0,1,7,2,8,2,0,0,"23",0,2,6,1,0,1,1038016,"2023-12-28T00:00:00.000Z",19,FALSE,29,18677986,"F",19,19,"New Orleans Pelicans","Trey Murphy III",0,7,9,8,3,9.2
0,1,6,2,1,6,4,0,0,"25",1,0,9,7,5,2,1038016,"2023-12-28T00:00:00.000Z",19,FALSE,29,340,"F",19,19,"New Orleans Pelicans","Larry Nance Jr.",6,16,16,9,7,33.4
0,0,0,0,0,0,0,0,0,"00",0,0,0,0,0,0,1038016,"2023-12-28T00:00:00.000Z",19,FALSE,29,17896021,"F",19,19,"New Orleans Pelicans","Jeremiah Robinson-Earl",0,0,0,0,0,0
0,0,0,0,0,0,0,0,0,"00",0,0,0,0,0,0,1038016,"2023-12-28T00:00:00.000Z",19,FALSE,29,491,"C",19,19,"New Orleans Pelicans","Cody Zeller",0,0,0,0,0,0
0,0,0,0,0,0,0,0,0,"00",0,0,0,0,0,0,1038016,"2023-12-28T00:00:00.000Z",19,FALSE,29,56677837,"G",19,19,"New Orleans Pelicans","Jordan Hawkins",0,0,0,0,0,0
0,0,0,0,0,0,0,0,0,"00",0,0,0,0,0,0,1038016,"2023-12-28T00:00:00.000Z",19,FALSE,29,38017663,"F",19,19,"New Orleans Pelicans","E.J. Liddell",0,0,0,0,0,0
0,0,0,0,0,0,0,0,0,"00",0,0,0,0,0,0,1038016,"2023-12-28T00:00:00.000Z",19,FALSE,29,17896017,"F",19,19,"New Orleans Pelicans","Matt Ryan",0,0,0,0,0,0
0,0,0,0,0,0,0,0,0,"00",0,0,0,0,0,0,1038016,"2023-12-28T00:00:00.000Z",19,FALSE,29,38017726,"G",19,19,"New Orleans Pelicans","Dereon Seabron",0,0,0,0,0,0
5,0,4,12,3,19,7,7,7,"35",6,1,24,10,1,3,1038016,"2023-12-28T00:00:00.000Z",19,FALSE,29,297,"F",29,29,"Utah Jazz","Lauri Markkanen",1,34,39,29,15,43.5
0,1,9,3,1,7,3,2,1,"26",3,2,8,12,0,1,1038016,"2023-12-28T00:00:00.000Z",19,FALSE,29,101,"F-C",29,29,"Utah Jazz","John Collins",1,20,20,8,12,24.4
0,1,1,1,1,5,5,0,0,"29",3,1,11,4,2,1,1038016,"2023-12-28T00:00:00.000Z",19,FALSE,29,38017705,"C",29,29,"Utah Jazz","Walker Kessler",3,15,15,11,4,23.8
3,1,0,3,1,5,3,0,0,"19",0,2,7,0,0,0,1038016,"2023-12-28T00:00:00.000Z",19,FALSE,29,139,"G",29,29,"Utah Jazz","Kris Dunn",1,7,10,10,3,14.5
3,0,4,6,3,17,8,9,7,"30",1,4,26,5,0,0,1038016,"2023-12-28T00:00:00.000Z",19,FALSE,29,413,"G",29,29,"Utah Jazz","Collin Sexton",0,31,34,29,8,36.5
6,0,2,5,1,11,3,3,3,"24",0,0,10,2,0,6,1038016,"2023-12-28T00:00:00.000Z",19,FALSE,29,100,"G",29,29,"Utah Jazz","Jordan Clarkson",0,12,18,16,8,15.4
5,0,3,5,1,7,1,2,1,"22",0,1,4,3,0,2,1038016,"2023-12-28T00:00:00.000Z",19,FALSE,29,56677834,"G",29,29,"Utah Jazz","Keyonte George",0,7,12,9,8,13.1
3,0,1,1,0,5,3,0,0,"19",2,0,6,3,1,2,1038016,"2023-12-28T00:00:00.000Z",19,FALSE,29,358,"F",29,29,"Utah Jazz","Kelly Olynyk",1,9,12,9,6,15.1
0,0,0,2,1,4,2,0,0,"14",2,4,5,2,1,1,1038016,"2023-12-28T00:00:00.000Z",19,FALSE,29,38017739,"F",29,29,"Utah Jazz","Simone Fontecchio",1,7,7,5,2,9.4
2,0,1,0,0,2,1,0,0,"16",0,0,2,1,0,2,1038016,"2023-12-28T00:00:00.000Z",19,FALSE,29,38017620,"G",29,29,"Utah Jazz","Ochai Agbaji",0,3,5,4,3,4.2
0,0,0,1,0,3,0,2,2,"06",0,0,2,0,0,0,1038016,"2023-12-28T00:00:00.000Z",19,FALSE,29,666650,"G",29,29,"Utah Jazz","Talen Horton-Tucker",0,2,2,2,0,2
0,0,0,0,0,0,0,0,0,"00",0,0,0,0,0,0,1038016,"2023-12-28T00:00:00.000Z",19,FALSE,29,56677824,"F",29,29,"Utah Jazz","Taylor Hendricks",0,0,0,0,0,0
0,0,0,0,0,0,0,0,0,"00",0,0,0,0,0,0,1038016,"2023-12-28T00:00:00.000Z",19,FALSE,29,666881,"F",29,29,"Utah Jazz","Luka Samanic",0,0,0,0,0,0
0,0,0,0,0,0,0,0,0,"00",0,0,0,0,0,0,1038016,"2023-12-28T00:00:00.000Z",19,FALSE,29,56677842,"F",29,29,"Utah Jazz","Brice Sensabaugh",0,0,0,0,0,0
0,0,0,0,0,0,0,0,0,"00",0,0,0,0,0,0,1038016,"2023-12-28T00:00:00.000Z",19,FALSE,29,11891374,"C",29,29,"Utah Jazz","Omer Yurtseven",0,0,0,0,0,0
0,0,0,0,0,0,0,0,0,"00",0,0,0,0,0,0,1038016,"2023-12-28T00:00:00.000Z",19,FALSE,29,17896023,"G",29,29,"Utah Jazz","Josh Christopher",0,0,0,0,0,0
0,0,0,0,0,0,0,0,0,"00",0,0,0,0,0,0,1038016,"2023-12-28T00:00:00.000Z",19,FALSE,29,38017630,"G",29,29,"Utah Jazz","Johnny Juzang",0,0,0,0,0,0
0,0,0,0,0,0,0,0,0,"00",0,0,0,0,0,0,1038016,"2023-12-28T00:00:00.000Z",19,FALSE,29,19465584,"F",29,29,"Utah Jazz","Micah Potter",0,0,0,0,0,0
0,1,4,3,2,6,3,0,0,"23",0,3,8,4,0,2,1038017,"2023-12-28T00:00:00.000Z",8,FALSE,15,375,"F",8,8,"Denver Nuggets","Michael Porter Jr.",1,12,12,8,4,13.8
2,0,5,10,4,14,6,4,4,"23",0,1,20,5,0,0,1038017,"2023-12-28T00:00:00.000Z",8,FALSE,15,38017721,"G",8,8,"Denver Nuggets","Peyton Watson",0,25,27,22,7,29
10,1,14,1,1,11,11,3,3,"30",0,1,26,14,0,3,1038017,"2023-12-28T00:00:00.000Z",8,FALSE,15,246,"C",8,8,"Denver Nuggets","Nikola Jokic",1,40,50,36,24,57.8
3,1,0,5,2,10,5,0,0,"25",2,2,12,2,0,0,1038017,"2023-12-28T00:00:00.000Z",8,FALSE,15,81,"G",8,8,"Denver Nuggets","Kentavious Caldwell-Pope",1,14,17,15,5,21.9
9,0,1,6,4,12,9,1,1,"26",2,0,23,3,2,1,1038017,"2023-12-28T00:00:00.000Z",8,FALSE,15,335,"G",8,8,"Denver Nuggets","Jamal Murray",2,26,35,32,12,45.1
4,0,3,2,1,8,4,4,2,"23",0,0,11,3,1,0,1038017,"2023-12-28T00:00:00.000Z",8,FALSE,15,38017709,"G",8,8,"Denver Nuggets","Christian Braun",1,14,18,15,7,23.6
1,0,2,3,2,5,3,0,0,"18",0,2,8,2,2,0,1038017,"2023-12-28T00:00:00.000Z",8,FALSE,15,215,"F-G",8,8,"Denver Nuggets","Justin Holiday",2,10,11,9,3,17.9
2,0,7,4,1,7,1,2,2,"30",4,3,5,11,0,0,1038017,"2023-12-28T00:00:00.000Z",8,FALSE,15,38017731,"G",15,15,"Memphis Grizzlies","Vince Williams Jr.",0,16,18,7,13,21.2
2,0,3,3,1,14,5,4,3,"28",1,1,14,4,2,0,1038017,"2023-12-28T00:00:00.000Z",8,FALSE,15,231,"F-C",15,15,"Memphis Grizzlies","Jaren Jackson Jr.",2,18,20,16,6,27.8
1,1,4,0,0,4,1,0,0,"22",0,3,2,4,0,2,1038017,"2023-12-28T00:00:00.000Z",8,FALSE,15,48,"C",15,15,"Memphis Grizzlies","Bismack Biyombo",1,6,7,3,5,9.3
2,0,1,5,3,13,9,2,2,"25",0,3,23,1,1,2,1038017,"2023-12-28T00:00:00.000Z",8,FALSE,15,3547287,"G",15,15,"Memphis Grizzlies","Desmond Bane",1,24,26,25,3,28.2
5,0,2,6,2,14,6,4,3,"23",1,1,17,3,1,3,1038017,"2023-12-28T00:00:00.000Z",8,FALSE,15,420,"G",15,15,"Memphis Grizzlies","Marcus Smart",1,20,25,22,8,28.1
0,0,0,0,0,0,0,0,0,"00",0,0,0,0,0,0,1038017,"2023-12-28T00:00:00.000Z",8,FALSE,15,17896067,"F",15,15,"Memphis Grizzlies","Santi Aldama",0,0,0,0,0,0
1,1,0,3,2,3,2,0,0,"12",0,0,6,0,0,0,1038017,"2023-12-28T00:00:00.000Z",8,FALSE,15,48248287,"G",15,15,"Memphis Grizzlies","Jacob Gilyard",1,6,7,7,1,10.5
3,1,4,5,1,8,4,1,1,"25",2,1,10,6,2,1,1038017,"2023-12-28T00:00:00.000Z",8,FALSE,15,666703,"G-F",15,15,"Memphis Grizzlies","John Konchar",3,16,19,13,9,29.7
0,0,0,0,0,0,0,0,0,"00",0,0,0,0,0,0,1038017,"2023-12-28T00:00:00.000Z",8,FALSE,15,666786,"G",15,15,"Memphis Grizzlies","Ja Morant",0,0,0,0,0,0
2,0,0,2,1,9,5,8,4,"29",0,0,15,0,0,0,1038017,"2023-12-28T00:00:00.000Z",8,FALSE,15,38017729,"F",15,15,"Memphis Grizzlies","David Roddy",0,15,17,17,2,18
1,1,1,3,1,8,2,2,2,"24",1,1,7,2,1,1,1038017,"2023-12-28T00:00:00.000Z",8,FALSE,15,17896027,"G-F",15,15,"Memphis Grizzlies","Ziaire Williams",2,9,10,8,3,15.9
7,0,1,1,1,7,3,2,2,"17",1,1,9,2,1,3,1038017,"2023-12-28T00:00:00.000Z",8,FALSE,15,236,"G",8,8,"Denver Nuggets","Reggie Jackson",1,11,18,16,9,21.9
2,1,3,8,2,13,5,0,0,"25",0,4,12,3,0,1,1038017,"2023-12-28T00:00:00.000Z",8,FALSE,15,56677776,"G",8,8,"Denver Nuggets","Julian Strawther",1,15,17,14,5,20.6
2,2,4,0,0,3,2,0,0,"13",5,3,4,9,0,0,1038017,"2023-12-28T00:00:00.000Z",8,FALSE,15,250,"C",8,8,"Denver Nuggets","DeAndre Jordan",2,13,15,6,11,23.8
1,0,1,0,0,2,1,0,0,"07",1,0,2,2,0,0,1038017,"2023-12-28T00:00:00.000Z",8,FALSE,15,17896007,"G",8,8,"Denver Nuggets","Braxton Key",0,4,5,3,3,5.9
0,0,2,0,0,3,2,0,0,"05",1,2,4,3,0,1,1038017,"2023-12-28T00:00:00.000Z",8,FALSE,15,3547268,"F-C",8,8,"Denver Nuggets","Zeke Nnaji",0,7,7,4,3,6.6
2,0,1,2,1,2,1,0,0,"05",0,0,3,1,0,0,1038017,"2023-12-28T00:00:00.000Z",8,FALSE,15,56677582,"G",8,8,"Denver Nuggets","Jalen Pickett",0,4,6,5,3,7.2
0,0,0,0,0,0,0,0,0,"00",0,0,0,0,0,0,1038017,"2023-12-28T00:00:00.000Z",8,FALSE,15,666489,"F",8,8,"Denver Nuggets","Vlatko Cancar",0,0,0,0,0,0
0,0,0,0,0,0,0,0,0,"00",0,0,0,0,0,0,1038017,"2023-12-28T00:00:00.000Z",8,FALSE,15,38017727,"G",8,8,"Denver Nuggets","Collin Gillespie",0,0,0,0,0,0
0,0,0,0,0,0,0,0,0,"00",0,0,0,0,0,0,1038017,"2023-12-28T00:00:00.000Z",8,FALSE,15,177,"F",8,8,"Denver Nuggets","Aaron Gordon",0,0,0,0,0,0
0,0,0,0,0,0,0,0,0,"00",0,0,0,0,0,0,1038017,"2023-12-28T00:00:00.000Z",8,FALSE,15,17896103,"F-C",8,8,"Denver Nuggets","Jay Huff",0,0,0,0,0,0
0,0,0,0,0,0,0,0,0,"00",0,0,0,0,0,0,1038017,"2023-12-28T00:00:00.000Z",8,FALSE,15,56677871,"F",8,8,"Denver Nuggets","Hunter Tyson",0,0,0,0,0,0
4,1,3,4,1,7,2,2,1,"22",0,0,6,3,1,2,1038017,"2023-12-28T00:00:00.000Z",8,FALSE,15,3547285,"F",15,15,"Memphis Grizzlies","Xavier Tillman",2,9,13,10,7,19.6
0,0,0,0,0,0,0,0,0,"00",0,0,0,0,0,0,1038017,"2023-12-28T00:00:00.000Z",8,FALSE,15,3,"C",15,15,"Memphis Grizzlies","Steven Adams",0,0,0,0,0,0
0,0,0,0,0,0,0,0,0,"00",0,0,0,0,0,0,1038017,"2023-12-28T00:00:00.000Z",8,FALSE,15,666505,"F",15,15,"Memphis Grizzlies","Brandon Clarke",0,0,0,0,0,0
0,0,0,0,0,0,0,0,0,"00",0,0,0,0,0,0,1038017,"2023-12-28T00:00:00.000Z",8,FALSE,15,56677830,"F",15,15,"Memphis Grizzlies","GG Jackson",0,0,0,0,0,0
0,0,0,0,0,0,0,0,0,"00",0,0,0,0,0,0,1038017,"2023-12-28T00:00:00.000Z",8,FALSE,15,254,"G",15,15,"Memphis Grizzlies","Luke Kennard",0,0,0,0,0,0
0,0,0,0,0,0,0,0,0,"00",0,0,0,0,0,0,1038017,"2023-12-28T00:00:00.000Z",8,FALSE,15,38017728,"F",15,15,"Memphis Grizzlies","Jake LaRavia",0,0,0,0,0,0
0,0,0,0,0,0,0,0,0,"00",0,0,0,0,0,0,1038017,"2023-12-28T00:00:00.000Z",8,FALSE,15,401,"G",15,15,"Memphis Grizzlies","Derrick Rose",0,0,0,0,0,0
1,0,4,3,0,11,5,0,0,"24",1,0,10,5,0,6,1038018,"2023-12-28T00:00:00.000Z",10,FALSE,16,17553979,"F",10,10,"Golden State Warriors","Jonathan Kuminga",0,15,16,11,6,11.5
5,0,0,6,2,11,4,4,3,"25",0,2,13,0,2,0,1038018,"2023-12-28T00:00:00.000Z",10,FALSE,16,443,"G",10,10,"Golden State Warriors","Klay Thompson",2,13,18,18,5,26.5
0,1,2,0,0,2,2,3,1,"14",3,3,5,5,0,0,1038018,"2023-12-28T00:00:00.000Z",10,FALSE,16,282,"F",10,10,"Golden State Warriors","Kevon Looney",1,10,10,5,5,14
5,0,2,5,2,9,4,0,0,"28",1,2,10,3,0,1,1038018,"2023-12-28T00:00:00.000Z",10,FALSE,16,56677858,"G",10,10,"Golden State Warriors","Brandin Podziemski",0,13,18,15,8,20.1
6,1,4,8,2,15,3,6,5,"32",0,1,13,4,2,1,1038018,"2023-12-28T00:00:00.000Z",10,FALSE,16,115,"G",10,10,"Golden State Warriors","Stephen Curry",3,17,23,19,10,34.8
0,0,0,0,0,0,0,0,0,"00",0,0,0,0,0,0,1038018,"2023-12-28T00:00:00.000Z",10,FALSE,16,185,"F",10,10,"Golden State Warriors","Draymond Green",0,0,0,0,0,0
1,2,7,0,0,9,4,2,2,"26",4,1,10,11,0,1,1038018,"2023-12-28T00:00:00.000Z",10,FALSE,16,56677799,"F",10,10,"Golden State Warriors","Trayce Jackson-Davis",2,21,22,11,12,29.7
0,0,0,0,0,0,0,0,0,"02",0,1,0,0,0,0,1038018,"2023-12-28T00:00:00.000Z",10,FALSE,16,251,"G",10,10,"Golden State Warriors","Cory Joseph",0,0,0,0,0,0
0,2,2,2,0,8,4,3,3,"13",1,1,11,3,0,0,1038018,"2023-12-28T00:00:00.000Z",10,FALSE,16,17553992,"G",10,10,"Golden State Warriors","Moses Moody",2,14,14,11,3,20.6
4,0,4,4,1,6,3,2,2,"27",0,4,9,4,0,3,1038018,"2023-12-28T00:00:00.000Z",10,FALSE,16,367,"G",10,10,"Golden State Warriors","Chris Paul",0,13,17,13,8,16.8
0,0,0,0,0,0,0,0,0,"02",0,1,0,0,0,0,1038018,"2023-12-28T00:00:00.000Z",10,FALSE,16,45658838,"G",10,10,"Golden State Warriors","Lester Quinones",0,0,0,0,0,0
0,1,0,1,0,1,0,0,0,"02",0,0,0,0,0,0,1038018,"2023-12-28T00:00:00.000Z",10,FALSE,16,398,"G",10,10,"Golden State Warriors","Jerome Robinson",1,0,0,0,0,3
1,0,5,1,1,5,4,1,1,"19",1,1,10,6,0,0,1038018,"2023-12-28T00:00:00.000Z",10,FALSE,16,407,"F",10,10,"Golden State Warriors","Dario Saric",0,16,17,11,7,18.7
4,0,1,3,0,11,4,4,3,"26",1,2,11,2,0,1,1038018,"2023-12-28T00:00:00.000Z",10,FALSE,16,475,"F-G",10,10,"Golden State Warriors","Andrew Wiggins",0,13,17,15,6,18.4
0,0,0,0,0,0,0,0,0,"00",0,0,0,0,0,0,1038018,"2023-12-28T00:00:00.000Z",10,FALSE,16,17896070,"F",10,10,"Golden State Warriors","Usman Garuba",0,0,0,0,0,0
0,0,0,0,0,0,0,0,0,"00",0,0,0,0,0,0,1038018,"2023-12-28T00:00:00.000Z",10,FALSE,16,2189,"",10,10,"Golden State Warriors","Gary Payton II",0,0,0,0,0,0
0,0,0,0,0,0,0,0,0,"00",0,0,0,0,0,0,1038018,"2023-12-28T00:00:00.000Z",10,FALSE,16,57875092,"F",10,10,"Golden State Warriors","Gui Santos",0,0,0,0,0,0
0,0,0,2,1,3,1,0,0,"18",0,4,3,0,1,0,1038018,"2023-12-28T00:00:00.000Z",10,FALSE,16,3092,"",16,16,"Miami Heat","Haywood Highsmith",1,3,3,3,0,6
6,0,4,5,2,15,7,2,1,"39",1,2,17,5,1,2,1038018,"2023-12-28T00:00:00.000Z",10,FALSE,16,56677785,"G",16,16,"Miami Heat","Jaime Jaquez Jr.",1,22,28,23,11,33
4,0,9,0,0,13,7,4,3,"35",2,2,17,11,0,0,1038018,"2023-12-28T00:00:00.000Z",10,FALSE,16,4,"C-F",16,16,"Miami Heat","Bam Adebayo",0,28,32,21,15,36.2
2,0,7,7,3,18,10,4,3,"31",0,0,26,7,1,2,1038018,"2023-12-28T00:00:00.000Z",10,FALSE,16,666633,"G",16,16,"Miami Heat","Tyler Herro",1,33,35,28,9,38.4
3,0,0,2,0,6,3,2,1,"25",2,3,7,2,0,1,1038018,"2023-12-28T00:00:00.000Z",10,FALSE,16,3547257,"G",16,16,"Miami Heat","R.J. Hampton",0,9,12,10,5,12.9
0,0,0,0,0,0,0,0,0,"00",0,0,0,0,0,0,1038018,"2023-12-28T00:00:00.000Z",10,FALSE,16,74,"C",16,16,"Miami Heat","Thomas Bryant",0,0,0,0,0,0
0,0,5,5,2,14,7,2,2,"28",1,1,18,6,2,1,1038018,"2023-12-28T00:00:00.000Z",10,FALSE,16,38017734,"F",16,16,"Miami Heat","Jamal Cain",2,24,24,18,6,30.2
3,1,1,1,0,5,4,5,3,"20",2,3,11,3,1,0,1038018,"2023-12-28T00:00:00.000Z",10,FALSE,16,38017696,"F",16,16,"Miami Heat","Nikola Jovic",2,14,17,14,6,25.1
4,0,7,3,1,5,2,3,3,"13",0,1,8,7,0,1,1038018,"2023-12-28T00:00:00.000Z",10,FALSE,16,285,"F-C",16,16,"Miami Heat","Kevin Love",0,15,19,12,11,21.4
0,0,0,0,0,0,0,0,0,"00",0,0,0,0,0,0,1038018,"2023-12-28T00:00:00.000Z",10,FALSE,16,391,"G-F",16,16,"Miami Heat","Josh Richardson",0,0,0,0,0,0
4,0,1,6,1,11,2,0,0,"30",1,3,5,2,0,0,1038018,"2023-12-28T00:00:00.000Z",10,FALSE,16,397,"F",16,16,"Miami Heat","Duncan Robinson",0,7,11,9,6,13.4
0,0,0,0,0,1,1,0,0,"01",1,0,2,1,0,0,1038018,"2023-12-28T00:00:00.000Z",10,FALSE,16,38017736,"F",16,16,"Miami Heat","Cole Swider",0,3,3,2,1,3.2
0,0,0,0,0,0,0,0,0,"00",0,0,0,0,0,0,1038018,"2023-12-28T00:00:00.000Z",10,FALSE,16,79,"G-F",16,16,"Miami Heat","Jimmy Butler",0,0,0,0,0,0
0,0,0,0,0,0,0,0,0,"00",0,0,0,0,0,0,1038018,"2023-12-28T00:00:00.000Z",10,FALSE,16,286,"G",16,16,"Miami Heat","Kyle Lowry",0,0,0,0,0,0
0,0,0,0,0,0,0,0,0,"00",0,0,0,0,0,0,1038018,"2023-12-28T00:00:00.000Z",10,FALSE,16,666747,"F",16,16,"Miami Heat","Caleb Martin",0,0,0,0,0,0
0,0,0,0,0,0,0,0,0,"00",0,0,0,0,0,0,1038018,"2023-12-28T00:00:00.000Z",10,FALSE,16,39398582,"C",16,16,"Miami Heat","Orlando Robinson",0,0,0,0,0,0
0,0,0,0,0,0,0,0,0,"00",0,0,0,0,0,0,1038018,"2023-12-28T00:00:00.000Z",10,FALSE,16,19465585,"G",16,16,"Miami Heat","Dru Smith",0,0,0,0,0,0
0,0,4,1,0,5,0,2,1,"21",3,1,1,7,0,1,1038019,"2023-12-28T00:00:00.000Z",25,FALSE,27,56677850,"F",25,25,"Portland Trail Blazers","Toumani Camara",0,8,8,1,7,8.4
5,0,7,5,1,21,9,13,10,"41",3,4,29,10,0,4,1038019,"2023-12-28T00:00:00.000Z",25,FALSE,27,182,"F",25,25,"Portland Trail Blazers","Jerami Grant",0,39,44,34,15,44.5
0,0,2,0,0,6,2,0,0,"14",5,3,4,7,0,0,1038019,"2023-12-28T00:00:00.000Z",25,FALSE,27,666476,"C",25,25,"Portland Trail Blazers","Moses Brown",0,11,11,4,7,12.4
6,0,5,8,6,19,10,5,3,"37",1,1,29,6,1,1,1038019,"2023-12-28T00:00:00.000Z",25,FALSE,27,65,"G",25,25,"Portland Trail Blazers","Malcolm Brogdon",1,35,41,35,12,47.2
4,0,1,7,3,23,8,6,6,"36",2,5,25,3,1,6,1038019,"2023-12-28T00:00:00.000Z",25,FALSE,27,56677747,"G",25,25,"Portland Trail Blazers","Scoot Henderson",1,28,32,29,7,31.6
0,3,4,0,0,3,3,2,1,"14",5,3,7,9,0,0,1038019,"2023-12-28T00:00:00.000Z",25,FALSE,27,39613724,"C",25,25,"Portland Trail Blazers","Ibou Badji",3,16,16,7,9,26.8
0,0,2,4,0,8,0,0,0,"14",1,0,0,3,1,0,1038019,"2023-12-28T00:00:00.000Z",25,FALSE,27,3547289,"G",25,25,"Portland Trail Blazers","Skylar Mays",1,3,3,0,3,6.6
0,0,0,0,0,0,0,0,0,"00",0,0,0,0,0,0,1038019,"2023-12-28T00:00:00.000Z",25,FALSE,27,56783340,"C",25,25,"Portland Trail Blazers","Duop Reath",0,0,0,0,0,0
0,0,0,0,0,0,0,0,0,"00",0,0,0,0,0,0,1038019,"2023-12-28T00:00:00.000Z",25,FALSE,27,419,"G",25,25,"Portland Trail Blazers","Anfernee Simons",0,0,0,0,0,0
1,0,2,7,1,7,1,2,1,"28",0,1,4,2,2,0,1038019,"2023-12-28T00:00:00.000Z",25,FALSE,27,666923,"G-F",25,25,"Portland Trail Blazers","Matisse Thybulle",2,6,7,5,3,13.9
0,1,7,0,0,4,2,2,2,"30",2,4,6,9,1,1,1038019,"2023-12-28T00:00:00.000Z",25,FALSE,27,38017711,"F",25,25,"Portland Trail Blazers","Jabari Walker",2,15,15,6,9,21.8
0,0,0,0,0,0,0,0,0,"00",0,0,0,0,0,0,1038019,"2023-12-28T00:00:00.000Z",25,FALSE,27,22,"C",25,25,"Portland Trail Blazers","Deandre Ayton",0,0,0,0,0,0
0,0,0,0,0,0,0,0,0,"00",0,0,0,0,0,0,1038019,"2023-12-28T00:00:00.000Z",25,FALSE,27,47957121,"F",25,25,"Portland Trail Blazers","Justin Minaya",0,0,0,0,0,0
0,0,0,0,0,0,0,0,0,"00",0,0,0,0,0,0,1038019,"2023-12-28T00:00:00.000Z",25,FALSE,27,56677791,"F",25,25,"Portland Trail Blazers","Kris Murray",0,0,0,0,0,0
0,0,0,0,0,0,0,0,0,"00",0,0,0,0,0,0,1038019,"2023-12-28T00:00:00.000Z",25,FALSE,27,56677829,"G-F",25,25,"Portland Trail Blazers","Rayan Rupert",0,0,0,0,0,0
0,0,0,0,0,0,0,0,0,"00",0,0,0,0,0,0,1038019,"2023-12-28T00:00:00.000Z",25,FALSE,27,38017690,"G",25,25,"Portland Trail Blazers","Shaedon Sharpe",0,0,0,0,0,0
0,0,0,0,0,0,0,0,0,"00",0,0,0,0,0,0,1038019,"2023-12-28T00:00:00.000Z",25,FALSE,27,476,"C-F",25,25,"Portland Trail Blazers","Robert Williams III",0,0,0,0,0,0
0,0,1,4,0,5,0,0,0,"05",0,0,0,1,0,0,1038019,"2023-12-28T00:00:00.000Z",25,FALSE,27,17896120,"F",25,25,"Portland Trail Blazers","Ish Wainright",0,1,1,0,1,1.2
3,1,6,2,0,10,6,5,4,"31",1,4,16,7,0,2,1038019,"2023-12-28T00:00:00.000Z",25,FALSE,27,38017699,"F",27,27,"San Antonio Spurs","Jeremy Sochan",1,23,26,19,10,29.9
6,7,6,4,2,14,9,10,10,"24",0,0,30,6,0,1,1038019,"2023-12-28T00:00:00.000Z",25,FALSE,27,56677822,"F-C",27,27,"San Antonio Spurs","Victor Wembanyama",7,36,42,36,12,66.2
7,1,5,9,2,16,7,1,1,"35",0,0,17,5,4,1,1038019,"2023-12-28T00:00:00.000Z",25,FALSE,27,3547246,"G-F",27,27,"San Antonio Spurs","Devin Vassell",5,22,29,24,12,47.5
4,0,3,6,3,10,4,2,2,"28",2,5,13,5,1,2,1038019,"2023-12-28T00:00:00.000Z",25,FALSE,27,38017692,"F",27,27,"San Antonio Spurs","Malaki Branham",1,18,22,17,9,26
2,0,6,2,0,9,4,4,3,"17",1,6,11,7,0,1,1038019,"2023-12-28T00:00:00.000Z",25,FALSE,27,102,"F-C",27,27,"San Antonio Spurs","Zach Collins",0,18,20,13,9,21.4
2,0,3,6,1,11,4,0,0,"31",0,5,9,3,1,2,1038019,"2023-12-28T00:00:00.000Z",25,FALSE,27,666682,"F",27,27,"San Antonio Spurs","Keldon Johnson",1,12,14,11,5,16.6
6,0,2,2,0,6,2,4,4,"26",3,0,8,5,1,1,1038019,"2023-12-28T00:00:00.000Z",25,FALSE,27,3547274,"G",27,27,"San Antonio Spurs","Tre Jones",1,13,19,14,11,25
0,0,0,1,0,1,0,0,0,"01",0,0,0,0,0,0,1038019,"2023-12-28T00:00:00.000Z",25,FALSE,27,17896059,"F",27,27,"San Antonio Spurs","Sandro Mamukelashvili",0,0,0,0,0,0
1,0,1,3,2,4,3,0,0,"16",0,0,8,1,0,0,1038019,"2023-12-28T00:00:00.000Z",25,FALSE,27,305,"F",27,27,"San Antonio Spurs","Doug McDermott",0,9,10,9,2,10.7
2,0,2,0,0,3,2,0,0,"16",0,0,4,2,0,0,1038019,"2023-12-28T00:00:00.000Z",25,FALSE,27,359,"F",27,27,"San Antonio Spurs","Cedi Osman",0,6,8,6,4,9.4
0,0,0,0,0,0,0,0,0,"01",0,0,0,0,0,0,1038019,"2023-12-28T00:00:00.000Z",25,FALSE,27,38017693,"G",27,27,"San Antonio Spurs","Blake Wesley",0,0,0,0,0,0
0,0,0,0,0,0,0,0,0,"00",0,0,0,0,0,0,1038019,"2023-12-28T00:00:00.000Z",25,FALSE,27,38017730,"F",27,27,"San Antonio Spurs","Dominick Barlow",0,0,0,0,0,0
0,0,0,0,0,0,0,0,0,"00",0,0,0,0,0,0,1038019,"2023-12-28T00:00:00.000Z",25,FALSE,27,17895854,"G",27,27,"San Antonio Spurs","Charles Bassey",0,0,0,0,0,0
0,0,0,0,0,0,0,0,0,"00",0,0,0,0,0,0,1038019,"2023-12-28T00:00:00.000Z",25,FALSE,27,56677865,"C",27,27,"San Antonio Spurs","Charles Bediako",0,0,0,0,0,0
0,0,0,0,0,0,0,0,0,"00",0,0,0,0,0,0,1038019,"2023-12-28T00:00:00.000Z",25,FALSE,27,56677817,"G",27,27,"San Antonio Spurs","Sidy Cissoko",0,0,0,0,0,0
0,0,0,0,0,0,0,0,0,"00",0,0,0,0,0,0,1038019,"2023-12-28T00:00:00.000Z",25,FALSE,27,17896049,"G",3,27,"San Antonio Spurs","David Duke Jr.",0,0,0,0,0,0
0,0,0,0,0,0,0,0,0,"00",0,0,0,0,0,0,1038019,"2023-12-28T00:00:00.000Z",25,FALSE,27,180,"G",27,27,"San Antonio Spurs","Devonte' Graham",0,0,0,0,0,0
0,1,1,1,0,1,0,2,2,"14",0,0,2,1,2,1,1038019,"2023-12-28T00:00:00.000Z",25,FALSE,27,38017649,"F",27,27,"San Antonio Spurs","Julian Champagnie",3,3,3,2,1,11.2
1,0,4,1,0,12,7,3,3,"28",0,2,17,4,1,0,1038020,"2023-12-28T00:00:00.000Z",14,FALSE,4,666609,"F",14,14,"Los Angeles Lakers","Rui Hachimura",1,21,22,18,5,26.3
3,0,2,2,1,8,3,0,0,"24",2,1,7,4,2,0,1038020,"2023-12-28T00:00:00.000Z",14,FALSE,4,457,"F",14,14,"Los Angeles Lakers","Jarred Vanderbilt",2,11,14,10,7,22.3
2,4,6,1,0,19,11,4,4,"26",2,4,26,8,2,2,1038020,"2023-12-28T00:00:00.000Z",14,FALSE,4,117,"F-C",14,14,"Los Angeles Lakers","Anthony Davis",6,34,36,28,10,54.6
3,0,3,4,1,7,1,0,0,"23",0,2,3,3,3,1,1038020,"2023-12-28T00:00:00.000Z",14,FALSE,4,383,"F",14,14,"Los Angeles Lakers","Taurean Prince",3,6,9,6,6,19.1
11,0,4,5,2,13,7,1,1,"25",0,0,17,4,0,2,1038020,"2023-12-28T00:00:00.000Z",14,FALSE,4,237,"F",14,14,"Los Angeles Lakers","LeBron James",0,21,32,28,15,36.3
3,2,7,3,2,4,3,2,2,"24",0,2,10,7,1,1,1038020,"2023-12-28T00:00:00.000Z",14,FALSE,4,38017697,"G",14,14,"Los Angeles Lakers","Max Christie",3,17,20,13,10,30.9
0,0,1,0,0,7,5,0,0,"07",1,0,10,2,0,0,1038020,"2023-12-28T00:00:00.000Z",14,FALSE,4,666626,"C",14,14,"Los Angeles Lakers","Jaxson Hayes",0,12,12,10,2,12.4
1,0,0,1,0,5,1,0,0,"07",0,1,2,0,1,1,1038020,"2023-12-28T00:00:00.000Z",14,FALSE,4,56677835,"G",14,14,"Los Angeles Lakers","Jalen Hood-Schifino",1,2,3,3,1,5.5
0,0,0,0,0,0,0,0,0,"00",0,0,0,0,0,0,1038020,"2023-12-28T00:00:00.000Z",14,FALSE,4,56677836,"F",14,14,"Los Angeles Lakers","Maxwell Lewis",0,0,0,0,0,0
4,0,2,3,2,8,6,2,2,"24",0,4,16,2,1,1,1038020,"2023-12-28T00:00:00.000Z",14,FALSE,4,17553995,"G",14,14,"Los Angeles Lakers","Austin Reaves",1,18,22,20,6,26.4
9,0,3,7,4,10,5,2,2,"29",0,3,16,3,0,1,1038020,"2023-12-28T00:00:00.000Z",14,FALSE,4,405,"G",14,14,"Los Angeles Lakers","D'Angelo Russell",0,19,28,25,12,32.1
4,1,5,3,3,4,3,0,0,"23",0,2,9,5,0,2,1038020,"2023-12-28T00:00:00.000Z",14,FALSE,4,486,"F",14,14,"Los Angeles Lakers","Christian Wood",1,14,18,13,9,22
0,0,0,0,0,0,0,0,0,"00",0,0,0,0,0,0,1038020,"2023-12-28T00:00:00.000Z",14,FALSE,4,56677738,"C",14,14,"Los Angeles Lakers","Colin Castleton",0,0,0,0,0,0
0,0,0,0,0,0,0,0,0,"00",0,0,0,0,0,0,1038020,"2023-12-28T00:00:00.000Z",14,FALSE,4,56677867,"F",14,14,"Los Angeles Lakers","Alex Fudge",0,0,0,0,0,0
0,0,0,0,0,0,0,0,0,"00",0,0,0,0,0,0,1038020,"2023-12-28T00:00:00.000Z",14,FALSE,4,56677868,"G",14,14,"Los Angeles Lakers","D'Moi Hodge",0,0,0,0,0,0
0,0,0,0,0,0,0,0,0,"00",0,0,0,0,0,0,1038020,"2023-12-28T00:00:00.000Z",14,FALSE,4,666860,"F-G",14,14,"Los Angeles Lakers","Cameron Reddish",0,0,0,0,0,0
0,0,0,0,0,0,0,0,0,"00",0,0,0,0,0,0,1038020,"2023-12-28T00:00:00.000Z",14,FALSE,4,1603383,"G",14,14,"Los Angeles Lakers","Gabe Vincent",0,0,0,0,0,0
1,0,2,4,3,6,3,2,1,"22",0,3,10,2,0,1,1038020,"2023-12-28T00:00:00.000Z",14,FALSE,4,38017708,"G",4,4,"Charlotte Hornets","Bryce McGowens",0,12,13,11,3,12.9
5,1,4,10,4,20,7,2,2,"33",1,3,20,5,0,3,1038020,"2023-12-28T00:00:00.000Z",14,FALSE,4,62,"F",4,4,"Charlotte Hornets","Miles Bridges",1,25,30,25,10,33.5
1,2,7,0,0,5,5,3,1,"26",3,3,11,10,1,0,1038020,"2023-12-28T00:00:00.000Z",14,FALSE,4,3547282,"C",4,4,"Charlotte Hornets","Nick Richards",3,21,22,12,11,33.5
2,1,0,5,3,9,5,4,4,"29",1,0,17,1,1,3,1038020,"2023-12-28T00:00:00.000Z",14,FALSE,4,56677823,"F",4,4,"Charlotte Hornets","Brandon Miller",2,18,20,19,3,24.2
8,0,6,3,1,14,5,9,7,"32",0,0,18,6,1,4,1038020,"2023-12-28T00:00:00.000Z",14,FALSE,4,403,"G",4,4,"Charlotte Hornets","Terry Rozier",1,24,32,26,14,36.2
2,0,2,3,0,7,2,4,1,"20",2,1,5,4,1,2,1038020,"2023-12-28T00:00:00.000Z",14,FALSE,4,666748,"F",4,4,"Charlotte Hornets","Cody Martin",1,9,11,7,6,13.8
0,0,5,4,0,11,4,2,1,"25",1,1,9,6,0,3,1038020,"2023-12-28T00:00:00.000Z",14,FALSE,4,666950,"F",4,4,"Charlotte Hornets","P.J. Washington",0,15,15,9,6,13.2
4,0,3,0,0,4,3,0,0,"14",0,1,6,3,1,1,1038020,"2023-12-28T00:00:00.000Z",14,FALSE,4,422,"G",4,4,"Charlotte Hornets","Ish Smith",1,9,13,10,7,17.6
1,0,2,1,1,3,2,0,0,"06",0,0,5,2,0,0,1038020,"2023-12-28T00:00:00.000Z",14,FALSE,4,17896037,"G",4,4,"Charlotte Hornets","James Bouknight",0,7,8,6,3,8.9
0,0,1,0,0,1,1,2,0,"09",0,1,2,1,0,0,1038020,"2023-12-28T00:00:00.000Z",14,FALSE,4,NA,NA,NA,4,"Charlotte Hornets","NA NA",0,3,3,2,1,3.2
4,1,3,2,2,4,2,0,0,"18",0,1,6,3,0,2,1038020,"2023-12-28T00:00:00.000Z",14,FALSE,4,56677846,"G",4,4,"Charlotte Hornets","Nick Smith Jr.",1,9,13,10,7,16.6
1,0,0,1,1,1,1,0,0,"06",0,0,3,0,0,0,1038020,"2023-12-28T00:00:00.000Z",14,FALSE,4,18678001,"F",4,4,"Charlotte Hornets","JT Thor",0,3,4,4,1,4.5
0,0,0,0,0,0,0,0,0,"00",0,0,0,0,0,0,1038020,"2023-12-28T00:00:00.000Z",14,FALSE,4,56677848,"G",4,4,"Charlotte Hornets","Amari Bailey",0,0,0,0,0,0
0,0,0,0,0,0,0,0,0,"00",0,0,0,0,0,0,1038020,"2023-12-28T00:00:00.000Z",14,FALSE,4,204,"F",4,4,"Charlotte Hornets","Gordon Hayward",0,0,0,0,0,0
0,0,0,0,0,0,0,0,0,"00",0,0,0,0,0,0,1038020,"2023-12-28T00:00:00.000Z",14,FALSE,4,347,"G",4,4,"Charlotte Hornets","Frank Ntilikina",0,0,0,0,0,0
0,0,0,0,0,0,0,0,0,"00",0,0,0,0,0,0,1038020,"2023-12-28T00:00:00.000Z",14,FALSE,4,38017698,"C",4,4,"Charlotte Hornets","Mark Williams",0,0,0,0,0,0
0,0,0,0,0,0,0,0,0,"00",0,0,0,0,0,0,1038020,"2023-12-28T00:00:00.000Z",14,FALSE,4,3547239,"G",4,4,"Charlotte Hornets","LaMelo Ball",0,0,0,0,0,0
0,0,0,0,0,0,0,0,0,"00",0,0,0,0,0,0,1038020,"2023-12-28T00:00:00.000Z",14,FALSE,4,56677866,"F",4,4,"Charlotte Hornets","Leaky Black",0,0,0,0,0,0
4,0,2,8,3,13,4,4,4,"32",4,2,15,6,1,1,1038023,"2023-12-29T00:00:00.000Z",1,FALSE,26,3547256,"F",1,1,"Atlanta Hawks","Saddiq Bey",1,21,25,19,10,30.2
4,1,13,4,1,12,5,6,5,"35",2,2,16,15,0,4,1038023,"2023-12-29T00:00:00.000Z",1,FALSE,26,17896040,"F",1,1,"Atlanta Hawks","Jalen Johnson",1,31,35,20,19,39
3,2,6,0,0,7,5,4,2,"28",6,1,12,12,1,2,1038023,"2023-12-29T00:00:00.000Z",1,FALSE,26,83,"C",1,1,"Atlanta Hawks","Clint Capela",3,24,27,15,15,37.9
3,0,5,8,4,20,7,0,0,"37",1,3,18,6,1,3,1038023,"2023-12-29T00:00:00.000Z",1,FALSE,26,334,"G",1,1,"Atlanta Hawks","Dejounte Murray",1,24,27,21,9,29.7
9,0,2,10,3,18,7,7,7,"39",1,4,24,3,4,4,1038023,"2023-12-29T00:00:00.000Z",1,FALSE,26,490,"G",1,1,"Atlanta Hawks","Trae Young",4,27,36,33,12,49.1
5,0,2,10,2,14,4,2,2,"27",2,1,12,4,0,1,1038023,"2023-12-29T00:00:00.000Z",1,FALSE,26,53,"G",1,1,"Atlanta Hawks","Bogdan Bogdanovic",0,16,21,17,9,23.3
0,0,1,2,1,2,1,0,0,"08",0,1,3,1,1,0,1038023,"2023-12-29T00:00:00.000Z",1,FALSE,26,666754,"G",1,1,"Atlanta Hawks","Garrison Mathews",1,4,4,3,1,7.2
0,0,0,1,1,1,1,0,0,"11",0,0,3,0,0,0,1038023,"2023-12-29T00:00:00.000Z",1,FALSE,26,319,"G",1,1,"Atlanta Hawks","Patty Mills",0,3,3,3,0,3
1,1,2,0,0,6,3,2,1,"23",1,2,7,3,1,0,1038023,"2023-12-29T00:00:00.000Z",1,FALSE,26,3547244,"F-C",1,1,"Atlanta Hawks","Onyeka Okongwu",2,10,11,8,4,18.1
1,0,3,3,1,6,3,0,0,"10",0,0,7,3,0,0,1038023,"2023-12-29T00:00:00.000Z",1,FALSE,26,221,"G",26,26,"Sacramento Kings","Kevin Huerter",0,10,11,8,4,12.1
8,0,5,16,8,20,10,7,3,"41",1,3,31,6,4,2,1038023,"2023-12-29T00:00:00.000Z",1,FALSE,26,161,"G",26,26,"Sacramento Kings","De'Aaron Fox",4,37,45,39,14,60.2
4,0,0,3,1,5,2,0,0,"24",0,1,5,0,1,1,1038023,"2023-12-29T00:00:00.000Z",1,FALSE,26,17896030,"G",26,26,"Sacramento Kings","Chris Duarte",1,5,9,9,4,13
0,0,0,0,0,0,0,0,0,"00",0,0,0,0,0,0,1038023,"2023-12-29T00:00:00.000Z",1,FALSE,26,17896044,"F",26,26,"Sacramento Kings","Kessler Edwards",0,0,0,0,0,0
8,1,4,5,2,10,6,1,1,"31",0,3,15,4,1,6,1038023,"2023-12-29T00:00:00.000Z",1,FALSE,26,324,"G",26,26,"Sacramento Kings","Malik Monk",2,19,27,23,12,31.8
1,0,6,9,4,12,7,1,1,"25",0,3,19,6,0,2,1038023,"2023-12-29T00:00:00.000Z",1,FALSE,26,290,"F",26,26,"Sacramento Kings","Trey Lyles",0,25,26,20,7,25.7
4,0,2,0,0,2,1,0,0,"13",1,0,2,3,0,0,1038023,"2023-12-29T00:00:00.000Z",1,FALSE,26,273,"C",26,26,"Sacramento Kings","Alex Len",0,5,9,6,7,11.6
2,0,0,1,0,3,1,0,0,"13",1,2,2,1,0,0,1038023,"2023-12-29T00:00:00.000Z",1,FALSE,26,17553994,"G",26,26,"Sacramento Kings","Davion Mitchell",0,3,5,4,3,6.2
0,0,0,0,0,0,0,0,0,"00",0,0,0,0,0,0,1038023,"2023-12-29T00:00:00.000Z",1,FALSE,26,38017714,"G",26,26,"Sacramento Kings","Keon Ellis",0,0,0,0,0,0
0,0,0,0,0,0,0,0,0,"00",0,0,0,0,0,0,1038023,"2023-12-29T00:00:00.000Z",1,FALSE,26,666564,"F",1,1,"Atlanta Hawks","Bruno Fernando",0,0,0,0,0,0
0,0,0,0,0,0,0,0,0,"00",0,0,0,0,0,0,1038023,"2023-12-29T00:00:00.000Z",1,FALSE,26,3547297,"G",1,1,"Atlanta Hawks","Trent Forrest",0,0,0,0,0,0
0,0,0,0,0,0,0,0,0,"00",0,0,0,0,0,0,1038023,"2023-12-29T00:00:00.000Z",1,FALSE,26,38017689,"F",1,1,"Atlanta Hawks","AJ Griffin",0,0,0,0,0,0
0,0,0,0,0,0,0,0,0,"00",0,0,0,0,0,0,1038023,"2023-12-29T00:00:00.000Z",1,FALSE,26,301,"G-F",1,1,"Atlanta Hawks","Wesley Matthews",0,0,0,0,0,0
0,0,0,0,0,0,0,0,0,"00",0,0,0,0,0,0,1038023,"2023-12-29T00:00:00.000Z",1,FALSE,26,56677838,"G",1,1,"Atlanta Hawks","Kobe Bufkin",0,0,0,0,0,0
0,0,0,0,0,0,0,0,0,"00",0,0,0,0,0,0,1038023,"2023-12-29T00:00:00.000Z",1,FALSE,26,56677806,"F",1,1,"Atlanta Hawks","Mouhamed Gueye",0,0,0,0,0,0
0,0,0,0,0,0,0,0,0,"00",0,0,0,0,0,0,1038023,"2023-12-29T00:00:00.000Z",1,FALSE,26,666656,"F",1,1,"Atlanta Hawks","De'Andre Hunter",0,0,0,0,0,0
0,0,0,0,0,0,0,0,0,"00",0,0,0,0,0,0,1038023,"2023-12-29T00:00:00.000Z",1,FALSE,26,4197387,"G",1,1,"Atlanta Hawks","Vit Krejci",0,0,0,0,0,0
0,0,0,0,0,0,0,0,0,"00",0,0,0,0,0,0,1038023,"2023-12-29T00:00:00.000Z",1,FALSE,26,56677855,"G",1,1,"Atlanta Hawks","Seth Lundy",0,0,0,0,0,0
0,0,0,2,0,2,0,2,2,"12",0,1,2,0,0,0,1038023,"2023-12-29T00:00:00.000Z",1,FALSE,26,30,"F",26,26,"Sacramento Kings","Harrison Barnes",0,2,2,2,0,2
0,2,5,6,1,12,4,0,0,"36",0,5,9,5,3,0,1038023,"2023-12-29T00:00:00.000Z",1,FALSE,26,38017688,"F",26,26,"Sacramento Kings","Keegan Murray",5,14,14,9,5,30
7,0,8,0,0,17,12,4,1,"35",2,2,25,10,0,1,1038023,"2023-12-29T00:00:00.000Z",1,FALSE,26,406,"F",26,26,"Sacramento Kings","Domantas Sabonis",0,35,42,32,17,46.5
0,0,0,0,0,0,0,0,0,"00",0,0,0,0,0,0,1038023,"2023-12-29T00:00:00.000Z",1,FALSE,26,306,"C",26,26,"Sacramento Kings","JaVale McGee",0,0,0,0,0,0
0,0,0,0,0,0,0,0,0,"00",0,0,0,0,0,0,1038023,"2023-12-29T00:00:00.000Z",1,FALSE,26,666925,"F",29,26,"Sacramento Kings","Juan Toscano-Anderson",0,0,0,0,0,0
0,0,0,0,0,0,0,0,0,"00",0,0,0,0,0,0,1038023,"2023-12-29T00:00:00.000Z",1,FALSE,26,4197162,"F",26,26,"Sacramento Kings","Aleksandar Vezenkov",0,0,0,0,0,0
0,0,0,0,0,0,0,0,0,"00",0,0,0,0,0,0,1038023,"2023-12-29T00:00:00.000Z",1,FALSE,26,17895990,"G",26,26,"Sacramento Kings","Jordan Ford",0,0,0,0,0,0
0,0,0,0,0,0,0,0,0,"00",0,0,0,0,0,0,1038023,"2023-12-29T00:00:00.000Z",1,FALSE,26,56677845,"G",26,26,"Sacramento Kings","Colby Jones",0,0,0,0,0,0
0,0,0,0,0,0,0,0,0,"00",0,0,0,0,0,0,1038023,"2023-12-29T00:00:00.000Z",1,FALSE,26,56677862,"F",26,26,"Sacramento Kings","Jalen Slawson",0,0,0,0,0,0
6,1,11,5,3,18,9,4,0,"34",2,2,21,13,1,1,1038022,"2023-12-29T00:00:00.000Z",30,FALSE,3,3547242,"F",30,30,"Washington Wizards","Deni Avdija",2,34,40,27,19,50.6
2,1,7,10,4,22,11,0,0,"31",1,1,26,8,0,2,1038022,"2023-12-29T00:00:00.000Z",30,FALSE,3,265,"F",30,30,"Washington Wizards","Kyle Kuzma",1,34,36,28,10,39.6
0,0,4,0,0,4,1,2,2,"17",1,4,4,5,1,1,1038022,"2023-12-29T00:00:00.000Z",30,FALSE,3,666577,"F",30,30,"Washington Wizards","Daniel Gafford",1,9,9,4,5,12
5,0,0,4,1,6,2,0,0,"25",0,4,5,0,0,1,1038022,"2023-12-29T00:00:00.000Z",30,FALSE,3,666848,"G",30,30,"Washington Wizards","Jordan Poole",0,5,10,10,5,11.5
6,0,3,0,0,9,6,0,0,"31",1,0,12,4,0,0,1038022,"2023-12-29T00:00:00.000Z",30,FALSE,3,249,"G",30,30,"Washington Wizards","Tyus Jones",0,16,22,18,10,25.8
0,0,0,0,0,0,0,0,0,"00",0,0,0,0,0,0,1038022,"2023-12-29T00:00:00.000Z",30,FALSE,3,38017704,"F",30,30,"Washington Wizards","Patrick Baldwin Jr.",0,0,0,0,0,0
0,0,0,0,0,0,0,0,0,"00",0,0,0,0,0,0,1038022,"2023-12-29T00:00:00.000Z",30,FALSE,3,18677954,"G",30,30,"Washington Wizards","Jared Butler",0,0,0,0,0,0
2,0,4,0,0,3,2,0,0,"19",2,3,4,6,0,1,1038022,"2023-12-29T00:00:00.000Z",30,FALSE,3,56677844,"G",30,30,"Washington Wizards","Bilal Coulibaly",0,10,12,6,8,13.2
0,0,0,0,0,0,0,0,0,"00",0,0,0,0,0,0,1038022,"2023-12-29T00:00:00.000Z",30,FALSE,3,38017687,"G",30,30,"Washington Wizards","Johnny Davis",0,0,0,0,0,0
3,0,4,0,0,7,5,0,0,"18",5,3,10,9,0,2,1038022,"2023-12-29T00:00:00.000Z",30,FALSE,3,17896038,"C",3,3,"Brooklyn Nets","Day'Ron Sharpe",0,19,22,13,12,23.3
3,0,2,1,0,6,2,2,1,"20",0,3,5,2,2,0,1038022,"2023-12-29T00:00:00.000Z",30,FALSE,3,421,"G",3,3,"Brooklyn Nets","Dennis Smith Jr.",2,7,10,8,5,17.9
3,0,1,1,0,15,6,6,3,"24",0,0,15,1,0,1,1038022,"2023-12-29T00:00:00.000Z",30,FALSE,3,17896048,"G",3,3,"Brooklyn Nets","Cam Thomas",0,16,19,18,4,19.7
0,0,0,0,0,0,0,0,0,"00",0,0,0,0,0,0,1038022,"2023-12-29T00:00:00.000Z",30,FALSE,3,464,"G",3,3,"Brooklyn Nets","Lonnie Walker IV",0,0,0,0,0,0
0,0,0,0,0,0,0,0,0,"00",0,0,0,0,0,0,1038022,"2023-12-29T00:00:00.000Z",30,FALSE,3,17896058,"F",3,3,"Brooklyn Nets","Trendon Watford",0,0,0,0,0,0
0,0,0,0,0,0,0,0,0,"00",0,0,0,0,0,0,1038022,"2023-12-29T00:00:00.000Z",30,FALSE,3,9051997,"G",3,3,"Brooklyn Nets","Armoni Brooks",0,0,0,0,0,0
0,0,0,0,0,0,0,0,0,"00",0,0,0,0,0,0,1038022,"2023-12-29T00:00:00.000Z",30,FALSE,3,56677843,"F",3,3,"Brooklyn Nets","Noah Clowney",0,0,0,0,0,0
0,0,0,0,0,0,0,0,0,"00",0,0,0,0,0,0,1038022,"2023-12-29T00:00:00.000Z",30,FALSE,3,17896041,"G",3,3,"Brooklyn Nets","Keon Johnson",0,0,0,0,0,0
0,0,0,0,0,0,0,0,0,"00",0,0,0,0,0,0,1038022,"2023-12-29T00:00:00.000Z",30,FALSE,3,417,"G-F",3,3,"Brooklyn Nets","Ben Simmons",0,0,0,0,0,0
0,0,0,0,0,0,0,0,0,"00",0,0,0,0,0,0,1038022,"2023-12-29T00:00:00.000Z",30,FALSE,3,56677841,"F",3,3,"Brooklyn Nets","Dariq Whitehead",0,0,0,0,0,0
0,0,0,0,0,0,0,0,0,"00",0,0,0,0,0,0,1038022,"2023-12-29T00:00:00.000Z",30,FALSE,3,3547302,"F",30,30,"Washington Wizards","Anthony Gill",0,0,0,0,0,0
0,0,0,7,3,10,6,0,0,"17",0,2,15,0,0,0,1038022,"2023-12-29T00:00:00.000Z",30,FALSE,3,17896045,"F",30,30,"Washington Wizards","Corey Kispert",0,15,15,15,0,15
3,2,3,7,3,9,4,0,0,"31",0,3,11,3,0,0,1038022,"2023-12-29T00:00:00.000Z",30,FALSE,3,337,"F-C",30,30,"Washington Wizards","Mike Muscala",2,14,17,14,6,25.1
0,0,0,0,0,0,0,0,0,"00",0,0,0,0,0,0,1038022,"2023-12-29T00:00:00.000Z",30,FALSE,3,17896106,"F",30,30,"Washington Wizards","Eugene Omoruyi",0,0,0,0,0,0
2,0,1,4,1,7,3,1,1,"18",0,0,8,1,1,0,1038022,"2023-12-29T00:00:00.000Z",30,FALSE,3,414,"G",30,30,"Washington Wizards","Landry Shamet",1,9,11,10,3,15.2
2,1,2,1,0,3,2,0,0,"17",1,0,4,3,2,0,1038022,"2023-12-29T00:00:00.000Z",30,FALSE,3,487,"G",30,30,"Washington Wizards","Delon Wright",3,7,9,6,5,19.6
0,0,0,0,0,0,0,0,0,"00",0,0,0,0,0,0,1038022,"2023-12-29T00:00:00.000Z",30,FALSE,3,NA,NA,NA,30,"Washington Wizards","NA NA",0,0,0,0,0,0
0,0,0,0,0,0,0,0,0,"00",0,0,0,0,0,0,1038022,"2023-12-29T00:00:00.000Z",30,FALSE,3,167,"F",30,30,"Washington Wizards","Danilo Gallinari",0,0,0,0,0,0
0,0,0,0,0,0,0,0,0,"00",0,0,0,0,0,0,1038022,"2023-12-29T00:00:00.000Z",30,FALSE,3,38017712,"G",30,30,"Washington Wizards","Ryan Rollins",0,0,0,0,0,0
3,0,6,5,3,11,6,1,1,"33",1,1,16,7,0,1,1038022,"2023-12-29T00:00:00.000Z",30,FALSE,3,666679,"F",3,3,"Brooklyn Nets","Cameron Johnson",0,23,26,19,10,27.9
1,0,2,3,0,7,2,0,0,"33",4,2,4,6,1,0,1038022,"2023-12-29T00:00:00.000Z",30,FALSE,3,158,"F",3,3,"Brooklyn Nets","Dorian Finney-Smith",1,10,11,5,7,15.7
2,3,8,0,0,10,4,5,3,"30",4,0,11,12,0,1,1038022,"2023-12-29T00:00:00.000Z",30,FALSE,3,666508,"F-C",3,3,"Brooklyn Nets","Nicolas Claxton",3,23,25,13,14,36.4
1,1,5,6,2,14,6,7,5,"36",0,2,19,5,1,2,1038022,"2023-12-29T00:00:00.000Z",30,FALSE,3,61,"F",3,3,"Brooklyn Nets","Mikal Bridges",2,24,25,20,6,30.5
6,0,6,10,3,16,5,6,4,"28",2,2,17,8,1,1,1038022,"2023-12-29T00:00:00.000Z",30,FALSE,3,130,"G",3,3,"Brooklyn Nets","Spencer Dinwiddie",1,25,31,23,14,37.6
0,0,0,0,0,0,0,0,0,"00",0,0,0,0,0,0,1038022,"2023-12-29T00:00:00.000Z",30,FALSE,3,174,"F-C",3,3,"Brooklyn Nets","Harry Giles III",0,0,0,0,0,0
2,0,2,2,1,4,3,0,0,"18",1,0,7,3,0,2,1038022,"2023-12-29T00:00:00.000Z",30,FALSE,3,351,"F",3,3,"Brooklyn Nets","Royce O'Neale",0,10,12,9,5,11.6
0,0,0,0,0,0,0,0,0,"00",0,0,0,0,0,0,1038022,"2023-12-29T00:00:00.000Z",30,FALSE,3,56677722,"F",3,3,"Brooklyn Nets","Jalen Wilson",0,0,0,0,0,0
6,0,9,6,5,16,11,5,4,"41",1,4,31,10,0,7,1038024,"2023-12-29T00:00:00.000Z",2,FALSE,28,70,"G",2,2,"Boston Celtics","Jaylen Brown",0,41,47,37,16,45
1,1,9,7,3,7,3,0,0,"34",0,2,9,9,0,0,1038024,"2023-12-29T00:00:00.000Z",2,FALSE,28,17896060,"F",2,2,"Boston Celtics","Sam Hauser",1,18,19,10,10,24.3
3,3,3,0,0,11,9,2,2,"33",5,3,20,8,0,1,1038024,"2023-12-29T00:00:00.000Z",2,FALSE,28,261,"F-C",2,2,"Boston Celtics","Luke Kornet",3,28,31,23,11,42.1
7,2,4,10,2,19,5,9,9,"36",1,2,21,5,3,3,1038024,"2023-12-29T00:00:00.000Z",2,FALSE,28,473,"G",2,2,"Boston Celtics","Derrick White",5,26,33,28,12,49.5
3,0,2,5,3,15,5,4,2,"32",0,1,15,2,0,1,1038024,"2023-12-29T00:00:00.000Z",2,FALSE,28,214,"G",2,2,"Boston Celtics","Jrue Holiday",0,17,20,18,5,20.9
0,0,0,0,0,1,1,0,0,"02",0,0,2,0,0,1,1038024,"2023-12-29T00:00:00.000Z",2,FALSE,28,17896094,"G",2,2,"Boston Celtics","Dalano Banton",0,2,2,2,0,1
1,0,5,1,0,3,1,0,0,"15",2,0,2,7,0,1,1038024,"2023-12-29T00:00:00.000Z",2,FALSE,28,666468,"F",2,2,"Boston Celtics","Oshae Brissett",0,9,10,3,8,10.9
1,0,1,2,1,3,2,0,0,"07",0,2,5,1,0,0,1038024,"2023-12-29T00:00:00.000Z",2,FALSE,28,338,"G",2,2,"Boston Celtics","Svi Mykhailiuk",0,6,7,6,2,7.7
6,0,2,8,3,10,3,0,0,"25",3,3,9,5,0,2,1038024,"2023-12-29T00:00:00.000Z",2,FALSE,28,3547276,"G",2,2,"Boston Celtics","Payton Pritchard",0,14,20,15,11,22
1,0,4,0,0,3,3,0,0,"15",1,0,6,5,0,0,1038024,"2023-12-29T00:00:00.000Z",2,FALSE,28,17553967,"C",2,2,"Boston Celtics","Neemias Queta",0,11,12,7,6,13.5
0,0,0,0,0,0,0,0,0,"00",0,0,0,0,0,0,1038024,"2023-12-29T00:00:00.000Z",2,FALSE,28,3547279,"F",2,2,"Boston Celtics","Lamar Stevens",0,0,0,0,0,0
0,0,0,0,0,0,0,0,0,"00",0,0,0,0,0,0,1038024,"2023-12-29T00:00:00.000Z",2,FALSE,28,434,"F",2,2,"Boston Celtics","Jayson Tatum",0,0,0,0,0,0
0,0,0,0,0,0,0,0,0,"00",0,0,0,0,0,0,1038024,"2023-12-29T00:00:00.000Z",2,FALSE,28,38017707,"G",2,2,"Boston Celtics","JD Davison",0,0,0,0,0,0
0,0,0,0,0,0,0,0,0,"00",0,0,0,0,0,0,1038024,"2023-12-29T00:00:00.000Z",2,FALSE,28,219,"C-F",2,2,"Boston Celtics","Al Horford",0,0,0,0,0,0
0,0,0,0,0,0,0,0,0,"00",0,0,0,0,0,0,1038024,"2023-12-29T00:00:00.000Z",2,FALSE,28,NA,NA,NA,2,"Boston Celtics","NA NA",0,0,0,0,0,0
0,0,0,0,0,0,0,0,0,"00",0,0,0,0,0,0,1038024,"2023-12-29T00:00:00.000Z",2,FALSE,28,378,"F-C",2,2,"Boston Celtics","Kristaps Porzingis",0,0,0,0,0,0
0,0,0,0,0,0,0,0,0,"00",0,0,0,0,0,0,1038024,"2023-12-29T00:00:00.000Z",2,FALSE,28,56677864,"G",2,2,"Boston Celtics","Jordan Walsh",0,0,0,0,0,0
2,0,2,4,2,8,5,0,0,"37",0,1,12,2,2,1,1038024,"2023-12-29T00:00:00.000Z",2,FALSE,28,18,"F",28,28,"Toronto Raptors","OG Anunoby",2,14,16,14,4,22.4
5,0,5,5,2,18,10,8,5,"41",0,1,27,5,2,1,1038024,"2023-12-29T00:00:00.000Z",2,FALSE,28,416,"F",28,28,"Toronto Raptors","Pascal Siakam",2,32,37,32,10,45.5
3,2,6,0,0,8,5,2,2,"22",4,3,12,10,0,0,1038024,"2023-12-29T00:00:00.000Z",2,FALSE,28,373,"C",28,28,"Toronto Raptors","Jakob Poeltl",2,22,25,15,13,34.5
1,0,4,4,1,10,2,2,1,"29",0,0,6,4,2,0,1038024,"2023-12-29T00:00:00.000Z",2,FALSE,28,3089,"",28,28,"Toronto Raptors","Gary Trent Jr.",2,10,11,7,5,18.3
5,3,7,15,7,24,10,4,3,"38",3,2,30,10,1,2,1038024,"2023-12-29T00:00:00.000Z",2,FALSE,28,17896055,"G-F",28,28,"Toronto Raptors","Scottie Barnes",4,40,45,35,15,59.5
0,0,2,0,0,1,0,0,0,"02",0,0,0,2,0,0,1038024,"2023-12-29T00:00:00.000Z",2,FALSE,28,3547249,"F",28,28,"Toronto Raptors","Precious Achiuwa",0,2,2,0,2,2.4
0,0,3,3,1,3,1,0,0,"07",0,1,3,3,0,0,1038024,"2023-12-29T00:00:00.000Z",2,FALSE,28,58,"F",28,28,"Toronto Raptors","Chris Boucher",0,6,6,3,3,6.6
0,0,0,0,0,0,0,0,0,"00",0,0,0,0,0,0,1038024,"2023-12-29T00:00:00.000Z",2,FALSE,28,56677828,"G",28,28,"Toronto Raptors","Gradey Dick",0,0,0,0,0,0
0,0,0,0,0,0,0,0,0,"06",0,1,0,0,2,0,1038024,"2023-12-29T00:00:00.000Z",2,FALSE,28,3547275,"G",28,28,"Toronto Raptors","Malachi Flynn",2,0,0,0,0,6
2,0,0,7,2,10,5,2,1,"15",0,4,13,0,1,0,1038024,"2023-12-29T00:00:00.000Z",2,FALSE,28,666762,"F",28,28,"Toronto Raptors","Jalen McDaniels",1,13,15,15,2,19
2,0,0,1,0,1,0,0,0,"08",0,0,0,0,0,0,1038024,"2023-12-29T00:00:00.000Z",2,FALSE,28,376,"F",28,28,"Toronto Raptors","Otto Porter Jr.",0,0,2,2,2,3
9,1,0,5,2,12,6,2,1,"35",2,2,15,2,0,0,1038024,"2023-12-29T00:00:00.000Z",2,FALSE,28,409,"G",28,28,"Toronto Raptors","Dennis Schroder",1,17,26,24,11,33.9
0,0,0,0,0,0,0,0,0,"00",0,0,0,0,0,0,1038024,"2023-12-29T00:00:00.000Z",2,FALSE,28,489,"F",28,28,"Toronto Raptors","Thaddeus Young",0,0,0,0,0,0
0,0,0,0,0,0,0,0,0,"00",0,0,0,0,0,0,1038024,"2023-12-29T00:00:00.000Z",2,FALSE,28,56677805,"G",28,28,"Toronto Raptors","Javon Freeman-Liberty",0,0,0,0,0,0
0,0,0,0,0,0,0,0,0,"00",0,0,0,0,0,0,1038024,"2023-12-29T00:00:00.000Z",2,FALSE,28,38017710,"C",28,28,"Toronto Raptors","Christian Koloko",0,0,0,0,0,0
0,0,0,0,0,0,0,0,0,"00",0,0,0,0,0,0,1038024,"2023-12-29T00:00:00.000Z",2,FALSE,28,56677869,"G",28,28,"Toronto Raptors","Markquis Nowell",0,0,0,0,0,0
0,0,0,0,0,0,0,0,0,"00",0,0,0,0,0,0,1038024,"2023-12-29T00:00:00.000Z",2,FALSE,28,2309958,"C-F",15,28,"Toronto Raptors","Jontay Porter",0,0,0,0,0,0
0,0,0,0,0,0,0,0,0,"00",0,0,0,0,0,0,1038024,"2023-12-29T00:00:00.000Z",2,FALSE,28,436,"G-F",28,28,"Toronto Raptors","Garrett Temple",0,0,0,0,0,0
3,1,2,1,0,5,3,2,2,"30",0,3,8,2,1,1,1038025,"2023-12-29T00:00:00.000Z",6,FALSE,17,3547247,"F-G",6,6,"Cleveland Cavaliers","Isaac Okoro",2,10,13,11,5,19.9
1,0,5,2,0,3,0,0,0,"17",0,1,0,5,1,2,1038025,"2023-12-29T00:00:00.000Z",6,FALSE,17,666940,"F",6,6,"Cleveland Cavaliers","Dean Wade",1,5,6,1,6,8.5
6,2,9,0,0,17,15,0,0,"40",3,2,30,12,0,0,1038025,"2023-12-29T00:00:00.000Z",6,FALSE,17,9,"C",6,6,"Cleveland Cavaliers","Jarrett Allen",2,42,48,36,18,59.4
2,2,3,11,2,18,5,0,0,"37",1,3,12,4,4,1,1038025,"2023-12-29T00:00:00.000Z",6,FALSE,17,666908,"G",6,6,"Cleveland Cavaliers","Max Strus",6,16,18,14,6,36.8
9,1,5,10,2,23,14,4,4,"36",1,3,34,6,2,2,1038025,"2023-12-29T00:00:00.000Z",6,FALSE,17,322,"G",6,6,"Cleveland Cavaliers","Donovan Mitchell",3,40,49,43,15,61.7
0,0,0,0,0,0,0,0,0,"00",0,0,0,0,0,0,1038025,"2023-12-29T00:00:00.000Z",6,FALSE,17,666676,"G",6,6,"Cleveland Cavaliers","Ty Jerome",0,0,0,0,0,0
0,0,0,0,0,0,0,0,0,"00",0,0,0,0,0,0,1038025,"2023-12-29T00:00:00.000Z",6,FALSE,17,248,"C",6,6,"Cleveland Cavaliers","Damian Jones",0,0,0,0,0,0
4,0,1,6,0,14,3,0,0,"28",0,2,6,1,1,2,1038025,"2023-12-29T00:00:00.000Z",6,FALSE,17,277,"G",6,6,"Cleveland Cavaliers","Caris LeVert",1,7,11,10,5,14.2
1,0,0,4,1,4,1,0,0,"15",0,1,3,0,0,0,1038025,"2023-12-29T00:00:00.000Z",6,FALSE,17,3547299,"G",6,6,"Cleveland Cavaliers","Sam Merrill",0,3,4,4,1,4.5
0,1,0,6,0,7,1,0,0,"14",0,2,2,0,1,0,1038025,"2023-12-29T00:00:00.000Z",6,FALSE,17,344,"F",6,6,"Cleveland Cavaliers","Georges Niang",2,2,2,2,0,8
1,0,1,3,1,10,6,1,1,"15",0,1,14,1,1,0,1038025,"2023-12-29T00:00:00.000Z",6,FALSE,17,56677872,"G",6,6,"Cleveland Cavaliers","Craig Porter",1,15,16,15,2,19.7
1,0,4,0,0,2,1,2,0,"08",2,2,2,6,0,0,1038025,"2023-12-29T00:00:00.000Z",6,FALSE,17,444,"C-F",6,6,"Cleveland Cavaliers","Tristan Thompson",0,8,9,3,7,10.7
0,0,0,0,0,0,0,0,0,"00",0,0,0,0,0,0,1038025,"2023-12-29T00:00:00.000Z",6,FALSE,17,56677847,"F",6,6,"Cleveland Cavaliers","Emoni Bates",0,0,0,0,0,0
0,0,0,0,0,0,0,0,0,"00",0,0,0,0,0,0,1038025,"2023-12-29T00:00:00.000Z",6,FALSE,17,666581,"G",6,6,"Cleveland Cavaliers","Darius Garland",0,0,0,0,0,0
0,0,0,0,0,0,0,0,0,"00",0,0,0,0,0,0,1038025,"2023-12-29T00:00:00.000Z",6,FALSE,17,17896076,"F-C",6,6,"Cleveland Cavaliers","Evan Mobley",0,0,0,0,0,0
0,0,0,0,0,0,0,0,0,"00",0,0,0,0,0,0,1038025,"2023-12-29T00:00:00.000Z",6,FALSE,17,38017662,"F",6,6,"Cleveland Cavaliers","Isaiah Mobley",0,0,0,0,0,0
0,0,0,0,0,0,0,0,0,"00",0,0,0,0,0,0,1038025,"2023-12-29T00:00:00.000Z",6,FALSE,17,404,"G",6,6,"Cleveland Cavaliers","Ricky Rubio",0,0,0,0,0,0
11,0,3,3,1,10,4,4,4,"33",0,1,13,3,3,4,1038025,"2023-12-29T00:00:00.000Z",6,FALSE,17,315,"F",17,17,"Milwaukee Bucks","Khris Middleton",3,16,27,24,14,38.1
5,0,14,1,0,22,14,7,6,"37",2,2,34,16,1,3,1038025,"2023-12-29T00:00:00.000Z",6,FALSE,17,15,"F",17,17,"Milwaukee Bucks","Giannis Antetokounmpo",1,50,55,39,21,60.7
2,6,7,3,1,10,4,0,0,"36",3,3,9,10,0,0,1038025,"2023-12-29T00:00:00.000Z",6,FALSE,17,283,"C",17,17,"Milwaukee Bucks","Brook Lopez",6,19,21,11,12,42
0,0,5,8,5,9,5,0,0,"35",0,1,15,5,0,3,1038025,"2023-12-29T00:00:00.000Z",6,FALSE,17,38,"G",17,17,"Milwaukee Bucks","Malik Beasley",0,20,20,15,5,18
4,0,2,6,2,16,9,11,11,"34",0,3,31,2,0,2,1038025,"2023-12-29T00:00:00.000Z",6,FALSE,17,278,"G",17,17,"Milwaukee Bucks","Damian Lillard",0,33,37,35,6,37.4
0,0,0,0,0,0,0,0,0,"00",0,0,0,0,0,0,1038025,"2023-12-29T00:00:00.000Z",6,FALSE,17,2148,"",17,17,"Milwaukee Bucks","Thanasis Antetokounmpo",0,0,0,0,0,0
0,0,0,2,1,3,2,0,0,"11",1,2,5,1,0,0,1038025,"2023-12-29T00:00:00.000Z",6,FALSE,17,38017676,"F",17,17,"Milwaukee Bucks","MarJon Beauchamp",0,6,6,5,1,6.2
3,0,1,3,1,3,1,0,0,"23",0,0,3,1,0,1,1038025,"2023-12-29T00:00:00.000Z",6,FALSE,17,105,"G",17,17,"Milwaukee Bucks","Pat Connaughton",0,4,7,6,4,7.7
0,0,0,0,0,0,0,0,0,"00",0,0,0,0,0,0,1038025,"2023-12-29T00:00:00.000Z",6,FALSE,17,38017733,"G",17,17,"Milwaukee Bucks","A.J. Green",0,0,0,0,0,0
0,0,0,0,0,0,0,0,0,"02",0,0,0,0,0,1,1038025,"2023-12-29T00:00:00.000Z",6,FALSE,17,56677852,"G",17,17,"Milwaukee Bucks","Andre Jackson Jr.",0,0,0,0,0,-1
0,0,0,0,0,0,0,0,0,"00",0,0,0,0,0,0,1038025,"2023-12-29T00:00:00.000Z",6,FALSE,17,56677854,"F",17,17,"Milwaukee Bucks","Chris Livingston",0,0,0,0,0,0
0,0,0,0,0,0,0,0,0,"00",0,0,0,0,0,0,1038025,"2023-12-29T00:00:00.000Z",6,FALSE,17,284,"C",17,17,"Milwaukee Bucks","Robin Lopez",0,0,0,0,0,0
0,0,0,1,0,1,0,0,0,"06",0,0,0,0,0,3,1038025,"2023-12-29T00:00:00.000Z",6,FALSE,17,368,"G",17,17,"Milwaukee Bucks","Cameron Payne",0,0,0,0,0,-3
1,0,4,2,1,6,2,6,4,"23",1,3,9,5,1,0,1038025,"2023-12-29T00:00:00.000Z",6,FALSE,17,377,"F",17,17,"Milwaukee Bucks","Bobby Portis",1,14,15,10,6,19.5
0,0,0,0,0,0,0,0,0,"00",0,0,0,0,0,0,1038025,"2023-12-29T00:00:00.000Z",6,FALSE,17,666453,"C",17,17,"Milwaukee Bucks","Marques Bolden",0,0,0,0,0,0
0,0,0,0,0,0,0,0,0,"00",0,0,0,0,0,0,1038025,"2023-12-29T00:00:00.000Z",6,FALSE,17,112,"F",17,17,"Milwaukee Bucks","Jae Crowder",0,0,0,0,0,0
0,0,0,0,0,0,0,0,0,"00",0,0,0,0,0,0,1038025,"2023-12-29T00:00:00.000Z",6,FALSE,17,38017691,"G",17,17,"Milwaukee Bucks","TyTy Washington Jr.",0,0,0,0,0,0
0,0,0,0,0,0,0,0,0,"00",0,0,0,0,0,0,1038025,"2023-12-29T00:00:00.000Z",6,FALSE,17,666960,"G",17,17,"Milwaukee Bucks","Lindell Wigginton",0,0,0,0,0,0
2,0,4,1,0,4,2,0,0,"35",1,3,4,5,0,0,1038026,"2023-12-29T00:00:00.000Z",11,FALSE,23,3547301,"F",11,11,"Houston Rockets","Jae'Sean Tate",0,9,11,6,7,13
0,1,2,2,0,11,5,1,0,"33",2,2,10,4,1,0,1038026,"2023-12-29T00:00:00.000Z",11,FALSE,23,188,"F",11,11,"Houston Rockets","Jeff Green",2,14,14,10,4,20.8
8,1,4,2,1,16,12,4,3,"34",3,6,28,7,1,5,1038026,"2023-12-29T00:00:00.000Z",11,FALSE,23,17896062,"F-C",11,11,"Houston Rockets","Alperen Sengun",2,35,43,36,15,49.4
4,0,6,9,5,19,12,4,2,"36",0,0,31,6,0,1,1038026,"2023-12-29T00:00:00.000Z",11,FALSE,23,17895966,"G",11,11,"Houston Rockets","Jalen Green",0,37,41,35,10,43.2
10,1,3,12,8,16,9,8,7,"43",0,3,33,3,1,5,1038026,"2023-12-29T00:00:00.000Z",11,FALSE,23,458,"G",11,11,"Houston Rockets","Fred VanVleet",2,36,46,43,13,52.6
3,0,1,2,0,6,2,0,0,"15",1,2,4,2,2,3,1038026,"2023-12-29T00:00:00.000Z",11,FALSE,23,213,"G",11,11,"Houston Rockets","Aaron Holiday",2,6,9,7,5,13.9
0,1,0,0,0,5,2,2,2,"08",1,4,6,1,0,0,1038026,"2023-12-29T00:00:00.000Z",11,FALSE,23,19465326,"C",11,11,"Houston Rockets","Jock Landale",1,7,7,6,1,10.2
4,1,3,9,2,26,13,15,14,"41",1,1,42,4,0,1,1038026,"2023-12-29T00:00:00.000Z",11,FALSE,23,3547254,"G",23,23,"Philadelphia 76ers","Tyrese Maxey",1,46,50,46,8,54.8
0,0,0,0,0,1,0,2,2,"05",2,1,2,2,0,0,1038026,"2023-12-29T00:00:00.000Z",11,FALSE,23,28,"C",23,23,"Philadelphia 76ers","Mo Bamba",0,4,4,2,2,4.4
3,0,1,1,1,4,3,2,2,"20",2,1,9,3,0,0,1038026,"2023-12-29T00:00:00.000Z",11,FALSE,23,45,"G",23,23,"Philadelphia 76ers","Patrick Beverley",0,12,15,12,6,17.1
0,0,2,1,0,5,3,1,1,"16",2,4,7,4,3,0,1038026,"2023-12-29T00:00:00.000Z",11,FALSE,23,108,"F",23,23,"Philadelphia 76ers","Robert Covington",3,11,11,7,4,20.8
0,0,2,0,0,0,0,0,0,"12",0,1,0,2,0,0,1038026,"2023-12-29T00:00:00.000Z",11,FALSE,23,2175,"",23,23,"Philadelphia 76ers","Danuel House Jr.",0,2,2,0,2,2.4
0,0,0,0,0,0,0,0,0,"00",0,0,0,0,0,0,1038026,"2023-12-29T00:00:00.000Z",11,FALSE,23,260,"G-F",23,23,"Philadelphia 76ers","Furkan Korkmaz",0,0,0,0,0,0
1,1,4,5,2,8,4,5,4,"27",1,5,14,5,1,1,1038026,"2023-12-29T00:00:00.000Z",11,FALSE,23,328,"F",23,23,"Philadelphia 76ers","Marcus Morris",2,19,20,15,6,26.5
0,0,0,0,0,0,0,0,0,"00",0,0,0,0,0,0,1038026,"2023-12-29T00:00:00.000Z",11,FALSE,23,17896025,"G",23,23,"Philadelphia 76ers","Jaden Springer",0,0,0,0,0,0
0,0,0,0,0,0,0,0,0,"00",0,0,0,0,0,0,1038026,"2023-12-29T00:00:00.000Z",11,FALSE,23,33,"F-G",23,23,"Philadelphia 76ers","Nicolas Batum",0,0,0,0,0,0
0,0,0,0,0,0,0,0,0,"00",0,0,0,0,0,0,1038026,"2023-12-29T00:00:00.000Z",11,FALSE,23,56913527,"G",23,23,"Philadelphia 76ers","Ricky Council IV",0,0,0,0,0,0
0,0,0,0,0,0,0,0,0,"00",0,0,0,0,0,0,1038026,"2023-12-29T00:00:00.000Z",11,FALSE,23,145,"F-C",23,23,"Philadelphia 76ers","Joel Embiid",0,0,0,0,0,0
0,0,0,0,0,0,0,0,0,"00",0,0,0,0,0,0,1038026,"2023-12-29T00:00:00.000Z",11,FALSE,23,38017732,"F",15,23,"Philadelphia 76ers","Kenneth Lofton Jr.",0,0,0,0,0,0
0,0,0,0,0,0,0,0,0,"00",0,0,0,0,0,0,1038026,"2023-12-29T00:00:00.000Z",11,FALSE,23,3547294,"F",23,23,"Philadelphia 76ers","Kenyon Martin Jr.",0,0,0,0,0,0
0,0,0,0,0,0,0,0,0,"00",0,0,0,0,0,0,1038026,"2023-12-29T00:00:00.000Z",11,FALSE,23,56677788,"G",23,23,"Philadelphia 76ers","Terquavion Smith",0,0,0,0,0,0
0,0,0,0,0,0,0,0,0,"00",0,0,0,0,0,0,1038026,"2023-12-29T00:00:00.000Z",11,FALSE,23,56677831,"F",11,11,"Houston Rockets","Cam Whitmore",0,0,0,0,0,0
0,0,0,0,0,0,0,0,0,"00",0,0,0,0,0,0,1038026,"2023-12-29T00:00:00.000Z",11,FALSE,23,296,"C",11,11,"Houston Rockets","Boban Marjanovic",0,0,0,0,0,0
0,0,0,0,0,0,0,0,0,"00",0,0,0,0,0,0,1038026,"2023-12-29T00:00:00.000Z",11,FALSE,23,66,"G-F",11,11,"Houston Rockets","Dillon Brooks",0,0,0,0,0,0
0,0,0,0,0,0,0,0,0,"00",0,0,0,0,0,0,1038026,"2023-12-29T00:00:00.000Z",11,FALSE,23,3547281,"G-F",11,11,"Houston Rockets","Nate Hinton",0,0,0,0,0,0
0,0,0,0,0,0,0,0,0,"00",0,0,0,0,0,0,1038026,"2023-12-29T00:00:00.000Z",11,FALSE,23,357,"G",11,11,"Houston Rockets","Victor Oladipo",0,0,0,0,0,0
2,2,6,2,0,13,5,0,0,"27",5,3,10,11,3,2,1038026,"2023-12-29T00:00:00.000Z",11,FALSE,23,38017695,"F",11,11,"Houston Rockets","Tari Eason",5,21,23,12,13,39.2
1,0,2,0,0,1,0,2,1,"09",1,1,1,3,0,0,1038026,"2023-12-29T00:00:00.000Z",11,FALSE,23,56677825,"G-F",11,11,"Houston Rockets","Amen Thompson",0,4,5,2,4,6.1
0,0,0,0,0,0,0,0,0,"00",0,0,0,0,0,0,1038026,"2023-12-29T00:00:00.000Z",11,FALSE,23,75,"G-F",11,11,"Houston Rockets","Reggie Bullock",0,0,0,0,0,0
0,0,0,0,0,0,0,0,0,"00",0,0,0,0,0,0,1038026,"2023-12-29T00:00:00.000Z",11,FALSE,23,56677809,"F",11,11,"Houston Rockets","Jermaine Samuels Jr.",0,0,0,0,0,0
0,0,0,0,0,0,0,0,0,"00",0,0,0,0,0,0,1038026,"2023-12-29T00:00:00.000Z",11,FALSE,23,38017684,"F",11,11,"Houston Rockets","Jabari Smith Jr.",0,0,0,0,0,0
0,0,0,0,0,0,0,0,0,"00",0,0,0,0,0,0,1038026,"2023-12-29T00:00:00.000Z",11,FALSE,23,47738533,"G",11,11,"Houston Rockets","Jeenathan Williams",0,0,0,0,0,0
1,0,1,4,3,7,4,2,2,"24",0,1,13,1,0,3,1038026,"2023-12-29T00:00:00.000Z",11,FALSE,23,360,"F",23,23,"Philadelphia 76ers","Kelly Oubre Jr.",0,14,15,14,2,12.7
7,3,3,6,2,18,10,0,0,"35",1,3,22,4,4,3,1038026,"2023-12-29T00:00:00.000Z",11,FALSE,23,200,"F",23,23,"Philadelphia 76ers","Tobias Harris",7,26,33,29,11,55.3
4,0,0,0,0,5,3,2,1,"24",2,3,7,2,1,0,1038026,"2023-12-29T00:00:00.000Z",11,FALSE,23,3547270,"F",23,23,"Philadelphia 76ers","Paul Reed",1,9,13,11,6,18.4
2,0,3,7,2,12,5,4,3,"36",0,1,15,3,1,2,1038026,"2023-12-29T00:00:00.000Z",11,FALSE,23,313,"G",23,23,"Philadelphia 76ers","De'Anthony Melton",1,18,20,17,5,22.6
9,1,6,5,2,10,4,2,1,"31",1,2,11,7,2,3,1038027,"2023-12-29T00:00:00.000Z",8,FALSE,21,38017703,"G-F",21,21,"Oklahoma City Thunder","Jalen Williams",3,18,27,20,16,38.9
3,2,3,4,4,14,9,2,2,"28",3,1,24,6,0,2,1038027,"2023-12-29T00:00:00.000Z",8,FALSE,21,38017685,"C-F",21,21,"Oklahoma City Thunder","Chet Holmgren",2,30,33,27,9,39.7
0,0,1,4,1,7,2,0,0,"15",1,2,5,2,1,0,1038027,"2023-12-29T00:00:00.000Z",8,FALSE,21,480,"G-F",21,21,"Oklahoma City Thunder","Kenrich Williams",1,7,7,5,2,10.4
0,0,0,0,0,0,0,0,0,"00",0,0,0,0,0,0,1038027,"2023-12-29T00:00:00.000Z",8,FALSE,21,38017716,"F",21,21,"Oklahoma City Thunder","Ousmane Dieng",0,0,0,0,0,0
0,0,0,0,0,0,0,0,0,"00",0,0,0,0,0,0,1038027,"2023-12-29T00:00:00.000Z",8,FALSE,21,56677853,"F",21,21,"Oklahoma City Thunder","Keyontae Johnson",0,0,0,0,0,0
0,0,0,0,0,0,0,0,0,"00",0,0,0,0,0,0,1038027,"2023-12-29T00:00:00.000Z",8,FALSE,21,3547271,"C",21,21,"Oklahoma City Thunder","Aleksej Pokusevski",0,0,0,0,0,0
4,0,6,1,0,10,6,0,0,"21",2,1,12,8,1,3,1038027,"2023-12-29T00:00:00.000Z",8,FALSE,21,17896065,"G",21,21,"Oklahoma City Thunder","Josh Giddey",1,20,24,16,12,27.6
3,1,4,3,2,20,14,10,10,"33",0,3,40,4,2,1,1038027,"2023-12-29T00:00:00.000Z",8,FALSE,21,175,"G",21,21,"Oklahoma City Thunder","Shai Gilgeous-Alexander",3,44,47,43,7,57.3
0,0,0,0,0,0,0,0,0,"00",0,0,0,0,0,0,1038027,"2023-12-29T00:00:00.000Z",8,FALSE,21,44,"F",21,21,"Oklahoma City Thunder","Davis Bertans",0,0,0,0,0,0
1,0,1,5,1,6,2,0,0,"13",0,0,5,1,0,0,1038027,"2023-12-29T00:00:00.000Z",8,FALSE,21,3547272,"G",21,21,"Oklahoma City Thunder","Isaiah Joe",0,6,7,6,2,7.7
0,0,0,0,0,0,0,0,0,"00",0,0,0,0,0,0,1038027,"2023-12-29T00:00:00.000Z",8,FALSE,21,17896036,"G",21,21,"Oklahoma City Thunder","Tre Mann",0,0,0,0,0,0
2,1,1,3,0,4,1,0,0,"14",0,2,2,1,0,0,1038027,"2023-12-29T00:00:00.000Z",8,FALSE,21,4197029,"G",21,21,"Oklahoma City Thunder","Vasilije Micic",1,3,5,4,3,9.2
0,0,1,0,0,0,0,2,2,"03",0,0,2,1,0,0,1038027,"2023-12-29T00:00:00.000Z",8,FALSE,21,24572055,"C",21,21,"Oklahoma City Thunder","Olivier Sarr",0,3,3,2,1,3.2
2,1,3,2,0,5,2,0,0,"18",0,1,4,3,0,0,1038027,"2023-12-29T00:00:00.000Z",8,FALSE,21,56677833,"G",21,21,"Oklahoma City Thunder","Cason Wallace",1,7,9,6,5,13.6
0,0,1,2,1,2,1,0,0,"03",0,0,3,1,0,0,1038027,"2023-12-29T00:00:00.000Z",8,FALSE,21,27924547,"F",21,21,"Oklahoma City Thunder","Lindy Waters III",0,4,4,3,1,4.2
0,0,3,1,1,5,3,0,0,"12",2,2,7,5,0,1,1038027,"2023-12-29T00:00:00.000Z",8,FALSE,21,17896078,"G",21,21,"Oklahoma City Thunder","Aaron Wiggins",0,12,12,7,5,12
4,1,8,2,0,2,0,0,0,"17",0,3,0,8,1,0,1038027,"2023-12-29T00:00:00.000Z",8,FALSE,21,38017706,"F",21,21,"Oklahoma City Thunder","Jaylin Williams",2,8,12,4,12,21.6
1,1,6,8,2,12,4,2,2,"31",0,1,12,6,0,0,1038027,"2023-12-29T00:00:00.000Z",8,FALSE,21,375,"F",8,8,"Denver Nuggets","Michael Porter Jr.",1,18,19,13,7,23.7
2,2,2,6,1,12,6,2,1,"32",0,4,14,2,1,1,1038027,"2023-12-29T00:00:00.000Z",8,FALSE,21,38017721,"G",8,8,"Denver Nuggets","Peyton Watson",3,16,18,16,4,27.4
7,1,8,1,1,10,9,0,0,"32",2,2,19,10,1,7,1038027,"2023-12-29T00:00:00.000Z",8,FALSE,21,246,"C",8,8,"Denver Nuggets","Nikola Jokic",2,29,36,26,17,40.5
2,0,0,3,2,5,3,1,0,"27",0,3,8,0,1,1,1038027,"2023-12-29T00:00:00.000Z",8,FALSE,21,81,"G",8,8,"Denver Nuggets","Kentavious Caldwell-Pope",1,8,10,10,2,13
11,1,3,6,1,15,4,1,0,"36",0,1,9,3,1,2,1038027,"2023-12-29T00:00:00.000Z",8,FALSE,21,335,"G",8,8,"Denver Nuggets","Jamal Murray",2,12,23,20,14,33.1
1,0,3,2,0,3,0,4,4,"17",0,1,4,3,0,1,1038027,"2023-12-29T00:00:00.000Z",8,FALSE,21,38017709,"G",8,8,"Denver Nuggets","Christian Braun",0,7,8,5,4,8.1
2,0,1,2,0,3,0,0,0,"16",0,1,0,1,0,0,1038027,"2023-12-29T00:00:00.000Z",8,FALSE,21,215,"F-G",8,8,"Denver Nuggets","Justin Holiday",0,1,3,2,3,4.2
3,0,2,5,2,10,3,0,0,"15",0,0,8,2,1,0,1038027,"2023-12-29T00:00:00.000Z",8,FALSE,21,236,"G",8,8,"Denver Nuggets","Reggie Jackson",1,10,13,11,5,17.9
1,0,5,0,0,4,3,0,0,"13",3,0,6,8,1,1,1038027,"2023-12-29T00:00:00.000Z",8,FALSE,21,250,"C",8,8,"Denver Nuggets","DeAndre Jordan",1,14,15,7,9,19.1
0,0,0,0,0,2,1,1,1,"03",0,0,3,0,0,0,1038027,"2023-12-29T00:00:00.000Z",8,FALSE,21,17896007,"G",8,8,"Denver Nuggets","Braxton Key",0,3,3,3,0,3
0,0,0,0,0,1,0,0,0,"03",0,0,0,0,0,0,1038027,"2023-12-29T00:00:00.000Z",8,FALSE,21,3547268,"F-C",8,8,"Denver Nuggets","Zeke Nnaji",0,0,0,0,0,0
0,0,0,0,0,1,0,0,0,"03",0,1,0,0,0,0,1038027,"2023-12-29T00:00:00.000Z",8,FALSE,21,56677582,"G",8,8,"Denver Nuggets","Jalen Pickett",0,0,0,0,0,0
0,0,1,4,1,7,3,4,3,"12",0,3,10,1,0,3,1038027,"2023-12-29T00:00:00.000Z",8,FALSE,21,56677776,"G",8,8,"Denver Nuggets","Julian Strawther",0,11,11,10,1,8.2
0,0,0,0,0,0,0,0,0,"00",0,0,0,0,0,0,1038027,"2023-12-29T00:00:00.000Z",8,FALSE,21,666489,"F",8,8,"Denver Nuggets","Vlatko Cancar",0,0,0,0,0,0
0,0,0,0,0,0,0,0,0,"00",0,0,0,0,0,0,1038027,"2023-12-29T00:00:00.000Z",8,FALSE,21,38017727,"G",8,8,"Denver Nuggets","Collin Gillespie",0,0,0,0,0,0
0,0,0,0,0,0,0,0,0,"00",0,0,0,0,0,0,1038027,"2023-12-29T00:00:00.000Z",8,FALSE,21,177,"F",8,8,"Denver Nuggets","Aaron Gordon",0,0,0,0,0,0
0,0,0,0,0,0,0,0,0,"00",0,0,0,0,0,0,1038027,"2023-12-29T00:00:00.000Z",8,FALSE,21,17896103,"F-C",8,8,"Denver Nuggets","Jay Huff",0,0,0,0,0,0
0,0,0,0,0,0,0,0,0,"00",0,0,0,0,0,0,1038027,"2023-12-29T00:00:00.000Z",8,FALSE,21,56677871,"F",8,8,"Denver Nuggets","Hunter Tyson",0,0,0,0,0,0
1,1,3,3,0,6,2,0,0,"32",1,3,4,4,3,1,1038027,"2023-12-29T00:00:00.000Z",8,FALSE,21,666541,"G",21,21,"Oklahoma City Thunder","Luguentz Dort",4,8,9,5,5,21.3
3,1,3,4,2,8,6,2,2,"33",1,2,16,4,0,1,1038028,"2023-12-29T00:00:00.000Z",24,FALSE,4,8,"G",24,24,"Phoenix Suns","Grayson Allen",1,20,23,19,7,27.3
11,3,3,3,3,11,8,2,2,"39",1,2,21,4,1,1,1038028,"2023-12-29T00:00:00.000Z",24,FALSE,4,140,"F",24,24,"Phoenix Suns","Kevin Durant",4,25,36,32,15,53.3
0,2,0,0,0,0,0,0,0,"06",0,1,0,0,0,1,1038028,"2023-12-29T00:00:00.000Z",24,FALSE,4,3547095,"C-F",24,24,"Phoenix Suns","Udoka Azubuike",2,0,0,0,0,5
7,1,3,2,0,8,3,0,0,"30",0,2,6,3,0,2,1038028,"2023-12-29T00:00:00.000Z",24,FALSE,4,37,"G",24,24,"Phoenix Suns","Bradley Beal",1,9,16,13,10,21.1
7,1,4,7,5,18,10,10,10,"37",0,4,35,4,0,2,1038028,"2023-12-29T00:00:00.000Z",24,FALSE,4,57,"G",24,24,"Phoenix Suns","Devin Booker",1,39,46,42,11,51.3
0,0,0,0,0,0,0,0,0,"00",0,0,0,0,0,0,1038028,"2023-12-29T00:00:00.000Z",24,FALSE,4,32,"F",24,24,"Phoenix Suns","Keita Bates-Diop",0,0,0,0,0,0
0,0,0,0,0,0,0,0,0,"00",0,0,0,0,0,0,1038028,"2023-12-29T00:00:00.000Z",24,FALSE,4,666451,"C",24,24,"Phoenix Suns","Bol Bol",0,0,0,0,0,0
0,0,0,0,0,0,0,0,0,"00",0,0,0,0,0,0,1038028,"2023-12-29T00:00:00.000Z",24,FALSE,4,147,"F",24,24,"Phoenix Suns","Drew Eubanks",0,0,0,0,0,0
0,0,0,0,0,0,0,0,0,"01",0,0,0,0,0,0,1038028,"2023-12-29T00:00:00.000Z",24,FALSE,4,18678058,"",24,24,"Phoenix Suns","Jordan Goodwin",0,0,0,0,0,0
1,1,2,12,7,12,7,0,0,"33",0,1,21,2,0,4,1038028,"2023-12-29T00:00:00.000Z",24,FALSE,4,178,"G",24,24,"Phoenix Suns","Eric Gordon",1,23,24,22,3,23.9
3,0,0,0,0,1,0,2,1,"14",0,1,1,0,1,0,1038028,"2023-12-29T00:00:00.000Z",24,FALSE,4,3547298,"G",24,24,"Phoenix Suns","Saben Lee",1,1,4,4,3,8.5
1,2,12,1,0,13,10,4,4,"28",3,1,24,15,0,3,1038028,"2023-12-29T00:00:00.000Z",24,FALSE,4,349,"C",24,24,"Phoenix Suns","Jusuf Nurkic",2,39,40,25,16,46.5
0,0,0,0,0,0,0,0,0,"00",0,0,0,0,0,0,1038028,"2023-12-29T00:00:00.000Z",24,FALSE,4,56677848,"G",4,4,"Charlotte Hornets","Amari Bailey",0,0,0,0,0,0
0,0,0,0,0,0,0,0,0,"00",0,0,0,0,0,0,1038028,"2023-12-29T00:00:00.000Z",24,FALSE,4,3547239,"G",4,4,"Charlotte Hornets","LaMelo Ball",0,0,0,0,0,0
0,0,0,0,0,0,0,0,0,"00",0,0,0,0,0,0,1038028,"2023-12-29T00:00:00.000Z",24,FALSE,4,56677866,"F",4,4,"Charlotte Hornets","Leaky Black",0,0,0,0,0,0
0,0,0,0,0,0,0,0,0,"00",0,0,0,0,0,0,1038028,"2023-12-29T00:00:00.000Z",24,FALSE,4,204,"F",4,4,"Charlotte Hornets","Gordon Hayward",0,0,0,0,0,0
0,0,0,0,0,0,0,0,0,"00",0,0,0,0,0,0,1038028,"2023-12-29T00:00:00.000Z",24,FALSE,4,347,"G",4,4,"Charlotte Hornets","Frank Ntilikina",0,0,0,0,0,0
0,0,0,0,0,0,0,0,0,"00",0,0,0,0,0,0,1038028,"2023-12-29T00:00:00.000Z",24,FALSE,4,38017698,"C",4,4,"Charlotte Hornets","Mark Williams",0,0,0,0,0,0
0,0,0,0,0,0,0,0,0,"00",0,0,0,0,0,0,1038028,"2023-12-29T00:00:00.000Z",24,FALSE,4,3547253,"G",4,24,"Phoenix Suns","Theo Maledon",0,0,0,0,0,0
0,0,0,0,0,0,0,0,0,"00",0,0,0,0,0,0,1038028,"2023-12-29T00:00:00.000Z",24,FALSE,4,356,"G",24,24,"Phoenix Suns","Josh Okogie",0,0,0,0,0,0
6,0,7,7,1,16,4,2,2,"37",0,2,11,7,1,3,1038028,"2023-12-29T00:00:00.000Z",24,FALSE,4,62,"F",4,4,"Charlotte Hornets","Miles Bridges",1,18,24,17,13,28.4
3,0,1,1,0,4,2,0,0,"21",0,1,4,1,0,0,1038028,"2023-12-29T00:00:00.000Z",24,FALSE,4,38017708,"G",4,4,"Charlotte Hornets","Bryce McGowens",0,5,8,7,4,9.7
0,0,1,0,0,4,3,0,0,"31",1,4,6,2,0,0,1038028,"2023-12-29T00:00:00.000Z",24,FALSE,4,3547282,"C",4,4,"Charlotte Hornets","Nick Richards",0,8,8,6,2,8.4
3,1,0,10,6,16,7,0,0,"31",1,4,20,1,1,0,1038028,"2023-12-29T00:00:00.000Z",24,FALSE,4,56677823,"F",4,4,"Charlotte Hornets","Brandon Miller",2,21,24,23,4,31.7
8,0,3,12,8,22,14,6,6,"39",1,0,42,4,1,0,1038028,"2023-12-29T00:00:00.000Z",24,FALSE,4,403,"G",4,4,"Charlotte Hornets","Terry Rozier",1,46,54,50,12,61.8
0,0,0,0,0,0,0,0,0,"00",0,0,0,0,0,0,1038028,"2023-12-29T00:00:00.000Z",24,FALSE,4,17896037,"G",4,4,"Charlotte Hornets","James Bouknight",0,0,0,0,0,0
1,1,1,4,3,10,5,0,0,"27",3,1,13,4,2,1,1038028,"2023-12-29T00:00:00.000Z",24,FALSE,4,666748,"F",4,4,"Charlotte Hornets","Cody Martin",3,17,18,14,5,27.3
0,0,0,0,0,0,0,0,0,"00",0,0,0,0,0,0,1038028,"2023-12-29T00:00:00.000Z",24,FALSE,4,NA,NA,NA,4,"Charlotte Hornets","NA NA",0,0,0,0,0,0
1,0,6,1,1,3,2,4,4,"19",1,0,9,7,1,0,1038028,"2023-12-29T00:00:00.000Z",24,FALSE,4,314,"F",24,24,"Phoenix Suns","Chimezie Metu",1,16,17,10,8,21.9
0,0,0,0,0,0,0,0,0,"00",0,0,0,0,0,0,1038028,"2023-12-29T00:00:00.000Z",24,FALSE,4,470,"G",24,24,"Phoenix Suns","Yuta Watanabe",0,0,0,0,0,0
0,0,0,0,0,0,0,0,0,"00",0,0,0,0,0,0,1038028,"2023-12-29T00:00:00.000Z",24,FALSE,4,272,"G",24,24,"Phoenix Suns","Damion Lee",0,0,0,0,0,0
0,0,0,0,0,0,0,0,0,"00",0,0,0,0,0,0,1038028,"2023-12-29T00:00:00.000Z",24,FALSE,4,666729,"F",24,24,"Phoenix Suns","Nassir Little",0,0,0,0,0,0
6,0,1,0,0,1,0,0,0,"13",0,1,0,1,0,0,1038028,"2023-12-29T00:00:00.000Z",24,FALSE,4,422,"G",4,4,"Charlotte Hornets","Ish Smith",0,1,7,6,7,10.2
1,0,1,4,2,7,4,0,0,"13",1,1,10,2,0,1,1038028,"2023-12-29T00:00:00.000Z",24,FALSE,4,56677846,"G",4,4,"Charlotte Hornets","Nick Smith Jr.",0,12,13,11,3,12.9
0,0,0,0,0,0,0,0,0,"00",0,0,0,0,0,0,1038028,"2023-12-29T00:00:00.000Z",24,FALSE,4,18678001,"F",4,4,"Charlotte Hornets","JT Thor",0,0,0,0,0,0
4,1,3,8,3,12,5,0,0,"28",1,3,13,4,0,1,1038028,"2023-12-29T00:00:00.000Z",24,FALSE,4,666950,"F",4,4,"Charlotte Hornets","P.J. Washington",1,17,21,17,8,25.8
2,0,7,3,1,12,6,0,0,"36",4,1,13,11,3,3,1038029,"2023-12-29T00:00:00.000Z",25,FALSE,27,56677850,"F",25,25,"Portland Trail Blazers","Toumani Camara",3,24,26,15,13,35.2
4,0,6,5,4,17,9,6,5,"39",0,2,27,6,0,4,1038029,"2023-12-29T00:00:00.000Z",25,FALSE,27,182,"F",25,25,"Portland Trail Blazers","Jerami Grant",0,33,37,31,10,36.2
0,0,0,0,0,0,0,0,0,"00",0,0,0,0,0,0,1038029,"2023-12-29T00:00:00.000Z",25,FALSE,27,476,"C-F",25,25,"Portland Trail Blazers","Robert Williams III",0,0,0,0,0,0
0,1,1,4,1,5,1,5,4,"12",2,1,7,3,1,1,1038029,"2023-12-29T00:00:00.000Z",25,FALSE,27,38017649,"F",27,27,"San Antonio Spurs","Julian Champagnie",2,10,10,7,3,15.6
4,0,3,0,0,3,0,2,2,"29",1,2,2,4,1,3,1038029,"2023-12-29T00:00:00.000Z",25,FALSE,27,38017699,"F",27,27,"San Antonio Spurs","Jeremy Sochan",1,6,10,6,8,12.8
2,1,2,1,0,10,8,3,1,"18",1,3,17,3,0,1,1038029,"2023-12-29T00:00:00.000Z",25,FALSE,27,102,"F-C",27,27,"San Antonio Spurs","Zach Collins",1,20,22,19,5,25.6
5,1,3,6,3,16,8,4,3,"31",0,1,22,3,4,0,1038029,"2023-12-29T00:00:00.000Z",25,FALSE,27,3547246,"G-F",27,27,"San Antonio Spurs","Devin Vassell",5,25,30,27,8,48.1
3,0,3,3,1,12,5,0,0,"29",3,1,11,6,1,3,1038029,"2023-12-29T00:00:00.000Z",25,FALSE,27,38017692,"F",27,27,"San Antonio Spurs","Malaki Branham",1,17,20,14,9,22.7
0,0,1,1,0,6,1,0,0,"14",1,2,2,2,1,0,1038029,"2023-12-29T00:00:00.000Z",25,FALSE,27,38017730,"F",27,27,"San Antonio Spurs","Dominick Barlow",1,4,4,2,2,7.4
7,0,5,8,3,18,9,11,8,"32",2,4,29,7,1,1,1038029,"2023-12-29T00:00:00.000Z",25,FALSE,27,666682,"F",27,27,"San Antonio Spurs","Keldon Johnson",1,36,43,36,14,49.9
5,0,5,0,0,9,7,0,0,"27",3,2,14,8,0,3,1038029,"2023-12-29T00:00:00.000Z",25,FALSE,27,3547274,"G",27,27,"San Antonio Spurs","Tre Jones",0,22,27,19,13,28.1
2,0,4,1,0,4,2,0,0,"18",0,1,4,4,0,0,1038029,"2023-12-29T00:00:00.000Z",25,FALSE,27,359,"F",27,27,"San Antonio Spurs","Cedi Osman",0,8,10,6,6,11.8
0,0,4,0,0,0,0,0,0,"04",0,1,0,4,0,0,1038029,"2023-12-29T00:00:00.000Z",25,FALSE,27,666476,"C",25,25,"Portland Trail Blazers","Moses Brown",0,4,4,0,4,4.8
7,0,1,7,5,18,9,4,4,"37",0,2,27,1,1,1,1038029,"2023-12-29T00:00:00.000Z",25,FALSE,27,65,"G",25,25,"Portland Trail Blazers","Malcolm Brogdon",1,28,35,34,8,40.7
11,1,3,5,3,21,9,2,1,"37",4,5,22,7,1,4,1038029,"2023-12-29T00:00:00.000Z",25,FALSE,27,56677747,"G",25,25,"Portland Trail Blazers","Scoot Henderson",2,29,40,33,18,48.9
1,2,1,0,0,0,0,2,2,"10",1,3,2,2,0,0,1038029,"2023-12-29T00:00:00.000Z",25,FALSE,27,39613724,"C",25,25,"Portland Trail Blazers","Ibou Badji",2,4,5,3,3,11.9
2,0,1,1,1,10,5,0,0,"20",1,0,11,2,1,0,1038029,"2023-12-29T00:00:00.000Z",25,FALSE,27,3547289,"G",25,25,"Portland Trail Blazers","Skylar Mays",1,13,15,13,4,19.4
0,0,0,0,0,0,0,0,0,"00",0,0,0,0,0,0,1038029,"2023-12-29T00:00:00.000Z",25,FALSE,27,47957121,"F",25,25,"Portland Trail Blazers","Justin Minaya",0,0,0,0,0,0
0,0,0,0,0,0,0,0,0,"00",0,0,0,0,0,0,1038029,"2023-12-29T00:00:00.000Z",25,FALSE,27,56677791,"F",25,25,"Portland Trail Blazers","Kris Murray",0,0,0,0,0,0
0,0,0,0,0,0,0,0,0,"00",0,0,0,0,0,0,1038029,"2023-12-29T00:00:00.000Z",25,FALSE,27,56677829,"G-F",25,25,"Portland Trail Blazers","Rayan Rupert",0,0,0,0,0,0
0,2,1,4,1,6,3,0,0,"27",0,1,7,1,1,1,1038029,"2023-12-29T00:00:00.000Z",25,FALSE,27,666923,"G-F",25,25,"Portland Trail Blazers","Matisse Thybulle",3,8,8,7,1,16.2
0,0,0,0,0,0,0,0,0,"00",0,0,0,0,0,0,1038029,"2023-12-29T00:00:00.000Z",25,FALSE,27,17896120,"F",25,25,"Portland Trail Blazers","Ish Wainright",0,0,0,0,0,0
1,1,3,2,1,11,7,13,10,"30",6,4,25,9,1,1,1038029,"2023-12-29T00:00:00.000Z",25,FALSE,27,38017711,"F",25,25,"Portland Trail Blazers","Jabari Walker",2,34,35,26,10,42.3
0,0,0,0,0,0,0,0,0,"00",0,0,0,0,0,0,1038029,"2023-12-29T00:00:00.000Z",25,FALSE,27,22,"C",25,25,"Portland Trail Blazers","Deandre Ayton",0,0,0,0,0,0
0,0,0,0,0,0,0,0,0,"00",0,0,0,0,0,0,1038029,"2023-12-29T00:00:00.000Z",25,FALSE,27,56783340,"C",25,25,"Portland Trail Blazers","Duop Reath",0,0,0,0,0,0
0,0,0,0,0,0,0,0,0,"00",0,0,0,0,0,0,1038029,"2023-12-29T00:00:00.000Z",25,FALSE,27,38017690,"G",25,25,"Portland Trail Blazers","Shaedon Sharpe",0,0,0,0,0,0
1,0,1,8,6,9,6,0,0,"23",0,1,18,1,0,2,1038029,"2023-12-29T00:00:00.000Z",25,FALSE,27,305,"F",27,27,"San Antonio Spurs","Doug McDermott",0,19,20,19,2,18.7
2,0,1,1,0,2,1,0,0,"07",0,1,2,1,0,0,1038029,"2023-12-29T00:00:00.000Z",25,FALSE,27,17896059,"F",27,27,"San Antonio Spurs","Sandro Mamukelashvili",0,3,5,4,3,6.2
0,0,0,0,0,0,0,0,0,"00",0,0,0,0,0,0,1038029,"2023-12-29T00:00:00.000Z",25,FALSE,27,38017693,"G",27,27,"San Antonio Spurs","Blake Wesley",0,0,0,0,0,0
0,0,0,0,0,0,0,0,0,"00",0,0,0,0,0,0,1038029,"2023-12-29T00:00:00.000Z",25,FALSE,27,17895854,"G",27,27,"San Antonio Spurs","Charles Bassey",0,0,0,0,0,0
0,0,0,0,0,0,0,0,0,"00",0,0,0,0,0,0,1038029,"2023-12-29T00:00:00.000Z",25,FALSE,27,56677817,"G",27,27,"San Antonio Spurs","Sidy Cissoko",0,0,0,0,0,0
0,0,0,0,0,0,0,0,0,"00",0,0,0,0,0,0,1038029,"2023-12-29T00:00:00.000Z",25,FALSE,27,17896049,"G",3,27,"San Antonio Spurs","David Duke Jr.",0,0,0,0,0,0
0,0,0,0,0,0,0,0,0,"00",0,0,0,0,0,0,1038029,"2023-12-29T00:00:00.000Z",25,FALSE,27,180,"G",27,27,"San Antonio Spurs","Devonte' Graham",0,0,0,0,0,0
0,0,0,0,0,0,0,0,0,"00",0,0,0,0,0,0,1038029,"2023-12-29T00:00:00.000Z",25,FALSE,27,56677822,"F-C",27,27,"San Antonio Spurs","Victor Wembanyama",0,0,0,0,0,0
0,0,0,0,0,0,0,0,0,"00",0,0,0,0,0,0,1038029,"2023-12-29T00:00:00.000Z",25,FALSE,27,419,"G",25,25,"Portland Trail Blazers","Anfernee Simons",0,0,0,0,0,0
2,0,1,4,3,6,5,0,0,"31",1,0,13,2,1,0,1038030,"2023-12-29T00:00:00.000Z",13,FALSE,15,666511,"G",13,13,"LA Clippers","Amir Coffey",1,15,17,15,4,21.4
3,0,6,8,2,21,8,6,5,"36",1,6,23,7,1,4,1038030,"2023-12-29T00:00:00.000Z",13,FALSE,15,172,"F",13,13,"LA Clippers","Paul George",1,30,33,26,10,34.9
1,1,14,0,0,8,7,1,1,"33",6,3,15,20,0,2,1038030,"2023-12-29T00:00:00.000Z",13,FALSE,15,493,"C",13,13,"LA Clippers","Ivica Zubac",1,35,36,16,21,41.5
2,0,2,6,0,10,3,6,5,"23",1,1,11,3,1,0,1038030,"2023-12-29T00:00:00.000Z",13,FALSE,15,666743,"G",13,13,"LA Clippers","Terance Mann",1,14,16,13,5,20.6
13,3,4,9,2,13,4,8,6,"44",0,1,16,4,0,5,1038030,"2023-12-29T00:00:00.000Z",13,FALSE,15,192,"G",13,13,"LA Clippers","James Harden",3,20,33,29,17,44.3
0,0,0,0,0,0,0,0,0,"00",0,0,0,0,0,0,1038030,"2023-12-29T00:00:00.000Z",13,FALSE,15,17896022,"G",13,13,"LA Clippers","Brandon Boston Jr.",0,0,0,0,0,0
0,0,4,3,1,5,3,0,0,"15",0,2,7,4,0,0,1038030,"2023-12-29T00:00:00.000Z",13,FALSE,15,56677849,"F",13,13,"LA Clippers","Kobe Brown",0,11,11,7,4,11.8
0,0,0,0,0,0,0,0,0,"00",0,0,0,0,0,0,1038030,"2023-12-29T00:00:00.000Z",13,FALSE,15,38017725,"F",13,13,"LA Clippers","Moussa Diabate",0,0,0,0,0,0
0,0,0,0,0,0,0,0,0,"00",0,0,0,0,0,0,1038030,"2023-12-29T00:00:00.000Z",13,FALSE,15,17896031,"G",13,13,"LA Clippers","Nah'Shon Hyland",0,0,0,0,0,0
0,0,0,0,0,0,0,0,0,"00",0,0,0,0,0,0,1038030,"2023-12-29T00:00:00.000Z",13,FALSE,15,56677856,"G",13,13,"LA Clippers","Jordan Miller",0,0,0,0,0,0
1,0,6,4,1,12,5,2,2,"25",0,2,13,6,0,1,1038030,"2023-12-29T00:00:00.000Z",13,FALSE,15,380,"F-G",13,13,"LA Clippers","Norman Powell",0,19,20,14,7,20.7
0,0,0,0,0,0,0,0,0,"00",0,0,0,0,0,0,1038030,"2023-12-29T00:00:00.000Z",13,FALSE,15,17896051,"G",13,13,"LA Clippers","Joshua Primo",0,0,0,0,0,0
0,2,1,1,0,3,2,2,1,"13",1,3,5,2,0,1,1038030,"2023-12-29T00:00:00.000Z",13,FALSE,15,439,"F",13,13,"LA Clippers","Daniel Theis",2,7,7,5,2,12.4
0,0,0,0,0,0,0,0,0,"00",0,0,0,0,0,0,1038030,"2023-12-29T00:00:00.000Z",13,FALSE,15,450,"F",13,13,"LA Clippers","PJ Tucker",0,0,0,0,0,0
6,0,5,4,2,9,6,0,0,"20",1,1,14,6,0,4,1038030,"2023-12-29T00:00:00.000Z",13,FALSE,15,472,"G",13,13,"LA Clippers","Russell Westbrook",0,20,26,20,12,26.2
0,0,0,0,0,0,0,0,0,"00",0,0,0,0,0,0,1038030,"2023-12-29T00:00:00.000Z",13,FALSE,15,274,"F",13,13,"LA Clippers","Kawhi Leonard",0,0,0,0,0,0
0,0,0,0,0,0,0,0,0,"00",0,0,0,0,0,0,1038030,"2023-12-29T00:00:00.000Z",13,FALSE,15,24417679,"G",13,13,"LA Clippers","Xavier Moon",0,0,0,0,0,0
0,0,2,0,0,2,1,0,0,"08",0,1,2,2,1,1,1038030,"2023-12-29T00:00:00.000Z",13,FALSE,15,48,"C",15,15,"Memphis Grizzlies","Bismack Biyombo",1,4,4,2,2,6.4
5,0,7,5,2,11,7,2,2,"37",0,3,18,7,2,2,1038030,"2023-12-29T00:00:00.000Z",13,FALSE,15,3547287,"G",15,15,"Memphis Grizzlies","Desmond Bane",2,25,30,23,12,37.9
10,0,6,7,0,19,7,6,5,"37",0,4,19,6,0,3,1038030,"2023-12-29T00:00:00.000Z",13,FALSE,15,666786,"G",15,15,"Memphis Grizzlies","Ja Morant",0,25,35,29,16,38.2
1,0,4,3,2,7,5,0,0,"22",1,1,12,5,1,0,1038030,"2023-12-29T00:00:00.000Z",13,FALSE,15,17896067,"F",15,15,"Memphis Grizzlies","Santi Aldama",1,17,18,13,6,22.5
0,0,0,0,0,0,0,0,0,"00",0,0,0,0,0,0,1038030,"2023-12-29T00:00:00.000Z",13,FALSE,15,48248287,"G",15,15,"Memphis Grizzlies","Jacob Gilyard",0,0,0,0,0,0
0,0,0,0,0,0,0,0,0,"00",0,0,0,0,0,0,1038030,"2023-12-29T00:00:00.000Z",13,FALSE,15,666703,"G-F",15,15,"Memphis Grizzlies","John Konchar",0,0,0,0,0,0
1,0,2,1,0,3,1,3,2,"22",0,1,4,2,0,1,1038030,"2023-12-29T00:00:00.000Z",13,FALSE,15,38017729,"F",15,15,"Memphis Grizzlies","David Roddy",0,6,7,5,3,6.9
0,1,2,1,0,5,1,0,0,"17",2,3,2,4,1,1,1038030,"2023-12-29T00:00:00.000Z",13,FALSE,15,3547285,"F",15,15,"Memphis Grizzlies","Xavier Tillman",2,6,6,2,4,11.8
5,1,1,4,1,6,1,3,2,"22",0,3,5,1,0,1,1038030,"2023-12-29T00:00:00.000Z",13,FALSE,15,38017731,"G",15,15,"Memphis Grizzlies","Vince Williams Jr.",1,6,11,10,6,15.7
1,0,2,2,0,3,0,0,0,"06",0,1,0,2,0,0,1038030,"2023-12-29T00:00:00.000Z",13,FALSE,15,17896027,"G-F",15,15,"Memphis Grizzlies","Ziaire Williams",0,2,3,1,3,3.9
0,0,0,0,0,0,0,0,0,"00",0,0,0,0,0,0,1038030,"2023-12-29T00:00:00.000Z",13,FALSE,15,3,"C",15,15,"Memphis Grizzlies","Steven Adams",0,0,0,0,0,0
0,0,0,0,0,0,0,0,0,"00",0,0,0,0,0,0,1038030,"2023-12-29T00:00:00.000Z",13,FALSE,15,666505,"F",15,15,"Memphis Grizzlies","Brandon Clarke",0,0,0,0,0,0
0,0,0,0,0,0,0,0,0,"00",0,0,0,0,0,0,1038030,"2023-12-29T00:00:00.000Z",13,FALSE,15,56677830,"F",15,15,"Memphis Grizzlies","GG Jackson",0,0,0,0,0,0
0,0,0,0,0,0,0,0,0,"00",0,0,0,0,0,0,1038030,"2023-12-29T00:00:00.000Z",13,FALSE,15,254,"G",15,15,"Memphis Grizzlies","Luke Kennard",0,0,0,0,0,0
0,0,0,0,0,0,0,0,0,"00",0,0,0,0,0,0,1038030,"2023-12-29T00:00:00.000Z",13,FALSE,15,38017728,"F",15,15,"Memphis Grizzlies","Jake LaRavia",0,0,0,0,0,0
0,0,0,0,0,0,0,0,0,"00",0,0,0,0,0,0,1038030,"2023-12-29T00:00:00.000Z",13,FALSE,15,401,"G",15,15,"Memphis Grizzlies","Derrick Rose",0,0,0,0,0,0
0,0,0,0,0,0,0,0,0,"00",0,0,0,0,0,0,1038030,"2023-12-29T00:00:00.000Z",13,FALSE,15,371,"F-C",13,13,"LA Clippers","Mason Plumlee",0,0,0,0,0,0
2,0,2,11,4,14,7,4,4,"32",0,0,22,2,3,2,1038030,"2023-12-29T00:00:00.000Z",13,FALSE,15,420,"G",15,15,"Memphis Grizzlies","Marcus Smart",3,24,26,24,4,34.4
4,2,2,6,4,17,8,2,2,"37",0,5,22,2,2,1,1038030,"2023-12-29T00:00:00.000Z",13,FALSE,15,231,"F-C",15,15,"Memphis Grizzlies","Jaren Jackson Jr.",4,24,28,26,6,41.4
2,1,7,5,3,19,11,7,7,"39",2,1,32,9,4,4,1038021,"2023-12-29T00:00:00.000Z",22,FALSE,20,17896026,"F",22,22,"Orlando Magic","Franz Wagner",5,41,43,34,11,56.8
4,1,9,6,2,19,9,12,9,"36",1,3,29,10,1,2,1038021,"2023-12-29T00:00:00.000Z",22,FALSE,20,38017683,"F",22,22,"Orlando Magic","Paolo Banchero",2,39,43,33,14,51
0,0,0,0,0,0,0,0,0,"00",0,0,0,0,0,0,1038021,"2023-12-29T00:00:00.000Z",22,FALSE,20,85,"F",22,22,"Orlando Magic","Wendell Carter Jr.",0,0,0,0,0,0
6,1,2,7,2,15,8,6,3,"31",0,4,21,2,0,3,1038021,"2023-12-29T00:00:00.000Z",22,FALSE,20,17896073,"G",22,22,"Orlando Magic","Jalen Suggs",1,23,29,27,8,32.4
5,0,4,0,0,2,2,0,0,"29",2,4,4,6,2,1,1038021,"2023-12-29T00:00:00.000Z",22,FALSE,20,56677827,"G",22,22,"Orlando Magic","Anthony Black",2,10,15,9,11,23.7
5,0,2,3,0,8,3,4,3,"23",0,2,9,2,2,1,1038021,"2023-12-29T00:00:00.000Z",22,FALSE,20,3547251,"G",22,22,"Orlando Magic","Cole Anthony",2,11,16,14,7,23.9
0,2,4,0,0,8,4,8,5,"31",3,3,13,7,1,2,1038021,"2023-12-29T00:00:00.000Z",22,FALSE,20,666442,"C",22,22,"Orlando Magic","Goga Bitadze",3,20,20,13,7,28.4
0,0,0,5,0,5,0,0,0,"21",2,1,0,2,0,1,1038021,"2023-12-29T00:00:00.000Z",22,FALSE,20,38017724,"G",22,22,"Orlando Magic","Caleb Houstan",0,2,2,0,2,1.4
1,0,0,4,0,5,1,0,0,"12",0,1,2,0,0,0,1038021,"2023-12-29T00:00:00.000Z",22,FALSE,20,666818,"F",22,22,"Orlando Magic","Chuma Okeke",0,2,3,3,1,3.5
0,0,0,0,0,0,0,0,0,"00",0,0,0,0,0,0,1038021,"2023-12-29T00:00:00.000Z",22,FALSE,20,17553983,"G",22,22,"Orlando Magic","Trevelin Queen",0,0,0,0,0,0
1,1,7,3,0,8,2,3,3,"18",4,1,7,11,0,1,1038021,"2023-12-29T00:00:00.000Z",22,FALSE,20,462,"C",22,22,"Orlando Magic","Moritz Wagner",1,18,19,8,12,23.7
0,0,0,0,0,0,0,0,0,"00",0,0,0,0,0,0,1038021,"2023-12-29T00:00:00.000Z",22,FALSE,20,165,"G",22,22,"Orlando Magic","Markelle Fultz",0,0,0,0,0,0
0,0,0,0,0,0,0,0,0,"00",0,0,0,0,0,0,1038021,"2023-12-29T00:00:00.000Z",22,FALSE,20,196,"G",22,22,"Orlando Magic","Gary Harris",0,0,0,0,0,0
0,0,0,0,0,0,0,0,0,"00",0,0,0,0,0,0,1038021,"2023-12-29T00:00:00.000Z",22,FALSE,20,38017607,"G",22,22,"Orlando Magic","Kevon Harris",0,0,0,0,0,0
0,0,0,0,0,0,0,0,0,"00",0,0,0,0,0,0,1038021,"2023-12-29T00:00:00.000Z",22,FALSE,20,56677839,"G",22,22,"Orlando Magic","Jett Howard",0,0,0,0,0,0
0,0,0,0,0,0,0,0,0,"00",0,0,0,0,0,0,1038021,"2023-12-29T00:00:00.000Z",22,FALSE,20,226,"F",22,22,"Orlando Magic","Joe Ingles",0,0,0,0,0,0
0,0,0,0,0,0,0,0,0,"00",0,0,0,0,0,0,1038021,"2023-12-29T00:00:00.000Z",22,FALSE,20,229,"F",22,22,"Orlando Magic","Jonathan Isaac",0,0,0,0,0,0
0,0,0,0,0,0,0,0,0,"00",0,0,0,0,0,0,1038021,"2023-12-29T00:00:00.000Z",22,FALSE,20,666885,"F",22,22,"Orlando Magic","Admiral Schofield",0,0,0,0,0,0
2,0,4,5,1,17,7,5,4,"37",2,4,19,6,1,2,1038021,"2023-12-29T00:00:00.000Z",22,FALSE,20,666423,"F-G",20,20,"New York Knicks","RJ Barrett",1,25,27,21,8,30.2
6,1,9,4,0,25,16,8,6,"36",3,5,38,12,0,5,1038021,"2023-12-29T00:00:00.000Z",22,FALSE,20,387,"F",20,20,"New York Knicks","Julius Randle",1,50,56,44,18,59.4
3,0,2,0,0,4,2,3,3,"25",1,4,7,3,3,2,1038021,"2023-12-29T00:00:00.000Z",22,FALSE,20,201,"F-C",20,20,"New York Knicks","Isaiah Hartenstein",3,10,13,10,6,22.1
2,1,1,5,0,7,1,0,0,"20",0,4,2,1,3,1,1038021,"2023-12-29T00:00:00.000Z",22,FALSE,20,131,"G",20,20,"New York Knicks","Donte DiVincenzo",4,3,5,4,3,17.2
0,0,0,0,0,0,0,0,0,"00",0,0,0,0,0,0,1038021,"2023-12-29T00:00:00.000Z",22,FALSE,20,NA,NA,NA,20,"New York Knicks","NA NA",0,0,0,0,0,0
0,0,0,0,0,0,0,0,0,"00",0,0,0,0,0,0,1038021,"2023-12-29T00:00:00.000Z",22,FALSE,20,666474,"G",20,20,"New York Knicks","Charles Brown",0,0,0,0,0,0
0,0,0,0,0,0,0,0,0,"00",0,0,0,0,0,0,1038021,"2023-12-29T00:00:00.000Z",22,FALSE,20,399,"C",20,20,"New York Knicks","Mitchell Robinson",0,0,0,0,0,0
0,0,0,0,0,0,0,0,0,"00",0,0,0,0,0,0,1038021,"2023-12-29T00:00:00.000Z",22,FALSE,20,17896063,"F",20,20,"New York Knicks","Jericho Sims",0,0,0,0,0,0
0,0,0,0,0,0,0,0,0,"00",0,0,0,0,0,0,1038021,"2023-12-29T00:00:00.000Z",22,FALSE,20,56677795,"F",20,20,"New York Knicks","Jacob Toppin",0,0,0,0,0,0
0,0,4,2,1,4,2,0,0,"31",0,2,5,4,0,2,1038021,"2023-12-29T00:00:00.000Z",22,FALSE,20,202,"G",20,20,"New York Knicks","Josh Hart",0,9,9,5,4,7.8
1,0,1,7,3,10,4,1,1,"28",0,4,12,1,0,1,1038021,"2023-12-29T00:00:00.000Z",22,FALSE,20,3547269,"G",20,20,"New York Knicks","Immanuel Quickley",0,13,14,13,2,13.7
0,0,2,3,1,3,1,0,0,"14",0,1,3,2,1,0,1038021,"2023-12-29T00:00:00.000Z",22,FALSE,20,17895858,"G",20,20,"New York Knicks","Quentin Grimes",1,5,5,3,2,8.4
0,1,4,0,0,1,1,0,0,"15",0,4,2,4,0,0,1038021,"2023-12-29T00:00:00.000Z",22,FALSE,20,173,"F",30,20,"New York Knicks","Taj Gibson",1,6,6,2,4,9.8
0,0,0,0,0,0,0,0,0,"00",0,0,0,0,0,0,1038021,"2023-12-29T00:00:00.000Z",22,FALSE,20,19,"G",20,20,"New York Knicks","Ryan Arcidiacono",0,0,0,0,0,0
0,0,0,0,0,0,0,0,0,"00",0,0,0,0,0,0,1038021,"2023-12-29T00:00:00.000Z",22,FALSE,20,160,"G-F",20,20,"New York Knicks","Evan Fournier",0,0,0,0,0,0
0,0,0,0,0,0,0,0,0,"00",0,0,0,0,0,0,1038021,"2023-12-29T00:00:00.000Z",22,FALSE,20,666675,"F",20,20,"New York Knicks","DaQuan Jeffries",0,0,0,0,0,0
0,0,0,0,0,0,0,0,0,"00",0,0,0,0,0,0,1038021,"2023-12-29T00:00:00.000Z",22,FALSE,20,17896033,"G",20,20,"New York Knicks","Miles McBride",0,0,0,0,0,0
8,1,7,4,0,15,4,12,12,"34",0,2,20,7,0,3,1038021,"2023-12-29T00:00:00.000Z",22,FALSE,20,73,"G",20,20,"New York Knicks","Jalen Brunson",1,27,35,28,15,40.4
2,1,4,5,1,9,4,6,3,"31",3,4,12,7,2,0,1038031,"2023-12-30T00:00:00.000Z",29,FALSE,16,38017739,"F",29,29,"Utah Jazz","Simone Fontecchio",3,19,21,14,9,32.4
1,0,3,8,1,13,4,4,3,"26",2,4,12,5,2,0,1038031,"2023-12-30T00:00:00.000Z",29,FALSE,16,297,"F",29,29,"Utah Jazz","Lauri Markkanen",2,17,18,13,6,25.5
0,0,6,6,2,11,4,0,0,"21",0,3,10,6,0,1,1038031,"2023-12-30T00:00:00.000Z",29,FALSE,16,101,"F-C",29,29,"Utah Jazz","John Collins",0,16,16,10,6,16.2
6,1,1,1,0,5,1,0,0,"18",0,3,2,1,2,1,1038031,"2023-12-30T00:00:00.000Z",29,FALSE,16,139,"G",29,29,"Utah Jazz","Kris Dunn",3,3,9,8,7,20.2
5,0,1,4,1,14,8,6,5,"26",1,1,22,2,1,3,1038031,"2023-12-30T00:00:00.000Z",29,FALSE,16,413,"G",29,29,"Utah Jazz","Collin Sexton",1,24,29,27,7,31.9
0,1,0,3,0,4,0,2,0,"15",0,1,0,0,0,0,1038031,"2023-12-30T00:00:00.000Z",29,FALSE,16,38017620,"G",29,29,"Utah Jazz","Ochai Agbaji",1,0,0,0,0,3
3,0,2,5,1,10,3,2,2,"25",0,0,9,2,0,0,1038031,"2023-12-30T00:00:00.000Z",29,FALSE,16,100,"G",29,29,"Utah Jazz","Jordan Clarkson",0,11,14,12,5,15.9
2,0,6,8,5,10,6,5,4,"28",0,3,21,6,0,2,1038031,"2023-12-30T00:00:00.000Z",29,FALSE,16,56677834,"G",29,29,"Utah Jazz","Keyonte George",0,27,29,23,8,29.2
0,0,0,0,0,0,0,0,0,"00",0,0,0,0,0,0,1038031,"2023-12-30T00:00:00.000Z",29,FALSE,16,666650,"G",29,29,"Utah Jazz","Talen Horton-Tucker",0,0,0,0,0,0
0,2,8,0,0,5,5,0,0,"23",0,1,10,8,0,0,1038031,"2023-12-30T00:00:00.000Z",29,FALSE,16,38017705,"C",29,29,"Utah Jazz","Walker Kessler",2,18,18,10,8,25.6
10,1,3,1,0,12,8,3,3,"27",3,5,19,6,1,3,1038031,"2023-12-30T00:00:00.000Z",29,FALSE,16,358,"F",29,29,"Utah Jazz","Kelly Olynyk",2,25,35,29,16,44.2
0,0,0,0,0,0,0,0,0,"00",0,0,0,0,0,0,1038031,"2023-12-30T00:00:00.000Z",29,FALSE,16,666881,"F",29,29,"Utah Jazz","Luka Samanic",0,0,0,0,0,0
0,0,0,0,0,0,0,0,0,"00",0,0,0,0,0,0,1038031,"2023-12-30T00:00:00.000Z",29,FALSE,16,11891374,"C",29,29,"Utah Jazz","Omer Yurtseven",0,0,0,0,0,0
0,0,0,0,0,0,0,0,0,"00",0,0,0,0,0,0,1038031,"2023-12-30T00:00:00.000Z",29,FALSE,16,17896023,"G",29,29,"Utah Jazz","Josh Christopher",0,0,0,0,0,0
0,0,0,0,0,0,0,0,0,"00",0,0,0,0,0,0,1038031,"2023-12-30T00:00:00.000Z",29,FALSE,16,56677824,"F",29,29,"Utah Jazz","Taylor Hendricks",0,0,0,0,0,0
0,0,0,0,0,0,0,0,0,"00",0,0,0,0,0,0,1038031,"2023-12-30T00:00:00.000Z",29,FALSE,16,38017630,"G",29,29,"Utah Jazz","Johnny Juzang",0,0,0,0,0,0
0,0,0,0,0,0,0,0,0,"00",0,0,0,0,0,0,1038031,"2023-12-30T00:00:00.000Z",29,FALSE,16,19465584,"F",29,29,"Utah Jazz","Micah Potter",0,0,0,0,0,0
0,0,0,0,0,0,0,0,0,"00",0,0,0,0,0,0,1038031,"2023-12-30T00:00:00.000Z",29,FALSE,16,56677842,"F",29,29,"Utah Jazz","Brice Sensabaugh",0,0,0,0,0,0
1,1,2,0,0,3,2,4,4,"23",0,2,8,2,0,2,1038031,"2023-12-30T00:00:00.000Z",29,FALSE,16,79,"G-F",16,16,"Miami Heat","Jimmy Butler",1,10,11,9,3,12.9
1,0,1,2,2,2,2,0,0,"10",1,5,6,2,0,1,1038031,"2023-12-30T00:00:00.000Z",29,FALSE,16,38017696,"F",16,16,"Miami Heat","Nikola Jovic",0,8,9,7,3,8.9
3,3,13,0,0,13,7,20,14,"36",3,1,28,16,3,4,1038031,"2023-12-30T00:00:00.000Z",29,FALSE,16,4,"C-F",16,16,"Miami Heat","Bam Adebayo",6,44,47,31,19,65.7
6,1,4,7,2,22,9,5,5,"39",2,2,25,6,1,1,1038031,"2023-12-30T00:00:00.000Z",29,FALSE,16,666633,"G",16,16,"Miami Heat","Tyler Herro",2,31,37,31,12,46.2
0,0,2,1,0,1,0,0,0,"08",0,1,0,2,0,1,1038031,"2023-12-30T00:00:00.000Z",29,FALSE,16,3547257,"G",16,16,"Miami Heat","R.J. Hampton",0,2,2,0,2,1.4
0,0,0,0,0,0,0,0,0,"00",0,0,0,0,0,0,1038031,"2023-12-30T00:00:00.000Z",29,FALSE,16,74,"C",16,16,"Miami Heat","Thomas Bryant",0,0,0,0,0,0
1,0,1,0,0,4,3,0,0,"11",0,2,6,1,0,1,1038031,"2023-12-30T00:00:00.000Z",29,FALSE,16,38017734,"F",16,16,"Miami Heat","Jamal Cain",0,7,8,7,2,7.7
1,1,6,4,0,5,1,2,2,"26",0,2,4,6,2,2,1038031,"2023-12-30T00:00:00.000Z",29,FALSE,16,3092,"",16,16,"Miami Heat","Haywood Highsmith",3,10,11,5,7,19.7
1,0,1,4,0,9,2,5,5,"35",0,4,9,1,0,2,1038031,"2023-12-30T00:00:00.000Z",29,FALSE,16,56677785,"G",16,16,"Miami Heat","Jaime Jaquez Jr.",0,10,11,10,2,9.7
2,0,4,8,2,11,4,4,2,"20",2,1,12,6,0,1,1038031,"2023-12-30T00:00:00.000Z",29,FALSE,16,285,"F-C",16,16,"Miami Heat","Kevin Love",0,18,20,14,8,21.2
0,0,0,0,0,0,0,0,0,"00",0,0,0,0,0,0,1038031,"2023-12-30T00:00:00.000Z",29,FALSE,16,391,"G-F",16,16,"Miami Heat","Josh Richardson",0,0,0,0,0,0
4,2,4,5,3,8,4,0,0,"32",0,4,11,4,2,1,1038031,"2023-12-30T00:00:00.000Z",29,FALSE,16,397,"F",16,16,"Miami Heat","Duncan Robinson",4,15,19,15,8,32.8
0,0,0,0,0,0,0,0,0,"00",0,0,0,0,0,0,1038031,"2023-12-30T00:00:00.000Z",29,FALSE,16,286,"G",16,16,"Miami Heat","Kyle Lowry",0,0,0,0,0,0
0,0,0,0,0,0,0,0,0,"00",0,0,0,0,0,0,1038031,"2023-12-30T00:00:00.000Z",29,FALSE,16,666747,"F",16,16,"Miami Heat","Caleb Martin",0,0,0,0,0,0
0,0,0,0,0,0,0,0,0,"00",0,0,0,0,0,0,1038031,"2023-12-30T00:00:00.000Z",29,FALSE,16,39398582,"C",16,16,"Miami Heat","Orlando Robinson",0,0,0,0,0,0
0,0,0,0,0,0,0,0,0,"00",0,0,0,0,0,0,1038031,"2023-12-30T00:00:00.000Z",29,FALSE,16,19465585,"G",16,16,"Miami Heat","Dru Smith",0,0,0,0,0,0
0,0,0,0,0,0,0,0,0,"00",0,0,0,0,0,0,1038031,"2023-12-30T00:00:00.000Z",29,FALSE,16,38017736,"F",16,16,"Miami Heat","Cole Swider",0,0,0,0,0,0
6,1,1,8,4,22,9,9,6,"41",0,3,28,1,0,4,1038033,"2023-12-30T00:00:00.000Z",12,FALSE,20,73,"G",20,20,"New York Knicks","Jalen Brunson",1,29,35,34,7,37.2
2,0,2,8,2,10,3,2,2,"17",0,0,10,2,3,1,1038033,"2023-12-30T00:00:00.000Z",12,FALSE,20,160,"G-F",20,20,"New York Knicks","Evan Fournier",3,12,14,12,4,23.4
1,0,0,0,0,3,1,0,0,"14",2,4,2,2,0,1,1038033,"2023-12-30T00:00:00.000Z",12,FALSE,20,173,"F",30,20,"New York Knicks","Taj Gibson",0,4,5,3,3,4.9
6,0,7,0,0,3,1,0,0,"33",2,3,2,9,4,1,1038033,"2023-12-30T00:00:00.000Z",12,FALSE,20,201,"F-C",20,20,"New York Knicks","Isaiah Hartenstein",4,11,17,8,15,32.8
2,1,4,11,7,21,15,1,1,"36",2,2,38,6,4,1,1038033,"2023-12-30T00:00:00.000Z",12,FALSE,20,131,"G",20,20,"New York Knicks","Donte DiVincenzo",5,44,46,40,8,62.2
2,0,1,11,7,13,8,2,2,"31",0,2,25,1,1,2,1038033,"2023-12-30T00:00:00.000Z",12,FALSE,20,3547250,"G-F",12,12,"Indiana Pacers","Aaron Nesmith",1,26,28,27,3,30.2
2,2,4,2,1,5,3,4,2,"21",0,5,9,4,0,1,1038033,"2023-12-30T00:00:00.000Z",12,FALSE,20,3547264,"F-C",12,12,"Indiana Pacers","Jalen Smith",2,13,15,11,6,21.8
2,0,7,8,6,17,10,3,2,"31",1,0,28,8,0,1,1038033,"2023-12-30T00:00:00.000Z",12,FALSE,20,452,"C-F",12,12,"Indiana Pacers","Myles Turner",0,36,38,30,10,39.6
5,0,2,4,2,10,5,2,2,"33",3,4,14,5,2,4,1038033,"2023-12-30T00:00:00.000Z",12,FALSE,20,38017507,"G-F",12,12,"Indiana Pacers","Andrew Nembhard",2,19,24,19,10,29.5
23,1,4,9,2,16,8,4,4,"36",1,0,22,5,2,2,1038033,"2023-12-30T00:00:00.000Z",12,FALSE,20,3547245,"G",12,12,"Indiana Pacers","Tyrese Haliburton",3,27,50,45,28,69.5
1,0,2,2,1,3,2,1,1,"18",0,1,6,2,1,1,1038033,"2023-12-30T00:00:00.000Z",12,FALSE,20,210,"G",12,12,"Indiana Pacers","Buddy Hield",1,8,9,7,3,11.9
0,1,1,0,0,1,1,0,0,"09",0,2,2,1,0,1,1038033,"2023-12-30T00:00:00.000Z",12,FALSE,20,17896035,"F",12,12,"Indiana Pacers","Isaiah Jackson",1,3,3,2,1,5.2
0,0,0,0,0,0,0,0,0,"00",0,0,0,0,0,0,1038033,"2023-12-30T00:00:00.000Z",12,FALSE,20,242,"F",12,12,"Indiana Pacers","James Johnson",0,0,0,0,0,0
0,0,0,5,3,10,7,3,3,"26",0,0,20,0,0,2,1038033,"2023-12-30T00:00:00.000Z",12,FALSE,20,38017686,"G-F",12,12,"Indiana Pacers","Bennedict Mathurin",0,20,20,20,0,18
3,0,0,0,0,3,2,1,1,"12",0,0,5,0,0,2,1038033,"2023-12-30T00:00:00.000Z",12,FALSE,20,304,"G",12,12,"Indiana Pacers","T.J. McConnell",0,5,8,8,3,7.5
0,0,0,0,0,0,0,0,0,"01",0,0,0,0,0,0,1038033,"2023-12-30T00:00:00.000Z",12,FALSE,20,3547207,"F",12,12,"Indiana Pacers","Jordan Nwora",0,0,0,0,0,0
0,0,0,0,0,0,0,0,0,"01",0,0,0,0,0,0,1038033,"2023-12-30T00:00:00.000Z",12,FALSE,20,56677861,"G",12,12,"Indiana Pacers","Ben Sheppard",0,0,0,0,0,0
2,3,6,1,1,6,4,1,0,"20",2,4,9,8,0,0,1038033,"2023-12-30T00:00:00.000Z",12,FALSE,20,3547243,"F",12,12,"Indiana Pacers","Obi Toppin",3,17,19,11,10,30.6
0,0,0,0,0,0,0,0,0,"01",0,0,0,0,0,0,1038033,"2023-12-30T00:00:00.000Z",12,FALSE,20,56677832,"F",12,12,"Indiana Pacers","Jarace Walker",0,0,0,0,0,0
0,0,0,0,0,0,0,0,0,"00",0,0,0,0,0,0,1038033,"2023-12-30T00:00:00.000Z",12,FALSE,20,69,"G",12,12,"Indiana Pacers","Bruce Brown",0,0,0,0,0,0
0,0,0,0,0,0,0,0,0,"00",0,0,0,0,0,0,1038033,"2023-12-30T00:00:00.000Z",12,FALSE,20,38017701,"G",12,12,"Indiana Pacers","Kendall Brown",0,0,0,0,0,0
0,0,0,0,0,0,0,0,0,"00",0,0,0,0,0,0,1038033,"2023-12-30T00:00:00.000Z",12,FALSE,20,56677778,"F-C",12,12,"Indiana Pacers","Oscar Tshiebwe",0,0,0,0,0,0
0,0,0,0,0,0,0,0,0,"00",0,0,0,0,0,0,1038033,"2023-12-30T00:00:00.000Z",12,FALSE,20,56677794,"G",12,12,"Indiana Pacers","Isaiah Wong",0,0,0,0,0,0
1,0,7,2,1,9,4,2,1,"38",3,3,10,10,1,0,1038033,"2023-12-30T00:00:00.000Z",12,FALSE,20,202,"G",20,20,"New York Knicks","Josh Hart",1,20,21,11,11,26.5
4,0,6,5,1,22,9,13,9,"39",6,1,28,12,0,5,1038033,"2023-12-30T00:00:00.000Z",12,FALSE,20,387,"F",20,20,"New York Knicks","Julius Randle",0,40,44,32,16,43.4
0,0,0,0,0,0,0,0,0,"01",0,0,0,0,0,0,1038033,"2023-12-30T00:00:00.000Z",12,FALSE,20,19,"G",20,20,"New York Knicks","Ryan Arcidiacono",0,0,0,0,0,0
0,0,0,1,1,2,1,0,0,"01",0,0,3,0,0,0,1038033,"2023-12-30T00:00:00.000Z",12,FALSE,20,666474,"G",20,20,"New York Knicks","Charles Brown",0,3,3,3,0,3
1,0,0,0,0,0,0,0,0,"01",0,0,0,0,0,0,1038033,"2023-12-30T00:00:00.000Z",12,FALSE,20,56677795,"F",20,20,"New York Knicks","Jacob Toppin",0,0,1,1,1,1.5
0,0,0,0,0,0,0,0,0,"00",0,0,0,0,0,0,1038033,"2023-12-30T00:00:00.000Z",12,FALSE,20,3547249,"F",28,20,"New York Knicks","Precious Achiuwa",0,0,0,0,0,0
0,0,0,0,0,0,0,0,0,"00",0,0,0,0,0,0,1038033,"2023-12-30T00:00:00.000Z",12,FALSE,20,18,"F",28,20,"New York Knicks","OG Anunoby",0,0,0,0,0,0
0,0,0,0,0,0,0,0,0,"00",0,0,0,0,0,0,1038033,"2023-12-30T00:00:00.000Z",12,FALSE,20,3547275,"G",28,20,"New York Knicks","Malachi Flynn",0,0,0,0,0,0
0,0,0,0,0,0,0,0,0,"00",0,0,0,0,0,0,1038033,"2023-12-30T00:00:00.000Z",12,FALSE,20,17895858,"G",20,20,"New York Knicks","Quentin Grimes",0,0,0,0,0,0
0,0,0,0,0,0,0,0,0,"00",0,0,0,0,0,0,1038033,"2023-12-30T00:00:00.000Z",12,FALSE,20,666675,"F",20,20,"New York Knicks","DaQuan Jeffries",0,0,0,0,0,0
0,0,0,0,0,0,0,0,0,"00",0,0,0,0,0,0,1038033,"2023-12-30T00:00:00.000Z",12,FALSE,20,399,"C",20,20,"New York Knicks","Mitchell Robinson",0,0,0,0,0,0
1,0,0,2,1,3,2,0,0,"18",0,3,5,0,0,0,1038033,"2023-12-30T00:00:00.000Z",12,FALSE,20,17896033,"G",20,20,"New York Knicks","Miles McBride",0,5,6,6,1,6.5
0,0,0,0,0,0,0,0,0,"00",0,0,0,0,0,0,1038033,"2023-12-30T00:00:00.000Z",12,FALSE,20,17896063,"F",20,20,"New York Knicks","Jericho Sims",0,0,0,0,0,0
0,0,0,0,0,0,0,0,0,"01",0,0,0,0,0,0,1038033,"2023-12-30T00:00:00.000Z",12,FALSE,20,NA,NA,NA,20,"New York Knicks","NA NA",0,0,0,0,0,0
2,1,3,1,0,6,2,2,2,"26",0,6,6,3,1,1,1038035,"2023-12-30T00:00:00.000Z",18,FALSE,14,3547259,"F",18,18,"Minnesota Timberwolves","Jaden McDaniels",2,9,11,8,5,17.6
2,0,7,4,1,7,3,2,2,"29",2,5,9,9,0,5,1038035,"2023-12-30T00:00:00.000Z",18,FALSE,14,447,"C",18,18,"Minnesota Timberwolves","Karl-Anthony Towns",0,18,20,11,11,17.8
0,1,9,0,0,7,6,1,1,"38",4,3,13,13,2,4,1038035,"2023-12-30T00:00:00.000Z",18,FALSE,14,176,"C",18,18,"Minnesota Timberwolves","Rudy Gobert",3,26,26,13,13,33.6
3,3,3,8,2,23,10,11,9,"38",0,3,31,3,0,3,1038035,"2023-12-30T00:00:00.000Z",18,FALSE,14,3547238,"G",18,18,"Minnesota Timberwolves","Anthony Edwards",3,34,37,34,6,45.1
7,0,3,9,4,11,4,4,3,"33",1,2,15,4,1,1,1038035,"2023-12-30T00:00:00.000Z",18,FALSE,14,104,"G",18,18,"Minnesota Timberwolves","Mike Conley",1,19,26,22,11,32.3
2,0,2,4,2,4,2,0,0,"16",0,4,6,2,1,2,1038035,"2023-12-30T00:00:00.000Z",18,FALSE,14,666400,"G",18,18,"Minnesota Timberwolves","Nickeil Alexander-Walker",1,8,10,8,4,12.4
7,1,3,1,0,4,2,0,0,"25",0,0,4,3,0,1,1038035,"2023-12-30T00:00:00.000Z",18,FALSE,14,12,"F",18,18,"Minnesota Timberwolves","Kyle Anderson",1,7,14,11,10,20.1
0,0,3,2,1,3,1,0,0,"08",0,0,3,3,1,0,1038035,"2023-12-30T00:00:00.000Z",18,FALSE,14,68,"F",18,18,"Minnesota Timberwolves","Troy Brown Jr.",1,6,6,3,3,9.6
0,0,0,0,0,0,0,0,0,"00",0,0,0,0,0,0,1038035,"2023-12-30T00:00:00.000Z",18,FALSE,14,666767,"G",18,18,"Minnesota Timberwolves","Jordan McLaughlin",0,0,0,0,0,0
0,0,0,0,0,0,0,0,0,"00",0,0,0,0,0,0,1038035,"2023-12-30T00:00:00.000Z",18,FALSE,14,320,"G",18,18,"Minnesota Timberwolves","Shake Milton",0,0,0,0,0,0
0,0,0,0,0,0,0,0,0,"00",0,0,0,0,0,0,1038035,"2023-12-30T00:00:00.000Z",18,FALSE,14,666626,"C",14,14,"Los Angeles Lakers","Jaxson Hayes",0,0,0,0,0,0
0,0,0,0,0,0,0,0,0,"00",0,0,0,0,0,0,1038035,"2023-12-30T00:00:00.000Z",18,FALSE,14,56677835,"G",14,14,"Los Angeles Lakers","Jalen Hood-Schifino",0,0,0,0,0,0
0,0,1,5,0,11,2,6,5,"29",1,2,9,2,0,1,1038035,"2023-12-30T00:00:00.000Z",18,FALSE,14,17553995,"G",14,14,"Los Angeles Lakers","Austin Reaves",0,11,11,9,2,10.4
3,0,1,1,0,4,1,4,3,"20",0,1,5,1,0,1,1038035,"2023-12-30T00:00:00.000Z",18,FALSE,14,405,"G",14,14,"Los Angeles Lakers","D'Angelo Russell",0,6,9,8,4,9.7
0,1,5,2,2,4,2,2,1,"13",0,1,7,5,0,2,1038035,"2023-12-30T00:00:00.000Z",18,FALSE,14,486,"F",14,14,"Los Angeles Lakers","Christian Wood",1,12,12,7,5,14
0,0,0,0,0,0,0,0,0,"00",0,0,0,0,0,0,1038035,"2023-12-30T00:00:00.000Z",18,FALSE,14,56677738,"C",14,14,"Los Angeles Lakers","Colin Castleton",0,0,0,0,0,0
0,0,0,0,0,0,0,0,0,"00",0,0,0,0,0,0,1038035,"2023-12-30T00:00:00.000Z",18,FALSE,14,56677867,"F",14,14,"Los Angeles Lakers","Alex Fudge",0,0,0,0,0,0
0,0,0,0,0,0,0,0,0,"00",0,0,0,0,0,0,1038035,"2023-12-30T00:00:00.000Z",18,FALSE,14,56677868,"G",14,14,"Los Angeles Lakers","D'Moi Hodge",0,0,0,0,0,0
0,0,0,0,0,0,0,0,0,"00",0,0,0,0,0,0,1038035,"2023-12-30T00:00:00.000Z",18,FALSE,14,56677836,"F",14,14,"Los Angeles Lakers","Maxwell Lewis",0,0,0,0,0,0
0,0,0,0,0,0,0,0,0,"00",0,0,0,0,0,0,1038035,"2023-12-30T00:00:00.000Z",18,FALSE,14,1603383,"G",14,14,"Los Angeles Lakers","Gabe Vincent",0,0,0,0,0,0
0,0,0,0,0,0,0,0,0,"00",0,0,0,0,0,0,1038035,"2023-12-30T00:00:00.000Z",18,FALSE,14,38017715,"F",18,18,"Minnesota Timberwolves","Josh Minott",0,0,0,0,0,0
0,0,0,0,0,0,0,0,0,"00",0,0,0,0,0,0,1038035,"2023-12-30T00:00:00.000Z",18,FALSE,14,17895968,"F",18,18,"Minnesota Timberwolves","Daishen Nix",0,0,0,0,0,0
1,2,5,5,2,11,8,4,3,"27",0,3,21,5,2,2,1038035,"2023-12-30T00:00:00.000Z",18,FALSE,14,667378,"F-C",18,18,"Minnesota Timberwolves","Naz Reid",4,26,27,22,6,38.5
0,0,0,0,0,0,0,0,0,"00",0,0,0,0,0,0,1038035,"2023-12-30T00:00:00.000Z",18,FALSE,14,56677851,"G",18,18,"Minnesota Timberwolves","Jaylen Clark",0,0,0,0,0,0
0,0,0,0,0,0,0,0,0,"00",0,0,0,0,0,0,1038035,"2023-12-30T00:00:00.000Z",18,FALSE,14,17896056,"C",18,18,"Minnesota Timberwolves","Luka Garza",0,0,0,0,0,0
0,0,0,0,0,0,0,0,0,"00",0,0,0,0,0,0,1038035,"2023-12-30T00:00:00.000Z",18,FALSE,14,56677782,"F",18,18,"Minnesota Timberwolves","Leonard Miller",0,0,0,0,0,0
0,0,0,0,0,0,0,0,0,"00",0,0,0,0,0,0,1038035,"2023-12-30T00:00:00.000Z",18,FALSE,14,38017700,"G",18,18,"Minnesota Timberwolves","Wendell Moore Jr.",0,0,0,0,0,0
4,0,2,1,0,7,2,0,0,"23",1,0,4,3,0,0,1038035,"2023-12-30T00:00:00.000Z",18,FALSE,14,666860,"F-G",14,14,"Los Angeles Lakers","Cameron Reddish",0,7,11,8,7,13.6
1,0,4,2,0,7,3,2,2,"27",1,5,8,5,2,0,1038035,"2023-12-30T00:00:00.000Z",18,FALSE,14,457,"F",14,14,"Los Angeles Lakers","Jarred Vanderbilt",2,13,14,9,6,21.5
8,2,13,2,1,17,12,10,8,"39",4,3,33,17,4,2,1038035,"2023-12-30T00:00:00.000Z",18,FALSE,14,117,"F-C",14,14,"Los Angeles Lakers","Anthony Davis",6,50,58,41,25,81.4
1,0,2,6,3,9,3,0,0,"33",0,1,9,2,3,3,1038035,"2023-12-30T00:00:00.000Z",18,FALSE,14,383,"F",14,14,"Los Angeles Lakers","Taurean Prince",3,11,12,10,3,18.9
6,1,3,4,1,21,10,7,5,"39",0,2,26,3,3,1,1038035,"2023-12-30T00:00:00.000Z",18,FALSE,14,237,"F",14,14,"Los Angeles Lakers","LeBron James",4,29,35,32,9,49.6
0,0,0,0,0,0,0,0,0,"00",0,0,0,0,0,0,1038035,"2023-12-30T00:00:00.000Z",18,FALSE,14,38017697,"G",14,14,"Los Angeles Lakers","Max Christie",0,0,0,0,0,0
0,0,0,1,0,8,2,1,1,"17",1,0,5,1,0,0,1038035,"2023-12-30T00:00:00.000Z",18,FALSE,14,666609,"F",14,14,"Los Angeles Lakers","Rui Hachimura",0,6,6,5,1,6.2
1,0,2,6,1,11,1,0,0,"26",0,0,3,2,0,1,1038036,"2023-12-30T00:00:00.000Z",10,FALSE,7,443,"G",10,10,"Golden State Warriors","Klay Thompson",0,5,6,4,3,5.9
3,0,4,5,1,12,6,4,3,"25",5,3,16,9,1,1,1038036,"2023-12-30T00:00:00.000Z",10,FALSE,7,17553979,"F",10,10,"Golden State Warriors","Jonathan Kuminga",1,25,28,19,12,33.3
2,0,3,0,0,11,8,3,1,"29",3,4,17,6,1,1,1038036,"2023-12-30T00:00:00.000Z",10,FALSE,7,56677799,"F",10,10,"Golden State Warriors","Trayce Jackson-Davis",1,23,25,19,8,29.2
6,1,2,9,6,14,9,0,0,"33",0,2,24,2,2,0,1038036,"2023-12-30T00:00:00.000Z",10,FALSE,7,367,"G",10,10,"Golden State Warriors","Chris Paul",3,26,32,30,8,44.4
7,0,2,15,6,25,9,1,1,"35",0,3,25,2,1,3,1038036,"2023-12-30T00:00:00.000Z",10,FALSE,7,115,"G",10,10,"Golden State Warriors","Stephen Curry",1,27,34,32,9,37.9
0,0,0,0,0,0,0,0,0,"00",0,0,0,0,0,0,1038036,"2023-12-30T00:00:00.000Z",10,FALSE,7,17896070,"F",10,10,"Golden State Warriors","Usman Garuba",0,0,0,0,0,0
0,0,0,0,0,0,0,0,0,"00",0,0,0,0,0,0,1038036,"2023-12-30T00:00:00.000Z",10,FALSE,7,185,"F",10,10,"Golden State Warriors","Draymond Green",0,0,0,0,0,0
0,0,0,0,0,0,0,0,0,"00",0,0,0,0,0,0,1038036,"2023-12-30T00:00:00.000Z",10,FALSE,7,251,"G",10,10,"Golden State Warriors","Cory Joseph",0,0,0,0,0,0
1,0,1,0,0,2,2,2,1,"11",2,2,5,3,0,0,1038036,"2023-12-30T00:00:00.000Z",10,FALSE,7,282,"F",10,10,"Golden State Warriors","Kevon Looney",0,8,9,6,4,10.1
0,0,0,0,0,0,0,0,0,"00",0,0,0,0,0,0,1038036,"2023-12-30T00:00:00.000Z",10,FALSE,7,17553992,"G",10,10,"Golden State Warriors","Moses Moody",0,0,0,0,0,0
0,1,0,1,0,3,1,0,0,"09",0,3,2,0,0,0,1038036,"2023-12-30T00:00:00.000Z",10,FALSE,7,2189,"",10,10,"Golden State Warriors","Gary Payton II",1,2,2,2,0,5
4,0,8,5,3,8,5,0,0,"29",1,1,13,9,1,2,1038036,"2023-12-30T00:00:00.000Z",10,FALSE,7,56677858,"G",10,10,"Golden State Warriors","Brandin Podziemski",1,22,26,17,13,30.8
0,0,0,0,0,0,0,0,0,"00",0,0,0,0,0,0,1038036,"2023-12-30T00:00:00.000Z",10,FALSE,7,45658838,"G",10,10,"Golden State Warriors","Lester Quinones",0,0,0,0,0,0
0,0,0,0,0,0,0,0,0,"00",0,0,0,0,0,0,1038036,"2023-12-30T00:00:00.000Z",10,FALSE,7,398,"G",10,10,"Golden State Warriors","Jerome Robinson",0,0,0,0,0,0
0,0,0,0,0,0,0,0,0,"00",0,0,0,0,0,0,1038036,"2023-12-30T00:00:00.000Z",10,FALSE,7,57875092,"F",10,10,"Golden State Warriors","Gui Santos",0,0,0,0,0,0
4,0,7,4,1,4,1,0,0,"15",2,1,3,9,1,2,1038036,"2023-12-30T00:00:00.000Z",10,FALSE,7,407,"F",10,10,"Golden State Warriors","Dario Saric",1,12,16,7,13,20.8
4,1,2,3,1,13,5,3,3,"28",3,2,14,5,1,0,1038036,"2023-12-30T00:00:00.000Z",10,FALSE,7,475,"F-G",10,10,"Golden State Warriors","Andrew Wiggins",2,19,23,18,9,32
5,0,0,5,3,12,8,0,0,"34",0,1,19,0,1,1,1038036,"2023-12-30T00:00:00.000Z",10,FALSE,7,151,"G",7,7,"Dallas Mavericks","Dante Exum",1,19,24,24,5,28.5
1,1,3,3,0,7,3,2,1,"24",2,1,7,5,2,1,1038036,"2023-12-30T00:00:00.000Z",10,FALSE,7,247,"F-G",7,7,"Dallas Mavericks","Derrick Jones Jr.",3,12,13,8,6,22.5
1,0,13,0,0,7,5,3,2,"35",1,2,12,14,0,1,1038036,"2023-12-30T00:00:00.000Z",10,FALSE,7,56677840,"C",7,7,"Dallas Mavericks","Dereck Lively II",0,26,27,13,15,29.3
0,0,2,5,1,8,4,0,0,"24",0,2,9,2,0,1,1038036,"2023-12-30T00:00:00.000Z",10,FALSE,7,38017679,"G",7,7,"Dallas Mavericks","Jaden Hardy",0,11,11,9,2,10.4
10,1,8,13,5,29,14,7,6,"37",0,3,39,8,1,4,1038036,"2023-12-30T00:00:00.000Z",10,FALSE,7,132,"F-G",7,7,"Dallas Mavericks","Luka Doncic",2,47,57,49,18,65.6
0,0,0,0,0,0,0,0,0,"00",0,0,0,0,0,0,1038036,"2023-12-30T00:00:00.000Z",10,FALSE,7,17896028,"F",7,7,"Dallas Mavericks","Greg Brown III",0,0,0,0,0,0
0,0,0,0,0,0,0,0,0,"00",0,0,0,0,0,0,1038036,"2023-12-30T00:00:00.000Z",10,FALSE,7,114,"G",7,7,"Dallas Mavericks","Seth Curry",0,0,0,0,0,0
2,0,0,4,3,8,6,3,3,"25",0,0,18,0,0,1,1038036,"2023-12-30T00:00:00.000Z",10,FALSE,7,3547258,"G",7,7,"Dallas Mavericks","Josh Green",0,18,20,20,2,20
5,0,6,8,2,12,5,5,4,"29",0,2,16,6,0,0,1038036,"2023-12-30T00:00:00.000Z",10,FALSE,7,191,"G",7,7,"Dallas Mavericks","Tim Hardaway Jr.",0,22,27,21,11,30.7
0,0,0,0,0,0,0,0,0,"00",0,0,0,0,0,0,1038036,"2023-12-30T00:00:00.000Z",10,FALSE,7,217,"F-C",7,7,"Dallas Mavericks","Richaun Holmes",0,0,0,0,0,0
0,0,0,0,0,0,0,0,0,"00",0,0,0,0,0,0,1038036,"2023-12-30T00:00:00.000Z",10,FALSE,7,228,"G",7,7,"Dallas Mavericks","Kyrie Irving",0,0,0,0,0,0
0,0,0,0,0,0,0,0,0,"00",0,0,0,0,0,0,1038036,"2023-12-30T00:00:00.000Z",10,FALSE,7,257,"F",7,7,"Dallas Mavericks","Maxi Kleber",0,0,0,0,0,0
0,0,0,0,0,0,0,0,0,"00",0,0,0,0,0,0,1038036,"2023-12-30T00:00:00.000Z",10,FALSE,7,17554004,"G",7,7,"Dallas Mavericks","AJ Lawson",0,0,0,0,0,0
0,0,0,0,0,0,0,0,0,"00",0,0,0,0,0,0,1038036,"2023-12-30T00:00:00.000Z",10,FALSE,7,329,"F",7,7,"Dallas Mavericks","Markieff Morris",0,0,0,0,0,0
1,0,0,0,0,2,1,0,0,"13",2,2,2,2,0,0,1038036,"2023-12-30T00:00:00.000Z",10,FALSE,7,379,"F-C",7,7,"Dallas Mavericks","Dwight Powell",0,4,5,3,3,5.9
0,0,0,0,0,0,0,0,0,"00",0,0,0,0,0,0,1038036,"2023-12-30T00:00:00.000Z",10,FALSE,7,56677859,"F",7,7,"Dallas Mavericks","Olivier-Maxence Prosper",0,0,0,0,0,0
0,0,0,0,0,0,0,0,0,"00",0,0,0,0,0,0,1038036,"2023-12-30T00:00:00.000Z",10,FALSE,7,24489167,"G",25,7,"Dallas Mavericks","Brandon Williams",0,0,0,0,0,0
0,0,5,2,2,3,3,2,2,"19",1,1,10,6,1,0,1038036,"2023-12-30T00:00:00.000Z",10,FALSE,7,666965,"F",7,7,"Dallas Mavericks","Grant Williams",1,16,16,10,6,20.2
3,0,7,6,2,14,7,5,3,"37",0,2,19,7,0,4,1038032,"2023-12-30T00:00:00.000Z",9,FALSE,28,54,"F",9,9,"Detroit Pistons","Bojan Bogdanovic",0,26,29,22,10,27.9
2,1,2,8,3,14,7,0,0,"31",0,2,17,2,1,1,1038032,"2023-12-30T00:00:00.000Z",9,FALSE,28,259,"F",9,9,"Detroit Pistons","Kevin Knox",2,19,21,19,4,27.4
2,0,15,0,0,11,6,6,6,"34",2,5,18,17,0,1,1038032,"2023-12-30T00:00:00.000Z",9,FALSE,28,38017694,"C",9,9,"Detroit Pistons","Jalen Duren",0,35,37,20,19,40.4
4,0,1,3,1,5,1,12,9,"29",4,2,12,5,1,1,1038032,"2023-12-30T00:00:00.000Z",9,FALSE,28,38017682,"G",9,9,"Detroit Pistons","Jaden Ivey",1,17,21,16,9,26
12,0,3,4,2,20,9,10,10,"38",0,4,30,3,1,0,1038032,"2023-12-30T00:00:00.000Z",9,FALSE,28,17896075,"G-F",9,9,"Detroit Pistons","Cade Cunningham",1,33,45,42,15,54.6
0,0,0,0,0,0,0,0,0,"00",0,0,0,0,0,0,1038032,"2023-12-30T00:00:00.000Z",9,FALSE,28,24,"F",9,9,"Detroit Pistons","Marvin Bagley III",0,0,0,0,0,0
1,0,0,3,3,6,4,5,5,"19",0,0,16,0,0,0,1038032,"2023-12-30T00:00:00.000Z",9,FALSE,28,77,"G",9,9,"Detroit Pistons","Alec Burks",0,16,17,17,1,17.5
0,0,0,0,0,0,0,0,0,"00",0,0,0,0,0,0,1038032,"2023-12-30T00:00:00.000Z",9,FALSE,28,197,"F-G",9,9,"Detroit Pistons","Joe Harris",0,0,0,0,0,0
4,0,1,0,0,2,0,0,0,"10",0,2,0,1,1,3,1038032,"2023-12-30T00:00:00.000Z",9,FALSE,28,3547241,"G",9,9,"Detroit Pistons","Killian Hayes",1,1,5,4,5,7.2
1,0,1,2,1,2,1,0,0,"17",0,3,3,1,0,1,1038032,"2023-12-30T00:00:00.000Z",9,FALSE,28,17896071,"F",9,9,"Detroit Pistons","Isaiah Livers",0,4,5,4,2,4.7
0,0,0,0,0,0,0,0,0,"00",0,0,0,0,0,0,1038032,"2023-12-30T00:00:00.000Z",9,FALSE,28,56677792,"G",9,9,"Detroit Pistons","Marcus Sasser",0,0,0,0,0,0
0,0,1,2,0,4,2,2,2,"12",0,1,6,1,0,0,1038032,"2023-12-30T00:00:00.000Z",9,FALSE,28,56677826,"G-F",9,9,"Detroit Pistons","Ausar Thompson",0,7,7,6,1,7.2
0,3,4,0,0,4,4,0,0,"13",0,1,8,4,0,0,1038032,"2023-12-30T00:00:00.000Z",9,FALSE,28,3547240,"C",9,9,"Detroit Pistons","James Wiseman",3,12,12,8,4,21.8
0,0,0,0,0,0,0,0,0,"00",0,0,0,0,0,0,1038032,"2023-12-30T00:00:00.000Z",9,FALSE,28,56677729,"G",9,9,"Detroit Pistons","Malcolm Cazalon",0,0,0,0,0,0
0,0,0,0,0,0,0,0,0,"00",0,0,0,0,0,0,1038032,"2023-12-30T00:00:00.000Z",9,FALSE,28,330,"G",9,9,"Detroit Pistons","Monte Morris",0,0,0,0,0,0
0,0,0,0,0,0,0,0,0,"00",0,0,0,0,0,0,1038032,"2023-12-30T00:00:00.000Z",9,FALSE,28,42097199,"G",9,9,"Detroit Pistons","Jared Rhoden",0,0,0,0,0,0
0,0,0,0,0,0,0,0,0,"00",0,0,0,0,0,0,1038032,"2023-12-30T00:00:00.000Z",9,FALSE,28,3547267,"F-C",9,9,"Detroit Pistons","Isaiah Stewart",0,0,0,0,0,0
0,0,0,0,0,0,0,0,0,"00",0,0,0,0,0,0,1038032,"2023-12-30T00:00:00.000Z",9,FALSE,28,44477024,"G",9,9,"Detroit Pistons","Stanley Umude",0,0,0,0,0,0
2,1,7,5,1,20,8,5,5,"36",2,4,22,9,2,1,1038032,"2023-12-30T00:00:00.000Z",9,FALSE,28,17896055,"G-F",28,28,"Toronto Raptors","Scottie Barnes",3,31,33,24,11,43.8
4,0,4,2,2,24,14,8,5,"40",1,5,35,5,0,2,1038032,"2023-12-30T00:00:00.000Z",9,FALSE,28,416,"F",28,28,"Toronto Raptors","Pascal Siakam",0,40,44,39,9,45
5,3,12,0,0,4,2,0,0,"35",2,4,4,14,1,0,1038032,"2023-12-30T00:00:00.000Z",9,FALSE,28,373,"C",28,28,"Toronto Raptors","Jakob Poeltl",4,18,23,9,19,40.3
4,1,1,9,6,16,8,2,2,"39",0,3,24,1,4,0,1038032,"2023-12-30T00:00:00.000Z",9,FALSE,28,3089,"",28,28,"Toronto Raptors","Gary Trent Jr.",5,25,29,28,5,46.2
9,0,0,6,3,18,11,5,5,"37",0,1,30,0,0,1,1038032,"2023-12-30T00:00:00.000Z",9,FALSE,28,409,"G",28,28,"Toronto Raptors","Dennis Schroder",0,30,39,39,9,42.5
0,0,2,1,0,1,0,6,4,"17",0,2,4,2,0,0,1038032,"2023-12-30T00:00:00.000Z",9,FALSE,28,58,"F",28,28,"Toronto Raptors","Chris Boucher",0,6,6,4,2,6.4
0,0,0,0,0,0,0,0,0,"00",0,0,0,0,0,0,1038032,"2023-12-30T00:00:00.000Z",9,FALSE,28,56677828,"G",28,28,"Toronto Raptors","Gradey Dick",0,0,0,0,0,0
0,0,1,1,0,3,0,2,2,"17",0,3,2,1,0,1,1038032,"2023-12-30T00:00:00.000Z",9,FALSE,28,666762,"F",28,28,"Toronto Raptors","Jalen McDaniels",0,3,3,2,1,2.2
1,0,0,0,0,0,0,0,0,"08",0,2,0,0,0,0,1038032,"2023-12-30T00:00:00.000Z",9,FALSE,28,376,"F",28,28,"Toronto Raptors","Otto Porter Jr.",0,0,1,1,1,1.5
0,0,0,0,0,0,0,0,0,"00",0,0,0,0,0,0,1038032,"2023-12-30T00:00:00.000Z",9,FALSE,28,436,"G-F",28,28,"Toronto Raptors","Garrett Temple",0,0,0,0,0,0
1,0,0,0,0,5,3,0,0,"11",1,3,6,1,2,2,1038032,"2023-12-30T00:00:00.000Z",9,FALSE,28,489,"F",28,28,"Toronto Raptors","Thaddeus Young",2,7,8,7,2,12.7
0,0,0,0,0,0,0,0,0,"00",0,0,0,0,0,0,1038032,"2023-12-30T00:00:00.000Z",9,FALSE,28,666423,"F-G",20,28,"Toronto Raptors","RJ Barrett",0,0,0,0,0,0
0,0,0,0,0,0,0,0,0,"00",0,0,0,0,0,0,1038032,"2023-12-30T00:00:00.000Z",9,FALSE,28,56677805,"G",28,28,"Toronto Raptors","Javon Freeman-Liberty",0,0,0,0,0,0
0,0,0,0,0,0,0,0,0,"00",0,0,0,0,0,0,1038032,"2023-12-30T00:00:00.000Z",9,FALSE,28,38017710,"C",28,28,"Toronto Raptors","Christian Koloko",0,0,0,0,0,0
0,0,0,0,0,0,0,0,0,"00",0,0,0,0,0,0,1038032,"2023-12-30T00:00:00.000Z",9,FALSE,28,56677869,"G",28,28,"Toronto Raptors","Markquis Nowell",0,0,0,0,0,0
0,0,0,0,0,0,0,0,0,"00",0,0,0,0,0,0,1038032,"2023-12-30T00:00:00.000Z",9,FALSE,28,2309958,"C-F",15,28,"Toronto Raptors","Jontay Porter",0,0,0,0,0,0
0,0,0,0,0,0,0,0,0,"00",0,0,0,0,0,0,1038032,"2023-12-30T00:00:00.000Z",9,FALSE,28,3547269,"G",20,28,"Toronto Raptors","Immanuel Quickley",0,0,0,0,0,0
2,0,3,0,0,3,2,1,1,"13",2,0,5,5,0,1,1038034,"2023-12-30T00:00:00.000Z",5,FALSE,23,28,"C",23,23,"Philadelphia 76ers","Mo Bamba",0,10,12,7,7,13
2,0,3,5,3,6,3,0,0,"19",0,1,9,3,0,1,1038034,"2023-12-30T00:00:00.000Z",5,FALSE,23,33,"F-G",23,23,"Philadelphia 76ers","Nicolas Batum",0,12,14,11,5,14.6
3,2,2,2,0,4,1,2,2,"24",0,4,4,2,1,1,1038034,"2023-12-30T00:00:00.000Z",5,FALSE,23,45,"G",23,23,"Philadelphia 76ers","Patrick Beverley",3,6,9,7,5,18.9
0,0,1,1,0,1,0,0,0,"05",0,0,0,1,0,0,1038034,"2023-12-30T00:00:00.000Z",5,FALSE,23,108,"F",23,23,"Philadelphia 76ers","Robert Covington",0,1,1,0,1,1.2
0,0,0,0,0,0,0,0,0,"00",0,0,0,0,0,0,1038034,"2023-12-30T00:00:00.000Z",5,FALSE,23,2175,"",23,23,"Philadelphia 76ers","Danuel House Jr.",0,0,0,0,0,0
0,0,0,0,0,1,1,0,0,"02",0,0,2,0,0,0,1038034,"2023-12-30T00:00:00.000Z",5,FALSE,23,260,"G-F",23,23,"Philadelphia 76ers","Furkan Korkmaz",0,2,2,2,0,2
0,0,1,1,0,2,1,0,0,"08",0,0,2,1,0,0,1038034,"2023-12-30T00:00:00.000Z",5,FALSE,23,3547294,"F",23,23,"Philadelphia 76ers","Kenyon Martin Jr.",0,3,3,2,1,3.2
1,0,2,2,0,5,2,0,0,"17",0,3,4,2,0,1,1038034,"2023-12-30T00:00:00.000Z",5,FALSE,23,328,"F",23,23,"Philadelphia 76ers","Marcus Morris",0,6,7,5,3,6.9
0,0,0,0,0,0,0,0,0,"00",0,0,0,0,0,0,1038034,"2023-12-30T00:00:00.000Z",5,FALSE,23,56913527,"G",23,23,"Philadelphia 76ers","Ricky Council IV",0,0,0,0,0,0
0,0,0,0,0,0,0,0,0,"00",0,0,0,0,0,0,1038034,"2023-12-30T00:00:00.000Z",5,FALSE,23,145,"F-C",23,23,"Philadelphia 76ers","Joel Embiid",0,0,0,0,0,0
0,0,0,0,0,0,0,0,0,"00",0,0,0,0,0,0,1038034,"2023-12-30T00:00:00.000Z",5,FALSE,23,38017732,"F",15,23,"Philadelphia 76ers","Kenneth Lofton Jr.",0,0,0,0,0,0
0,0,0,0,0,0,0,0,0,"00",0,0,0,0,0,0,1038034,"2023-12-30T00:00:00.000Z",5,FALSE,23,56677788,"G",23,23,"Philadelphia 76ers","Terquavion Smith",0,0,0,0,0,0
0,0,0,0,0,0,0,0,0,"00",0,0,0,0,0,0,1038034,"2023-12-30T00:00:00.000Z",5,FALSE,23,17896025,"G",23,23,"Philadelphia 76ers","Jaden Springer",0,0,0,0,0,0
0,0,3,9,3,9,3,0,0,"26",0,4,9,3,4,0,1038034,"2023-12-30T00:00:00.000Z",5,FALSE,23,313,"G",23,23,"Philadelphia 76ers","De'Anthony Melton",4,12,12,9,3,24.6
7,0,0,8,2,22,8,5,2,"36",0,4,20,0,1,2,1038034,"2023-12-30T00:00:00.000Z",5,FALSE,23,3547254,"G",23,23,"Philadelphia 76ers","Tyrese Maxey",1,20,27,27,7,31.5
4,0,6,2,0,17,9,7,6,"37",0,0,24,6,0,2,1038034,"2023-12-30T00:00:00.000Z",5,FALSE,23,125,"G",5,5,"Chicago Bulls","DeMar DeRozan",0,30,34,28,10,35.2
3,0,1,3,1,11,6,0,0,"33",2,0,13,3,0,2,1038034,"2023-12-30T00:00:00.000Z",5,FALSE,23,3547248,"F",5,5,"Chicago Bulls","Patrick Williams",0,16,19,16,6,19.1
2,3,20,0,0,8,6,10,3,"30",3,4,15,23,2,3,1038034,"2023-12-30T00:00:00.000Z",5,FALSE,23,137,"C",5,5,"Chicago Bulls","Andre Drummond",5,38,40,17,25,57.6
5,1,2,5,3,7,4,5,3,"28",0,2,14,2,1,3,1038034,"2023-12-30T00:00:00.000Z",5,FALSE,23,89,"G",5,5,"Chicago Bulls","Alex Caruso",2,16,21,19,7,26.9
2,0,6,5,1,15,7,6,5,"40",2,3,20,8,0,5,1038034,"2023-12-30T00:00:00.000Z",5,FALSE,23,666956,"G",5,5,"Chicago Bulls","Coby White",0,28,30,22,10,27.6
1,0,2,4,1,5,1,2,1,"13",0,3,4,2,1,0,1038034,"2023-12-30T00:00:00.000Z",5,FALSE,23,87,"G",5,5,"Chicago Bulls","Jevon Carter",1,6,7,5,3,10.9
0,0,0,0,0,0,0,0,0,"00",0,0,0,0,0,0,1038034,"2023-12-30T00:00:00.000Z",5,FALSE,23,110,"F",5,5,"Chicago Bulls","Torrey Craig",0,0,0,0,0,0
2,1,1,4,0,11,3,0,0,"29",2,2,6,3,0,0,1038034,"2023-12-30T00:00:00.000Z",5,FALSE,23,17895983,"G",5,5,"Chicago Bulls","Ayo Dosunmu",1,9,11,8,5,15.6
0,0,0,0,0,0,0,0,0,"01",0,0,0,0,0,0,1038034,"2023-12-30T00:00:00.000Z",5,FALSE,23,56677857,"F",5,5,"Chicago Bulls","Julian Phillips",0,0,0,0,0,0
0,0,0,0,0,0,0,0,0,"00",0,0,0,0,0,0,1038034,"2023-12-30T00:00:00.000Z",5,FALSE,23,56677860,"F",5,5,"Chicago Bulls","Adama Sanogo",0,0,0,0,0,0
2,0,3,0,0,3,3,0,0,"17",3,0,6,6,1,0,1038034,"2023-12-30T00:00:00.000Z",5,FALSE,23,17896116,"G",5,5,"Chicago Bulls","Terry Taylor",1,12,14,8,8,19.2
0,0,0,2,1,2,1,0,0,"12",0,1,3,0,0,1,1038034,"2023-12-30T00:00:00.000Z",5,FALSE,23,38017719,"F",5,5,"Chicago Bulls","Dalen Terry",0,3,3,3,0,2
0,0,0,0,0,0,0,0,0,"00",0,0,0,0,0,0,1038034,"2023-12-30T00:00:00.000Z",5,FALSE,23,27,"G",5,5,"Chicago Bulls","Lonzo Ball",0,0,0,0,0,0
0,0,0,0,0,0,0,0,0,"00",0,0,0,0,0,0,1038034,"2023-12-30T00:00:00.000Z",5,FALSE,23,56677874,"F",5,5,"Chicago Bulls","Onuralp Bitim",0,0,0,0,0,0
0,0,0,0,0,0,0,0,0,"00",0,0,0,0,0,0,1038034,"2023-12-30T00:00:00.000Z",5,FALSE,23,NA,NA,NA,5,"Chicago Bulls","NA NA",0,0,0,0,0,0
0,0,0,0,0,0,0,0,0,"00",0,0,0,0,0,0,1038034,"2023-12-30T00:00:00.000Z",5,FALSE,23,268,"G",5,5,"Chicago Bulls","Zach LaVine",0,0,0,0,0,0
0,0,0,0,0,0,0,0,0,"00",0,0,0,0,0,0,1038034,"2023-12-30T00:00:00.000Z",5,FALSE,23,460,"C",5,5,"Chicago Bulls","Nikola Vucevic",0,0,0,0,0,0
2,1,2,5,0,13,5,1,1,"28",3,2,11,5,2,0,1038034,"2023-12-30T00:00:00.000Z",5,FALSE,23,360,"F",23,23,"Philadelphia 76ers","Kelly Oubre Jr.",3,16,18,13,7,29
4,1,4,3,0,16,6,4,3,"34",3,1,15,7,0,0,1038034,"2023-12-30T00:00:00.000Z",5,FALSE,23,200,"F",23,23,"Philadelphia 76ers","Tobias Harris",1,22,26,19,11,32.4
3,1,3,2,1,10,4,2,2,"28",4,3,11,7,4,1,1038034,"2023-12-30T00:00:00.000Z",5,FALSE,23,3547270,"F",23,23,"Philadelphia 76ers","Paul Reed",5,18,21,14,10,37.9
0,0,0,0,0,0,0,0,0,"00",0,0,0,0,0,0,1038037,"2023-12-31T00:00:00.000Z",30,FALSE,1,301,"G-F",1,1,"Atlanta Hawks","Wesley Matthews",0,0,0,0,0,0
0,0,2,1,0,1,0,0,0,"08",0,0,0,2,0,0,1038037,"2023-12-31T00:00:00.000Z",30,FALSE,1,319,"G",1,1,"Atlanta Hawks","Patty Mills",0,2,2,0,2,2.4
0,0,0,0,0,0,0,0,0,"00",0,0,0,0,0,0,1038037,"2023-12-31T00:00:00.000Z",30,FALSE,1,56677838,"G",1,1,"Atlanta Hawks","Kobe Bufkin",0,0,0,0,0,0
0,0,0,0,0,0,0,0,0,"00",0,0,0,0,0,0,1038037,"2023-12-31T00:00:00.000Z",30,FALSE,1,56677806,"F",1,1,"Atlanta Hawks","Mouhamed Gueye",0,0,0,0,0,0
0,0,0,0,0,0,0,0,0,"00",0,0,0,0,0,0,1038037,"2023-12-31T00:00:00.000Z",30,FALSE,1,666656,"F",1,1,"Atlanta Hawks","De'Andre Hunter",0,0,0,0,0,0
0,0,0,0,0,0,0,0,0,"00",0,0,0,0,0,0,1038037,"2023-12-31T00:00:00.000Z",30,FALSE,1,4197387,"G",1,1,"Atlanta Hawks","Vit Krejci",0,0,0,0,0,0
0,0,0,0,0,0,0,0,0,"00",0,0,0,0,0,0,1038037,"2023-12-31T00:00:00.000Z",30,FALSE,1,56677855,"G",1,1,"Atlanta Hawks","Seth Lundy",0,0,0,0,0,0
0,0,0,0,0,0,0,0,0,"00",0,0,0,0,0,0,1038037,"2023-12-31T00:00:00.000Z",30,FALSE,1,3547244,"F-C",1,1,"Atlanta Hawks","Onyeka Okongwu",0,0,0,0,0,0
0,1,8,5,2,10,4,3,1,"32",3,3,11,11,0,1,1038037,"2023-12-31T00:00:00.000Z",30,FALSE,1,3547256,"F",1,1,"Atlanta Hawks","Saddiq Bey",1,22,22,11,11,26.2
3,1,10,0,0,11,5,4,1,"33",7,4,11,17,1,2,1038037,"2023-12-31T00:00:00.000Z",30,FALSE,1,83,"C",1,1,"Atlanta Hawks","Clint Capela",2,28,31,14,20,39.9
3,0,5,6,3,21,13,5,3,"34",1,1,32,6,0,1,1038037,"2023-12-31T00:00:00.000Z",30,FALSE,1,334,"G",1,1,"Atlanta Hawks","Dejounte Murray",0,38,41,35,9,42.7
13,0,3,8,4,19,11,19,14,"40",0,2,40,3,3,5,1038037,"2023-12-31T00:00:00.000Z",30,FALSE,1,490,"G",1,1,"Atlanta Hawks","Trae Young",3,43,56,53,16,67.1
1,0,1,8,1,19,5,1,1,"27",0,1,12,1,0,0,1038037,"2023-12-31T00:00:00.000Z",30,FALSE,1,53,"G",1,1,"Atlanta Hawks","Bogdan Bogdanovic",0,13,14,13,2,14.7
2,0,3,0,0,2,0,0,0,"15",0,4,0,3,1,1,1038037,"2023-12-31T00:00:00.000Z",30,FALSE,1,666564,"F",1,1,"Atlanta Hawks","Bruno Fernando",1,3,5,2,5,8.6
0,0,0,0,0,0,0,0,0,"00",0,0,0,0,0,0,1038037,"2023-12-31T00:00:00.000Z",30,FALSE,1,3547297,"G",1,1,"Atlanta Hawks","Trent Forrest",0,0,0,0,0,0
0,0,0,0,0,0,0,0,0,"00",0,0,0,0,0,0,1038037,"2023-12-31T00:00:00.000Z",30,FALSE,1,38017689,"F",1,1,"Atlanta Hawks","AJ Griffin",0,0,0,0,0,0
1,1,1,0,0,0,0,0,0,"14",1,1,0,2,0,0,1038037,"2023-12-31T00:00:00.000Z",30,FALSE,1,666754,"G",1,1,"Atlanta Hawks","Garrison Mathews",1,2,3,1,3,6.9
2,1,11,6,2,9,5,8,5,"31",1,5,17,12,1,3,1038037,"2023-12-31T00:00:00.000Z",30,FALSE,1,3547242,"F",30,30,"Washington Wizards","Deni Avdija",2,29,31,19,14,37.4
5,0,6,18,7,31,15,1,1,"34",2,4,38,8,0,2,1038037,"2023-12-31T00:00:00.000Z",30,FALSE,1,265,"F",30,30,"Washington Wizards","Kyle Kuzma",0,46,51,43,13,53.1
0,4,7,0,0,4,3,4,4,"28",2,2,10,9,2,0,1038037,"2023-12-31T00:00:00.000Z",30,FALSE,1,666577,"F",30,30,"Washington Wizards","Daniel Gafford",6,19,19,10,9,38.8
6,1,3,7,1,14,6,0,0,"29",0,3,13,3,0,0,1038037,"2023-12-31T00:00:00.000Z",30,FALSE,1,666848,"G",30,30,"Washington Wizards","Jordan Poole",1,16,22,19,9,28.6
7,1,0,7,3,11,5,1,1,"27",0,1,14,0,1,1,1038037,"2023-12-31T00:00:00.000Z",30,FALSE,1,249,"G",30,30,"Washington Wizards","Tyus Jones",2,14,21,21,7,29.5
0,0,0,0,0,0,0,0,0,"00",0,0,0,0,0,0,1038037,"2023-12-31T00:00:00.000Z",30,FALSE,1,NA,NA,NA,30,"Washington Wizards","NA NA",0,0,0,0,0,0
3,0,3,1,0,3,0,2,2,"17",1,2,2,4,0,0,1038037,"2023-12-31T00:00:00.000Z",30,FALSE,1,56677844,"G",30,30,"Washington Wizards","Bilal Coulibaly",0,6,9,5,7,11.3
0,0,0,0,0,0,0,0,0,"00",0,0,0,0,0,0,1038037,"2023-12-31T00:00:00.000Z",30,FALSE,1,38017687,"G",30,30,"Washington Wizards","Johnny Davis",0,0,0,0,0,0
0,0,0,0,0,0,0,0,0,"00",0,0,0,0,0,0,1038037,"2023-12-31T00:00:00.000Z",30,FALSE,1,3547302,"F",30,30,"Washington Wizards","Anthony Gill",0,0,0,0,0,0
4,0,0,5,1,10,5,5,4,"18",0,0,15,0,0,0,1038037,"2023-12-31T00:00:00.000Z",30,FALSE,1,17896045,"F",30,30,"Washington Wizards","Corey Kispert",0,15,19,19,4,21
3,0,4,5,2,8,4,0,0,"20",0,1,10,4,0,0,1038037,"2023-12-31T00:00:00.000Z",30,FALSE,1,337,"F-C",30,30,"Washington Wizards","Mike Muscala",0,14,17,13,7,19.3
0,0,0,0,0,0,0,0,0,"00",0,0,0,0,0,0,1038037,"2023-12-31T00:00:00.000Z",30,FALSE,1,17896106,"F",30,30,"Washington Wizards","Eugene Omoruyi",0,0,0,0,0,0
0,0,0,0,0,0,0,0,0,"00",0,0,0,0,0,0,1038037,"2023-12-31T00:00:00.000Z",30,FALSE,1,38017712,"G",30,30,"Washington Wizards","Ryan Rollins",0,0,0,0,0,0
2,2,2,2,0,6,2,0,0,"18",0,1,4,2,1,0,1038037,"2023-12-31T00:00:00.000Z",30,FALSE,1,414,"G",30,30,"Washington Wizards","Landry Shamet",3,6,8,6,4,18.4
2,0,0,2,1,2,1,0,0,"18",0,2,3,0,0,3,1038037,"2023-12-31T00:00:00.000Z",30,FALSE,1,487,"G",30,30,"Washington Wizards","Delon Wright",0,3,5,5,2,3
0,0,0,0,0,0,0,0,0,"00",0,0,0,0,0,0,1038037,"2023-12-31T00:00:00.000Z",30,FALSE,1,38017704,"F",30,30,"Washington Wizards","Patrick Baldwin Jr.",0,0,0,0,0,0
0,0,0,0,0,0,0,0,0,"00",0,0,0,0,0,0,1038037,"2023-12-31T00:00:00.000Z",30,FALSE,1,18677954,"G",30,30,"Washington Wizards","Jared Butler",0,0,0,0,0,0
0,0,0,0,0,0,0,0,0,"00",0,0,0,0,0,0,1038037,"2023-12-31T00:00:00.000Z",30,FALSE,1,167,"F",30,30,"Washington Wizards","Danilo Gallinari",0,0,0,0,0,0
4,0,13,4,2,12,9,5,4,"37",0,2,24,13,0,2,1038037,"2023-12-31T00:00:00.000Z",30,FALSE,1,17896040,"F",1,1,"Atlanta Hawks","Jalen Johnson",0,37,41,28,17,43.6
8,2,4,7,4,18,10,5,2,"38",1,3,26,5,3,3,1038038,"2023-12-31T00:00:00.000Z",19,FALSE,14,227,"F",19,19,"New Orleans Pelicans","Brandon Ingram",5,31,39,34,13,56
6,0,2,0,0,12,8,12,10,"32",2,5,26,4,0,4,1038038,"2023-12-31T00:00:00.000Z",19,FALSE,14,666969,"F",19,19,"New Orleans Pelicans","Zion Williamson",0,30,36,32,10,35.8
1,1,6,0,0,7,4,5,5,"25",2,1,13,8,1,0,1038038,"2023-12-31T00:00:00.000Z",19,FALSE,14,455,"C",19,19,"New Orleans Pelicans","Jonas Valanciunas",2,21,22,14,9,30.1
1,0,1,5,3,9,5,0,0,"29",3,3,13,4,0,0,1038038,"2023-12-31T00:00:00.000Z",19,FALSE,14,17896024,"F",19,19,"New Orleans Pelicans","Herbert Jones",0,17,18,14,5,19.3
9,1,5,11,6,19,8,0,0,"36",0,2,22,5,1,1,1038038,"2023-12-31T00:00:00.000Z",19,FALSE,14,303,"G",19,19,"New Orleans Pelicans","CJ McCollum",2,27,36,31,14,46.5
1,2,3,5,2,8,3,0,0,"20",0,1,8,3,4,1,1038038,"2023-12-31T00:00:00.000Z",19,FALSE,14,17896097,"G",19,19,"New Orleans Pelicans","Jose Alvarado",6,11,12,9,4,30.1
0,0,1,1,1,1,1,0,0,"08",0,1,3,1,0,1,1038038,"2023-12-31T00:00:00.000Z",19,FALSE,14,38017677,"G",19,19,"New Orleans Pelicans","Dyson Daniels",0,4,4,3,1,3.2
1,0,2,1,0,1,0,1,1,"08",0,1,1,2,0,0,1038038,"2023-12-31T00:00:00.000Z",19,FALSE,14,56677837,"G",19,19,"New Orleans Pelicans","Jordan Hawkins",0,3,4,2,3,4.9
0,0,0,0,0,0,0,0,0,"00",0,0,0,0,0,0,1038038,"2023-12-31T00:00:00.000Z",19,FALSE,14,3547260,"G",19,19,"New Orleans Pelicans","Kira Lewis Jr.",0,0,0,0,0,0
3,0,3,3,0,8,3,0,0,"21",2,2,6,5,0,0,1038038,"2023-12-31T00:00:00.000Z",19,FALSE,14,3547293,"F",19,19,"New Orleans Pelicans","Naji Marshall",0,11,14,9,8,16.5
3,0,8,1,1,4,3,4,4,"23",2,3,11,10,0,1,1038038,"2023-12-31T00:00:00.000Z",19,FALSE,14,340,"F",19,19,"New Orleans Pelicans","Larry Nance Jr.",0,21,24,14,13,26.5
0,0,0,0,0,0,0,0,0,"00",0,0,0,0,0,0,1038038,"2023-12-31T00:00:00.000Z",19,FALSE,14,17896021,"F",19,19,"New Orleans Pelicans","Jeremiah Robinson-Earl",0,0,0,0,0,0
0,0,0,0,0,0,0,0,0,"00",0,0,0,0,0,0,1038038,"2023-12-31T00:00:00.000Z",19,FALSE,14,491,"C",19,19,"New Orleans Pelicans","Cody Zeller",0,0,0,0,0,0
0,0,0,0,0,0,0,0,0,"00",0,0,0,0,0,0,1038038,"2023-12-31T00:00:00.000Z",19,FALSE,14,38017663,"F",19,19,"New Orleans Pelicans","E.J. Liddell",0,0,0,0,0,0
0,0,0,0,0,0,0,0,0,"00",0,0,0,0,0,0,1038038,"2023-12-31T00:00:00.000Z",19,FALSE,14,18677986,"F",19,19,"New Orleans Pelicans","Trey Murphy III",0,0,0,0,0,0
0,0,0,0,0,0,0,0,0,"00",0,0,0,0,0,0,1038038,"2023-12-31T00:00:00.000Z",19,FALSE,14,17896017,"F",19,19,"New Orleans Pelicans","Matt Ryan",0,0,0,0,0,0
0,0,0,0,0,0,0,0,0,"00",0,0,0,0,0,0,1038038,"2023-12-31T00:00:00.000Z",19,FALSE,14,666860,"F-G",14,14,"Los Angeles Lakers","Cameron Reddish",0,0,0,0,0,0
0,0,0,0,0,0,0,0,0,"00",0,0,0,0,0,0,1038038,"2023-12-31T00:00:00.000Z",19,FALSE,14,405,"G",14,14,"Los Angeles Lakers","D'Angelo Russell",0,0,0,0,0,0
0,0,0,0,0,0,0,0,0,"00",0,0,0,0,0,0,1038038,"2023-12-31T00:00:00.000Z",19,FALSE,14,56677738,"C",14,14,"Los Angeles Lakers","Colin Castleton",0,0,0,0,0,0
1,0,1,0,0,1,1,2,2,"08",0,0,4,1,1,1,1038038,"2023-12-31T00:00:00.000Z",19,FALSE,14,666609,"F",14,14,"Los Angeles Lakers","Rui Hachimura",1,5,6,5,2,8.7
0,0,2,1,0,4,2,0,0,"21",0,0,4,2,1,1,1038038,"2023-12-31T00:00:00.000Z",19,FALSE,14,457,"F",14,14,"Los Angeles Lakers","Jarred Vanderbilt",1,6,6,4,2,8.4
3,5,8,2,0,15,7,8,6,"35",2,4,20,10,0,3,1038038,"2023-12-31T00:00:00.000Z",19,FALSE,14,117,"F-C",14,14,"Los Angeles Lakers","Anthony Davis",5,30,33,23,13,48.5
4,2,1,7,4,9,5,1,1,"34",0,2,15,1,2,2,1038038,"2023-12-31T00:00:00.000Z",19,FALSE,14,383,"F",14,14,"Los Angeles Lakers","Taurean Prince",4,16,20,19,5,32.2
8,1,5,7,3,24,12,8,7,"37",0,2,34,5,0,4,1038038,"2023-12-31T00:00:00.000Z",19,FALSE,14,237,"F",14,14,"Los Angeles Lakers","LeBron James",1,39,47,42,13,51
9,1,1,5,1,12,7,6,5,"36",1,3,20,2,1,0,1038038,"2023-12-31T00:00:00.000Z",19,FALSE,14,17553995,"G",14,14,"Los Angeles Lakers","Austin Reaves",2,22,31,29,11,41.9
1,1,5,4,1,4,1,0,0,"25",0,1,3,5,0,0,1038038,"2023-12-31T00:00:00.000Z",19,FALSE,14,486,"F",14,14,"Los Angeles Lakers","Christian Wood",1,8,9,4,6,13.5
0,0,6,6,1,11,3,0,0,"29",1,1,7,7,2,2,1038038,"2023-12-31T00:00:00.000Z",19,FALSE,14,38017697,"G",14,14,"Los Angeles Lakers","Max Christie",2,14,14,7,7,19.4
0,0,2,0,0,1,0,0,0,"10",0,2,0,2,0,0,1038038,"2023-12-31T00:00:00.000Z",19,FALSE,14,666626,"C",14,14,"Los Angeles Lakers","Jaxson Hayes",0,2,2,0,2,2.4
0,0,0,0,0,1,1,0,0,"05",0,0,2,0,1,0,1038038,"2023-12-31T00:00:00.000Z",19,FALSE,14,56677835,"G",14,14,"Los Angeles Lakers","Jalen Hood-Schifino",1,2,2,2,0,5
0,0,0,0,0,0,0,0,0,"00",0,0,0,0,0,0,1038038,"2023-12-31T00:00:00.000Z",19,FALSE,14,56677867,"F",14,14,"Los Angeles Lakers","Alex Fudge",0,0,0,0,0,0
0,0,0,0,0,0,0,0,0,"00",0,0,0,0,0,0,1038038,"2023-12-31T00:00:00.000Z",19,FALSE,14,56677868,"G",14,14,"Los Angeles Lakers","D'Moi Hodge",0,0,0,0,0,0
0,0,0,0,0,0,0,0,0,"00",0,0,0,0,0,0,1038038,"2023-12-31T00:00:00.000Z",19,FALSE,14,56677836,"F",14,14,"Los Angeles Lakers","Maxwell Lewis",0,0,0,0,0,0
0,0,0,0,0,0,0,0,0,"00",0,0,0,0,0,0,1038038,"2023-12-31T00:00:00.000Z",19,FALSE,14,1603383,"G",14,14,"Los Angeles Lakers","Gabe Vincent",0,0,0,0,0,0
0,0,0,0,0,0,0,0,0,"00",0,0,0,0,0,0,1038038,"2023-12-31T00:00:00.000Z",19,FALSE,14,38017726,"G",19,19,"New Orleans Pelicans","Dereon Seabron",0,0,0,0,0,0
3,1,4,5,4,10,7,0,0,"30",0,4,18,4,0,0,1038039,"2023-12-31T00:00:00.000Z",21,FALSE,3,666541,"G",21,21,"Oklahoma City Thunder","Luguentz Dort",1,22,25,21,7,30.3
5,1,3,3,1,14,7,4,2,"29",0,1,17,3,0,3,1038039,"2023-12-31T00:00:00.000Z",21,FALSE,3,38017703,"G-F",21,21,"Oklahoma City Thunder","Jalen Williams",1,20,25,22,8,28.1
3,2,10,5,3,10,7,2,1,"32",0,3,18,10,0,3,1038039,"2023-12-31T00:00:00.000Z",21,FALSE,3,38017685,"C-F",21,21,"Oklahoma City Thunder","Chet Holmgren",2,28,31,21,13,37.5
5,0,5,8,4,16,8,0,0,"27",1,3,20,6,0,2,1038039,"2023-12-31T00:00:00.000Z",21,FALSE,3,17896065,"G",21,21,"Oklahoma City Thunder","Josh Giddey",0,26,31,25,11,32.7
6,0,4,2,1,15,7,9,9,"35",0,2,24,4,0,1,1038039,"2023-12-31T00:00:00.000Z",21,FALSE,3,175,"G",21,21,"Oklahoma City Thunder","Shai Gilgeous-Alexander",0,28,34,30,10,36.8
0,0,0,0,0,0,0,0,0,"00",0,0,0,0,0,0,1038039,"2023-12-31T00:00:00.000Z",21,FALSE,3,44,"F",21,21,"Oklahoma City Thunder","Davis Bertans",0,0,0,0,0,0
0,0,1,2,2,2,2,2,1,"16",0,1,7,1,0,2,1038039,"2023-12-31T00:00:00.000Z",21,FALSE,3,3547272,"G",21,21,"Oklahoma City Thunder","Isaiah Joe",0,8,8,7,1,6.2
0,0,0,0,0,0,0,0,0,"00",0,0,0,0,0,0,1038039,"2023-12-31T00:00:00.000Z",21,FALSE,3,17896036,"G",21,21,"Oklahoma City Thunder","Tre Mann",0,0,0,0,0,0
4,0,2,0,0,1,1,0,0,"12",1,4,2,3,1,0,1038039,"2023-12-31T00:00:00.000Z",21,FALSE,3,4197029,"G",21,21,"Oklahoma City Thunder","Vasilije Micic",1,5,9,6,7,14.6
0,0,0,0,0,0,0,0,0,"00",0,0,0,0,0,0,1038039,"2023-12-31T00:00:00.000Z",21,FALSE,3,3547271,"C",21,21,"Oklahoma City Thunder","Aleksej Pokusevski",0,0,0,0,0,0
1,1,2,4,2,7,3,2,2,"22",1,5,10,3,0,0,1038039,"2023-12-31T00:00:00.000Z",21,FALSE,3,56677833,"G",21,21,"Oklahoma City Thunder","Cason Wallace",1,13,14,11,4,18.1
0,0,0,1,1,1,1,0,0,"02",0,0,3,0,0,0,1038039,"2023-12-31T00:00:00.000Z",21,FALSE,3,27924547,"F",21,21,"Oklahoma City Thunder","Lindy Waters III",0,3,3,3,0,3
0,0,4,0,0,0,0,0,0,"11",1,0,0,5,0,2,1038039,"2023-12-31T00:00:00.000Z",21,FALSE,3,17896078,"G",21,21,"Oklahoma City Thunder","Aaron Wiggins",0,5,5,0,5,4
2,1,2,1,0,3,1,1,1,"06",1,1,3,3,0,0,1038039,"2023-12-31T00:00:00.000Z",21,FALSE,3,38017706,"F",21,21,"Oklahoma City Thunder","Jaylin Williams",1,6,8,5,5,12.6
2,0,4,2,0,4,1,0,0,"18",0,0,2,4,0,0,1038039,"2023-12-31T00:00:00.000Z",21,FALSE,3,480,"G-F",21,21,"Oklahoma City Thunder","Kenrich Williams",0,6,8,4,6,9.8
0,0,0,0,0,0,0,0,0,"00",0,0,0,0,0,0,1038039,"2023-12-31T00:00:00.000Z",21,FALSE,3,38017716,"F",21,21,"Oklahoma City Thunder","Ousmane Dieng",0,0,0,0,0,0
0,0,0,0,0,0,0,0,0,"00",0,0,0,0,0,0,1038039,"2023-12-31T00:00:00.000Z",21,FALSE,3,56677853,"F",21,21,"Oklahoma City Thunder","Keyontae Johnson",0,0,0,0,0,0
0,0,0,0,0,0,0,0,0,"00",0,0,0,0,0,0,1038039,"2023-12-31T00:00:00.000Z",21,FALSE,3,24572055,"C",21,21,"Oklahoma City Thunder","Olivier Sarr",0,0,0,0,0,0
0,0,5,6,2,11,5,2,1,"34",1,4,13,6,1,1,1038039,"2023-12-31T00:00:00.000Z",21,FALSE,3,666679,"F",3,3,"Brooklyn Nets","Cameron Johnson",1,19,19,13,6,22.2
2,0,3,8,2,13,3,0,0,"24",3,2,8,6,1,0,1038039,"2023-12-31T00:00:00.000Z",21,FALSE,3,158,"F",3,3,"Brooklyn Nets","Dorian Finney-Smith",1,14,16,10,8,21.2
5,1,10,0,0,11,5,10,5,"36",6,2,15,16,1,0,1038039,"2023-12-31T00:00:00.000Z",21,FALSE,3,666508,"F-C",3,3,"Brooklyn Nets","Nicolas Claxton",2,31,36,20,21,47.7
7,0,7,10,3,20,8,3,3,"37",0,1,22,7,1,1,1038039,"2023-12-31T00:00:00.000Z",21,FALSE,3,61,"F",3,3,"Brooklyn Nets","Mikal Bridges",1,29,36,29,14,42.9
5,0,0,6,1,13,4,4,4,"37",3,3,13,3,1,1,1038039,"2023-12-31T00:00:00.000Z",21,FALSE,3,130,"G",3,3,"Brooklyn Nets","Spencer Dinwiddie",1,16,21,18,8,26.1
0,0,0,0,0,0,0,0,0,"00",0,0,0,0,0,0,1038039,"2023-12-31T00:00:00.000Z",21,FALSE,3,174,"F-C",3,3,"Brooklyn Nets","Harry Giles III",0,0,0,0,0,0
2,0,2,7,1,9,2,0,0,"21",1,2,5,3,1,0,1038039,"2023-12-31T00:00:00.000Z",21,FALSE,3,351,"F",3,3,"Brooklyn Nets","Royce O'Neale",1,8,10,7,5,14.6
0,1,1,0,0,1,1,2,1,"08",1,1,3,2,1,0,1038039,"2023-12-31T00:00:00.000Z",21,FALSE,3,17896038,"C",3,3,"Brooklyn Nets","Day'Ron Sharpe",2,5,5,3,2,11.4
4,0,2,1,0,3,2,3,3,"15",1,4,7,3,1,3,1038039,"2023-12-31T00:00:00.000Z",21,FALSE,3,421,"G",3,3,"Brooklyn Nets","Dennis Smith Jr.",1,10,14,11,7,16.6
0,0,0,8,3,18,7,7,3,"26",1,2,20,1,1,0,1038039,"2023-12-31T00:00:00.000Z",21,FALSE,3,17896048,"G",3,3,"Brooklyn Nets","Cam Thomas",1,21,21,20,1,24.2
0,0,0,0,0,0,0,0,0,"00",0,0,0,0,0,0,1038039,"2023-12-31T00:00:00.000Z",21,FALSE,3,464,"G",3,3,"Brooklyn Nets","Lonnie Walker IV",0,0,0,0,0,0
0,0,0,0,0,1,1,0,0,"02",0,0,2,0,0,0,1038039,"2023-12-31T00:00:00.000Z",21,FALSE,3,17896058,"F",3,3,"Brooklyn Nets","Trendon Watford",0,2,2,2,0,2
0,0,0,0,0,0,0,0,0,"00",0,0,0,0,0,0,1038039,"2023-12-31T00:00:00.000Z",21,FALSE,3,9051997,"G",3,3,"Brooklyn Nets","Armoni Brooks",0,0,0,0,0,0
0,0,0,0,0,0,0,0,0,"00",0,0,0,0,0,0,1038039,"2023-12-31T00:00:00.000Z",21,FALSE,3,56677843,"F",3,3,"Brooklyn Nets","Noah Clowney",0,0,0,0,0,0
0,0,0,0,0,0,0,0,0,"00",0,0,0,0,0,0,1038039,"2023-12-31T00:00:00.000Z",21,FALSE,3,17896041,"G",3,3,"Brooklyn Nets","Keon Johnson",0,0,0,0,0,0
0,0,0,0,0,0,0,0,0,"00",0,0,0,0,0,0,1038039,"2023-12-31T00:00:00.000Z",21,FALSE,3,417,"G-F",3,3,"Brooklyn Nets","Ben Simmons",0,0,0,0,0,0
0,0,0,0,0,0,0,0,0,"00",0,0,0,0,0,0,1038039,"2023-12-31T00:00:00.000Z",21,FALSE,3,56677841,"F",3,3,"Brooklyn Nets","Dariq Whitehead",0,0,0,0,0,0
0,0,0,0,0,0,0,0,0,"00",0,0,0,0,0,0,1038039,"2023-12-31T00:00:00.000Z",21,FALSE,3,56677722,"F",3,3,"Brooklyn Nets","Jalen Wilson",0,0,0,0,0,0
2,0,2,2,0,2,0,0,0,"19",0,2,0,2,0,1,1038040,"2023-12-31T00:00:00.000Z",27,FALSE,2,38017649,"F",27,27,"San Antonio Spurs","Julian Champagnie",0,2,4,2,4,4.4
5,0,3,4,1,11,4,0,0,"24",0,1,9,3,0,1,1038040,"2023-12-31T00:00:00.000Z",27,FALSE,2,38017699,"F",27,27,"San Antonio Spurs","Jeremy Sochan",0,12,17,14,8,19.1
3,1,5,8,3,16,8,2,2,"24",2,0,21,7,0,3,1038040,"2023-12-31T00:00:00.000Z",27,FALSE,2,56677822,"F-C",27,27,"San Antonio Spurs","Victor Wembanyama",1,28,31,24,10,33.9
1,0,4,4,2,15,9,2,2,"31",1,3,22,5,2,2,1038040,"2023-12-31T00:00:00.000Z",27,FALSE,2,3547246,"G-F",27,27,"San Antonio Spurs","Devin Vassell",2,27,28,23,6,33.5
0,0,1,5,1,9,4,3,2,"23",0,0,11,1,0,1,1038040,"2023-12-31T00:00:00.000Z",27,FALSE,2,38017692,"F",27,27,"San Antonio Spurs","Malaki Branham",0,12,12,11,1,11.2
1,0,3,1,1,6,3,2,1,"12",1,2,8,4,2,0,1038040,"2023-12-31T00:00:00.000Z",27,FALSE,2,38017730,"F",27,27,"San Antonio Spurs","Dominick Barlow",2,12,13,9,5,20.3
0,0,2,2,0,2,0,0,0,"08",1,0,0,3,1,0,1038040,"2023-12-31T00:00:00.000Z",27,FALSE,2,56677817,"G",27,27,"San Antonio Spurs","Sidy Cissoko",1,3,3,0,3,6.6
1,0,1,2,2,4,3,1,1,"08",1,0,9,2,0,1,1038040,"2023-12-31T00:00:00.000Z",27,FALSE,2,180,"G",27,27,"San Antonio Spurs","Devonte' Graham",0,11,12,10,3,11.9
2,0,3,5,0,10,4,0,0,"22",1,3,8,4,0,1,1038040,"2023-12-31T00:00:00.000Z",27,FALSE,2,3547274,"G",27,27,"San Antonio Spurs","Tre Jones",0,12,14,10,6,14.8
4,0,5,5,1,9,3,0,0,"20",2,1,7,7,0,0,1038040,"2023-12-31T00:00:00.000Z",27,FALSE,2,17896059,"F",27,27,"San Antonio Spurs","Sandro Mamukelashvili",0,14,18,11,11,21.4
1,0,0,3,0,3,0,0,0,"16",0,1,0,0,0,1,1038040,"2023-12-31T00:00:00.000Z",27,FALSE,2,305,"F",27,27,"San Antonio Spurs","Doug McDermott",0,0,1,1,1,0.5
2,0,0,2,1,4,2,0,0,"16",0,2,5,0,1,0,1038040,"2023-12-31T00:00:00.000Z",27,FALSE,2,359,"F",27,27,"San Antonio Spurs","Cedi Osman",1,5,7,7,2,11
6,0,1,2,0,3,0,2,1,"17",0,2,1,1,0,1,1038040,"2023-12-31T00:00:00.000Z",27,FALSE,2,38017693,"G",27,27,"San Antonio Spurs","Blake Wesley",0,2,8,7,7,10.2
0,0,0,0,0,0,0,0,0,"00",0,0,0,0,0,0,1038040,"2023-12-31T00:00:00.000Z",27,FALSE,2,17895854,"G",27,27,"San Antonio Spurs","Charles Bassey",0,0,0,0,0,0
0,0,0,0,0,0,0,0,0,"00",0,0,0,0,0,0,1038040,"2023-12-31T00:00:00.000Z",27,FALSE,2,102,"F-C",27,27,"San Antonio Spurs","Zach Collins",0,0,0,0,0,0
0,0,0,0,0,0,0,0,0,"00",0,0,0,0,0,0,1038040,"2023-12-31T00:00:00.000Z",27,FALSE,2,17896049,"G",3,27,"San Antonio Spurs","David Duke Jr.",0,0,0,0,0,0
0,0,0,0,0,0,0,0,0,"00",0,0,0,0,0,0,1038040,"2023-12-31T00:00:00.000Z",27,FALSE,2,666682,"F",27,27,"San Antonio Spurs","Keldon Johnson",0,0,0,0,0,0
2,2,5,10,5,17,10,0,0,"31",1,1,25,6,0,3,1038040,"2023-12-31T00:00:00.000Z",27,FALSE,2,434,"F",2,2,"Boston Celtics","Jayson Tatum",2,31,33,27,8,38.2
4,0,6,2,1,4,3,0,0,"20",1,0,7,7,0,0,1038040,"2023-12-31T00:00:00.000Z",27,FALSE,2,219,"C-F",2,2,"Boston Celtics","Al Horford",0,14,18,11,11,21.4
2,2,8,7,0,14,4,6,6,"30",1,2,14,9,1,1,1038040,"2023-12-31T00:00:00.000Z",27,FALSE,2,378,"F-C",2,2,"Boston Celtics","Kristaps Porzingis",3,23,25,16,11,35.8
3,0,5,2,2,13,9,6,4,"26",1,0,24,6,2,2,1038040,"2023-12-31T00:00:00.000Z",27,FALSE,2,70,"G",2,2,"Boston Celtics","Jaylen Brown",2,30,33,27,9,39.7
5,0,2,6,3,11,7,0,0,"26",0,1,17,2,0,0,1038040,"2023-12-31T00:00:00.000Z",27,FALSE,2,473,"G",2,2,"Boston Celtics","Derrick White",0,19,24,22,7,26.9
1,0,3,0,0,2,0,4,4,"11",1,2,4,4,0,2,1038040,"2023-12-31T00:00:00.000Z",27,FALSE,2,17896094,"G",2,2,"Boston Celtics","Dalano Banton",0,8,9,5,5,8.3
0,0,3,0,0,5,2,1,0,"21",3,2,4,6,2,0,1038040,"2023-12-31T00:00:00.000Z",27,FALSE,2,666468,"F",2,2,"Boston Celtics","Oshae Brissett",2,10,10,4,6,17.2
1,0,4,5,3,6,4,0,0,"20",0,2,11,4,0,1,1038040,"2023-12-31T00:00:00.000Z",27,FALSE,2,17896060,"F",2,2,"Boston Celtics","Sam Hauser",0,15,16,12,5,16.3
2,2,1,0,0,7,5,2,2,"16",3,1,12,4,0,0,1038040,"2023-12-31T00:00:00.000Z",27,FALSE,2,261,"F-C",2,2,"Boston Celtics","Luke Kornet",2,16,18,14,6,25.8
0,0,1,4,0,4,0,0,0,"08",0,1,0,1,1,1,1038040,"2023-12-31T00:00:00.000Z",27,FALSE,2,338,"G",2,2,"Boston Celtics","Svi Mykhailiuk",1,1,1,0,1,3.2
7,0,2,5,1,8,4,2,0,"19",1,0,9,3,0,0,1038040,"2023-12-31T00:00:00.000Z",27,FALSE,2,3547276,"G",2,2,"Boston Celtics","Payton Pritchard",0,12,19,16,10,23.1
0,1,2,0,0,2,2,1,1,"05",0,0,5,2,0,0,1038040,"2023-12-31T00:00:00.000Z",27,FALSE,2,17553967,"C",2,2,"Boston Celtics","Neemias Queta",1,7,7,5,2,10.4
2,0,2,0,0,1,1,0,0,"07",0,0,2,2,0,0,1038040,"2023-12-31T00:00:00.000Z",27,FALSE,2,3547279,"F",2,2,"Boston Celtics","Lamar Stevens",0,4,6,4,4,7.4
0,0,0,0,0,0,0,0,0,"00",0,0,0,0,0,0,1038040,"2023-12-31T00:00:00.000Z",27,FALSE,2,38017707,"G",2,2,"Boston Celtics","JD Davison",0,0,0,0,0,0
0,0,0,0,0,0,0,0,0,"00",0,0,0,0,0,0,1038040,"2023-12-31T00:00:00.000Z",27,FALSE,2,NA,NA,NA,2,"Boston Celtics","NA NA",0,0,0,0,0,0
0,0,0,0,0,0,0,0,0,"00",0,0,0,0,0,0,1038040,"2023-12-31T00:00:00.000Z",27,FALSE,2,56677864,"G",2,2,"Boston Celtics","Jordan Walsh",0,0,0,0,0,0
0,0,0,0,0,0,0,0,0,"00",0,0,0,0,0,0,1038040,"2023-12-31T00:00:00.000Z",27,FALSE,2,214,"G",2,2,"Boston Celtics","Jrue Holiday",0,0,0,0,0,0
2,0,2,4,0,11,4,7,4,"31",0,2,12,2,3,2,1038041,"2023-12-31T00:00:00.000Z",15,FALSE,26,420,"G",15,15,"Memphis Grizzlies","Marcus Smart",3,14,16,14,4,24.4
1,0,3,4,1,14,6,6,5,"28",0,3,18,3,1,0,1038041,"2023-12-31T00:00:00.000Z",15,FALSE,26,231,"F-C",15,15,"Memphis Grizzlies","Jaren Jackson Jr.",1,21,22,19,4,26.1
0,1,5,0,0,0,0,0,0,"22",0,1,0,5,0,0,1038041,"2023-12-31T00:00:00.000Z",15,FALSE,26,48,"C",15,15,"Memphis Grizzlies","Bismack Biyombo",1,5,5,0,5,9
6,0,7,7,3,14,6,3,2,"35",0,2,17,7,0,2,1038041,"2023-12-31T00:00:00.000Z",15,FALSE,26,3547287,"G",15,15,"Memphis Grizzlies","Desmond Bane",0,24,30,23,13,32.4
3,0,3,4,2,12,4,8,7,"31",0,3,17,3,0,0,1038041,"2023-12-31T00:00:00.000Z",15,FALSE,26,666786,"G",15,15,"Memphis Grizzlies","Ja Morant",0,20,23,20,6,25.1
1,0,2,5,1,6,2,2,0,"14",0,0,5,2,0,0,1038041,"2023-12-31T00:00:00.000Z",15,FALSE,26,17896067,"F",15,15,"Memphis Grizzlies","Santi Aldama",0,7,8,6,3,8.9
2,0,3,8,5,9,6,0,0,"20",0,2,17,3,0,1,1038041,"2023-12-31T00:00:00.000Z",15,FALSE,26,254,"G",15,15,"Memphis Grizzlies","Luke Kennard",0,20,22,19,5,22.6
0,0,0,0,0,0,0,0,0,"05",0,0,0,0,0,0,1038041,"2023-12-31T00:00:00.000Z",15,FALSE,26,666703,"G-F",15,15,"Memphis Grizzlies","John Konchar",0,0,0,0,0,0
0,0,1,0,0,2,0,0,0,"05",0,0,0,1,0,1,1038041,"2023-12-31T00:00:00.000Z",15,FALSE,26,17896027,"G-F",15,15,"Memphis Grizzlies","Ziaire Williams",0,1,1,0,1,0.2
0,0,0,0,0,0,0,0,0,"00",0,0,0,0,0,0,1038041,"2023-12-31T00:00:00.000Z",15,FALSE,26,3,"C",15,15,"Memphis Grizzlies","Steven Adams",0,0,0,0,0,0
0,0,0,0,0,0,0,0,0,"00",0,0,0,0,0,0,1038041,"2023-12-31T00:00:00.000Z",15,FALSE,26,666505,"F",15,15,"Memphis Grizzlies","Brandon Clarke",0,0,0,0,0,0
0,0,0,0,0,0,0,0,0,"00",0,0,0,0,0,0,1038041,"2023-12-31T00:00:00.000Z",15,FALSE,26,48248287,"G",15,15,"Memphis Grizzlies","Jacob Gilyard",0,0,0,0,0,0
0,0,0,0,0,0,0,0,0,"00",0,0,0,0,0,0,1038041,"2023-12-31T00:00:00.000Z",15,FALSE,26,56677830,"F",15,15,"Memphis Grizzlies","GG Jackson",0,0,0,0,0,0
0,0,0,0,0,0,0,0,0,"00",0,0,0,0,0,0,1038041,"2023-12-31T00:00:00.000Z",15,FALSE,26,38017728,"F",15,15,"Memphis Grizzlies","Jake LaRavia",0,0,0,0,0,0
1,0,2,4,2,9,4,0,0,"26",1,1,10,3,0,1,1038041,"2023-12-31T00:00:00.000Z",15,FALSE,26,38017688,"F",26,26,"Sacramento Kings","Keegan Murray",0,13,14,11,4,14.1
1,0,0,2,0,3,0,2,2,"11",0,0,2,0,0,1,1038041,"2023-12-31T00:00:00.000Z",15,FALSE,26,38017729,"F",15,15,"Memphis Grizzlies","David Roddy",0,2,3,3,1,2.5
3,0,0,0,0,3,1,0,0,"12",0,0,2,0,0,1,1038041,"2023-12-31T00:00:00.000Z",15,FALSE,26,401,"G",15,15,"Memphis Grizzlies","Derrick Rose",0,2,5,5,3,5.5
0,0,1,2,0,4,1,0,0,"08",1,0,2,2,0,0,1038041,"2023-12-31T00:00:00.000Z",15,FALSE,26,3547285,"F",15,15,"Memphis Grizzlies","Xavier Tillman",0,4,4,2,2,4.4
1,0,6,4,0,4,0,0,0,"18",0,1,0,6,0,0,1038041,"2023-12-31T00:00:00.000Z",15,FALSE,26,38017731,"G",15,15,"Memphis Grizzlies","Vince Williams Jr.",0,6,7,1,7,8.7
0,1,2,5,2,8,4,1,1,"20",0,2,11,2,0,1,1038041,"2023-12-31T00:00:00.000Z",15,FALSE,26,30,"F",26,26,"Sacramento Kings","Harrison Barnes",1,13,13,11,2,15.4
12,0,19,1,0,11,5,5,3,"32",2,4,13,21,1,3,1038041,"2023-12-31T00:00:00.000Z",15,FALSE,26,406,"F",26,26,"Sacramento Kings","Domantas Sabonis",1,34,46,25,33,56.2
0,0,5,2,1,6,2,2,2,"26",1,2,7,6,0,1,1038041,"2023-12-31T00:00:00.000Z",15,FALSE,26,17896030,"G",26,26,"Sacramento Kings","Chris Duarte",0,13,13,7,6,13.2
4,1,3,8,3,23,9,5,3,"34",1,3,24,4,0,1,1038041,"2023-12-31T00:00:00.000Z",15,FALSE,26,161,"G",26,26,"Sacramento Kings","De'Aaron Fox",1,28,32,28,8,36.8
0,0,0,2,0,2,0,0,0,"04",0,0,0,0,0,0,1038041,"2023-12-31T00:00:00.000Z",15,FALSE,26,17896044,"F",26,26,"Sacramento Kings","Kessler Edwards",0,0,0,0,0,0
0,0,0,0,0,0,0,0,0,"04",0,1,0,0,0,0,1038041,"2023-12-31T00:00:00.000Z",15,FALSE,26,38017714,"G",26,26,"Sacramento Kings","Keon Ellis",0,0,0,0,0,0
0,0,0,3,1,9,4,0,0,"17",0,1,9,0,0,0,1038041,"2023-12-31T00:00:00.000Z",15,FALSE,26,221,"G",26,26,"Sacramento Kings","Kevin Huerter",0,9,9,9,0,9
1,1,4,0,0,1,0,0,0,"12",4,3,0,8,0,2,1038041,"2023-12-31T00:00:00.000Z",15,FALSE,26,273,"C",26,26,"Sacramento Kings","Alex Len",1,8,9,1,9,12.1
0,0,3,3,3,4,4,1,1,"19",0,1,12,3,1,1,1038041,"2023-12-31T00:00:00.000Z",15,FALSE,26,290,"F",26,26,"Sacramento Kings","Trey Lyles",1,15,15,12,3,17.6
0,1,2,0,0,0,0,0,0,"04",0,1,0,2,0,2,1038041,"2023-12-31T00:00:00.000Z",15,FALSE,26,306,"C",26,26,"Sacramento Kings","JaVale McGee",1,2,2,0,2,3.4
4,0,2,0,0,4,4,0,0,"14",0,2,8,2,0,0,1038041,"2023-12-31T00:00:00.000Z",15,FALSE,26,17553994,"G",26,26,"Sacramento Kings","Davion Mitchell",0,10,14,12,6,16.4
5,0,5,5,4,13,10,3,3,"21",0,1,27,5,0,0,1038041,"2023-12-31T00:00:00.000Z",15,FALSE,26,324,"G",26,26,"Sacramento Kings","Malik Monk",0,32,37,32,10,40.5
1,0,2,0,0,0,0,0,0,"03",0,0,0,2,0,0,1038041,"2023-12-31T00:00:00.000Z",15,FALSE,26,666925,"F",29,26,"Sacramento Kings","Juan Toscano-Anderson",0,2,3,1,3,3.9
0,0,1,0,0,2,1,0,0,"04",0,0,2,1,0,0,1038041,"2023-12-31T00:00:00.000Z",15,FALSE,26,4197162,"F",26,26,"Sacramento Kings","Aleksandar Vezenkov",0,3,3,2,1,3.2
0,0,0,0,0,0,0,0,0,"00",0,0,0,0,0,0,1038041,"2023-12-31T00:00:00.000Z",15,FALSE,26,17895990,"G",26,26,"Sacramento Kings","Jordan Ford",0,0,0,0,0,0
0,0,0,0,0,0,0,0,0,"00",0,0,0,0,0,0,1038041,"2023-12-31T00:00:00.000Z",15,FALSE,26,56677845,"G",26,26,"Sacramento Kings","Colby Jones",0,0,0,0,0,0
0,0,0,0,0,0,0,0,0,"00",0,0,0,0,0,0,1038041,"2023-12-31T00:00:00.000Z",15,FALSE,26,56677862,"F",26,26,"Sacramento Kings","Jalen Slawson",0,0,0,0,0,0
4,1,2,4,2,8,4,0,0,"35",0,0,10,2,2,1,1038042,"2023-12-31T00:00:00.000Z",24,FALSE,22,8,"G",24,24,"Phoenix Suns","Grayson Allen",3,12,16,14,6,26.4
5,1,5,5,2,21,12,5,5,"38",0,1,31,5,3,0,1038042,"2023-12-31T00:00:00.000Z",24,FALSE,22,140,"F",24,24,"Phoenix Suns","Kevin Durant",4,36,41,36,10,56.5
3,0,10,3,0,17,8,5,3,"33",3,3,19,13,0,1,1038042,"2023-12-31T00:00:00.000Z",24,FALSE,22,349,"C",24,24,"Phoenix Suns","Jusuf Nurkic",0,32,35,22,16,38.1
2,1,1,2,1,13,10,4,4,"35",0,1,25,1,1,1,1038042,"2023-12-31T00:00:00.000Z",24,FALSE,22,37,"G",24,24,"Phoenix Suns","Bradley Beal",2,26,28,27,3,34.2
5,0,4,8,3,17,7,5,4,"37",0,3,21,4,3,1,1038042,"2023-12-31T00:00:00.000Z",24,FALSE,22,57,"G",24,24,"Phoenix Suns","Devin Booker",3,25,30,26,9,41.3
0,1,1,0,0,0,0,0,0,"08",0,1,0,1,0,1,1038042,"2023-12-31T00:00:00.000Z",24,FALSE,22,3547095,"C-F",24,24,"Phoenix Suns","Udoka Azubuike",1,1,1,0,1,3.2
0,0,0,0,0,0,0,0,0,"00",0,0,0,0,0,0,1038042,"2023-12-31T00:00:00.000Z",24,FALSE,22,32,"F",24,24,"Phoenix Suns","Keita Bates-Diop",0,0,0,0,0,0
0,0,1,2,0,3,0,0,0,"30",0,3,0,1,2,0,1038042,"2023-12-31T00:00:00.000Z",24,FALSE,22,178,"G",24,24,"Phoenix Suns","Eric Gordon",2,1,1,0,1,7.2
0,0,4,2,0,7,3,0,0,"17",2,2,6,6,0,1,1038042,"2023-12-31T00:00:00.000Z",24,FALSE,22,314,"F",24,24,"Phoenix Suns","Chimezie Metu",0,12,12,6,6,12.2
2,0,1,1,0,2,0,0,0,"07",1,3,0,2,0,0,1038042,"2023-12-31T00:00:00.000Z",24,FALSE,22,356,"G",24,24,"Phoenix Suns","Josh Okogie",0,2,4,2,4,5.4
0,0,0,0,0,0,0,0,0,"00",0,0,0,0,0,0,1038042,"2023-12-31T00:00:00.000Z",24,FALSE,22,666451,"C",24,24,"Phoenix Suns","Bol Bol",0,0,0,0,0,0
0,0,0,0,0,0,0,0,0,"00",0,0,0,0,0,0,1038042,"2023-12-31T00:00:00.000Z",24,FALSE,22,147,"F",24,24,"Phoenix Suns","Drew Eubanks",0,0,0,0,0,0
0,0,0,0,0,0,0,0,0,"00",0,0,0,0,0,0,1038042,"2023-12-31T00:00:00.000Z",24,FALSE,22,18678058,"",24,24,"Phoenix Suns","Jordan Goodwin",0,0,0,0,0,0
0,0,0,0,0,0,0,0,0,"00",0,0,0,0,0,0,1038042,"2023-12-31T00:00:00.000Z",24,FALSE,22,3547298,"G",24,24,"Phoenix Suns","Saben Lee",0,0,0,0,0,0
0,0,0,0,0,0,0,0,0,"00",0,0,0,0,0,0,1038042,"2023-12-31T00:00:00.000Z",24,FALSE,22,17553983,"G",22,22,"Orlando Magic","Trevelin Queen",0,0,0,0,0,0
0,0,0,0,0,0,0,0,0,"00",0,0,0,0,0,0,1038042,"2023-12-31T00:00:00.000Z",24,FALSE,22,165,"G",22,22,"Orlando Magic","Markelle Fultz",0,0,0,0,0,0
0,0,0,0,0,0,0,0,0,"00",0,0,0,0,0,0,1038042,"2023-12-31T00:00:00.000Z",24,FALSE,22,38017607,"G",22,22,"Orlando Magic","Kevon Harris",0,0,0,0,0,0
0,0,0,0,0,0,0,0,0,"00",0,0,0,0,0,0,1038042,"2023-12-31T00:00:00.000Z",24,FALSE,22,56677839,"G",22,22,"Orlando Magic","Jett Howard",0,0,0,0,0,0
0,0,0,0,0,0,0,0,0,"00",0,0,0,0,0,0,1038042,"2023-12-31T00:00:00.000Z",24,FALSE,22,226,"F",22,22,"Orlando Magic","Joe Ingles",0,0,0,0,0,0
0,0,0,0,0,0,0,0,0,"00",0,0,0,0,0,0,1038042,"2023-12-31T00:00:00.000Z",24,FALSE,22,666885,"F",22,22,"Orlando Magic","Admiral Schofield",0,0,0,0,0,0
0,0,0,0,0,0,0,0,0,"00",0,0,0,0,0,0,1038042,"2023-12-31T00:00:00.000Z",24,FALSE,22,470,"G",24,24,"Phoenix Suns","Yuta Watanabe",0,0,0,0,0,0
0,0,0,0,0,0,0,0,0,"00",0,0,0,0,0,0,1038042,"2023-12-31T00:00:00.000Z",24,FALSE,22,272,"G",24,24,"Phoenix Suns","Damion Lee",0,0,0,0,0,0
0,0,0,0,0,0,0,0,0,"00",0,0,0,0,0,0,1038042,"2023-12-31T00:00:00.000Z",24,FALSE,22,666729,"F",24,24,"Phoenix Suns","Nassir Little",0,0,0,0,0,0
0,0,0,0,0,0,0,0,0,"00",0,0,0,0,0,0,1038042,"2023-12-31T00:00:00.000Z",24,FALSE,22,3547253,"G",4,24,"Phoenix Suns","Theo Maledon",0,0,0,0,0,0
6,1,6,8,2,25,11,3,3,"39",1,4,27,7,0,2,1038042,"2023-12-31T00:00:00.000Z",24,FALSE,22,17896026,"F",22,22,"Orlando Magic","Franz Wagner",1,34,40,33,13,45.4
7,1,9,6,2,23,12,2,2,"37",0,1,28,9,0,3,1038042,"2023-12-31T00:00:00.000Z",24,FALSE,22,38017683,"F",22,22,"Orlando Magic","Paolo Banchero",1,37,44,35,16,49.3
1,1,3,0,0,5,3,0,0,"22",4,4,6,7,0,2,1038042,"2023-12-31T00:00:00.000Z",24,FALSE,22,666442,"C",22,22,"Orlando Magic","Goga Bitadze",1,13,14,7,8,16.9
3,1,4,7,1,10,1,2,1,"29",0,4,4,4,0,1,1038042,"2023-12-31T00:00:00.000Z",24,FALSE,22,17896073,"G",22,22,"Orlando Magic","Jalen Suggs",1,8,11,7,7,15.3
0,0,2,1,0,3,1,0,0,"22",0,2,2,2,0,2,1038042,"2023-12-31T00:00:00.000Z",24,FALSE,22,56677827,"G",22,22,"Orlando Magic","Anthony Black",0,4,4,2,2,2.4
0,0,4,4,2,7,4,3,3,"18",1,0,13,5,1,2,1038042,"2023-12-31T00:00:00.000Z",24,FALSE,22,3547251,"G",22,22,"Orlando Magic","Cole Anthony",1,18,18,13,5,20
2,0,4,3,3,7,6,2,2,"24",1,2,17,5,0,3,1038042,"2023-12-31T00:00:00.000Z",24,FALSE,22,85,"F",22,22,"Orlando Magic","Wendell Carter Jr.",0,22,24,19,7,23
2,0,2,6,1,7,2,0,0,"32",0,1,5,2,0,0,1038042,"2023-12-31T00:00:00.000Z",24,FALSE,22,196,"G",22,22,"Orlando Magic","Gary Harris",0,7,9,7,4,10.4
0,0,0,0,0,0,0,0,0,"07",0,0,0,0,0,0,1038042,"2023-12-31T00:00:00.000Z",24,FALSE,22,38017724,"G",22,22,"Orlando Magic","Caleb Houstan",0,0,0,0,0,0
0,0,0,0,0,0,0,0,0,"00",0,0,0,0,0,0,1038042,"2023-12-31T00:00:00.000Z",24,FALSE,22,229,"F",22,22,"Orlando Magic","Jonathan Isaac",0,0,0,0,0,0
0,0,0,0,0,0,0,0,0,"01",0,0,0,0,0,0,1038042,"2023-12-31T00:00:00.000Z",24,FALSE,22,666818,"F",22,22,"Orlando Magic","Chuma Okeke",0,0,0,0,0,0
1,0,3,2,1,3,2,0,0,"09",1,0,5,4,1,0,1038042,"2023-12-31T00:00:00.000Z",24,FALSE,22,462,"C",22,22,"Orlando Magic","Moritz Wagner",1,9,10,6,5,14.3
1,0,3,6,3,12,7,0,0,"35",3,6,17,6,1,1,1038043,"2024-01-01T00:00:00.000Z",20,FALSE,18,18,"F",28,20,"New York Knicks","OG Anunoby",1,23,24,18,7,27.7
0,0,6,6,2,24,14,13,9,"36",3,5,39,9,0,6,1038043,"2024-01-01T00:00:00.000Z",20,FALSE,18,387,"F",20,20,"New York Knicks","Julius Randle",0,48,48,39,9,43.8
3,3,5,0,0,3,2,4,3,"39",4,3,7,9,3,1,1038043,"2024-01-01T00:00:00.000Z",20,FALSE,18,201,"F-C",20,20,"New York Knicks","Isaiah Hartenstein",6,16,19,10,12,39.3
14,0,4,9,1,23,5,5,5,"41",0,4,16,4,2,2,1038043,"2024-01-01T00:00:00.000Z",20,FALSE,18,73,"G",20,20,"New York Knicks","Jalen Brunson",2,20,34,30,18,45.8
2,1,3,6,2,11,5,4,3,"26",1,0,15,4,1,1,1038043,"2024-01-01T00:00:00.000Z",20,FALSE,18,131,"G",20,20,"New York Knicks","Donte DiVincenzo",2,19,21,17,6,27.8
0,0,2,0,0,2,0,0,0,"08",1,2,0,3,0,0,1038043,"2024-01-01T00:00:00.000Z",20,FALSE,18,3547249,"F",28,20,"New York Knicks","Precious Achiuwa",0,3,3,0,3,3.6
0,0,0,0,0,0,0,0,0,"00",0,0,0,0,0,0,1038043,"2024-01-01T00:00:00.000Z",20,FALSE,18,19,"G",20,20,"New York Knicks","Ryan Arcidiacono",0,0,0,0,0,0
0,0,0,0,0,0,0,0,0,"00",0,0,0,0,0,0,1038043,"2024-01-01T00:00:00.000Z",20,FALSE,18,666474,"G",20,20,"New York Knicks","Charles Brown",0,0,0,0,0,0
0,0,0,0,0,0,0,0,0,"00",0,0,0,0,0,0,1038043,"2024-01-01T00:00:00.000Z",20,FALSE,18,160,"G-F",20,20,"New York Knicks","Evan Fournier",0,0,0,0,0,0
1,0,1,3,2,4,3,2,2,"18",2,1,10,3,0,0,1038043,"2024-01-01T00:00:00.000Z",20,FALSE,18,17895858,"G",20,20,"New York Knicks","Quentin Grimes",0,13,14,11,4,15.1
2,0,9,3,2,7,3,0,0,"29",2,2,8,11,0,1,1038043,"2024-01-01T00:00:00.000Z",20,FALSE,18,202,"G",20,20,"New York Knicks","Josh Hart",0,19,21,10,13,23.2
0,0,0,1,0,3,0,0,0,"07",0,0,0,0,0,1,1038043,"2024-01-01T00:00:00.000Z",20,FALSE,18,17896033,"G",20,20,"New York Knicks","Miles McBride",0,0,0,0,0,-1
1,0,13,0,0,8,3,6,4,"38",2,2,10,15,0,1,1038043,"2024-01-01T00:00:00.000Z",20,FALSE,18,176,"C",18,18,"Minnesota Timberwolves","Rudy Gobert",0,25,26,11,16,28.5
5,1,2,1,0,6,2,1,1,"29",0,1,5,2,1,0,1038043,"2024-01-01T00:00:00.000Z",20,FALSE,18,104,"G",18,18,"Minnesota Timberwolves","Mike Conley",2,7,12,10,7,20.9
2,2,4,9,4,21,11,10,9,"37",0,1,35,4,0,4,1038043,"2024-01-01T00:00:00.000Z",20,FALSE,18,3547238,"G",18,18,"Minnesota Timberwolves","Anthony Edwards",2,39,41,37,6,44.8
3,0,2,0,0,1,1,2,0,"17",0,0,2,2,2,3,1038043,"2024-01-01T00:00:00.000Z",20,FALSE,18,12,"F",18,18,"Minnesota Timberwolves","Kyle Anderson",2,4,7,5,5,11.9
0,0,1,0,0,0,0,0,0,"06",0,1,0,1,0,1,1038043,"2024-01-01T00:00:00.000Z",20,FALSE,18,68,"F",18,18,"Minnesota Timberwolves","Troy Brown Jr.",0,1,1,0,1,0.2
3,0,1,2,1,5,4,0,0,"12",0,1,9,1,2,0,1038043,"2024-01-01T00:00:00.000Z",20,FALSE,18,666767,"G",18,18,"Minnesota Timberwolves","Jordan McLaughlin",2,10,13,12,4,20.7
0,0,0,0,0,0,0,0,0,"00",0,0,0,0,0,0,1038043,"2024-01-01T00:00:00.000Z",20,FALSE,18,320,"G",18,18,"Minnesota Timberwolves","Shake Milton",0,0,0,0,0,0
0,0,0,0,0,0,0,0,0,"00",0,0,0,0,0,0,1038043,"2024-01-01T00:00:00.000Z",20,FALSE,18,56677795,"F",20,20,"New York Knicks","Jacob Toppin",0,0,0,0,0,0
0,0,0,0,0,0,0,0,0,"00",0,0,0,0,0,0,1038043,"2024-01-01T00:00:00.000Z",20,FALSE,18,3547275,"G",28,20,"New York Knicks","Malachi Flynn",0,0,0,0,0,0
0,0,0,0,0,0,0,0,0,"00",0,0,0,0,0,0,1038043,"2024-01-01T00:00:00.000Z",20,FALSE,18,399,"C",20,20,"New York Knicks","Mitchell Robinson",0,0,0,0,0,0
0,0,0,0,0,0,0,0,0,"00",0,0,0,0,0,0,1038043,"2024-01-01T00:00:00.000Z",20,FALSE,18,NA,NA,NA,20,"New York Knicks","NA NA",0,0,0,0,0,0
0,1,0,5,1,8,2,4,3,"33",1,4,8,1,1,1,1038043,"2024-01-01T00:00:00.000Z",20,FALSE,18,3547259,"F",18,18,"Minnesota Timberwolves","Jaden McDaniels",2,9,9,8,1,14.2
3,0,5,5,3,18,10,6,6,"32",1,5,29,6,0,3,1038043,"2024-01-01T00:00:00.000Z",20,FALSE,18,447,"C",18,18,"Minnesota Timberwolves","Karl-Anthony Towns",0,35,38,32,9,37.7
0,0,0,0,0,0,0,0,0,"00",0,0,0,0,0,0,1038043,"2024-01-01T00:00:00.000Z",20,FALSE,18,38017715,"F",18,18,"Minnesota Timberwolves","Josh Minott",0,0,0,0,0,0
0,0,0,0,0,0,0,0,0,"00",0,0,0,0,0,0,1038043,"2024-01-01T00:00:00.000Z",20,FALSE,18,17895968,"F",18,18,"Minnesota Timberwolves","Daishen Nix",0,0,0,0,0,0
0,0,2,4,1,6,2,0,0,"19",0,5,5,2,0,0,1038043,"2024-01-01T00:00:00.000Z",20,FALSE,18,667378,"F-C",18,18,"Minnesota Timberwolves","Naz Reid",0,7,7,5,2,7.4
0,0,0,0,0,0,0,0,0,"00",0,0,0,0,0,0,1038043,"2024-01-01T00:00:00.000Z",20,FALSE,18,56677851,"G",18,18,"Minnesota Timberwolves","Jaylen Clark",0,0,0,0,0,0
0,0,0,0,0,0,0,0,0,"00",0,0,0,0,0,0,1038043,"2024-01-01T00:00:00.000Z",20,FALSE,18,17896056,"C",18,18,"Minnesota Timberwolves","Luka Garza",0,0,0,0,0,0
0,0,0,0,0,0,0,0,0,"00",0,0,0,0,0,0,1038043,"2024-01-01T00:00:00.000Z",20,FALSE,18,56677782,"F",18,18,"Minnesota Timberwolves","Leonard Miller",0,0,0,0,0,0
0,0,0,0,0,0,0,0,0,"00",0,0,0,0,0,0,1038043,"2024-01-01T00:00:00.000Z",20,FALSE,18,38017700,"G",18,18,"Minnesota Timberwolves","Wendell Moore Jr.",0,0,0,0,0,0
0,0,0,0,0,0,0,0,0,"01",0,1,0,0,0,0,1038043,"2024-01-01T00:00:00.000Z",20,FALSE,18,173,"F",30,20,"New York Knicks","Taj Gibson",0,0,0,0,0,0
0,0,0,0,0,0,0,0,0,"00",0,0,0,0,0,0,1038043,"2024-01-01T00:00:00.000Z",20,FALSE,18,17896063,"F",20,20,"New York Knicks","Jericho Sims",0,0,0,0,0,0
2,0,0,2,1,3,1,0,0,"17",0,2,3,0,0,0,1038043,"2024-01-01T00:00:00.000Z",20,FALSE,18,666400,"G",18,18,"Minnesota Timberwolves","Nickeil Alexander-Walker",0,3,5,5,2,6
1,0,6,2,1,12,6,8,6,"30",3,5,19,9,0,5,1038044,"2024-01-01T00:00:00.000Z",28,FALSE,6,666423,"F-G",20,28,"Toronto Raptors","RJ Barrett",0,28,29,20,10,26.3
2,0,5,8,5,20,13,6,5,"40",0,3,36,5,1,1,1038044,"2024-01-01T00:00:00.000Z",28,FALSE,6,416,"F",28,28,"Toronto Raptors","Pascal Siakam",1,41,43,38,7,47
4,3,7,0,0,8,5,7,4,"37",4,4,14,11,0,4,1038044,"2024-01-01T00:00:00.000Z",28,FALSE,6,373,"C",28,28,"Toronto Raptors","Jakob Poeltl",3,25,29,18,15,38.2
5,1,5,5,1,17,7,7,5,"36",1,3,20,6,1,0,1038044,"2024-01-01T00:00:00.000Z",28,FALSE,6,17896055,"G-F",28,28,"Toronto Raptors","Scottie Barnes",2,26,31,25,11,40.7
3,0,6,5,2,13,5,3,2,"28",0,4,14,6,2,0,1038044,"2024-01-01T00:00:00.000Z",28,FALSE,6,3547269,"G",20,28,"Toronto Raptors","Immanuel Quickley",2,20,23,17,9,31.7
0,0,1,0,0,0,0,0,0,"11",0,0,0,1,0,0,1038044,"2024-01-01T00:00:00.000Z",28,FALSE,6,58,"F",28,28,"Toronto Raptors","Chris Boucher",0,1,1,0,1,1.2
0,0,0,0,0,0,0,0,0,"00",0,0,0,0,0,0,1038044,"2024-01-01T00:00:00.000Z",28,FALSE,6,56677828,"G",28,28,"Toronto Raptors","Gradey Dick",0,0,0,0,0,0
0,0,0,0,0,0,0,0,0,"00",0,0,0,0,0,0,1038044,"2024-01-01T00:00:00.000Z",28,FALSE,6,56677805,"G",28,28,"Toronto Raptors","Javon Freeman-Liberty",0,0,0,0,0,0
0,0,0,0,0,0,0,0,0,"00",0,0,0,0,0,0,1038044,"2024-01-01T00:00:00.000Z",28,FALSE,6,666762,"F",28,28,"Toronto Raptors","Jalen McDaniels",0,0,0,0,0,0
0,0,0,0,0,0,0,0,0,"00",0,0,0,0,0,0,1038044,"2024-01-01T00:00:00.000Z",28,FALSE,6,2309958,"C-F",15,28,"Toronto Raptors","Jontay Porter",0,0,0,0,0,0
0,0,0,0,0,0,0,0,0,"00",0,0,0,0,0,0,1038044,"2024-01-01T00:00:00.000Z",28,FALSE,6,376,"F",28,28,"Toronto Raptors","Otto Porter Jr.",0,0,0,0,0,0
8,0,3,5,1,7,3,7,5,"30",0,2,12,3,0,1,1038044,"2024-01-01T00:00:00.000Z",28,FALSE,6,409,"G",28,28,"Toronto Raptors","Dennis Schroder",0,15,23,20,11,26.6
0,0,0,0,0,0,0,0,0,"00",0,0,0,0,0,0,1038044,"2024-01-01T00:00:00.000Z",28,FALSE,6,436,"G-F",28,28,"Toronto Raptors","Garrett Temple",0,0,0,0,0,0
2,0,4,5,1,10,3,2,2,"26",2,1,9,6,1,0,1038044,"2024-01-01T00:00:00.000Z",28,FALSE,6,3089,"",28,28,"Toronto Raptors","Gary Trent Jr.",1,15,17,11,8,22.2
0,0,0,0,0,0,0,0,0,"02",0,0,0,0,0,0,1038044,"2024-01-01T00:00:00.000Z",28,FALSE,6,489,"F",28,28,"Toronto Raptors","Thaddeus Young",0,0,0,0,0,0
0,0,0,0,0,0,0,0,0,"00",0,0,0,0,0,0,1038044,"2024-01-01T00:00:00.000Z",28,FALSE,6,38017710,"C",28,28,"Toronto Raptors","Christian Koloko",0,0,0,0,0,0
0,0,0,0,0,0,0,0,0,"00",0,0,0,0,0,0,1038044,"2024-01-01T00:00:00.000Z",28,FALSE,6,56677869,"G",28,28,"Toronto Raptors","Markquis Nowell",0,0,0,0,0,0
3,1,1,4,0,10,5,7,6,"28",0,4,16,1,2,1,1038044,"2024-01-01T00:00:00.000Z",28,FALSE,6,3547247,"F-G",6,6,"Cleveland Cavaliers","Isaac Okoro",3,17,20,19,4,29.7
0,0,3,1,0,2,1,0,0,"21",0,2,2,3,1,0,1038044,"2024-01-01T00:00:00.000Z",28,FALSE,6,666940,"F",6,6,"Cleveland Cavaliers","Dean Wade",1,5,5,2,3,8.6
4,0,8,0,0,11,5,8,6,"34",3,4,16,11,1,0,1038044,"2024-01-01T00:00:00.000Z",28,FALSE,6,9,"C",6,6,"Cleveland Cavaliers","Jarrett Allen",1,27,31,20,15,38.2
3,1,6,5,2,7,2,0,0,"37",0,4,6,6,1,3,1038044,"2024-01-01T00:00:00.000Z",28,FALSE,6,666908,"G",6,6,"Cleveland Cavaliers","Max Strus",2,12,15,9,9,20.7
7,0,6,9,4,21,8,6,6,"38",1,4,26,7,4,3,1038044,"2024-01-01T00:00:00.000Z",28,FALSE,6,322,"G",6,6,"Cleveland Cavaliers","Donovan Mitchell",4,33,40,33,14,53.9
0,0,0,0,0,0,0,0,0,"00",0,0,0,0,0,0,1038044,"2024-01-01T00:00:00.000Z",28,FALSE,6,666676,"G",6,6,"Cleveland Cavaliers","Ty Jerome",0,0,0,0,0,0
0,0,0,0,0,0,0,0,0,"00",0,0,0,0,0,0,1038044,"2024-01-01T00:00:00.000Z",28,FALSE,6,248,"C",6,6,"Cleveland Cavaliers","Damian Jones",0,0,0,0,0,0
4,0,4,7,2,20,12,5,5,"29",0,0,31,4,0,0,1038044,"2024-01-01T00:00:00.000Z",28,FALSE,6,277,"G",6,6,"Cleveland Cavaliers","Caris LeVert",0,35,39,35,8,41.8
1,0,3,8,4,11,6,0,0,"17",0,2,16,3,0,1,1038044,"2024-01-01T00:00:00.000Z",28,FALSE,6,3547299,"G",6,6,"Cleveland Cavaliers","Sam Merrill",0,19,20,17,4,20.1
2,0,4,1,0,5,4,0,0,"16",0,5,8,4,0,1,1038044,"2024-01-01T00:00:00.000Z",28,FALSE,6,344,"F",6,6,"Cleveland Cavaliers","Georges Niang",0,12,14,10,6,14.8
0,0,1,1,0,2,0,0,0,"06",0,1,0,1,0,0,1038044,"2024-01-01T00:00:00.000Z",28,FALSE,6,56677872,"G",6,6,"Cleveland Cavaliers","Craig Porter",0,1,1,0,1,1.2
1,0,1,0,0,0,0,0,0,"14",2,3,0,3,0,0,1038044,"2024-01-01T00:00:00.000Z",28,FALSE,6,444,"C-F",6,6,"Cleveland Cavaliers","Tristan Thompson",0,3,4,1,4,5.1
0,0,0,0,0,0,0,0,0,"00",0,0,0,0,0,0,1038044,"2024-01-01T00:00:00.000Z",28,FALSE,6,56677847,"F",6,6,"Cleveland Cavaliers","Emoni Bates",0,0,0,0,0,0
0,0,0,0,0,0,0,0,0,"00",0,0,0,0,0,0,1038044,"2024-01-01T00:00:00.000Z",28,FALSE,6,666581,"G",6,6,"Cleveland Cavaliers","Darius Garland",0,0,0,0,0,0
0,0,0,0,0,0,0,0,0,"00",0,0,0,0,0,0,1038044,"2024-01-01T00:00:00.000Z",28,FALSE,6,17896076,"F-C",6,6,"Cleveland Cavaliers","Evan Mobley",0,0,0,0,0,0
0,0,0,0,0,0,0,0,0,"00",0,0,0,0,0,0,1038044,"2024-01-01T00:00:00.000Z",28,FALSE,6,38017662,"F",6,6,"Cleveland Cavaliers","Isaiah Mobley",0,0,0,0,0,0
0,0,0,0,0,0,0,0,0,"00",0,0,0,0,0,0,1038044,"2024-01-01T00:00:00.000Z",28,FALSE,6,404,"G",6,6,"Cleveland Cavaliers","Ricky Rubio",0,0,0,0,0,0
0,0,3,2,0,10,6,6,4,"26",0,6,16,3,1,1,1038045,"2024-01-01T00:00:00.000Z",11,FALSE,9,3547301,"F",11,11,"Houston Rockets","Jae'Sean Tate",1,19,19,16,3,21.6
1,1,6,5,3,7,3,0,0,"27",0,1,9,6,0,1,1038045,"2024-01-01T00:00:00.000Z",11,FALSE,9,38017684,"F",11,11,"Houston Rockets","Jabari Smith Jr.",1,15,16,10,7,19.7
9,0,3,2,0,13,9,9,8,"27",1,3,26,4,3,2,1038045,"2024-01-01T00:00:00.000Z",11,FALSE,9,17896062,"F-C",11,11,"Houston Rockets","Alperen Sengun",3,30,39,35,13,51.3
1,0,5,9,5,12,6,6,5,"27",0,0,22,5,1,0,1038045,"2024-01-01T00:00:00.000Z",11,FALSE,9,17895966,"G",11,11,"Houston Rockets","Jalen Green",1,27,28,23,6,32.5
7,0,1,6,3,11,6,0,0,"26",0,1,15,1,1,1,1038045,"2024-01-01T00:00:00.000Z",11,FALSE,9,458,"G",11,11,"Houston Rockets","Fred VanVleet",1,16,23,22,8,28.7
0,0,0,0,0,0,0,0,0,"00",0,0,0,0,0,0,1038045,"2024-01-01T00:00:00.000Z",11,FALSE,9,66,"G-F",11,11,"Houston Rockets","Dillon Brooks",0,0,0,0,0,0
2,0,2,2,1,5,3,0,0,"14",0,0,7,2,0,1,1038045,"2024-01-01T00:00:00.000Z",11,FALSE,9,75,"G-F",11,11,"Houston Rockets","Reggie Bullock",0,9,11,9,4,11.4
1,0,2,4,1,15,8,0,0,"24",2,3,17,4,3,0,1038045,"2024-01-01T00:00:00.000Z",11,FALSE,9,38017695,"F",11,11,"Houston Rockets","Tari Eason",3,21,22,18,5,32.3
2,0,2,1,0,2,1,2,1,"09",0,0,3,2,0,1,1038045,"2024-01-01T00:00:00.000Z",11,FALSE,9,188,"F",11,11,"Houston Rockets","Jeff Green",0,5,7,5,4,7.4
4,0,2,1,0,3,0,0,0,"11",1,1,0,3,0,0,1038045,"2024-01-01T00:00:00.000Z",11,FALSE,9,213,"G",11,11,"Houston Rockets","Aaron Holiday",0,3,7,4,7,9.6
2,2,3,0,0,4,2,2,1,"24",1,2,5,4,0,2,1038045,"2024-01-01T00:00:00.000Z",11,FALSE,9,56677826,"G-F",9,9,"Detroit Pistons","Ausar Thompson",2,9,11,7,6,16.8
0,1,3,0,0,1,1,2,2,"17",1,5,4,4,0,1,1038045,"2024-01-01T00:00:00.000Z",11,FALSE,9,3547240,"C",9,9,"Detroit Pistons","James Wiseman",1,8,8,4,4,10.8
2,0,1,6,3,11,4,4,3,"27",1,0,14,2,0,4,1038045,"2024-01-01T00:00:00.000Z",11,FALSE,9,54,"F",9,9,"Detroit Pistons","Bojan Bogdanovic",0,16,18,16,4,15.4
0,0,3,4,1,7,4,2,2,"23",0,2,11,3,0,0,1038045,"2024-01-01T00:00:00.000Z",11,FALSE,9,259,"F",9,9,"Detroit Pistons","Kevin Knox",0,14,14,11,3,14.6
1,0,11,0,0,7,6,0,0,"22",2,5,12,13,0,1,1038045,"2024-01-01T00:00:00.000Z",11,FALSE,9,38017694,"C",9,9,"Detroit Pistons","Jalen Duren",0,25,26,13,14,28.1
3,0,2,4,3,10,6,4,4,"26",4,1,19,6,0,2,1038045,"2024-01-01T00:00:00.000Z",11,FALSE,9,38017682,"G",9,9,"Detroit Pistons","Jaden Ivey",0,25,28,22,9,28.7
10,0,1,5,0,16,3,1,0,"30",0,2,6,1,0,4,1038045,"2024-01-01T00:00:00.000Z",11,FALSE,9,17896075,"G-F",9,9,"Detroit Pistons","Cade Cunningham",0,7,17,16,11,18.2
2,0,0,0,0,2,1,0,0,"09",0,0,2,0,0,0,1038045,"2024-01-01T00:00:00.000Z",11,FALSE,9,24,"F",9,9,"Detroit Pistons","Marvin Bagley III",0,2,4,4,2,5
2,1,2,6,3,11,6,6,6,"23",0,2,21,2,1,2,1038045,"2024-01-01T00:00:00.000Z",11,FALSE,9,77,"G",9,9,"Detroit Pistons","Alec Burks",2,23,25,23,4,30.4
0,0,0,0,0,0,0,0,0,"00",0,0,0,0,0,0,1038045,"2024-01-01T00:00:00.000Z",11,FALSE,9,197,"F-G",9,9,"Detroit Pistons","Joe Harris",0,0,0,0,0,0
3,0,1,2,1,8,3,4,1,"19",0,2,8,1,1,1,1038045,"2024-01-01T00:00:00.000Z",11,FALSE,9,3547241,"G",9,9,"Detroit Pistons","Killian Hayes",1,9,12,11,4,15.7
0,0,0,0,0,2,1,0,0,"13",0,0,2,0,0,0,1038045,"2024-01-01T00:00:00.000Z",11,FALSE,9,17896071,"F",9,9,"Detroit Pistons","Isaiah Livers",0,2,2,2,0,2
2,0,0,2,2,3,3,2,1,"07",0,0,9,0,1,0,1038045,"2024-01-01T00:00:00.000Z",11,FALSE,9,56677792,"G",9,9,"Detroit Pistons","Marcus Sasser",1,9,11,11,2,15
0,0,0,0,0,0,0,0,0,"00",0,0,0,0,0,0,1038045,"2024-01-01T00:00:00.000Z",11,FALSE,9,56677729,"G",9,9,"Detroit Pistons","Malcolm Cazalon",0,0,0,0,0,0
0,0,0,0,0,0,0,0,0,"00",0,0,0,0,0,0,1038045,"2024-01-01T00:00:00.000Z",11,FALSE,9,330,"G",9,9,"Detroit Pistons","Monte Morris",0,0,0,0,0,0
0,0,0,0,0,0,0,0,0,"07",0,0,0,0,0,0,1038045,"2024-01-01T00:00:00.000Z",11,FALSE,9,19465326,"C",11,11,"Houston Rockets","Jock Landale",0,0,0,0,0,0
1,0,1,1,0,2,0,0,0,"06",0,1,0,1,0,0,1038045,"2024-01-01T00:00:00.000Z",11,FALSE,9,296,"C",11,11,"Houston Rockets","Boban Marjanovic",0,1,2,1,2,2.7
6,0,3,1,1,6,5,1,1,"28",1,3,12,4,2,2,1038045,"2024-01-01T00:00:00.000Z",11,FALSE,9,56677825,"G-F",11,11,"Houston Rockets","Amen Thompson",2,16,22,18,10,29.8
0,0,3,1,1,5,4,0,0,"08",1,0,9,4,0,0,1038045,"2024-01-01T00:00:00.000Z",11,FALSE,9,56677831,"F",11,11,"Houston Rockets","Cam Whitmore",0,13,13,9,4,13.8
0,0,0,0,0,0,0,0,0,"00",0,0,0,0,0,0,1038045,"2024-01-01T00:00:00.000Z",11,FALSE,9,3547281,"G-F",11,11,"Houston Rockets","Nate Hinton",0,0,0,0,0,0
0,0,0,0,0,0,0,0,0,"00",0,0,0,0,0,0,1038045,"2024-01-01T00:00:00.000Z",11,FALSE,9,357,"G",11,11,"Houston Rockets","Victor Oladipo",0,0,0,0,0,0
0,0,0,0,0,0,0,0,0,"00",0,0,0,0,0,0,1038045,"2024-01-01T00:00:00.000Z",11,FALSE,9,56677809,"F",11,11,"Houston Rockets","Jermaine Samuels Jr.",0,0,0,0,0,0
0,0,0,0,0,0,0,0,0,"00",0,0,0,0,0,0,1038045,"2024-01-01T00:00:00.000Z",11,FALSE,9,47738533,"G",11,11,"Houston Rockets","Jeenathan Williams",0,0,0,0,0,0
0,0,0,0,0,0,0,0,0,"00",0,0,0,0,0,0,1038045,"2024-01-01T00:00:00.000Z",11,FALSE,9,42097199,"G",9,9,"Detroit Pistons","Jared Rhoden",0,0,0,0,0,0
0,0,0,0,0,0,0,0,0,"00",0,0,0,0,0,0,1038045,"2024-01-01T00:00:00.000Z",11,FALSE,9,3547267,"F-C",9,9,"Detroit Pistons","Isaiah Stewart",0,0,0,0,0,0
0,0,0,0,0,0,0,0,0,"00",0,0,0,0,0,0,1038045,"2024-01-01T00:00:00.000Z",11,FALSE,9,44477024,"G",9,9,"Detroit Pistons","Stanley Umude",0,0,0,0,0,0
6,0,2,5,2,13,9,2,1,"32",1,5,21,3,1,4,1038046,"2024-01-01T00:00:00.000Z",17,FALSE,12,315,"F",17,17,"Milwaukee Bucks","Khris Middleton",1,24,30,27,9,32.6
11,2,15,3,0,20,11,11,8,"37",3,3,30,18,1,4,1038046,"2024-01-01T00:00:00.000Z",17,FALSE,12,15,"F",17,17,"Milwaukee Bucks","Giannis Antetokounmpo",3,48,59,41,29,73.1
1,4,4,6,2,17,8,4,3,"38",1,3,21,5,0,0,1038046,"2024-01-01T00:00:00.000Z",17,FALSE,12,283,"C",17,17,"Milwaukee Bucks","Brook Lopez",4,26,27,22,6,40.5
0,0,4,8,4,8,4,0,0,"37",0,5,12,4,0,0,1038046,"2024-01-01T00:00:00.000Z",17,FALSE,12,38,"G",17,17,"Milwaukee Bucks","Malik Beasley",0,16,16,12,4,16.8
5,0,6,9,1,16,3,6,6,"38",1,3,13,7,0,1,1038046,"2024-01-01T00:00:00.000Z",17,FALSE,12,278,"G",17,17,"Milwaukee Bucks","Damian Lillard",0,20,25,18,12,27.9
0,0,0,0,0,0,0,0,0,"00",0,0,0,0,0,0,1038046,"2024-01-01T00:00:00.000Z",17,FALSE,12,2148,"",17,17,"Milwaukee Bucks","Thanasis Antetokounmpo",0,0,0,0,0,0
0,0,0,0,0,0,0,0,0,"00",0,0,0,0,0,0,1038046,"2024-01-01T00:00:00.000Z",17,FALSE,12,666453,"C",17,17,"Milwaukee Bucks","Marques Bolden",0,0,0,0,0,0
2,1,2,3,1,3,1,0,0,"23",0,1,3,2,1,0,1038046,"2024-01-01T00:00:00.000Z",17,FALSE,12,105,"G",17,17,"Milwaukee Bucks","Pat Connaughton",2,5,7,5,4,14.4
0,0,0,0,0,0,0,0,0,"00",0,0,0,0,0,0,1038046,"2024-01-01T00:00:00.000Z",17,FALSE,12,38017733,"G",17,17,"Milwaukee Bucks","A.J. Green",0,0,0,0,0,0
0,0,1,0,0,0,0,0,0,"05",0,1,0,1,0,0,1038046,"2024-01-01T00:00:00.000Z",17,FALSE,12,56677852,"G",17,17,"Milwaukee Bucks","Andre Jackson Jr.",0,1,1,0,1,1.2
0,0,0,0,0,0,0,0,0,"00",0,0,0,0,0,0,1038046,"2024-01-01T00:00:00.000Z",17,FALSE,12,56677854,"F",17,17,"Milwaukee Bucks","Chris Livingston",0,0,0,0,0,0
0,0,0,0,0,0,0,0,0,"00",0,0,0,0,0,0,1038046,"2024-01-01T00:00:00.000Z",17,FALSE,12,284,"C",17,17,"Milwaukee Bucks","Robin Lopez",0,0,0,0,0,0
2,0,0,2,0,4,1,3,3,"12",1,1,5,1,1,2,1038046,"2024-01-01T00:00:00.000Z",17,FALSE,12,368,"G",17,17,"Milwaukee Bucks","Cameron Payne",1,6,8,7,3,10.2
0,1,4,4,0,12,4,0,0,"18",1,4,8,5,0,0,1038046,"2024-01-01T00:00:00.000Z",17,FALSE,12,377,"F",17,17,"Milwaukee Bucks","Bobby Portis",1,13,13,8,5,17
0,0,0,0,0,0,0,0,0,"00",0,0,0,0,0,0,1038046,"2024-01-01T00:00:00.000Z",17,FALSE,12,666960,"G",17,17,"Milwaukee Bucks","Lindell Wigginton",0,0,0,0,0,0
0,0,0,0,0,0,0,0,0,"00",0,0,0,0,0,0,1038046,"2024-01-01T00:00:00.000Z",17,FALSE,12,38017676,"F",17,17,"Milwaukee Bucks","MarJon Beauchamp",0,0,0,0,0,0
0,0,0,0,0,0,0,0,0,"00",0,0,0,0,0,0,1038046,"2024-01-01T00:00:00.000Z",17,FALSE,12,112,"F",17,17,"Milwaukee Bucks","Jae Crowder",0,0,0,0,0,0
0,0,0,0,0,0,0,0,0,"00",0,0,0,0,0,0,1038046,"2024-01-01T00:00:00.000Z",17,FALSE,12,38017691,"G",17,17,"Milwaukee Bucks","TyTy Washington Jr.",0,0,0,0,0,0
0,2,4,7,1,10,1,2,1,"27",1,4,4,5,3,0,1038046,"2024-01-01T00:00:00.000Z",17,FALSE,12,3547250,"G-F",12,12,"Indiana Pacers","Aaron Nesmith",5,9,9,4,5,25
0,0,1,6,1,10,3,0,0,"12",1,1,7,2,0,0,1038046,"2024-01-01T00:00:00.000Z",17,FALSE,12,3547264,"F-C",12,12,"Indiana Pacers","Jalen Smith",0,9,9,7,2,9.4
0,2,3,2,0,5,3,7,7,"28",1,5,13,4,0,0,1038046,"2024-01-01T00:00:00.000Z",17,FALSE,12,452,"C-F",12,12,"Indiana Pacers","Myles Turner",2,17,17,13,4,23.8
0,0,0,0,0,2,1,0,0,"08",0,0,2,0,0,2,1038046,"2024-01-01T00:00:00.000Z",17,FALSE,12,38017507,"G-F",12,12,"Indiana Pacers","Andrew Nembhard",0,2,2,2,0,0
11,1,8,7,1,22,11,3,3,"37",1,0,26,9,1,2,1038046,"2024-01-01T00:00:00.000Z",17,FALSE,12,3547245,"G",12,12,"Indiana Pacers","Tyrese Haliburton",2,35,46,37,20,57.3
0,0,1,4,0,6,0,0,0,"21",2,2,0,3,0,0,1038046,"2024-01-01T00:00:00.000Z",17,FALSE,12,210,"G",12,12,"Indiana Pacers","Buddy Hield",0,3,3,0,3,3.6
1,0,7,0,0,9,6,7,6,"20",2,5,18,9,1,2,1038046,"2024-01-01T00:00:00.000Z",17,FALSE,12,17896035,"F",12,12,"Indiana Pacers","Isaiah Jackson",1,27,28,19,10,31.3
0,0,0,0,0,0,0,0,0,"00",0,0,0,0,0,0,1038046,"2024-01-01T00:00:00.000Z",17,FALSE,12,242,"F",12,12,"Indiana Pacers","James Johnson",0,0,0,0,0,0
0,0,10,5,1,15,9,9,6,"36",3,3,25,13,0,1,1038046,"2024-01-01T00:00:00.000Z",17,FALSE,12,38017686,"G-F",12,12,"Indiana Pacers","Bennedict Mathurin",0,38,38,25,13,39.6
9,0,3,1,0,9,5,8,6,"22",1,0,16,4,1,0,1038046,"2024-01-01T00:00:00.000Z",17,FALSE,12,304,"G",12,12,"Indiana Pacers","T.J. McConnell",1,20,29,25,13,37.3
0,0,0,0,0,0,0,0,0,"00",0,0,0,0,0,0,1038046,"2024-01-01T00:00:00.000Z",17,FALSE,12,3547207,"F",12,12,"Indiana Pacers","Jordan Nwora",0,0,0,0,0,0
0,0,0,0,0,0,0,0,0,"00",0,0,0,0,0,0,1038046,"2024-01-01T00:00:00.000Z",17,FALSE,12,56677861,"G",12,12,"Indiana Pacers","Ben Sheppard",0,0,0,0,0,0
2,0,1,3,1,9,4,2,2,"29",2,4,11,3,1,0,1038046,"2024-01-01T00:00:00.000Z",17,FALSE,12,3547243,"F",12,12,"Indiana Pacers","Obi Toppin",1,14,16,13,5,20.6
0,0,0,0,0,0,0,0,0,"00",0,0,0,0,0,0,1038046,"2024-01-01T00:00:00.000Z",17,FALSE,12,56677832,"F",12,12,"Indiana Pacers","Jarace Walker",0,0,0,0,0,0
0,0,0,0,0,0,0,0,0,"00",0,0,0,0,0,0,1038046,"2024-01-01T00:00:00.000Z",17,FALSE,12,69,"G",12,12,"Indiana Pacers","Bruce Brown",0,0,0,0,0,0
0,0,0,0,0,0,0,0,0,"00",0,0,0,0,0,0,1038046,"2024-01-01T00:00:00.000Z",17,FALSE,12,38017701,"G",12,12,"Indiana Pacers","Kendall Brown",0,0,0,0,0,0
0,0,0,0,0,0,0,0,0,"00",0,0,0,0,0,0,1038046,"2024-01-01T00:00:00.000Z",17,FALSE,12,56677778,"F-C",12,12,"Indiana Pacers","Oscar Tshiebwe",0,0,0,0,0,0
0,0,0,0,0,0,0,0,0,"00",0,0,0,0,0,0,1038046,"2024-01-01T00:00:00.000Z",17,FALSE,12,56677794,"G",12,12,"Indiana Pacers","Isaiah Wong",0,0,0,0,0,0
1,0,7,11,4,17,8,2,2,"31",1,1,22,8,0,1,1038047,"2024-01-01T00:00:00.000Z",8,FALSE,4,375,"F",8,8,"Denver Nuggets","Michael Porter Jr.",0,30,31,23,9,32.1
0,1,1,1,1,5,4,2,1,"25",1,0,10,2,1,0,1038047,"2024-01-01T00:00:00.000Z",8,FALSE,4,177,"F",8,8,"Denver Nuggets","Aaron Gordon",2,12,12,10,2,18.4
6,1,11,0,0,7,6,1,1,"27",0,2,13,11,1,3,1038047,"2024-01-01T00:00:00.000Z",8,FALSE,4,246,"C",8,8,"Denver Nuggets","Nikola Jokic",2,24,30,19,17,38.2
4,0,3,3,0,6,2,1,1,"29",0,3,5,3,1,0,1038047,"2024-01-01T00:00:00.000Z",8,FALSE,4,81,"G",8,8,"Denver Nuggets","Kentavious Caldwell-Pope",1,8,12,9,7,17.6
7,1,3,9,5,16,7,7,6,"27",0,1,25,3,2,2,1038047,"2024-01-01T00:00:00.000Z",8,FALSE,4,335,"G",8,8,"Denver Nuggets","Jamal Murray",3,28,35,32,10,46.1
2,2,3,3,1,6,3,3,2,"24",1,1,9,4,1,1,1038047,"2024-01-01T00:00:00.000Z",8,FALSE,4,38017709,"G",8,8,"Denver Nuggets","Christian Braun",3,13,15,11,6,24.8
0,0,0,0,0,0,0,0,0,"00",0,0,0,0,0,0,1038047,"2024-01-01T00:00:00.000Z",8,FALSE,4,215,"F-G",8,8,"Denver Nuggets","Justin Holiday",0,0,0,0,0,0
4,0,4,3,2,11,6,2,1,"17",0,2,15,4,1,0,1038047,"2024-01-01T00:00:00.000Z",8,FALSE,4,236,"G",8,8,"Denver Nuggets","Reggie Jackson",1,19,23,19,8,28.8
0,0,0,0,0,0,0,0,0,"00",0,0,0,0,0,0,1038047,"2024-01-01T00:00:00.000Z",8,FALSE,4,250,"C",8,8,"Denver Nuggets","DeAndre Jordan",0,0,0,0,0,0
0,0,1,0,0,1,0,0,0,"04",0,0,0,1,1,0,1038047,"2024-01-01T00:00:00.000Z",8,FALSE,4,17896007,"G",8,8,"Denver Nuggets","Braxton Key",1,1,1,0,1,4.2
1,3,2,2,0,5,1,0,0,"20",1,2,2,3,0,2,1038047,"2024-01-01T00:00:00.000Z",8,FALSE,4,3547268,"F-C",8,8,"Denver Nuggets","Zeke Nnaji",3,5,6,3,4,14.1
1,1,4,4,2,6,3,0,0,"19",0,2,8,4,1,0,1038047,"2024-01-01T00:00:00.000Z",8,FALSE,4,38017721,"G",8,8,"Denver Nuggets","Peyton Watson",2,12,13,9,5,20.3
0,0,0,0,0,0,0,0,0,"00",0,0,0,0,0,0,1038047,"2024-01-01T00:00:00.000Z",8,FALSE,4,666489,"F",8,8,"Denver Nuggets","Vlatko Cancar",0,0,0,0,0,0
0,0,0,0,0,0,0,0,0,"00",0,0,0,0,0,0,1038047,"2024-01-01T00:00:00.000Z",8,FALSE,4,38017727,"G",8,8,"Denver Nuggets","Collin Gillespie",0,0,0,0,0,0
0,0,0,0,0,0,0,0,0,"00",0,0,0,0,0,0,1038047,"2024-01-01T00:00:00.000Z",8,FALSE,4,17896103,"F-C",8,8,"Denver Nuggets","Jay Huff",0,0,0,0,0,0
0,0,0,0,0,0,0,0,0,"00",0,0,0,0,0,0,1038047,"2024-01-01T00:00:00.000Z",8,FALSE,4,56677871,"F",8,8,"Denver Nuggets","Hunter Tyson",0,0,0,0,0,0
3,0,2,3,2,8,4,0,0,"23",0,4,10,2,0,0,1038047,"2024-01-01T00:00:00.000Z",8,FALSE,4,38017708,"G",4,4,"Charlotte Hornets","Bryce McGowens",0,12,15,13,5,16.9
5,0,9,5,3,14,10,5,3,"36",0,1,26,9,1,2,1038047,"2024-01-01T00:00:00.000Z",8,FALSE,4,62,"F",4,4,"Charlotte Hornets","Miles Bridges",1,35,40,31,14,45.3
1,1,6,0,0,12,7,2,1,"30",2,2,15,8,1,0,1038047,"2024-01-01T00:00:00.000Z",8,FALSE,4,3547282,"C",4,4,"Charlotte Hornets","Nick Richards",2,23,24,16,9,32.1
0,0,0,0,0,0,0,0,0,"00",0,0,0,0,0,0,1038047,"2024-01-01T00:00:00.000Z",8,FALSE,4,38017698,"C",4,4,"Charlotte Hornets","Mark Williams",0,0,0,0,0,0
0,0,0,1,0,1,0,0,0,"04",0,0,0,0,0,0,1038047,"2024-01-01T00:00:00.000Z",8,FALSE,4,56677582,"G",8,8,"Denver Nuggets","Jalen Pickett",0,0,0,0,0,0
1,0,1,1,0,2,1,0,0,"13",0,1,2,1,0,1,1038047,"2024-01-01T00:00:00.000Z",8,FALSE,4,56677776,"G",8,8,"Denver Nuggets","Julian Strawther",0,3,4,3,2,3.7
1,0,5,9,3,17,5,2,2,"32",0,1,15,5,0,2,1038047,"2024-01-01T00:00:00.000Z",8,FALSE,4,56677823,"F",4,4,"Charlotte Hornets","Brandon Miller",0,20,21,16,6,20.5
4,0,2,0,0,12,5,0,0,"29",1,2,10,3,0,4,1038047,"2024-01-01T00:00:00.000Z",8,FALSE,4,422,"G",4,4,"Charlotte Hornets","Ish Smith",0,13,17,14,7,15.6
6,2,2,3,0,6,0,4,2,"25",1,0,2,3,2,0,1038047,"2024-01-01T00:00:00.000Z",8,FALSE,4,666748,"F",4,4,"Charlotte Hornets","Cody Martin",4,5,11,8,9,26.6
0,0,5,3,1,5,2,1,1,"26",1,2,6,6,0,2,1038047,"2024-01-01T00:00:00.000Z",8,FALSE,4,666950,"F",4,4,"Charlotte Hornets","P.J. Washington",0,12,12,6,6,11.2
2,1,1,3,1,8,2,0,0,"19",2,2,5,3,0,2,1038047,"2024-01-01T00:00:00.000Z",8,FALSE,4,56677846,"G",4,4,"Charlotte Hornets","Nick Smith Jr.",1,8,10,7,5,12.6
0,0,3,0,0,1,0,2,2,"12",1,1,2,4,0,0,1038047,"2024-01-01T00:00:00.000Z",8,FALSE,4,NA,NA,NA,4,"Charlotte Hornets","NA NA",0,6,6,2,4,6.8
2,0,0,0,0,1,0,0,0,"04",0,0,0,0,0,0,1038047,"2024-01-01T00:00:00.000Z",8,FALSE,4,17896037,"G",4,4,"Charlotte Hornets","James Bouknight",0,0,2,2,2,3
0,0,0,0,0,0,0,0,0,"00",0,0,0,0,0,0,1038047,"2024-01-01T00:00:00.000Z",8,FALSE,4,347,"G",4,4,"Charlotte Hornets","Frank Ntilikina",0,0,0,0,0,0
0,1,2,0,0,2,1,0,0,"04",0,0,2,2,0,0,1038047,"2024-01-01T00:00:00.000Z",8,FALSE,4,18678001,"F",4,4,"Charlotte Hornets","JT Thor",1,4,4,2,2,7.4
0,0,0,0,0,0,0,0,0,"00",0,0,0,0,0,0,1038047,"2024-01-01T00:00:00.000Z",8,FALSE,4,56677848,"G",4,4,"Charlotte Hornets","Amari Bailey",0,0,0,0,0,0
0,0,0,0,0,0,0,0,0,"00",0,0,0,0,0,0,1038047,"2024-01-01T00:00:00.000Z",8,FALSE,4,3547239,"G",4,4,"Charlotte Hornets","LaMelo Ball",0,0,0,0,0,0
0,0,0,0,0,0,0,0,0,"00",0,0,0,0,0,0,1038047,"2024-01-01T00:00:00.000Z",8,FALSE,4,56677866,"F",4,4,"Charlotte Hornets","Leaky Black",0,0,0,0,0,0
0,0,0,0,0,0,0,0,0,"00",0,0,0,0,0,0,1038047,"2024-01-01T00:00:00.000Z",8,FALSE,4,204,"F",4,4,"Charlotte Hornets","Gordon Hayward",0,0,0,0,0,0
0,0,0,0,0,0,0,0,0,"00",0,0,0,0,0,0,1038047,"2024-01-01T00:00:00.000Z",8,FALSE,4,403,"G",4,4,"Charlotte Hornets","Terry Rozier",0,0,0,0,0,0
4,1,2,5,2,7,4,2,2,"28",0,1,12,2,2,1,1038048,"2024-01-01T00:00:00.000Z",24,FALSE,25,8,"G",24,24,"Phoenix Suns","Grayson Allen",3,14,18,16,6,28.4
1,0,3,4,2,8,4,4,4,"26",2,3,14,5,1,2,1038048,"2024-01-01T00:00:00.000Z",24,FALSE,25,314,"F",24,24,"Phoenix Suns","Chimezie Metu",1,19,20,15,6,22.5
5,2,6,2,1,8,6,6,5,"25",1,3,18,7,1,2,1038048,"2024-01-01T00:00:00.000Z",24,FALSE,25,349,"C",24,24,"Phoenix Suns","Jusuf Nurkic",3,25,30,23,12,40.9
1,1,4,3,1,16,8,4,4,"34",0,2,21,4,1,4,1038048,"2024-01-01T00:00:00.000Z",24,FALSE,25,37,"G",24,24,"Phoenix Suns","Bradley Beal",2,25,26,22,5,29.3
6,0,5,4,1,16,4,2,1,"31",3,2,10,8,1,2,1038048,"2024-01-01T00:00:00.000Z",24,FALSE,25,57,"G",24,24,"Phoenix Suns","Devin Booker",1,18,24,16,14,29.6
0,0,2,0,0,2,0,2,0,"04",0,0,0,2,0,0,1038048,"2024-01-01T00:00:00.000Z",24,FALSE,25,3547095,"C-F",24,24,"Phoenix Suns","Udoka Azubuike",0,2,2,0,2,2.4
1,0,3,1,1,1,1,0,0,"17",0,1,3,3,2,0,1038048,"2024-01-01T00:00:00.000Z",24,FALSE,25,32,"F",24,24,"Phoenix Suns","Keita Bates-Diop",2,6,7,4,4,14.1
1,0,7,2,1,6,4,2,2,"20",2,5,11,9,0,2,1038048,"2024-01-01T00:00:00.000Z",24,FALSE,25,666451,"C",24,24,"Phoenix Suns","Bol Bol",0,20,21,12,10,21.3
0,0,1,0,0,0,0,4,1,"06",0,2,1,1,0,0,1038048,"2024-01-01T00:00:00.000Z",24,FALSE,25,147,"F",24,24,"Phoenix Suns","Drew Eubanks",0,2,2,1,1,2.2
1,0,0,1,0,2,1,0,0,"06",1,0,2,1,1,1,1038048,"2024-01-01T00:00:00.000Z",24,FALSE,25,18678058,"",24,24,"Phoenix Suns","Jordan Goodwin",1,3,4,3,2,6.7
1,0,3,6,2,10,4,5,2,"20",0,0,12,3,1,1,1038048,"2024-01-01T00:00:00.000Z",24,FALSE,25,178,"G",24,24,"Phoenix Suns","Eric Gordon",1,15,16,13,4,19.1
0,0,0,0,0,0,0,0,0,"00",0,0,0,0,0,0,1038048,"2024-01-01T00:00:00.000Z",24,FALSE,25,3547298,"G",24,24,"Phoenix Suns","Saben Lee",0,0,0,0,0,0
0,0,0,0,0,0,0,0,0,"00",0,0,0,0,0,0,1038048,"2024-01-01T00:00:00.000Z",24,FALSE,25,666729,"F",24,24,"Phoenix Suns","Nassir Little",0,0,0,0,0,0
3,1,2,0,0,2,1,2,1,"18",0,1,3,2,0,1,1038048,"2024-01-01T00:00:00.000Z",24,FALSE,25,356,"G",24,24,"Phoenix Suns","Josh Okogie",1,5,8,6,5,11.9
0,0,0,1,0,2,1,0,0,"05",0,0,2,0,0,0,1038048,"2024-01-01T00:00:00.000Z",24,FALSE,25,470,"G",24,24,"Phoenix Suns","Yuta Watanabe",0,2,2,2,0,2
0,0,0,0,0,0,0,0,0,"00",0,0,0,0,0,0,1038048,"2024-01-01T00:00:00.000Z",24,FALSE,25,140,"F",24,24,"Phoenix Suns","Kevin Durant",0,0,0,0,0,0
0,0,0,0,0,0,0,0,0,"00",0,0,0,0,0,0,1038048,"2024-01-01T00:00:00.000Z",24,FALSE,25,272,"G",24,24,"Phoenix Suns","Damion Lee",0,0,0,0,0,0
0,0,0,0,0,0,0,0,0,"00",0,0,0,0,0,0,1038048,"2024-01-01T00:00:00.000Z",24,FALSE,25,3547253,"G",4,24,"Phoenix Suns","Theo Maledon",0,0,0,0,0,0
0,2,3,4,1,5,1,0,0,"29",1,2,3,4,2,0,1038048,"2024-01-01T00:00:00.000Z",24,FALSE,25,666923,"G-F",25,25,"Portland Trail Blazers","Matisse Thybulle",4,7,7,3,4,19.8
3,1,1,3,1,12,6,3,2,"25",0,1,15,1,1,3,1038048,"2024-01-01T00:00:00.000Z",24,FALSE,25,182,"F",25,25,"Portland Trail Blazers","Jerami Grant",2,16,19,18,4,23.7
5,0,2,4,2,8,3,2,2,"21",0,0,10,2,0,2,1038048,"2024-01-01T00:00:00.000Z",24,FALSE,25,65,"G",25,25,"Portland Trail Blazers","Malcolm Brogdon",0,12,17,15,7,17.9
6,2,3,3,1,18,7,4,2,"34",0,1,17,3,1,5,1038048,"2024-01-01T00:00:00.000Z",24,FALSE,25,56677747,"G",25,25,"Portland Trail Blazers","Scoot Henderson",3,20,26,23,9,33.6
1,1,5,0,0,2,2,0,0,"23",0,6,4,5,0,2,1038048,"2024-01-01T00:00:00.000Z",24,FALSE,25,39613724,"C",25,25,"Portland Trail Blazers","Ibou Badji",1,9,10,5,6,12.5
1,0,0,5,0,8,2,2,2,"18",1,0,6,1,0,1,1038048,"2024-01-01T00:00:00.000Z",24,FALSE,25,38017690,"G",25,25,"Portland Trail Blazers","Shaedon Sharpe",0,7,8,7,2,7.7
0,0,7,2,0,7,3,6,4,"25",2,2,10,9,1,1,1038048,"2024-01-01T00:00:00.000Z",24,FALSE,25,38017711,"F",25,25,"Portland Trail Blazers","Jabari Walker",1,19,19,10,9,22.8
3,1,1,3,1,8,3,0,0,"18",1,1,7,2,0,1,1038048,"2024-01-01T00:00:00.000Z",24,FALSE,25,3547289,"G",25,25,"Portland Trail Blazers","Skylar Mays",1,9,12,10,5,15.9
1,1,1,2,0,5,3,0,0,"19",1,2,6,2,1,0,1038048,"2024-01-01T00:00:00.000Z",24,FALSE,25,56677791,"F",25,25,"Portland Trail Blazers","Kris Murray",2,8,9,7,3,15.9
0,0,0,0,0,0,0,0,0,"00",0,0,0,0,0,0,1038048,"2024-01-01T00:00:00.000Z",24,FALSE,25,56677850,"F",25,25,"Portland Trail Blazers","Toumani Camara",0,0,0,0,0,0
0,1,1,4,2,5,2,2,2,"12",0,2,8,1,0,1,1038048,"2024-01-01T00:00:00.000Z",24,FALSE,25,17896120,"F",25,25,"Portland Trail Blazers","Ish Wainright",1,9,9,8,1,11.2
0,0,0,0,0,0,0,0,0,"00",0,0,0,0,0,0,1038048,"2024-01-01T00:00:00.000Z",24,FALSE,25,22,"C",25,25,"Portland Trail Blazers","Deandre Ayton",0,0,0,0,0,0
0,0,0,0,0,0,0,0,0,"00",0,0,0,0,0,0,1038048,"2024-01-01T00:00:00.000Z",24,FALSE,25,47957121,"F",25,25,"Portland Trail Blazers","Justin Minaya",0,0,0,0,0,0
0,0,0,0,0,0,0,0,0,"00",0,0,0,0,0,0,1038048,"2024-01-01T00:00:00.000Z",24,FALSE,25,56783340,"C",25,25,"Portland Trail Blazers","Duop Reath",0,0,0,0,0,0
0,0,0,0,0,0,0,0,0,"00",0,0,0,0,0,0,1038048,"2024-01-01T00:00:00.000Z",24,FALSE,25,56677829,"G-F",25,25,"Portland Trail Blazers","Rayan Rupert",0,0,0,0,0,0
0,0,0,0,0,0,0,0,0,"00",0,0,0,0,0,0,1038048,"2024-01-01T00:00:00.000Z",24,FALSE,25,419,"G",25,25,"Portland Trail Blazers","Anfernee Simons",0,0,0,0,0,0
0,0,0,0,0,0,0,0,0,"00",0,0,0,0,0,0,1038048,"2024-01-01T00:00:00.000Z",24,FALSE,25,476,"C-F",25,25,"Portland Trail Blazers","Robert Williams III",0,0,0,0,0,0
1,1,6,0,0,2,1,0,0,"16",0,2,2,6,0,2,1038048,"2024-01-01T00:00:00.000Z",24,FALSE,25,666476,"C",25,25,"Portland Trail Blazers","Moses Brown",1,8,9,3,7,11.7
2,1,6,8,3,16,10,1,1,"29",0,0,24,6,2,1,1038049,"2024-01-01T00:00:00.000Z",29,FALSE,7,38017739,"F",29,29,"Utah Jazz","Simone Fontecchio",3,30,32,26,8,42.2
1,1,2,8,4,12,6,1,1,"25",2,0,17,4,1,1,1038049,"2024-01-01T00:00:00.000Z",29,FALSE,7,297,"F",29,29,"Utah Jazz","Lauri Markkanen",2,21,22,18,5,28.3
1,0,5,5,0,13,7,1,1,"18",0,1,15,5,1,0,1038049,"2024-01-01T00:00:00.000Z",29,FALSE,7,101,"F-C",29,29,"Utah Jazz","John Collins",1,20,21,16,6,25.5
7,0,3,1,1,4,3,0,0,"20",0,2,7,3,0,2,1038049,"2024-01-01T00:00:00.000Z",29,FALSE,7,139,"G",29,29,"Utah Jazz","Kris Dunn",0,10,17,14,10,19.1
6,0,2,3,0,8,2,4,4,"19",1,1,8,3,0,1,1038049,"2024-01-01T00:00:00.000Z",29,FALSE,7,413,"G",29,29,"Utah Jazz","Collin Sexton",0,11,17,14,9,19.6
0,0,1,5,0,6,1,0,0,"19",1,1,2,2,0,1,1038049,"2024-01-01T00:00:00.000Z",29,FALSE,7,38017620,"G",29,29,"Utah Jazz","Ochai Agbaji",0,4,4,2,2,3.4
11,0,8,6,1,16,8,3,3,"28",2,4,20,10,1,4,1038049,"2024-01-01T00:00:00.000Z",29,FALSE,7,100,"G",29,29,"Utah Jazz","Jordan Clarkson",1,30,41,31,21,47.5
3,0,3,6,2,8,3,6,6,"29",0,1,14,3,0,0,1038049,"2024-01-01T00:00:00.000Z",29,FALSE,7,56677834,"G",29,29,"Utah Jazz","Keyonte George",0,17,20,17,6,22.1
0,0,0,0,0,0,0,0,0,"00",0,0,0,0,0,0,1038049,"2024-01-01T00:00:00.000Z",29,FALSE,7,666650,"G",29,29,"Utah Jazz","Talen Horton-Tucker",0,0,0,0,0,0
0,4,10,1,0,6,5,2,1,"26",0,2,11,10,1,1,1038049,"2024-01-01T00:00:00.000Z",29,FALSE,7,38017705,"C",29,29,"Utah Jazz","Walker Kessler",5,21,21,11,10,37
6,0,5,1,1,3,3,0,0,"19",0,3,7,5,3,1,1038049,"2024-01-01T00:00:00.000Z",29,FALSE,7,358,"F",29,29,"Utah Jazz","Kelly Olynyk",3,12,18,13,11,30
0,0,0,0,0,4,1,0,0,"04",1,0,2,1,0,0,1038049,"2024-01-01T00:00:00.000Z",29,FALSE,7,666881,"F",29,29,"Utah Jazz","Luka Samanic",0,3,3,2,1,3.2
0,0,1,0,0,0,0,0,0,"04",0,0,0,1,0,0,1038049,"2024-01-01T00:00:00.000Z",29,FALSE,7,11891374,"C",29,29,"Utah Jazz","Omer Yurtseven",0,1,1,0,1,1.2
0,0,0,0,0,0,0,0,0,"00",0,0,0,0,0,0,1038049,"2024-01-01T00:00:00.000Z",29,FALSE,7,17896023,"G",29,29,"Utah Jazz","Josh Christopher",0,0,0,0,0,0
0,0,0,0,0,0,0,0,0,"00",0,0,0,0,0,0,1038049,"2024-01-01T00:00:00.000Z",29,FALSE,7,56677824,"F",29,29,"Utah Jazz","Taylor Hendricks",0,0,0,0,0,0
0,0,0,0,0,0,0,0,0,"00",0,0,0,0,0,0,1038049,"2024-01-01T00:00:00.000Z",29,FALSE,7,38017630,"G",29,29,"Utah Jazz","Johnny Juzang",0,0,0,0,0,0
0,0,0,0,0,0,0,0,0,"00",0,0,0,0,0,0,1038049,"2024-01-01T00:00:00.000Z",29,FALSE,7,19465584,"F",29,29,"Utah Jazz","Micah Potter",0,0,0,0,0,0
0,0,0,0,0,0,0,0,0,"00",0,0,0,0,0,0,1038049,"2024-01-01T00:00:00.000Z",29,FALSE,7,56677842,"F",29,29,"Utah Jazz","Brice Sensabaugh",0,0,0,0,0,0
3,0,0,0,0,3,2,0,0,"12",1,0,4,1,0,0,1038049,"2024-01-01T00:00:00.000Z",29,FALSE,7,151,"G",7,7,"Dallas Mavericks","Dante Exum",0,5,8,7,4,9.7
0,1,2,3,1,4,2,2,1,"24",1,1,6,3,1,2,1038049,"2024-01-01T00:00:00.000Z",29,FALSE,7,247,"F-G",7,7,"Dallas Mavericks","Derrick Jones Jr.",2,9,9,6,3,13.6
2,1,4,0,0,8,5,0,0,"24",2,1,10,6,1,0,1038049,"2024-01-01T00:00:00.000Z",29,FALSE,7,56677840,"C",7,7,"Dallas Mavericks","Dereck Lively II",2,16,18,12,8,26.2
4,1,8,3,2,14,6,1,0,"32",1,3,14,9,0,1,1038049,"2024-01-01T00:00:00.000Z",29,FALSE,7,228,"G",7,7,"Dallas Mavericks","Kyrie Irving",1,23,27,18,13,32.8
14,0,6,13,3,20,6,6,4,"34",0,1,19,6,1,4,1038049,"2024-01-01T00:00:00.000Z",29,FALSE,7,132,"F-G",7,7,"Dallas Mavericks","Luka Doncic",1,25,39,33,20,46.2
0,0,0,0,0,0,0,0,0,"00",0,0,0,0,0,0,1038049,"2024-01-01T00:00:00.000Z",29,FALSE,7,114,"G",7,7,"Dallas Mavericks","Seth Curry",0,0,0,0,0,0
1,0,2,1,0,4,0,0,0,"21",0,4,0,2,0,2,1038049,"2024-01-01T00:00:00.000Z",29,FALSE,7,3547258,"G",7,7,"Dallas Mavericks","Josh Green",0,2,3,1,3,1.9
0,0,2,6,0,9,3,0,0,"23",0,1,6,2,0,1,1038049,"2024-01-01T00:00:00.000Z",29,FALSE,7,191,"G",7,7,"Dallas Mavericks","Tim Hardaway Jr.",0,8,8,6,2,7.4
0,0,3,9,5,15,6,0,0,"21",0,0,17,3,0,2,1038049,"2024-01-01T00:00:00.000Z",29,FALSE,7,38017679,"G",7,7,"Dallas Mavericks","Jaden Hardy",0,20,20,17,3,18.6
0,0,1,0,0,1,1,0,0,"07",0,0,2,1,0,0,1038049,"2024-01-01T00:00:00.000Z",29,FALSE,7,217,"F-C",7,7,"Dallas Mavericks","Richaun Holmes",0,3,3,2,1,3.2
0,0,0,0,0,0,0,0,0,"00",0,0,0,0,0,0,1038049,"2024-01-01T00:00:00.000Z",29,FALSE,7,329,"F",7,7,"Dallas Mavericks","Markieff Morris",0,0,0,0,0,0
1,2,0,4,0,7,2,1,0,"18",0,2,4,0,1,3,1038049,"2024-01-01T00:00:00.000Z",29,FALSE,7,666965,"F",7,7,"Dallas Mavericks","Grant Williams",3,4,5,5,1,11.5
0,0,0,0,0,0,0,0,0,"00",0,0,0,0,0,0,1038049,"2024-01-01T00:00:00.000Z",29,FALSE,7,17896028,"F",7,7,"Dallas Mavericks","Greg Brown III",0,0,0,0,0,0
0,0,0,0,0,0,0,0,0,"00",0,0,0,0,0,0,1038049,"2024-01-01T00:00:00.000Z",29,FALSE,7,257,"F",7,7,"Dallas Mavericks","Maxi Kleber",0,0,0,0,0,0
0,0,0,0,0,0,0,0,0,"00",0,0,0,0,0,0,1038049,"2024-01-01T00:00:00.000Z",29,FALSE,7,17554004,"G",7,7,"Dallas Mavericks","AJ Lawson",0,0,0,0,0,0
1,0,0,0,0,3,2,0,0,"07",1,1,4,1,0,1,1038049,"2024-01-01T00:00:00.000Z",29,FALSE,7,24489167,"G",25,7,"Dallas Mavericks","Brandon Williams",0,5,6,5,2,5.7
1,0,2,0,0,3,2,0,0,"10",2,1,4,4,2,0,1038049,"2024-01-01T00:00:00.000Z",29,FALSE,7,379,"F-C",7,7,"Dallas Mavericks","Dwight Powell",2,8,9,5,5,16.3
0,0,3,1,0,2,0,0,0,"07",0,0,0,3,0,0,1038049,"2024-01-01T00:00:00.000Z",29,FALSE,7,56677859,"F",7,7,"Dallas Mavericks","Olivier-Maxence Prosper",0,3,3,0,3,3.6
5,1,5,5,2,19,10,3,2,"34",1,0,24,6,4,2,1038050,"2024-01-01T00:00:00.000Z",13,FALSE,16,274,"F",13,13,"LA Clippers","Kawhi Leonard",5,30,35,29,11,51.7
2,0,3,8,3,14,7,6,6,"34",0,4,23,3,1,3,1038050,"2024-01-01T00:00:00.000Z",13,FALSE,16,172,"F",13,13,"LA Clippers","Paul George",1,26,28,25,5,29.6
1,0,11,0,0,4,3,0,0,"29",1,4,6,12,0,1,1038050,"2024-01-01T00:00:00.000Z",13,FALSE,16,493,"C",13,13,"LA Clippers","Ivica Zubac",0,18,19,7,13,20.9
0,0,2,2,1,7,5,1,1,"18",1,2,12,3,0,1,1038050,"2024-01-01T00:00:00.000Z",13,FALSE,16,666743,"G",13,13,"LA Clippers","Terance Mann",0,15,15,12,3,14.6
10,2,4,5,3,8,5,2,2,"31",0,1,15,4,1,2,1038050,"2024-01-01T00:00:00.000Z",13,FALSE,16,192,"G",13,13,"LA Clippers","James Harden",3,19,29,25,14,41.8
0,0,0,0,0,1,0,0,0,"03",0,0,0,0,0,0,1038050,"2024-01-01T00:00:00.000Z",13,FALSE,16,17896022,"G",13,13,"LA Clippers","Brandon Boston Jr.",0,0,0,0,0,0
0,0,0,0,0,0,0,0,0,"03",0,0,0,0,0,1,1038050,"2024-01-01T00:00:00.000Z",13,FALSE,16,56677849,"F",13,13,"LA Clippers","Kobe Brown",0,0,0,0,0,-1
2,0,0,2,1,3,2,0,0,"18",1,2,5,1,0,0,1038050,"2024-01-01T00:00:00.000Z",13,FALSE,16,666511,"G",13,13,"LA Clippers","Amir Coffey",0,6,8,7,3,9.2
0,0,1,0,0,0,0,0,0,"03",0,0,0,1,0,0,1038050,"2024-01-01T00:00:00.000Z",13,FALSE,16,38017725,"F",13,13,"LA Clippers","Moussa Diabate",0,1,1,0,1,1.2
0,0,0,0,0,0,0,0,0,"00",0,0,0,0,0,0,1038050,"2024-01-01T00:00:00.000Z",13,FALSE,16,17896031,"G",13,13,"LA Clippers","Nah'Shon Hyland",0,0,0,0,0,0
0,0,0,0,0,0,0,0,0,"00",0,0,0,0,0,0,1038050,"2024-01-01T00:00:00.000Z",13,FALSE,16,371,"F-C",13,13,"LA Clippers","Mason Plumlee",0,0,0,0,0,0
2,0,2,5,4,11,9,0,0,"33",0,4,22,2,2,1,1038050,"2024-01-01T00:00:00.000Z",13,FALSE,16,380,"F-G",13,13,"LA Clippers","Norman Powell",2,24,26,24,4,32.4
0,0,1,1,0,3,2,2,2,"16",0,3,6,1,0,2,1038050,"2024-01-01T00:00:00.000Z",13,FALSE,16,439,"F",13,13,"LA Clippers","Daniel Theis",0,7,7,6,1,5.2
0,0,0,0,0,0,0,0,0,"00",0,0,0,0,0,0,1038050,"2024-01-01T00:00:00.000Z",13,FALSE,16,450,"F",13,13,"LA Clippers","PJ Tucker",0,0,0,0,0,0
3,0,2,1,0,10,4,0,0,"18",2,0,8,4,2,2,1038050,"2024-01-01T00:00:00.000Z",13,FALSE,16,472,"G",13,13,"LA Clippers","Russell Westbrook",2,12,15,11,7,21.3
0,0,0,0,0,0,0,0,0,"00",0,0,0,0,0,0,1038050,"2024-01-01T00:00:00.000Z",13,FALSE,16,56677856,"G",13,13,"LA Clippers","Jordan Miller",0,0,0,0,0,0
0,0,0,0,0,0,0,0,0,"00",0,0,0,0,0,0,1038050,"2024-01-01T00:00:00.000Z",13,FALSE,16,24417679,"G",13,13,"LA Clippers","Xavier Moon",0,0,0,0,0,0
0,0,0,0,0,0,0,0,0,"00",0,0,0,0,0,0,1038050,"2024-01-01T00:00:00.000Z",13,FALSE,16,17896051,"G",13,13,"LA Clippers","Joshua Primo",0,0,0,0,0,0
1,1,0,4,1,12,4,0,0,"35",3,3,9,3,1,0,1038050,"2024-01-01T00:00:00.000Z",13,FALSE,16,38017734,"F",16,16,"Miami Heat","Jamal Cain",2,12,13,10,4,20.1
2,0,1,3,0,13,6,4,3,"38",3,2,15,4,4,2,1038050,"2024-01-01T00:00:00.000Z",13,FALSE,16,56677785,"G",16,16,"Miami Heat","Jaime Jaquez Jr.",4,19,21,17,6,32.8
4,0,12,2,0,17,6,13,9,"36",3,3,21,15,0,3,1038050,"2024-01-01T00:00:00.000Z",13,FALSE,16,4,"C-F",16,16,"Miami Heat","Bam Adebayo",0,36,40,25,19,42
6,0,6,8,4,13,4,0,0,"35",0,1,12,6,2,3,1038050,"2024-01-01T00:00:00.000Z",13,FALSE,16,666633,"G",16,16,"Miami Heat","Tyler Herro",2,18,24,18,12,31.2
3,0,0,1,0,5,3,2,2,"24",1,3,8,1,0,3,1038050,"2024-01-01T00:00:00.000Z",13,FALSE,16,286,"G",16,16,"Miami Heat","Kyle Lowry",0,9,12,11,4,10.7
1,0,0,0,0,0,0,0,0,"03",0,0,0,0,0,0,1038050,"2024-01-01T00:00:00.000Z",13,FALSE,16,74,"C",16,16,"Miami Heat","Thomas Bryant",0,0,1,1,1,1.5
0,0,0,1,0,1,0,0,0,"12",0,2,0,0,0,0,1038050,"2024-01-01T00:00:00.000Z",13,FALSE,16,3547257,"G",16,16,"Miami Heat","R.J. Hampton",0,0,0,0,0,0
1,0,0,2,1,2,1,0,0,"03",0,0,3,0,0,0,1038050,"2024-01-01T00:00:00.000Z",13,FALSE,16,38017696,"F",16,16,"Miami Heat","Nikola Jovic",0,3,4,4,1,4.5
3,2,2,5,1,11,7,2,2,"22",2,2,17,4,0,1,1038050,"2024-01-01T00:00:00.000Z",13,FALSE,16,285,"F-C",16,16,"Miami Heat","Kevin Love",2,21,24,20,7,31.3
2,0,1,7,3,8,3,6,6,"26",0,1,15,1,0,1,1038050,"2024-01-01T00:00:00.000Z",13,FALSE,16,397,"F",16,16,"Miami Heat","Duncan Robinson",0,16,18,17,3,18.2
1,0,1,0,0,0,0,2,1,"03",0,0,1,1,0,0,1038050,"2024-01-01T00:00:00.000Z",13,FALSE,16,39398582,"C",16,16,"Miami Heat","Orlando Robinson",0,2,3,2,2,3.7
0,0,0,1,1,1,1,0,0,"03",0,0,3,0,0,0,1038050,"2024-01-01T00:00:00.000Z",13,FALSE,16,38017736,"F",16,16,"Miami Heat","Cole Swider",0,3,3,3,0,3
0,0,0,0,0,0,0,0,0,"00",0,0,0,0,0,0,1038050,"2024-01-01T00:00:00.000Z",13,FALSE,16,79,"G-F",16,16,"Miami Heat","Jimmy Butler",0,0,0,0,0,0
0,0,0,0,0,0,0,0,0,"00",0,0,0,0,0,0,1038050,"2024-01-01T00:00:00.000Z",13,FALSE,16,3092,"",16,16,"Miami Heat","Haywood Highsmith",0,0,0,0,0,0
0,0,0,0,0,0,0,0,0,"00",0,0,0,0,0,0,1038050,"2024-01-01T00:00:00.000Z",13,FALSE,16,666747,"F",16,16,"Miami Heat","Caleb Martin",0,0,0,0,0,0
0,0,0,0,0,0,0,0,0,"00",0,0,0,0,0,0,1038050,"2024-01-01T00:00:00.000Z",13,FALSE,16,391,"G-F",16,16,"Miami Heat","Josh Richardson",0,0,0,0,0,0
0,0,0,0,0,0,0,0,0,"00",0,0,0,0,0,0,1038050,"2024-01-01T00:00:00.000Z",13,FALSE,16,19465585,"G",16,16,"Miami Heat","Dru Smith",0,0,0,0,0,0
2,2,7,4,1,13,9,3,1,"30",1,0,20,8,0,1,1038051,"2024-01-02T00:00:00.000Z",23,FALSE,5,200,"F",23,23,"Philadelphia 76ers","Tobias Harris",2,28,30,22,10,37.6
2,1,1,3,1,4,2,1,1,"22",2,2,6,3,0,1,1038051,"2024-01-02T00:00:00.000Z",23,FALSE,5,33,"F-G",23,23,"Philadelphia 76ers","Nicolas Batum",1,9,11,8,5,14.6
10,2,15,5,2,20,10,12,9,"32",0,4,31,15,1,4,1038051,"2024-01-02T00:00:00.000Z",23,FALSE,5,145,"F-C",23,23,"Philadelphia 76ers","Joel Embiid",3,46,56,41,25,69
3,0,3,5,3,8,5,3,3,"27",0,3,16,3,3,1,1038051,"2024-01-02T00:00:00.000Z",23,FALSE,5,360,"F",23,23,"Philadelphia 76ers","Kelly Oubre Jr.",3,19,22,19,6,32.1
5,0,1,7,4,12,6,6,5,"29",0,2,21,1,0,1,1038051,"2024-01-02T00:00:00.000Z",23,FALSE,5,3547254,"G",23,23,"Philadelphia 76ers","Tyrese Maxey",0,22,27,26,6,28.7
2,0,1,1,1,1,1,0,0,"14",0,1,3,1,0,1,1038051,"2024-01-02T00:00:00.000Z",23,FALSE,5,45,"G",23,23,"Philadelphia 76ers","Patrick Beverley",0,4,6,5,3,6.2
1,0,0,2,0,5,2,1,1,"15",0,1,5,0,0,1,1038051,"2024-01-02T00:00:00.000Z",23,FALSE,5,2175,"",23,23,"Philadelphia 76ers","Danuel House Jr.",0,5,6,6,1,5.5
0,0,1,0,0,3,0,4,2,"11",1,0,2,2,1,1,1038051,"2024-01-02T00:00:00.000Z",23,FALSE,5,328,"F",23,23,"Philadelphia 76ers","Marcus Morris",1,4,4,2,2,6.4
0,0,0,2,1,3,1,0,0,"11",1,1,3,1,0,1,1038051,"2024-01-02T00:00:00.000Z",23,FALSE,5,3547248,"F",5,5,"Chicago Bulls","Patrick Williams",0,4,4,3,1,3.2
0,1,7,1,0,13,5,4,1,"28",10,2,11,17,1,2,1038051,"2024-01-02T00:00:00.000Z",23,FALSE,5,137,"C",5,5,"Chicago Bulls","Andre Drummond",2,28,28,11,17,35.4
2,1,1,6,1,10,3,2,1,"21",1,0,8,2,0,2,1038051,"2024-01-02T00:00:00.000Z",23,FALSE,5,89,"G",5,5,"Chicago Bulls","Alex Caruso",1,10,12,10,4,14.4
3,0,4,5,0,15,5,5,4,"28",0,4,14,4,2,1,1038051,"2024-01-02T00:00:00.000Z",23,FALSE,5,666956,"G",5,5,"Chicago Bulls","Coby White",2,18,21,17,7,28.3
0,0,0,0,0,0,0,0,0,"00",0,0,0,0,0,0,1038051,"2024-01-02T00:00:00.000Z",23,FALSE,5,260,"G-F",23,23,"Philadelphia 76ers","Furkan Korkmaz",0,0,0,0,0,0
0,0,0,0,0,0,0,0,0,"00",0,0,0,0,0,0,1038051,"2024-01-02T00:00:00.000Z",23,FALSE,5,313,"G",23,23,"Philadelphia 76ers","De'Anthony Melton",0,0,0,0,0,0
0,0,0,0,0,0,0,0,0,"00",0,0,0,0,0,0,1038051,"2024-01-02T00:00:00.000Z",23,FALSE,5,56677788,"G",23,23,"Philadelphia 76ers","Terquavion Smith",0,0,0,0,0,0
3,0,4,3,0,10,5,7,6,"30",0,4,16,4,0,1,1038051,"2024-01-02T00:00:00.000Z",23,FALSE,5,125,"G",5,5,"Chicago Bulls","DeMar DeRozan",0,20,23,19,7,24.3
0,0,3,4,1,14,7,0,0,"32",0,2,15,3,1,3,1038051,"2024-01-02T00:00:00.000Z",23,FALSE,5,17895983,"G",5,5,"Chicago Bulls","Ayo Dosunmu",1,18,18,15,3,18.6
1,0,1,8,3,11,3,0,0,"23",0,0,9,1,3,0,1038051,"2024-01-02T00:00:00.000Z",23,FALSE,5,87,"G",5,5,"Chicago Bulls","Jevon Carter",3,10,11,10,2,20.7
1,1,1,2,0,5,0,0,0,"20",4,2,0,5,1,4,1038051,"2024-01-02T00:00:00.000Z",23,FALSE,5,17896116,"G",5,5,"Chicago Bulls","Terry Taylor",2,5,6,1,6,9.5
7,1,7,3,0,7,2,2,2,"21",1,4,6,8,0,3,1038051,"2024-01-02T00:00:00.000Z",23,FALSE,5,38017719,"F",5,5,"Chicago Bulls","Dalen Terry",1,14,21,13,15,26.1
0,0,0,0,0,0,0,0,0,"00",0,0,0,0,0,0,1038051,"2024-01-02T00:00:00.000Z",23,FALSE,5,110,"F",5,5,"Chicago Bulls","Torrey Craig",0,0,0,0,0,0
0,3,0,3,1,5,3,0,0,"17",0,2,7,0,1,0,1038051,"2024-01-02T00:00:00.000Z",23,FALSE,5,56677857,"F",5,5,"Chicago Bulls","Julian Phillips",4,7,7,7,0,19
0,0,4,0,0,3,3,3,2,"09",2,0,8,6,0,1,1038051,"2024-01-02T00:00:00.000Z",23,FALSE,5,56677860,"F",5,5,"Chicago Bulls","Adama Sanogo",0,14,14,8,6,14.2
0,0,0,0,0,0,0,0,0,"00",0,0,0,0,0,0,1038051,"2024-01-02T00:00:00.000Z",23,FALSE,5,27,"G",5,5,"Chicago Bulls","Lonzo Ball",0,0,0,0,0,0
0,0,0,0,0,0,0,0,0,"00",0,0,0,0,0,0,1038051,"2024-01-02T00:00:00.000Z",23,FALSE,5,56677874,"F",5,5,"Chicago Bulls","Onuralp Bitim",0,0,0,0,0,0
0,0,0,0,0,0,0,0,0,"00",0,0,0,0,0,0,1038051,"2024-01-02T00:00:00.000Z",23,FALSE,5,NA,NA,NA,5,"Chicago Bulls","NA NA",0,0,0,0,0,0
0,0,0,0,0,0,0,0,0,"00",0,0,0,0,0,0,1038051,"2024-01-02T00:00:00.000Z",23,FALSE,5,268,"G",5,5,"Chicago Bulls","Zach LaVine",0,0,0,0,0,0
0,0,0,0,0,0,0,0,0,"00",0,0,0,0,0,0,1038051,"2024-01-02T00:00:00.000Z",23,FALSE,5,460,"C",5,5,"Chicago Bulls","Nikola Vucevic",0,0,0,0,0,0
2,1,0,2,0,4,2,0,0,"21",2,4,4,2,1,2,1038051,"2024-01-02T00:00:00.000Z",23,FALSE,5,17896025,"G",23,23,"Philadelphia 76ers","Jaden Springer",2,6,8,6,4,13.4
0,0,4,0,0,3,1,0,0,"13",0,2,2,4,2,0,1038051,"2024-01-02T00:00:00.000Z",23,FALSE,5,3547270,"F",23,23,"Philadelphia 76ers","Paul Reed",2,6,6,2,4,12.8
0,0,2,0,0,1,0,0,0,"07",0,3,0,2,1,2,1038051,"2024-01-02T00:00:00.000Z",23,FALSE,5,28,"C",23,23,"Philadelphia 76ers","Mo Bamba",1,2,2,0,2,3.4
0,0,0,1,0,1,0,0,0,"06",0,0,0,0,0,0,1038051,"2024-01-02T00:00:00.000Z",23,FALSE,5,56913527,"G",23,23,"Philadelphia 76ers","Ricky Council IV",0,0,0,0,0,0
0,0,2,0,0,2,0,0,0,"04",0,0,0,2,0,2,1038051,"2024-01-02T00:00:00.000Z",23,FALSE,5,38017732,"F",15,23,"Philadelphia 76ers","Kenneth Lofton Jr.",0,2,2,0,2,0.4
1,0,0,0,0,3,0,0,0,"09",0,0,0,0,0,0,1038051,"2024-01-02T00:00:00.000Z",23,FALSE,5,3547294,"F",23,23,"Philadelphia 76ers","Kenyon Martin Jr.",0,0,1,1,1,1.5
0,0,0,0,0,0,0,0,0,"00",0,0,0,0,0,0,1038051,"2024-01-02T00:00:00.000Z",23,FALSE,5,108,"F",23,23,"Philadelphia 76ers","Robert Covington",0,0,0,0,0,0
3,0,1,4,0,7,1,4,3,"29",1,3,5,2,0,3,1038052,"2024-01-02T00:00:00.000Z",15,FALSE,27,420,"G",15,15,"Memphis Grizzlies","Marcus Smart",0,7,10,8,5,8.9
1,4,6,4,1,14,3,4,3,"32",1,4,10,7,3,1,1038052,"2024-01-02T00:00:00.000Z",15,FALSE,27,231,"F-C",15,15,"Memphis Grizzlies","Jaren Jackson Jr.",7,17,18,11,8,39.9
1,3,6,0,0,4,2,0,0,"28",2,4,4,8,1,2,1038052,"2024-01-02T00:00:00.000Z",15,FALSE,27,48,"C",15,15,"Memphis Grizzlies","Bismack Biyombo",4,12,13,5,9,25.1
2,0,3,6,2,17,11,0,0,"34",0,1,24,3,0,3,1038052,"2024-01-02T00:00:00.000Z",15,FALSE,27,3547287,"G",15,15,"Memphis Grizzlies","Desmond Bane",0,27,29,26,5,27.6
10,0,5,9,3,15,7,12,9,"35",0,3,26,5,1,4,1038052,"2024-01-02T00:00:00.000Z",15,FALSE,27,666786,"G",15,15,"Memphis Grizzlies","Ja Morant",1,31,41,36,15,46
0,1,9,2,1,6,5,2,2,"28",2,1,13,11,0,0,1038052,"2024-01-02T00:00:00.000Z",15,FALSE,27,17896067,"F",15,15,"Memphis Grizzlies","Santi Aldama",1,24,24,13,11,29.2
3,0,4,7,3,7,3,3,3,"20",1,2,12,5,0,0,1038052,"2024-01-02T00:00:00.000Z",15,FALSE,27,254,"G",15,15,"Memphis Grizzlies","Luke Kennard",0,17,20,15,8,22.5
0,0,0,0,0,0,0,0,0,"01",0,0,0,0,0,0,1038052,"2024-01-02T00:00:00.000Z",15,FALSE,27,666703,"G-F",15,15,"Memphis Grizzlies","John Konchar",0,0,0,0,0,0
0,0,0,0,0,0,0,0,0,"01",0,0,0,0,0,0,1038052,"2024-01-02T00:00:00.000Z",15,FALSE,27,38017729,"F",15,15,"Memphis Grizzlies","David Roddy",0,0,0,0,0,0
2,0,0,1,0,4,2,0,0,"08",0,0,4,0,0,0,1038052,"2024-01-02T00:00:00.000Z",15,FALSE,27,401,"G",15,15,"Memphis Grizzlies","Derrick Rose",0,4,6,6,2,7
0,0,0,0,0,0,0,0,0,"01",0,0,0,0,0,0,1038052,"2024-01-02T00:00:00.000Z",15,FALSE,27,3547285,"F",15,15,"Memphis Grizzlies","Xavier Tillman",0,0,0,0,0,0
0,0,0,0,0,0,0,0,0,"00",0,0,0,0,0,0,1038052,"2024-01-02T00:00:00.000Z",15,FALSE,27,38017728,"F",15,15,"Memphis Grizzlies","Jake LaRavia",0,0,0,0,0,0
2,0,4,6,3,6,3,3,3,"22",0,4,12,4,1,1,1038052,"2024-01-02T00:00:00.000Z",15,FALSE,27,38017649,"F",27,27,"San Antonio Spurs","Julian Champagnie",1,16,18,14,6,21.8
0,0,0,0,0,0,0,0,0,"00",0,0,0,0,0,0,1038052,"2024-01-02T00:00:00.000Z",15,FALSE,27,3,"C",15,15,"Memphis Grizzlies","Steven Adams",0,0,0,0,0,0
0,0,0,0,0,0,0,0,0,"00",0,0,0,0,0,0,1038052,"2024-01-02T00:00:00.000Z",15,FALSE,27,666505,"F",15,15,"Memphis Grizzlies","Brandon Clarke",0,0,0,0,0,0
0,0,0,0,0,0,0,0,0,"00",0,0,0,0,0,0,1038052,"2024-01-02T00:00:00.000Z",15,FALSE,27,48248287,"G",15,15,"Memphis Grizzlies","Jacob Gilyard",0,0,0,0,0,0
0,0,0,0,0,0,0,0,0,"00",0,0,0,0,0,0,1038052,"2024-01-02T00:00:00.000Z",15,FALSE,27,56677830,"F",15,15,"Memphis Grizzlies","GG Jackson",0,0,0,0,0,0
3,1,1,2,1,8,3,5,4,"34",1,2,11,2,1,2,1038052,"2024-01-02T00:00:00.000Z",15,FALSE,27,3547246,"G-F",27,27,"San Antonio Spurs","Devin Vassell",2,13,16,14,5,21.9
1,0,1,0,0,5,1,0,0,"08",0,1,2,1,0,0,1038052,"2024-01-02T00:00:00.000Z",15,FALSE,27,38017692,"F",27,27,"San Antonio Spurs","Malaki Branham",0,3,4,3,2,4.7
2,0,3,0,0,6,2,0,0,"14",4,4,4,7,0,2,1038052,"2024-01-02T00:00:00.000Z",15,FALSE,27,38017730,"F",27,27,"San Antonio Spurs","Dominick Barlow",0,11,13,6,9,13.4
0,0,0,0,0,0,0,0,0,"00",0,0,0,0,0,0,1038052,"2024-01-02T00:00:00.000Z",15,FALSE,27,3547163,"F",6,27,"San Antonio Spurs","Mamadi Diakite",0,0,0,0,0,0
0,0,0,0,0,0,0,0,0,"00",0,0,0,0,0,0,1038052,"2024-01-02T00:00:00.000Z",15,FALSE,27,180,"G",27,27,"San Antonio Spurs","Devonte' Graham",0,0,0,0,0,0
4,0,5,4,1,16,7,5,4,"31",1,4,19,6,1,3,1038052,"2024-01-02T00:00:00.000Z",15,FALSE,27,666682,"F",27,27,"San Antonio Spurs","Keldon Johnson",1,25,29,23,10,32.2
4,0,4,3,0,6,1,0,0,"25",0,2,2,4,1,0,1038052,"2024-01-02T00:00:00.000Z",15,FALSE,27,3547274,"G",27,27,"San Antonio Spurs","Tre Jones",1,6,10,6,8,15.8
0,1,0,1,1,1,1,0,0,"02",0,0,3,0,0,1,1038052,"2024-01-02T00:00:00.000Z",15,FALSE,27,17896059,"F",27,27,"San Antonio Spurs","Sandro Mamukelashvili",1,3,3,3,0,5
0,0,0,4,1,4,1,0,0,"16",0,0,3,0,0,0,1038052,"2024-01-02T00:00:00.000Z",15,FALSE,27,305,"F",27,27,"San Antonio Spurs","Doug McDermott",0,3,3,3,0,3
2,0,6,2,0,3,0,0,0,"13",0,2,0,6,0,2,1038052,"2024-01-02T00:00:00.000Z",15,FALSE,27,359,"F",27,27,"San Antonio Spurs","Cedi Osman",0,6,8,2,8,8.2
1,0,1,2,0,8,5,2,0,"21",0,4,10,1,2,1,1038052,"2024-01-02T00:00:00.000Z",15,FALSE,27,38017693,"G",27,27,"San Antonio Spurs","Blake Wesley",2,11,12,11,2,17.7
0,0,0,0,0,0,0,0,0,"00",0,0,0,0,0,0,1038052,"2024-01-02T00:00:00.000Z",15,FALSE,27,17895854,"G",27,27,"San Antonio Spurs","Charles Bassey",0,0,0,0,0,0
0,0,0,0,0,0,0,0,0,"00",0,0,0,0,0,0,1038052,"2024-01-02T00:00:00.000Z",15,FALSE,27,56677817,"G",27,27,"San Antonio Spurs","Sidy Cissoko",0,0,0,0,0,0
0,0,0,0,0,0,0,0,0,"00",0,0,0,0,0,0,1038052,"2024-01-02T00:00:00.000Z",15,FALSE,27,102,"F-C",27,27,"San Antonio Spurs","Zach Collins",0,0,0,0,0,0
0,0,0,0,0,0,0,0,0,"00",0,0,0,0,0,0,1038052,"2024-01-02T00:00:00.000Z",15,FALSE,27,17896049,"G",3,27,"San Antonio Spurs","David Duke Jr.",0,0,0,0,0,0
1,2,2,2,1,6,4,4,3,"28",0,1,12,2,0,1,1038052,"2024-01-02T00:00:00.000Z",15,FALSE,27,38017699,"F",27,27,"San Antonio Spurs","Jeremy Sochan",2,14,15,13,3,20.9
1,4,7,5,2,16,8,4,2,"26",0,0,20,7,0,1,1038052,"2024-01-02T00:00:00.000Z",15,FALSE,27,56677822,"F-C",27,27,"San Antonio Spurs","Victor Wembanyama",4,27,28,21,8,40.9
2,0,4,5,2,6,3,0,0,"22",1,5,8,5,0,2,1038052,"2024-01-02T00:00:00.000Z",15,FALSE,27,38017731,"G",15,15,"Memphis Grizzlies","Vince Williams Jr.",0,13,15,10,7,15
0,0,0,0,0,0,0,0,0,"01",0,0,0,0,0,0,1038052,"2024-01-02T00:00:00.000Z",15,FALSE,27,17896027,"G-F",15,15,"Memphis Grizzlies","Ziaire Williams",0,0,0,0,0,0
5,1,4,2,2,9,5,0,0,"25",1,2,12,5,0,1,1038053,"2024-01-02T00:00:00.000Z",19,FALSE,3,227,"F",19,19,"New Orleans Pelicans","Brandon Ingram",1,17,22,17,10,27.5
5,1,2,0,0,9,5,0,0,"26",1,3,10,3,0,4,1038053,"2024-01-02T00:00:00.000Z",19,FALSE,3,666969,"F",19,19,"New Orleans Pelicans","Zion Williamson",1,13,18,15,8,20.1
0,1,9,1,1,5,5,0,0,"20",3,0,11,12,1,1,1038053,"2024-01-02T00:00:00.000Z",19,FALSE,3,455,"C",19,19,"New Orleans Pelicans","Jonas Valanciunas",2,23,23,11,12,30.4
1,1,2,4,2,10,5,2,2,"24",2,1,14,4,2,3,1038053,"2024-01-02T00:00:00.000Z",19,FALSE,3,17896024,"F",19,19,"New Orleans Pelicans","Herbert Jones",3,18,19,15,5,26.3
5,0,4,8,4,11,6,0,0,"24",2,0,16,6,0,2,1038053,"2024-01-02T00:00:00.000Z",19,FALSE,3,303,"G",19,19,"New Orleans Pelicans","CJ McCollum",0,22,27,21,11,28.7
2,0,2,6,3,9,4,3,2,"22",1,2,13,3,2,1,1038053,"2024-01-02T00:00:00.000Z",19,FALSE,3,17896097,"G",19,19,"New Orleans Pelicans","Jose Alvarado",2,16,18,15,5,24.6
3,2,1,4,1,5,2,2,2,"20",1,0,7,2,2,1,1038053,"2024-01-02T00:00:00.000Z",19,FALSE,3,38017677,"G",19,19,"New Orleans Pelicans","Dyson Daniels",4,9,12,10,5,24.9
1,2,0,8,2,13,3,4,3,"26",0,0,11,0,0,0,1038053,"2024-01-02T00:00:00.000Z",19,FALSE,3,56677837,"G",19,19,"New Orleans Pelicans","Jordan Hawkins",2,11,12,12,1,18.5
1,1,1,2,0,6,2,2,2,"16",1,0,6,2,1,0,1038053,"2024-01-02T00:00:00.000Z",19,FALSE,3,3547293,"F",19,19,"New Orleans Pelicans","Naji Marshall",2,8,9,7,3,15.9
0,0,6,2,1,4,2,2,1,"20",2,2,6,8,2,1,1038053,"2024-01-02T00:00:00.000Z",19,FALSE,3,340,"F",19,19,"New Orleans Pelicans","Larry Nance Jr.",2,14,14,6,8,20.6
0,0,1,0,0,3,1,3,2,"08",1,2,4,2,0,0,1038053,"2024-01-02T00:00:00.000Z",19,FALSE,3,491,"C",19,19,"New Orleans Pelicans","Cody Zeller",0,6,6,4,2,6.4
0,0,0,0,0,0,0,0,0,"00",0,0,0,0,0,0,1038053,"2024-01-02T00:00:00.000Z",19,FALSE,3,17896017,"F",19,19,"New Orleans Pelicans","Matt Ryan",0,0,0,0,0,0
0,0,0,0,0,0,0,0,0,"00",0,0,0,0,0,0,1038053,"2024-01-02T00:00:00.000Z",19,FALSE,3,38017726,"G",19,19,"New Orleans Pelicans","Dereon Seabron",0,0,0,0,0,0
2,0,4,9,5,12,6,0,0,"27",0,2,17,4,1,1,1038053,"2024-01-02T00:00:00.000Z",19,FALSE,3,666679,"F",3,3,"Brooklyn Nets","Cameron Johnson",1,21,23,19,6,26.8
1,0,3,4,1,6,1,0,0,"20",1,1,3,4,2,0,1038053,"2024-01-02T00:00:00.000Z",19,FALSE,3,158,"F",3,3,"Brooklyn Nets","Dorian Finney-Smith",2,7,8,4,5,15.3
1,2,3,0,0,7,4,0,0,"23",0,1,8,3,0,0,1038053,"2024-01-02T00:00:00.000Z",19,FALSE,3,666508,"F-C",3,3,"Brooklyn Nets","Nicolas Claxton",2,11,12,9,4,19.1
2,0,1,5,2,11,4,3,3,"29",2,0,13,3,0,4,1038053,"2024-01-02T00:00:00.000Z",19,FALSE,3,61,"F",3,3,"Brooklyn Nets","Mikal Bridges",0,16,18,15,5,15.6
5,0,0,4,0,6,0,0,0,"21",0,1,0,0,0,1,1038053,"2024-01-02T00:00:00.000Z",19,FALSE,3,130,"G",3,3,"Brooklyn Nets","Spencer Dinwiddie",0,0,5,5,5,6.5
5,0,4,5,0,6,0,0,0,"28",4,3,0,8,1,3,1038053,"2024-01-02T00:00:00.000Z",19,FALSE,3,351,"F",3,3,"Brooklyn Nets","Royce O'Neale",1,8,13,5,13,17.1
0,0,0,2,0,3,1,0,0,"05",1,0,2,1,0,1,1038053,"2024-01-02T00:00:00.000Z",19,FALSE,3,3547260,"G",19,19,"New Orleans Pelicans","Kira Lewis Jr.",0,3,3,2,1,2.2
0,0,4,0,0,1,0,0,0,"04",1,0,0,5,0,1,1038053,"2024-01-02T00:00:00.000Z",19,FALSE,3,17896021,"F",19,19,"New Orleans Pelicans","Jeremiah Robinson-Earl",0,5,5,0,5,5
0,0,0,0,0,0,0,0,0,"00",0,0,0,0,0,0,1038053,"2024-01-02T00:00:00.000Z",19,FALSE,3,38017663,"F",19,19,"New Orleans Pelicans","E.J. Liddell",0,0,0,0,0,0
0,0,0,0,0,0,0,0,0,"00",0,0,0,0,0,0,1038053,"2024-01-02T00:00:00.000Z",19,FALSE,3,18677986,"F",19,19,"New Orleans Pelicans","Trey Murphy III",0,0,0,0,0,0
0,0,0,0,0,0,0,0,0,"00",0,0,0,0,0,0,1038053,"2024-01-02T00:00:00.000Z",19,FALSE,3,417,"G-F",3,3,"Brooklyn Nets","Ben Simmons",0,0,0,0,0,0
0,0,0,0,0,0,0,0,0,"00",0,0,0,0,0,0,1038053,"2024-01-02T00:00:00.000Z",19,FALSE,3,464,"G",3,3,"Brooklyn Nets","Lonnie Walker IV",0,0,0,0,0,0
0,0,0,0,0,0,0,0,0,"00",0,0,0,0,0,0,1038053,"2024-01-02T00:00:00.000Z",19,FALSE,3,56677841,"F",3,3,"Brooklyn Nets","Dariq Whitehead",0,0,0,0,0,0
2,1,6,0,0,9,6,0,0,"17",3,0,12,9,0,1,1038053,"2024-01-02T00:00:00.000Z",19,FALSE,3,17896038,"C",3,3,"Brooklyn Nets","Day'Ron Sharpe",1,21,23,14,11,27.8
0,0,1,4,0,11,0,0,0,"20",1,0,0,2,1,1,1038053,"2024-01-02T00:00:00.000Z",19,FALSE,3,17896048,"G",3,3,"Brooklyn Nets","Cam Thomas",1,2,2,0,2,4.4
4,0,1,4,2,7,3,2,1,"20",0,1,9,1,1,1,1038053,"2024-01-02T00:00:00.000Z",19,FALSE,3,421,"G",3,3,"Brooklyn Nets","Dennis Smith Jr.",1,10,14,13,5,18.2
2,0,0,2,0,8,4,0,0,"12",4,0,8,4,1,0,1038053,"2024-01-02T00:00:00.000Z",19,FALSE,3,56677722,"F",3,3,"Brooklyn Nets","Jalen Wilson",1,12,14,10,6,18.8
0,0,0,4,1,5,2,0,0,"08",1,1,5,1,0,0,1038053,"2024-01-02T00:00:00.000Z",19,FALSE,3,9051997,"G",3,3,"Brooklyn Nets","Armoni Brooks",0,6,6,5,1,6.2
1,1,2,2,0,6,3,2,0,"08",1,2,6,3,0,0,1038053,"2024-01-02T00:00:00.000Z",19,FALSE,3,174,"F-C",3,3,"Brooklyn Nets","Harry Giles III",1,9,10,7,4,14.1
1,0,0,0,0,4,2,1,0,"07",1,1,4,1,0,0,1038053,"2024-01-02T00:00:00.000Z",19,FALSE,3,17896058,"F",3,3,"Brooklyn Nets","Trendon Watford",0,5,6,5,2,6.7
0,0,0,0,0,0,0,0,0,"00",0,0,0,0,0,0,1038053,"2024-01-02T00:00:00.000Z",19,FALSE,3,56677843,"F",3,3,"Brooklyn Nets","Noah Clowney",0,0,0,0,0,0
0,0,0,0,0,0,0,0,0,"00",0,0,0,0,0,0,1038053,"2024-01-02T00:00:00.000Z",19,FALSE,3,17896041,"G",3,3,"Brooklyn Nets","Keon Johnson",0,0,0,0,0,0
1,3,3,7,1,14,4,0,0,"37",5,2,9,8,1,0,1038054,"2024-01-02T00:00:00.000Z",21,FALSE,2,666541,"G",21,21,"Oklahoma City Thunder","Luguentz Dort",4,17,18,10,9,32.1
1,2,1,2,2,9,6,2,2,"31",0,3,16,1,3,5,1038054,"2024-01-02T00:00:00.000Z",21,FALSE,2,38017703,"G-F",21,21,"Oklahoma City Thunder","Jalen Williams",5,17,18,17,2,28.7
7,4,3,5,3,9,5,2,1,"33",0,1,14,3,0,1,1038054,"2024-01-02T00:00:00.000Z",21,FALSE,2,38017685,"C-F",21,21,"Oklahoma City Thunder","Chet Holmgren",4,17,24,21,10,39.1
6,0,7,7,4,14,8,3,3,"27",1,0,23,8,0,3,1038054,"2024-01-02T00:00:00.000Z",21,FALSE,2,17896065,"G",21,21,"Oklahoma City Thunder","Josh Giddey",0,31,37,29,14,38.6
7,0,6,5,3,22,14,8,5,"37",0,5,36,6,1,0,1038054,"2024-01-02T00:00:00.000Z",21,FALSE,2,175,"G",21,21,"Oklahoma City Thunder","Shai Gilgeous-Alexander",1,42,49,43,13,56.7
0,0,0,0,0,0,0,0,0,"00",0,0,0,0,0,0,1038054,"2024-01-02T00:00:00.000Z",21,FALSE,2,44,"F",21,21,"Oklahoma City Thunder","Davis Bertans",0,0,0,0,0,0
0,0,3,3,2,5,4,0,0,"13",0,1,10,3,0,1,1038054,"2024-01-02T00:00:00.000Z",21,FALSE,2,3547272,"G",21,21,"Oklahoma City Thunder","Isaiah Joe",0,13,13,10,3,12.6
0,0,0,0,0,0,0,0,0,"00",0,0,0,0,0,0,1038054,"2024-01-02T00:00:00.000Z",21,FALSE,2,17896036,"G",21,21,"Oklahoma City Thunder","Tre Mann",0,0,0,0,0,0
0,0,0,0,0,0,0,0,0,"00",0,0,0,0,0,0,1038054,"2024-01-02T00:00:00.000Z",21,FALSE,2,38017716,"F",21,21,"Oklahoma City Thunder","Ousmane Dieng",0,0,0,0,0,0
0,0,0,0,0,0,0,0,0,"00",0,0,0,0,0,0,1038054,"2024-01-02T00:00:00.000Z",21,FALSE,2,56677853,"F",21,21,"Oklahoma City Thunder","Keyontae Johnson",0,0,0,0,0,0
0,0,0,0,0,0,0,0,0,"00",0,0,0,0,0,0,1038054,"2024-01-02T00:00:00.000Z",21,FALSE,2,24572055,"C",21,21,"Oklahoma City Thunder","Olivier Sarr",0,0,0,0,0,0
0,0,0,0,0,0,0,0,0,"00",0,0,0,0,0,0,1038054,"2024-01-02T00:00:00.000Z",21,FALSE,2,27924547,"F",21,21,"Oklahoma City Thunder","Lindy Waters III",0,0,0,0,0,0
3,0,4,8,0,18,4,8,7,"38",2,5,15,6,0,3,1038054,"2024-01-02T00:00:00.000Z",21,FALSE,2,70,"G",2,2,"Boston Celtics","Jaylen Brown",0,21,24,18,9,23.7
8,0,8,5,2,21,10,10,8,"38",5,3,30,13,1,4,1038054,"2024-01-02T00:00:00.000Z",21,FALSE,2,434,"F",2,2,"Boston Celtics","Jayson Tatum",1,43,51,38,21,56.6
2,3,4,3,2,18,12,9,8,"35",6,1,34,10,0,1,1038054,"2024-01-02T00:00:00.000Z",21,FALSE,2,378,"F-C",2,2,"Boston Celtics","Kristaps Porzingis",3,44,46,36,12,57
6,1,5,9,5,12,7,0,0,"28",0,4,19,5,1,3,1038054,"2024-01-02T00:00:00.000Z",21,FALSE,2,473,"G",2,2,"Boston Celtics","Derrick White",2,24,30,25,11,37
7,0,4,5,2,8,2,2,1,"31",1,1,7,5,1,3,1038054,"2024-01-02T00:00:00.000Z",21,FALSE,2,214,"G",2,2,"Boston Celtics","Jrue Holiday",1,12,19,14,12,23.5
0,0,0,0,0,0,0,0,0,"00",0,0,0,0,0,0,1038054,"2024-01-02T00:00:00.000Z",21,FALSE,2,17896094,"G",2,2,"Boston Celtics","Dalano Banton",0,0,0,0,0,0
0,0,0,0,0,0,0,0,0,"00",0,0,0,0,0,0,1038054,"2024-01-02T00:00:00.000Z",21,FALSE,2,666468,"F",2,2,"Boston Celtics","Oshae Brissett",0,0,0,0,0,0
0,0,1,3,2,3,2,0,0,"10",0,0,6,1,0,0,1038054,"2024-01-02T00:00:00.000Z",21,FALSE,2,17896060,"F",2,2,"Boston Celtics","Sam Hauser",0,7,7,6,1,7.2
3,5,2,3,1,5,3,0,0,"20",0,0,7,2,1,0,1038054,"2024-01-02T00:00:00.000Z",21,FALSE,2,219,"C-F",2,2,"Boston Celtics","Al Horford",6,9,12,10,5,31.9
0,1,0,0,0,2,0,0,0,"15",2,0,0,2,1,0,1038054,"2024-01-02T00:00:00.000Z",21,FALSE,2,261,"F-C",2,2,"Boston Celtics","Luke Kornet",2,2,2,0,2,8.4
0,0,0,0,0,0,0,0,0,"00",0,0,0,0,0,0,1038054,"2024-01-02T00:00:00.000Z",21,FALSE,2,338,"G",2,2,"Boston Celtics","Svi Mykhailiuk",0,0,0,0,0,0
4,0,2,4,1,5,2,0,0,"25",1,1,5,3,2,0,1038054,"2024-01-02T00:00:00.000Z",21,FALSE,2,3547276,"G",2,2,"Boston Celtics","Payton Pritchard",2,8,12,9,7,20.6
5,0,1,4,1,5,1,0,0,"11",0,2,3,1,0,0,1038054,"2024-01-02T00:00:00.000Z",21,FALSE,2,4197029,"G",21,21,"Oklahoma City Thunder","Vasilije Micic",0,4,9,8,6,11.7
0,0,0,0,0,0,0,0,0,"00",0,0,0,0,0,0,1038054,"2024-01-02T00:00:00.000Z",21,FALSE,2,3547271,"C",21,21,"Oklahoma City Thunder","Aleksej Pokusevski",0,0,0,0,0,0
3,0,0,2,1,3,2,0,0,"17",1,3,5,1,1,0,1038054,"2024-01-02T00:00:00.000Z",21,FALSE,2,56677833,"G",21,21,"Oklahoma City Thunder","Cason Wallace",1,6,9,8,4,13.7
1,0,1,1,0,3,1,2,2,"13",0,1,4,1,1,0,1038054,"2024-01-02T00:00:00.000Z",21,FALSE,2,17896078,"G",21,21,"Oklahoma City Thunder","Aaron Wiggins",1,5,6,5,2,9.7
1,1,2,3,1,4,2,0,0,"08",0,0,5,2,0,0,1038054,"2024-01-02T00:00:00.000Z",21,FALSE,2,38017706,"F",21,21,"Oklahoma City Thunder","Jaylin Williams",1,7,8,6,3,11.9
2,0,1,1,0,3,1,0,0,"13",3,4,2,4,0,0,1038054,"2024-01-02T00:00:00.000Z",21,FALSE,2,480,"G-F",21,21,"Oklahoma City Thunder","Kenrich Williams",0,6,8,4,6,9.8
0,0,0,0,0,0,0,0,0,"00",0,0,0,0,0,0,1038054,"2024-01-02T00:00:00.000Z",21,FALSE,2,17553967,"C",2,2,"Boston Celtics","Neemias Queta",0,0,0,0,0,0
0,0,0,0,0,0,0,0,0,"00",0,0,0,0,0,0,1038054,"2024-01-02T00:00:00.000Z",21,FALSE,2,3547279,"F",2,2,"Boston Celtics","Lamar Stevens",0,0,0,0,0,0
0,0,0,0,0,0,0,0,0,"00",0,0,0,0,0,0,1038054,"2024-01-02T00:00:00.000Z",21,FALSE,2,38017707,"G",2,2,"Boston Celtics","JD Davison",0,0,0,0,0,0
0,0,0,0,0,0,0,0,0,"00",0,0,0,0,0,0,1038054,"2024-01-02T00:00:00.000Z",21,FALSE,2,NA,NA,NA,2,"Boston Celtics","NA NA",0,0,0,0,0,0
0,0,0,0,0,0,0,0,0,"00",0,0,0,0,0,0,1038054,"2024-01-02T00:00:00.000Z",21,FALSE,2,56677864,"G",2,2,"Boston Celtics","Jordan Walsh",0,0,0,0,0,0
2,1,3,8,3,11,6,0,0,"25",0,4,15,3,0,1,1038055,"2024-01-02T00:00:00.000Z",10,FALSE,22,443,"G",10,10,"Golden State Warriors","Klay Thompson",1,18,20,17,5,23.6
4,2,4,5,1,14,7,5,4,"34",2,2,19,6,1,1,1038055,"2024-01-02T00:00:00.000Z",10,FALSE,22,17553979,"F",10,10,"Golden State Warriors","Jonathan Kuminga",3,25,29,23,10,40.2
2,2,2,0,0,4,3,6,4,"24",2,1,10,4,1,3,1038055,"2024-01-02T00:00:00.000Z",10,FALSE,22,56677799,"F",10,10,"Golden State Warriors","Trayce Jackson-Davis",3,14,16,12,6,23.8
5,0,2,3,3,5,3,4,3,"30",0,1,12,2,0,1,1038055,"2024-01-02T00:00:00.000Z",10,FALSE,22,367,"G",10,10,"Golden State Warriors","Chris Paul",0,14,19,17,7,20.9
6,1,1,9,4,20,12,11,8,"35",1,4,36,2,4,2,1038055,"2024-01-02T00:00:00.000Z",10,FALSE,22,115,"G",10,10,"Golden State Warriors","Stephen Curry",5,38,44,42,8,60.4
0,0,0,0,0,0,0,0,0,"00",0,0,0,0,0,0,1038055,"2024-01-02T00:00:00.000Z",10,FALSE,22,185,"F",10,10,"Golden State Warriors","Draymond Green",0,0,0,0,0,0
0,0,0,0,0,0,0,0,0,"00",0,0,0,0,0,0,1038055,"2024-01-02T00:00:00.000Z",10,FALSE,22,251,"G",10,10,"Golden State Warriors","Cory Joseph",0,0,0,0,0,0
2,0,4,0,0,2,1,4,3,"17",1,4,5,5,0,0,1038055,"2024-01-02T00:00:00.000Z",10,FALSE,22,282,"F",10,10,"Golden State Warriors","Kevon Looney",0,10,12,7,7,14
0,0,0,0,0,0,0,0,0,"00",0,0,0,0,0,0,1038055,"2024-01-02T00:00:00.000Z",10,FALSE,22,17553992,"G",10,10,"Golden State Warriors","Moses Moody",0,0,0,0,0,0
0,0,3,3,0,5,1,0,0,"11",1,0,2,4,0,1,1038055,"2024-01-02T00:00:00.000Z",10,FALSE,22,2189,"",10,10,"Golden State Warriors","Gary Payton II",0,6,6,2,4,5.8
2,0,3,3,1,7,4,4,1,"29",1,2,10,4,1,0,1038055,"2024-01-02T00:00:00.000Z",10,FALSE,22,56677858,"G",10,10,"Golden State Warriors","Brandin Podziemski",1,14,16,12,6,20.8
0,0,0,0,0,0,0,0,0,"00",0,0,0,0,0,0,1038055,"2024-01-02T00:00:00.000Z",10,FALSE,22,45658838,"G",10,10,"Golden State Warriors","Lester Quinones",0,0,0,0,0,0
0,0,0,0,0,0,0,0,0,"00",0,0,0,0,0,0,1038055,"2024-01-02T00:00:00.000Z",10,FALSE,22,398,"G",10,10,"Golden State Warriors","Jerome Robinson",0,0,0,0,0,0
1,0,2,1,0,3,1,0,0,"14",1,0,2,3,0,2,1038055,"2024-01-02T00:00:00.000Z",10,FALSE,22,407,"F",10,10,"Golden State Warriors","Dario Saric",0,5,6,3,4,5.1
0,0,3,3,1,7,4,3,1,"21",0,1,10,3,2,1,1038055,"2024-01-02T00:00:00.000Z",10,FALSE,22,475,"F-G",10,10,"Golden State Warriors","Andrew Wiggins",2,13,13,10,3,18.6
0,0,0,0,0,0,0,0,0,"00",0,0,0,0,0,0,1038055,"2024-01-02T00:00:00.000Z",10,FALSE,22,17896070,"F",10,10,"Golden State Warriors","Usman Garuba",0,0,0,0,0,0
0,0,0,0,0,0,0,0,0,"00",0,0,0,0,0,0,1038055,"2024-01-02T00:00:00.000Z",10,FALSE,22,57875092,"F",10,10,"Golden State Warriors","Gui Santos",0,0,0,0,0,0
3,0,4,5,1,19,10,4,4,"37",2,4,25,6,2,4,1038055,"2024-01-02T00:00:00.000Z",10,FALSE,22,17896026,"F",22,22,"Orlando Magic","Franz Wagner",2,31,34,28,9,38.7
5,1,8,8,3,20,8,11,8,"34",4,4,27,12,2,5,1038055,"2024-01-02T00:00:00.000Z",10,FALSE,22,38017683,"F",22,22,"Orlando Magic","Paolo Banchero",3,39,44,32,17,52.9
1,1,4,1,1,6,6,0,0,"26",3,3,13,7,1,0,1038055,"2024-01-02T00:00:00.000Z",10,FALSE,22,666442,"C",22,22,"Orlando Magic","Goga Bitadze",2,20,21,14,8,28.9
0,0,1,3,2,3,2,0,0,"08",0,1,6,1,0,0,1038055,"2024-01-02T00:00:00.000Z",10,FALSE,22,38017724,"G",22,22,"Orlando Magic","Caleb Houstan",0,7,7,6,1,7.2
0,0,0,0,0,0,0,0,0,"00",0,0,0,0,0,0,1038055,"2024-01-02T00:00:00.000Z",10,FALSE,22,666818,"F",22,22,"Orlando Magic","Chuma Okeke",0,0,0,0,0,0
0,0,0,0,0,0,0,0,0,"00",0,0,0,0,0,0,1038055,"2024-01-02T00:00:00.000Z",10,FALSE,22,17553983,"G",22,22,"Orlando Magic","Trevelin Queen",0,0,0,0,0,0
1,0,2,2,1,8,5,1,1,"16",3,2,12,5,1,1,1038055,"2024-01-02T00:00:00.000Z",10,FALSE,22,462,"C",22,22,"Orlando Magic","Moritz Wagner",1,17,18,13,6,21.5
0,0,0,0,0,0,0,0,0,"00",0,0,0,0,0,0,1038055,"2024-01-02T00:00:00.000Z",10,FALSE,22,165,"G",22,22,"Orlando Magic","Markelle Fultz",0,0,0,0,0,0
0,0,0,0,0,0,0,0,0,"00",0,0,0,0,0,0,1038055,"2024-01-02T00:00:00.000Z",10,FALSE,22,38017607,"G",22,22,"Orlando Magic","Kevon Harris",0,0,0,0,0,0
0,0,0,0,0,0,0,0,0,"00",0,0,0,0,0,0,1038055,"2024-01-02T00:00:00.000Z",10,FALSE,22,56677839,"G",22,22,"Orlando Magic","Jett Howard",0,0,0,0,0,0
0,0,0,0,0,0,0,0,0,"00",0,0,0,0,0,0,1038055,"2024-01-02T00:00:00.000Z",10,FALSE,22,226,"F",22,22,"Orlando Magic","Joe Ingles",0,0,0,0,0,0
0,0,0,0,0,0,0,0,0,"00",0,0,0,0,0,0,1038055,"2024-01-02T00:00:00.000Z",10,FALSE,22,229,"F",22,22,"Orlando Magic","Jonathan Isaac",0,0,0,0,0,0
0,0,0,0,0,0,0,0,0,"00",0,0,0,0,0,0,1038055,"2024-01-02T00:00:00.000Z",10,FALSE,22,666885,"F",22,22,"Orlando Magic","Admiral Schofield",0,0,0,0,0,0
0,0,0,1,0,2,0,0,0,"13",0,2,0,0,1,1,1038055,"2024-01-02T00:00:00.000Z",10,FALSE,22,56677827,"G",22,22,"Orlando Magic","Anthony Black",1,0,0,0,0,2
3,0,1,7,3,14,3,2,1,"31",1,2,10,2,0,4,1038055,"2024-01-02T00:00:00.000Z",10,FALSE,22,17896073,"G",22,22,"Orlando Magic","Jalen Suggs",0,12,15,13,5,12.9
2,0,2,6,2,7,3,0,0,"29",0,1,8,2,0,0,1038055,"2024-01-02T00:00:00.000Z",10,FALSE,22,196,"G",22,22,"Orlando Magic","Gary Harris",0,10,12,10,4,13.4
1,1,2,1,0,5,1,4,4,"20",0,1,6,2,1,0,1038055,"2024-01-02T00:00:00.000Z",10,FALSE,22,85,"F",22,22,"Orlando Magic","Wendell Carter Jr.",2,8,9,7,3,15.9
2,1,1,2,1,8,3,1,1,"26",3,4,8,4,0,2,1038055,"2024-01-02T00:00:00.000Z",10,FALSE,22,3547251,"G",22,22,"Orlando Magic","Cole Anthony",1,12,14,10,6,16.8
1,0,1,2,1,2,1,0,0,"24",0,2,3,1,2,1,1038056,"2024-01-02T00:00:00.000Z",26,FALSE,4,30,"F",26,26,"Sacramento Kings","Harrison Barnes",2,4,5,4,2,10.7
2,0,2,6,1,12,4,2,1,"37",1,5,10,3,3,1,1038056,"2024-01-02T00:00:00.000Z",26,FALSE,4,38017688,"F",26,26,"Sacramento Kings","Keegan Murray",3,13,15,12,5,24.6
4,0,10,1,1,21,11,1,0,"35",9,5,23,19,1,11,1038056,"2024-01-02T00:00:00.000Z",26,FALSE,4,406,"F",26,26,"Sacramento Kings","Domantas Sabonis",1,42,46,27,23,43.8
4,0,3,4,2,11,5,0,0,"29",4,1,12,7,1,1,1038056,"2024-01-02T00:00:00.000Z",26,FALSE,4,17896030,"G",26,26,"Sacramento Kings","Chris Duarte",1,19,23,16,11,28.4
6,1,5,10,3,25,11,8,5,"38",0,2,30,5,1,3,1038056,"2024-01-02T00:00:00.000Z",26,FALSE,4,161,"G",26,26,"Sacramento Kings","De'Aaron Fox",2,35,41,36,11,48
0,0,0,0,0,0,0,0,0,"00",0,0,0,0,0,0,1038056,"2024-01-02T00:00:00.000Z",26,FALSE,4,17896044,"F",26,26,"Sacramento Kings","Kessler Edwards",0,0,0,0,0,0
0,0,0,0,0,0,0,0,0,"00",0,0,0,0,0,0,1038056,"2024-01-02T00:00:00.000Z",26,FALSE,4,38017714,"G",26,26,"Sacramento Kings","Keon Ellis",0,0,0,0,0,0
0,0,2,2,0,4,1,2,2,"12",0,3,4,2,0,0,1038056,"2024-01-02T00:00:00.000Z",26,FALSE,4,221,"G",26,26,"Sacramento Kings","Kevin Huerter",0,6,6,4,2,6.4
3,0,4,0,0,1,1,2,1,"13",0,2,3,4,0,1,1038056,"2024-01-02T00:00:00.000Z",26,FALSE,4,273,"C",26,26,"Sacramento Kings","Alex Len",0,7,10,6,7,11.3
1,0,3,5,3,6,3,0,0,"17",0,0,9,3,0,0,1038056,"2024-01-02T00:00:00.000Z",26,FALSE,4,290,"F",26,26,"Sacramento Kings","Trey Lyles",0,12,13,10,4,14.1
0,0,0,0,0,0,0,0,0,"00",0,0,0,0,0,0,1038056,"2024-01-02T00:00:00.000Z",26,FALSE,4,306,"C",26,26,"Sacramento Kings","JaVale McGee",0,0,0,0,0,0
0,0,1,1,1,3,1,2,1,"14",0,1,4,1,0,1,1038056,"2024-01-02T00:00:00.000Z",26,FALSE,4,17553994,"G",26,26,"Sacramento Kings","Davion Mitchell",0,5,5,4,1,4.2
2,1,2,5,2,7,2,0,0,"20",1,2,6,3,0,1,1038056,"2024-01-02T00:00:00.000Z",26,FALSE,4,324,"G",26,26,"Sacramento Kings","Malik Monk",1,9,11,8,5,14.6
0,0,0,0,0,0,0,0,0,"01",0,0,0,0,0,0,1038056,"2024-01-02T00:00:00.000Z",26,FALSE,4,666925,"F",29,26,"Sacramento Kings","Juan Toscano-Anderson",0,0,0,0,0,0
0,0,0,0,0,0,0,0,0,"00",0,0,0,0,0,0,1038056,"2024-01-02T00:00:00.000Z",26,FALSE,4,4197162,"F",26,26,"Sacramento Kings","Aleksandar Vezenkov",0,0,0,0,0,0
0,0,0,0,0,0,0,0,0,"00",0,0,0,0,0,0,1038056,"2024-01-02T00:00:00.000Z",26,FALSE,4,17895990,"G",26,26,"Sacramento Kings","Jordan Ford",0,0,0,0,0,0
0,0,0,0,0,0,0,0,0,"00",0,0,0,0,0,0,1038056,"2024-01-02T00:00:00.000Z",26,FALSE,4,56677845,"G",26,26,"Sacramento Kings","Colby Jones",0,0,0,0,0,0
0,0,0,0,0,0,0,0,0,"00",0,0,0,0,0,0,1038056,"2024-01-02T00:00:00.000Z",26,FALSE,4,56677862,"F",26,26,"Sacramento Kings","Jalen Slawson",0,0,0,0,0,0
2,0,1,2,0,3,1,3,2,"22",1,1,4,2,0,0,1038056,"2024-01-02T00:00:00.000Z",26,FALSE,4,38017708,"G",4,4,"Charlotte Hornets","Bryce McGowens",0,6,8,6,4,9.4
3,2,5,6,3,18,9,6,6,"40",0,0,27,5,1,3,1038056,"2024-01-02T00:00:00.000Z",26,FALSE,4,62,"F",4,4,"Charlotte Hornets","Miles Bridges",3,32,35,30,8,43.5
1,2,9,0,0,4,3,2,1,"26",1,2,7,10,1,2,1038056,"2024-01-02T00:00:00.000Z",26,FALSE,4,3547282,"C",4,4,"Charlotte Hornets","Nick Richards",3,17,18,8,11,27.5
2,0,2,5,1,10,4,2,1,"33",0,2,10,2,1,1,1038056,"2024-01-02T00:00:00.000Z",26,FALSE,4,666748,"F",4,4,"Charlotte Hornets","Cody Martin",1,12,14,12,4,17.4
6,2,3,11,3,24,13,6,5,"36",0,3,34,3,1,2,1038056,"2024-01-02T00:00:00.000Z",26,FALSE,4,403,"G",4,4,"Charlotte Hornets","Terry Rozier",3,37,43,40,9,53.6
0,0,0,0,0,0,0,0,0,"00",0,0,0,0,0,0,1038056,"2024-01-02T00:00:00.000Z",26,FALSE,4,17896037,"G",4,4,"Charlotte Hornets","James Bouknight",0,0,0,0,0,0
0,2,1,0,0,1,0,0,0,"16",0,4,0,1,2,1,1038056,"2024-01-02T00:00:00.000Z",26,FALSE,4,NA,NA,NA,4,"Charlotte Hornets","NA NA",4,1,1,0,1,12.2
0,0,0,0,0,0,0,0,0,"00",0,0,0,0,0,0,1038056,"2024-01-02T00:00:00.000Z",26,FALSE,4,56677823,"F",4,4,"Charlotte Hornets","Brandon Miller",0,0,0,0,0,0
4,0,5,0,0,4,2,0,0,"18",1,1,4,6,1,4,1038056,"2024-01-02T00:00:00.000Z",26,FALSE,4,422,"G",4,4,"Charlotte Hornets","Ish Smith",1,10,14,8,10,16.2
1,2,0,3,2,3,2,0,0,"14",0,1,6,0,0,0,1038056,"2024-01-02T00:00:00.000Z",26,FALSE,4,56677846,"G",4,4,"Charlotte Hornets","Nick Smith Jr.",2,6,7,7,1,13.5
0,0,2,1,0,2,1,0,0,"06",0,0,2,2,0,0,1038056,"2024-01-02T00:00:00.000Z",26,FALSE,4,18678001,"F",4,4,"Charlotte Hornets","JT Thor",0,4,4,2,2,4.4
4,0,3,6,3,13,7,0,0,"29",1,1,17,4,1,1,1038056,"2024-01-02T00:00:00.000Z",26,FALSE,4,666950,"F",4,4,"Charlotte Hornets","P.J. Washington",1,21,25,21,8,29.8
0,0,0,0,0,0,0,0,0,"00",0,0,0,0,0,0,1038056,"2024-01-02T00:00:00.000Z",26,FALSE,4,56677848,"G",4,4,"Charlotte Hornets","Amari Bailey",0,0,0,0,0,0
0,0,0,0,0,0,0,0,0,"00",0,0,0,0,0,0,1038056,"2024-01-02T00:00:00.000Z",26,FALSE,4,3547239,"G",4,4,"Charlotte Hornets","LaMelo Ball",0,0,0,0,0,0
0,0,0,0,0,0,0,0,0,"00",0,0,0,0,0,0,1038056,"2024-01-02T00:00:00.000Z",26,FALSE,4,56677866,"F",4,4,"Charlotte Hornets","Leaky Black",0,0,0,0,0,0
0,0,0,0,0,0,0,0,0,"00",0,0,0,0,0,0,1038056,"2024-01-02T00:00:00.000Z",26,FALSE,4,204,"F",4,4,"Charlotte Hornets","Gordon Hayward",0,0,0,0,0,0
0,0,0,0,0,0,0,0,0,"00",0,0,0,0,0,0,1038056,"2024-01-02T00:00:00.000Z",26,FALSE,4,347,"G",4,4,"Charlotte Hornets","Frank Ntilikina",0,0,0,0,0,0
0,0,0,0,0,0,0,0,0,"00",0,0,0,0,0,0,1038056,"2024-01-02T00:00:00.000Z",26,FALSE,4,38017698,"C",4,4,"Charlotte Hornets","Mark Williams",0,0,0,0,0,0
3,0,2,1,1,4,4,0,0,"19",0,2,9,2,1,0,1038057,"2024-01-03T00:00:00.000Z",6,FALSE,30,3547247,"F-G",6,6,"Cleveland Cavaliers","Isaac Okoro",1,11,14,12,5,18.9
1,0,3,1,0,3,1,0,0,"20",0,1,2,3,0,0,1038057,"2024-01-03T00:00:00.000Z",6,FALSE,30,666940,"F",6,6,"Cleveland Cavaliers","Dean Wade",0,5,6,3,4,7.1
7,2,12,0,0,10,7,4,3,"29",7,0,17,19,0,1,1038057,"2024-01-03T00:00:00.000Z",6,FALSE,30,9,"C",6,6,"Cleveland Cavaliers","Jarrett Allen",2,36,43,24,26,55.3
3,1,2,8,6,13,9,0,0,"28",2,4,24,4,1,1,1038057,"2024-01-03T00:00:00.000Z",6,FALSE,30,666908,"G",6,6,"Cleveland Cavaliers","Max Strus",2,28,31,27,7,38.3
4,2,2,9,4,16,6,6,6,"24",1,0,22,3,2,2,1038057,"2024-01-03T00:00:00.000Z",6,FALSE,30,322,"G",6,6,"Cleveland Cavaliers","Donovan Mitchell",4,25,29,26,7,41.6
0,0,0,0,0,0,0,0,0,"00",0,0,0,0,0,0,1038057,"2024-01-03T00:00:00.000Z",6,FALSE,30,666676,"G",6,6,"Cleveland Cavaliers","Ty Jerome",0,0,0,0,0,0
0,1,1,1,0,3,2,0,0,"06",0,0,4,1,0,0,1038057,"2024-01-03T00:00:00.000Z",6,FALSE,30,248,"C",6,6,"Cleveland Cavaliers","Damian Jones",1,5,5,4,1,8.2
5,1,3,6,3,18,9,0,0,"23",2,1,21,5,1,0,1038057,"2024-01-03T00:00:00.000Z",6,FALSE,30,277,"G",6,6,"Cleveland Cavaliers","Caris LeVert",2,26,31,26,10,40.5
6,0,4,9,3,11,4,0,0,"29",1,2,11,5,0,0,1038057,"2024-01-03T00:00:00.000Z",6,FALSE,30,3547299,"G",6,6,"Cleveland Cavaliers","Sam Merrill",0,16,22,17,11,26
1,0,7,7,3,11,5,2,2,"28",1,2,15,8,0,0,1038057,"2024-01-03T00:00:00.000Z",6,FALSE,30,344,"F",6,6,"Cleveland Cavaliers","Georges Niang",0,23,24,16,9,26.1
3,0,2,0,0,5,4,1,0,"15",1,0,8,3,0,1,1038057,"2024-01-03T00:00:00.000Z",6,FALSE,30,56677872,"G",6,6,"Cleveland Cavaliers","Craig Porter",0,11,14,11,6,15.1
4,1,6,0,0,7,3,3,1,"19",3,1,7,9,0,3,1038057,"2024-01-03T00:00:00.000Z",6,FALSE,30,444,"C-F",6,6,"Cleveland Cavaliers","Tristan Thompson",1,16,20,11,13,23.8
0,0,0,0,0,0,0,0,0,"00",0,0,0,0,0,0,1038057,"2024-01-03T00:00:00.000Z",6,FALSE,30,56677847,"F",6,6,"Cleveland Cavaliers","Emoni Bates",0,0,0,0,0,0
0,0,0,0,0,0,0,0,0,"00",0,0,0,0,0,0,1038057,"2024-01-03T00:00:00.000Z",6,FALSE,30,666581,"G",6,6,"Cleveland Cavaliers","Darius Garland",0,0,0,0,0,0
0,0,0,0,0,0,0,0,0,"00",0,0,0,0,0,0,1038057,"2024-01-03T00:00:00.000Z",6,FALSE,30,17896076,"F-C",6,6,"Cleveland Cavaliers","Evan Mobley",0,0,0,0,0,0
0,0,0,0,0,0,0,0,0,"00",0,0,0,0,0,0,1038057,"2024-01-03T00:00:00.000Z",6,FALSE,30,38017662,"F",6,6,"Cleveland Cavaliers","Isaiah Mobley",0,0,0,0,0,0
0,0,0,0,0,0,0,0,0,"00",0,0,0,0,0,0,1038057,"2024-01-03T00:00:00.000Z",6,FALSE,30,404,"G",6,6,"Cleveland Cavaliers","Ricky Rubio",0,0,0,0,0,0
4,0,4,3,1,11,3,0,0,"21",2,1,7,6,1,3,1038057,"2024-01-03T00:00:00.000Z",6,FALSE,30,3547242,"F",30,30,"Washington Wizards","Deni Avdija",1,13,17,11,10,20.2
3,0,2,6,2,12,7,0,0,"23",0,1,16,2,1,1,1038057,"2024-01-03T00:00:00.000Z",6,FALSE,30,265,"F",30,30,"Washington Wizards","Kyle Kuzma",1,18,21,19,5,24.9
1,1,2,0,0,8,6,1,0,"20",3,2,12,5,0,0,1038057,"2024-01-03T00:00:00.000Z",6,FALSE,30,666577,"F",30,30,"Washington Wizards","Daniel Gafford",1,17,18,13,6,22.5
2,0,0,4,2,11,3,0,0,"23",3,3,8,3,0,1,1038057,"2024-01-03T00:00:00.000Z",6,FALSE,30,666848,"G",30,30,"Washington Wizards","Jordan Poole",0,11,13,10,5,13.6
2,1,2,2,1,11,4,0,0,"21",0,0,9,2,1,0,1038057,"2024-01-03T00:00:00.000Z",6,FALSE,30,249,"G",30,30,"Washington Wizards","Tyus Jones",2,11,13,11,4,20.4
1,0,1,1,1,2,2,0,0,"09",0,0,5,1,0,0,1038057,"2024-01-03T00:00:00.000Z",6,FALSE,30,18677954,"G",30,30,"Washington Wizards","Jared Butler",0,6,7,6,2,7.7
1,2,4,4,1,12,2,2,0,"32",1,4,5,5,3,2,1038057,"2024-01-03T00:00:00.000Z",6,FALSE,30,56677844,"G",30,30,"Washington Wizards","Bilal Coulibaly",5,10,11,6,6,25.5
0,0,0,0,0,3,1,0,0,"05",0,0,2,0,0,0,1038057,"2024-01-03T00:00:00.000Z",6,FALSE,30,38017687,"G",30,30,"Washington Wizards","Johnny Davis",0,2,2,2,0,2
0,0,0,0,0,0,0,0,0,"00",0,0,0,0,0,0,1038057,"2024-01-03T00:00:00.000Z",6,FALSE,30,167,"F",30,30,"Washington Wizards","Danilo Gallinari",0,0,0,0,0,0
0,0,1,0,0,1,1,0,0,"05",0,0,2,1,0,0,1038057,"2024-01-03T00:00:00.000Z",6,FALSE,30,3547302,"F",30,30,"Washington Wizards","Anthony Gill",0,3,3,2,1,3.2
0,0,1,5,0,9,4,6,4,"20",0,0,12,1,0,0,1038057,"2024-01-03T00:00:00.000Z",6,FALSE,30,17896045,"F",30,30,"Washington Wizards","Corey Kispert",0,13,13,12,1,13.2
2,0,2,5,2,9,5,0,0,"21",2,0,12,4,0,0,1038057,"2024-01-03T00:00:00.000Z",6,FALSE,30,337,"F-C",30,30,"Washington Wizards","Mike Muscala",0,16,18,14,6,19.8
0,0,0,1,0,3,1,0,0,"07",1,2,2,1,0,0,1038057,"2024-01-03T00:00:00.000Z",6,FALSE,30,17896106,"F",30,30,"Washington Wizards","Eugene Omoruyi",0,3,3,2,1,3.2
2,0,3,3,2,6,3,2,1,"15",0,0,9,3,1,0,1038057,"2024-01-03T00:00:00.000Z",6,FALSE,30,414,"G",30,30,"Washington Wizards","Landry Shamet",1,12,14,11,5,18.6
4,1,2,1,0,3,0,0,0,"18",0,1,0,2,1,1,1038057,"2024-01-03T00:00:00.000Z",6,FALSE,30,487,"G",30,30,"Washington Wizards","Delon Wright",2,2,6,4,6,13.4
0,0,0,0,0,0,0,0,0,"00",0,0,0,0,0,0,1038057,"2024-01-03T00:00:00.000Z",6,FALSE,30,38017704,"F",30,30,"Washington Wizards","Patrick Baldwin Jr.",0,0,0,0,0,0
0,0,0,0,0,0,0,0,0,"00",0,0,0,0,0,0,1038057,"2024-01-03T00:00:00.000Z",6,FALSE,30,NA,NA,NA,30,"Washington Wizards","NA NA",0,0,0,0,0,0
0,0,0,0,0,0,0,0,0,"00",0,0,0,0,0,0,1038057,"2024-01-03T00:00:00.000Z",6,FALSE,30,38017712,"G",30,30,"Washington Wizards","Ryan Rollins",0,0,0,0,0,0
3,0,4,2,2,2,2,2,2,"31",0,4,8,4,1,1,1038061,"2024-01-03T00:00:00.000Z",11,FALSE,3,3547301,"F",11,11,"Houston Rockets","Jae'Sean Tate",1,12,15,11,7,19.3
0,1,11,4,1,8,2,2,2,"33",0,4,7,11,0,0,1038061,"2024-01-03T00:00:00.000Z",11,FALSE,3,38017684,"F",11,11,"Houston Rockets","Jabari Smith Jr.",1,18,18,7,11,23.2
4,1,4,2,0,17,11,10,8,"34",4,1,30,8,2,2,1038061,"2024-01-03T00:00:00.000Z",11,FALSE,3,17896062,"F-C",11,11,"Houston Rockets","Alperen Sengun",3,38,42,34,12,52.6
4,0,8,9,3,15,5,2,1,"31",0,1,14,8,0,4,1038061,"2024-01-03T00:00:00.000Z",11,FALSE,3,17895966,"G",11,11,"Houston Rockets","Jalen Green",0,22,26,18,12,25.6
10,2,6,8,6,9,7,2,1,"36",0,2,21,6,0,4,1038061,"2024-01-03T00:00:00.000Z",11,FALSE,3,458,"G",11,11,"Houston Rockets","Fred VanVleet",2,27,37,31,16,45.2
1,0,1,1,0,2,0,0,0,"08",0,0,0,1,0,0,1038061,"2024-01-03T00:00:00.000Z",11,FALSE,3,75,"G-F",11,11,"Houston Rockets","Reggie Bullock",0,1,2,1,2,2.7
0,0,0,2,2,4,2,2,2,"17",0,1,8,0,0,1,1038061,"2024-01-03T00:00:00.000Z",11,FALSE,3,188,"F",11,11,"Houston Rockets","Jeff Green",0,8,8,8,0,7
3,0,1,3,1,5,1,0,0,"14",0,2,3,1,0,1,1038061,"2024-01-03T00:00:00.000Z",11,FALSE,3,213,"G",11,11,"Houston Rockets","Aaron Holiday",0,4,7,6,4,7.7
0,0,0,0,0,0,0,0,0,"00",0,0,0,0,0,0,1038061,"2024-01-03T00:00:00.000Z",11,FALSE,3,19465326,"C",11,11,"Houston Rockets","Jock Landale",0,0,0,0,0,0
0,0,0,0,0,0,0,0,0,"00",0,0,0,0,0,0,1038061,"2024-01-03T00:00:00.000Z",11,FALSE,3,296,"C",11,11,"Houston Rockets","Boban Marjanovic",0,0,0,0,0,0
1,0,6,3,1,7,3,7,3,"20",0,1,10,6,0,1,1038061,"2024-01-03T00:00:00.000Z",11,FALSE,3,56677825,"G-F",11,11,"Houston Rockets","Amen Thompson",0,16,17,11,7,17.7
1,0,2,5,3,7,4,0,0,"16",0,3,11,2,2,1,1038061,"2024-01-03T00:00:00.000Z",11,FALSE,3,56677831,"F",11,11,"Houston Rockets","Cam Whitmore",2,13,14,12,3,19.9
0,0,0,0,0,0,0,0,0,"00",0,0,0,0,0,0,1038061,"2024-01-03T00:00:00.000Z",11,FALSE,3,66,"G-F",11,11,"Houston Rockets","Dillon Brooks",0,0,0,0,0,0
0,0,0,0,0,0,0,0,0,"00",0,0,0,0,0,0,1038061,"2024-01-03T00:00:00.000Z",11,FALSE,3,38017695,"F",11,11,"Houston Rockets","Tari Eason",0,0,0,0,0,0
0,0,0,0,0,0,0,0,0,"00",0,0,0,0,0,0,1038061,"2024-01-03T00:00:00.000Z",11,FALSE,3,3547281,"G-F",11,11,"Houston Rockets","Nate Hinton",0,0,0,0,0,0
0,0,0,0,0,0,0,0,0,"00",0,0,0,0,0,0,1038061,"2024-01-03T00:00:00.000Z",11,FALSE,3,357,"G",11,11,"Houston Rockets","Victor Oladipo",0,0,0,0,0,0
0,0,0,0,0,0,0,0,0,"00",0,0,0,0,0,0,1038061,"2024-01-03T00:00:00.000Z",11,FALSE,3,56677809,"F",11,11,"Houston Rockets","Jermaine Samuels Jr.",0,0,0,0,0,0
0,0,0,0,0,0,0,0,0,"00",0,0,0,0,0,0,1038061,"2024-01-03T00:00:00.000Z",11,FALSE,3,47738533,"G",11,11,"Houston Rockets","Jeenathan Williams",0,0,0,0,0,0
5,1,6,6,3,13,6,2,0,"32",0,0,15,6,0,0,1038061,"2024-01-03T00:00:00.000Z",11,FALSE,3,666679,"F",3,3,"Brooklyn Nets","Cameron Johnson",1,21,26,20,11,32.7
2,1,1,11,1,16,4,0,0,"20",1,2,9,2,0,2,1038061,"2024-01-03T00:00:00.000Z",11,FALSE,3,158,"F",3,3,"Brooklyn Nets","Dorian Finney-Smith",1,11,13,11,4,15.4
0,2,8,0,0,8,6,0,0,"28",5,5,12,13,1,1,1038061,"2024-01-03T00:00:00.000Z",11,FALSE,3,666508,"F-C",3,3,"Brooklyn Nets","Nicolas Claxton",3,25,25,12,13,35.6
3,1,4,12,3,18,5,3,2,"36",0,1,15,4,1,1,1038061,"2024-01-03T00:00:00.000Z",11,FALSE,3,61,"F",3,3,"Brooklyn Nets","Mikal Bridges",2,19,22,18,7,29.3
5,0,1,3,2,5,3,5,3,"28",0,1,11,1,2,1,1038061,"2024-01-03T00:00:00.000Z",11,FALSE,3,130,"G",3,3,"Brooklyn Nets","Spencer Dinwiddie",2,12,17,16,6,24.7
3,0,3,8,2,13,5,2,1,"30",1,3,13,4,2,1,1038061,"2024-01-03T00:00:00.000Z",11,FALSE,3,351,"F",3,3,"Brooklyn Nets","Royce O'Neale",2,17,20,16,7,27.3
1,1,8,0,0,7,4,6,3,"20",4,5,11,12,1,1,1038061,"2024-01-03T00:00:00.000Z",11,FALSE,3,17896038,"C",3,3,"Brooklyn Nets","Day'Ron Sharpe",2,23,24,12,13,31.9
0,0,0,0,0,0,0,0,0,"05",0,0,0,0,1,0,1038061,"2024-01-03T00:00:00.000Z",11,FALSE,3,56677722,"F",3,3,"Brooklyn Nets","Jalen Wilson",1,0,0,0,0,3
5,0,0,2,0,7,0,4,4,"18",0,1,4,0,1,1,1038061,"2024-01-03T00:00:00.000Z",11,FALSE,3,17896048,"G",3,3,"Brooklyn Nets","Cam Thomas",1,4,9,9,5,13.5
1,0,4,2,2,6,3,4,3,"20",4,1,11,8,1,0,1038061,"2024-01-03T00:00:00.000Z",11,FALSE,3,17896058,"F",3,3,"Brooklyn Nets","Trendon Watford",1,19,20,12,9,25.1
0,0,1,0,0,0,0,0,0,"03",0,0,0,1,0,0,1038061,"2024-01-03T00:00:00.000Z",11,FALSE,3,9051997,"G",3,3,"Brooklyn Nets","Armoni Brooks",0,1,1,0,1,1.2
0,0,0,0,0,0,0,0,0,"00",0,0,0,0,0,0,1038061,"2024-01-03T00:00:00.000Z",11,FALSE,3,174,"F-C",3,3,"Brooklyn Nets","Harry Giles III",0,0,0,0,0,0
0,0,0,0,0,0,0,0,0,"00",0,0,0,0,0,0,1038061,"2024-01-03T00:00:00.000Z",11,FALSE,3,421,"G",3,3,"Brooklyn Nets","Dennis Smith Jr.",0,0,0,0,0,0
0,0,0,0,0,0,0,0,0,"00",0,0,0,0,0,0,1038061,"2024-01-03T00:00:00.000Z",11,FALSE,3,56677843,"F",3,3,"Brooklyn Nets","Noah Clowney",0,0,0,0,0,0
0,0,0,0,0,0,0,0,0,"00",0,0,0,0,0,0,1038061,"2024-01-03T00:00:00.000Z",11,FALSE,3,17896041,"G",3,3,"Brooklyn Nets","Keon Johnson",0,0,0,0,0,0
0,0,0,0,0,0,0,0,0,"00",0,0,0,0,0,0,1038061,"2024-01-03T00:00:00.000Z",11,FALSE,3,417,"G-F",3,3,"Brooklyn Nets","Ben Simmons",0,0,0,0,0,0
0,0,0,0,0,0,0,0,0,"00",0,0,0,0,0,0,1038061,"2024-01-03T00:00:00.000Z",11,FALSE,3,464,"G",3,3,"Brooklyn Nets","Lonnie Walker IV",0,0,0,0,0,0
0,0,0,0,0,0,0,0,0,"00",0,0,0,0,0,0,1038061,"2024-01-03T00:00:00.000Z",11,FALSE,3,56677841,"F",3,3,"Brooklyn Nets","Dariq Whitehead",0,0,0,0,0,0
1,1,2,0,0,2,0,0,0,"08",0,0,0,2,2,1,1038062,"2024-01-03T00:00:00.000Z",15,FALSE,28,666703,"G-F",15,15,"Memphis Grizzlies","John Konchar",3,2,3,1,3,11.9
2,0,5,0,0,2,2,0,0,"13",3,0,4,8,0,1,1038062,"2024-01-03T00:00:00.000Z",15,FALSE,28,58,"F",28,28,"Toronto Raptors","Chris Boucher",0,12,14,6,10,15.6
2,0,5,5,0,10,2,3,2,"33",0,4,6,5,1,3,1038062,"2024-01-03T00:00:00.000Z",15,FALSE,28,420,"G",15,15,"Memphis Grizzlies","Marcus Smart",1,11,13,8,7,15
0,4,3,8,4,18,7,6,6,"37",1,1,24,4,1,3,1038062,"2024-01-03T00:00:00.000Z",15,FALSE,28,231,"F-C",15,15,"Memphis Grizzlies","Jaren Jackson Jr.",5,28,28,24,4,40.8
2,0,3,0,0,3,2,0,0,"23",2,3,4,5,0,0,1038062,"2024-01-03T00:00:00.000Z",15,FALSE,28,3547285,"F",15,15,"Memphis Grizzlies","Xavier Tillman",0,9,11,6,7,13
8,0,2,6,2,18,9,2,2,"38",2,4,22,4,0,0,1038062,"2024-01-03T00:00:00.000Z",15,FALSE,28,3547287,"G",15,15,"Memphis Grizzlies","Desmond Bane",0,26,34,30,12,38.8
9,0,7,6,3,18,10,6,5,"35",1,1,28,8,1,2,1038062,"2024-01-03T00:00:00.000Z",15,FALSE,28,666786,"G",15,15,"Memphis Grizzlies","Ja Morant",1,36,45,37,17,52.1
3,0,7,4,2,6,2,2,1,"22",1,4,7,8,1,1,1038062,"2024-01-03T00:00:00.000Z",15,FALSE,28,17896067,"F",15,15,"Memphis Grizzlies","Santi Aldama",1,15,18,10,11,23.1
0,0,0,0,0,0,0,0,0,"00",0,0,0,0,0,0,1038062,"2024-01-03T00:00:00.000Z",15,FALSE,28,48,"C",15,15,"Memphis Grizzlies","Bismack Biyombo",0,0,0,0,0,0
0,0,1,4,0,5,1,0,0,"19",0,1,2,1,0,0,1038062,"2024-01-03T00:00:00.000Z",15,FALSE,28,254,"G",15,15,"Memphis Grizzlies","Luke Kennard",0,3,3,2,1,3.2
0,0,0,0,0,0,0,0,0,"00",0,0,0,0,0,0,1038062,"2024-01-03T00:00:00.000Z",15,FALSE,28,401,"G",15,15,"Memphis Grizzlies","Derrick Rose",0,0,0,0,0,0
0,0,4,7,4,12,7,0,0,"18",2,1,18,6,1,0,1038062,"2024-01-03T00:00:00.000Z",15,FALSE,28,17896027,"G-F",15,15,"Memphis Grizzlies","Ziaire Williams",1,24,24,18,6,28.2
0,0,0,0,0,0,0,0,0,"00",0,0,0,0,0,0,1038062,"2024-01-03T00:00:00.000Z",15,FALSE,28,3,"C",15,15,"Memphis Grizzlies","Steven Adams",0,0,0,0,0,0
0,0,0,0,0,0,0,0,0,"00",0,0,0,0,0,0,1038062,"2024-01-03T00:00:00.000Z",15,FALSE,28,666505,"F",15,15,"Memphis Grizzlies","Brandon Clarke",0,0,0,0,0,0
0,0,0,0,0,0,0,0,0,"00",0,0,0,0,0,0,1038062,"2024-01-03T00:00:00.000Z",15,FALSE,28,48248287,"G",15,15,"Memphis Grizzlies","Jacob Gilyard",0,0,0,0,0,0
0,0,0,0,0,0,0,0,0,"00",0,0,0,0,0,0,1038062,"2024-01-03T00:00:00.000Z",15,FALSE,28,56677830,"F",15,15,"Memphis Grizzlies","GG Jackson",0,0,0,0,0,0
0,0,0,0,0,0,0,0,0,"00",0,0,0,0,0,0,1038062,"2024-01-03T00:00:00.000Z",15,FALSE,28,38017728,"F",15,15,"Memphis Grizzlies","Jake LaRavia",0,0,0,0,0,0
0,0,0,0,0,0,0,0,0,"00",0,0,0,0,0,0,1038062,"2024-01-03T00:00:00.000Z",15,FALSE,28,38017731,"G",15,15,"Memphis Grizzlies","Vince Williams Jr.",0,0,0,0,0,0
3,0,7,5,2,12,5,3,2,"33",0,3,14,7,1,3,1038062,"2024-01-03T00:00:00.000Z",15,FALSE,28,666423,"F-G",20,28,"Toronto Raptors","RJ Barrett",1,21,24,17,10,26.9
0,0,6,2,1,14,9,6,5,"30",1,5,24,7,1,3,1038062,"2024-01-03T00:00:00.000Z",15,FALSE,28,416,"F",28,28,"Toronto Raptors","Pascal Siakam",1,31,31,24,7,32.4
2,5,5,0,0,7,2,4,3,"33",3,3,7,8,1,1,1038062,"2024-01-03T00:00:00.000Z",15,FALSE,28,373,"C",28,28,"Toronto Raptors","Jakob Poeltl",6,15,17,9,10,36.6
8,0,2,5,2,14,7,4,4,"40",0,2,20,2,1,1,1038062,"2024-01-03T00:00:00.000Z",15,FALSE,28,17896055,"G-F",28,28,"Toronto Raptors","Scottie Barnes",1,22,30,28,10,36.4
5,1,3,8,5,18,8,6,5,"33",0,3,26,3,0,1,1038062,"2024-01-03T00:00:00.000Z",15,FALSE,28,3547269,"G",20,28,"Toronto Raptors","Immanuel Quickley",1,29,34,31,8,39.1
0,0,0,2,0,2,0,0,0,"07",0,0,0,0,0,0,1038062,"2024-01-03T00:00:00.000Z",15,FALSE,28,38017729,"F",15,15,"Memphis Grizzlies","David Roddy",0,0,0,0,0,0
0,0,0,0,0,0,0,0,0,"00",0,0,0,0,0,0,1038062,"2024-01-03T00:00:00.000Z",15,FALSE,28,376,"F",28,28,"Toronto Raptors","Otto Porter Jr.",0,0,0,0,0,0
0,0,1,1,1,5,2,0,0,"22",0,2,5,1,1,2,1038062,"2024-01-03T00:00:00.000Z",15,FALSE,28,3089,"",28,28,"Toronto Raptors","Gary Trent Jr.",1,6,6,5,1,7.2
5,0,7,3,1,11,6,4,3,"29",0,0,16,7,0,0,1038062,"2024-01-03T00:00:00.000Z",15,FALSE,28,409,"G",28,28,"Toronto Raptors","Dennis Schroder",0,23,28,21,12,31.9
0,0,3,2,0,2,0,0,0,"07",0,2,0,3,0,0,1038062,"2024-01-03T00:00:00.000Z",15,FALSE,28,2309958,"C-F",15,28,"Toronto Raptors","Jontay Porter",0,3,3,0,3,3.6
0,0,0,0,0,0,0,0,0,"00",0,0,0,0,0,0,1038062,"2024-01-03T00:00:00.000Z",15,FALSE,28,666762,"F",28,28,"Toronto Raptors","Jalen McDaniels",0,0,0,0,0,0
0,0,0,0,0,0,0,0,0,"00",0,0,0,0,0,0,1038062,"2024-01-03T00:00:00.000Z",15,FALSE,28,436,"G-F",28,28,"Toronto Raptors","Garrett Temple",0,0,0,0,0,0
0,0,0,0,0,0,0,0,0,"00",0,0,0,0,0,0,1038062,"2024-01-03T00:00:00.000Z",15,FALSE,28,489,"F",28,28,"Toronto Raptors","Thaddeus Young",0,0,0,0,0,0
0,0,0,0,0,0,0,0,0,"00",0,0,0,0,0,0,1038062,"2024-01-03T00:00:00.000Z",15,FALSE,28,56677828,"G",28,28,"Toronto Raptors","Gradey Dick",0,0,0,0,0,0
0,0,0,0,0,0,0,0,0,"00",0,0,0,0,0,0,1038062,"2024-01-03T00:00:00.000Z",15,FALSE,28,56677805,"G",28,28,"Toronto Raptors","Javon Freeman-Liberty",0,0,0,0,0,0
0,0,0,0,0,0,0,0,0,"00",0,0,0,0,0,0,1038062,"2024-01-03T00:00:00.000Z",15,FALSE,28,38017710,"C",28,28,"Toronto Raptors","Christian Koloko",0,0,0,0,0,0
0,0,0,0,0,0,0,0,0,"00",0,0,0,0,0,0,1038062,"2024-01-03T00:00:00.000Z",15,FALSE,28,56677869,"G",28,28,"Toronto Raptors","Markquis Nowell",0,0,0,0,0,0
2,1,0,3,1,10,5,0,0,"33",0,3,11,0,2,1,1038063,"2024-01-03T00:00:00.000Z",18,FALSE,19,3547259,"F",18,18,"Minnesota Timberwolves","Jaden McDaniels",3,11,13,13,2,22
2,0,4,4,0,19,8,7,6,"36",2,2,22,6,0,1,1038063,"2024-01-03T00:00:00.000Z",18,FALSE,19,447,"C",18,18,"Minnesota Timberwolves","Karl-Anthony Towns",0,28,30,24,8,31.2
0,1,4,0,0,3,2,2,1,"24",1,4,5,5,0,1,1038063,"2024-01-03T00:00:00.000Z",18,FALSE,19,176,"C",18,18,"Minnesota Timberwolves","Rudy Gobert",1,10,10,5,5,13
5,1,2,7,4,22,11,10,9,"37",2,1,35,4,1,6,1038063,"2024-01-03T00:00:00.000Z",18,FALSE,19,3547238,"G",18,18,"Minnesota Timberwolves","Anthony Edwards",2,39,44,40,9,47.3
9,0,0,3,1,5,3,0,0,"26",0,1,7,0,1,0,1038063,"2024-01-03T00:00:00.000Z",18,FALSE,19,104,"G",18,18,"Minnesota Timberwolves","Mike Conley",1,7,16,16,9,23.5
1,0,0,2,0,3,1,2,2,"19",0,0,4,0,0,1,1038063,"2024-01-03T00:00:00.000Z",18,FALSE,19,666400,"G",18,18,"Minnesota Timberwolves","Nickeil Alexander-Walker",0,4,5,5,1,4.5
0,0,3,0,0,2,0,2,1,"14",1,0,1,4,2,0,1038063,"2024-01-03T00:00:00.000Z",18,FALSE,19,12,"F",18,18,"Minnesota Timberwolves","Kyle Anderson",2,5,5,1,4,11.8
1,0,0,2,1,2,1,0,0,"03",0,0,3,0,0,0,1038063,"2024-01-03T00:00:00.000Z",18,FALSE,19,68,"F",18,18,"Minnesota Timberwolves","Troy Brown Jr.",0,3,4,4,1,4.5
4,0,1,4,0,6,1,2,1,"17",2,0,3,3,1,0,1038063,"2024-01-03T00:00:00.000Z",18,FALSE,19,666767,"G",18,18,"Minnesota Timberwolves","Jordan McLaughlin",1,6,10,7,7,15.6
0,0,0,1,1,2,2,0,0,"03",0,0,5,0,0,0,1038063,"2024-01-03T00:00:00.000Z",18,FALSE,19,320,"G",18,18,"Minnesota Timberwolves","Shake Milton",0,5,5,5,0,5
0,1,0,0,0,0,0,2,2,"03",0,0,2,0,0,0,1038063,"2024-01-03T00:00:00.000Z",18,FALSE,19,38017715,"F",18,18,"Minnesota Timberwolves","Josh Minott",1,2,2,2,0,5
0,0,0,0,0,0,0,0,0,"00",0,0,0,0,0,0,1038063,"2024-01-03T00:00:00.000Z",18,FALSE,19,17895968,"F",18,18,"Minnesota Timberwolves","Daishen Nix",0,0,0,0,0,0
2,2,6,5,2,8,3,0,0,"25",0,2,8,6,0,1,1038063,"2024-01-03T00:00:00.000Z",18,FALSE,19,667378,"F-C",18,18,"Minnesota Timberwolves","Naz Reid",2,14,16,10,8,23.2
0,0,0,0,0,0,0,0,0,"00",0,0,0,0,0,0,1038063,"2024-01-03T00:00:00.000Z",18,FALSE,19,56677851,"G",18,18,"Minnesota Timberwolves","Jaylen Clark",0,0,0,0,0,0
0,0,0,0,0,0,0,0,0,"00",0,0,0,0,0,0,1038063,"2024-01-03T00:00:00.000Z",18,FALSE,19,17896056,"C",18,18,"Minnesota Timberwolves","Luka Garza",0,0,0,0,0,0
0,0,0,0,0,0,0,0,0,"00",0,0,0,0,0,0,1038063,"2024-01-03T00:00:00.000Z",18,FALSE,19,56677782,"F",18,18,"Minnesota Timberwolves","Leonard Miller",0,0,0,0,0,0
0,0,0,0,0,0,0,0,0,"00",0,0,0,0,0,0,1038063,"2024-01-03T00:00:00.000Z",18,FALSE,19,38017700,"G",18,18,"Minnesota Timberwolves","Wendell Moore Jr.",0,0,0,0,0,0
7,0,4,3,1,11,7,5,4,"32",0,3,19,4,2,3,1038063,"2024-01-03T00:00:00.000Z",18,FALSE,19,227,"F",19,19,"New Orleans Pelicans","Brandon Ingram",2,23,30,26,11,37.3
6,1,3,0,0,15,11,6,5,"29",1,3,27,4,1,2,1038063,"2024-01-03T00:00:00.000Z",18,FALSE,19,666969,"F",19,19,"New Orleans Pelicans","Zion Williamson",2,31,37,33,10,44.8
3,0,6,2,0,5,2,0,0,"20",1,5,4,7,0,1,1038063,"2024-01-03T00:00:00.000Z",18,FALSE,19,455,"C",19,19,"New Orleans Pelicans","Jonas Valanciunas",0,11,14,7,10,15.9
2,1,3,5,4,11,6,0,0,"37",0,3,16,3,1,3,1038063,"2024-01-03T00:00:00.000Z",18,FALSE,19,17896024,"F",19,19,"New Orleans Pelicans","Herbert Jones",2,19,21,18,5,25.6
5,1,3,6,4,16,8,4,4,"30",0,2,24,3,0,2,1038063,"2024-01-03T00:00:00.000Z",18,FALSE,19,303,"G",19,19,"New Orleans Pelicans","CJ McCollum",1,27,32,29,8,36.1
3,1,2,6,2,8,3,0,0,"27",1,3,8,3,0,1,1038063,"2024-01-03T00:00:00.000Z",18,FALSE,19,17896097,"G",19,19,"New Orleans Pelicans","Jose Alvarado",1,11,14,11,6,18.1
1,0,3,1,1,3,2,2,2,"24",2,0,7,5,1,0,1038063,"2024-01-03T00:00:00.000Z",18,FALSE,19,38017677,"G",19,19,"New Orleans Pelicans","Dyson Daniels",1,12,13,8,6,17.5
0,0,0,1,0,2,1,0,0,"03",0,0,2,0,0,0,1038063,"2024-01-03T00:00:00.000Z",18,FALSE,19,56677837,"G",19,19,"New Orleans Pelicans","Jordan Hawkins",0,2,2,2,0,2
0,0,0,0,0,0,0,0,0,"00",0,0,0,0,0,0,1038063,"2024-01-03T00:00:00.000Z",18,FALSE,19,3547260,"G",19,19,"New Orleans Pelicans","Kira Lewis Jr.",0,0,0,0,0,0
0,0,2,2,0,4,1,0,0,"14",0,4,2,2,1,0,1038063,"2024-01-03T00:00:00.000Z",18,FALSE,19,3547293,"F",19,19,"New Orleans Pelicans","Naji Marshall",1,4,4,2,2,7.4
2,1,6,0,0,6,4,0,0,"22",3,1,8,9,1,0,1038063,"2024-01-03T00:00:00.000Z",18,FALSE,19,340,"F",19,19,"New Orleans Pelicans","Larry Nance Jr.",2,17,19,10,11,27.8
0,0,0,0,0,0,0,0,0,"00",0,0,0,0,0,0,1038063,"2024-01-03T00:00:00.000Z",18,FALSE,19,17896021,"F",19,19,"New Orleans Pelicans","Jeremiah Robinson-Earl",0,0,0,0,0,0
1,0,0,0,0,0,0,0,0,"02",1,0,0,1,0,0,1038063,"2024-01-03T00:00:00.000Z",18,FALSE,19,491,"C",19,19,"New Orleans Pelicans","Cody Zeller",0,1,2,1,2,2.7
0,0,0,0,0,0,0,0,0,"00",0,0,0,0,0,0,1038063,"2024-01-03T00:00:00.000Z",18,FALSE,19,38017663,"F",19,19,"New Orleans Pelicans","E.J. Liddell",0,0,0,0,0,0
0,0,0,0,0,0,0,0,0,"00",0,0,0,0,0,0,1038063,"2024-01-03T00:00:00.000Z",18,FALSE,19,18677986,"F",19,19,"New Orleans Pelicans","Trey Murphy III",0,0,0,0,0,0
0,0,0,0,0,0,0,0,0,"00",0,0,0,0,0,0,1038063,"2024-01-03T00:00:00.000Z",18,FALSE,19,17896017,"F",19,19,"New Orleans Pelicans","Matt Ryan",0,0,0,0,0,0
0,0,0,0,0,0,0,0,0,"00",0,0,0,0,0,0,1038063,"2024-01-03T00:00:00.000Z",18,FALSE,19,38017726,"G",19,19,"New Orleans Pelicans","Dereon Seabron",0,0,0,0,0,0
1,0,4,2,0,5,3,2,2,"27",0,4,8,4,2,0,1038064,"2024-01-03T00:00:00.000Z",7,FALSE,25,3547258,"G",7,7,"Dallas Mavericks","Josh Green",2,12,13,9,5,20.3
1,2,0,0,0,3,2,2,1,"23",0,2,5,0,2,1,1038064,"2024-01-03T00:00:00.000Z",7,FALSE,25,247,"F-G",7,7,"Dallas Mavericks","Derrick Jones Jr.",4,5,6,6,1,17.5
4,3,3,0,0,1,0,0,0,"19",1,1,0,4,2,0,1038064,"2024-01-03T00:00:00.000Z",7,FALSE,25,56677840,"C",7,7,"Dallas Mavericks","Dereck Lively II",5,4,8,4,8,25.8
5,0,8,8,4,19,10,6,5,"29",1,0,29,9,2,1,1038064,"2024-01-03T00:00:00.000Z",7,FALSE,25,228,"G",7,7,"Dallas Mavericks","Kyrie Irving",2,38,43,34,14,52.3
5,0,6,7,4,21,13,14,11,"31",0,1,41,6,1,4,1038064,"2024-01-03T00:00:00.000Z",7,FALSE,25,132,"F-G",7,7,"Dallas Mavericks","Luka Doncic",1,47,52,46,11,54.7
2,0,1,0,0,1,0,0,0,"15",0,0,0,1,0,0,1038064,"2024-01-03T00:00:00.000Z",7,FALSE,25,114,"G",7,7,"Dallas Mavericks","Seth Curry",0,1,3,2,3,4.2
0,0,3,5,2,10,5,2,2,"23",0,2,14,3,0,0,1038064,"2024-01-03T00:00:00.000Z",7,FALSE,25,191,"G",7,7,"Dallas Mavericks","Tim Hardaway Jr.",0,17,17,14,3,17.6
1,1,2,6,1,10,4,3,2,"11",0,0,11,2,0,0,1038064,"2024-01-03T00:00:00.000Z",7,FALSE,25,38017679,"G",7,7,"Dallas Mavericks","Jaden Hardy",1,13,14,12,3,17.9
0,0,0,1,1,4,1,0,0,"08",0,1,3,0,1,0,1038064,"2024-01-03T00:00:00.000Z",7,FALSE,25,17554004,"G",7,7,"Dallas Mavericks","AJ Lawson",1,3,3,3,0,6
1,1,3,1,1,3,1,0,0,"12",0,2,3,3,0,1,1038064,"2024-01-03T00:00:00.000Z",7,FALSE,25,329,"F",7,7,"Dallas Mavericks","Markieff Morris",1,6,7,4,4,10.1
2,0,2,0,0,1,1,6,3,"13",1,2,5,3,0,1,1038064,"2024-01-03T00:00:00.000Z",7,FALSE,25,379,"F-C",7,7,"Dallas Mavericks","Dwight Powell",0,8,10,7,5,10.6
1,1,3,0,0,3,1,4,3,"08",2,1,5,5,0,0,1038064,"2024-01-03T00:00:00.000Z",7,FALSE,25,56677859,"F",7,7,"Dallas Mavericks","Olivier-Maxence Prosper",1,10,11,6,6,15.5
0,0,1,0,0,1,0,2,0,"06",1,0,0,2,1,0,1038064,"2024-01-03T00:00:00.000Z",7,FALSE,25,24489167,"G",25,7,"Dallas Mavericks","Brandon Williams",1,2,2,0,2,5.4
2,0,1,0,0,2,1,0,0,"15",1,2,2,2,0,3,1038064,"2024-01-03T00:00:00.000Z",7,FALSE,25,666965,"F",7,7,"Dallas Mavericks","Grant Williams",0,4,6,4,4,4.4
0,0,0,0,0,0,0,0,0,"00",0,0,0,0,0,0,1038064,"2024-01-03T00:00:00.000Z",7,FALSE,25,17896028,"F",7,7,"Dallas Mavericks","Greg Brown III",0,0,0,0,0,0
2,0,2,3,0,6,2,1,1,"17",0,1,5,2,0,0,1038064,"2024-01-03T00:00:00.000Z",7,FALSE,25,65,"G",25,25,"Portland Trail Blazers","Malcolm Brogdon",0,7,9,7,4,10.4
1,0,4,0,0,4,2,2,1,"08",1,0,5,5,0,1,1038064,"2024-01-03T00:00:00.000Z",7,FALSE,25,3547289,"G",25,25,"Portland Trail Blazers","Skylar Mays",0,10,11,6,6,11.5
2,0,1,1,0,4,1,0,0,"15",0,0,2,1,0,0,1038064,"2024-01-03T00:00:00.000Z",7,FALSE,25,56677791,"F",25,25,"Portland Trail Blazers","Kris Murray",0,3,5,4,3,6.2
1,0,2,1,0,2,1,0,0,"06",0,4,2,2,0,2,1038064,"2024-01-03T00:00:00.000Z",7,FALSE,25,56783340,"C",25,25,"Portland Trail Blazers","Duop Reath",0,4,5,3,3,3.9
0,0,3,5,1,12,6,3,3,"22",1,3,16,4,0,0,1038064,"2024-01-03T00:00:00.000Z",7,FALSE,25,38017690,"G",25,25,"Portland Trail Blazers","Shaedon Sharpe",0,20,20,16,4,20.8
1,0,2,6,4,6,4,0,0,"23",0,4,12,2,1,0,1038064,"2024-01-03T00:00:00.000Z",7,FALSE,25,666923,"G-F",25,25,"Portland Trail Blazers","Matisse Thybulle",1,14,15,13,3,18.9
0,0,5,5,3,5,3,0,0,"17",0,0,9,5,1,0,1038064,"2024-01-03T00:00:00.000Z",7,FALSE,25,17896120,"F",25,25,"Portland Trail Blazers","Ish Wainright",1,14,14,9,5,18
4,0,4,1,0,3,1,2,2,"17",1,2,4,5,0,1,1038064,"2024-01-03T00:00:00.000Z",7,FALSE,25,38017711,"F",25,25,"Portland Trail Blazers","Jabari Walker",0,9,13,8,9,15
0,0,0,0,0,0,0,0,0,"00",0,0,0,0,0,0,1038064,"2024-01-03T00:00:00.000Z",7,FALSE,25,22,"C",25,25,"Portland Trail Blazers","Deandre Ayton",0,0,0,0,0,0
0,0,0,0,0,0,0,0,0,"00",0,0,0,0,0,0,1038064,"2024-01-03T00:00:00.000Z",7,FALSE,25,666476,"C",25,25,"Portland Trail Blazers","Moses Brown",0,0,0,0,0,0
0,0,0,0,0,0,0,0,0,"00",0,0,0,0,0,0,1038064,"2024-01-03T00:00:00.000Z",7,FALSE,25,47957121,"F",25,25,"Portland Trail Blazers","Justin Minaya",0,0,0,0,0,0
0,2,1,0,0,2,0,0,0,"15",3,6,0,4,0,4,1038064,"2024-01-03T00:00:00.000Z",7,FALSE,25,39613724,"C",25,25,"Portland Trail Blazers","Ibou Badji",2,4,4,0,4,6.8
3,0,4,7,1,16,5,4,4,"27",1,1,15,5,0,2,1038064,"2024-01-03T00:00:00.000Z",7,FALSE,25,419,"G",25,25,"Portland Trail Blazers","Anfernee Simons",0,20,23,18,8,23.5
7,0,4,4,1,11,2,4,2,"33",1,4,7,5,0,6,1038064,"2024-01-03T00:00:00.000Z",7,FALSE,25,56677747,"G",25,25,"Portland Trail Blazers","Scoot Henderson",0,12,19,14,12,17.5
0,0,0,0,0,0,0,0,0,"00",0,0,0,0,0,0,1038064,"2024-01-03T00:00:00.000Z",7,FALSE,25,56677829,"G-F",25,25,"Portland Trail Blazers","Rayan Rupert",0,0,0,0,0,0
0,0,0,0,0,0,0,0,0,"00",0,0,0,0,0,0,1038064,"2024-01-03T00:00:00.000Z",7,FALSE,25,476,"C-F",25,25,"Portland Trail Blazers","Robert Williams III",0,0,0,0,0,0
0,0,0,0,0,0,0,0,0,"00",0,0,0,0,0,0,1038064,"2024-01-03T00:00:00.000Z",7,FALSE,25,217,"F-C",7,7,"Dallas Mavericks","Richaun Holmes",0,0,0,0,0,0
0,0,0,0,0,0,0,0,0,"00",0,0,0,0,0,0,1038064,"2024-01-03T00:00:00.000Z",7,FALSE,25,257,"F",7,7,"Dallas Mavericks","Maxi Kleber",0,0,0,0,0,0
2,0,1,3,1,9,4,3,1,"20",0,3,10,1,0,3,1038064,"2024-01-03T00:00:00.000Z",7,FALSE,25,182,"F",25,25,"Portland Trail Blazers","Jerami Grant",0,11,13,12,3,11.2
0,1,3,4,2,8,3,3,2,"20",2,6,10,5,2,2,1038064,"2024-01-03T00:00:00.000Z",7,FALSE,25,56677850,"F",25,25,"Portland Trail Blazers","Toumani Camara",3,15,15,10,5,23
0,0,0,0,0,0,0,0,0,"00",0,0,0,0,0,0,1038064,"2024-01-03T00:00:00.000Z",7,FALSE,25,151,"G",7,7,"Dallas Mavericks","Dante Exum",0,0,0,0,0,0
3,0,3,4,2,9,4,1,0,"32",1,2,10,4,3,1,1038065,"2024-01-03T00:00:00.000Z",24,FALSE,13,8,"G",24,24,"Phoenix Suns","Grayson Allen",3,14,17,13,7,27.3
2,0,2,4,1,6,3,0,0,"15",1,0,7,3,2,1,1038065,"2024-01-03T00:00:00.000Z",24,FALSE,13,314,"F",24,24,"Phoenix Suns","Chimezie Metu",2,10,12,9,5,18.6
1,0,5,1,0,5,3,3,3,"25",1,3,9,6,1,1,1038065,"2024-01-03T00:00:00.000Z",24,FALSE,13,349,"C",24,24,"Phoenix Suns","Jusuf Nurkic",1,15,16,10,7,19.7
4,1,3,6,0,20,7,7,7,"41",2,5,21,5,2,3,1038065,"2024-01-03T00:00:00.000Z",24,FALSE,13,37,"G",24,24,"Phoenix Suns","Bradley Beal",3,26,30,25,9,39
6,0,2,8,5,15,11,9,8,"37",0,4,35,2,0,6,1038065,"2024-01-03T00:00:00.000Z",24,FALSE,13,57,"G",24,24,"Phoenix Suns","Devin Booker",0,37,43,41,8,40.4
0,0,0,0,0,0,0,0,0,"02",0,0,0,0,0,0,1038065,"2024-01-03T00:00:00.000Z",24,FALSE,13,3547095,"C-F",24,24,"Phoenix Suns","Udoka Azubuike",0,0,0,0,0,0
3,0,0,2,1,3,1,2,2,"21",0,3,5,0,1,0,1038065,"2024-01-03T00:00:00.000Z",24,FALSE,13,32,"F",24,24,"Phoenix Suns","Keita Bates-Diop",1,5,8,8,3,12.5
2,0,2,2,2,7,6,0,0,"19",3,2,14,5,0,2,1038065,"2024-01-03T00:00:00.000Z",24,FALSE,13,666451,"C",24,24,"Phoenix Suns","Bol Bol",0,19,21,16,7,21
0,0,0,0,0,0,0,0,0,"04",0,1,0,0,0,0,1038065,"2024-01-03T00:00:00.000Z",24,FALSE,13,147,"F",24,24,"Phoenix Suns","Drew Eubanks",0,0,0,0,0,0
0,0,0,0,0,0,0,0,0,"00",0,0,0,0,0,0,1038065,"2024-01-03T00:00:00.000Z",24,FALSE,13,18678058,"",24,24,"Phoenix Suns","Jordan Goodwin",0,0,0,0,0,0
1,0,4,6,3,11,5,4,3,"28",1,1,16,5,0,1,1038065,"2024-01-03T00:00:00.000Z",24,FALSE,13,178,"G",24,24,"Phoenix Suns","Eric Gordon",0,21,22,17,6,22.5
1,1,1,2,1,3,2,0,0,"16",1,2,5,2,0,1,1038065,"2024-01-03T00:00:00.000Z",24,FALSE,13,356,"G",24,24,"Phoenix Suns","Josh Okogie",1,7,8,6,3,10.9
0,0,0,0,0,0,0,0,0,"00",0,0,0,0,0,0,1038065,"2024-01-03T00:00:00.000Z",24,FALSE,13,17896022,"G",13,13,"LA Clippers","Brandon Boston Jr.",0,0,0,0,0,0
0,0,0,0,0,0,0,0,0,"00",0,0,0,0,0,0,1038065,"2024-01-03T00:00:00.000Z",24,FALSE,13,56677849,"F",13,13,"LA Clippers","Kobe Brown",0,0,0,0,0,0
1,0,0,0,0,1,1,2,1,"13",0,1,3,0,0,0,1038065,"2024-01-03T00:00:00.000Z",24,FALSE,13,666511,"G",13,13,"LA Clippers","Amir Coffey",0,3,4,4,1,4.5
0,0,0,0,0,0,0,0,0,"00",0,0,0,0,0,0,1038065,"2024-01-03T00:00:00.000Z",24,FALSE,13,17896031,"G",13,13,"LA Clippers","Nah'Shon Hyland",0,0,0,0,0,0
0,0,0,0,0,0,0,0,0,"00",0,0,0,0,0,0,1038065,"2024-01-03T00:00:00.000Z",24,FALSE,13,371,"F-C",13,13,"LA Clippers","Mason Plumlee",0,0,0,0,0,0
1,0,2,5,3,8,5,0,0,"26",0,1,13,2,0,3,1038065,"2024-01-03T00:00:00.000Z",24,FALSE,13,380,"F-G",13,13,"LA Clippers","Norman Powell",0,15,16,14,3,13.9
1,0,2,0,0,5,3,0,0,"20",1,3,6,3,1,0,1038065,"2024-01-03T00:00:00.000Z",24,FALSE,13,439,"F",13,13,"LA Clippers","Daniel Theis",1,9,10,7,4,14.1
0,0,0,0,0,0,0,0,0,"00",0,0,0,0,0,0,1038065,"2024-01-03T00:00:00.000Z",24,FALSE,13,450,"F",13,13,"LA Clippers","PJ Tucker",0,0,0,0,0,0
2,0,3,2,0,7,2,2,2,"18",2,1,6,5,2,2,1038065,"2024-01-03T00:00:00.000Z",24,FALSE,13,472,"G",13,13,"LA Clippers","Russell Westbrook",2,11,13,8,7,19
0,0,0,0,0,0,0,0,0,"00",0,0,0,0,0,0,1038065,"2024-01-03T00:00:00.000Z",24,FALSE,13,38017725,"F",13,13,"LA Clippers","Moussa Diabate",0,0,0,0,0,0
0,0,0,0,0,0,0,0,0,"00",0,0,0,0,0,0,1038065,"2024-01-03T00:00:00.000Z",24,FALSE,13,56677856,"G",13,13,"LA Clippers","Jordan Miller",0,0,0,0,0,0
0,0,0,0,0,0,0,0,0,"00",0,0,0,0,0,0,1038065,"2024-01-03T00:00:00.000Z",24,FALSE,13,24417679,"G",13,13,"LA Clippers","Xavier Moon",0,0,0,0,0,0
0,0,0,0,0,0,0,0,0,"00",0,0,0,0,0,0,1038065,"2024-01-03T00:00:00.000Z",24,FALSE,13,17896051,"G",13,13,"LA Clippers","Joshua Primo",0,0,0,0,0,0
0,0,0,0,0,0,0,0,0,"00",0,0,0,0,0,0,1038065,"2024-01-03T00:00:00.000Z",24,FALSE,13,470,"G",24,24,"Phoenix Suns","Yuta Watanabe",0,0,0,0,0,0
0,0,0,0,0,0,0,0,0,"00",0,0,0,0,0,0,1038065,"2024-01-03T00:00:00.000Z",24,FALSE,13,140,"F",24,24,"Phoenix Suns","Kevin Durant",0,0,0,0,0,0
0,0,0,0,0,0,0,0,0,"00",0,0,0,0,0,0,1038065,"2024-01-03T00:00:00.000Z",24,FALSE,13,272,"G",24,24,"Phoenix Suns","Damion Lee",0,0,0,0,0,0
0,0,0,0,0,0,0,0,0,"00",0,0,0,0,0,0,1038065,"2024-01-03T00:00:00.000Z",24,FALSE,13,3547298,"G",24,24,"Phoenix Suns","Saben Lee",0,0,0,0,0,0
0,0,0,0,0,0,0,0,0,"00",0,0,0,0,0,0,1038065,"2024-01-03T00:00:00.000Z",24,FALSE,13,666729,"F",24,24,"Phoenix Suns","Nassir Little",0,0,0,0,0,0
0,0,0,0,0,0,0,0,0,"00",0,0,0,0,0,0,1038065,"2024-01-03T00:00:00.000Z",24,FALSE,13,3547253,"G",4,24,"Phoenix Suns","Theo Maledon",0,0,0,0,0,0
3,2,6,6,4,16,9,8,8,"40",2,1,30,8,2,2,1038065,"2024-01-03T00:00:00.000Z",24,FALSE,13,274,"F",13,13,"LA Clippers","Kawhi Leonard",4,38,41,33,11,54.1
3,0,5,10,5,14,8,14,12,"37",2,3,33,7,2,1,1038065,"2024-01-03T00:00:00.000Z",24,FALSE,13,172,"F",13,13,"LA Clippers","Paul George",2,40,43,36,10,50.9
2,2,2,0,0,4,2,2,2,"27",1,5,6,3,0,0,1038065,"2024-01-03T00:00:00.000Z",24,FALSE,13,493,"C",13,13,"LA Clippers","Ivica Zubac",2,9,11,8,5,18.6
1,0,1,4,2,8,5,0,0,"23",2,1,12,3,2,0,1038065,"2024-01-03T00:00:00.000Z",24,FALSE,13,666743,"G",13,13,"LA Clippers","Terance Mann",2,15,16,13,4,23.1
11,1,5,7,4,13,7,4,4,"36",0,2,22,5,0,4,1038065,"2024-01-03T00:00:00.000Z",24,FALSE,13,192,"G",13,13,"LA Clippers","James Harden",1,27,38,33,16,43.5
4,0,5,4,3,11,6,1,1,"35",2,2,16,7,2,0,1038066,"2024-01-03T00:00:00.000Z",29,FALSE,9,38017739,"F",29,29,"Utah Jazz","Simone Fontecchio",2,23,27,20,11,36.4
0,1,5,8,4,18,10,8,7,"38",2,1,31,7,0,1,1038066,"2024-01-03T00:00:00.000Z",29,FALSE,9,297,"F",29,29,"Utah Jazz","Lauri Markkanen",1,38,38,31,7,41.4
3,0,0,6,2,13,7,2,1,"23",4,3,17,4,0,2,1038066,"2024-01-03T00:00:00.000Z",29,FALSE,9,101,"F-C",29,29,"Utah Jazz","John Collins",0,21,24,20,7,24.3
4,1,1,1,0,6,2,0,0,"16",0,0,4,1,3,0,1038066,"2024-01-03T00:00:00.000Z",29,FALSE,9,139,"G",29,29,"Utah Jazz","Kris Dunn",4,5,9,8,5,23.2
5,0,1,2,1,14,7,10,10,"30",1,5,25,2,1,0,1038066,"2024-01-03T00:00:00.000Z",29,FALSE,9,413,"G",29,29,"Utah Jazz","Collin Sexton",1,27,32,30,7,37.9
2,0,1,1,1,1,1,0,0,"13",0,2,3,1,2,1,1038066,"2024-01-03T00:00:00.000Z",29,FALSE,9,38017620,"G",29,29,"Utah Jazz","Ochai Agbaji",2,4,6,5,3,12.2
3,0,5,5,4,20,11,11,10,"38",1,1,36,6,1,5,1038066,"2024-01-03T00:00:00.000Z",29,FALSE,9,100,"G",29,29,"Utah Jazz","Jordan Clarkson",1,42,45,39,9,45.7
2,0,2,4,1,9,2,0,0,"23",0,1,5,2,1,1,1038066,"2024-01-03T00:00:00.000Z",29,FALSE,9,56677834,"G",29,29,"Utah Jazz","Keyonte George",1,7,9,7,4,12.4
0,0,0,0,0,0,0,0,0,"00",0,0,0,0,0,0,1038066,"2024-01-03T00:00:00.000Z",29,FALSE,9,56677824,"F",29,29,"Utah Jazz","Taylor Hendricks",0,0,0,0,0,0
0,0,0,0,0,0,0,0,0,"00",0,0,0,0,0,0,1038066,"2024-01-03T00:00:00.000Z",29,FALSE,9,666650,"G",29,29,"Utah Jazz","Talen Horton-Tucker",0,0,0,0,0,0
1,6,5,0,0,6,4,0,0,"29",3,4,8,8,0,0,1038066,"2024-01-03T00:00:00.000Z",29,FALSE,9,38017705,"C",29,29,"Utah Jazz","Walker Kessler",6,16,17,9,9,37.1
4,0,3,1,0,5,3,3,3,"20",2,3,9,5,1,2,1038066,"2024-01-03T00:00:00.000Z",29,FALSE,9,358,"F",29,29,"Utah Jazz","Kelly Olynyk",1,14,18,13,9,22
2,0,0,2,0,5,2,0,0,"13",1,1,4,1,0,0,1038066,"2024-01-03T00:00:00.000Z",29,FALSE,9,259,"F",9,9,"Detroit Pistons","Kevin Knox",0,5,7,6,3,8.2
0,0,0,0,0,0,0,0,0,"00",0,0,0,0,0,0,1038066,"2024-01-03T00:00:00.000Z",29,FALSE,9,56677792,"G",9,9,"Detroit Pistons","Marcus Sasser",0,0,0,0,0,0
1,1,1,1,0,4,1,2,0,"11",2,2,2,3,1,0,1038066,"2024-01-03T00:00:00.000Z",29,FALSE,9,56677826,"G-F",9,9,"Detroit Pistons","Ausar Thompson",2,5,6,3,4,13.1
0,0,4,0,0,7,4,0,0,"17",5,1,8,9,0,3,1038066,"2024-01-03T00:00:00.000Z",29,FALSE,9,3547240,"C",9,9,"Detroit Pistons","James Wiseman",0,17,17,8,9,15.8
0,0,0,0,0,0,0,0,0,"00",0,0,0,0,0,0,1038066,"2024-01-03T00:00:00.000Z",29,FALSE,9,56677729,"G",9,9,"Detroit Pistons","Malcolm Cazalon",0,0,0,0,0,0
0,0,0,0,0,0,0,0,0,"00",0,0,0,0,0,0,1038066,"2024-01-03T00:00:00.000Z",29,FALSE,9,330,"G",9,9,"Detroit Pistons","Monte Morris",0,0,0,0,0,0
0,0,0,0,0,0,0,0,0,"00",0,0,0,0,0,0,1038066,"2024-01-03T00:00:00.000Z",29,FALSE,9,56677842,"F",29,29,"Utah Jazz","Brice Sensabaugh",0,0,0,0,0,0
0,0,0,0,0,0,0,0,0,"00",0,0,0,0,0,0,1038066,"2024-01-03T00:00:00.000Z",29,FALSE,9,11891374,"C",29,29,"Utah Jazz","Omer Yurtseven",0,0,0,0,0,0
0,0,0,0,0,0,0,0,0,"00",0,0,0,0,0,0,1038066,"2024-01-03T00:00:00.000Z",29,FALSE,9,17896023,"G",29,29,"Utah Jazz","Josh Christopher",0,0,0,0,0,0
0,0,0,0,0,0,0,0,0,"00",0,0,0,0,0,0,1038066,"2024-01-03T00:00:00.000Z",29,FALSE,9,38017630,"G",29,29,"Utah Jazz","Johnny Juzang",0,0,0,0,0,0
0,0,0,0,0,0,0,0,0,"00",0,0,0,0,0,0,1038066,"2024-01-03T00:00:00.000Z",29,FALSE,9,19465584,"F",29,29,"Utah Jazz","Micah Potter",0,0,0,0,0,0
5,0,6,15,8,26,13,2,2,"43",1,6,36,7,1,1,1038066,"2024-01-03T00:00:00.000Z",29,FALSE,9,54,"F",9,9,"Detroit Pistons","Bojan Bogdanovic",1,43,48,41,12,53.9
1,0,1,4,1,7,4,1,1,"36",3,4,10,4,2,1,1038066,"2024-01-03T00:00:00.000Z",29,FALSE,9,17896071,"F",9,9,"Detroit Pistons","Isaiah Livers",2,14,15,11,5,21.3
4,1,6,0,0,7,6,5,5,"36",4,0,17,10,0,2,1038066,"2024-01-03T00:00:00.000Z",29,FALSE,9,38017694,"C",9,9,"Detroit Pistons","Jalen Duren",1,27,31,21,14,36
1,0,1,3,2,8,4,2,1,"22",0,2,11,1,0,2,1038066,"2024-01-03T00:00:00.000Z",29,FALSE,9,38017682,"G",9,9,"Detroit Pistons","Jaden Ivey",0,12,13,12,2,11.7
12,0,5,7,3,21,12,5,4,"40",0,5,31,5,1,6,1038066,"2024-01-03T00:00:00.000Z",29,FALSE,9,17896075,"G-F",9,9,"Detroit Pistons","Cade Cunningham",1,36,48,43,17,52
0,0,0,0,0,0,0,0,0,"00",0,0,0,0,0,0,1038066,"2024-01-03T00:00:00.000Z",29,FALSE,9,24,"F",9,9,"Detroit Pistons","Marvin Bagley III",0,0,0,0,0,0
1,0,4,9,5,17,9,5,4,"34",0,4,27,4,0,2,1038066,"2024-01-03T00:00:00.000Z",29,FALSE,9,77,"G",9,9,"Detroit Pistons","Alec Burks",0,31,32,28,5,31.3
0,0,0,0,0,0,0,0,0,"00",0,0,0,0,0,0,1038066,"2024-01-03T00:00:00.000Z",29,FALSE,9,197,"F-G",9,9,"Detroit Pistons","Joe Harris",0,0,0,0,0,0
6,1,4,0,0,3,1,0,0,"13",0,2,2,4,0,0,1038066,"2024-01-03T00:00:00.000Z",29,FALSE,9,3547241,"G",9,9,"Detroit Pistons","Killian Hayes",1,6,12,8,10,18.8
0,0,0,0,0,0,0,0,0,"00",0,0,0,0,0,0,1038066,"2024-01-03T00:00:00.000Z",29,FALSE,9,42097199,"G",9,9,"Detroit Pistons","Jared Rhoden",0,0,0,0,0,0
0,0,0,0,0,0,0,0,0,"00",0,0,0,0,0,0,1038066,"2024-01-03T00:00:00.000Z",29,FALSE,9,3547267,"F-C",9,9,"Detroit Pistons","Isaiah Stewart",0,0,0,0,0,0
0,0,0,0,0,0,0,0,0,"00",0,0,0,0,0,0,1038066,"2024-01-03T00:00:00.000Z",29,FALSE,9,44477024,"G",9,9,"Detroit Pistons","Stanley Umude",0,0,0,0,0,0
0,0,0,0,0,0,0,0,0,"00",0,0,0,0,0,0,1038066,"2024-01-03T00:00:00.000Z",29,FALSE,9,666881,"F",29,29,"Utah Jazz","Luka Samanic",0,0,0,0,0,0
1,0,0,1,0,1,0,0,0,"19",0,2,0,0,0,4,1038067,"2024-01-03T00:00:00.000Z",14,FALSE,16,666860,"F-G",14,14,"Los Angeles Lakers","Cameron Reddish",0,0,1,1,1,-2.5
9,0,6,6,0,18,6,0,0,"38",0,2,12,6,0,2,1038067,"2024-01-03T00:00:00.000Z",14,FALSE,16,237,"F",14,14,"Los Angeles Lakers","LeBron James",0,18,27,21,15,30.7
6,5,14,1,0,17,10,10,9,"43",3,2,29,17,3,5,1038067,"2024-01-03T00:00:00.000Z",14,FALSE,16,117,"F-C",14,14,"Los Angeles Lakers","Anthony Davis",8,46,52,35,23,77.4
2,0,5,5,0,6,0,0,0,"29",0,2,0,5,0,1,1038067,"2024-01-03T00:00:00.000Z",14,FALSE,16,383,"F",14,14,"Los Angeles Lakers","Taurean Prince",0,5,7,2,7,8
8,0,5,6,2,12,7,9,8,"37",0,2,24,5,0,3,1038067,"2024-01-03T00:00:00.000Z",14,FALSE,16,17553995,"G",14,14,"Los Angeles Lakers","Austin Reaves",0,29,37,32,13,39
0,0,4,9,2,12,5,2,2,"28",1,2,14,5,0,2,1038067,"2024-01-03T00:00:00.000Z",14,FALSE,16,38017697,"G",14,14,"Los Angeles Lakers","Max Christie",0,19,19,14,5,18
0,0,0,0,0,0,0,0,0,"00",0,0,0,0,0,0,1038067,"2024-01-03T00:00:00.000Z",14,FALSE,16,666609,"F",14,14,"Los Angeles Lakers","Rui Hachimura",0,0,0,0,0,0
0,0,0,1,0,1,0,0,0,"01",0,0,0,0,0,0,1038067,"2024-01-03T00:00:00.000Z",14,FALSE,16,38017736,"F",16,16,"Miami Heat","Cole Swider",0,0,0,0,0,0
0,0,0,0,0,0,0,0,0,"00",0,0,0,0,0,0,1038067,"2024-01-03T00:00:00.000Z",14,FALSE,16,79,"G-F",16,16,"Miami Heat","Jimmy Butler",0,0,0,0,0,0
0,0,0,0,0,0,0,0,0,"00",0,0,0,0,0,0,1038067,"2024-01-03T00:00:00.000Z",14,FALSE,16,3092,"",16,16,"Miami Heat","Haywood Highsmith",0,0,0,0,0,0
0,0,0,0,0,0,0,0,0,"00",0,0,0,0,0,0,1038067,"2024-01-03T00:00:00.000Z",14,FALSE,16,666747,"F",16,16,"Miami Heat","Caleb Martin",0,0,0,0,0,0
0,0,0,0,0,0,0,0,0,"00",0,0,0,0,0,0,1038067,"2024-01-03T00:00:00.000Z",14,FALSE,16,19465585,"G",16,16,"Miami Heat","Dru Smith",0,0,0,0,0,0
0,0,0,0,0,0,0,0,0,"01",0,0,0,0,0,0,1038067,"2024-01-03T00:00:00.000Z",14,FALSE,16,666626,"C",14,14,"Los Angeles Lakers","Jaxson Hayes",0,0,0,0,0,0
0,0,1,0,0,4,0,0,0,"06",1,1,0,2,0,0,1038067,"2024-01-03T00:00:00.000Z",14,FALSE,16,56677835,"G",14,14,"Los Angeles Lakers","Jalen Hood-Schifino",0,2,2,0,2,2.4
0,0,0,0,0,0,0,0,0,"00",0,0,0,0,0,0,1038067,"2024-01-03T00:00:00.000Z",14,FALSE,16,405,"G",14,14,"Los Angeles Lakers","D'Angelo Russell",0,0,0,0,0,0
0,0,2,0,0,3,2,0,0,"15",0,0,4,2,0,2,1038067,"2024-01-03T00:00:00.000Z",14,FALSE,16,457,"F",14,14,"Los Angeles Lakers","Jarred Vanderbilt",0,6,6,4,2,4.4
3,1,4,2,0,10,5,3,3,"24",4,1,13,8,0,2,1038067,"2024-01-03T00:00:00.000Z",14,FALSE,16,486,"F",14,14,"Los Angeles Lakers","Christian Wood",1,21,24,16,11,28.1
0,0,0,0,0,0,0,0,0,"00",0,0,0,0,0,0,1038067,"2024-01-03T00:00:00.000Z",14,FALSE,16,56677738,"C",14,14,"Los Angeles Lakers","Colin Castleton",0,0,0,0,0,0
0,0,0,0,0,0,0,0,0,"00",0,0,0,0,0,0,1038067,"2024-01-03T00:00:00.000Z",14,FALSE,16,56677867,"F",14,14,"Los Angeles Lakers","Alex Fudge",0,0,0,0,0,0
0,0,0,0,0,0,0,0,0,"00",0,0,0,0,0,0,1038067,"2024-01-03T00:00:00.000Z",14,FALSE,16,56677868,"G",14,14,"Los Angeles Lakers","D'Moi Hodge",0,0,0,0,0,0
0,0,0,0,0,0,0,0,0,"00",0,0,0,0,0,0,1038067,"2024-01-03T00:00:00.000Z",14,FALSE,16,56677836,"F",14,14,"Los Angeles Lakers","Maxwell Lewis",0,0,0,0,0,0
0,0,0,0,0,0,0,0,0,"00",0,0,0,0,0,0,1038067,"2024-01-03T00:00:00.000Z",14,FALSE,16,1603383,"G",14,14,"Los Angeles Lakers","Gabe Vincent",0,0,0,0,0,0
1,0,7,5,3,11,6,0,0,"28",1,4,15,8,1,0,1038067,"2024-01-03T00:00:00.000Z",14,FALSE,16,38017696,"F",16,16,"Miami Heat","Nikola Jovic",1,23,24,16,9,29.1
8,1,0,6,2,14,7,0,0,"39",0,1,16,0,1,2,1038067,"2024-01-03T00:00:00.000Z",14,FALSE,16,56677785,"G",16,16,"Miami Heat","Jaime Jaquez Jr.",2,16,24,24,8,32
5,0,4,1,0,14,5,6,5,"38",3,4,15,7,3,2,1038067,"2024-01-03T00:00:00.000Z",14,FALSE,16,4,"C-F",16,16,"Miami Heat","Bam Adebayo",3,22,27,20,12,37.9
0,0,0,0,0,0,0,0,0,"01",0,0,0,0,0,0,1038067,"2024-01-03T00:00:00.000Z",14,FALSE,16,3547257,"G",16,16,"Miami Heat","R.J. Hampton",0,0,0,0,0,0
0,0,0,0,0,0,0,0,0,"01",0,0,0,0,0,0,1038067,"2024-01-03T00:00:00.000Z",14,FALSE,16,39398582,"C",16,16,"Miami Heat","Orlando Robinson",0,0,0,0,0,0
3,1,11,1,0,7,4,6,2,"28",3,3,10,14,1,0,1038067,"2024-01-03T00:00:00.000Z",14,FALSE,16,285,"F-C",16,16,"Miami Heat","Kevin Love",2,24,27,13,17,37.3
2,0,0,12,3,14,5,0,0,"30",0,3,13,0,1,1,1038067,"2024-01-03T00:00:00.000Z",14,FALSE,16,397,"F",16,16,"Miami Heat","Duncan Robinson",1,13,15,15,2,18
1,1,1,3,2,7,4,0,0,"20",0,3,10,1,0,0,1038067,"2024-01-03T00:00:00.000Z",14,FALSE,16,391,"G-F",16,16,"Miami Heat","Josh Richardson",1,11,12,11,2,15.7
0,0,0,0,0,0,0,0,0,"00",0,0,0,0,0,0,1038067,"2024-01-03T00:00:00.000Z",14,FALSE,16,74,"C",16,16,"Miami Heat","Thomas Bryant",0,0,0,0,0,0
0,0,0,0,0,0,0,0,0,"01",0,0,0,0,0,0,1038067,"2024-01-03T00:00:00.000Z",14,FALSE,16,38017734,"F",16,16,"Miami Heat","Jamal Cain",0,0,0,0,0,0
4,0,6,8,4,19,7,3,3,"27",0,3,21,6,3,2,1038067,"2024-01-03T00:00:00.000Z",14,FALSE,16,666633,"G",16,16,"Miami Heat","Tyler Herro",3,27,31,25,10,41.2
6,0,3,5,2,6,3,2,2,"26",0,2,10,3,4,1,1038067,"2024-01-03T00:00:00.000Z",14,FALSE,16,286,"G",16,16,"Miami Heat","Kyle Lowry",4,13,19,16,9,33.6
1,0,2,6,4,9,5,5,3,"36",1,4,17,3,1,0,1038068,"2024-01-03T00:00:00.000Z",26,FALSE,22,30,"F",26,26,"Sacramento Kings","Harrison Barnes",1,20,21,18,4,25.1
1,0,8,6,2,21,13,0,0,"46",4,0,28,12,1,0,1038068,"2024-01-03T00:00:00.000Z",26,FALSE,22,38017688,"F",26,26,"Sacramento Kings","Keegan Murray",1,40,41,29,13,46.9
12,1,17,0,0,14,8,9,6,"45",6,2,22,23,2,6,1038068,"2024-01-03T00:00:00.000Z",26,FALSE,22,406,"F",26,26,"Sacramento Kings","Domantas Sabonis",3,45,57,34,35,70.6
1,0,0,1,0,3,0,0,0,"10",0,3,0,0,1,2,1038068,"2024-01-03T00:00:00.000Z",26,FALSE,22,17896030,"G",26,26,"Sacramento Kings","Chris Duarte",1,0,1,1,1,2.5
7,0,1,5,0,22,6,4,3,"44",3,1,15,4,1,3,1038068,"2024-01-03T00:00:00.000Z",26,FALSE,22,161,"G",26,26,"Sacramento Kings","De'Aaron Fox",1,19,26,22,11,30.3
0,0,0,0,0,0,0,0,0,"00",0,0,0,0,0,0,1038068,"2024-01-03T00:00:00.000Z",26,FALSE,22,17896044,"F",26,26,"Sacramento Kings","Kessler Edwards",0,0,0,0,0,0
0,0,0,0,0,0,0,0,0,"00",0,0,0,0,0,0,1038068,"2024-01-03T00:00:00.000Z",26,FALSE,22,38017714,"G",26,26,"Sacramento Kings","Keon Ellis",0,0,0,0,0,0
2,0,6,4,0,5,0,2,2,"18",1,1,2,7,0,1,1038068,"2024-01-03T00:00:00.000Z",26,FALSE,22,221,"G",26,26,"Sacramento Kings","Kevin Huerter",0,9,11,4,9,12.4
9,1,3,13,7,20,12,8,6,"46",0,5,37,3,2,3,1038068,"2024-01-03T00:00:00.000Z",26,FALSE,22,324,"G",26,26,"Sacramento Kings","Malik Monk",3,40,49,46,12,60.1
0,0,0,0,0,0,0,0,0,"01",0,0,0,0,0,0,1038068,"2024-01-03T00:00:00.000Z",26,FALSE,22,666925,"F",29,26,"Sacramento Kings","Juan Toscano-Anderson",0,0,0,0,0,0
0,0,0,0,0,0,0,0,0,"00",0,0,0,0,0,0,1038068,"2024-01-03T00:00:00.000Z",26,FALSE,22,4197162,"F",26,26,"Sacramento Kings","Aleksandar Vezenkov",0,0,0,0,0,0
0,0,0,0,0,0,0,0,0,"00",0,0,0,0,0,0,1038068,"2024-01-03T00:00:00.000Z",26,FALSE,22,17895990,"G",26,26,"Sacramento Kings","Jordan Ford",0,0,0,0,0,0
0,0,0,0,0,0,0,0,0,"00",0,0,0,0,0,0,1038068,"2024-01-03T00:00:00.000Z",26,FALSE,22,56677845,"G",26,26,"Sacramento Kings","Colby Jones",0,0,0,0,0,0
0,0,0,0,0,0,0,0,0,"00",0,0,0,0,0,0,1038068,"2024-01-03T00:00:00.000Z",26,FALSE,22,56677862,"F",26,26,"Sacramento Kings","Jalen Slawson",0,0,0,0,0,0
1,0,2,1,1,4,2,1,1,"05",0,0,6,2,0,0,1038068,"2024-01-03T00:00:00.000Z",26,FALSE,22,17896026,"F",22,22,"Orlando Magic","Franz Wagner",0,8,9,7,3,9.9
5,0,3,9,6,25,13,14,11,"45",1,4,43,4,0,8,1038068,"2024-01-03T00:00:00.000Z",26,FALSE,22,38017683,"F",22,22,"Orlando Magic","Paolo Banchero",0,47,52,48,9,47.3
2,3,5,1,0,5,2,2,2,"28",1,3,6,6,1,1,1038068,"2024-01-03T00:00:00.000Z",26,FALSE,22,666442,"C",22,22,"Orlando Magic","Goga Bitadze",4,12,14,8,8,27.2
1,0,1,3,1,4,2,1,0,"12",0,2,5,1,1,1,1038068,"2024-01-03T00:00:00.000Z",26,FALSE,22,196,"G",22,22,"Orlando Magic","Gary Harris",1,6,7,6,2,9.7
0,0,0,0,0,0,0,0,0,"00",0,0,0,0,0,0,1038068,"2024-01-03T00:00:00.000Z",26,FALSE,22,273,"C",26,26,"Sacramento Kings","Alex Len",0,0,0,0,0,0
0,1,0,3,2,6,4,0,0,"22",3,3,10,3,0,0,1038068,"2024-01-03T00:00:00.000Z",26,FALSE,22,290,"F",26,26,"Sacramento Kings","Trey Lyles",1,13,13,10,3,16.6
0,0,2,0,0,2,2,3,1,"08",0,2,5,2,1,0,1038068,"2024-01-03T00:00:00.000Z",26,FALSE,22,306,"C",26,26,"Sacramento Kings","JaVale McGee",1,7,7,5,2,10.4
3,0,1,2,0,3,1,0,0,"14",0,0,2,1,0,2,1038068,"2024-01-03T00:00:00.000Z",26,FALSE,22,17553994,"G",26,26,"Sacramento Kings","Davion Mitchell",0,3,6,5,4,5.7
4,2,2,12,6,18,8,2,2,"39",1,4,24,3,2,4,1038068,"2024-01-03T00:00:00.000Z",26,FALSE,22,17896073,"G",22,22,"Orlando Magic","Jalen Suggs",4,27,31,28,7,41.6
6,1,2,3,0,7,2,2,1,"38",0,5,5,2,2,0,1038068,"2024-01-03T00:00:00.000Z",26,FALSE,22,17553983,"G",22,22,"Orlando Magic","Trevelin Queen",3,7,13,11,8,25.4
4,0,1,1,1,7,4,0,0,"25",1,1,9,2,0,1,1038068,"2024-01-03T00:00:00.000Z",26,FALSE,22,56677827,"G",22,22,"Orlando Magic","Anthony Black",0,11,15,13,6,16.4
1,0,2,6,4,6,4,3,3,"31",0,2,15,2,4,1,1038068,"2024-01-03T00:00:00.000Z",26,FALSE,22,38017724,"G",22,22,"Orlando Magic","Caleb Houstan",4,17,18,16,3,29.9
3,0,6,3,3,7,3,0,0,"21",1,4,9,7,0,1,1038068,"2024-01-03T00:00:00.000Z",26,FALSE,22,85,"F",22,22,"Orlando Magic","Wendell Carter Jr.",0,16,19,12,10,20.9
3,1,6,4,3,5,4,0,0,"27",1,2,11,7,0,0,1038068,"2024-01-03T00:00:00.000Z",26,FALSE,22,666818,"F",22,22,"Orlando Magic","Chuma Okeke",1,18,21,14,10,26.9
1,0,0,0,0,0,0,0,0,"06",0,1,0,0,0,0,1038068,"2024-01-03T00:00:00.000Z",26,FALSE,22,666885,"F",22,22,"Orlando Magic","Admiral Schofield",0,0,1,1,1,1.5
2,0,2,1,0,2,0,2,2,"13",1,2,2,3,0,3,1038068,"2024-01-03T00:00:00.000Z",26,FALSE,22,462,"C",22,22,"Orlando Magic","Moritz Wagner",0,5,7,4,5,5.6
0,0,0,0,0,0,0,0,0,"00",0,0,0,0,0,0,1038068,"2024-01-03T00:00:00.000Z",26,FALSE,22,3547251,"G",22,22,"Orlando Magic","Cole Anthony",0,0,0,0,0,0
0,0,0,0,0,0,0,0,0,"00",0,0,0,0,0,0,1038068,"2024-01-03T00:00:00.000Z",26,FALSE,22,165,"G",22,22,"Orlando Magic","Markelle Fultz",0,0,0,0,0,0
0,0,0,0,0,0,0,0,0,"00",0,0,0,0,0,0,1038068,"2024-01-03T00:00:00.000Z",26,FALSE,22,38017607,"G",22,22,"Orlando Magic","Kevon Harris",0,0,0,0,0,0
0,0,0,0,0,0,0,0,0,"00",0,0,0,0,0,0,1038068,"2024-01-03T00:00:00.000Z",26,FALSE,22,56677839,"G",22,22,"Orlando Magic","Jett Howard",0,0,0,0,0,0
0,0,0,0,0,0,0,0,0,"00",0,0,0,0,0,0,1038068,"2024-01-03T00:00:00.000Z",26,FALSE,22,226,"F",22,22,"Orlando Magic","Joe Ingles",0,0,0,0,0,0
0,0,0,0,0,0,0,0,0,"00",0,0,0,0,0,0,1038068,"2024-01-03T00:00:00.000Z",26,FALSE,22,229,"F",22,22,"Orlando Magic","Jonathan Isaac",0,0,0,0,0,0
2,0,6,4,1,9,5,0,0,"34",2,2,11,8,2,1,1038060,"2024-01-03T00:00:00.000Z",20,FALSE,5,18,"F",28,20,"New York Knicks","OG Anunoby",2,19,21,13,10,28.6
4,1,6,7,3,23,13,7,6,"39",0,3,35,6,2,3,1038060,"2024-01-03T00:00:00.000Z",20,FALSE,5,387,"F",20,20,"New York Knicks","Julius Randle",3,41,45,39,10,54.2
1,5,13,0,0,6,4,3,2,"37",7,2,10,20,0,2,1038060,"2024-01-03T00:00:00.000Z",20,FALSE,5,201,"F-C",20,20,"New York Knicks","Isaiah Hartenstein",5,30,31,11,21,48.5
13,0,3,9,4,22,13,1,1,"38",0,3,31,3,0,4,1038060,"2024-01-03T00:00:00.000Z",20,FALSE,5,73,"G",20,20,"New York Knicks","Jalen Brunson",0,34,47,44,16,50.1
5,0,4,8,3,10,4,0,0,"25",1,2,11,5,1,3,1038060,"2024-01-03T00:00:00.000Z",20,FALSE,5,131,"G",20,20,"New York Knicks","Donte DiVincenzo",1,16,21,16,10,24.5
1,1,1,0,0,2,2,0,0,"12",2,2,4,3,0,0,1038060,"2024-01-03T00:00:00.000Z",20,FALSE,5,3547249,"F",28,20,"New York Knicks","Precious Achiuwa",1,7,8,5,4,12.1
0,0,0,0,0,0,0,0,0,"01",0,0,0,0,0,0,1038060,"2024-01-03T00:00:00.000Z",20,FALSE,5,19,"G",20,20,"New York Knicks","Ryan Arcidiacono",0,0,0,0,0,0
0,0,0,0,0,0,0,0,0,"00",0,0,0,0,0,0,1038060,"2024-01-03T00:00:00.000Z",20,FALSE,5,160,"G-F",20,20,"New York Knicks","Evan Fournier",0,0,0,0,0,0
0,0,0,0,0,0,0,0,0,"00",0,0,0,0,0,0,1038060,"2024-01-03T00:00:00.000Z",20,FALSE,5,173,"F",30,20,"New York Knicks","Taj Gibson",0,0,0,0,0,0
0,0,1,6,2,9,3,0,0,"18",0,0,8,1,1,0,1038060,"2024-01-03T00:00:00.000Z",20,FALSE,5,17895858,"G",20,20,"New York Knicks","Quentin Grimes",1,9,9,8,1,12.2
3,0,4,2,1,5,1,0,0,"25",1,2,3,5,0,2,1038060,"2024-01-03T00:00:00.000Z",20,FALSE,5,202,"G",20,20,"New York Knicks","Josh Hart",0,8,11,6,8,11.5
0,0,0,2,1,3,1,0,0,"10",0,1,3,0,0,0,1038060,"2024-01-03T00:00:00.000Z",20,FALSE,5,17896033,"G",20,20,"New York Knicks","Miles McBride",0,3,3,3,0,3
0,0,1,0,0,0,0,0,0,"01",0,0,0,1,0,0,1038060,"2024-01-03T00:00:00.000Z",20,FALSE,5,17896063,"F",20,20,"New York Knicks","Jericho Sims",0,1,1,0,1,1.2
0,0,0,0,0,0,0,0,0,"00",0,0,0,0,0,0,1038060,"2024-01-03T00:00:00.000Z",20,FALSE,5,666474,"G",20,20,"New York Knicks","Charles Brown",0,0,0,0,0,0
0,0,0,0,0,0,0,0,0,"00",0,0,0,0,0,0,1038060,"2024-01-03T00:00:00.000Z",20,FALSE,5,3547275,"G",28,20,"New York Knicks","Malachi Flynn",0,0,0,0,0,0
0,0,0,0,0,0,0,0,0,"00",0,0,0,0,0,0,1038060,"2024-01-03T00:00:00.000Z",20,FALSE,5,399,"C",20,20,"New York Knicks","Mitchell Robinson",0,0,0,0,0,0
0,0,0,0,0,0,0,0,0,"00",0,0,0,0,0,0,1038060,"2024-01-03T00:00:00.000Z",20,FALSE,5,56677795,"F",20,20,"New York Knicks","Jacob Toppin",0,0,0,0,0,0
4,1,3,4,3,13,10,5,5,"38",0,1,28,3,1,0,1038060,"2024-01-03T00:00:00.000Z",20,FALSE,5,125,"G",5,5,"Chicago Bulls","DeMar DeRozan",2,31,35,32,7,43.6
2,0,3,2,1,8,2,0,0,"27",1,3,5,4,1,5,1038060,"2024-01-03T00:00:00.000Z",20,FALSE,5,3547248,"F",5,5,"Chicago Bulls","Patrick Williams",1,9,11,7,6,10.8
0,1,8,0,0,12,5,6,3,"30",8,3,13,16,2,1,1038060,"2024-01-03T00:00:00.000Z",20,FALSE,5,137,"C",5,5,"Chicago Bulls","Andre Drummond",3,29,29,13,16,40.2
3,1,4,8,2,13,5,1,1,"33",0,4,13,4,4,1,1038060,"2024-01-03T00:00:00.000Z",20,FALSE,5,89,"G",5,5,"Chicago Bulls","Alex Caruso",5,17,20,16,7,36.3
8,1,4,9,6,19,9,2,2,"38",0,1,26,4,0,3,1038060,"2024-01-03T00:00:00.000Z",20,FALSE,5,666956,"G",5,5,"Chicago Bulls","Coby White",1,30,38,34,12,42.8
4,2,4,6,1,12,2,2,2,"31",0,1,7,4,0,0,1038060,"2024-01-03T00:00:00.000Z",20,FALSE,5,17895983,"G",5,5,"Chicago Bulls","Ayo Dosunmu",2,11,15,11,8,23.8
2,1,0,3,0,6,1,0,0,"16",0,2,2,0,1,1,1038060,"2024-01-03T00:00:00.000Z",20,FALSE,5,87,"G",5,5,"Chicago Bulls","Jevon Carter",2,2,4,4,2,10
0,0,0,0,0,0,0,0,0,"00",0,0,0,0,0,0,1038060,"2024-01-03T00:00:00.000Z",20,FALSE,5,110,"F",5,5,"Chicago Bulls","Torrey Craig",0,0,0,0,0,0
0,0,0,0,0,1,0,0,0,"02",1,0,0,1,0,0,1038060,"2024-01-03T00:00:00.000Z",20,FALSE,5,56677857,"F",5,5,"Chicago Bulls","Julian Phillips",0,1,1,0,1,1.2
0,0,0,0,0,0,0,0,0,"01",0,0,0,0,0,0,1038060,"2024-01-03T00:00:00.000Z",20,FALSE,5,56677860,"F",5,5,"Chicago Bulls","Adama Sanogo",0,0,0,0,0,0
0,0,1,0,0,3,2,0,0,"16",1,0,4,2,0,0,1038060,"2024-01-03T00:00:00.000Z",20,FALSE,5,17896116,"G",5,5,"Chicago Bulls","Terry Taylor",0,6,6,4,2,6.4
1,0,1,0,0,2,1,0,0,"08",0,2,2,1,0,0,1038060,"2024-01-03T00:00:00.000Z",20,FALSE,5,38017719,"F",5,5,"Chicago Bulls","Dalen Terry",0,3,4,3,2,4.7
0,0,0,0,0,0,0,0,0,"00",0,0,0,0,0,0,1038060,"2024-01-03T00:00:00.000Z",20,FALSE,5,27,"G",5,5,"Chicago Bulls","Lonzo Ball",0,0,0,0,0,0
0,0,0,0,0,0,0,0,0,"00",0,0,0,0,0,0,1038060,"2024-01-03T00:00:00.000Z",20,FALSE,5,56677874,"F",5,5,"Chicago Bulls","Onuralp Bitim",0,0,0,0,0,0
0,0,0,0,0,0,0,0,0,"00",0,0,0,0,0,0,1038060,"2024-01-03T00:00:00.000Z",20,FALSE,5,NA,NA,NA,5,"Chicago Bulls","NA NA",0,0,0,0,0,0
0,0,0,0,0,0,0,0,0,"00",0,0,0,0,0,0,1038060,"2024-01-03T00:00:00.000Z",20,FALSE,5,268,"G",5,5,"Chicago Bulls","Zach LaVine",0,0,0,0,0,0
0,0,0,0,0,0,0,0,0,"00",0,0,0,0,0,0,1038060,"2024-01-03T00:00:00.000Z",20,FALSE,5,460,"C",5,5,"Chicago Bulls","Nikola Vucevic",0,0,0,0,0,0
2,1,6,8,2,12,3,2,2,"36",2,2,10,8,0,0,1038059,"2024-01-03T00:00:00.000Z",1,FALSE,21,3547256,"F",1,1,"Atlanta Hawks","Saddiq Bey",1,18,20,12,10,25.6
3,0,6,4,2,18,11,4,4,"29",1,5,28,7,4,1,1038059,"2024-01-03T00:00:00.000Z",1,FALSE,21,17896040,"F",1,1,"Atlanta Hawks","Jalen Johnson",4,35,38,31,10,51.9
0,3,7,0,0,8,5,2,2,"25",7,2,12,14,0,0,1038059,"2024-01-03T00:00:00.000Z",1,FALSE,21,83,"C",1,1,"Atlanta Hawks","Clint Capela",3,26,26,12,14,37.8
6,0,4,5,2,18,8,4,4,"35",2,2,22,6,0,3,1038059,"2024-01-03T00:00:00.000Z",1,FALSE,21,334,"G",1,1,"Atlanta Hawks","Dejounte Murray",0,28,34,28,12,35.2
11,0,4,9,2,13,6,11,10,"34",0,2,24,4,2,6,1038059,"2024-01-03T00:00:00.000Z",1,FALSE,21,490,"G",1,1,"Atlanta Hawks","Trae Young",2,28,39,35,15,45.3
4,0,1,11,5,16,7,4,4,"28",0,2,23,1,1,0,1038059,"2024-01-03T00:00:00.000Z",1,FALSE,21,53,"G",1,1,"Atlanta Hawks","Bogdan Bogdanovic",1,24,28,27,5,33.2
0,0,0,0,0,0,0,0,0,"00",0,0,0,0,0,0,1038059,"2024-01-03T00:00:00.000Z",1,FALSE,21,666564,"F",1,1,"Atlanta Hawks","Bruno Fernando",0,0,0,0,0,0
2,1,2,0,0,3,3,0,0,"14",0,3,6,2,0,0,1038059,"2024-01-03T00:00:00.000Z",1,FALSE,21,3547297,"G",1,1,"Atlanta Hawks","Trent Forrest",1,8,10,8,4,14.4
0,0,0,0,0,0,0,0,0,"00",0,0,0,0,0,0,1038059,"2024-01-03T00:00:00.000Z",1,FALSE,21,38017689,"F",1,1,"Atlanta Hawks","AJ Griffin",0,0,0,0,0,0
0,0,0,0,0,0,0,0,0,"00",0,0,0,0,0,0,1038059,"2024-01-03T00:00:00.000Z",1,FALSE,21,56677855,"G",1,1,"Atlanta Hawks","Seth Lundy",0,0,0,0,0,0
2,0,0,2,1,3,2,1,0,"17",0,1,5,0,0,1,1038059,"2024-01-03T00:00:00.000Z",1,FALSE,21,666754,"G",1,1,"Atlanta Hawks","Garrison Mathews",0,5,7,7,2,7
0,0,0,0,0,0,0,0,0,"00",0,0,0,0,0,0,1038059,"2024-01-03T00:00:00.000Z",1,FALSE,21,301,"G-F",1,1,"Atlanta Hawks","Wesley Matthews",0,0,0,0,0,0
0,0,0,0,0,0,0,0,0,"00",0,0,0,0,0,0,1038059,"2024-01-03T00:00:00.000Z",1,FALSE,21,319,"G",1,1,"Atlanta Hawks","Patty Mills",0,0,0,0,0,0
0,0,4,0,0,4,3,5,5,"22",3,2,11,7,1,0,1038059,"2024-01-03T00:00:00.000Z",1,FALSE,21,3547244,"F-C",1,1,"Atlanta Hawks","Onyeka Okongwu",1,18,18,11,7,22.4
0,0,0,0,0,0,0,0,0,"00",0,0,0,0,0,0,1038059,"2024-01-03T00:00:00.000Z",1,FALSE,21,56677838,"G",1,1,"Atlanta Hawks","Kobe Bufkin",0,0,0,0,0,0
0,0,0,0,0,0,0,0,0,"00",0,0,0,0,0,0,1038059,"2024-01-03T00:00:00.000Z",1,FALSE,21,56677806,"F",1,1,"Atlanta Hawks","Mouhamed Gueye",0,0,0,0,0,0
0,0,0,0,0,0,0,0,0,"00",0,0,0,0,0,0,1038059,"2024-01-03T00:00:00.000Z",1,FALSE,21,666656,"F",1,1,"Atlanta Hawks","De'Andre Hunter",0,0,0,0,0,0
0,0,0,0,0,0,0,0,0,"00",0,0,0,0,0,0,1038059,"2024-01-03T00:00:00.000Z",1,FALSE,21,4197387,"G",1,1,"Atlanta Hawks","Vit Krejci",0,0,0,0,0,0
3,0,1,3,2,7,3,6,6,"29",3,4,14,4,0,0,1038059,"2024-01-03T00:00:00.000Z",1,FALSE,21,666541,"G",21,21,"Oklahoma City Thunder","Luguentz Dort",0,18,21,17,7,23.3
6,0,2,1,1,12,9,5,2,"35",1,4,21,3,4,2,1038059,"2024-01-03T00:00:00.000Z",1,FALSE,21,38017703,"G-F",21,21,"Oklahoma City Thunder","Jalen Williams",4,24,30,27,9,43.6
1,0,3,5,2,9,5,0,0,"25",0,1,12,3,0,4,1038059,"2024-01-03T00:00:00.000Z",1,FALSE,21,38017685,"C-F",21,21,"Oklahoma City Thunder","Chet Holmgren",0,15,16,13,4,13.1
4,0,1,3,2,7,3,2,1,"22",2,1,9,3,1,2,1038059,"2024-01-03T00:00:00.000Z",1,FALSE,21,17896065,"G",21,21,"Oklahoma City Thunder","Josh Giddey",1,12,16,13,7,19.6
8,0,12,3,2,24,11,11,9,"35",1,2,33,13,0,2,1038059,"2024-01-03T00:00:00.000Z",1,FALSE,21,175,"G",21,21,"Oklahoma City Thunder","Shai Gilgeous-Alexander",0,46,54,41,21,58.6
1,0,0,5,1,8,4,0,0,"18",1,2,9,1,1,2,1038059,"2024-01-03T00:00:00.000Z",1,FALSE,21,3547272,"G",21,21,"Oklahoma City Thunder","Isaiah Joe",1,10,11,10,2,12.7
2,0,1,7,3,9,5,2,2,"20",0,2,15,1,1,0,1038059,"2024-01-03T00:00:00.000Z",1,FALSE,21,56677833,"G",21,21,"Oklahoma City Thunder","Cason Wallace",1,16,18,17,3,22.2
1,0,3,6,3,6,3,0,0,"20",0,2,9,3,0,1,1038059,"2024-01-03T00:00:00.000Z",1,FALSE,21,27924547,"F",21,21,"Oklahoma City Thunder","Lindy Waters III",0,12,13,10,4,13.1
2,0,3,2,1,2,1,0,0,"15",0,4,3,3,2,0,1038059,"2024-01-03T00:00:00.000Z",1,FALSE,21,38017706,"F",21,21,"Oklahoma City Thunder","Jaylin Williams",2,6,8,5,5,15.6
2,1,2,1,1,7,6,0,0,"21",1,1,13,3,1,0,1038059,"2024-01-03T00:00:00.000Z",1,FALSE,21,17896078,"G",21,21,"Oklahoma City Thunder","Aaron Wiggins",2,16,18,15,5,25.6
0,0,0,0,0,0,0,0,0,"00",0,0,0,0,0,0,1038059,"2024-01-03T00:00:00.000Z",1,FALSE,21,44,"F",21,21,"Oklahoma City Thunder","Davis Bertans",0,0,0,0,0,0
0,0,0,0,0,0,0,0,0,"00",0,0,0,0,0,0,1038059,"2024-01-03T00:00:00.000Z",1,FALSE,21,17896036,"G",21,21,"Oklahoma City Thunder","Tre Mann",0,0,0,0,0,0
0,0,0,0,0,0,0,0,0,"00",0,0,0,0,0,0,1038059,"2024-01-03T00:00:00.000Z",1,FALSE,21,4197029,"G",21,21,"Oklahoma City Thunder","Vasilije Micic",0,0,0,0,0,0
0,0,0,0,0,0,0,0,0,"00",0,0,0,0,0,0,1038059,"2024-01-03T00:00:00.000Z",1,FALSE,21,24572055,"C",21,21,"Oklahoma City Thunder","Olivier Sarr",0,0,0,0,0,0
0,0,0,0,0,0,0,0,0,"00",0,0,0,0,0,0,1038059,"2024-01-03T00:00:00.000Z",1,FALSE,21,480,"G-F",21,21,"Oklahoma City Thunder","Kenrich Williams",0,0,0,0,0,0
0,0,0,0,0,0,0,0,0,"00",0,0,0,0,0,0,1038059,"2024-01-03T00:00:00.000Z",1,FALSE,21,38017716,"F",21,21,"Oklahoma City Thunder","Ousmane Dieng",0,0,0,0,0,0
0,0,0,0,0,0,0,0,0,"00",0,0,0,0,0,0,1038059,"2024-01-03T00:00:00.000Z",1,FALSE,21,56677853,"F",21,21,"Oklahoma City Thunder","Keyontae Johnson",0,0,0,0,0,0
0,0,0,0,0,0,0,0,0,"00",0,0,0,0,0,0,1038059,"2024-01-03T00:00:00.000Z",1,FALSE,21,3547271,"C",21,21,"Oklahoma City Thunder","Aleksej Pokusevski",0,0,0,0,0,0
2,0,4,1,1,4,4,0,0,"22",0,2,9,4,3,0,1038058,"2024-01-03T00:00:00.000Z",12,FALSE,17,3547250,"G-F",12,12,"Indiana Pacers","Aaron Nesmith",3,13,15,11,6,25.8
3,0,5,4,1,8,5,2,2,"19",2,2,13,7,0,1,1038058,"2024-01-03T00:00:00.000Z",12,FALSE,17,3547264,"F-C",12,12,"Indiana Pacers","Jalen Smith",0,20,23,16,10,24.9
2,2,7,4,1,9,6,4,2,"30",0,4,15,7,0,2,1038058,"2024-01-03T00:00:00.000Z",12,FALSE,17,452,"C-F",12,12,"Indiana Pacers","Myles Turner",2,22,24,17,9,30.4
2,0,5,1,0,7,5,6,5,"28",0,6,15,5,0,4,1038058,"2024-01-03T00:00:00.000Z",12,FALSE,17,69,"G",12,12,"Indiana Pacers","Bruce Brown",0,20,22,17,7,20
12,3,2,11,5,20,10,6,6,"34",0,1,31,2,1,0,1038058,"2024-01-03T00:00:00.000Z",12,FALSE,17,3547245,"G",12,12,"Indiana Pacers","Tyrese Haliburton",4,33,45,43,14,63.4
0,0,0,4,2,8,3,3,2,"13",0,1,10,0,1,0,1038058,"2024-01-03T00:00:00.000Z",12,FALSE,17,210,"G",12,12,"Indiana Pacers","Buddy Hield",1,10,10,10,0,13
2,0,1,2,1,3,2,3,2,"10",0,3,7,1,0,0,1038058,"2024-01-03T00:00:00.000Z",12,FALSE,17,368,"G",17,17,"Milwaukee Bucks","Cameron Payne",0,8,10,9,3,11.2
1,1,3,2,0,10,4,2,1,"20",3,1,9,6,0,0,1038058,"2024-01-03T00:00:00.000Z",12,FALSE,17,377,"F",17,17,"Milwaukee Bucks","Bobby Portis",1,15,16,10,7,20.7
0,0,0,0,0,0,0,0,0,"00",0,0,0,0,0,0,1038058,"2024-01-03T00:00:00.000Z",12,FALSE,17,666960,"G",17,17,"Milwaukee Bucks","Lindell Wigginton",0,0,0,0,0,0
0,0,0,0,0,0,0,0,0,"00",0,0,0,0,0,0,1038058,"2024-01-03T00:00:00.000Z",12,FALSE,17,666453,"C",17,17,"Milwaukee Bucks","Marques Bolden",0,0,0,0,0,0
0,0,0,0,0,0,0,0,0,"00",0,0,0,0,0,0,1038058,"2024-01-03T00:00:00.000Z",12,FALSE,17,112,"F",17,17,"Milwaukee Bucks","Jae Crowder",0,0,0,0,0,0
0,0,0,0,0,0,0,0,0,"00",0,0,0,0,0,0,1038058,"2024-01-03T00:00:00.000Z",12,FALSE,17,38017733,"G",17,17,"Milwaukee Bucks","A.J. Green",0,0,0,0,0,0
0,0,0,0,0,0,0,0,0,"00",0,0,0,0,0,0,1038058,"2024-01-03T00:00:00.000Z",12,FALSE,17,38017691,"G",17,17,"Milwaukee Bucks","TyTy Washington Jr.",0,0,0,0,0,0
3,0,2,0,0,6,4,1,1,"18",2,3,9,4,1,1,1038058,"2024-01-03T00:00:00.000Z",12,FALSE,17,17896035,"F",12,12,"Indiana Pacers","Isaiah Jackson",1,13,16,12,7,20.3
0,0,0,0,0,0,0,0,0,"00",0,0,0,0,0,0,1038058,"2024-01-03T00:00:00.000Z",12,FALSE,17,242,"F",12,12,"Indiana Pacers","James Johnson",0,0,0,0,0,0
3,0,1,2,2,9,6,2,2,"25",0,4,16,1,0,1,1038058,"2024-01-03T00:00:00.000Z",12,FALSE,17,38017686,"G-F",12,12,"Indiana Pacers","Bennedict Mathurin",0,17,20,19,4,20.7
3,0,6,1,0,6,2,2,2,"19",0,1,6,6,0,1,1038058,"2024-01-03T00:00:00.000Z",12,FALSE,17,304,"G",12,12,"Indiana Pacers","T.J. McConnell",0,12,15,9,9,16.7
0,0,0,0,0,0,0,0,0,"00",0,0,0,0,0,0,1038058,"2024-01-03T00:00:00.000Z",12,FALSE,17,38017507,"G-F",12,12,"Indiana Pacers","Andrew Nembhard",0,0,0,0,0,0
4,0,5,6,2,12,5,4,3,"27",3,3,15,8,1,0,1038058,"2024-01-03T00:00:00.000Z",12,FALSE,17,3547243,"F",12,12,"Indiana Pacers","Obi Toppin",1,23,27,19,12,33.6
0,0,0,0,0,0,0,0,0,"01",0,0,0,0,0,0,1038058,"2024-01-03T00:00:00.000Z",12,FALSE,17,3547207,"F",12,12,"Indiana Pacers","Jordan Nwora",0,0,0,0,0,0
0,0,0,1,0,1,0,0,0,"02",0,0,0,0,0,0,1038058,"2024-01-03T00:00:00.000Z",12,FALSE,17,56677861,"G",12,12,"Indiana Pacers","Ben Sheppard",0,0,0,0,0,0
0,0,0,0,0,0,0,4,3,"02",0,0,3,0,0,0,1038058,"2024-01-03T00:00:00.000Z",12,FALSE,17,56677832,"F",12,12,"Indiana Pacers","Jarace Walker",0,3,3,3,0,3
0,0,0,0,0,0,0,0,0,"00",0,0,0,0,0,0,1038058,"2024-01-03T00:00:00.000Z",12,FALSE,17,38017701,"G",12,12,"Indiana Pacers","Kendall Brown",0,0,0,0,0,0
0,0,0,0,0,0,0,0,0,"00",0,0,0,0,0,0,1038058,"2024-01-03T00:00:00.000Z",12,FALSE,17,56677778,"F-C",12,12,"Indiana Pacers","Oscar Tshiebwe",0,0,0,0,0,0
0,0,0,0,0,0,0,0,0,"00",0,0,0,0,0,0,1038058,"2024-01-03T00:00:00.000Z",12,FALSE,17,56677794,"G",12,12,"Indiana Pacers","Isaiah Wong",0,0,0,0,0,0
7,2,5,7,4,13,7,1,1,"32",1,2,19,6,0,4,1038058,"2024-01-03T00:00:00.000Z",12,FALSE,17,315,"F",17,17,"Milwaukee Bucks","Khris Middleton",2,25,32,26,13,38.7
8,1,11,2,1,13,8,13,9,"36",0,2,26,11,2,3,1038058,"2024-01-03T00:00:00.000Z",12,FALSE,17,15,"F",17,17,"Milwaukee Bucks","Giannis Antetokounmpo",3,37,45,34,19,57.2
1,0,2,4,2,11,6,3,2,"28",3,3,16,5,0,2,1038058,"2024-01-03T00:00:00.000Z",12,FALSE,17,283,"C",17,17,"Milwaukee Bucks","Brook Lopez",0,21,22,17,6,21.5
1,0,1,5,2,8,3,0,0,"23",0,4,8,1,0,0,1038058,"2024-01-03T00:00:00.000Z",12,FALSE,17,38,"G",17,17,"Milwaukee Bucks","Malik Beasley",0,9,10,9,2,10.7
5,0,1,8,2,18,6,10,9,"36",1,3,23,2,3,2,1038058,"2024-01-03T00:00:00.000Z",12,FALSE,17,278,"G",17,17,"Milwaukee Bucks","Damian Lillard",3,25,30,28,7,39.9
1,0,1,2,1,3,1,0,0,"14",1,3,3,2,0,0,1038058,"2024-01-03T00:00:00.000Z",12,FALSE,17,105,"G",17,17,"Milwaukee Bucks","Pat Connaughton",0,5,6,4,3,6.9
1,0,2,3,0,9,6,0,0,"21",1,1,12,3,0,1,1038058,"2024-01-03T00:00:00.000Z",12,FALSE,17,38017676,"F",17,17,"Milwaukee Bucks","MarJon Beauchamp",0,15,16,13,4,16.1
2,0,2,2,1,4,3,0,0,"14",0,1,7,2,1,1,1038058,"2024-01-03T00:00:00.000Z",12,FALSE,17,56677852,"G",17,17,"Milwaukee Bucks","Andre Jackson Jr.",1,9,11,9,4,14.4
0,0,1,0,0,0,0,0,0,"02",0,2,0,1,0,0,1038058,"2024-01-03T00:00:00.000Z",12,FALSE,17,2148,"",17,17,"Milwaukee Bucks","Thanasis Antetokounmpo",0,1,1,0,1,1.2
1,0,1,0,0,0,0,0,0,"02",0,0,0,1,0,0,1038058,"2024-01-03T00:00:00.000Z",12,FALSE,17,56677854,"F",17,17,"Milwaukee Bucks","Chris Livingston",0,1,2,1,2,2.7
0,0,1,0,0,0,0,0,0,"02",0,0,0,1,0,0,1038058,"2024-01-03T00:00:00.000Z",12,FALSE,17,284,"C",17,17,"Milwaukee Bucks","Robin Lopez",0,1,1,0,1,1.2
2,0,0,2,0,4,0,0,0,"21",0,0,0,0,1,0,1038069,"2024-01-04T00:00:00.000Z",27,FALSE,17,38017649,"F",27,27,"San Antonio Spurs","Julian Champagnie",1,0,2,2,2,6
5,1,6,5,1,11,3,2,2,"33",2,1,9,8,2,1,1038069,"2024-01-04T00:00:00.000Z",27,FALSE,17,38017699,"F",27,27,"San Antonio Spurs","Jeremy Sochan",3,17,22,14,13,34.1
1,5,6,8,2,18,10,6,5,"26",3,5,27,9,1,5,1038069,"2024-01-04T00:00:00.000Z",27,FALSE,17,56677822,"F-C",27,27,"San Antonio Spurs","Victor Wembanyama",6,36,37,28,10,52.3
4,0,5,9,6,21,14,0,0,"35",1,0,34,6,1,0,1038069,"2024-01-04T00:00:00.000Z",27,FALSE,17,3547246,"G-F",27,27,"San Antonio Spurs","Devin Vassell",1,40,44,38,10,50.2
6,0,3,2,0,13,7,4,4,"35",2,2,18,5,1,3,1038069,"2024-01-04T00:00:00.000Z",27,FALSE,17,3547274,"G",27,27,"San Antonio Spurs","Tre Jones",1,23,29,24,11,33
4,2,1,0,0,3,3,0,0,"15",0,1,6,1,1,0,1038069,"2024-01-04T00:00:00.000Z",27,FALSE,17,38017730,"F",27,27,"San Antonio Spurs","Dominick Barlow",3,7,11,10,5,22.2
0,0,0,0,0,0,0,0,0,"00",0,0,0,0,0,0,1038069,"2024-01-04T00:00:00.000Z",27,FALSE,17,38017692,"F",27,27,"San Antonio Spurs","Malaki Branham",0,0,0,0,0,0
0,0,0,0,0,0,0,0,0,"00",0,0,0,0,0,0,1038069,"2024-01-04T00:00:00.000Z",27,FALSE,17,3547163,"F",6,27,"San Antonio Spurs","Mamadi Diakite",0,0,0,0,0,0
0,0,0,0,0,0,0,0,0,"00",0,0,0,0,0,0,1038069,"2024-01-04T00:00:00.000Z",27,FALSE,17,180,"G",27,27,"San Antonio Spurs","Devonte' Graham",0,0,0,0,0,0
1,0,8,8,2,17,5,2,2,"30",2,1,14,10,0,1,1038069,"2024-01-04T00:00:00.000Z",27,FALSE,17,666682,"F",27,27,"San Antonio Spurs","Keldon Johnson",0,24,25,15,11,26.5
2,0,0,0,0,0,0,0,0,"02",0,0,0,0,0,0,1038069,"2024-01-04T00:00:00.000Z",27,FALSE,17,17896059,"F",27,27,"San Antonio Spurs","Sandro Mamukelashvili",0,0,2,2,2,3
5,0,2,6,3,7,4,3,2,"28",0,3,13,2,3,1,1038069,"2024-01-04T00:00:00.000Z",27,FALSE,17,359,"F",27,27,"San Antonio Spurs","Cedi Osman",3,15,20,18,7,30.9
1,0,1,0,0,1,0,0,0,"15",0,3,0,1,0,0,1038069,"2024-01-04T00:00:00.000Z",27,FALSE,17,38017693,"G",27,27,"San Antonio Spurs","Blake Wesley",0,1,2,1,2,2.7
0,0,0,0,0,0,0,0,0,"00",0,0,0,0,0,0,1038069,"2024-01-04T00:00:00.000Z",27,FALSE,17,17895854,"G",27,27,"San Antonio Spurs","Charles Bassey",0,0,0,0,0,0
0,0,0,0,0,0,0,0,0,"00",0,0,0,0,0,0,1038069,"2024-01-04T00:00:00.000Z",27,FALSE,17,56677817,"G",27,27,"San Antonio Spurs","Sidy Cissoko",0,0,0,0,0,0
0,0,0,0,0,0,0,0,0,"00",0,0,0,0,0,0,1038069,"2024-01-04T00:00:00.000Z",27,FALSE,17,102,"F-C",27,27,"San Antonio Spurs","Zach Collins",0,0,0,0,0,0
0,0,0,0,0,0,0,0,0,"00",0,0,0,0,0,0,1038069,"2024-01-04T00:00:00.000Z",27,FALSE,17,17896049,"G",3,27,"San Antonio Spurs","David Duke Jr.",0,0,0,0,0,0
0,0,0,0,0,0,0,0,0,"00",0,0,0,0,0,0,1038069,"2024-01-04T00:00:00.000Z",27,FALSE,17,305,"F",27,27,"San Antonio Spurs","Doug McDermott",0,0,0,0,0,0
5,0,3,3,2,8,5,0,0,"15",0,0,12,3,1,1,1038069,"2024-01-04T00:00:00.000Z",27,FALSE,17,315,"F",17,17,"Milwaukee Bucks","Khris Middleton",1,15,20,17,8,25.1
7,1,11,3,2,28,19,6,4,"40",3,3,44,14,2,1,1038069,"2024-01-04T00:00:00.000Z",27,FALSE,17,15,"F",17,17,"Milwaukee Bucks","Giannis Antetokounmpo",3,58,65,51,21,79.3
1,3,4,5,1,10,4,0,0,"33",0,4,9,4,0,4,1038069,"2024-01-04T00:00:00.000Z",27,FALSE,17,283,"C",17,17,"Milwaukee Bucks","Brook Lopez",3,13,14,10,5,20.3
0,0,2,4,2,6,4,0,0,"27",0,0,10,2,0,2,1038069,"2024-01-04T00:00:00.000Z",27,FALSE,17,38,"G",17,17,"Milwaukee Bucks","Malik Beasley",0,12,12,10,2,10.4
10,0,3,6,1,19,10,4,4,"39",1,3,25,4,1,0,1038069,"2024-01-04T00:00:00.000Z",27,FALSE,17,278,"G",17,17,"Milwaukee Bucks","Damian Lillard",1,29,39,35,14,47.8
0,0,0,0,0,0,0,0,0,"00",0,0,0,0,0,0,1038069,"2024-01-04T00:00:00.000Z",27,FALSE,17,2148,"",17,17,"Milwaukee Bucks","Thanasis Antetokounmpo",0,0,0,0,0,0
0,0,1,4,2,8,3,0,0,"17",2,1,8,3,0,1,1038069,"2024-01-04T00:00:00.000Z",27,FALSE,17,38017676,"F",17,17,"Milwaukee Bucks","MarJon Beauchamp",0,11,11,8,3,10.6
0,0,5,4,2,4,2,2,1,"28",1,0,7,6,1,3,1038069,"2024-01-04T00:00:00.000Z",27,FALSE,17,105,"G",17,17,"Milwaukee Bucks","Pat Connaughton",1,13,13,7,6,14.2
0,0,0,0,0,0,0,0,0,"00",0,0,0,0,0,0,1038069,"2024-01-04T00:00:00.000Z",27,FALSE,17,38017733,"G",17,17,"Milwaukee Bucks","A.J. Green",0,0,0,0,0,0
0,0,1,0,0,0,0,0,0,"05",0,1,0,1,0,0,1038069,"2024-01-04T00:00:00.000Z",27,FALSE,17,56677852,"G",17,17,"Milwaukee Bucks","Andre Jackson Jr.",0,1,1,0,1,1.2
0,0,0,0,0,0,0,0,0,"00",0,0,0,0,0,0,1038069,"2024-01-04T00:00:00.000Z",27,FALSE,17,56677854,"F",17,17,"Milwaukee Bucks","Chris Livingston",0,0,0,0,0,0
0,0,0,0,0,0,0,0,0,"00",0,0,0,0,0,0,1038069,"2024-01-04T00:00:00.000Z",27,FALSE,17,284,"C",17,17,"Milwaukee Bucks","Robin Lopez",0,0,0,0,0,0
4,0,1,3,0,3,0,5,5,"15",0,1,5,1,0,0,1038069,"2024-01-04T00:00:00.000Z",27,FALSE,17,368,"G",17,17,"Milwaukee Bucks","Cameron Payne",0,6,10,9,5,12.2
0,1,3,2,0,6,2,2,1,"21",1,3,5,4,0,2,1038069,"2024-01-04T00:00:00.000Z",27,FALSE,17,377,"F",17,17,"Milwaukee Bucks","Bobby Portis",1,9,9,5,4,10.8
0,0,0,0,0,0,0,0,0,"00",0,0,0,0,0,0,1038069,"2024-01-04T00:00:00.000Z",27,FALSE,17,666960,"G",17,17,"Milwaukee Bucks","Lindell Wigginton",0,0,0,0,0,0
0,0,0,0,0,0,0,0,0,"00",0,0,0,0,0,0,1038069,"2024-01-04T00:00:00.000Z",27,FALSE,17,666453,"C",17,17,"Milwaukee Bucks","Marques Bolden",0,0,0,0,0,0
0,0,0,0,0,0,0,0,0,"00",0,0,0,0,0,0,1038069,"2024-01-04T00:00:00.000Z",27,FALSE,17,112,"F",17,17,"Milwaukee Bucks","Jae Crowder",0,0,0,0,0,0
0,0,0,0,0,0,0,0,0,"00",0,0,0,0,0,0,1038069,"2024-01-04T00:00:00.000Z",27,FALSE,17,38017691,"G",17,17,"Milwaukee Bucks","TyTy Washington Jr.",0,0,0,0,0,0
3,1,3,10,4,18,9,2,2,"35",0,2,24,3,1,0,1038070,"2024-01-04T00:00:00.000Z",10,FALSE,8,443,"G",10,10,"Golden State Warriors","Klay Thompson",2,27,30,27,6,38.1
4,0,3,1,0,7,5,7,6,"19",1,1,16,4,0,1,1038070,"2024-01-04T00:00:00.000Z",10,FALSE,8,17553979,"F",10,10,"Golden State Warriors","Jonathan Kuminga",0,20,24,20,8,25.8
3,0,2,0,0,4,3,1,1,"22",2,5,7,4,0,0,1038070,"2024-01-04T00:00:00.000Z",10,FALSE,8,282,"F",10,10,"Golden State Warriors","Kevon Looney",0,11,14,10,7,16.3
6,1,4,12,5,23,11,3,3,"35",0,1,30,4,1,2,1038070,"2024-01-04T00:00:00.000Z",10,FALSE,8,115,"G",10,10,"Golden State Warriors","Stephen Curry",2,34,40,36,10,47.8
6,0,3,3,1,7,4,1,0,"30",1,2,9,4,0,0,1038070,"2024-01-04T00:00:00.000Z",10,FALSE,8,367,"G",10,10,"Golden State Warriors","Chris Paul",0,13,19,15,10,22.8
0,0,0,0,0,0,0,0,0,"00",0,0,0,0,0,0,1038070,"2024-01-04T00:00:00.000Z",10,FALSE,8,185,"F",10,10,"Golden State Warriors","Draymond Green",0,0,0,0,0,0
2,0,0,0,0,4,2,0,0,"21",2,4,4,2,0,2,1038070,"2024-01-04T00:00:00.000Z",10,FALSE,8,56677799,"F",10,10,"Golden State Warriors","Trayce Jackson-Davis",0,6,8,6,4,7.4
0,0,0,0,0,0,0,0,0,"00",0,0,0,0,0,0,1038070,"2024-01-04T00:00:00.000Z",10,FALSE,8,251,"G",10,10,"Golden State Warriors","Cory Joseph",0,0,0,0,0,0
0,0,0,0,0,0,0,0,0,"00",0,0,0,0,0,0,1038070,"2024-01-04T00:00:00.000Z",10,FALSE,8,17553992,"G",10,10,"Golden State Warriors","Moses Moody",0,0,0,0,0,0
5,0,2,4,3,10,5,0,0,"28",0,2,13,2,1,0,1038070,"2024-01-04T00:00:00.000Z",10,FALSE,8,56677858,"G",10,10,"Golden State Warriors","Brandin Podziemski",1,15,20,18,7,25.9
6,0,6,2,1,7,5,2,2,"23",1,1,13,7,1,2,1038070,"2024-01-04T00:00:00.000Z",10,FALSE,8,407,"F",10,10,"Golden State Warriors","Dario Saric",1,20,26,19,13,31.4
0,1,1,4,1,10,5,0,0,"27",2,2,11,3,0,1,1038070,"2024-01-04T00:00:00.000Z",10,FALSE,8,475,"F-G",10,10,"Golden State Warriors","Andrew Wiggins",1,14,14,11,3,16.6
4,1,2,2,0,8,4,0,0,"35",1,0,8,3,1,1,1038070,"2024-01-04T00:00:00.000Z",10,FALSE,8,81,"G",8,8,"Denver Nuggets","Kentavious Caldwell-Pope",2,11,15,12,7,22.6
6,0,2,6,1,16,8,9,8,"32",0,4,25,2,2,0,1038070,"2024-01-04T00:00:00.000Z",10,FALSE,8,335,"G",8,8,"Denver Nuggets","Jamal Murray",2,27,33,31,8,42.4
1,1,0,2,0,4,1,0,0,"19",0,3,2,0,1,1,1038070,"2024-01-04T00:00:00.000Z",10,FALSE,8,38017709,"G",8,8,"Denver Nuggets","Christian Braun",2,2,3,3,1,8.5
3,0,0,0,0,6,1,0,0,"16",0,0,2,0,0,1,1038070,"2024-01-04T00:00:00.000Z",10,FALSE,8,236,"G",8,8,"Denver Nuggets","Reggie Jackson",0,2,5,5,3,5.5
0,0,0,0,0,0,0,0,0,"00",0,0,0,0,0,0,1038070,"2024-01-04T00:00:00.000Z",10,FALSE,8,17896070,"F",10,10,"Golden State Warriors","Usman Garuba",0,0,0,0,0,0
0,0,0,0,0,0,0,0,0,"00",0,0,0,0,0,0,1038070,"2024-01-04T00:00:00.000Z",10,FALSE,8,2189,"",10,10,"Golden State Warriors","Gary Payton II",0,0,0,0,0,0
0,0,0,0,0,0,0,0,0,"00",0,0,0,0,0,0,1038070,"2024-01-04T00:00:00.000Z",10,FALSE,8,57875092,"F",10,10,"Golden State Warriors","Gui Santos",0,0,0,0,0,0
0,0,4,5,2,6,3,0,0,"31",0,3,8,4,0,0,1038070,"2024-01-04T00:00:00.000Z",10,FALSE,8,375,"F",8,8,"Denver Nuggets","Michael Porter Jr.",0,12,12,8,4,12.8
2,1,4,4,2,17,11,7,6,"35",5,2,30,9,0,0,1038070,"2024-01-04T00:00:00.000Z",10,FALSE,8,177,"F",8,8,"Denver Nuggets","Aaron Gordon",1,39,41,32,11,46.8
10,1,7,2,2,16,13,7,6,"38",2,2,34,9,2,4,1038070,"2024-01-04T00:00:00.000Z",10,FALSE,8,246,"C",8,8,"Denver Nuggets","Nikola Jokic",3,43,53,44,19,64.8
0,0,0,0,0,0,0,0,0,"00",0,0,0,0,0,0,1038070,"2024-01-04T00:00:00.000Z",10,FALSE,8,56677871,"F",8,8,"Denver Nuggets","Hunter Tyson",0,0,0,0,0,0
0,0,4,4,2,10,6,6,5,"19",1,1,19,5,0,0,1038070,"2024-01-04T00:00:00.000Z",10,FALSE,8,38017721,"G",8,8,"Denver Nuggets","Peyton Watson",0,24,24,19,5,25
1,0,0,1,0,1,0,0,0,"09",1,0,0,1,1,0,1038070,"2024-01-04T00:00:00.000Z",10,FALSE,8,56677776,"G",8,8,"Denver Nuggets","Julian Strawther",1,1,2,1,2,5.7
1,0,2,0,0,1,1,0,0,"06",1,0,2,3,0,0,1038070,"2024-01-04T00:00:00.000Z",10,FALSE,8,3547268,"F-C",8,8,"Denver Nuggets","Zeke Nnaji",0,5,6,3,4,7.1
0,0,0,0,0,0,0,0,0,"00",0,0,0,0,0,0,1038070,"2024-01-04T00:00:00.000Z",10,FALSE,8,38017727,"G",8,8,"Denver Nuggets","Collin Gillespie",0,0,0,0,0,0
0,0,0,0,0,0,0,0,0,"00",0,0,0,0,0,0,1038070,"2024-01-04T00:00:00.000Z",10,FALSE,8,215,"F-G",8,8,"Denver Nuggets","Justin Holiday",0,0,0,0,0,0
0,0,0,0,0,0,0,0,0,"00",0,0,0,0,0,0,1038070,"2024-01-04T00:00:00.000Z",10,FALSE,8,17896103,"F-C",8,8,"Denver Nuggets","Jay Huff",0,0,0,0,0,0
0,0,0,0,0,0,0,0,0,"00",0,0,0,0,0,0,1038070,"2024-01-04T00:00:00.000Z",10,FALSE,8,250,"C",8,8,"Denver Nuggets","DeAndre Jordan",0,0,0,0,0,0
0,0,0,0,0,0,0,0,0,"00",0,0,0,0,0,0,1038070,"2024-01-04T00:00:00.000Z",10,FALSE,8,17896007,"G",8,8,"Denver Nuggets","Braxton Key",0,0,0,0,0,0
0,0,0,0,0,0,0,0,0,"00",0,0,0,0,0,0,1038070,"2024-01-04T00:00:00.000Z",10,FALSE,8,666489,"F",8,8,"Denver Nuggets","Vlatko Cancar",0,0,0,0,0,0
0,0,0,0,0,0,0,0,0,"00",0,0,0,0,0,0,1038070,"2024-01-04T00:00:00.000Z",10,FALSE,8,56677582,"G",8,8,"Denver Nuggets","Jalen Pickett",0,0,0,0,0,0
0,0,0,0,0,0,0,0,0,"00",0,0,0,0,0,0,1038070,"2024-01-04T00:00:00.000Z",10,FALSE,8,45658838,"G",10,10,"Golden State Warriors","Lester Quinones",0,0,0,0,0,0
0,0,0,0,0,0,0,0,0,"00",0,0,0,0,0,0,1038070,"2024-01-04T00:00:00.000Z",10,FALSE,8,398,"G",10,10,"Golden State Warriors","Jerome Robinson",0,0,0,0,0,0
1,0,3,6,4,14,9,0,0,"31",0,2,22,3,2,0,1038080,"2024-01-05T00:00:00.000Z",8,FALSE,22,375,"F",8,8,"Denver Nuggets","Michael Porter Jr.",2,25,26,23,4,33.1
3,0,5,4,2,8,5,5,4,"36",3,4,16,8,0,1,1038080,"2024-01-05T00:00:00.000Z",8,FALSE,22,177,"F",8,8,"Denver Nuggets","Aaron Gordon",0,24,27,19,11,29.1
8,0,4,1,0,19,13,4,3,"37",0,3,29,4,3,2,1038080,"2024-01-05T00:00:00.000Z",8,FALSE,22,246,"C",8,8,"Denver Nuggets","Nikola Jokic",3,33,41,37,12,52.8
2,1,2,3,0,4,1,4,4,"29",1,1,6,3,1,3,1038080,"2024-01-05T00:00:00.000Z",8,FALSE,22,81,"G",8,8,"Denver Nuggets","Kentavious Caldwell-Pope",2,9,11,8,5,15.6
9,0,6,6,0,23,9,2,2,"34",1,3,20,7,1,3,1038080,"2024-01-05T00:00:00.000Z",8,FALSE,22,335,"G",8,8,"Denver Nuggets","Jamal Murray",1,27,36,29,16,41.9
0,0,3,3,1,4,2,2,1,"16",1,0,6,4,0,1,1038080,"2024-01-05T00:00:00.000Z",8,FALSE,22,38017709,"G",8,8,"Denver Nuggets","Christian Braun",0,10,10,6,4,9.8
0,0,0,0,0,0,0,0,0,"00",0,0,0,0,0,0,1038080,"2024-01-05T00:00:00.000Z",8,FALSE,22,38017727,"G",8,8,"Denver Nuggets","Collin Gillespie",0,0,0,0,0,0
1,0,1,1,0,1,0,0,0,"10",0,1,0,1,0,0,1038080,"2024-01-05T00:00:00.000Z",8,FALSE,22,215,"F-G",8,8,"Denver Nuggets","Justin Holiday",0,1,2,1,2,2.7
0,0,0,0,0,0,0,0,0,"00",0,0,0,0,0,0,1038080,"2024-01-05T00:00:00.000Z",8,FALSE,22,17896103,"F-C",8,8,"Denver Nuggets","Jay Huff",0,0,0,0,0,0
3,0,2,5,1,12,5,0,0,"17",1,0,11,3,0,1,1038080,"2024-01-05T00:00:00.000Z",8,FALSE,22,236,"G",8,8,"Denver Nuggets","Reggie Jackson",0,14,17,14,6,18.1
0,0,0,0,0,0,0,0,0,"00",0,0,0,0,0,0,1038080,"2024-01-05T00:00:00.000Z",8,FALSE,22,250,"C",8,8,"Denver Nuggets","DeAndre Jordan",0,0,0,0,0,0
1,0,2,2,1,3,1,0,0,"06",0,1,3,2,0,0,1038080,"2024-01-05T00:00:00.000Z",8,FALSE,22,17896007,"G",8,8,"Denver Nuggets","Braxton Key",0,5,6,4,3,6.9
0,0,1,0,0,1,1,2,1,"11",1,4,3,2,1,2,1038080,"2024-01-05T00:00:00.000Z",8,FALSE,22,3547268,"F-C",8,8,"Denver Nuggets","Zeke Nnaji",1,5,5,3,2,6.4
0,0,0,2,0,6,2,0,0,"13",1,4,4,1,0,0,1038080,"2024-01-05T00:00:00.000Z",8,FALSE,22,38017721,"G",8,8,"Denver Nuggets","Peyton Watson",0,5,5,4,1,5.2
0,0,0,0,0,0,0,0,0,"00",0,0,0,0,0,0,1038080,"2024-01-05T00:00:00.000Z",8,FALSE,22,666489,"F",8,8,"Denver Nuggets","Vlatko Cancar",0,0,0,0,0,0
0,0,0,0,0,0,0,0,0,"00",0,0,0,0,0,0,1038080,"2024-01-05T00:00:00.000Z",8,FALSE,22,56677582,"G",8,8,"Denver Nuggets","Jalen Pickett",0,0,0,0,0,0
0,0,0,0,0,0,0,0,0,"00",0,0,0,0,0,0,1038080,"2024-01-05T00:00:00.000Z",8,FALSE,22,56677776,"G",8,8,"Denver Nuggets","Julian Strawther",0,0,0,0,0,0
0,0,0,0,0,0,0,0,0,"00",0,0,0,0,0,0,1038080,"2024-01-05T00:00:00.000Z",8,FALSE,22,56677871,"F",8,8,"Denver Nuggets","Hunter Tyson",0,0,0,0,0,0
1,1,4,3,1,3,1,2,0,"28",3,1,3,7,1,4,1038080,"2024-01-05T00:00:00.000Z",8,FALSE,22,666818,"F",22,22,"Orlando Magic","Chuma Okeke",2,10,11,4,8,14.9
11,0,9,4,1,21,8,19,15,"41",1,2,32,10,3,5,1038080,"2024-01-05T00:00:00.000Z",8,FALSE,22,38017683,"F",22,22,"Orlando Magic","Paolo Banchero",3,42,53,43,21,64.5
3,0,8,4,2,14,8,2,1,"38",3,4,19,11,2,0,1038080,"2024-01-05T00:00:00.000Z",8,FALSE,22,462,"C",22,22,"Orlando Magic","Moritz Wagner",2,30,33,22,14,42.7
1,0,0,0,0,1,0,0,0,"05",0,1,0,0,0,0,1038080,"2024-01-05T00:00:00.000Z",8,FALSE,22,56677827,"G",22,22,"Orlando Magic","Anthony Black",0,0,1,1,1,1.5
1,1,2,9,7,15,9,4,2,"34",2,3,27,4,0,2,1038080,"2024-01-05T00:00:00.000Z",8,FALSE,22,17896073,"G",22,22,"Orlando Magic","Jalen Suggs",1,31,32,28,5,34.3
4,0,2,8,3,15,8,4,4,"31",0,2,23,2,1,3,1038080,"2024-01-05T00:00:00.000Z",8,FALSE,22,3547251,"G",22,22,"Orlando Magic","Cole Anthony",1,25,29,27,6,31.4
0,0,0,0,0,0,0,0,0,"00",0,0,0,0,0,0,1038080,"2024-01-05T00:00:00.000Z",8,FALSE,22,17896026,"F",22,22,"Orlando Magic","Franz Wagner",0,0,0,0,0,0
0,0,0,0,0,0,0,0,0,"00",0,0,0,0,0,0,1038080,"2024-01-05T00:00:00.000Z",8,FALSE,22,56677839,"G",22,22,"Orlando Magic","Jett Howard",0,0,0,0,0,0
0,0,0,0,0,0,0,0,0,"00",0,0,0,0,0,0,1038080,"2024-01-05T00:00:00.000Z",8,FALSE,22,226,"F",22,22,"Orlando Magic","Joe Ingles",0,0,0,0,0,0
0,0,0,0,0,0,0,0,0,"00",0,0,0,0,0,0,1038080,"2024-01-05T00:00:00.000Z",8,FALSE,22,229,"F",22,22,"Orlando Magic","Jonathan Isaac",0,0,0,0,0,0
1,0,0,5,2,6,3,2,0,"24",0,3,8,0,0,0,1038080,"2024-01-05T00:00:00.000Z",8,FALSE,22,38017724,"G",22,22,"Orlando Magic","Caleb Houstan",0,8,9,9,1,9.5
2,1,4,1,0,4,2,1,1,"31",1,4,5,5,2,0,1038080,"2024-01-05T00:00:00.000Z",8,FALSE,22,17553983,"G",22,22,"Orlando Magic","Trevelin Queen",3,10,12,7,7,23
1,0,0,2,1,3,2,0,0,"08",1,0,5,1,0,0,1038080,"2024-01-05T00:00:00.000Z",8,FALSE,22,666885,"F",22,22,"Orlando Magic","Admiral Schofield",0,6,7,6,2,7.7
0,0,0,0,0,0,0,0,0,"00",0,0,0,0,0,0,1038080,"2024-01-05T00:00:00.000Z",8,FALSE,22,666442,"C",22,22,"Orlando Magic","Goga Bitadze",0,0,0,0,0,0
0,0,0,0,0,0,0,0,0,"00",0,0,0,0,0,0,1038080,"2024-01-05T00:00:00.000Z",8,FALSE,22,85,"F",22,22,"Orlando Magic","Wendell Carter Jr.",0,0,0,0,0,0
0,0,0,0,0,0,0,0,0,"00",0,0,0,0,0,0,1038080,"2024-01-05T00:00:00.000Z",8,FALSE,22,165,"G",22,22,"Orlando Magic","Markelle Fultz",0,0,0,0,0,0
0,0,0,0,0,0,0,0,0,"00",0,0,0,0,0,0,1038080,"2024-01-05T00:00:00.000Z",8,FALSE,22,196,"G",22,22,"Orlando Magic","Gary Harris",0,0,0,0,0,0
0,0,0,0,0,0,0,0,0,"00",0,0,0,0,0,0,1038080,"2024-01-05T00:00:00.000Z",8,FALSE,22,38017607,"G",22,22,"Orlando Magic","Kevon Harris",0,0,0,0,0,0
5,1,3,4,2,12,5,2,1,"27",0,2,13,3,1,3,1038071,"2024-01-05T00:00:00.000Z",2,FALSE,29,70,"G",2,2,"Boston Celtics","Jaylen Brown",2,16,21,18,8,27.1
5,1,9,8,5,12,6,14,13,"25",0,1,30,9,1,1,1038071,"2024-01-05T00:00:00.000Z",2,FALSE,29,434,"F",2,2,"Boston Celtics","Jayson Tatum",2,39,44,35,14,53.3
2,1,5,3,1,7,4,12,10,"27",0,3,19,5,0,1,1038071,"2024-01-05T00:00:00.000Z",2,FALSE,29,378,"F-C",2,2,"Boston Celtics","Kristaps Porzingis",1,24,26,21,7,30
3,1,7,7,2,9,3,2,2,"26",0,2,10,7,1,0,1038071,"2024-01-05T00:00:00.000Z",2,FALSE,29,473,"G",2,2,"Boston Celtics","Derrick White",2,17,20,13,10,28.9
1,2,5,3,2,8,6,0,0,"24",1,1,14,6,0,2,1038071,"2024-01-05T00:00:00.000Z",2,FALSE,29,214,"G",2,2,"Boston Celtics","Jrue Holiday",2,20,21,15,7,26.7
1,0,1,1,0,2,1,4,3,"06",0,1,5,1,0,0,1038071,"2024-01-05T00:00:00.000Z",2,FALSE,29,17896094,"G",2,2,"Boston Celtics","Dalano Banton",0,6,7,6,2,7.7
2,0,2,2,0,5,2,2,2,"17",1,3,6,3,2,0,1038071,"2024-01-05T00:00:00.000Z",2,FALSE,29,666468,"F",2,2,"Boston Celtics","Oshae Brissett",2,9,11,8,5,18.6
1,0,4,7,3,10,5,0,0,"23",1,1,13,5,1,0,1038071,"2024-01-05T00:00:00.000Z",2,FALSE,29,17896060,"F",2,2,"Boston Celtics","Sam Hauser",1,18,19,14,6,23.5
0,1,3,0,0,3,1,0,0,"11",4,1,2,7,1,1,1038071,"2024-01-05T00:00:00.000Z",2,FALSE,29,261,"F-C",2,2,"Boston Celtics","Luke Kornet",2,9,9,2,7,15.4
0,0,3,6,1,7,1,0,0,"15",0,2,3,3,0,0,1038071,"2024-01-05T00:00:00.000Z",2,FALSE,29,338,"G",2,2,"Boston Celtics","Svi Mykhailiuk",0,6,6,3,3,6.6
4,0,1,7,1,10,3,0,0,"23",1,3,7,2,1,3,1038071,"2024-01-05T00:00:00.000Z",2,FALSE,29,3547276,"G",2,2,"Boston Celtics","Payton Pritchard",1,9,13,11,6,15.4
0,0,0,0,0,1,0,0,0,"04",0,2,0,0,0,0,1038071,"2024-01-05T00:00:00.000Z",2,FALSE,29,17553967,"C",2,2,"Boston Celtics","Neemias Queta",0,0,0,0,0,0
0,1,4,1,0,4,2,0,0,"12",1,1,4,5,1,1,1038071,"2024-01-05T00:00:00.000Z",2,FALSE,29,3547279,"F",2,2,"Boston Celtics","Lamar Stevens",2,9,9,4,5,15
0,0,0,0,0,0,0,0,0,"00",0,0,0,0,0,0,1038071,"2024-01-05T00:00:00.000Z",2,FALSE,29,38017707,"G",2,2,"Boston Celtics","JD Davison",0,0,0,0,0,0
0,0,0,0,0,0,0,0,0,"00",0,0,0,0,0,0,1038071,"2024-01-05T00:00:00.000Z",2,FALSE,29,219,"C-F",2,2,"Boston Celtics","Al Horford",0,0,0,0,0,0
0,0,0,0,0,0,0,0,0,"00",0,0,0,0,0,0,1038071,"2024-01-05T00:00:00.000Z",2,FALSE,29,NA,NA,NA,2,"Boston Celtics","NA NA",0,0,0,0,0,0
0,0,0,0,0,0,0,0,0,"00",0,0,0,0,0,0,1038071,"2024-01-05T00:00:00.000Z",2,FALSE,29,56677864,"G",2,2,"Boston Celtics","Jordan Walsh",0,0,0,0,0,0
3,0,3,5,2,7,2,2,1,"25",1,2,7,4,1,2,1038071,"2024-01-05T00:00:00.000Z",2,FALSE,29,38017739,"F",29,29,"Utah Jazz","Simone Fontecchio",1,11,14,10,7,17.3
5,0,1,7,2,16,7,2,1,"23",4,1,17,5,0,0,1038071,"2024-01-05T00:00:00.000Z",2,FALSE,29,297,"F",29,29,"Utah Jazz","Lauri Markkanen",0,22,27,22,10,30.5
2,1,11,1,0,9,5,3,2,"22",0,5,12,11,0,2,1038071,"2024-01-05T00:00:00.000Z",2,FALSE,29,101,"F-C",29,29,"Utah Jazz","John Collins",1,23,25,14,13,29.2
5,1,3,1,0,7,1,0,0,"26",2,4,2,5,3,1,1038071,"2024-01-05T00:00:00.000Z",2,FALSE,29,139,"G",29,29,"Utah Jazz","Kris Dunn",4,7,12,7,10,26.5
3,0,1,3,0,11,5,3,3,"21",0,1,13,1,3,3,1038071,"2024-01-05T00:00:00.000Z",2,FALSE,29,413,"G",29,29,"Utah Jazz","Collin Sexton",3,14,17,16,4,24.7
0,0,6,0,0,3,2,0,0,"14",1,2,4,7,0,0,1038071,"2024-01-05T00:00:00.000Z",2,FALSE,29,38017705,"C",29,29,"Utah Jazz","Walker Kessler",0,11,11,4,7,12.4
2,0,1,2,0,7,1,0,0,"17",1,0,2,2,1,4,1038071,"2024-01-05T00:00:00.000Z",2,FALSE,29,100,"G",29,29,"Utah Jazz","Jordan Clarkson",1,4,6,4,4,6.4
1,0,3,7,2,10,4,2,2,"20",1,0,12,4,0,1,1038071,"2024-01-05T00:00:00.000Z",2,FALSE,29,56677834,"G",29,29,"Utah Jazz","Keyonte George",0,16,17,13,5,17.3
1,0,3,3,0,5,2,1,1,"22",1,4,5,4,0,2,1038071,"2024-01-05T00:00:00.000Z",2,FALSE,29,38017620,"G",29,29,"Utah Jazz","Ochai Agbaji",0,9,10,6,5,9.3
0,0,0,0,0,0,0,0,0,"00",0,0,0,0,0,0,1038071,"2024-01-05T00:00:00.000Z",2,FALSE,29,56677824,"F",29,29,"Utah Jazz","Taylor Hendricks",0,0,0,0,0,0
0,0,0,0,0,0,0,0,0,"00",0,0,0,0,0,0,1038071,"2024-01-05T00:00:00.000Z",2,FALSE,29,38017630,"G",29,29,"Utah Jazz","Johnny Juzang",0,0,0,0,0,0
0,0,0,0,0,0,0,0,0,"00",0,0,0,0,0,0,1038071,"2024-01-05T00:00:00.000Z",2,FALSE,29,19465584,"F",29,29,"Utah Jazz","Micah Potter",0,0,0,0,0,0
0,0,0,0,0,0,0,0,0,"00",0,0,0,0,0,0,1038071,"2024-01-05T00:00:00.000Z",2,FALSE,29,56677842,"F",29,29,"Utah Jazz","Brice Sensabaugh",0,0,0,0,0,0
0,0,3,1,0,3,1,5,4,"12",2,0,6,5,0,2,1038071,"2024-01-05T00:00:00.000Z",2,FALSE,29,666881,"F",29,29,"Utah Jazz","Luka Samanic",0,11,11,6,5,10
0,0,4,2,0,4,0,2,0,"12",3,1,0,7,0,1,1038071,"2024-01-05T00:00:00.000Z",2,FALSE,29,11891374,"C",29,29,"Utah Jazz","Omer Yurtseven",0,7,7,0,7,7.4
0,0,0,0,0,0,0,0,0,"00",0,0,0,0,0,0,1038071,"2024-01-05T00:00:00.000Z",2,FALSE,29,17896023,"G",29,29,"Utah Jazz","Josh Christopher",0,0,0,0,0,0
1,0,1,1,0,2,0,8,6,"14",0,3,6,1,1,0,1038071,"2024-01-05T00:00:00.000Z",2,FALSE,29,358,"F",29,29,"Utah Jazz","Kelly Olynyk",1,7,8,7,2,11.7
0,0,1,1,0,10,4,6,3,"12",0,1,11,1,2,0,1038071,"2024-01-05T00:00:00.000Z",2,FALSE,29,666650,"G",29,29,"Utah Jazz","Talen Horton-Tucker",2,12,12,11,1,18.2
3,1,2,2,1,11,7,0,0,"22",0,3,15,2,1,2,1038072,"2024-01-05T00:00:00.000Z",12,FALSE,1,3547250,"G-F",12,12,"Indiana Pacers","Aaron Nesmith",2,17,20,18,5,25.9
2,0,2,3,1,7,5,0,0,"23",0,2,11,2,0,0,1038072,"2024-01-05T00:00:00.000Z",12,FALSE,1,3547264,"F-C",12,12,"Indiana Pacers","Jalen Smith",0,13,15,13,4,16.4
3,1,3,3,2,14,10,5,5,"22",2,0,27,5,1,1,1038072,"2024-01-05T00:00:00.000Z",12,FALSE,1,452,"C-F",12,12,"Indiana Pacers","Myles Turner",2,32,35,30,8,42.5
2,0,3,1,1,9,8,0,0,"22",0,1,17,3,0,2,1038072,"2024-01-05T00:00:00.000Z",12,FALSE,1,69,"G",12,12,"Indiana Pacers","Bruce Brown",0,20,22,19,5,21.6
18,1,7,4,2,6,4,0,0,"25",1,1,10,8,2,2,1038072,"2024-01-05T00:00:00.000Z",12,FALSE,1,3547245,"G",12,12,"Indiana Pacers","Tyrese Haliburton",3,18,36,28,26,53.6
1,0,3,8,3,9,4,0,0,"17",0,4,11,3,0,1,1038072,"2024-01-05T00:00:00.000Z",12,FALSE,1,210,"G",12,12,"Indiana Pacers","Buddy Hield",0,14,15,12,4,15.1
4,0,2,4,2,9,6,4,4,"18",1,2,18,3,0,0,1038072,"2024-01-05T00:00:00.000Z",12,FALSE,1,38017686,"G-F",12,12,"Indiana Pacers","Bennedict Mathurin",0,21,25,22,7,27.6
10,0,1,0,0,6,5,0,0,"23",2,2,10,3,3,1,1038072,"2024-01-05T00:00:00.000Z",12,FALSE,1,304,"G",12,12,"Indiana Pacers","T.J. McConnell",3,13,23,20,13,36.6
2,0,3,5,3,6,3,0,0,"22",0,2,9,3,1,1,1038072,"2024-01-05T00:00:00.000Z",12,FALSE,1,3547243,"F",12,12,"Indiana Pacers","Obi Toppin",1,12,14,11,5,17.6
3,0,4,9,1,14,3,10,9,"23",0,2,16,4,2,3,1038072,"2024-01-05T00:00:00.000Z",12,FALSE,1,53,"G",1,1,"Atlanta Hawks","Bogdan Bogdanovic",2,20,23,19,7,28.3
0,1,2,0,0,2,2,2,2,"07",0,1,6,2,0,0,1038072,"2024-01-05T00:00:00.000Z",12,FALSE,1,666564,"F",1,1,"Atlanta Hawks","Bruno Fernando",1,8,8,6,2,11.4
2,0,2,1,0,4,2,2,2,"14",0,0,6,2,1,2,1038072,"2024-01-05T00:00:00.000Z",12,FALSE,1,3547297,"G",1,1,"Atlanta Hawks","Trent Forrest",1,8,10,8,4,12.4
0,0,0,3,1,3,1,0,0,"07",0,0,3,0,0,2,1038072,"2024-01-05T00:00:00.000Z",12,FALSE,1,38017689,"F",1,1,"Atlanta Hawks","AJ Griffin",0,3,3,3,0,1
0,0,0,2,1,2,1,0,0,"07",0,0,3,0,0,0,1038072,"2024-01-05T00:00:00.000Z",12,FALSE,1,56677855,"G",1,1,"Atlanta Hawks","Seth Lundy",0,3,3,3,0,3
2,0,2,3,2,3,2,0,0,"20",1,1,6,3,0,1,1038072,"2024-01-05T00:00:00.000Z",12,FALSE,1,666754,"G",1,1,"Atlanta Hawks","Garrison Mathews",0,9,11,8,5,11.6
0,0,0,0,0,0,0,0,0,"00",0,0,0,0,0,0,1038072,"2024-01-05T00:00:00.000Z",12,FALSE,1,301,"G-F",1,1,"Atlanta Hawks","Wesley Matthews",0,0,0,0,0,0
0,0,0,0,0,0,0,0,0,"00",0,0,0,0,0,0,1038072,"2024-01-05T00:00:00.000Z",12,FALSE,1,319,"G",1,1,"Atlanta Hawks","Patty Mills",0,0,0,0,0,0
1,1,2,0,0,1,1,2,1,"21",4,1,3,6,0,0,1038072,"2024-01-05T00:00:00.000Z",12,FALSE,1,3547244,"F-C",1,1,"Atlanta Hawks","Onyeka Okongwu",1,9,10,4,7,14.7
0,0,0,0,0,0,0,0,0,"00",0,0,0,0,0,0,1038072,"2024-01-05T00:00:00.000Z",12,FALSE,1,56677838,"G",1,1,"Atlanta Hawks","Kobe Bufkin",0,0,0,0,0,0
0,0,0,0,0,0,0,0,0,"00",0,0,0,0,0,0,1038072,"2024-01-05T00:00:00.000Z",12,FALSE,1,56677806,"F",1,1,"Atlanta Hawks","Mouhamed Gueye",0,0,0,0,0,0
0,0,0,0,0,0,0,0,0,"00",0,0,0,0,0,0,1038072,"2024-01-05T00:00:00.000Z",12,FALSE,1,666656,"F",1,1,"Atlanta Hawks","De'Andre Hunter",0,0,0,0,0,0
0,0,0,0,0,0,0,0,0,"00",0,0,0,0,0,0,1038072,"2024-01-05T00:00:00.000Z",12,FALSE,1,4197387,"G",1,1,"Atlanta Hawks","Vit Krejci",0,0,0,0,0,0
0,0,2,0,0,2,1,2,0,"07",1,3,2,3,0,1,1038072,"2024-01-05T00:00:00.000Z",12,FALSE,1,17896035,"F",12,12,"Indiana Pacers","Isaiah Jackson",0,5,5,2,3,4.6
1,0,1,1,0,3,1,0,0,"08",0,2,2,1,3,1,1038072,"2024-01-05T00:00:00.000Z",12,FALSE,1,242,"F",12,12,"Indiana Pacers","James Johnson",3,3,4,3,2,12.7
2,0,1,2,1,3,2,2,2,"10",0,1,7,1,0,1,1038072,"2024-01-05T00:00:00.000Z",12,FALSE,1,3547207,"F",12,12,"Indiana Pacers","Jordan Nwora",0,8,10,9,3,10.2
1,0,1,3,1,3,1,0,0,"09",0,0,3,1,1,0,1038072,"2024-01-05T00:00:00.000Z",12,FALSE,1,56677861,"G",12,12,"Indiana Pacers","Ben Sheppard",1,4,5,4,2,8.7
1,0,0,3,2,6,3,0,0,"12",1,1,8,1,0,1,1038072,"2024-01-05T00:00:00.000Z",12,FALSE,1,56677832,"F",12,12,"Indiana Pacers","Jarace Walker",0,9,10,9,2,9.7
0,0,0,0,0,0,0,0,0,"00",0,0,0,0,0,0,1038072,"2024-01-05T00:00:00.000Z",12,FALSE,1,38017701,"G",12,12,"Indiana Pacers","Kendall Brown",0,0,0,0,0,0
0,0,0,0,0,0,0,0,0,"00",0,0,0,0,0,0,1038072,"2024-01-05T00:00:00.000Z",12,FALSE,1,38017507,"G-F",12,12,"Indiana Pacers","Andrew Nembhard",0,0,0,0,0,0
0,0,0,0,0,0,0,0,0,"00",0,0,0,0,0,0,1038072,"2024-01-05T00:00:00.000Z",12,FALSE,1,56677778,"F-C",12,12,"Indiana Pacers","Oscar Tshiebwe",0,0,0,0,0,0
0,0,0,0,0,0,0,0,0,"00",0,0,0,0,0,0,1038072,"2024-01-05T00:00:00.000Z",12,FALSE,1,56677794,"G",12,12,"Indiana Pacers","Isaiah Wong",0,0,0,0,0,0
2,0,1,6,1,7,2,4,4,"30",3,1,9,4,0,1,1038072,"2024-01-05T00:00:00.000Z",12,FALSE,1,3547256,"F",1,1,"Atlanta Hawks","Saddiq Bey",0,13,15,11,6,15.8
3,0,7,4,1,11,5,1,1,"29",1,1,12,8,1,0,1038072,"2024-01-05T00:00:00.000Z",12,FALSE,1,17896040,"F",1,1,"Atlanta Hawks","Jalen Johnson",1,20,23,15,11,29.1
0,1,2,0,0,9,4,2,1,"20",5,2,9,7,0,1,1038072,"2024-01-05T00:00:00.000Z",12,FALSE,1,83,"C",1,1,"Atlanta Hawks","Clint Capela",1,16,16,9,7,19.4
2,0,1,3,2,19,13,2,2,"34",0,0,30,1,0,1,1038072,"2024-01-05T00:00:00.000Z",12,FALSE,1,334,"G",1,1,"Atlanta Hawks","Dejounte Murray",0,31,33,32,3,33.2
6,0,2,11,1,18,4,5,4,"28",0,2,13,2,2,3,1038072,"2024-01-05T00:00:00.000Z",12,FALSE,1,490,"G",1,1,"Atlanta Hawks","Trae Young",2,15,21,19,8,27.4
2,0,2,10,3,15,3,0,0,"32",1,4,9,3,1,0,1038073,"2024-01-05T00:00:00.000Z",3,FALSE,21,666679,"F",3,3,"Brooklyn Nets","Cameron Johnson",1,12,14,11,5,18.6
2,1,2,5,3,6,3,0,0,"22",1,4,9,3,1,0,1038073,"2024-01-05T00:00:00.000Z",3,FALSE,21,158,"F",3,3,"Brooklyn Nets","Dorian Finney-Smith",2,12,14,11,5,21.6
3,0,5,0,0,11,8,10,7,"34",8,1,23,13,1,3,1038073,"2024-01-05T00:00:00.000Z",3,FALSE,21,666508,"F-C",3,3,"Brooklyn Nets","Nicolas Claxton",1,36,39,26,16,43.1
3,1,7,5,0,13,5,8,7,"39",1,4,17,8,0,4,1038073,"2024-01-05T00:00:00.000Z",3,FALSE,21,61,"F",3,3,"Brooklyn Nets","Mikal Bridges",1,25,28,20,11,30.1
4,1,3,7,3,12,7,6,6,"33",0,3,23,3,0,2,1038073,"2024-01-05T00:00:00.000Z",3,FALSE,21,130,"G",3,3,"Brooklyn Nets","Spencer Dinwiddie",1,26,30,27,7,33.6
2,0,2,2,1,4,2,0,0,"16",2,3,5,4,1,5,1038073,"2024-01-05T00:00:00.000Z",3,FALSE,21,351,"F",3,3,"Brooklyn Nets","Royce O'Neale",1,9,11,7,6,10.8
2,0,1,0,0,3,1,4,4,"09",1,1,6,2,1,0,1038073,"2024-01-05T00:00:00.000Z",3,FALSE,21,17896038,"C",3,3,"Brooklyn Nets","Day'Ron Sharpe",1,8,10,8,4,14.4
7,0,6,4,1,11,6,0,0,"25",6,4,13,12,2,0,1038073,"2024-01-05T00:00:00.000Z",3,FALSE,21,421,"G",3,3,"Brooklyn Nets","Dennis Smith Jr.",2,25,32,20,19,43.9
0,0,2,5,3,14,6,5,4,"24",0,0,19,2,1,1,1038073,"2024-01-05T00:00:00.000Z",3,FALSE,21,17896048,"G",3,3,"Brooklyn Nets","Cam Thomas",1,21,21,19,2,23.4
0,0,1,1,0,2,0,0,0,"06",0,0,0,1,1,0,1038073,"2024-01-05T00:00:00.000Z",3,FALSE,21,464,"G",3,3,"Brooklyn Nets","Lonnie Walker IV",1,1,1,0,1,4.2
0,0,0,0,0,0,0,0,0,"00",0,0,0,0,0,0,1038073,"2024-01-05T00:00:00.000Z",3,FALSE,21,56677841,"F",3,3,"Brooklyn Nets","Dariq Whitehead",0,0,0,0,0,0
0,0,0,0,0,0,0,0,0,"00",0,0,0,0,0,0,1038073,"2024-01-05T00:00:00.000Z",3,FALSE,21,56677722,"F",3,3,"Brooklyn Nets","Jalen Wilson",0,0,0,0,0,0
3,0,2,5,2,8,5,0,0,"28",2,4,12,4,3,1,1038073,"2024-01-05T00:00:00.000Z",3,FALSE,21,666541,"G",21,21,"Oklahoma City Thunder","Luguentz Dort",3,16,19,15,7,29.3
5,1,5,4,2,11,8,3,2,"36",0,3,20,5,0,3,1038073,"2024-01-05T00:00:00.000Z",3,FALSE,21,38017703,"G-F",21,21,"Oklahoma City Thunder","Jalen Williams",1,25,30,25,10,33.5
3,1,3,4,0,15,8,2,1,"35",3,3,17,6,1,1,1038073,"2024-01-05T00:00:00.000Z",3,FALSE,21,38017685,"C-F",21,21,"Oklahoma City Thunder","Chet Holmgren",2,23,26,20,9,33.7
5,1,8,1,0,9,5,4,3,"24",0,3,13,8,1,2,1038073,"2024-01-05T00:00:00.000Z",3,FALSE,21,17896065,"G",21,21,"Oklahoma City Thunder","Josh Giddey",2,21,26,18,13,34.1
6,0,8,5,2,19,11,15,10,"36",1,5,34,9,0,2,1038073,"2024-01-05T00:00:00.000Z",3,FALSE,21,175,"G",21,21,"Oklahoma City Thunder","Shai Gilgeous-Alexander",0,43,49,40,15,51.8
0,0,0,1,0,1,0,0,0,"01",0,0,0,0,0,0,1038073,"2024-01-05T00:00:00.000Z",3,FALSE,21,44,"F",21,21,"Oklahoma City Thunder","Davis Bertans",0,0,0,0,0,0
1,1,1,3,1,5,1,0,0,"20",0,1,3,1,0,1,1038073,"2024-01-05T00:00:00.000Z",3,FALSE,21,3547272,"G",21,21,"Oklahoma City Thunder","Isaiah Joe",1,4,5,4,2,7.7
0,0,0,0,0,0,0,0,0,"00",0,0,0,0,0,0,1038073,"2024-01-05T00:00:00.000Z",3,FALSE,21,17896036,"G",21,21,"Oklahoma City Thunder","Tre Mann",0,0,0,0,0,0
3,1,0,1,0,4,3,0,0,"12",0,0,6,0,1,0,1038073,"2024-01-05T00:00:00.000Z",3,FALSE,21,4197029,"G",21,21,"Oklahoma City Thunder","Vasilije Micic",2,6,9,9,3,16.5
0,0,0,0,0,0,0,0,0,"00",0,0,0,0,0,0,1038073,"2024-01-05T00:00:00.000Z",3,FALSE,21,3547271,"C",21,21,"Oklahoma City Thunder","Aleksej Pokusevski",0,0,0,0,0,0
0,0,0,0,0,0,0,0,0,"00",0,0,0,0,0,0,1038073,"2024-01-05T00:00:00.000Z",3,FALSE,21,56677853,"F",21,21,"Oklahoma City Thunder","Keyontae Johnson",0,0,0,0,0,0
0,0,0,0,0,0,0,0,0,"00",0,0,0,0,0,0,1038073,"2024-01-05T00:00:00.000Z",3,FALSE,21,24572055,"C",21,21,"Oklahoma City Thunder","Olivier Sarr",0,0,0,0,0,0
0,0,0,0,0,0,0,0,0,"00",0,0,0,0,0,0,1038073,"2024-01-05T00:00:00.000Z",3,FALSE,21,38017716,"F",21,21,"Oklahoma City Thunder","Ousmane Dieng",0,0,0,0,0,0
0,0,1,4,2,7,3,0,0,"23",1,1,8,2,1,0,1038073,"2024-01-05T00:00:00.000Z",3,FALSE,21,56677833,"G",21,21,"Oklahoma City Thunder","Cason Wallace",1,10,10,8,2,13.4
0,0,0,1,0,1,0,0,0,"04",0,1,0,0,0,0,1038073,"2024-01-05T00:00:00.000Z",3,FALSE,21,27924547,"F",21,21,"Oklahoma City Thunder","Lindy Waters III",0,0,0,0,0,0
2,0,0,1,0,2,1,0,0,"08",0,2,2,0,0,0,1038073,"2024-01-05T00:00:00.000Z",3,FALSE,21,17896078,"G",21,21,"Oklahoma City Thunder","Aaron Wiggins",0,2,4,4,2,5
0,0,0,1,0,1,0,0,0,"02",0,1,0,0,0,0,1038073,"2024-01-05T00:00:00.000Z",3,FALSE,21,38017706,"F",21,21,"Oklahoma City Thunder","Jaylin Williams",0,0,0,0,0,0
1,0,1,0,0,1,0,0,0,"11",0,2,0,1,1,3,1038073,"2024-01-05T00:00:00.000Z",3,FALSE,21,480,"G-F",21,21,"Oklahoma City Thunder","Kenrich Williams",1,1,2,1,2,2.7
0,0,0,0,0,0,0,0,0,"00",0,0,0,0,0,0,1038073,"2024-01-05T00:00:00.000Z",3,FALSE,21,174,"F-C",3,3,"Brooklyn Nets","Harry Giles III",0,0,0,0,0,0
0,0,0,0,0,0,0,0,0,"00",0,0,0,0,0,0,1038073,"2024-01-05T00:00:00.000Z",3,FALSE,21,17896058,"F",3,3,"Brooklyn Nets","Trendon Watford",0,0,0,0,0,0
0,0,0,0,0,0,0,0,0,"00",0,0,0,0,0,0,1038073,"2024-01-05T00:00:00.000Z",3,FALSE,21,9051997,"G",3,3,"Brooklyn Nets","Armoni Brooks",0,0,0,0,0,0
0,0,0,0,0,0,0,0,0,"00",0,0,0,0,0,0,1038073,"2024-01-05T00:00:00.000Z",3,FALSE,21,56677843,"F",3,3,"Brooklyn Nets","Noah Clowney",0,0,0,0,0,0
0,0,0,0,0,0,0,0,0,"00",0,0,0,0,0,0,1038073,"2024-01-05T00:00:00.000Z",3,FALSE,21,17896041,"G",3,3,"Brooklyn Nets","Keon Johnson",0,0,0,0,0,0
0,0,0,0,0,0,0,0,0,"00",0,0,0,0,0,0,1038073,"2024-01-05T00:00:00.000Z",3,FALSE,21,417,"G-F",3,3,"Brooklyn Nets","Ben Simmons",0,0,0,0,0,0
0,0,2,0,0,5,2,6,4,"22",2,2,8,4,1,3,1038074,"2024-01-05T00:00:00.000Z",6,FALSE,30,3547247,"F-G",6,6,"Cleveland Cavaliers","Isaac Okoro",1,12,12,8,4,12.8
1,0,5,3,2,4,2,0,0,"22",0,0,6,5,1,0,1038074,"2024-01-05T00:00:00.000Z",6,FALSE,30,666940,"F",6,6,"Cleveland Cavaliers","Dean Wade",1,11,12,7,6,16.5
3,1,6,0,0,7,5,2,2,"28",6,2,12,12,2,4,1038074,"2024-01-05T00:00:00.000Z",6,FALSE,30,9,"C",6,6,"Cleveland Cavaliers","Jarrett Allen",3,24,27,15,15,35.9
3,0,5,3,1,6,4,0,0,"30",0,1,9,5,0,3,1038074,"2024-01-05T00:00:00.000Z",6,FALSE,30,666908,"G",6,6,"Cleveland Cavaliers","Max Strus",0,14,17,12,8,16.5
4,0,1,8,5,15,8,8,5,"26",1,2,26,2,1,3,1038074,"2024-01-05T00:00:00.000Z",6,FALSE,30,322,"G",6,6,"Cleveland Cavaliers","Donovan Mitchell",1,28,32,30,6,34.4
0,0,0,0,0,0,0,0,0,"00",0,0,0,0,0,0,1038074,"2024-01-05T00:00:00.000Z",6,FALSE,30,666676,"G",6,6,"Cleveland Cavaliers","Ty Jerome",0,0,0,0,0,0
0,0,1,0,0,1,1,0,0,"05",0,0,2,1,0,0,1038074,"2024-01-05T00:00:00.000Z",6,FALSE,30,248,"C",6,6,"Cleveland Cavaliers","Damian Jones",0,3,3,2,1,3.2
0,0,0,0,0,0,0,0,0,"00",0,0,0,0,0,0,1038074,"2024-01-05T00:00:00.000Z",6,FALSE,30,56677847,"F",6,6,"Cleveland Cavaliers","Emoni Bates",0,0,0,0,0,0
0,0,0,0,0,0,0,0,0,"00",0,0,0,0,0,0,1038074,"2024-01-05T00:00:00.000Z",6,FALSE,30,666581,"G",6,6,"Cleveland Cavaliers","Darius Garland",0,0,0,0,0,0
0,0,0,0,0,0,0,0,0,"00",0,0,0,0,0,0,1038074,"2024-01-05T00:00:00.000Z",6,FALSE,30,17896076,"F-C",6,6,"Cleveland Cavaliers","Evan Mobley",0,0,0,0,0,0
0,0,0,0,0,0,0,0,0,"00",0,0,0,0,0,0,1038074,"2024-01-05T00:00:00.000Z",6,FALSE,30,38017662,"F",6,6,"Cleveland Cavaliers","Isaiah Mobley",0,0,0,0,0,0
0,0,0,0,0,0,0,0,0,"00",0,0,0,0,0,0,1038074,"2024-01-05T00:00:00.000Z",6,FALSE,30,404,"G",6,6,"Cleveland Cavaliers","Ricky Rubio",0,0,0,0,0,0
4,1,5,1,0,8,5,4,3,"26",0,4,13,5,2,3,1038074,"2024-01-05T00:00:00.000Z",6,FALSE,30,3547242,"F",30,30,"Washington Wizards","Deni Avdija",3,18,22,17,9,31
2,0,1,4,1,14,4,0,0,"26",1,2,9,2,1,7,1038074,"2024-01-05T00:00:00.000Z",6,FALSE,30,265,"F",30,30,"Washington Wizards","Kyle Kuzma",1,11,13,11,4,10.4
1,1,4,0,0,2,1,2,2,"24",0,2,4,4,0,0,1038074,"2024-01-05T00:00:00.000Z",6,FALSE,30,666577,"F",30,30,"Washington Wizards","Daniel Gafford",1,8,9,5,5,13.3
11,0,4,2,1,7,3,4,4,"27",0,0,11,4,2,2,1038074,"2024-01-05T00:00:00.000Z",6,FALSE,30,277,"G",6,6,"Cleveland Cavaliers","Caris LeVert",2,15,26,22,15,36.3
2,0,2,9,3,12,4,0,0,"26",0,2,11,2,1,0,1038074,"2024-01-05T00:00:00.000Z",6,FALSE,30,3547299,"G",6,6,"Cleveland Cavaliers","Sam Merrill",1,13,15,13,4,19.4
1,0,9,8,4,9,5,0,0,"25",0,2,14,9,0,1,1038074,"2024-01-05T00:00:00.000Z",6,FALSE,30,344,"F",6,6,"Cleveland Cavaliers","Georges Niang",0,23,24,15,10,25.3
4,0,3,0,0,6,3,1,1,"12",1,2,7,4,1,5,1038074,"2024-01-05T00:00:00.000Z",6,FALSE,30,56677872,"G",6,6,"Cleveland Cavaliers","Craig Porter",1,11,15,11,8,15.8
2,0,2,0,0,5,4,2,0,"17",2,6,8,4,0,2,1038074,"2024-01-05T00:00:00.000Z",6,FALSE,30,444,"C-F",6,6,"Cleveland Cavaliers","Tristan Thompson",0,12,14,10,6,13.8
1,1,0,2,0,4,0,2,2,"23",0,4,2,0,0,0,1038074,"2024-01-05T00:00:00.000Z",6,FALSE,30,666848,"G",30,30,"Washington Wizards","Jordan Poole",1,2,3,3,1,6.5
5,0,1,6,4,10,6,0,0,"26",0,0,16,1,2,1,1038074,"2024-01-05T00:00:00.000Z",6,FALSE,30,249,"G",30,30,"Washington Wizards","Tyus Jones",2,17,22,21,6,29.7
2,1,0,0,0,2,1,0,0,"06",0,0,2,0,0,0,1038074,"2024-01-05T00:00:00.000Z",6,FALSE,30,18677954,"G",30,30,"Washington Wizards","Jared Butler",1,2,4,4,2,8
1,3,5,4,2,13,6,3,1,"36",2,0,15,7,1,1,1038074,"2024-01-05T00:00:00.000Z",6,FALSE,30,56677844,"G",30,30,"Washington Wizards","Bilal Coulibaly",4,22,23,16,8,35.9
0,0,0,0,0,2,0,0,0,"06",1,0,0,1,0,0,1038074,"2024-01-05T00:00:00.000Z",6,FALSE,30,38017687,"G",30,30,"Washington Wizards","Johnny Davis",0,1,1,0,1,1.2
0,0,0,0,0,0,0,0,0,"00",0,0,0,0,0,0,1038074,"2024-01-05T00:00:00.000Z",6,FALSE,30,167,"F",30,30,"Washington Wizards","Danilo Gallinari",0,0,0,0,0,0
0,0,0,1,0,3,0,2,1,"05",1,1,1,1,0,0,1038074,"2024-01-05T00:00:00.000Z",6,FALSE,30,3547302,"F",30,30,"Washington Wizards","Anthony Gill",0,2,2,1,1,2.2
1,1,1,6,1,12,6,0,0,"20",0,2,13,1,0,2,1038074,"2024-01-05T00:00:00.000Z",6,FALSE,30,17896045,"F",30,30,"Washington Wizards","Corey Kispert",1,14,15,14,2,16.7
0,0,5,2,0,3,0,0,0,"18",1,2,0,6,0,1,1038074,"2024-01-05T00:00:00.000Z",6,FALSE,30,337,"F-C",30,30,"Washington Wizards","Mike Muscala",0,6,6,0,6,6.2
0,0,0,1,0,5,3,2,2,"07",1,2,8,1,1,0,1038074,"2024-01-05T00:00:00.000Z",6,FALSE,30,17896106,"F",30,30,"Washington Wizards","Eugene Omoruyi",1,9,9,8,1,12.2
2,0,2,3,1,6,3,0,0,"17",0,0,7,2,5,1,1038074,"2024-01-05T00:00:00.000Z",6,FALSE,30,487,"G",30,30,"Washington Wizards","Delon Wright",5,9,11,9,4,26.4
0,0,0,0,0,0,0,0,0,"00",0,0,0,0,0,0,1038074,"2024-01-05T00:00:00.000Z",6,FALSE,30,38017704,"F",30,30,"Washington Wizards","Patrick Baldwin Jr.",0,0,0,0,0,0
0,0,0,0,0,0,0,0,0,"00",0,0,0,0,0,0,1038074,"2024-01-05T00:00:00.000Z",6,FALSE,30,NA,NA,NA,30,"Washington Wizards","NA NA",0,0,0,0,0,0
0,0,0,0,0,0,0,0,0,"00",0,0,0,0,0,0,1038074,"2024-01-05T00:00:00.000Z",6,FALSE,30,38017712,"G",30,30,"Washington Wizards","Ryan Rollins",0,0,0,0,0,0
0,0,0,0,0,0,0,0,0,"00",0,0,0,0,0,0,1038074,"2024-01-05T00:00:00.000Z",6,FALSE,30,414,"G",30,30,"Washington Wizards","Landry Shamet",0,0,0,0,0,0
1,1,3,1,0,2,0,0,0,"21",1,2,0,4,0,2,1038075,"2024-01-05T00:00:00.000Z",23,FALSE,20,33,"F-G",23,23,"Philadelphia 76ers","Nicolas Batum",1,4,5,1,5,7.3
4,0,3,2,1,6,2,1,0,"24",0,2,5,3,0,0,1038075,"2024-01-05T00:00:00.000Z",23,FALSE,20,200,"F",23,23,"Philadelphia 76ers","Tobias Harris",0,8,12,9,7,14.6
3,3,7,1,1,23,10,12,9,"36",3,3,30,10,1,6,1038075,"2024-01-05T00:00:00.000Z",23,FALSE,20,145,"F-C",23,23,"Philadelphia 76ers","Joel Embiid",4,40,43,33,13,52.5
1,3,5,6,3,12,6,0,0,"31",2,2,15,7,0,3,1038075,"2024-01-05T00:00:00.000Z",23,FALSE,20,360,"F",23,23,"Philadelphia 76ers","Kelly Oubre Jr.",3,22,23,16,8,30.9
9,1,3,7,1,20,9,10,8,"37",1,1,27,4,2,1,1038075,"2024-01-05T00:00:00.000Z",23,FALSE,20,3547254,"G",23,23,"Philadelphia 76ers","Tyrese Maxey",3,31,40,36,13,53.3
1,0,2,0,0,1,1,0,0,"05",0,0,2,2,2,0,1038075,"2024-01-05T00:00:00.000Z",23,FALSE,20,28,"C",23,23,"Philadelphia 76ers","Mo Bamba",2,4,5,3,3,11.9
0,0,2,1,0,1,0,2,2,"14",0,2,2,2,1,2,1038075,"2024-01-05T00:00:00.000Z",23,FALSE,20,45,"G",23,23,"Philadelphia 76ers","Patrick Beverley",1,4,4,2,2,5.4
1,0,4,1,0,3,1,0,0,"22",0,1,2,4,1,0,1038075,"2024-01-05T00:00:00.000Z",23,FALSE,20,2175,"",23,23,"Philadelphia 76ers","Danuel House Jr.",1,6,7,3,5,11.3
0,0,0,0,0,0,0,0,0,"07",0,2,0,0,0,0,1038075,"2024-01-05T00:00:00.000Z",23,FALSE,20,3547294,"F",23,23,"Philadelphia 76ers","Kenyon Martin Jr.",0,0,0,0,0,0
1,0,0,1,0,1,0,0,0,"16",0,0,0,0,0,0,1038075,"2024-01-05T00:00:00.000Z",23,FALSE,20,328,"F",23,23,"Philadelphia 76ers","Marcus Morris",0,0,1,1,1,1.5
0,0,1,0,0,5,3,0,0,"12",0,2,6,1,0,0,1038075,"2024-01-05T00:00:00.000Z",23,FALSE,20,3547270,"F",23,23,"Philadelphia 76ers","Paul Reed",0,7,7,6,1,7.2
1,1,0,3,0,7,1,2,1,"15",1,1,3,1,1,0,1038075,"2024-01-05T00:00:00.000Z",23,FALSE,20,17896025,"G",23,23,"Philadelphia 76ers","Jaden Springer",2,4,5,4,2,11.7
0,0,0,0,0,0,0,0,0,"00",0,0,0,0,0,0,1038075,"2024-01-05T00:00:00.000Z",23,FALSE,20,56913527,"G",23,23,"Philadelphia 76ers","Ricky Council IV",0,0,0,0,0,0
0,0,0,0,0,0,0,0,0,"00",0,0,0,0,0,0,1038075,"2024-01-05T00:00:00.000Z",23,FALSE,20,108,"F",23,23,"Philadelphia 76ers","Robert Covington",0,0,0,0,0,0
0,0,0,0,0,0,0,0,0,"00",0,0,0,0,0,0,1038075,"2024-01-05T00:00:00.000Z",23,FALSE,20,260,"G-F",23,23,"Philadelphia 76ers","Furkan Korkmaz",0,0,0,0,0,0
0,0,0,0,0,0,0,0,0,"00",0,0,0,0,0,0,1038075,"2024-01-05T00:00:00.000Z",23,FALSE,20,38017732,"F",15,23,"Philadelphia 76ers","Kenneth Lofton Jr.",0,0,0,0,0,0
0,0,0,0,0,0,0,0,0,"00",0,0,0,0,0,0,1038075,"2024-01-05T00:00:00.000Z",23,FALSE,20,313,"G",23,23,"Philadelphia 76ers","De'Anthony Melton",0,0,0,0,0,0
0,0,0,0,0,0,0,0,0,"00",0,0,0,0,0,0,1038075,"2024-01-05T00:00:00.000Z",23,FALSE,20,56677788,"G",23,23,"Philadelphia 76ers","Terquavion Smith",0,0,0,0,0,0
0,0,1,3,1,11,3,4,4,"37",1,3,11,2,1,0,1038075,"2024-01-05T00:00:00.000Z",23,FALSE,20,18,"F",28,20,"New York Knicks","OG Anunoby",1,13,13,11,2,16.4
5,1,7,3,0,11,1,6,6,"30",0,3,8,7,1,4,1038075,"2024-01-05T00:00:00.000Z",23,FALSE,20,387,"F",20,20,"New York Knicks","Julius Randle",2,15,20,13,12,25.9
5,2,5,0,0,9,8,2,1,"35",1,4,17,6,2,1,1038075,"2024-01-05T00:00:00.000Z",23,FALSE,20,201,"F-C",20,20,"New York Knicks","Isaiah Hartenstein",4,23,28,22,11,42.7
3,0,1,6,4,6,4,2,2,"17",1,4,14,2,1,2,1038075,"2024-01-05T00:00:00.000Z",23,FALSE,20,131,"G",20,20,"New York Knicks","Donte DiVincenzo",1,16,19,17,5,21.9
2,1,3,9,4,20,11,3,3,"32",0,1,29,3,1,0,1038075,"2024-01-05T00:00:00.000Z",23,FALSE,20,73,"G",20,20,"New York Knicks","Jalen Brunson",2,32,34,31,5,41.6
0,1,1,2,1,3,2,0,0,"13",2,0,5,3,0,1,1038075,"2024-01-05T00:00:00.000Z",23,FALSE,20,3547249,"F",28,20,"New York Knicks","Precious Achiuwa",1,8,8,5,3,10.6
0,0,1,1,0,1,0,0,0,"04",0,1,0,1,0,0,1038075,"2024-01-05T00:00:00.000Z",23,FALSE,20,19,"G",20,20,"New York Knicks","Ryan Arcidiacono",0,1,1,0,1,1.2
0,0,1,0,0,0,0,0,0,"01",0,0,0,1,0,0,1038075,"2024-01-05T00:00:00.000Z",23,FALSE,20,3547275,"G",28,20,"New York Knicks","Malachi Flynn",0,1,1,0,1,1.2
2,1,6,9,4,13,6,3,3,"24",2,3,19,8,1,1,1038075,"2024-01-05T00:00:00.000Z",23,FALSE,20,17895858,"G",20,20,"New York Knicks","Quentin Grimes",2,27,29,21,10,36.6
6,1,12,2,0,7,4,2,2,"30",3,2,10,15,0,2,1038075,"2024-01-05T00:00:00.000Z",23,FALSE,20,202,"G",20,20,"New York Knicks","Josh Hart",1,25,31,16,21,38
4,0,1,6,4,8,4,3,3,"15",0,1,15,1,0,0,1038075,"2024-01-05T00:00:00.000Z",23,FALSE,20,17896033,"G",20,20,"New York Knicks","Miles McBride",0,16,20,19,5,22.2
0,0,0,0,0,0,0,0,0,"00",0,0,0,0,0,0,1038075,"2024-01-05T00:00:00.000Z",23,FALSE,20,666474,"G",20,20,"New York Knicks","Charles Brown",0,0,0,0,0,0
0,0,0,0,0,0,0,0,0,"00",0,0,0,0,0,0,1038075,"2024-01-05T00:00:00.000Z",23,FALSE,20,399,"C",20,20,"New York Knicks","Mitchell Robinson",0,0,0,0,0,0
0,0,0,0,0,0,0,0,0,"00",0,0,0,0,0,0,1038075,"2024-01-05T00:00:00.000Z",23,FALSE,20,56677795,"F",20,20,"New York Knicks","Jacob Toppin",0,0,0,0,0,0
0,0,0,0,0,0,0,0,0,"00",0,0,0,0,0,0,1038075,"2024-01-05T00:00:00.000Z",23,FALSE,20,17896089,"G",20,20,"New York Knicks","Duane Washington Jr.",0,0,0,0,0,0
0,0,0,0,0,0,0,0,0,"00",0,0,0,0,0,0,1038075,"2024-01-05T00:00:00.000Z",23,FALSE,20,160,"G-F",20,20,"New York Knicks","Evan Fournier",0,0,0,0,0,0
0,0,0,0,0,0,0,0,0,"00",0,0,0,0,0,0,1038075,"2024-01-05T00:00:00.000Z",23,FALSE,20,173,"F",30,20,"New York Knicks","Taj Gibson",0,0,0,0,0,0
0,0,0,0,0,0,0,0,0,"02",0,0,0,0,0,0,1038075,"2024-01-05T00:00:00.000Z",23,FALSE,20,17896063,"F",20,20,"New York Knicks","Jericho Sims",0,0,0,0,0,0
4,0,1,4,2,5,3,0,0,"21",0,2,8,1,2,0,1038076,"2024-01-05T00:00:00.000Z",5,FALSE,4,38017719,"F",5,5,"Chicago Bulls","Dalen Terry",2,9,13,12,5,21.2
6,0,1,2,0,10,6,5,5,"38",0,4,17,1,3,3,1038076,"2024-01-05T00:00:00.000Z",5,FALSE,4,125,"G",5,5,"Chicago Bulls","DeMar DeRozan",3,18,24,23,7,33.2
0,3,7,0,0,7,3,2,1,"23",3,1,7,10,1,2,1038076,"2024-01-05T00:00:00.000Z",5,FALSE,4,137,"C",5,5,"Chicago Bulls","Andre Drummond",4,17,17,7,10,29
4,2,5,3,2,9,5,0,0,"40",0,2,12,5,1,0,1038076,"2024-01-05T00:00:00.000Z",5,FALSE,4,17895983,"G",5,5,"Chicago Bulls","Ayo Dosunmu",3,17,21,16,9,33
6,0,9,6,3,12,7,6,5,"40",1,1,22,10,0,5,1038076,"2024-01-05T00:00:00.000Z",5,FALSE,4,666956,"G",5,5,"Chicago Bulls","Coby White",0,32,38,28,16,38
4,0,5,5,1,11,6,3,2,"30",0,1,15,5,0,2,1038076,"2024-01-05T00:00:00.000Z",5,FALSE,4,268,"G",5,5,"Chicago Bulls","Zach LaVine",0,20,24,19,9,25
3,0,7,5,1,12,5,0,0,"25",0,3,11,7,0,1,1038076,"2024-01-05T00:00:00.000Z",5,FALSE,4,460,"C",5,5,"Chicago Bulls","Nikola Vucevic",0,18,21,14,10,22.9
0,0,0,0,0,0,0,0,0,"00",0,0,0,0,0,0,1038076,"2024-01-05T00:00:00.000Z",5,FALSE,4,27,"G",5,5,"Chicago Bulls","Lonzo Ball",0,0,0,0,0,0
0,0,0,0,0,0,0,0,0,"00",0,0,0,0,0,0,1038076,"2024-01-05T00:00:00.000Z",5,FALSE,4,56677874,"F",5,5,"Chicago Bulls","Onuralp Bitim",0,0,0,0,0,0
0,0,0,0,0,0,0,0,0,"00",0,0,0,0,0,0,1038076,"2024-01-05T00:00:00.000Z",5,FALSE,4,NA,NA,NA,5,"Chicago Bulls","NA NA",0,0,0,0,0,0
0,0,0,0,0,0,0,0,0,"00",0,0,0,0,0,0,1038076,"2024-01-05T00:00:00.000Z",5,FALSE,4,56677860,"F",5,5,"Chicago Bulls","Adama Sanogo",0,0,0,0,0,0
0,0,0,0,0,0,0,0,0,"00",0,0,0,0,0,0,1038076,"2024-01-05T00:00:00.000Z",5,FALSE,4,3547248,"F",5,5,"Chicago Bulls","Patrick Williams",0,0,0,0,0,0
2,0,3,7,3,11,5,0,0,"36",2,4,13,5,2,1,1038076,"2024-01-05T00:00:00.000Z",5,FALSE,4,666748,"F",4,4,"Charlotte Hornets","Cody Martin",2,18,20,15,7,27
2,0,5,7,3,18,12,2,1,"42",0,1,28,5,0,2,1038076,"2024-01-05T00:00:00.000Z",5,FALSE,4,62,"F",4,4,"Charlotte Hornets","Miles Bridges",0,33,35,30,7,35
1,0,7,0,0,6,2,2,0,"27",5,4,4,12,0,2,1038076,"2024-01-05T00:00:00.000Z",5,FALSE,4,3547282,"C",4,4,"Charlotte Hornets","Nick Richards",0,16,17,5,13,17.9
1,0,3,7,1,13,3,2,2,"23",0,3,9,3,1,0,1038076,"2024-01-05T00:00:00.000Z",5,FALSE,4,56677823,"F",4,4,"Charlotte Hornets","Brandon Miller",1,12,13,10,4,17.1
7,0,3,7,1,17,5,4,4,"36",1,2,15,4,1,3,1038076,"2024-01-05T00:00:00.000Z",5,FALSE,4,403,"G",4,4,"Charlotte Hornets","Terry Rozier",1,19,26,22,11,30.3
0,0,0,1,0,4,0,0,0,"05",2,0,0,2,0,1,1038076,"2024-01-05T00:00:00.000Z",5,FALSE,4,38017708,"G",4,4,"Charlotte Hornets","Bryce McGowens",0,2,2,0,2,1.4
0,1,2,0,0,1,1,2,2,"17",0,4,4,2,1,1,1038076,"2024-01-05T00:00:00.000Z",5,FALSE,4,NA,NA,NA,4,"Charlotte Hornets","NA NA",2,6,6,4,2,11.4
4,0,1,2,0,9,3,0,0,"16",1,1,6,2,1,0,1038076,"2024-01-05T00:00:00.000Z",5,FALSE,4,422,"G",4,4,"Charlotte Hornets","Ish Smith",1,8,12,10,6,17.4
0,0,2,2,2,6,4,0,0,"16",0,0,10,2,1,1,1038076,"2024-01-05T00:00:00.000Z",5,FALSE,4,56677846,"G",4,4,"Charlotte Hornets","Nick Smith Jr.",1,12,12,10,2,14.4
1,0,2,0,0,2,1,0,0,"16",0,1,2,2,0,0,1038076,"2024-01-05T00:00:00.000Z",5,FALSE,4,18678001,"F",4,4,"Charlotte Hornets","JT Thor",0,4,5,3,3,5.9
2,0,2,1,0,2,0,0,0,"06",1,0,0,3,0,0,1038076,"2024-01-05T00:00:00.000Z",5,FALSE,4,666950,"F",4,4,"Charlotte Hornets","P.J. Washington",0,3,5,2,5,6.6
0,0,0,0,0,0,0,0,0,"00",0,0,0,0,0,0,1038076,"2024-01-05T00:00:00.000Z",5,FALSE,4,56677848,"G",4,4,"Charlotte Hornets","Amari Bailey",0,0,0,0,0,0
0,0,0,0,0,0,0,0,0,"00",0,0,0,0,0,0,1038076,"2024-01-05T00:00:00.000Z",5,FALSE,4,3547239,"G",4,4,"Charlotte Hornets","LaMelo Ball",0,0,0,0,0,0
0,0,0,0,0,0,0,0,0,"00",0,0,0,0,0,0,1038076,"2024-01-05T00:00:00.000Z",5,FALSE,4,56677866,"F",4,4,"Charlotte Hornets","Leaky Black",0,0,0,0,0,0
0,0,0,0,0,0,0,0,0,"00",0,0,0,0,0,0,1038076,"2024-01-05T00:00:00.000Z",5,FALSE,4,204,"F",4,4,"Charlotte Hornets","Gordon Hayward",0,0,0,0,0,0
0,0,0,0,0,0,0,0,0,"00",0,0,0,0,0,0,1038076,"2024-01-05T00:00:00.000Z",5,FALSE,4,347,"G",4,4,"Charlotte Hornets","Frank Ntilikina",0,0,0,0,0,0
0,0,0,0,0,0,0,0,0,"00",0,0,0,0,0,0,1038076,"2024-01-05T00:00:00.000Z",5,FALSE,4,38017698,"C",4,4,"Charlotte Hornets","Mark Williams",0,0,0,0,0,0
2,0,2,2,1,5,3,0,0,"14",0,1,7,2,0,0,1038076,"2024-01-05T00:00:00.000Z",5,FALSE,4,87,"G",5,5,"Chicago Bulls","Jevon Carter",0,9,11,9,4,12.4
0,1,0,1,0,3,2,1,1,"09",0,2,5,0,0,1,1038076,"2024-01-05T00:00:00.000Z",5,FALSE,4,17896116,"G",5,5,"Chicago Bulls","Terry Taylor",1,5,5,5,0,7
0,0,0,0,0,0,0,0,0,"00",0,0,0,0,0,0,1038076,"2024-01-05T00:00:00.000Z",5,FALSE,4,89,"G",5,5,"Chicago Bulls","Alex Caruso",0,0,0,0,0,0
0,0,0,0,0,0,0,0,0,"00",0,0,0,0,0,0,1038076,"2024-01-05T00:00:00.000Z",5,FALSE,4,110,"F",5,5,"Chicago Bulls","Torrey Craig",0,0,0,0,0,0
0,0,0,0,0,0,0,0,0,"00",0,0,0,0,0,0,1038076,"2024-01-05T00:00:00.000Z",5,FALSE,4,56677857,"F",5,5,"Chicago Bulls","Julian Phillips",0,0,0,0,0,0
0,0,0,0,0,0,0,0,0,"00",0,0,0,0,0,0,1038076,"2024-01-05T00:00:00.000Z",5,FALSE,4,17896037,"G",4,4,"Charlotte Hornets","James Bouknight",0,0,0,0,0,0
2,0,3,1,0,1,0,0,0,"21",0,1,0,3,1,0,1038077,"2024-01-05T00:00:00.000Z",11,FALSE,18,3547301,"F",11,11,"Houston Rockets","Jae'Sean Tate",1,3,5,2,5,9.6
2,0,8,5,3,13,6,2,1,"32",1,3,16,9,0,4,1038077,"2024-01-05T00:00:00.000Z",11,FALSE,18,38017684,"F",11,11,"Houston Rockets","Jabari Smith Jr.",0,25,27,18,11,25.8
1,0,4,1,0,17,8,3,3,"33",1,3,19,5,0,2,1038077,"2024-01-05T00:00:00.000Z",11,FALSE,18,17896062,"F-C",11,11,"Houston Rockets","Alperen Sengun",0,24,25,20,6,24.5
2,0,4,8,4,16,7,4,2,"31",1,1,20,5,0,2,1038077,"2024-01-05T00:00:00.000Z",11,FALSE,18,17895966,"G",11,11,"Houston Rockets","Jalen Green",0,25,27,22,7,27
8,1,1,5,2,9,2,1,1,"31",0,0,7,1,1,1,1038077,"2024-01-05T00:00:00.000Z",11,FALSE,18,458,"G",11,11,"Houston Rockets","Fred VanVleet",2,8,16,15,9,25.2
0,0,1,2,1,4,2,0,0,"08",0,1,5,1,0,0,1038077,"2024-01-05T00:00:00.000Z",11,FALSE,18,75,"G-F",11,11,"Houston Rockets","Reggie Bullock",0,6,6,5,1,6.2
0,0,0,2,0,4,2,0,0,"21",1,2,4,1,0,0,1038077,"2024-01-05T00:00:00.000Z",11,FALSE,18,188,"F",11,11,"Houston Rockets","Jeff Green",0,5,5,4,1,5.2
0,0,0,0,0,0,0,0,0,"00",0,0,0,0,0,0,1038077,"2024-01-05T00:00:00.000Z",11,FALSE,18,38017695,"F",11,11,"Houston Rockets","Tari Eason",0,0,0,0,0,0
0,0,0,0,0,0,0,0,0,"00",0,0,0,0,0,0,1038077,"2024-01-05T00:00:00.000Z",11,FALSE,18,3547281,"G-F",11,11,"Houston Rockets","Nate Hinton",0,0,0,0,0,0
0,0,0,0,0,0,0,0,0,"00",0,0,0,0,0,0,1038077,"2024-01-05T00:00:00.000Z",11,FALSE,18,357,"G",11,11,"Houston Rockets","Victor Oladipo",0,0,0,0,0,0
0,0,0,0,0,0,0,0,0,"00",0,0,0,0,0,0,1038077,"2024-01-05T00:00:00.000Z",11,FALSE,18,56677809,"F",11,11,"Houston Rockets","Jermaine Samuels Jr.",0,0,0,0,0,0
0,0,0,0,0,0,0,0,0,"00",0,0,0,0,0,0,1038077,"2024-01-05T00:00:00.000Z",11,FALSE,18,47738533,"G",11,11,"Houston Rockets","Jeenathan Williams",0,0,0,0,0,0
0,0,3,3,2,10,7,0,0,"30",0,1,16,3,1,0,1038077,"2024-01-05T00:00:00.000Z",11,FALSE,18,3547259,"F",18,18,"Minnesota Timberwolves","Jaden McDaniels",1,19,19,16,3,22.6
6,1,6,4,1,17,8,5,5,"31",2,2,22,8,0,4,1038077,"2024-01-05T00:00:00.000Z",11,FALSE,18,447,"C",18,18,"Minnesota Timberwolves","Karl-Anthony Towns",1,30,36,28,14,39.6
1,2,9,0,0,7,6,3,1,"33",3,2,13,12,2,1,1038077,"2024-01-05T00:00:00.000Z",11,FALSE,18,176,"C",18,18,"Minnesota Timberwolves","Rudy Gobert",4,25,26,14,13,39.9
5,0,3,5,2,17,8,6,6,"33",0,2,24,3,2,5,1038077,"2024-01-05T00:00:00.000Z",11,FALSE,18,3547238,"G",18,18,"Minnesota Timberwolves","Anthony Edwards",2,27,32,29,8,36.1
5,0,2,5,2,8,3,0,0,"25",0,3,8,2,0,0,1038077,"2024-01-05T00:00:00.000Z",11,FALSE,18,104,"G",18,18,"Minnesota Timberwolves","Mike Conley",0,10,15,13,7,17.9
3,2,2,4,2,6,4,2,1,"17",1,2,11,3,2,0,1038077,"2024-01-05T00:00:00.000Z",11,FALSE,18,666400,"G",18,18,"Minnesota Timberwolves","Nickeil Alexander-Walker",4,14,17,14,6,31.1
5,0,6,0,0,4,1,0,0,"18",1,3,2,7,3,2,1038077,"2024-01-05T00:00:00.000Z",11,FALSE,18,12,"F",18,18,"Minnesota Timberwolves","Kyle Anderson",3,9,14,7,12,24.9
1,0,1,2,1,2,1,0,0,"03",0,0,3,1,0,0,1038077,"2024-01-05T00:00:00.000Z",11,FALSE,18,68,"F",18,18,"Minnesota Timberwolves","Troy Brown Jr.",0,4,5,4,2,5.7
0,0,0,2,0,4,1,0,0,"03",1,1,2,1,0,1,1038077,"2024-01-05T00:00:00.000Z",11,FALSE,18,17896056,"C",18,18,"Minnesota Timberwolves","Luka Garza",0,3,3,2,1,2.2
3,0,3,1,1,1,1,0,0,"13",0,0,3,3,2,0,1038077,"2024-01-05T00:00:00.000Z",11,FALSE,18,666767,"G",18,18,"Minnesota Timberwolves","Jordan McLaughlin",2,6,9,6,6,17.1
0,0,0,0,0,0,0,0,0,"00",0,0,0,0,0,0,1038077,"2024-01-05T00:00:00.000Z",11,FALSE,18,56677782,"F",18,18,"Minnesota Timberwolves","Leonard Miller",0,0,0,0,0,0
0,0,0,1,0,1,0,0,0,"03",0,1,0,0,0,1,1038077,"2024-01-05T00:00:00.000Z",11,FALSE,18,320,"G",18,18,"Minnesota Timberwolves","Shake Milton",0,0,0,0,0,-1
0,0,0,0,0,0,0,2,2,"03",0,0,2,0,0,0,1038077,"2024-01-05T00:00:00.000Z",11,FALSE,18,38017715,"F",18,18,"Minnesota Timberwolves","Josh Minott",0,2,2,2,0,2
0,1,2,0,0,0,0,0,0,"03",0,0,0,2,0,0,1038077,"2024-01-05T00:00:00.000Z",11,FALSE,18,38017700,"G",18,18,"Minnesota Timberwolves","Wendell Moore Jr.",1,2,2,0,2,5.4
2,1,6,6,3,11,6,2,1,"25",1,1,16,7,0,0,1038077,"2024-01-05T00:00:00.000Z",11,FALSE,18,667378,"F-C",18,18,"Minnesota Timberwolves","Naz Reid",1,23,25,18,9,30.4
0,0,0,0,0,0,0,0,0,"00",0,0,0,0,0,0,1038077,"2024-01-05T00:00:00.000Z",11,FALSE,18,56677851,"G",18,18,"Minnesota Timberwolves","Jaylen Clark",0,0,0,0,0,0
0,0,1,0,0,3,1,0,0,"04",2,0,2,3,0,0,1038077,"2024-01-05T00:00:00.000Z",11,FALSE,18,296,"C",11,11,"Houston Rockets","Boban Marjanovic",0,5,5,2,3,5.6
1,0,5,2,0,9,2,3,2,"20",1,3,6,6,3,2,1038077,"2024-01-05T00:00:00.000Z",11,FALSE,18,56677825,"G-F",11,11,"Houston Rockets","Amen Thompson",3,12,13,7,7,21.7
0,0,2,4,1,10,4,2,2,"15",0,1,11,2,2,4,1038077,"2024-01-05T00:00:00.000Z",11,FALSE,18,56677831,"F",11,11,"Houston Rockets","Cam Whitmore",2,13,13,11,2,15.4
0,0,0,0,0,0,0,0,0,"00",0,0,0,0,0,0,1038077,"2024-01-05T00:00:00.000Z",11,FALSE,18,66,"G-F",11,11,"Houston Rockets","Dillon Brooks",0,0,0,0,0,0
2,0,2,1,1,3,2,0,0,"19",0,0,5,2,0,0,1038077,"2024-01-05T00:00:00.000Z",11,FALSE,18,213,"G",11,11,"Houston Rockets","Aaron Holiday",0,7,9,7,4,10.4
0,1,0,1,0,1,0,0,0,"05",0,0,0,0,0,0,1038077,"2024-01-05T00:00:00.000Z",11,FALSE,18,19465326,"C",11,11,"Houston Rockets","Jock Landale",1,0,0,0,0,3
0,0,0,0,0,0,0,0,0,"00",0,0,0,0,0,0,1038077,"2024-01-05T00:00:00.000Z",11,FALSE,18,17895968,"F",18,18,"Minnesota Timberwolves","Daishen Nix",0,0,0,0,0,0
4,0,1,1,0,9,3,7,6,"30",0,2,12,1,0,2,1038078,"2024-01-05T00:00:00.000Z",19,FALSE,13,227,"F",19,19,"New Orleans Pelicans","Brandon Ingram",0,13,17,16,5,17.2
1,1,4,0,0,9,3,8,6,"19",2,3,12,6,1,1,1038078,"2024-01-05T00:00:00.000Z",19,FALSE,13,666969,"F",19,19,"New Orleans Pelicans","Zion Williamson",2,18,19,13,7,25.7
1,1,7,1,1,12,6,0,0,"23",4,2,13,11,0,3,1038078,"2024-01-05T00:00:00.000Z",19,FALSE,13,455,"C",19,19,"New Orleans Pelicans","Jonas Valanciunas",1,24,25,14,12,27.7
2,1,0,2,1,6,3,2,2,"25",0,1,9,0,1,0,1038078,"2024-01-05T00:00:00.000Z",19,FALSE,13,17896024,"F",19,19,"New Orleans Pelicans","Herbert Jones",2,9,11,11,2,18
3,0,5,9,4,13,4,0,0,"31",1,3,12,6,1,1,1038078,"2024-01-05T00:00:00.000Z",19,FALSE,13,303,"G",19,19,"New Orleans Pelicans","CJ McCollum",1,18,21,15,9,25.7
2,2,1,2,0,7,1,0,0,"19",0,0,2,1,0,0,1038078,"2024-01-05T00:00:00.000Z",19,FALSE,13,17896097,"G",19,19,"New Orleans Pelicans","Jose Alvarado",2,3,5,4,3,12.2
3,0,3,1,0,4,1,2,0,"26",0,1,2,3,4,0,1038078,"2024-01-05T00:00:00.000Z",19,FALSE,13,38017677,"G",19,19,"New Orleans Pelicans","Dyson Daniels",4,5,8,5,6,22.1
1,1,2,6,1,9,1,0,0,"17",0,0,3,2,0,0,1038078,"2024-01-05T00:00:00.000Z",19,FALSE,13,18677986,"F",19,19,"New Orleans Pelicans","Trey Murphy III",1,5,6,4,3,9.9
2,0,3,2,1,6,3,0,0,"19",3,0,7,6,1,0,1038078,"2024-01-05T00:00:00.000Z",19,FALSE,13,340,"F",19,19,"New Orleans Pelicans","Larry Nance Jr.",1,13,15,9,8,20.2
0,0,0,0,0,0,0,0,0,"00",0,0,0,0,0,0,1038078,"2024-01-05T00:00:00.000Z",19,FALSE,13,17896021,"F",19,19,"New Orleans Pelicans","Jeremiah Robinson-Earl",0,0,0,0,0,0
2,0,2,1,0,1,0,2,1,"07",1,3,1,3,0,0,1038078,"2024-01-05T00:00:00.000Z",19,FALSE,13,491,"C",19,19,"New Orleans Pelicans","Cody Zeller",0,4,6,3,5,7.6
0,0,0,0,0,0,0,0,0,"00",0,0,0,0,0,0,1038078,"2024-01-05T00:00:00.000Z",19,FALSE,13,3547260,"G",19,19,"New Orleans Pelicans","Kira Lewis Jr.",0,0,0,0,0,0
0,0,0,0,0,0,0,0,0,"00",0,0,0,0,0,0,1038078,"2024-01-05T00:00:00.000Z",19,FALSE,13,38017663,"F",19,19,"New Orleans Pelicans","E.J. Liddell",0,0,0,0,0,0
0,0,0,0,0,0,0,0,0,"00",0,0,0,0,0,0,1038078,"2024-01-05T00:00:00.000Z",19,FALSE,13,17896017,"F",19,19,"New Orleans Pelicans","Matt Ryan",0,0,0,0,0,0
0,0,0,0,0,0,0,0,0,"00",0,0,0,0,0,0,1038078,"2024-01-05T00:00:00.000Z",19,FALSE,13,38017726,"G",19,19,"New Orleans Pelicans","Dereon Seabron",0,0,0,0,0,0
1,1,7,10,6,15,9,0,0,"30",0,2,24,7,0,2,1038078,"2024-01-05T00:00:00.000Z",19,FALSE,13,172,"F",13,13,"LA Clippers","Paul George",1,31,32,25,8,34.9
1,1,1,0,0,3,1,0,0,"07",1,1,2,2,0,1,1038078,"2024-01-05T00:00:00.000Z",19,FALSE,13,17896022,"G",13,13,"LA Clippers","Brandon Boston Jr.",1,4,5,3,3,7.9
0,0,0,1,0,1,0,0,0,"06",0,0,0,0,0,0,1038078,"2024-01-05T00:00:00.000Z",19,FALSE,13,56677849,"F",13,13,"LA Clippers","Kobe Brown",0,0,0,0,0,0
0,0,1,3,3,7,4,2,2,"07",0,0,13,1,0,0,1038078,"2024-01-05T00:00:00.000Z",19,FALSE,13,56677837,"G",19,19,"New Orleans Pelicans","Jordan Hawkins",0,14,14,13,1,14.2
1,0,0,1,1,9,4,0,0,"17",3,2,9,3,1,2,1038078,"2024-01-05T00:00:00.000Z",19,FALSE,13,3547293,"F",19,19,"New Orleans Pelicans","Naji Marshall",1,12,13,10,4,15.1
0,0,2,2,0,4,2,0,0,"21",1,1,4,3,1,2,1038078,"2024-01-05T00:00:00.000Z",19,FALSE,13,666511,"G",13,13,"LA Clippers","Amir Coffey",1,7,7,4,3,8.6
1,0,0,0,0,3,0,0,0,"06",0,1,0,0,0,0,1038078,"2024-01-05T00:00:00.000Z",19,FALSE,13,17896031,"G",13,13,"LA Clippers","Nah'Shon Hyland",0,0,1,1,1,1.5
0,0,1,0,0,2,2,5,4,"07",1,1,8,2,0,0,1038078,"2024-01-05T00:00:00.000Z",19,FALSE,13,371,"F-C",13,13,"LA Clippers","Mason Plumlee",0,10,10,8,2,10.4
2,0,3,6,3,13,5,0,0,"25",0,1,13,3,1,0,1038078,"2024-01-05T00:00:00.000Z",19,FALSE,13,380,"F-G",13,13,"LA Clippers","Norman Powell",1,16,18,15,5,22.6
0,0,3,1,0,3,1,0,0,"17",2,1,2,5,0,1,1038078,"2024-01-05T00:00:00.000Z",19,FALSE,13,439,"F",13,13,"LA Clippers","Daniel Theis",0,7,7,2,5,7
0,0,0,0,0,0,0,0,0,"00",0,0,0,0,0,0,1038078,"2024-01-05T00:00:00.000Z",19,FALSE,13,450,"F",13,13,"LA Clippers","PJ Tucker",0,0,0,0,0,0
5,2,3,3,1,6,3,2,1,"22",2,2,8,5,2,4,1038078,"2024-01-05T00:00:00.000Z",19,FALSE,13,472,"G",13,13,"LA Clippers","Russell Westbrook",4,13,18,13,10,29.5
0,0,0,0,0,0,0,0,0,"00",0,0,0,0,0,0,1038078,"2024-01-05T00:00:00.000Z",19,FALSE,13,38017725,"F",13,13,"LA Clippers","Moussa Diabate",0,0,0,0,0,0
0,0,0,0,0,0,0,0,0,"00",0,0,0,0,0,0,1038078,"2024-01-05T00:00:00.000Z",19,FALSE,13,56677856,"G",13,13,"LA Clippers","Jordan Miller",0,0,0,0,0,0
0,0,0,0,0,0,0,0,0,"00",0,0,0,0,0,0,1038078,"2024-01-05T00:00:00.000Z",19,FALSE,13,24417679,"G",13,13,"LA Clippers","Xavier Moon",0,0,0,0,0,0
0,0,0,0,0,0,0,0,0,"00",0,0,0,0,0,0,1038078,"2024-01-05T00:00:00.000Z",19,FALSE,13,17896051,"G",13,13,"LA Clippers","Joshua Primo",0,0,0,0,0,0
13,0,3,6,1,7,2,3,3,"29",0,2,8,3,0,1,1038078,"2024-01-05T00:00:00.000Z",19,FALSE,13,192,"G",13,13,"LA Clippers","James Harden",0,11,24,21,16,30.1
2,1,7,4,2,15,7,4,3,"30",2,1,19,9,1,2,1038078,"2024-01-05T00:00:00.000Z",19,FALSE,13,274,"F",13,13,"LA Clippers","Kawhi Leonard",2,28,30,21,11,36.8
2,2,8,0,0,7,6,4,3,"23",0,3,15,8,0,1,1038078,"2024-01-05T00:00:00.000Z",19,FALSE,13,493,"C",13,13,"LA Clippers","Ivica Zubac",2,23,25,17,10,32.6
1,0,2,3,2,3,2,2,2,"17",1,2,8,3,1,0,1038078,"2024-01-05T00:00:00.000Z",19,FALSE,13,666743,"G",13,13,"LA Clippers","Terance Mann",1,11,12,9,4,16.1
5,0,3,0,0,8,7,0,0,"25",2,0,14,5,1,1,1038079,"2024-01-05T00:00:00.000Z",7,FALSE,25,3547258,"G",7,7,"Dallas Mavericks","Josh Green",1,19,24,19,10,29.5
0,0,3,3,2,6,5,0,0,"20",0,4,12,3,3,3,1038079,"2024-01-05T00:00:00.000Z",7,FALSE,25,247,"F-G",7,7,"Dallas Mavericks","Derrick Jones Jr.",3,15,15,12,3,21.6
3,1,7,0,0,4,2,4,2,"26",2,0,6,9,1,2,1038079,"2024-01-05T00:00:00.000Z",7,FALSE,25,379,"F-C",7,7,"Dallas Mavericks","Dwight Powell",2,15,18,9,12,25.3
9,0,7,7,3,14,8,0,0,"32",2,2,19,9,1,4,1038079,"2024-01-05T00:00:00.000Z",7,FALSE,25,38017679,"G",7,7,"Dallas Mavericks","Jaden Hardy",1,28,37,28,18,42.3
5,2,9,7,3,18,10,1,1,"29",0,0,24,9,2,1,1038079,"2024-01-05T00:00:00.000Z",7,FALSE,25,228,"G",7,7,"Dallas Mavericks","Kyrie Irving",4,33,38,29,14,53.3
1,3,1,2,1,5,3,0,0,"12",1,2,7,2,0,2,1038079,"2024-01-05T00:00:00.000Z",7,FALSE,25,17896028,"F",7,7,"Dallas Mavericks","Greg Brown III",3,9,10,8,3,17.9
1,0,1,4,1,9,4,0,0,"20",1,2,9,2,0,0,1038079,"2024-01-05T00:00:00.000Z",7,FALSE,25,114,"G",7,7,"Dallas Mavericks","Seth Curry",0,11,12,10,3,12.9
4,1,2,7,3,14,8,1,0,"27",0,3,19,2,1,1,1038079,"2024-01-05T00:00:00.000Z",7,FALSE,25,191,"G",7,7,"Dallas Mavericks","Tim Hardaway Jr.",2,21,25,23,6,32.4
2,0,4,4,1,8,4,6,5,"25",1,5,14,5,2,2,1038079,"2024-01-05T00:00:00.000Z",7,FALSE,25,17554004,"G",7,7,"Dallas Mavericks","AJ Lawson",2,19,21,16,7,27
0,0,0,0,0,0,0,0,0,"00",0,0,0,0,0,0,1038079,"2024-01-05T00:00:00.000Z",7,FALSE,25,132,"F-G",7,7,"Dallas Mavericks","Luka Doncic",0,0,0,0,0,0
0,0,0,0,0,0,0,0,0,"00",0,0,0,0,0,0,1038079,"2024-01-05T00:00:00.000Z",7,FALSE,25,151,"G",7,7,"Dallas Mavericks","Dante Exum",0,0,0,0,0,0
0,0,0,0,0,0,0,0,0,"00",0,0,0,0,0,0,1038079,"2024-01-05T00:00:00.000Z",7,FALSE,25,217,"F-C",7,7,"Dallas Mavericks","Richaun Holmes",0,0,0,0,0,0
0,0,0,0,0,0,0,0,0,"00",0,0,0,0,0,0,1038079,"2024-01-05T00:00:00.000Z",7,FALSE,25,257,"F",7,7,"Dallas Mavericks","Maxi Kleber",0,0,0,0,0,0
0,0,0,0,0,0,0,0,0,"00",0,0,0,0,0,0,1038079,"2024-01-05T00:00:00.000Z",7,FALSE,25,56677840,"C",7,7,"Dallas Mavericks","Dereck Lively II",0,0,0,0,0,0
0,0,0,0,0,0,0,0,0,"00",0,0,0,0,0,0,1038079,"2024-01-05T00:00:00.000Z",7,FALSE,25,329,"F",7,7,"Dallas Mavericks","Markieff Morris",0,0,0,0,0,0
0,0,0,0,0,0,0,0,0,"00",0,0,0,0,0,0,1038079,"2024-01-05T00:00:00.000Z",7,FALSE,25,666965,"F",7,7,"Dallas Mavericks","Grant Williams",0,0,0,0,0,0
3,1,1,3,2,11,6,5,4,"22",0,1,18,1,3,1,1038079,"2024-01-05T00:00:00.000Z",7,FALSE,25,182,"F",25,25,"Portland Trail Blazers","Jerami Grant",4,19,22,21,4,34.7
1,0,6,7,2,10,4,1,0,"24",1,2,10,7,1,2,1038079,"2024-01-05T00:00:00.000Z",7,FALSE,25,56677850,"F",25,25,"Portland Trail Blazers","Toumani Camara",1,17,18,11,8,20.9
2,0,3,3,1,12,7,2,1,"27",4,3,16,7,0,3,1038079,"2024-01-05T00:00:00.000Z",7,FALSE,25,56783340,"C",25,25,"Portland Trail Blazers","Duop Reath",0,23,25,18,9,24.4
4,0,5,4,1,8,1,3,3,"23",0,1,6,5,0,2,1038079,"2024-01-05T00:00:00.000Z",7,FALSE,25,419,"G",25,25,"Portland Trail Blazers","Anfernee Simons",0,11,15,10,9,16
10,0,2,7,3,15,7,0,0,"33",1,0,17,3,1,1,1038079,"2024-01-05T00:00:00.000Z",7,FALSE,25,56677747,"G",25,25,"Portland Trail Blazers","Scoot Henderson",1,20,30,27,13,37.6
1,0,2,0,0,1,0,0,0,"18",0,3,0,2,0,1,1038079,"2024-01-05T00:00:00.000Z",7,FALSE,25,39613724,"C",25,25,"Portland Trail Blazers","Ibou Badji",0,2,3,1,3,2.9
3,0,3,4,0,8,2,2,0,"16",0,0,4,3,1,3,1038079,"2024-01-05T00:00:00.000Z",7,FALSE,25,65,"G",25,25,"Portland Trail Blazers","Malcolm Brogdon",1,7,10,7,6,12.1
0,0,0,0,0,0,0,0,0,"00",0,0,0,0,0,0,1038079,"2024-01-05T00:00:00.000Z",7,FALSE,25,3547289,"G",25,25,"Portland Trail Blazers","Skylar Mays",0,0,0,0,0,0
1,0,2,3,2,8,4,0,0,"20",2,0,10,4,1,1,1038079,"2024-01-05T00:00:00.000Z",7,FALSE,25,56677791,"F",25,25,"Portland Trail Blazers","Kris Murray",1,14,15,11,5,18.3
2,1,4,6,1,15,5,4,4,"24",1,2,15,5,1,2,1038079,"2024-01-05T00:00:00.000Z",7,FALSE,25,38017690,"G",25,25,"Portland Trail Blazers","Shaedon Sharpe",2,20,22,17,7,28
0,1,2,1,0,2,0,0,0,"14",0,0,0,2,1,0,1038079,"2024-01-05T00:00:00.000Z",7,FALSE,25,666923,"G-F",25,25,"Portland Trail Blazers","Matisse Thybulle",2,2,2,0,2,8.4
0,0,0,0,0,0,0,0,0,"00",0,0,0,0,0,0,1038079,"2024-01-05T00:00:00.000Z",7,FALSE,25,476,"C-F",25,25,"Portland Trail Blazers","Robert Williams III",0,0,0,0,0,0
3,0,5,3,2,7,3,0,0,"14",1,3,8,6,0,0,1038079,"2024-01-05T00:00:00.000Z",7,FALSE,25,56677859,"F",7,7,"Dallas Mavericks","Olivier-Maxence Prosper",0,14,17,11,9,19.7
2,1,0,1,1,3,2,3,2,"10",0,0,7,0,0,1,1038079,"2024-01-05T00:00:00.000Z",7,FALSE,25,24489167,"G",25,7,"Dallas Mavericks","Brandon Williams",1,7,9,9,2,12
0,0,2,2,1,5,3,0,0,"19",1,3,7,3,0,2,1038079,"2024-01-05T00:00:00.000Z",7,FALSE,25,56677829,"G-F",25,25,"Portland Trail Blazers","Rayan Rupert",0,10,10,7,3,8.6
0,0,0,0,0,0,0,0,0,"00",0,0,0,0,0,0,1038079,"2024-01-05T00:00:00.000Z",7,FALSE,25,17896120,"F",25,25,"Portland Trail Blazers","Ish Wainright",0,0,0,0,0,0
0,0,0,0,0,0,0,0,0,"00",0,0,0,0,0,0,1038079,"2024-01-05T00:00:00.000Z",7,FALSE,25,22,"C",25,25,"Portland Trail Blazers","Deandre Ayton",0,0,0,0,0,0
0,0,0,0,0,0,0,0,0,"00",0,0,0,0,0,0,1038079,"2024-01-05T00:00:00.000Z",7,FALSE,25,666476,"C",25,25,"Portland Trail Blazers","Moses Brown",0,0,0,0,0,0
0,0,0,0,0,0,0,0,0,"00",0,0,0,0,0,0,1038079,"2024-01-05T00:00:00.000Z",7,FALSE,25,47957121,"F",25,25,"Portland Trail Blazers","Justin Minaya",0,0,0,0,0,0
0,0,0,0,0,0,0,0,0,"00",0,0,0,0,0,0,1038079,"2024-01-05T00:00:00.000Z",7,FALSE,25,38017711,"F",25,25,"Portland Trail Blazers","Jabari Walker",0,0,0,0,0,0
4,2,3,14,9,19,11,0,0,"37",1,4,31,4,0,2,1038081,"2024-01-05T00:00:00.000Z",24,FALSE,16,8,"G",24,24,"Phoenix Suns","Grayson Allen",2,35,39,35,8,45.8
0,0,2,0,0,3,3,1,1,"17",0,0,7,2,2,2,1038081,"2024-01-05T00:00:00.000Z",24,FALSE,16,314,"F",24,24,"Phoenix Suns","Chimezie Metu",2,9,9,7,2,13.4
2,0,8,1,0,6,3,0,0,"26",1,2,6,9,1,0,1038081,"2024-01-05T00:00:00.000Z",24,FALSE,16,349,"C",24,24,"Phoenix Suns","Jusuf Nurkic",1,15,17,8,11,22.8
9,0,7,6,2,18,11,1,1,"37",1,2,25,8,0,2,1038081,"2024-01-05T00:00:00.000Z",24,FALSE,16,37,"G",24,24,"Phoenix Suns","Bradley Beal",0,33,42,34,17,46.1
10,0,5,7,2,19,9,0,0,"35",0,2,20,5,2,3,1038081,"2024-01-05T00:00:00.000Z",24,FALSE,16,57,"G",24,24,"Phoenix Suns","Devin Booker",2,25,35,30,15,44
0,0,3,3,0,6,0,0,0,"19",1,1,0,4,3,0,1038081,"2024-01-05T00:00:00.000Z",24,FALSE,16,32,"F",24,24,"Phoenix Suns","Keita Bates-Diop",3,4,4,0,4,13.8
1,1,2,0,0,2,2,1,0,"10",1,1,4,3,0,0,1038081,"2024-01-05T00:00:00.000Z",24,FALSE,16,666451,"C",24,24,"Phoenix Suns","Bol Bol",1,7,8,5,4,12.1
0,0,4,1,1,8,4,4,2,"22",2,1,11,6,1,0,1038081,"2024-01-05T00:00:00.000Z",24,FALSE,16,147,"F",24,24,"Phoenix Suns","Drew Eubanks",1,17,17,11,6,21.2
0,0,0,1,0,1,0,0,0,"02",0,0,0,0,0,0,1038081,"2024-01-05T00:00:00.000Z",24,FALSE,16,18678058,"",24,24,"Phoenix Suns","Jordan Goodwin",0,0,0,0,0,0
4,2,1,1,0,2,0,8,7,"24",1,5,7,2,3,0,1038081,"2024-01-05T00:00:00.000Z",24,FALSE,16,356,"G",24,24,"Phoenix Suns","Josh Okogie",5,9,13,11,6,30.4
0,0,0,1,0,3,1,0,0,"09",1,0,2,1,0,0,1038081,"2024-01-05T00:00:00.000Z",24,FALSE,16,470,"G",24,24,"Phoenix Suns","Yuta Watanabe",0,3,3,2,1,3.2
0,0,0,0,0,0,0,0,0,"02",0,0,0,0,0,1,1038081,"2024-01-05T00:00:00.000Z",24,FALSE,16,38017736,"F",16,16,"Miami Heat","Cole Swider",0,0,0,0,0,-1
0,0,0,0,0,0,0,0,0,"00",0,0,0,0,0,0,1038081,"2024-01-05T00:00:00.000Z",24,FALSE,16,79,"G-F",16,16,"Miami Heat","Jimmy Butler",0,0,0,0,0,0
0,0,0,0,0,0,0,0,0,"00",0,0,0,0,0,0,1038081,"2024-01-05T00:00:00.000Z",24,FALSE,16,3092,"",16,16,"Miami Heat","Haywood Highsmith",0,0,0,0,0,0
0,0,0,0,0,0,0,0,0,"00",0,0,0,0,0,0,1038081,"2024-01-05T00:00:00.000Z",24,FALSE,16,666747,"F",16,16,"Miami Heat","Caleb Martin",0,0,0,0,0,0
0,0,0,0,0,0,0,0,0,"00",0,0,0,0,0,0,1038081,"2024-01-05T00:00:00.000Z",24,FALSE,16,39398582,"C",16,16,"Miami Heat","Orlando Robinson",0,0,0,0,0,0
0,0,0,0,0,0,0,0,0,"00",0,0,0,0,0,0,1038081,"2024-01-05T00:00:00.000Z",24,FALSE,16,19465585,"G",16,16,"Miami Heat","Dru Smith",0,0,0,0,0,0
1,1,9,0,0,19,11,7,6,"36",2,2,28,11,0,1,1038081,"2024-01-05T00:00:00.000Z",24,FALSE,16,4,"C-F",16,16,"Miami Heat","Bam Adebayo",1,39,40,29,12,44.7
6,0,4,7,1,17,4,0,0,"35",0,2,9,4,0,1,1038081,"2024-01-05T00:00:00.000Z",24,FALSE,16,666633,"G",16,16,"Miami Heat","Tyler Herro",0,13,19,15,10,21.8
4,0,2,6,2,7,2,0,0,"23",1,2,6,3,0,4,1038081,"2024-01-05T00:00:00.000Z",24,FALSE,16,286,"G",16,16,"Miami Heat","Kyle Lowry",0,9,13,10,7,11.6
0,0,2,0,0,0,0,0,0,"02",0,0,0,2,0,0,1038081,"2024-01-05T00:00:00.000Z",24,FALSE,16,74,"C",16,16,"Miami Heat","Thomas Bryant",0,2,2,0,2,2.4
0,0,0,1,1,5,2,2,2,"05",2,0,7,2,0,0,1038081,"2024-01-05T00:00:00.000Z",24,FALSE,16,38017734,"F",16,16,"Miami Heat","Jamal Cain",0,9,9,7,2,9.4
1,0,0,0,0,0,0,0,0,"02",0,1,0,0,0,0,1038081,"2024-01-05T00:00:00.000Z",24,FALSE,16,3547257,"G",16,16,"Miami Heat","R.J. Hampton",0,0,1,1,1,1.5
2,0,4,6,3,9,6,6,5,"20",3,4,20,7,0,2,1038081,"2024-01-05T00:00:00.000Z",24,FALSE,16,285,"F-C",16,16,"Miami Heat","Kevin Love",0,27,29,22,9,29.4
7,0,7,6,1,9,2,5,5,"29",1,3,10,8,2,0,1038081,"2024-01-05T00:00:00.000Z",24,FALSE,16,391,"G-F",16,16,"Miami Heat","Josh Richardson",2,18,25,17,15,36.1
3,1,1,6,1,7,1,2,1,"27",0,3,4,1,1,3,1038081,"2024-01-05T00:00:00.000Z",24,FALSE,16,397,"F",16,16,"Miami Heat","Duncan Robinson",2,5,8,7,4,12.7
1,0,3,3,1,3,1,0,0,"24",1,0,3,4,0,0,1038081,"2024-01-05T00:00:00.000Z",24,FALSE,16,38017696,"F",16,16,"Miami Heat","Nikola Jovic",0,7,8,4,5,9.3
0,0,0,0,0,0,0,2,0,"02",0,0,0,0,1,0,1038081,"2024-01-05T00:00:00.000Z",24,FALSE,16,3547298,"G",24,24,"Phoenix Suns","Saben Lee",1,0,0,0,0,3
0,0,0,0,0,0,0,0,0,"00",0,0,0,0,0,0,1038081,"2024-01-05T00:00:00.000Z",24,FALSE,16,3547095,"C-F",24,24,"Phoenix Suns","Udoka Azubuike",0,0,0,0,0,0
0,0,0,0,0,0,0,0,0,"00",0,0,0,0,0,0,1038081,"2024-01-05T00:00:00.000Z",24,FALSE,16,140,"F",24,24,"Phoenix Suns","Kevin Durant",0,0,0,0,0,0
0,0,0,0,0,0,0,0,0,"00",0,0,0,0,0,0,1038081,"2024-01-05T00:00:00.000Z",24,FALSE,16,178,"G",24,24,"Phoenix Suns","Eric Gordon",0,0,0,0,0,0
0,0,0,0,0,0,0,0,0,"00",0,0,0,0,0,0,1038081,"2024-01-05T00:00:00.000Z",24,FALSE,16,272,"G",24,24,"Phoenix Suns","Damion Lee",0,0,0,0,0,0
0,0,0,0,0,0,0,0,0,"00",0,0,0,0,0,0,1038081,"2024-01-05T00:00:00.000Z",24,FALSE,16,666729,"F",24,24,"Phoenix Suns","Nassir Little",0,0,0,0,0,0
0,0,0,0,0,0,0,0,0,"00",0,0,0,0,0,0,1038081,"2024-01-05T00:00:00.000Z",24,FALSE,16,3547253,"G",4,24,"Phoenix Suns","Theo Maledon",0,0,0,0,0,0
1,0,1,2,0,7,5,0,0,"35",1,4,10,2,2,3,1038081,"2024-01-05T00:00:00.000Z",24,FALSE,16,56677785,"G",16,16,"Miami Heat","Jaime Jaquez Jr.",2,12,13,11,3,16.9
0,0,0,0,0,0,0,0,0,"00",0,0,0,0,0,0,1038082,"2024-01-05T00:00:00.000Z",10,FALSE,9,185,"F",10,10,"Golden State Warriors","Draymond Green",0,0,0,0,0,0
2,0,0,2,1,2,1,0,0,"09",0,0,3,0,0,0,1038082,"2024-01-05T00:00:00.000Z",10,FALSE,9,251,"G",10,10,"Golden State Warriors","Cory Joseph",0,3,5,5,2,6
0,0,1,1,0,2,0,0,0,"05",0,1,0,1,0,0,1038082,"2024-01-05T00:00:00.000Z",10,FALSE,9,17553992,"G",10,10,"Golden State Warriors","Moses Moody",0,1,1,0,1,1.2
0,0,0,0,0,0,0,0,0,"00",0,0,0,0,0,0,1038082,"2024-01-05T00:00:00.000Z",10,FALSE,9,45658838,"G",10,10,"Golden State Warriors","Lester Quinones",0,0,0,0,0,0
0,0,0,0,0,0,0,0,0,"00",0,0,0,0,0,0,1038082,"2024-01-05T00:00:00.000Z",10,FALSE,9,398,"G",10,10,"Golden State Warriors","Jerome Robinson",0,0,0,0,0,0
0,0,0,0,0,0,0,0,0,"00",0,0,0,0,0,0,1038082,"2024-01-05T00:00:00.000Z",10,FALSE,9,17896070,"F",10,10,"Golden State Warriors","Usman Garuba",0,0,0,0,0,0
0,0,0,0,0,0,0,0,0,"00",0,0,0,0,0,0,1038082,"2024-01-05T00:00:00.000Z",10,FALSE,9,2189,"",10,10,"Golden State Warriors","Gary Payton II",0,0,0,0,0,0
3,0,3,8,2,19,5,0,0,"36",2,0,12,5,2,1,1038082,"2024-01-05T00:00:00.000Z",10,FALSE,9,54,"F",9,9,"Detroit Pistons","Bojan Bogdanovic",2,17,20,15,8,27.5
1,0,1,2,1,3,2,0,0,"22",0,2,5,1,1,0,1038082,"2024-01-05T00:00:00.000Z",10,FALSE,9,17896071,"F",9,9,"Detroit Pistons","Isaiah Livers",1,6,7,6,2,10.7
2,2,8,0,0,6,6,2,1,"33",4,2,13,12,0,1,1038082,"2024-01-05T00:00:00.000Z",10,FALSE,9,38017694,"C",9,9,"Detroit Pistons","Jalen Duren",2,25,27,15,14,35.4
3,1,2,5,2,10,5,0,0,"24",2,6,12,4,0,4,1038082,"2024-01-05T00:00:00.000Z",10,FALSE,9,38017682,"G",9,9,"Detroit Pistons","Jaden Ivey",1,16,19,15,7,20.3
3,1,5,7,1,22,13,3,3,"35",0,2,30,5,0,2,1038082,"2024-01-05T00:00:00.000Z",10,FALSE,9,17896075,"G-F",9,9,"Detroit Pistons","Cade Cunningham",1,35,38,33,8,41.5
0,0,0,0,0,0,0,0,0,"00",0,0,0,0,0,0,1038082,"2024-01-05T00:00:00.000Z",10,FALSE,9,57875092,"F",10,10,"Golden State Warriors","Gui Santos",0,0,0,0,0,0
4,2,2,9,3,18,6,4,4,"35",1,2,19,3,1,2,1038082,"2024-01-05T00:00:00.000Z",10,FALSE,9,443,"G",10,10,"Golden State Warriors","Klay Thompson",3,22,26,23,7,35.6
1,0,6,1,0,8,4,3,3,"36",0,2,11,6,0,4,1038082,"2024-01-05T00:00:00.000Z",10,FALSE,9,17553979,"F",10,10,"Golden State Warriors","Jonathan Kuminga",0,17,18,12,7,15.7
1,0,3,0,0,1,1,2,2,"12",1,2,4,4,0,0,1038082,"2024-01-05T00:00:00.000Z",10,FALSE,9,282,"F",10,10,"Golden State Warriors","Kevon Looney",0,8,9,5,5,10.3
4,1,6,12,4,19,7,9,8,"31",0,0,26,6,1,4,1038082,"2024-01-05T00:00:00.000Z",10,FALSE,9,115,"G",10,10,"Golden State Warriors","Stephen Curry",2,32,36,30,10,41.2
4,1,6,4,2,5,3,1,0,"23",0,2,8,6,0,1,1038082,"2024-01-05T00:00:00.000Z",10,FALSE,9,367,"G",10,10,"Golden State Warriors","Chris Paul",1,14,18,12,10,23.2
0,1,7,0,0,5,5,1,1,"23",2,2,11,9,0,2,1038082,"2024-01-05T00:00:00.000Z",10,FALSE,9,56677799,"F",10,10,"Golden State Warriors","Trayce Jackson-Davis",1,20,20,11,9,22.8
5,0,3,2,2,7,4,3,1,"25",2,2,11,5,1,1,1038082,"2024-01-05T00:00:00.000Z",10,FALSE,9,56677858,"G",10,10,"Golden State Warriors","Brandin Podziemski",1,16,21,16,10,26.5
1,0,3,5,3,10,6,2,2,"22",0,3,17,3,0,1,1038082,"2024-01-05T00:00:00.000Z",10,FALSE,9,407,"F",10,10,"Golden State Warriors","Dario Saric",0,20,21,18,4,21.1
2,0,1,2,1,5,1,0,0,"19",1,2,3,2,0,1,1038082,"2024-01-05T00:00:00.000Z",10,FALSE,9,475,"F-G",10,10,"Golden State Warriors","Andrew Wiggins",0,5,7,5,4,7.4
0,0,0,0,0,0,0,0,0,"00",0,0,0,0,0,0,1038082,"2024-01-05T00:00:00.000Z",10,FALSE,9,24,"F",9,9,"Detroit Pistons","Marvin Bagley III",0,0,0,0,0,0
2,1,3,10,3,14,5,0,0,"21",1,2,13,4,0,2,1038082,"2024-01-05T00:00:00.000Z",10,FALSE,9,77,"G",9,9,"Detroit Pistons","Alec Burks",1,17,19,15,6,21.8
0,0,0,0,0,0,0,0,0,"00",0,0,0,0,0,0,1038082,"2024-01-05T00:00:00.000Z",10,FALSE,9,197,"F-G",9,9,"Detroit Pistons","Joe Harris",0,0,0,0,0,0
5,0,1,2,0,3,0,0,0,"16",0,0,0,1,2,0,1038082,"2024-01-05T00:00:00.000Z",10,FALSE,9,3547241,"G",9,9,"Detroit Pistons","Killian Hayes",2,1,6,5,6,14.7
3,2,1,8,4,13,7,0,0,"23",0,3,18,1,1,0,1038082,"2024-01-05T00:00:00.000Z",10,FALSE,9,259,"F",9,9,"Detroit Pistons","Kevin Knox",3,19,22,21,4,32.7
2,0,0,0,0,0,0,0,0,"06",0,1,0,0,0,0,1038082,"2024-01-05T00:00:00.000Z",10,FALSE,9,56677792,"G",9,9,"Detroit Pistons","Marcus Sasser",0,0,2,2,2,3
1,0,4,1,0,3,0,2,2,"09",0,3,2,4,2,1,1038082,"2024-01-05T00:00:00.000Z",10,FALSE,9,56677826,"G-F",9,9,"Detroit Pistons","Ausar Thompson",2,6,7,3,5,13.3
0,2,2,1,0,5,1,3,2,"15",1,2,4,3,0,0,1038082,"2024-01-05T00:00:00.000Z",10,FALSE,9,3547240,"C",9,9,"Detroit Pistons","James Wiseman",2,7,7,4,3,13.6
0,0,0,0,0,0,0,0,0,"00",0,0,0,0,0,0,1038082,"2024-01-05T00:00:00.000Z",10,FALSE,9,56677729,"G",9,9,"Detroit Pistons","Malcolm Cazalon",0,0,0,0,0,0
0,0,0,0,0,0,0,0,0,"00",0,0,0,0,0,0,1038082,"2024-01-05T00:00:00.000Z",10,FALSE,9,330,"G",9,9,"Detroit Pistons","Monte Morris",0,0,0,0,0,0
0,0,0,0,0,0,0,0,0,"00",0,0,0,0,0,0,1038082,"2024-01-05T00:00:00.000Z",10,FALSE,9,42097199,"G",9,9,"Detroit Pistons","Jared Rhoden",0,0,0,0,0,0
0,0,0,0,0,0,0,0,0,"00",0,0,0,0,0,0,1038082,"2024-01-05T00:00:00.000Z",10,FALSE,9,3547267,"F-C",9,9,"Detroit Pistons","Isaiah Stewart",0,0,0,0,0,0
0,0,0,0,0,0,0,0,0,"00",0,0,0,0,0,0,1038082,"2024-01-05T00:00:00.000Z",10,FALSE,9,44477024,"G",9,9,"Detroit Pistons","Stanley Umude",0,0,0,0,0,0
0,0,1,3,2,8,3,0,0,"32",1,0,8,2,1,0,1038083,"2024-01-05T00:00:00.000Z",14,FALSE,15,666860,"F-G",14,14,"Los Angeles Lakers","Cameron Reddish",1,10,10,8,2,13.4
7,0,3,9,4,24,11,10,6,"39",2,0,32,5,5,4,1038083,"2024-01-05T00:00:00.000Z",14,FALSE,15,237,"F",14,14,"Los Angeles Lakers","LeBron James",5,37,44,39,12,59.5
4,2,3,3,0,22,13,7,5,"41",3,4,31,6,0,4,1038083,"2024-01-05T00:00:00.000Z",14,FALSE,15,117,"F-C",14,14,"Los Angeles Lakers","Anthony Davis",2,37,41,35,10,46.2
2,1,1,7,3,9,3,2,1,"35",1,3,10,2,2,1,1038083,"2024-01-05T00:00:00.000Z",14,FALSE,15,383,"F",14,14,"Los Angeles Lakers","Taurean Prince",3,12,14,12,4,23.4
12,0,7,3,0,14,8,4,3,"40",0,4,19,7,2,1,1038083,"2024-01-05T00:00:00.000Z",14,FALSE,15,17553995,"G",14,14,"Los Angeles Lakers","Austin Reaves",2,26,38,31,19,50.4
0,0,3,1,0,3,1,0,0,"20",0,2,2,3,1,2,1038083,"2024-01-05T00:00:00.000Z",14,FALSE,15,38017697,"G",14,14,"Los Angeles Lakers","Max Christie",1,5,5,2,3,6.6
0,0,0,0,0,0,0,0,0,"00",0,0,0,0,0,0,1038083,"2024-01-05T00:00:00.000Z",14,FALSE,15,56677867,"F",14,14,"Los Angeles Lakers","Alex Fudge",0,0,0,0,0,0
0,0,0,0,0,0,0,0,0,"00",0,0,0,0,0,0,1038083,"2024-01-05T00:00:00.000Z",14,FALSE,15,666626,"C",14,14,"Los Angeles Lakers","Jaxson Hayes",0,0,0,0,0,0
0,0,0,0,0,0,0,0,0,"00",0,0,0,0,0,0,1038083,"2024-01-05T00:00:00.000Z",14,FALSE,15,56677868,"G",14,14,"Los Angeles Lakers","D'Moi Hodge",0,0,0,0,0,0
0,0,0,0,0,0,0,0,0,"00",0,0,0,0,0,0,1038083,"2024-01-05T00:00:00.000Z",14,FALSE,15,56677835,"G",14,14,"Los Angeles Lakers","Jalen Hood-Schifino",0,0,0,0,0,0
0,0,0,0,0,0,0,0,0,"00",0,0,0,0,0,0,1038083,"2024-01-05T00:00:00.000Z",14,FALSE,15,56677836,"F",14,14,"Los Angeles Lakers","Maxwell Lewis",0,0,0,0,0,0
1,0,4,0,0,0,0,0,0,"17",1,1,0,5,1,0,1038083,"2024-01-05T00:00:00.000Z",14,FALSE,15,457,"F",14,14,"Los Angeles Lakers","Jarred Vanderbilt",1,5,6,1,6,10.5
0,0,5,2,1,5,3,4,4,"16",0,0,11,5,1,1,1038083,"2024-01-05T00:00:00.000Z",14,FALSE,15,486,"F",14,14,"Los Angeles Lakers","Christian Wood",1,16,16,11,5,19
0,0,0,0,0,0,0,0,0,"00",0,0,0,0,0,0,1038083,"2024-01-05T00:00:00.000Z",14,FALSE,15,56677738,"C",14,14,"Los Angeles Lakers","Colin Castleton",0,0,0,0,0,0
0,0,0,0,0,0,0,0,0,"00",0,0,0,0,0,0,1038083,"2024-01-05T00:00:00.000Z",14,FALSE,15,666609,"F",14,14,"Los Angeles Lakers","Rui Hachimura",0,0,0,0,0,0
0,0,0,0,0,0,0,0,0,"00",0,0,0,0,0,0,1038083,"2024-01-05T00:00:00.000Z",14,FALSE,15,405,"G",14,14,"Los Angeles Lakers","D'Angelo Russell",0,0,0,0,0,0
0,0,0,0,0,0,0,0,0,"00",0,0,0,0,0,0,1038083,"2024-01-05T00:00:00.000Z",14,FALSE,15,1603383,"G",14,14,"Los Angeles Lakers","Gabe Vincent",0,0,0,0,0,0
5,0,1,14,8,16,9,4,3,"39",1,2,29,2,1,3,1038083,"2024-01-05T00:00:00.000Z",14,FALSE,15,420,"G",15,15,"Memphis Grizzlies","Marcus Smart",1,31,36,34,7,38.9
1,3,9,6,5,14,11,4,4,"30",0,5,31,9,0,3,1038083,"2024-01-05T00:00:00.000Z",14,FALSE,15,231,"F-C",15,15,"Memphis Grizzlies","Jaren Jackson Jr.",3,40,41,32,10,49.3
1,0,9,0,0,3,3,0,0,"31",1,2,6,10,0,2,1038083,"2024-01-05T00:00:00.000Z",14,FALSE,15,48,"C",15,15,"Memphis Grizzlies","Bismack Biyombo",0,16,17,7,11,17.5
13,0,5,8,5,14,8,4,3,"37",0,2,24,5,1,3,1038083,"2024-01-05T00:00:00.000Z",14,FALSE,15,3547287,"G",15,15,"Memphis Grizzlies","Desmond Bane",1,29,42,37,18,49.5
7,1,5,7,3,17,7,5,4,"35",2,3,21,7,1,2,1038083,"2024-01-05T00:00:00.000Z",14,FALSE,15,666786,"G",15,15,"Memphis Grizzlies","Ja Morant",2,28,35,28,14,43.9
0,0,0,0,0,0,0,0,0,"09",0,0,0,0,1,1,1038083,"2024-01-05T00:00:00.000Z",14,FALSE,15,17896067,"F",15,15,"Memphis Grizzlies","Santi Aldama",1,0,0,0,0,2
4,0,2,3,0,4,0,0,0,"20",1,0,0,3,1,0,1038083,"2024-01-05T00:00:00.000Z",14,FALSE,15,254,"G",15,15,"Memphis Grizzlies","Luke Kennard",1,3,7,4,7,12.6
0,0,0,0,0,0,0,0,0,"00",0,0,0,0,0,0,1038083,"2024-01-05T00:00:00.000Z",14,FALSE,15,666703,"G-F",15,15,"Memphis Grizzlies","John Konchar",0,0,0,0,0,0
0,0,2,1,0,2,0,0,0,"07",0,1,0,2,0,0,1038083,"2024-01-05T00:00:00.000Z",14,FALSE,15,38017729,"F",15,15,"Memphis Grizzlies","David Roddy",0,2,2,0,2,2.4
0,0,0,0,0,0,0,0,0,"00",0,0,0,0,0,0,1038083,"2024-01-05T00:00:00.000Z",14,FALSE,15,401,"G",15,15,"Memphis Grizzlies","Derrick Rose",0,0,0,0,0,0
1,0,4,0,0,1,0,2,1,"12",1,3,1,5,2,1,1038083,"2024-01-05T00:00:00.000Z",14,FALSE,15,3547285,"F",15,15,"Memphis Grizzlies","Xavier Tillman",2,6,7,2,6,13.5
1,0,1,6,2,11,6,1,1,"20",0,2,15,1,1,2,1038083,"2024-01-05T00:00:00.000Z",14,FALSE,15,17896027,"G-F",15,15,"Memphis Grizzlies","Ziaire Williams",1,16,17,16,2,18.7
0,0,0,0,0,0,0,0,0,"00",0,0,0,0,0,0,1038083,"2024-01-05T00:00:00.000Z",14,FALSE,15,3,"C",15,15,"Memphis Grizzlies","Steven Adams",0,0,0,0,0,0
0,0,0,0,0,0,0,0,0,"00",0,0,0,0,0,0,1038083,"2024-01-05T00:00:00.000Z",14,FALSE,15,666505,"F",15,15,"Memphis Grizzlies","Brandon Clarke",0,0,0,0,0,0
0,0,0,0,0,0,0,0,0,"00",0,0,0,0,0,0,1038083,"2024-01-05T00:00:00.000Z",14,FALSE,15,48248287,"G",15,15,"Memphis Grizzlies","Jacob Gilyard",0,0,0,0,0,0
0,0,0,0,0,0,0,0,0,"00",0,0,0,0,0,0,1038083,"2024-01-05T00:00:00.000Z",14,FALSE,15,56677830,"F",15,15,"Memphis Grizzlies","GG Jackson",0,0,0,0,0,0
0,0,0,0,0,0,0,0,0,"00",0,0,0,0,0,0,1038083,"2024-01-05T00:00:00.000Z",14,FALSE,15,38017728,"F",15,15,"Memphis Grizzlies","Jake LaRavia",0,0,0,0,0,0
0,0,0,0,0,0,0,0,0,"00",0,0,0,0,0,0,1038083,"2024-01-05T00:00:00.000Z",14,FALSE,15,38017731,"G",15,15,"Memphis Grizzlies","Vince Williams Jr.",0,0,0,0,0,0
0,0,0,0,0,0,0,0,0,"00",0,0,0,0,0,0,1038084,"2024-01-05T00:00:00.000Z",26,FALSE,28,436,"G-F",28,28,"Toronto Raptors","Garrett Temple",0,0,0,0,0,0
0,0,0,0,0,0,0,0,0,"00",0,0,0,0,0,0,1038084,"2024-01-05T00:00:00.000Z",26,FALSE,28,3089,"",28,28,"Toronto Raptors","Gary Trent Jr.",0,0,0,0,0,0
0,0,0,0,0,0,0,0,0,"00",0,0,0,0,0,0,1038084,"2024-01-05T00:00:00.000Z",26,FALSE,28,489,"F",28,28,"Toronto Raptors","Thaddeus Young",0,0,0,0,0,0
0,0,0,1,0,2,1,0,0,"07",0,1,2,0,0,0,1038084,"2024-01-05T00:00:00.000Z",26,FALSE,28,666762,"F",28,28,"Toronto Raptors","Jalen McDaniels",0,2,2,2,0,2
1,1,6,5,1,9,5,5,3,"28",3,2,14,9,1,0,1038084,"2024-01-05T00:00:00.000Z",26,FALSE,28,58,"F",28,28,"Toronto Raptors","Chris Boucher",2,23,24,15,10,32.3
6,2,4,8,4,15,8,0,0,"35",0,2,20,4,1,5,1038084,"2024-01-05T00:00:00.000Z",26,FALSE,28,17896055,"G-F",28,28,"Toronto Raptors","Scottie Barnes",3,24,30,26,10,37.8
8,0,5,12,4,17,6,4,4,"38",0,1,20,5,0,3,1038084,"2024-01-05T00:00:00.000Z",26,FALSE,28,3547269,"G",20,28,"Toronto Raptors","Immanuel Quickley",0,25,33,28,13,35
0,1,2,3,2,4,3,2,2,"13",1,2,10,3,0,1,1038084,"2024-01-05T00:00:00.000Z",26,FALSE,28,2309958,"C-F",15,28,"Toronto Raptors","Jontay Porter",1,13,13,10,3,15.6
3,1,1,4,0,11,7,5,4,"32",1,1,18,2,1,0,1038084,"2024-01-05T00:00:00.000Z",26,FALSE,28,409,"G",28,28,"Toronto Raptors","Dennis Schroder",2,20,23,21,5,30.9
0,0,0,0,0,0,0,0,0,"00",0,0,0,0,0,0,1038084,"2024-01-05T00:00:00.000Z",26,FALSE,28,56677828,"G",28,28,"Toronto Raptors","Gradey Dick",0,0,0,0,0,0
0,0,0,0,0,0,0,0,0,"00",0,0,0,0,0,0,1038084,"2024-01-05T00:00:00.000Z",26,FALSE,28,56677805,"G",28,28,"Toronto Raptors","Javon Freeman-Liberty",0,0,0,0,0,0
0,0,0,0,0,0,0,0,0,"00",0,0,0,0,0,0,1038084,"2024-01-05T00:00:00.000Z",26,FALSE,28,38017710,"C",28,28,"Toronto Raptors","Christian Koloko",0,0,0,0,0,0
0,0,0,0,0,0,0,0,0,"00",0,0,0,0,0,0,1038084,"2024-01-05T00:00:00.000Z",26,FALSE,28,56677869,"G",28,28,"Toronto Raptors","Markquis Nowell",0,0,0,0,0,0
0,0,0,0,0,0,0,0,0,"00",0,0,0,0,0,0,1038084,"2024-01-05T00:00:00.000Z",26,FALSE,28,376,"F",28,28,"Toronto Raptors","Otto Porter Jr.",0,0,0,0,0,0
2,0,1,8,5,12,5,2,1,"34",3,3,16,4,0,1,1038084,"2024-01-05T00:00:00.000Z",26,FALSE,28,30,"F",26,26,"Sacramento Kings","Harrison Barnes",0,20,22,18,6,22.8
1,0,9,4,4,11,6,4,2,"35",3,1,18,12,1,3,1038084,"2024-01-05T00:00:00.000Z",26,FALSE,28,38017688,"F",26,26,"Sacramento Kings","Keegan Murray",1,30,31,19,13,33.9
11,0,11,0,0,16,11,3,2,"39",4,6,24,15,0,6,1038084,"2024-01-05T00:00:00.000Z",26,FALSE,28,406,"F",26,26,"Sacramento Kings","Domantas Sabonis",0,39,50,35,26,52.5
1,0,0,3,2,6,4,0,0,"16",0,2,10,0,0,1,1038084,"2024-01-05T00:00:00.000Z",26,FALSE,28,17896030,"G",26,26,"Sacramento Kings","Chris Duarte",0,10,11,11,1,10.5
4,1,1,3,1,20,10,3,3,"37",1,4,24,2,2,2,1038084,"2024-01-05T00:00:00.000Z",26,FALSE,28,161,"G",26,26,"Sacramento Kings","De'Aaron Fox",3,26,30,28,6,39.4
0,0,0,0,0,0,0,0,0,"00",0,0,0,0,0,0,1038084,"2024-01-05T00:00:00.000Z",26,FALSE,28,17896044,"F",26,26,"Sacramento Kings","Kessler Edwards",0,0,0,0,0,0
0,0,0,0,0,0,0,0,0,"00",0,0,0,0,0,0,1038084,"2024-01-05T00:00:00.000Z",26,FALSE,28,38017714,"G",26,26,"Sacramento Kings","Keon Ellis",0,0,0,0,0,0
3,0,2,2,1,2,1,0,0,"14",0,1,3,2,0,0,1038084,"2024-01-05T00:00:00.000Z",26,FALSE,28,221,"G",26,26,"Sacramento Kings","Kevin Huerter",0,5,8,6,5,9.9
0,0,0,0,0,0,0,0,0,"00",0,0,0,0,0,0,1038084,"2024-01-05T00:00:00.000Z",26,FALSE,28,273,"C",26,26,"Sacramento Kings","Alex Len",0,0,0,0,0,0
1,0,3,5,4,6,4,0,0,"15",0,2,12,3,0,0,1038084,"2024-01-05T00:00:00.000Z",26,FALSE,28,290,"F",26,26,"Sacramento Kings","Trey Lyles",0,15,16,13,4,17.1
1,0,2,0,0,3,2,2,2,"07",0,0,6,2,0,0,1038084,"2024-01-05T00:00:00.000Z",26,FALSE,28,306,"C",26,26,"Sacramento Kings","JaVale McGee",0,8,9,7,3,9.9
2,0,1,4,1,8,3,0,0,"11",0,0,7,1,0,0,1038084,"2024-01-05T00:00:00.000Z",26,FALSE,28,17553994,"G",26,26,"Sacramento Kings","Davion Mitchell",0,8,10,9,3,11.2
9,0,1,9,3,16,6,1,0,"32",0,4,15,1,1,1,1038084,"2024-01-05T00:00:00.000Z",26,FALSE,28,324,"G",26,26,"Sacramento Kings","Malik Monk",1,16,25,24,10,31.7
0,0,0,0,0,0,0,0,0,"00",0,0,0,0,0,0,1038084,"2024-01-05T00:00:00.000Z",26,FALSE,28,666925,"F",29,26,"Sacramento Kings","Juan Toscano-Anderson",0,0,0,0,0,0
0,0,0,0,0,0,0,0,0,"00",0,0,0,0,0,0,1038084,"2024-01-05T00:00:00.000Z",26,FALSE,28,4197162,"F",26,26,"Sacramento Kings","Aleksandar Vezenkov",0,0,0,0,0,0
0,0,0,0,0,0,0,0,0,"00",0,0,0,0,0,0,1038084,"2024-01-05T00:00:00.000Z",26,FALSE,28,17895990,"G",26,26,"Sacramento Kings","Jordan Ford",0,0,0,0,0,0
0,0,0,0,0,0,0,0,0,"00",0,0,0,0,0,0,1038084,"2024-01-05T00:00:00.000Z",26,FALSE,28,56677845,"G",26,26,"Sacramento Kings","Colby Jones",0,0,0,0,0,0
0,0,0,0,0,0,0,0,0,"00",0,0,0,0,0,0,1038084,"2024-01-05T00:00:00.000Z",26,FALSE,28,56677862,"F",26,26,"Sacramento Kings","Jalen Slawson",0,0,0,0,0,0
2,1,3,4,2,8,4,4,4,"27",1,2,14,4,0,0,1038084,"2024-01-05T00:00:00.000Z",26,FALSE,28,666423,"F-G",20,28,"Toronto Raptors","RJ Barrett",1,18,20,16,6,24.8
9,1,3,0,0,11,6,7,6,"37",1,3,18,4,2,2,1038084,"2024-01-05T00:00:00.000Z",26,FALSE,28,416,"F",28,28,"Toronto Raptors","Pascal Siakam",3,22,31,27,13,43.3
2,3,5,0,0,10,7,0,0,"23",1,6,14,6,0,3,1038084,"2024-01-05T00:00:00.000Z",26,FALSE,28,373,"C",28,28,"Toronto Raptors","Jakob Poeltl",3,20,22,16,8,30.2
0,1,3,7,0,13,3,2,2,"32",1,2,8,4,3,0,1038085,"2024-01-06T00:00:00.000Z",12,FALSE,2,3547250,"G-F",12,12,"Indiana Pacers","Aaron Nesmith",4,12,12,8,4,24.8
2,0,6,4,1,6,2,2,2,"26",1,2,7,7,0,0,1038085,"2024-01-06T00:00:00.000Z",12,FALSE,2,3547264,"F-C",12,12,"Indiana Pacers","Jalen Smith",0,14,16,9,9,18.4
2,0,4,5,0,11,5,4,2,"30",3,3,12,7,0,0,1038085,"2024-01-06T00:00:00.000Z",12,FALSE,2,452,"C-F",12,12,"Indiana Pacers","Myles Turner",0,19,21,14,9,23.4
3,0,2,10,3,16,6,0,0,"31",0,3,15,2,0,0,1038085,"2024-01-06T00:00:00.000Z",12,FALSE,2,210,"G",12,12,"Indiana Pacers","Buddy Hield",0,17,20,18,5,21.9
7,0,5,9,2,17,5,5,5,"35",1,1,17,6,5,4,1038085,"2024-01-06T00:00:00.000Z",12,FALSE,2,3547245,"G",12,12,"Indiana Pacers","Tyrese Haliburton",5,23,30,24,13,45.7
0,0,0,0,0,0,0,0,0,"01",0,0,0,0,0,0,1038085,"2024-01-06T00:00:00.000Z",12,FALSE,2,38017701,"G",12,12,"Indiana Pacers","Kendall Brown",0,0,0,0,0,0
0,0,2,0,0,3,2,0,0,"09",1,4,4,3,0,0,1038085,"2024-01-06T00:00:00.000Z",12,FALSE,2,17896035,"F",12,12,"Indiana Pacers","Isaiah Jackson",0,7,7,4,3,7.6
1,1,3,4,1,20,13,8,4,"36",1,0,31,4,0,3,1038085,"2024-01-06T00:00:00.000Z",12,FALSE,2,70,"G",2,2,"Boston Celtics","Jaylen Brown",1,35,36,32,5,37.3
6,0,13,13,8,23,14,4,2,"38",1,4,38,14,0,4,1038085,"2024-01-06T00:00:00.000Z",12,FALSE,2,434,"F",2,2,"Boston Celtics","Jayson Tatum",0,52,58,44,20,59.8
0,1,2,1,0,2,1,0,0,"06",1,0,2,3,1,0,1038085,"2024-01-06T00:00:00.000Z",12,FALSE,2,378,"F-C",2,2,"Boston Celtics","Kristaps Porzingis",2,5,5,2,3,11.6
2,1,5,2,1,6,3,0,0,"24",0,5,7,5,0,4,1038085,"2024-01-06T00:00:00.000Z",12,FALSE,2,473,"G",2,2,"Boston Celtics","Derrick White",1,12,14,9,7,15
5,1,5,5,1,9,3,2,1,"37",1,2,8,6,1,2,1038085,"2024-01-06T00:00:00.000Z",12,FALSE,2,214,"G",2,2,"Boston Celtics","Jrue Holiday",2,14,19,13,11,26.7
0,0,0,0,0,0,0,0,0,"01",0,0,0,0,0,0,1038085,"2024-01-06T00:00:00.000Z",12,FALSE,2,17896094,"G",2,2,"Boston Celtics","Dalano Banton",0,0,0,0,0,0
0,0,3,3,1,9,3,1,1,"20",5,3,8,8,0,0,1038085,"2024-01-06T00:00:00.000Z",12,FALSE,2,666468,"F",2,2,"Boston Celtics","Oshae Brissett",0,16,16,8,8,17.6
1,0,4,5,1,6,2,0,0,"16",0,4,5,4,0,1,1038085,"2024-01-06T00:00:00.000Z",12,FALSE,2,17896060,"F",2,2,"Boston Celtics","Sam Hauser",0,9,10,6,5,10.3
8,3,6,5,2,8,4,2,0,"30",1,1,10,7,1,2,1038085,"2024-01-06T00:00:00.000Z",12,FALSE,2,219,"C-F",2,2,"Boston Celtics","Al Horford",4,17,25,18,15,40.4
3,0,1,0,0,2,1,2,2,"16",3,1,4,4,1,1,1038085,"2024-01-06T00:00:00.000Z",12,FALSE,2,261,"F-C",2,2,"Boston Celtics","Luke Kornet",1,8,11,7,7,15.3
0,0,0,0,0,0,0,0,0,"01",0,0,0,0,0,0,1038085,"2024-01-06T00:00:00.000Z",12,FALSE,2,338,"G",2,2,"Boston Celtics","Svi Mykhailiuk",0,0,0,0,0,0
0,0,2,3,1,5,2,0,0,"15",0,0,5,2,1,0,1038085,"2024-01-06T00:00:00.000Z",12,FALSE,2,3547276,"G",2,2,"Boston Celtics","Payton Pritchard",1,7,7,5,2,10.4
0,0,0,0,0,0,0,0,0,"00",0,0,0,0,0,0,1038085,"2024-01-06T00:00:00.000Z",12,FALSE,2,17553967,"C",2,2,"Boston Celtics","Neemias Queta",0,0,0,0,0,0
0,0,0,0,0,0,0,0,0,"00",0,0,0,0,0,0,1038085,"2024-01-06T00:00:00.000Z",12,FALSE,2,3547279,"F",2,2,"Boston Celtics","Lamar Stevens",0,0,0,0,0,0
0,0,0,0,0,0,0,0,0,"00",0,0,0,0,0,0,1038085,"2024-01-06T00:00:00.000Z",12,FALSE,2,38017707,"G",2,2,"Boston Celtics","JD Davison",0,0,0,0,0,0
0,0,0,0,0,0,0,0,0,"00",0,0,0,0,0,0,1038085,"2024-01-06T00:00:00.000Z",12,FALSE,2,NA,NA,NA,2,"Boston Celtics","NA NA",0,0,0,0,0,0
0,0,0,0,0,0,0,0,0,"00",0,0,0,0,0,0,1038085,"2024-01-06T00:00:00.000Z",12,FALSE,2,56677864,"G",2,2,"Boston Celtics","Jordan Walsh",0,0,0,0,0,0
0,0,0,0,0,0,0,0,0,"00",0,0,0,0,0,0,1038085,"2024-01-06T00:00:00.000Z",12,FALSE,2,242,"F",12,12,"Indiana Pacers","James Johnson",0,0,0,0,0,0
2,1,2,3,0,15,7,9,6,"35",2,2,20,4,2,1,1038085,"2024-01-06T00:00:00.000Z",12,FALSE,2,38017686,"G-F",12,12,"Indiana Pacers","Bennedict Mathurin",3,24,26,22,6,35.8
5,0,1,0,0,3,3,0,0,"12",0,0,6,1,2,3,1038085,"2024-01-06T00:00:00.000Z",12,FALSE,2,304,"G",12,12,"Indiana Pacers","T.J. McConnell",2,7,12,11,6,17.7
0,0,0,0,0,0,0,0,0,"01",0,0,0,0,0,0,1038085,"2024-01-06T00:00:00.000Z",12,FALSE,2,3547207,"F",12,12,"Indiana Pacers","Jordan Nwora",0,0,0,0,0,0
0,0,1,0,0,0,0,0,0,"03",0,0,0,1,0,0,1038085,"2024-01-06T00:00:00.000Z",12,FALSE,2,56677861,"G",12,12,"Indiana Pacers","Ben Sheppard",0,1,1,0,1,1.2
1,0,2,4,2,8,4,0,0,"23",1,1,10,3,0,0,1038085,"2024-01-06T00:00:00.000Z",12,FALSE,2,3547243,"F",12,12,"Indiana Pacers","Obi Toppin",0,13,14,11,4,15.1
0,0,0,0,0,1,1,0,0,"01",0,0,2,0,0,0,1038085,"2024-01-06T00:00:00.000Z",12,FALSE,2,56677778,"F-C",12,12,"Indiana Pacers","Oscar Tshiebwe",0,2,2,2,0,2
1,0,0,0,0,0,0,0,0,"01",0,0,0,0,0,0,1038085,"2024-01-06T00:00:00.000Z",12,FALSE,2,56677832,"F",12,12,"Indiana Pacers","Jarace Walker",0,0,1,1,1,1.5
0,0,0,0,0,0,0,0,0,"00",0,0,0,0,0,0,1038085,"2024-01-06T00:00:00.000Z",12,FALSE,2,69,"G",12,12,"Indiana Pacers","Bruce Brown",0,0,0,0,0,0
0,0,0,0,0,0,0,0,0,"00",0,0,0,0,0,0,1038085,"2024-01-06T00:00:00.000Z",12,FALSE,2,38017507,"G-F",12,12,"Indiana Pacers","Andrew Nembhard",0,0,0,0,0,0
0,0,0,0,0,0,0,0,0,"00",0,0,0,0,0,0,1038085,"2024-01-06T00:00:00.000Z",12,FALSE,2,56677794,"G",12,12,"Indiana Pacers","Isaiah Wong",0,0,0,0,0,0
6,0,7,4,2,13,9,5,3,"33",3,5,23,10,2,4,1038086,"2024-01-06T00:00:00.000Z",30,FALSE,20,3547242,"F",30,30,"Washington Wizards","Deni Avdija",2,33,39,29,16,46
2,1,2,10,4,21,10,4,3,"32",0,3,27,2,0,3,1038086,"2024-01-06T00:00:00.000Z",30,FALSE,20,265,"F",30,30,"Washington Wizards","Kyle Kuzma",1,29,31,29,4,32.4
3,1,8,0,0,2,2,4,2,"31",4,5,6,12,1,1,1038086,"2024-01-06T00:00:00.000Z",30,FALSE,20,666577,"F",30,30,"Washington Wizards","Daniel Gafford",2,18,21,9,15,29.9
4,0,3,5,1,10,4,2,1,"30",0,3,10,3,2,2,1038086,"2024-01-06T00:00:00.000Z",30,FALSE,20,666848,"G",30,30,"Washington Wizards","Jordan Poole",2,13,17,14,7,23.6
8,0,1,6,2,13,4,2,1,"28",0,0,11,1,0,2,1038086,"2024-01-06T00:00:00.000Z",30,FALSE,20,249,"G",30,30,"Washington Wizards","Tyus Jones",0,12,20,19,9,22.2
2,0,0,2,2,3,3,0,0,"03",0,0,8,0,0,0,1038086,"2024-01-06T00:00:00.000Z",30,FALSE,20,18677954,"G",30,30,"Washington Wizards","Jared Butler",0,8,10,10,2,11
3,0,1,2,0,5,2,0,0,"28",2,3,4,3,0,3,1038086,"2024-01-06T00:00:00.000Z",30,FALSE,20,56677844,"G",30,30,"Washington Wizards","Bilal Coulibaly",0,7,10,7,6,9.1
0,0,0,0,0,2,1,0,0,"03",0,0,2,0,0,0,1038086,"2024-01-06T00:00:00.000Z",30,FALSE,20,38017687,"G",30,30,"Washington Wizards","Johnny Davis",0,2,2,2,0,2
0,0,0,0,0,0,0,0,0,"00",0,0,0,0,0,0,1038086,"2024-01-06T00:00:00.000Z",30,FALSE,20,167,"F",30,30,"Washington Wizards","Danilo Gallinari",0,0,0,0,0,0
0,0,2,1,1,1,1,0,0,"03",0,0,3,2,0,0,1038086,"2024-01-06T00:00:00.000Z",30,FALSE,20,3547302,"F",30,30,"Washington Wizards","Anthony Gill",0,5,5,3,2,5.4
1,1,2,2,1,4,3,1,1,"15",0,0,8,2,0,4,1038086,"2024-01-06T00:00:00.000Z",30,FALSE,20,17896045,"F",30,30,"Washington Wizards","Corey Kispert",1,10,11,9,3,10.9
0,0,3,3,0,4,0,2,1,"14",3,0,1,6,0,1,1038086,"2024-01-06T00:00:00.000Z",30,FALSE,20,337,"F-C",30,30,"Washington Wizards","Mike Muscala",0,7,7,1,6,7.2
1,0,1,1,0,1,0,0,0,"03",0,1,0,1,0,0,1038086,"2024-01-06T00:00:00.000Z",30,FALSE,20,17896106,"F",30,30,"Washington Wizards","Eugene Omoruyi",0,1,2,1,2,2.7
3,0,3,1,0,6,1,0,0,"17",0,0,2,3,0,0,1038086,"2024-01-06T00:00:00.000Z",30,FALSE,20,487,"G",30,30,"Washington Wizards","Delon Wright",0,5,8,5,6,10.1
0,0,0,0,0,0,0,0,0,"00",0,0,0,0,0,0,1038086,"2024-01-06T00:00:00.000Z",30,FALSE,20,38017704,"F",30,30,"Washington Wizards","Patrick Baldwin Jr.",0,0,0,0,0,0
0,0,0,0,0,0,0,0,0,"00",0,0,0,0,0,0,1038086,"2024-01-06T00:00:00.000Z",30,FALSE,20,NA,NA,NA,30,"Washington Wizards","NA NA",0,0,0,0,0,0
0,0,0,0,0,0,0,0,0,"00",0,0,0,0,0,0,1038086,"2024-01-06T00:00:00.000Z",30,FALSE,20,38017712,"G",30,30,"Washington Wizards","Ryan Rollins",0,0,0,0,0,0
0,0,0,0,0,0,0,0,0,"00",0,0,0,0,0,0,1038086,"2024-01-06T00:00:00.000Z",30,FALSE,20,414,"G",30,30,"Washington Wizards","Landry Shamet",0,0,0,0,0,0
2,0,3,3,1,7,4,0,0,"31",2,3,9,5,1,1,1038086,"2024-01-06T00:00:00.000Z",30,FALSE,20,18,"F",28,20,"New York Knicks","OG Anunoby",1,14,16,11,7,20
5,0,4,8,3,23,13,13,10,"38",3,2,39,7,1,2,1038086,"2024-01-06T00:00:00.000Z",30,FALSE,20,387,"F",20,20,"New York Knicks","Julius Randle",1,46,51,44,12,55.9
2,2,17,0,0,8,4,0,0,"39",2,3,8,19,4,5,1038086,"2024-01-06T00:00:00.000Z",30,FALSE,20,201,"F-C",20,20,"New York Knicks","Isaiah Hartenstein",6,27,29,10,21,46.8
3,0,4,7,2,10,4,0,0,"26",1,1,10,5,1,1,1038086,"2024-01-06T00:00:00.000Z",30,FALSE,20,131,"G",20,20,"New York Knicks","Donte DiVincenzo",1,15,18,13,8,22.5
8,0,3,8,4,18,10,9,9,"35",0,2,33,3,0,2,1038086,"2024-01-06T00:00:00.000Z",30,FALSE,20,73,"G",20,20,"New York Knicks","Jalen Brunson",0,36,44,41,11,46.6
0,0,0,0,0,1,1,0,0,"08",0,1,2,0,0,0,1038086,"2024-01-06T00:00:00.000Z",30,FALSE,20,3547249,"F",28,20,"New York Knicks","Precious Achiuwa",0,2,2,2,0,2
0,0,0,0,0,0,0,0,0,"00",0,0,0,0,0,0,1038086,"2024-01-06T00:00:00.000Z",30,FALSE,20,19,"G",20,20,"New York Knicks","Ryan Arcidiacono",0,0,0,0,0,0
0,0,0,0,0,1,0,0,0,"01",0,0,0,0,0,0,1038086,"2024-01-06T00:00:00.000Z",30,FALSE,20,3547275,"G",28,20,"New York Knicks","Malachi Flynn",0,0,0,0,0,0
0,0,0,0,0,0,0,0,0,"00",0,0,0,0,0,0,1038086,"2024-01-06T00:00:00.000Z",30,FALSE,20,160,"G-F",20,20,"New York Knicks","Evan Fournier",0,0,0,0,0,0
0,0,0,0,0,0,0,0,0,"00",0,0,0,0,0,0,1038086,"2024-01-06T00:00:00.000Z",30,FALSE,20,173,"F",30,20,"New York Knicks","Taj Gibson",0,0,0,0,0,0
1,0,1,4,2,5,2,0,0,"15",0,1,6,1,1,1,1038086,"2024-01-06T00:00:00.000Z",30,FALSE,20,17895858,"G",20,20,"New York Knicks","Quentin Grimes",1,7,8,7,2,10.7
1,0,2,4,1,8,3,2,2,"32",2,1,9,4,0,2,1038086,"2024-01-06T00:00:00.000Z",30,FALSE,20,202,"G",20,20,"New York Knicks","Josh Hart",0,13,14,10,5,13.3
5,0,0,2,1,6,2,0,0,"13",1,2,5,1,1,0,1038086,"2024-01-06T00:00:00.000Z",30,FALSE,20,17896033,"G",20,20,"New York Knicks","Miles McBride",1,6,11,10,6,16.7
0,0,0,0,0,0,0,0,0,"02",0,0,0,0,0,0,1038086,"2024-01-06T00:00:00.000Z",30,FALSE,20,17896063,"F",20,20,"New York Knicks","Jericho Sims",0,0,0,0,0,0
0,0,0,0,0,0,0,0,0,"00",0,0,0,0,0,0,1038086,"2024-01-06T00:00:00.000Z",30,FALSE,20,666474,"G",20,20,"New York Knicks","Charles Brown",0,0,0,0,0,0
0,0,0,0,0,0,0,0,0,"00",0,0,0,0,0,0,1038086,"2024-01-06T00:00:00.000Z",30,FALSE,20,399,"C",20,20,"New York Knicks","Mitchell Robinson",0,0,0,0,0,0
0,0,0,0,0,0,0,0,0,"00",0,0,0,0,0,0,1038086,"2024-01-06T00:00:00.000Z",30,FALSE,20,56677795,"F",20,20,"New York Knicks","Jacob Toppin",0,0,0,0,0,0
0,0,0,0,0,0,0,0,0,"00",0,0,0,0,0,0,1038086,"2024-01-06T00:00:00.000Z",30,FALSE,20,17896089,"G",20,20,"New York Knicks","Duane Washington Jr.",0,0,0,0,0,0
2,0,1,3,0,3,0,0,0,"13",1,1,0,2,0,0,1038087,"2024-01-06T00:00:00.000Z",23,FALSE,29,17896025,"G",23,23,"Philadelphia 76ers","Jaden Springer",0,2,4,2,4,5.4
1,0,1,1,0,7,4,2,1,"17",1,4,9,2,1,0,1038087,"2024-01-06T00:00:00.000Z",23,FALSE,29,3547294,"F",23,23,"Philadelphia 76ers","Kenyon Martin Jr.",1,11,12,10,3,15.9
0,0,0,0,0,0,0,0,0,"00",0,0,0,0,0,0,1038087,"2024-01-06T00:00:00.000Z",23,FALSE,29,56913527,"G",23,23,"Philadelphia 76ers","Ricky Council IV",0,0,0,0,0,0
0,0,0,0,0,0,0,0,0,"00",0,0,0,0,0,0,1038087,"2024-01-06T00:00:00.000Z",23,FALSE,29,108,"F",23,23,"Philadelphia 76ers","Robert Covington",0,0,0,0,0,0
0,0,0,0,0,0,0,0,0,"00",0,0,0,0,0,0,1038087,"2024-01-06T00:00:00.000Z",23,FALSE,29,145,"F-C",23,23,"Philadelphia 76ers","Joel Embiid",0,0,0,0,0,0
0,0,0,0,0,0,0,0,0,"00",0,0,0,0,0,0,1038087,"2024-01-06T00:00:00.000Z",23,FALSE,29,2175,"",23,23,"Philadelphia 76ers","Danuel House Jr.",0,0,0,0,0,0
0,0,0,0,0,0,0,0,0,"00",0,0,0,0,0,0,1038087,"2024-01-06T00:00:00.000Z",23,FALSE,29,56677788,"G",23,23,"Philadelphia 76ers","Terquavion Smith",0,0,0,0,0,0
0,0,0,0,0,0,0,0,0,"00",0,0,0,0,0,0,1038087,"2024-01-06T00:00:00.000Z",23,FALSE,29,200,"F",23,23,"Philadelphia 76ers","Tobias Harris",0,0,0,0,0,0
0,0,0,0,0,0,0,0,0,"00",0,0,0,0,0,0,1038087,"2024-01-06T00:00:00.000Z",23,FALSE,29,260,"G-F",23,23,"Philadelphia 76ers","Furkan Korkmaz",0,0,0,0,0,0
0,0,0,0,0,0,0,0,0,"00",0,0,0,0,0,0,1038087,"2024-01-06T00:00:00.000Z",23,FALSE,29,38017732,"F",15,23,"Philadelphia 76ers","Kenneth Lofton Jr.",0,0,0,0,0,0
4,2,3,5,0,6,1,0,0,"26",1,3,2,4,4,2,1038087,"2024-01-06T00:00:00.000Z",23,FALSE,29,33,"F-G",23,23,"Philadelphia 76ers","Nicolas Batum",6,6,10,6,8,28.8
1,2,4,7,3,12,5,2,2,"28",2,2,15,6,2,0,1038087,"2024-01-06T00:00:00.000Z",23,FALSE,29,328,"F",23,23,"Philadelphia 76ers","Marcus Morris",4,21,22,16,7,35.7
1,0,3,0,0,12,7,4,2,"25",3,1,16,6,0,1,1038087,"2024-01-06T00:00:00.000Z",23,FALSE,29,3547270,"F",23,23,"Philadelphia 76ers","Paul Reed",0,22,23,17,7,23.7
4,0,3,6,1,18,8,8,7,"38",1,5,24,4,1,0,1038087,"2024-01-06T00:00:00.000Z",23,FALSE,29,360,"F",23,23,"Philadelphia 76ers","Kelly Oubre Jr.",1,28,32,28,8,37.8
9,1,0,8,1,24,9,6,6,"42",1,0,25,1,3,3,1038087,"2024-01-06T00:00:00.000Z",23,FALSE,29,3547254,"G",23,23,"Philadelphia 76ers","Tyrese Maxey",4,26,35,34,10,48.7
1,1,2,2,0,9,3,1,0,"17",3,4,6,5,1,0,1038087,"2024-01-06T00:00:00.000Z",23,FALSE,29,28,"C",23,23,"Philadelphia 76ers","Mo Bamba",2,11,12,7,6,19.5
7,0,2,6,2,13,5,0,0,"34",2,0,12,4,0,0,1038087,"2024-01-06T00:00:00.000Z",23,FALSE,29,45,"G",23,23,"Philadelphia 76ers","Patrick Beverley",0,16,23,19,11,27.3
0,0,0,0,0,0,0,0,0,"00",0,0,0,0,0,0,1038087,"2024-01-06T00:00:00.000Z",23,FALSE,29,313,"G",23,23,"Philadelphia 76ers","De'Anthony Melton",0,0,0,0,0,0
2,0,6,6,1,9,3,0,0,"33",1,1,7,7,1,4,1038087,"2024-01-06T00:00:00.000Z",23,FALSE,29,38017739,"F",29,29,"Utah Jazz","Simone Fontecchio",1,14,16,9,9,17.4
1,1,9,9,5,19,12,5,4,"35",4,2,33,13,0,1,1038087,"2024-01-06T00:00:00.000Z",23,FALSE,29,297,"F",29,29,"Utah Jazz","Lauri Markkanen",1,46,47,34,14,52.1
2,1,4,0,0,10,9,2,1,"28",1,1,19,5,0,1,1038087,"2024-01-06T00:00:00.000Z",23,FALSE,29,101,"F-C",29,29,"Utah Jazz","John Collins",1,24,26,21,7,30
10,0,2,3,1,14,9,4,3,"27",1,3,22,3,0,5,1038087,"2024-01-06T00:00:00.000Z",23,FALSE,29,413,"G",29,29,"Utah Jazz","Collin Sexton",0,25,35,32,13,35.6
1,2,5,1,0,1,0,0,0,"23",0,3,0,5,1,1,1038087,"2024-01-06T00:00:00.000Z",23,FALSE,29,139,"G",29,29,"Utah Jazz","Kris Dunn",3,5,6,1,6,15.5
1,0,2,2,0,2,0,0,0,"13",1,1,0,3,0,1,1038087,"2024-01-06T00:00:00.000Z",23,FALSE,29,38017620,"G",29,29,"Utah Jazz","Ochai Agbaji",0,3,4,1,4,4.1
6,0,5,6,0,14,5,9,8,"31",0,0,18,5,1,5,1038087,"2024-01-06T00:00:00.000Z",23,FALSE,29,100,"G",29,29,"Utah Jazz","Jordan Clarkson",1,23,29,24,11,31
3,0,2,2,0,4,2,2,2,"16",0,2,6,2,0,2,1038087,"2024-01-06T00:00:00.000Z",23,FALSE,29,56677834,"G",29,29,"Utah Jazz","Keyonte George",0,8,11,9,5,10.9
0,0,0,0,0,0,0,0,0,"00",0,0,0,0,0,0,1038087,"2024-01-06T00:00:00.000Z",23,FALSE,29,666650,"G",29,29,"Utah Jazz","Talen Horton-Tucker",0,0,0,0,0,0
0,0,3,0,0,4,4,2,2,"19",1,2,10,4,1,0,1038087,"2024-01-06T00:00:00.000Z",23,FALSE,29,38017705,"C",29,29,"Utah Jazz","Walker Kessler",1,14,14,10,4,17.8
4,0,1,1,1,3,2,0,0,"15",0,3,5,1,0,3,1038087,"2024-01-06T00:00:00.000Z",23,FALSE,29,358,"F",29,29,"Utah Jazz","Kelly Olynyk",0,6,10,9,5,9.2
0,0,0,0,0,0,0,0,0,"00",0,0,0,0,0,0,1038087,"2024-01-06T00:00:00.000Z",23,FALSE,29,666881,"F",29,29,"Utah Jazz","Luka Samanic",0,0,0,0,0,0
0,0,0,0,0,0,0,0,0,"00",0,0,0,0,0,0,1038087,"2024-01-06T00:00:00.000Z",23,FALSE,29,11891374,"C",29,29,"Utah Jazz","Omer Yurtseven",0,0,0,0,0,0
0,0,0,0,0,0,0,0,0,"00",0,0,0,0,0,0,1038087,"2024-01-06T00:00:00.000Z",23,FALSE,29,17896023,"G",29,29,"Utah Jazz","Josh Christopher",0,0,0,0,0,0
0,0,0,0,0,0,0,0,0,"00",0,0,0,0,0,0,1038087,"2024-01-06T00:00:00.000Z",23,FALSE,29,56677824,"F",29,29,"Utah Jazz","Taylor Hendricks",0,0,0,0,0,0
0,0,0,0,0,0,0,0,0,"00",0,0,0,0,0,0,1038087,"2024-01-06T00:00:00.000Z",23,FALSE,29,38017630,"G",29,29,"Utah Jazz","Johnny Juzang",0,0,0,0,0,0
0,0,0,0,0,0,0,0,0,"00",0,0,0,0,0,0,1038087,"2024-01-06T00:00:00.000Z",23,FALSE,29,19465584,"F",29,29,"Utah Jazz","Micah Potter",0,0,0,0,0,0
0,0,0,0,0,0,0,0,0,"00",0,0,0,0,0,0,1038087,"2024-01-06T00:00:00.000Z",23,FALSE,29,56677842,"F",29,29,"Utah Jazz","Brice Sensabaugh",0,0,0,0,0,0
0,0,5,0,0,3,2,0,0,"20",3,4,4,8,1,0,1038088,"2024-01-06T00:00:00.000Z",11,FALSE,17,3547301,"F",11,11,"Houston Rockets","Jae'Sean Tate",1,12,12,4,8,16.6
2,1,11,5,3,7,3,6,5,"40",1,4,14,12,2,1,1038088,"2024-01-06T00:00:00.000Z",11,FALSE,17,38017684,"F",11,11,"Houston Rockets","Jabari Smith Jr.",3,26,28,16,14,39.4
4,0,10,1,0,21,7,10,7,"31",1,5,21,11,0,3,1038088,"2024-01-06T00:00:00.000Z",11,FALSE,17,17896062,"F-C",11,11,"Houston Rockets","Alperen Sengun",0,32,36,25,15,37.2
2,0,4,6,1,12,5,5,5,"28",0,1,16,4,1,1,1038088,"2024-01-06T00:00:00.000Z",11,FALSE,17,17895966,"G",11,11,"Houston Rockets","Jalen Green",1,20,22,18,6,25.8
7,0,1,10,3,13,4,3,3,"37",1,3,14,2,2,1,1038088,"2024-01-06T00:00:00.000Z",11,FALSE,17,458,"G",11,11,"Houston Rockets","Fred VanVleet",2,16,23,21,9,31.9
0,0,0,0,0,0,0,0,0,"00",0,0,0,0,0,0,1038088,"2024-01-06T00:00:00.000Z",11,FALSE,17,75,"G-F",11,11,"Houston Rockets","Reggie Bullock",0,0,0,0,0,0
2,1,2,5,2,11,5,5,4,"34",0,4,16,2,0,1,1038088,"2024-01-06T00:00:00.000Z",11,FALSE,17,188,"F",11,11,"Houston Rockets","Jeff Green",1,18,20,18,4,23.4
0,0,1,5,3,7,4,0,0,"21",0,1,11,1,0,2,1038088,"2024-01-06T00:00:00.000Z",11,FALSE,17,213,"G",11,11,"Houston Rockets","Aaron Holiday",0,12,12,11,1,10.2
0,0,0,0,0,0,0,0,0,"00",0,0,0,0,0,0,1038088,"2024-01-06T00:00:00.000Z",11,FALSE,17,19465326,"C",11,11,"Houston Rockets","Jock Landale",0,0,0,0,0,0
0,0,0,0,0,0,0,0,0,"00",0,0,0,0,0,0,1038088,"2024-01-06T00:00:00.000Z",11,FALSE,17,66,"G-F",11,11,"Houston Rockets","Dillon Brooks",0,0,0,0,0,0
0,0,0,0,0,0,0,0,0,"00",0,0,0,0,0,0,1038088,"2024-01-06T00:00:00.000Z",11,FALSE,17,38017695,"F",11,11,"Houston Rockets","Tari Eason",0,0,0,0,0,0
0,0,0,0,0,0,0,0,0,"00",0,0,0,0,0,0,1038088,"2024-01-06T00:00:00.000Z",11,FALSE,17,3547281,"G-F",11,11,"Houston Rockets","Nate Hinton",0,0,0,0,0,0
0,0,0,0,0,0,0,0,0,"00",0,0,0,0,0,0,1038088,"2024-01-06T00:00:00.000Z",11,FALSE,17,357,"G",11,11,"Houston Rockets","Victor Oladipo",0,0,0,0,0,0
0,0,0,0,0,0,0,0,0,"00",0,0,0,0,0,0,1038088,"2024-01-06T00:00:00.000Z",11,FALSE,17,56677809,"F",11,11,"Houston Rockets","Jermaine Samuels Jr.",0,0,0,0,0,0
0,0,0,0,0,0,0,0,0,"00",0,0,0,0,0,0,1038088,"2024-01-06T00:00:00.000Z",11,FALSE,17,47738533,"G",11,11,"Houston Rockets","Jeenathan Williams",0,0,0,0,0,0
5,0,3,5,0,9,3,6,4,"33",0,5,10,3,1,3,1038088,"2024-01-06T00:00:00.000Z",11,FALSE,17,315,"F",17,17,"Milwaukee Bucks","Khris Middleton",1,13,18,15,8,21.1
0,0,0,0,0,0,0,0,0,"00",0,0,0,0,0,0,1038088,"2024-01-06T00:00:00.000Z",11,FALSE,17,666453,"C",17,17,"Milwaukee Bucks","Marques Bolden",0,0,0,0,0,0
0,0,0,0,0,0,0,0,0,"00",0,0,0,0,0,0,1038088,"2024-01-06T00:00:00.000Z",11,FALSE,17,112,"F",17,17,"Milwaukee Bucks","Jae Crowder",0,0,0,0,0,0
0,0,0,0,0,0,0,0,0,"00",0,0,0,0,0,0,1038088,"2024-01-06T00:00:00.000Z",11,FALSE,17,56677854,"F",17,17,"Milwaukee Bucks","Chris Livingston",0,0,0,0,0,0
0,0,0,0,0,0,0,0,0,"00",0,0,0,0,0,0,1038088,"2024-01-06T00:00:00.000Z",11,FALSE,17,38017691,"G",17,17,"Milwaukee Bucks","TyTy Washington Jr.",0,0,0,0,0,0
0,0,0,0,0,0,0,0,0,"00",0,0,0,0,0,0,1038088,"2024-01-06T00:00:00.000Z",11,FALSE,17,666960,"G",17,17,"Milwaukee Bucks","Lindell Wigginton",0,0,0,0,0,0
2,1,14,2,1,25,16,21,15,"39",3,4,48,17,0,2,1038088,"2024-01-06T00:00:00.000Z",11,FALSE,17,15,"F",17,17,"Milwaukee Bucks","Giannis Antetokounmpo",1,65,67,50,19,72.4
0,1,5,6,1,9,3,0,0,"31",0,2,7,5,1,0,1038088,"2024-01-06T00:00:00.000Z",11,FALSE,17,283,"C",17,17,"Milwaukee Bucks","Brook Lopez",2,12,12,7,5,19
0,0,1,1,1,1,1,0,0,"16",0,2,3,1,0,2,1038088,"2024-01-06T00:00:00.000Z",11,FALSE,17,38,"G",17,17,"Milwaukee Bucks","Malik Beasley",0,4,4,3,1,2.2
9,0,2,8,1,16,5,10,7,"39",0,1,18,2,2,1,1038088,"2024-01-06T00:00:00.000Z",11,FALSE,17,278,"G",17,17,"Milwaukee Bucks","Damian Lillard",2,20,29,27,11,38.9
0,0,0,0,0,0,0,0,0,"00",0,0,0,0,0,0,1038088,"2024-01-06T00:00:00.000Z",11,FALSE,17,2148,"",17,17,"Milwaukee Bucks","Thanasis Antetokounmpo",0,0,0,0,0,0
3,1,3,3,1,4,2,0,0,"23",1,1,5,4,0,1,1038088,"2024-01-06T00:00:00.000Z",11,FALSE,17,38017676,"F",17,17,"Milwaukee Bucks","MarJon Beauchamp",1,9,12,8,7,16.3
1,0,1,5,3,5,3,0,0,"19",0,0,9,1,0,0,1038088,"2024-01-06T00:00:00.000Z",11,FALSE,17,105,"G",17,17,"Milwaukee Bucks","Pat Connaughton",0,10,11,10,2,11.7
0,0,0,0,0,0,0,0,0,"03",0,1,0,0,0,0,1038088,"2024-01-06T00:00:00.000Z",11,FALSE,17,38017733,"G",17,17,"Milwaukee Bucks","A.J. Green",0,0,0,0,0,0
0,0,2,1,0,1,0,1,1,"12",0,3,1,2,2,0,1038088,"2024-01-06T00:00:00.000Z",11,FALSE,17,56677852,"G",17,17,"Milwaukee Bucks","Andre Jackson Jr.",2,3,3,1,2,9.4
1,0,0,1,0,1,0,2,1,"08",0,0,1,0,0,0,1038088,"2024-01-06T00:00:00.000Z",11,FALSE,17,368,"G",17,17,"Milwaukee Bucks","Cameron Payne",0,1,2,2,1,2.5
0,1,6,2,1,5,2,2,1,"17",0,5,6,6,1,2,1038088,"2024-01-06T00:00:00.000Z",11,FALSE,17,377,"F",17,17,"Milwaukee Bucks","Bobby Portis",2,12,12,6,6,17.2
0,0,0,0,0,0,0,0,0,"00",0,0,0,0,0,0,1038088,"2024-01-06T00:00:00.000Z",11,FALSE,17,296,"C",11,11,"Houston Rockets","Boban Marjanovic",0,0,0,0,0,0
5,0,2,1,0,3,2,0,0,"16",1,2,4,3,0,1,1038088,"2024-01-06T00:00:00.000Z",11,FALSE,17,56677825,"G-F",11,11,"Houston Rockets","Amen Thompson",0,7,12,9,8,14.1
0,0,3,1,1,6,4,3,3,"13",0,0,12,3,1,0,1038088,"2024-01-06T00:00:00.000Z",11,FALSE,17,56677831,"F",11,11,"Houston Rockets","Cam Whitmore",1,15,15,12,3,18.6
0,0,0,0,0,0,0,0,0,"00",0,0,0,0,0,0,1038088,"2024-01-06T00:00:00.000Z",11,FALSE,17,284,"C",17,17,"Milwaukee Bucks","Robin Lopez",0,0,0,0,0,0
1,1,5,1,0,3,2,0,0,"31",0,2,4,5,0,0,1038093,"2024-01-07T00:00:00.000Z",7,FALSE,18,3547258,"G",7,7,"Dallas Mavericks","Josh Green",1,9,10,5,6,14.5
1,3,5,6,1,12,5,2,1,"35",5,2,12,10,1,1,1038093,"2024-01-07T00:00:00.000Z",7,FALSE,18,247,"F-G",7,7,"Dallas Mavericks","Derrick Jones Jr.",4,22,23,13,11,36.5
4,0,1,0,0,5,3,5,3,"28",5,4,9,6,1,0,1038093,"2024-01-07T00:00:00.000Z",7,FALSE,18,379,"F-C",7,7,"Dallas Mavericks","Dwight Powell",1,15,19,13,10,25.2
5,2,3,8,6,27,14,1,1,"39",5,2,35,8,3,3,1038093,"2024-01-07T00:00:00.000Z",7,FALSE,18,228,"G",7,7,"Dallas Mavericks","Kyrie Irving",5,43,48,40,13,64.1
8,0,6,12,5,26,12,8,5,"39",0,3,34,6,1,3,1038093,"2024-01-07T00:00:00.000Z",7,FALSE,18,132,"F-G",7,7,"Dallas Mavericks","Luka Doncic",1,40,48,42,14,53.2
0,0,0,0,0,0,0,0,0,"00",0,0,0,0,0,0,1038093,"2024-01-07T00:00:00.000Z",7,FALSE,18,17896028,"F",7,7,"Dallas Mavericks","Greg Brown III",0,0,0,0,0,0
0,0,3,2,0,3,0,0,0,"12",0,1,0,3,1,1,1038093,"2024-01-07T00:00:00.000Z",7,FALSE,18,114,"G",7,7,"Dallas Mavericks","Seth Curry",1,3,3,0,3,5.6
1,0,4,8,2,13,4,2,2,"32",0,2,12,4,0,0,1038093,"2024-01-07T00:00:00.000Z",7,FALSE,18,191,"G",7,7,"Dallas Mavericks","Tim Hardaway Jr.",0,16,17,13,5,18.3
0,0,0,0,0,1,0,0,0,"04",0,0,0,0,0,0,1038093,"2024-01-07T00:00:00.000Z",7,FALSE,18,38017679,"G",7,7,"Dallas Mavericks","Jaden Hardy",0,0,0,0,0,0
0,0,0,0,0,0,0,0,0,"00",0,0,0,0,0,0,1038093,"2024-01-07T00:00:00.000Z",7,FALSE,18,217,"F-C",7,7,"Dallas Mavericks","Richaun Holmes",0,0,0,0,0,0
0,0,0,0,0,0,0,0,0,"00",0,0,0,0,0,0,1038093,"2024-01-07T00:00:00.000Z",7,FALSE,18,17554004,"G",7,7,"Dallas Mavericks","AJ Lawson",0,0,0,0,0,0
0,2,2,3,1,5,3,2,2,"20",0,3,9,2,0,3,1038093,"2024-01-07T00:00:00.000Z",7,FALSE,18,666965,"F",7,7,"Dallas Mavericks","Grant Williams",2,11,11,9,2,14.4
0,0,0,0,0,0,0,0,0,"00",0,0,0,0,0,0,1038093,"2024-01-07T00:00:00.000Z",7,FALSE,18,38017700,"G",18,18,"Minnesota Timberwolves","Wendell Moore Jr.",0,0,0,0,0,0
0,0,5,4,1,12,7,2,0,"27",4,2,15,9,0,0,1038093,"2024-01-07T00:00:00.000Z",7,FALSE,18,667378,"F-C",18,18,"Minnesota Timberwolves","Naz Reid",0,24,24,15,9,25.8
7,0,1,6,3,7,3,0,0,"32",0,1,9,1,0,2,1038093,"2024-01-07T00:00:00.000Z",7,FALSE,18,104,"G",18,18,"Minnesota Timberwolves","Mike Conley",0,10,17,16,8,18.7
1,0,0,4,1,5,1,0,0,"13",1,0,3,1,0,0,1038093,"2024-01-07T00:00:00.000Z",7,FALSE,18,666400,"G",18,18,"Minnesota Timberwolves","Nickeil Alexander-Walker",0,4,5,4,2,5.7
4,0,1,0,0,1,1,2,2,"20",1,3,4,2,0,1,1038093,"2024-01-07T00:00:00.000Z",7,FALSE,18,12,"F",18,18,"Minnesota Timberwolves","Kyle Anderson",0,6,10,8,6,11.4
0,0,0,0,0,0,0,0,0,"00",0,0,0,0,0,0,1038093,"2024-01-07T00:00:00.000Z",7,FALSE,18,68,"F",18,18,"Minnesota Timberwolves","Troy Brown Jr.",0,0,0,0,0,0
1,1,1,7,2,7,2,0,0,"13",0,0,6,1,2,0,1038093,"2024-01-07T00:00:00.000Z",7,FALSE,18,666767,"G",18,18,"Minnesota Timberwolves","Jordan McLaughlin",3,7,8,7,2,17.7
0,0,0,0,0,0,0,0,0,"00",0,0,0,0,0,0,1038093,"2024-01-07T00:00:00.000Z",7,FALSE,18,56677782,"F",18,18,"Minnesota Timberwolves","Leonard Miller",0,0,0,0,0,0
0,0,0,0,0,0,0,0,0,"00",0,0,0,0,0,0,1038093,"2024-01-07T00:00:00.000Z",7,FALSE,18,17896056,"C",18,18,"Minnesota Timberwolves","Luka Garza",0,0,0,0,0,0
0,0,0,0,0,0,0,0,0,"00",0,0,0,0,0,0,1038093,"2024-01-07T00:00:00.000Z",7,FALSE,18,17895968,"F",18,18,"Minnesota Timberwolves","Daishen Nix",0,0,0,0,0,0
0,0,0,0,0,0,0,0,0,"00",0,0,0,0,0,0,1038093,"2024-01-07T00:00:00.000Z",7,FALSE,18,320,"G",18,18,"Minnesota Timberwolves","Shake Milton",0,0,0,0,0,0
0,0,0,0,0,0,0,0,0,"00",0,0,0,0,0,0,1038093,"2024-01-07T00:00:00.000Z",7,FALSE,18,38017715,"F",18,18,"Minnesota Timberwolves","Josh Minott",0,0,0,0,0,0
0,0,0,0,0,0,0,0,0,"00",0,0,0,0,0,0,1038093,"2024-01-07T00:00:00.000Z",7,FALSE,18,56677851,"G",18,18,"Minnesota Timberwolves","Jaylen Clark",0,0,0,0,0,0
0,0,0,0,0,0,0,0,0,"00",0,0,0,0,0,0,1038093,"2024-01-07T00:00:00.000Z",7,FALSE,18,329,"F",7,7,"Dallas Mavericks","Markieff Morris",0,0,0,0,0,0
0,0,0,0,0,0,0,0,0,"00",0,0,0,0,0,0,1038093,"2024-01-07T00:00:00.000Z",7,FALSE,18,56677859,"F",7,7,"Dallas Mavericks","Olivier-Maxence Prosper",0,0,0,0,0,0
0,0,0,0,0,0,0,0,0,"00",0,0,0,0,0,0,1038093,"2024-01-07T00:00:00.000Z",7,FALSE,18,24489167,"G",25,7,"Dallas Mavericks","Brandon Williams",0,0,0,0,0,0
0,0,0,0,0,0,0,0,0,"00",0,0,0,0,0,0,1038093,"2024-01-07T00:00:00.000Z",7,FALSE,18,151,"G",7,7,"Dallas Mavericks","Dante Exum",0,0,0,0,0,0
0,0,0,0,0,0,0,0,0,"00",0,0,0,0,0,0,1038093,"2024-01-07T00:00:00.000Z",7,FALSE,18,257,"F",7,7,"Dallas Mavericks","Maxi Kleber",0,0,0,0,0,0
0,0,0,0,0,0,0,0,0,"00",0,0,0,0,0,0,1038093,"2024-01-07T00:00:00.000Z",7,FALSE,18,56677840,"C",7,7,"Dallas Mavericks","Dereck Lively II",0,0,0,0,0,0
4,0,2,5,0,10,1,0,0,"37",1,4,2,3,0,0,1038093,"2024-01-07T00:00:00.000Z",7,FALSE,18,3547259,"F",18,18,"Minnesota Timberwolves","Jaden McDaniels",0,5,9,6,7,11.6
1,2,7,9,3,16,8,6,5,"27",0,5,24,7,0,3,1038093,"2024-01-07T00:00:00.000Z",7,FALSE,18,447,"C",18,18,"Minnesota Timberwolves","Karl-Anthony Towns",2,31,32,25,8,36.9
1,0,11,0,0,9,4,4,1,"34",6,4,9,17,1,5,1038093,"2024-01-07T00:00:00.000Z",7,FALSE,18,176,"C",18,18,"Minnesota Timberwolves","Rudy Gobert",1,26,27,10,18,28.9
3,1,5,6,3,27,14,7,5,"37",5,3,36,10,3,2,1038093,"2024-01-07T00:00:00.000Z",7,FALSE,18,3547238,"G",18,18,"Minnesota Timberwolves","Anthony Edwards",4,46,49,39,13,62.5
1,0,2,2,0,6,1,2,1,"17",0,0,3,2,0,1,1038096,"2024-01-07T00:00:00.000Z",10,FALSE,28,475,"F-G",10,10,"Golden State Warriors","Andrew Wiggins",0,5,6,4,3,5.9
4,1,3,5,1,12,5,2,2,"25",1,0,13,4,1,1,1038096,"2024-01-07T00:00:00.000Z",10,FALSE,28,17553979,"F",10,10,"Golden State Warriors","Jonathan Kuminga",2,17,21,17,8,28.8
2,3,8,0,0,9,8,0,0,"27",3,0,16,11,0,0,1038096,"2024-01-07T00:00:00.000Z",10,FALSE,28,56677799,"F",10,10,"Golden State Warriors","Trayce Jackson-Davis",3,27,29,18,13,41.2
3,0,0,7,5,15,10,0,0,"28",0,0,25,0,0,2,1038096,"2024-01-07T00:00:00.000Z",10,FALSE,28,443,"G",10,10,"Golden State Warriors","Klay Thompson",0,25,28,28,3,27.5
6,0,1,9,0,14,2,5,5,"30",0,3,9,1,0,2,1038096,"2024-01-07T00:00:00.000Z",10,FALSE,28,115,"G",10,10,"Golden State Warriors","Stephen Curry",0,10,16,15,7,17.2
0,0,0,0,0,0,0,0,0,"00",0,0,0,0,0,0,1038096,"2024-01-07T00:00:00.000Z",10,FALSE,28,185,"F",10,10,"Golden State Warriors","Draymond Green",0,0,0,0,0,0
2,0,0,1,0,2,0,0,0,"14",0,1,0,0,0,1,1038096,"2024-01-07T00:00:00.000Z",10,FALSE,28,251,"G",10,10,"Golden State Warriors","Cory Joseph",0,0,2,2,2,2
2,0,0,0,0,6,4,2,2,"17",7,2,10,7,0,1,1038096,"2024-01-07T00:00:00.000Z",10,FALSE,28,282,"F",10,10,"Golden State Warriors","Kevon Looney",0,17,19,12,9,20.4
1,0,3,6,4,9,7,3,3,"22",0,1,21,3,1,1,1038096,"2024-01-07T00:00:00.000Z",10,FALSE,28,17553992,"G",10,10,"Golden State Warriors","Moses Moody",1,24,25,22,4,28.1
4,0,6,8,1,11,2,0,0,"29",2,1,5,8,0,0,1038096,"2024-01-07T00:00:00.000Z",10,FALSE,28,56677858,"G",10,10,"Golden State Warriors","Brandin Podziemski",0,13,17,9,12,20.6
6,0,6,8,5,20,13,8,6,"36",0,3,37,6,1,0,1038096,"2024-01-07T00:00:00.000Z",10,FALSE,28,666423,"F-G",20,28,"Toronto Raptors","RJ Barrett",1,43,49,43,12,56.2
6,2,5,3,2,11,7,0,0,"30",1,0,16,6,0,1,1038096,"2024-01-07T00:00:00.000Z",10,FALSE,28,416,"F",28,28,"Toronto Raptors","Pascal Siakam",2,22,28,22,12,37.2
5,0,8,0,0,8,6,5,2,"31",3,3,14,11,0,2,1038096,"2024-01-07T00:00:00.000Z",10,FALSE,28,373,"C",28,28,"Toronto Raptors","Jakob Poeltl",0,25,30,19,16,32.7
3,1,1,4,0,11,3,0,0,"24",1,1,6,2,1,2,1038096,"2024-01-07T00:00:00.000Z",10,FALSE,28,17896055,"G-F",28,28,"Toronto Raptors","Scottie Barnes",2,8,11,9,5,16.9
10,0,4,4,1,10,4,0,0,"26",1,0,9,5,1,0,1038096,"2024-01-07T00:00:00.000Z",10,FALSE,28,3547269,"G",20,28,"Toronto Raptors","Immanuel Quickley",1,14,24,19,15,33
1,1,7,3,3,7,7,0,0,"16",2,0,17,9,1,0,1038096,"2024-01-07T00:00:00.000Z",10,FALSE,28,58,"F",28,28,"Toronto Raptors","Chris Boucher",2,26,27,18,10,35.3
1,0,0,0,0,0,0,0,0,"04",0,0,0,0,0,0,1038096,"2024-01-07T00:00:00.000Z",10,FALSE,28,666762,"F",28,28,"Toronto Raptors","Jalen McDaniels",0,0,1,1,1,1.5
1,1,1,2,0,3,1,0,0,"11",1,1,2,2,0,0,1038096,"2024-01-07T00:00:00.000Z",10,FALSE,28,2309958,"C-F",15,28,"Toronto Raptors","Jontay Porter",1,4,5,3,3,8.9
4,0,3,3,1,10,6,1,0,"28",0,5,13,3,0,0,1038096,"2024-01-07T00:00:00.000Z",10,FALSE,28,409,"G",28,28,"Toronto Raptors","Dennis Schroder",0,16,20,17,7,22.6
0,0,0,0,0,1,1,0,0,"04",0,0,2,0,1,1,1038096,"2024-01-07T00:00:00.000Z",10,FALSE,28,436,"G-F",28,28,"Toronto Raptors","Garrett Temple",1,2,2,2,0,4
4,0,3,5,2,10,4,1,1,"18",2,1,11,5,2,0,1038096,"2024-01-07T00:00:00.000Z",10,FALSE,28,407,"F",10,10,"Golden State Warriors","Dario Saric",2,16,20,15,9,29
0,0,0,0,0,0,0,0,0,"00",0,0,0,0,0,0,1038096,"2024-01-07T00:00:00.000Z",10,FALSE,28,17896070,"F",10,10,"Golden State Warriors","Usman Garuba",0,0,0,0,0,0
0,0,0,0,0,0,0,0,0,"00",0,0,0,0,0,0,1038096,"2024-01-07T00:00:00.000Z",10,FALSE,28,367,"G",10,10,"Golden State Warriors","Chris Paul",0,0,0,0,0,0
0,0,0,0,0,0,0,0,0,"00",0,0,0,0,0,0,1038096,"2024-01-07T00:00:00.000Z",10,FALSE,28,2189,"",10,10,"Golden State Warriors","Gary Payton II",0,0,0,0,0,0
0,0,0,0,0,0,0,0,0,"00",0,0,0,0,0,0,1038096,"2024-01-07T00:00:00.000Z",10,FALSE,28,57875092,"F",10,10,"Golden State Warriors","Gui Santos",0,0,0,0,0,0
0,0,0,0,0,0,0,0,0,"00",0,0,0,0,0,0,1038096,"2024-01-07T00:00:00.000Z",10,FALSE,28,376,"F",28,28,"Toronto Raptors","Otto Porter Jr.",0,0,0,0,0,0
0,0,1,2,1,3,2,0,0,"06",0,1,5,1,1,1,1038096,"2024-01-07T00:00:00.000Z",10,FALSE,28,45658838,"G",10,10,"Golden State Warriors","Lester Quinones",1,6,6,5,1,8.2
1,0,1,1,0,2,0,0,0,"07",0,1,0,1,0,0,1038096,"2024-01-07T00:00:00.000Z",10,FALSE,28,398,"G",10,10,"Golden State Warriors","Jerome Robinson",0,1,2,1,2,2.7
1,0,1,5,2,11,6,0,0,"26",0,1,14,1,2,0,1038096,"2024-01-07T00:00:00.000Z",10,FALSE,28,3089,"",28,28,"Toronto Raptors","Gary Trent Jr.",2,15,16,15,2,22.7
0,0,0,1,1,2,1,0,0,"04",0,0,3,0,0,1,1038096,"2024-01-07T00:00:00.000Z",10,FALSE,28,489,"F",28,28,"Toronto Raptors","Thaddeus Young",0,3,3,3,0,2
0,0,0,0,0,0,0,0,0,"00",0,0,0,0,0,0,1038096,"2024-01-07T00:00:00.000Z",10,FALSE,28,56677828,"G",28,28,"Toronto Raptors","Gradey Dick",0,0,0,0,0,0
0,0,0,0,0,0,0,0,0,"00",0,0,0,0,0,0,1038096,"2024-01-07T00:00:00.000Z",10,FALSE,28,56677805,"G",28,28,"Toronto Raptors","Javon Freeman-Liberty",0,0,0,0,0,0
0,0,0,0,0,0,0,0,0,"00",0,0,0,0,0,0,1038096,"2024-01-07T00:00:00.000Z",10,FALSE,28,38017710,"C",28,28,"Toronto Raptors","Christian Koloko",0,0,0,0,0,0
0,0,0,0,0,0,0,0,0,"00",0,0,0,0,0,0,1038096,"2024-01-07T00:00:00.000Z",10,FALSE,28,56677869,"G",28,28,"Toronto Raptors","Markquis Nowell",0,0,0,0,0,0
1,0,3,3,2,6,2,2,1,"20",1,1,7,4,2,5,1038097,"2024-01-07T00:00:00.000Z",14,FALSE,13,666860,"F-G",14,14,"Los Angeles Lakers","Cameron Reddish",2,11,12,8,5,14.3
7,0,7,3,1,19,11,3,2,"38",1,2,25,8,1,4,1038097,"2024-01-07T00:00:00.000Z",14,FALSE,13,237,"F",14,14,"Los Angeles Lakers","LeBron James",1,33,40,32,15,44.1
1,1,9,1,0,15,10,4,2,"39",1,1,22,10,3,3,1038097,"2024-01-07T00:00:00.000Z",14,FALSE,13,117,"F-C",14,14,"Los Angeles Lakers","Anthony Davis",4,32,33,23,11,44.5
2,0,1,6,3,8,4,2,2,"30",0,3,13,1,1,0,1038097,"2024-01-07T00:00:00.000Z",14,FALSE,13,383,"F",14,14,"Los Angeles Lakers","Taurean Prince",1,14,16,15,3,20.2
2,0,0,3,0,5,2,5,4,"32",0,0,8,0,0,2,1038097,"2024-01-07T00:00:00.000Z",14,FALSE,13,17553995,"G",14,14,"Los Angeles Lakers","Austin Reaves",0,8,10,10,2,9
0,2,1,1,1,6,3,0,0,"13",2,0,7,3,0,0,1038097,"2024-01-07T00:00:00.000Z",14,FALSE,13,38017697,"G",14,14,"Los Angeles Lakers","Max Christie",2,10,10,7,3,16.6
0,0,0,0,0,0,0,0,0,"00",0,0,0,0,0,0,1038097,"2024-01-07T00:00:00.000Z",14,FALSE,13,666626,"C",14,14,"Los Angeles Lakers","Jaxson Hayes",0,0,0,0,0,0
0,0,0,0,0,0,0,0,0,"00",0,0,0,0,0,0,1038097,"2024-01-07T00:00:00.000Z",14,FALSE,13,56677835,"G",14,14,"Los Angeles Lakers","Jalen Hood-Schifino",0,0,0,0,0,0
0,0,0,0,0,0,0,0,0,"00",0,0,0,0,0,0,1038097,"2024-01-07T00:00:00.000Z",14,FALSE,13,56677738,"C",14,14,"Los Angeles Lakers","Colin Castleton",0,0,0,0,0,0
0,0,0,0,0,0,0,0,0,"00",0,0,0,0,0,0,1038097,"2024-01-07T00:00:00.000Z",14,FALSE,13,666609,"F",14,14,"Los Angeles Lakers","Rui Hachimura",0,0,0,0,0,0
0,0,0,0,0,0,0,0,0,"00",0,0,0,0,0,0,1038097,"2024-01-07T00:00:00.000Z",14,FALSE,13,1603383,"G",14,14,"Los Angeles Lakers","Gabe Vincent",0,0,0,0,0,0
3,1,4,11,4,18,8,2,2,"38",0,4,22,4,5,3,1038097,"2024-01-07T00:00:00.000Z",14,FALSE,13,172,"F",13,13,"LA Clippers","Paul George",6,26,29,25,7,46.3
2,2,8,7,2,17,6,2,1,"35",0,4,15,8,3,3,1038097,"2024-01-07T00:00:00.000Z",14,FALSE,13,274,"F",13,13,"LA Clippers","Kawhi Leonard",5,23,25,17,10,39.6
1,1,9,0,0,13,9,4,4,"37",10,4,22,19,0,2,1038097,"2024-01-07T00:00:00.000Z",14,FALSE,13,493,"C",13,13,"LA Clippers","Ivica Zubac",1,41,42,23,20,47.3
3,0,0,3,2,5,2,0,0,"25",0,2,6,0,0,1,1038097,"2024-01-07T00:00:00.000Z",14,FALSE,13,666743,"G",13,13,"LA Clippers","Terance Mann",0,6,9,9,3,9.5
9,0,2,7,3,13,4,5,4,"39",2,3,15,4,1,5,1038097,"2024-01-07T00:00:00.000Z",14,FALSE,13,192,"G",13,13,"LA Clippers","James Harden",1,19,28,24,13,31.3
0,0,0,0,0,0,0,0,0,"00",0,0,0,0,0,0,1038097,"2024-01-07T00:00:00.000Z",14,FALSE,13,17896022,"G",13,13,"LA Clippers","Brandon Boston Jr.",0,0,0,0,0,0
0,0,0,0,0,0,0,0,0,"00",0,0,0,0,0,0,1038097,"2024-01-07T00:00:00.000Z",14,FALSE,13,56677849,"F",13,13,"LA Clippers","Kobe Brown",0,0,0,0,0,0
0,0,1,0,0,1,0,0,0,"13",0,0,0,1,0,0,1038097,"2024-01-07T00:00:00.000Z",14,FALSE,13,666511,"G",13,13,"LA Clippers","Amir Coffey",0,1,1,0,1,1.2
0,0,0,0,0,0,0,0,0,"00",0,0,0,0,0,0,1038097,"2024-01-07T00:00:00.000Z",14,FALSE,13,17896031,"G",13,13,"LA Clippers","Nah'Shon Hyland",0,0,0,0,0,0
0,0,0,0,0,0,0,0,0,"00",0,0,0,0,0,0,1038097,"2024-01-07T00:00:00.000Z",14,FALSE,13,56677856,"G",13,13,"LA Clippers","Jordan Miller",0,0,0,0,0,0
0,0,0,0,0,0,0,0,0,"00",0,0,0,0,0,0,1038097,"2024-01-07T00:00:00.000Z",14,FALSE,13,371,"F-C",13,13,"LA Clippers","Mason Plumlee",0,0,0,0,0,0
0,0,0,5,2,12,3,6,6,"25",0,1,14,0,2,0,1038097,"2024-01-07T00:00:00.000Z",14,FALSE,13,380,"F-G",13,13,"LA Clippers","Norman Powell",2,14,14,14,0,20
0,1,2,0,0,3,1,0,0,"09",1,0,2,3,0,0,1038097,"2024-01-07T00:00:00.000Z",14,FALSE,13,439,"F",13,13,"LA Clippers","Daniel Theis",1,5,5,2,3,8.6
0,0,0,0,0,0,0,0,0,"00",0,0,0,0,0,0,1038097,"2024-01-07T00:00:00.000Z",14,FALSE,13,56677836,"F",14,14,"Los Angeles Lakers","Maxwell Lewis",0,0,0,0,0,0
6,1,0,9,3,14,5,0,0,"31",0,2,13,0,1,3,1038097,"2024-01-07T00:00:00.000Z",14,FALSE,13,405,"G",14,14,"Los Angeles Lakers","D'Angelo Russell",2,13,19,19,6,25
4,0,2,1,0,3,1,0,0,"21",2,0,2,4,1,1,1038097,"2024-01-07T00:00:00.000Z",14,FALSE,13,457,"F",14,14,"Los Angeles Lakers","Jarred Vanderbilt",1,6,10,6,8,14.8
0,0,0,0,0,0,0,0,0,"00",0,0,0,0,0,0,1038097,"2024-01-07T00:00:00.000Z",14,FALSE,13,666971,"G-F",20,14,"Los Angeles Lakers","Dylan Windler",0,0,0,0,0,0
0,2,9,2,1,6,4,0,0,"16",1,2,9,10,0,1,1038097,"2024-01-07T00:00:00.000Z",14,FALSE,13,486,"F",14,14,"Los Angeles Lakers","Christian Wood",2,19,19,9,10,26
0,0,0,0,0,0,0,0,0,"00",0,0,0,0,0,0,1038097,"2024-01-07T00:00:00.000Z",14,FALSE,13,450,"F",13,13,"LA Clippers","PJ Tucker",0,0,0,0,0,0
3,0,1,4,1,9,3,0,0,"19",0,1,7,1,1,0,1038097,"2024-01-07T00:00:00.000Z",14,FALSE,13,472,"G",13,13,"LA Clippers","Russell Westbrook",1,8,11,10,4,15.7
0,0,0,0,0,0,0,0,0,"00",0,0,0,0,0,0,1038097,"2024-01-07T00:00:00.000Z",14,FALSE,13,38017725,"F",13,13,"LA Clippers","Moussa Diabate",0,0,0,0,0,0
0,0,0,0,0,0,0,0,0,"00",0,0,0,0,0,0,1038097,"2024-01-07T00:00:00.000Z",14,FALSE,13,24417679,"G",13,13,"LA Clippers","Xavier Moon",0,0,0,0,0,0
0,0,0,0,0,0,0,0,0,"00",0,0,0,0,0,0,1038097,"2024-01-07T00:00:00.000Z",14,FALSE,13,17896051,"G",13,13,"LA Clippers","Joshua Primo",0,0,0,0,0,0
4,0,1,14,7,15,8,3,2,"36",1,2,25,2,1,0,1038091,"2024-01-07T00:00:00.000Z",22,FALSE,1,38017724,"G",22,22,"Orlando Magic","Caleb Houstan",1,27,31,29,6,36.4
4,1,9,7,4,29,13,7,5,"45",1,2,35,10,3,2,1038091,"2024-01-07T00:00:00.000Z",22,FALSE,1,38017683,"F",22,22,"Orlando Magic","Paolo Banchero",4,45,49,39,14,63
3,2,7,0,0,6,5,2,1,"28",7,4,11,14,0,0,1038091,"2024-01-07T00:00:00.000Z",22,FALSE,1,666442,"C",22,22,"Orlando Magic","Goga Bitadze",2,25,28,14,17,38.3
2,0,7,5,1,5,1,0,0,"38",0,0,3,7,0,1,1038091,"2024-01-07T00:00:00.000Z",22,FALSE,1,666818,"F",22,22,"Orlando Magic","Chuma Okeke",0,10,12,5,9,13.4
3,0,4,7,4,13,6,0,0,"29",1,6,16,5,1,1,1038091,"2024-01-07T00:00:00.000Z",22,FALSE,1,17896073,"G",22,22,"Orlando Magic","Jalen Suggs",1,21,24,19,8,28.5
5,0,9,3,0,13,3,4,4,"31",0,5,10,9,0,4,1038091,"2024-01-07T00:00:00.000Z",22,FALSE,1,3547251,"G",22,22,"Orlando Magic","Cole Anthony",0,19,24,15,14,24.3
0,0,0,1,0,2,0,0,0,"12",0,1,0,0,1,1,1038091,"2024-01-07T00:00:00.000Z",22,FALSE,1,56677827,"G",22,22,"Orlando Magic","Anthony Black",1,0,0,0,0,2
4,0,2,0,0,2,0,4,0,"15",0,0,0,2,1,1,1038091,"2024-01-07T00:00:00.000Z",22,FALSE,1,165,"G",22,22,"Orlando Magic","Markelle Fultz",1,2,6,4,6,10.4
0,0,0,0,0,0,0,0,0,"00",0,0,0,0,0,0,1038091,"2024-01-07T00:00:00.000Z",22,FALSE,1,226,"F",22,22,"Orlando Magic","Joe Ingles",0,0,0,0,0,0
0,0,0,0,0,1,1,0,0,"06",1,2,2,1,0,1,1038091,"2024-01-07T00:00:00.000Z",22,FALSE,1,17553983,"G",22,22,"Orlando Magic","Trevelin Queen",0,3,3,2,1,2.2
0,0,0,0,0,0,0,0,0,"00",0,0,0,0,0,0,1038091,"2024-01-07T00:00:00.000Z",22,FALSE,1,666885,"F",22,22,"Orlando Magic","Admiral Schofield",0,0,0,0,0,0
0,0,5,4,1,12,6,2,2,"25",2,2,15,7,1,0,1038091,"2024-01-07T00:00:00.000Z",22,FALSE,1,462,"C",22,22,"Orlando Magic","Moritz Wagner",1,22,22,15,7,26.4
0,0,0,0,0,0,0,0,0,"00",0,0,0,0,0,0,1038091,"2024-01-07T00:00:00.000Z",22,FALSE,1,196,"G",22,22,"Orlando Magic","Gary Harris",0,0,0,0,0,0
0,0,0,0,0,0,0,0,0,"00",0,0,0,0,0,0,1038091,"2024-01-07T00:00:00.000Z",22,FALSE,1,38017607,"G",22,22,"Orlando Magic","Kevon Harris",0,0,0,0,0,0
0,0,0,0,0,0,0,0,0,"00",0,0,0,0,0,0,1038091,"2024-01-07T00:00:00.000Z",22,FALSE,1,56677839,"G",22,22,"Orlando Magic","Jett Howard",0,0,0,0,0,0
0,0,0,0,0,0,0,0,0,"00",0,0,0,0,0,0,1038091,"2024-01-07T00:00:00.000Z",22,FALSE,1,229,"F",22,22,"Orlando Magic","Jonathan Isaac",0,0,0,0,0,0
0,0,0,0,0,0,0,0,0,"00",0,0,0,0,0,0,1038091,"2024-01-07T00:00:00.000Z",22,FALSE,1,17896026,"F",22,22,"Orlando Magic","Franz Wagner",0,0,0,0,0,0
2,0,6,4,2,10,5,5,4,"38",1,1,16,7,1,0,1038091,"2024-01-07T00:00:00.000Z",22,FALSE,1,3547256,"F",1,1,"Atlanta Hawks","Saddiq Bey",1,23,25,18,9,30.4
4,1,10,4,0,12,6,0,0,"40",1,6,12,11,0,3,1038091,"2024-01-07T00:00:00.000Z",22,FALSE,1,17896040,"F",1,1,"Atlanta Hawks","Jalen Johnson",1,23,27,16,15,31.2
0,2,8,0,0,6,2,2,0,"36",4,3,4,12,3,1,1038091,"2024-01-07T00:00:00.000Z",22,FALSE,1,83,"C",1,1,"Atlanta Hawks","Clint Capela",5,16,16,4,12,32.4
0,0,0,0,0,0,0,0,0,"00",0,0,0,0,0,0,1038091,"2024-01-07T00:00:00.000Z",22,FALSE,1,56677838,"G",1,1,"Atlanta Hawks","Kobe Bufkin",0,0,0,0,0,0
0,0,0,0,0,0,0,0,0,"00",0,0,0,0,0,0,1038091,"2024-01-07T00:00:00.000Z",22,FALSE,1,56677806,"F",1,1,"Atlanta Hawks","Mouhamed Gueye",0,0,0,0,0,0
0,0,0,0,0,0,0,0,0,"00",0,0,0,0,0,0,1038091,"2024-01-07T00:00:00.000Z",22,FALSE,1,666656,"F",1,1,"Atlanta Hawks","De'Andre Hunter",0,0,0,0,0,0
0,0,0,0,0,0,0,0,0,"00",0,0,0,0,0,0,1038091,"2024-01-07T00:00:00.000Z",22,FALSE,1,4197387,"G",1,1,"Atlanta Hawks","Vit Krejci",0,0,0,0,0,0
2,0,6,2,0,20,9,10,6,"40",0,2,24,6,0,3,1038091,"2024-01-07T00:00:00.000Z",22,FALSE,1,334,"G",1,1,"Atlanta Hawks","Dejounte Murray",0,30,32,26,8,31.2
9,1,4,9,2,23,11,10,7,"42",0,2,31,4,1,5,1038091,"2024-01-07T00:00:00.000Z",22,FALSE,1,490,"G",1,1,"Atlanta Hawks","Trae Young",2,35,44,40,13,50.3
1,0,2,9,4,17,7,0,0,"26",1,5,18,3,4,0,1038091,"2024-01-07T00:00:00.000Z",22,FALSE,1,53,"G",1,1,"Atlanta Hawks","Bogdan Bogdanovic",4,21,22,19,4,35.1
3,5,5,2,1,3,2,2,0,"32",1,3,5,6,0,0,1038091,"2024-01-07T00:00:00.000Z",22,FALSE,1,3547244,"F-C",1,1,"Atlanta Hawks","Onyeka Okongwu",5,11,14,8,9,31.7
0,0,0,0,0,0,0,0,0,"02",0,0,0,0,0,0,1038091,"2024-01-07T00:00:00.000Z",22,FALSE,1,666754,"G",1,1,"Atlanta Hawks","Garrison Mathews",0,0,0,0,0,0
0,1,1,0,0,0,0,0,0,"09",0,1,0,1,0,0,1038091,"2024-01-07T00:00:00.000Z",22,FALSE,1,301,"G-F",1,1,"Atlanta Hawks","Wesley Matthews",1,1,1,0,1,4.2
0,0,0,0,0,0,0,0,0,"00",0,0,0,0,0,0,1038091,"2024-01-07T00:00:00.000Z",22,FALSE,1,666564,"F",1,1,"Atlanta Hawks","Bruno Fernando",0,0,0,0,0,0
0,0,0,0,0,0,0,0,0,"00",0,0,0,0,0,0,1038091,"2024-01-07T00:00:00.000Z",22,FALSE,1,3547297,"G",1,1,"Atlanta Hawks","Trent Forrest",0,0,0,0,0,0
0,0,0,0,0,0,0,0,0,"00",0,0,0,0,0,0,1038091,"2024-01-07T00:00:00.000Z",22,FALSE,1,38017689,"F",1,1,"Atlanta Hawks","AJ Griffin",0,0,0,0,0,0
0,0,0,0,0,0,0,0,0,"00",0,0,0,0,0,0,1038091,"2024-01-07T00:00:00.000Z",22,FALSE,1,56677855,"G",1,1,"Atlanta Hawks","Seth Lundy",0,0,0,0,0,0
0,0,0,0,0,0,0,0,0,"00",0,0,0,0,0,0,1038091,"2024-01-07T00:00:00.000Z",22,FALSE,1,319,"G",1,1,"Atlanta Hawks","Patty Mills",0,0,0,0,0,0
0,0,0,0,0,0,0,0,0,"00",0,0,0,0,0,0,1038091,"2024-01-07T00:00:00.000Z",22,FALSE,1,85,"F",22,22,"Orlando Magic","Wendell Carter Jr.",0,0,0,0,0,0
0,0,0,5,2,9,4,0,0,"22",1,1,10,1,0,0,1038092,"2024-01-07T00:00:00.000Z",26,FALSE,19,30,"F",26,26,"Sacramento Kings","Harrison Barnes",0,11,11,10,1,11.2
0,0,0,6,1,9,2,3,3,"26",1,1,8,1,2,0,1038092,"2024-01-07T00:00:00.000Z",26,FALSE,19,38017688,"F",26,26,"Sacramento Kings","Keegan Murray",2,9,9,8,1,15.2
6,0,10,2,1,12,8,1,0,"29",0,2,17,10,1,3,1038092,"2024-01-07T00:00:00.000Z",26,FALSE,19,406,"F",26,26,"Sacramento Kings","Domantas Sabonis",1,27,33,23,16,38
1,0,0,2,0,3,0,2,1,"15",0,0,1,0,0,0,1038092,"2024-01-07T00:00:00.000Z",26,FALSE,19,17896030,"G",26,26,"Sacramento Kings","Chris Duarte",0,1,2,2,1,2.5
4,0,2,4,1,10,1,0,0,"26",0,3,3,2,0,4,1038092,"2024-01-07T00:00:00.000Z",26,FALSE,19,161,"G",26,26,"Sacramento Kings","De'Aaron Fox",0,5,9,7,6,7.4
3,1,0,6,2,10,6,4,3,"24",1,0,17,1,1,0,1038092,"2024-01-07T00:00:00.000Z",26,FALSE,19,221,"G",26,26,"Sacramento Kings","Kevin Huerter",2,18,21,20,4,28.7
5,1,1,6,2,9,2,0,0,"21",0,1,6,1,1,1,1038092,"2024-01-07T00:00:00.000Z",26,FALSE,19,324,"G",26,26,"Sacramento Kings","Malik Monk",2,7,12,11,6,19.7
0,1,0,0,0,0,0,0,0,"04",0,1,0,0,0,1,1038092,"2024-01-07T00:00:00.000Z",26,FALSE,19,38017663,"F",19,19,"New Orleans Pelicans","E.J. Liddell",1,0,0,0,0,2
2,0,4,1,1,4,3,4,4,"22",1,2,11,5,0,1,1038092,"2024-01-07T00:00:00.000Z",26,FALSE,19,3547293,"F",19,19,"New Orleans Pelicans","Naji Marshall",0,16,18,13,7,19
4,1,5,0,0,4,1,0,0,"14",2,1,2,7,0,2,1038092,"2024-01-07T00:00:00.000Z",26,FALSE,19,340,"F",19,19,"New Orleans Pelicans","Larry Nance Jr.",1,9,13,6,11,17.4
0,1,0,2,1,4,3,0,0,"10",0,1,7,0,0,1,1038092,"2024-01-07T00:00:00.000Z",26,FALSE,19,17896021,"F",19,19,"New Orleans Pelicans","Jeremiah Robinson-Earl",1,7,7,7,0,9
1,0,1,1,1,3,2,2,2,"07",1,0,7,2,0,2,1038092,"2024-01-07T00:00:00.000Z",26,FALSE,19,491,"C",19,19,"New Orleans Pelicans","Cody Zeller",0,9,10,8,3,8.9
0,0,0,0,0,0,0,0,0,"00",0,0,0,0,0,0,1038092,"2024-01-07T00:00:00.000Z",26,FALSE,19,17896097,"G",19,19,"New Orleans Pelicans","Jose Alvarado",0,0,0,0,0,0
0,0,0,0,0,0,0,0,0,"00",0,0,0,0,0,0,1038092,"2024-01-07T00:00:00.000Z",26,FALSE,19,3547260,"G",19,19,"New Orleans Pelicans","Kira Lewis Jr.",0,0,0,0,0,0
0,0,0,0,0,0,0,0,0,"00",0,0,0,0,0,0,1038092,"2024-01-07T00:00:00.000Z",26,FALSE,19,17896017,"F",19,19,"New Orleans Pelicans","Matt Ryan",0,0,0,0,0,0
0,0,0,0,0,0,0,0,0,"00",0,0,0,0,0,0,1038092,"2024-01-07T00:00:00.000Z",26,FALSE,19,38017726,"G",19,19,"New Orleans Pelicans","Dereon Seabron",0,0,0,0,0,0
0,0,0,0,0,0,0,0,0,"00",0,0,0,0,0,0,1038092,"2024-01-07T00:00:00.000Z",26,FALSE,19,666969,"F",19,19,"New Orleans Pelicans","Zion Williamson",0,0,0,0,0,0
0,0,0,2,0,2,0,0,0,"10",0,1,0,0,1,0,1038092,"2024-01-07T00:00:00.000Z",26,FALSE,19,17553994,"G",26,26,"Sacramento Kings","Davion Mitchell",1,0,0,0,0,3
0,0,1,5,1,9,5,0,0,"21",1,0,11,2,0,0,1038092,"2024-01-07T00:00:00.000Z",26,FALSE,19,4197162,"F",26,26,"Sacramento Kings","Aleksandar Vezenkov",0,13,13,11,2,13.4
0,0,1,2,2,4,3,2,2,"08",1,0,10,2,0,0,1038092,"2024-01-07T00:00:00.000Z",26,FALSE,19,17896044,"F",26,26,"Sacramento Kings","Kessler Edwards",0,12,12,10,2,12.4
1,0,0,3,3,6,5,0,0,"12",2,1,13,2,1,0,1038092,"2024-01-07T00:00:00.000Z",26,FALSE,19,38017714,"G",26,26,"Sacramento Kings","Keon Ellis",1,15,16,14,3,19.9
4,0,1,2,0,5,2,0,0,"10",0,1,4,1,1,0,1038092,"2024-01-07T00:00:00.000Z",26,FALSE,19,56677845,"G",26,26,"Sacramento Kings","Colby Jones",1,5,9,8,5,14.2
3,0,0,0,0,2,0,0,0,"10",1,1,0,1,1,0,1038092,"2024-01-07T00:00:00.000Z",26,FALSE,19,273,"C",26,26,"Sacramento Kings","Alex Len",1,1,4,3,4,8.7
1,0,1,0,0,1,0,0,0,"06",0,0,0,1,0,1,1038092,"2024-01-07T00:00:00.000Z",26,FALSE,19,306,"C",26,26,"Sacramento Kings","JaVale McGee",0,1,2,1,2,1.7
0,0,0,0,0,0,0,0,0,"00",0,0,0,0,0,0,1038092,"2024-01-07T00:00:00.000Z",26,FALSE,19,17895990,"G",26,26,"Sacramento Kings","Jordan Ford",0,0,0,0,0,0
2,1,3,5,1,9,5,2,1,"24",0,2,12,3,0,2,1038092,"2024-01-07T00:00:00.000Z",26,FALSE,19,56677837,"G",19,19,"New Orleans Pelicans","Jordan Hawkins",1,15,17,14,5,19.6
4,2,6,10,7,16,11,2,1,"27",1,0,30,7,0,3,1038092,"2024-01-07T00:00:00.000Z",26,FALSE,19,303,"G",19,19,"New Orleans Pelicans","CJ McCollum",2,37,41,34,11,47.4
6,0,4,2,2,6,6,0,0,"29",1,3,14,5,0,0,1038092,"2024-01-07T00:00:00.000Z",26,FALSE,19,38017677,"G",19,19,"New Orleans Pelicans","Dyson Daniels",0,19,25,20,11,29
0,0,0,0,0,0,0,0,0,"00",0,0,0,0,0,0,1038092,"2024-01-07T00:00:00.000Z",26,FALSE,19,290,"F",26,26,"Sacramento Kings","Trey Lyles",0,0,0,0,0,0
0,0,0,0,0,0,0,0,0,"00",0,0,0,0,0,0,1038092,"2024-01-07T00:00:00.000Z",26,FALSE,19,56677862,"F",26,26,"Sacramento Kings","Jalen Slawson",0,0,0,0,0,0
0,0,0,0,0,0,0,0,0,"00",0,0,0,0,0,0,1038092,"2024-01-07T00:00:00.000Z",26,FALSE,19,666925,"F",29,26,"Sacramento Kings","Juan Toscano-Anderson",0,0,0,0,0,0
8,1,4,3,1,12,6,2,2,"30",1,0,15,5,1,1,1038092,"2024-01-07T00:00:00.000Z",26,FALSE,19,227,"F",19,19,"New Orleans Pelicans","Brandon Ingram",2,20,28,23,13,38
5,0,2,6,3,7,4,0,0,"25",0,1,11,2,1,1,1038092,"2024-01-07T00:00:00.000Z",26,FALSE,19,18677986,"F",19,19,"New Orleans Pelicans","Trey Murphy III",1,13,18,16,7,22.9
1,1,11,2,1,10,6,2,2,"22",1,2,15,12,0,1,1038092,"2024-01-07T00:00:00.000Z",26,FALSE,19,455,"C",19,19,"New Orleans Pelicans","Jonas Valanciunas",1,27,28,16,13,32.9
2,1,2,3,1,7,3,2,2,"26",1,1,9,3,0,1,1038092,"2024-01-07T00:00:00.000Z",26,FALSE,19,17896024,"F",19,19,"New Orleans Pelicans","Herbert Jones",1,12,14,11,5,17.6
2,0,1,5,1,12,7,3,3,"28",0,1,18,1,0,1,1038094,"2024-01-07T00:00:00.000Z",8,FALSE,9,375,"F",8,8,"Denver Nuggets","Michael Porter Jr.",0,19,21,20,3,21.2
1,0,0,0,0,4,3,2,2,"20",1,0,8,1,1,0,1038094,"2024-01-07T00:00:00.000Z",8,FALSE,9,177,"F",8,8,"Denver Nuggets","Aaron Gordon",1,9,10,9,2,13.7
16,5,7,0,0,3,2,0,0,"25",0,4,4,7,0,3,1038094,"2024-01-07T00:00:00.000Z",8,FALSE,9,246,"C",8,8,"Denver Nuggets","Nikola Jokic",5,11,27,20,23,48.4
0,1,4,6,3,10,6,3,3,"36",0,2,18,4,2,2,1038094,"2024-01-07T00:00:00.000Z",8,FALSE,9,81,"G",8,8,"Denver Nuggets","Kentavious Caldwell-Pope",3,22,22,18,4,29.8
4,1,3,8,3,24,14,7,6,"30",2,4,37,5,1,1,1038094,"2024-01-07T00:00:00.000Z",8,FALSE,9,335,"G",8,8,"Denver Nuggets","Jamal Murray",2,42,46,41,9,54
1,1,3,1,0,5,3,2,1,"21",0,0,7,3,0,0,1038094,"2024-01-07T00:00:00.000Z",8,FALSE,9,38017709,"G",8,8,"Denver Nuggets","Christian Braun",1,10,11,8,4,15.1
9,0,1,1,1,7,5,2,2,"21",2,5,13,3,1,2,1038094,"2024-01-07T00:00:00.000Z",8,FALSE,9,236,"G",8,8,"Denver Nuggets","Reggie Jackson",1,16,25,22,12,31.1
1,0,2,2,1,6,2,2,2,"11",0,0,7,2,0,0,1038094,"2024-01-07T00:00:00.000Z",8,FALSE,9,56677792,"G",9,9,"Detroit Pistons","Marcus Sasser",0,9,10,8,3,10.9
4,0,2,1,0,5,2,3,1,"20",3,2,5,5,0,1,1038094,"2024-01-07T00:00:00.000Z",8,FALSE,9,56677826,"G-F",9,9,"Detroit Pistons","Ausar Thompson",0,10,14,9,9,16
0,0,1,0,0,7,4,2,1,"18",2,1,9,3,0,0,1038094,"2024-01-07T00:00:00.000Z",8,FALSE,9,3547240,"C",9,9,"Detroit Pistons","James Wiseman",0,12,12,9,3,12.6
0,0,0,0,0,0,0,0,0,"00",0,0,0,0,0,0,1038094,"2024-01-07T00:00:00.000Z",8,FALSE,9,56677729,"G",9,9,"Detroit Pistons","Malcolm Cazalon",0,0,0,0,0,0
0,0,0,0,0,0,0,0,0,"00",0,0,0,0,0,0,1038094,"2024-01-07T00:00:00.000Z",8,FALSE,9,330,"G",9,9,"Detroit Pistons","Monte Morris",0,0,0,0,0,0
0,0,0,0,0,0,0,0,0,"00",0,0,0,0,0,0,1038094,"2024-01-07T00:00:00.000Z",8,FALSE,9,42097199,"G",9,9,"Detroit Pistons","Jared Rhoden",0,0,0,0,0,0
0,0,0,0,0,0,0,0,0,"00",0,0,0,0,0,0,1038094,"2024-01-07T00:00:00.000Z",8,FALSE,9,3547267,"F-C",9,9,"Detroit Pistons","Isaiah Stewart",0,0,0,0,0,0
0,0,0,0,0,0,0,0,0,"00",0,0,0,0,0,0,1038094,"2024-01-07T00:00:00.000Z",8,FALSE,9,44477024,"G",9,9,"Detroit Pistons","Stanley Umude",0,0,0,0,0,0
3,0,3,2,1,6,1,0,0,"11",0,2,3,3,0,0,1038094,"2024-01-07T00:00:00.000Z",8,FALSE,9,17896075,"G-F",9,9,"Detroit Pistons","Cade Cunningham",0,6,9,6,6,11.1
0,0,0,0,0,0,0,0,0,"00",0,0,0,0,0,0,1038094,"2024-01-07T00:00:00.000Z",8,FALSE,9,24,"F",9,9,"Detroit Pistons","Marvin Bagley III",0,0,0,0,0,0
1,0,3,3,3,9,6,3,3,"20",1,1,18,4,0,1,1038094,"2024-01-07T00:00:00.000Z",8,FALSE,9,77,"G",9,9,"Detroit Pistons","Alec Burks",0,22,23,19,5,23.3
0,0,0,0,0,0,0,0,0,"00",0,0,0,0,0,0,1038094,"2024-01-07T00:00:00.000Z",8,FALSE,9,197,"F-G",9,9,"Detroit Pistons","Joe Harris",0,0,0,0,0,0
6,0,2,1,0,5,1,0,0,"25",0,4,2,2,1,1,1038094,"2024-01-07T00:00:00.000Z",8,FALSE,9,3547241,"G",9,9,"Detroit Pistons","Killian Hayes",1,4,10,8,8,15.4
1,0,1,3,1,8,4,4,3,"20",2,0,12,3,0,0,1038094,"2024-01-07T00:00:00.000Z",8,FALSE,9,259,"F",9,9,"Detroit Pistons","Kevin Knox",0,15,16,13,4,17.1
0,0,0,0,0,0,0,0,0,"00",0,0,0,0,0,0,1038094,"2024-01-07T00:00:00.000Z",8,FALSE,9,666489,"F",8,8,"Denver Nuggets","Vlatko Cancar",0,0,0,0,0,0
0,0,0,0,0,0,0,0,0,"00",0,0,0,0,0,0,1038094,"2024-01-07T00:00:00.000Z",8,FALSE,9,56677582,"G",8,8,"Denver Nuggets","Jalen Pickett",0,0,0,0,0,0
0,0,0,0,0,0,0,0,0,"00",0,0,0,0,0,0,1038094,"2024-01-07T00:00:00.000Z",8,FALSE,9,56677776,"G",8,8,"Denver Nuggets","Julian Strawther",0,0,0,0,0,0
0,0,0,0,0,0,0,0,0,"00",0,0,0,0,0,0,1038094,"2024-01-07T00:00:00.000Z",8,FALSE,9,56677871,"F",8,8,"Denver Nuggets","Hunter Tyson",0,0,0,0,0,0
1,0,1,4,2,12,6,0,0,"27",0,2,14,1,3,3,1038094,"2024-01-07T00:00:00.000Z",8,FALSE,9,54,"F",9,9,"Detroit Pistons","Bojan Bogdanovic",3,15,16,15,2,22.7
1,0,3,2,1,8,4,2,2,"31",2,5,11,5,1,0,1038094,"2024-01-07T00:00:00.000Z",8,FALSE,9,17896071,"F",9,9,"Detroit Pistons","Isaiah Livers",1,16,17,12,6,21.5
4,0,3,0,0,12,8,6,4,"30",2,1,20,5,0,1,1038094,"2024-01-07T00:00:00.000Z",8,FALSE,9,38017694,"C",9,9,"Detroit Pistons","Jalen Duren",0,25,29,24,9,31
6,0,3,6,0,11,4,8,5,"27",1,2,13,4,1,4,1038094,"2024-01-07T00:00:00.000Z",8,FALSE,9,38017682,"G",9,9,"Detroit Pistons","Jaden Ivey",1,17,23,19,10,25.8
1,1,5,4,2,10,4,5,5,"23",1,0,15,6,1,0,1038094,"2024-01-07T00:00:00.000Z",8,FALSE,9,38017721,"G",8,8,"Denver Nuggets","Peyton Watson",2,21,22,16,7,29.7
1,1,7,0,0,3,3,5,3,"21",0,5,9,7,0,3,1038094,"2024-01-07T00:00:00.000Z",8,FALSE,9,250,"C",8,8,"Denver Nuggets","DeAndre Jordan",1,16,17,10,8,18.9
0,0,0,0,0,0,0,0,0,"03",0,1,0,0,0,1,1038094,"2024-01-07T00:00:00.000Z",8,FALSE,9,38017727,"G",8,8,"Denver Nuggets","Collin Gillespie",0,0,0,0,0,-1
0,0,0,0,0,0,0,0,0,"04",0,0,0,0,0,0,1038094,"2024-01-07T00:00:00.000Z",8,FALSE,9,215,"F-G",8,8,"Denver Nuggets","Justin Holiday",0,0,0,0,0,0
0,0,0,1,0,1,0,0,0,"02",0,1,0,0,0,0,1038094,"2024-01-07T00:00:00.000Z",8,FALSE,9,17896103,"F-C",8,8,"Denver Nuggets","Jay Huff",0,0,0,0,0,0
0,0,1,0,0,0,0,2,2,"03",0,0,2,1,0,0,1038094,"2024-01-07T00:00:00.000Z",8,FALSE,9,17896007,"G",8,8,"Denver Nuggets","Braxton Key",0,3,3,2,1,3.2
0,0,0,1,0,1,0,0,0,"03",0,0,0,0,0,0,1038094,"2024-01-07T00:00:00.000Z",8,FALSE,9,3547268,"F-C",8,8,"Denver Nuggets","Zeke Nnaji",0,0,0,0,0,0
3,2,2,8,4,15,6,0,0,"39",0,2,16,2,0,3,1038095,"2024-01-07T00:00:00.000Z",24,FALSE,15,8,"G",24,24,"Phoenix Suns","Grayson Allen",2,18,21,19,5,25.9
5,1,8,1,0,23,11,1,1,"37",2,1,23,10,0,1,1038095,"2024-01-07T00:00:00.000Z",24,FALSE,15,140,"F",24,24,"Phoenix Suns","Kevin Durant",1,33,38,28,15,44.5
5,1,13,2,1,17,8,3,1,"32",6,4,18,19,0,2,1038095,"2024-01-07T00:00:00.000Z",24,FALSE,15,349,"C",24,24,"Phoenix Suns","Jusuf Nurkic",1,37,42,23,24,49.3
5,0,3,1,0,12,5,4,2,"37",3,3,12,6,0,1,1038095,"2024-01-07T00:00:00.000Z",24,FALSE,15,37,"G",24,24,"Phoenix Suns","Bradley Beal",0,18,23,17,11,25.7
8,1,0,6,2,17,9,5,4,"37",0,4,24,0,2,2,1038095,"2024-01-07T00:00:00.000Z",24,FALSE,15,57,"G",24,24,"Phoenix Suns","Devin Booker",3,24,32,32,8,43
1,0,2,3,1,3,1,0,0,"14",1,3,3,3,0,0,1038095,"2024-01-07T00:00:00.000Z",24,FALSE,15,32,"F",24,24,"Phoenix Suns","Keita Bates-Diop",0,6,7,4,4,8.1
0,0,4,0,0,3,2,5,4,"13",3,1,8,7,0,2,1038095,"2024-01-07T00:00:00.000Z",24,FALSE,15,147,"F",24,24,"Phoenix Suns","Drew Eubanks",0,15,15,8,7,14.4
0,0,0,0,0,0,0,0,0,"00",0,0,0,0,0,0,1038095,"2024-01-07T00:00:00.000Z",24,FALSE,15,18678058,"",24,24,"Phoenix Suns","Jordan Goodwin",0,0,0,0,0,0
0,1,0,0,0,0,0,2,1,"05",1,1,1,1,0,0,1038095,"2024-01-07T00:00:00.000Z",24,FALSE,15,3547298,"G",24,24,"Phoenix Suns","Saben Lee",1,2,2,1,1,5.2
0,0,1,5,0,7,2,0,0,"12",0,3,4,1,1,1,1038095,"2024-01-07T00:00:00.000Z",24,FALSE,15,314,"F",24,24,"Phoenix Suns","Chimezie Metu",1,5,5,4,1,7.2
2,0,1,2,0,5,2,2,2,"14",0,5,6,1,2,0,1038095,"2024-01-07T00:00:00.000Z",24,FALSE,15,356,"G",24,24,"Phoenix Suns","Josh Okogie",2,7,9,8,3,16.2
0,0,0,0,0,0,0,0,0,"00",0,0,0,0,0,0,1038095,"2024-01-07T00:00:00.000Z",24,FALSE,15,470,"G",24,24,"Phoenix Suns","Yuta Watanabe",0,0,0,0,0,0
6,1,9,8,3,20,11,4,3,"32",1,5,28,10,0,2,1038095,"2024-01-07T00:00:00.000Z",24,FALSE,15,231,"F-C",15,15,"Memphis Grizzlies","Jaren Jackson Jr.",1,38,44,34,16,50
2,3,5,0,0,2,0,2,1,"26",1,3,1,6,0,2,1038095,"2024-01-07T00:00:00.000Z",24,FALSE,15,48,"C",15,15,"Memphis Grizzlies","Bismack Biyombo",3,7,9,3,8,18.2
5,1,3,7,2,14,8,5,5,"36",2,3,23,5,1,3,1038095,"2024-01-07T00:00:00.000Z",24,FALSE,15,3547287,"G",15,15,"Memphis Grizzlies","Desmond Bane",2,28,33,28,10,39.5
8,0,6,13,4,20,9,5,3,"38",0,2,25,6,3,5,1038095,"2024-01-07T00:00:00.000Z",24,FALSE,15,420,"G",15,15,"Memphis Grizzlies","Marcus Smart",3,31,39,33,14,48.2
1,1,5,7,1,11,2,3,2,"16",2,2,7,7,1,4,1038095,"2024-01-07T00:00:00.000Z",24,FALSE,15,17896067,"F",15,15,"Memphis Grizzlies","Santi Aldama",2,14,15,8,8,18.9
0,0,1,1,0,1,0,0,0,"03",0,0,0,1,0,0,1038095,"2024-01-07T00:00:00.000Z",24,FALSE,15,666703,"G-F",15,15,"Memphis Grizzlies","John Konchar",0,1,1,0,1,1.2
0,0,0,0,0,0,0,0,0,"00",0,0,0,0,0,0,1038095,"2024-01-07T00:00:00.000Z",24,FALSE,15,38017729,"F",15,15,"Memphis Grizzlies","David Roddy",0,0,0,0,0,0
0,0,0,0,0,0,0,0,0,"00",0,0,0,0,0,0,1038095,"2024-01-07T00:00:00.000Z",24,FALSE,15,401,"G",15,15,"Memphis Grizzlies","Derrick Rose",0,0,0,0,0,0
0,0,0,1,0,3,0,0,0,"03",3,1,0,3,0,0,1038095,"2024-01-07T00:00:00.000Z",24,FALSE,15,3547285,"F",15,15,"Memphis Grizzlies","Xavier Tillman",0,3,3,0,3,3.6
1,2,5,4,3,11,6,4,4,"37",4,2,19,9,0,0,1038095,"2024-01-07T00:00:00.000Z",24,FALSE,15,38017731,"G",15,15,"Memphis Grizzlies","Vince Williams Jr.",2,28,29,20,10,37.3
3,0,2,5,1,10,4,1,0,"27",2,4,9,4,2,1,1038095,"2024-01-07T00:00:00.000Z",24,FALSE,15,17896027,"G-F",15,15,"Memphis Grizzlies","Ziaire Williams",2,13,16,12,7,23.3
0,0,0,0,0,0,0,0,0,"00",0,0,0,0,0,0,1038095,"2024-01-07T00:00:00.000Z",24,FALSE,15,3,"C",15,15,"Memphis Grizzlies","Steven Adams",0,0,0,0,0,0
0,0,0,0,0,0,0,0,0,"00",0,0,0,0,0,0,1038095,"2024-01-07T00:00:00.000Z",24,FALSE,15,666505,"F",15,15,"Memphis Grizzlies","Brandon Clarke",0,0,0,0,0,0
0,0,0,0,0,0,0,0,0,"00",0,0,0,0,0,0,1038095,"2024-01-07T00:00:00.000Z",24,FALSE,15,48248287,"G",15,15,"Memphis Grizzlies","Jacob Gilyard",0,0,0,0,0,0
0,0,0,0,0,0,0,0,0,"00",0,0,0,0,0,0,1038095,"2024-01-07T00:00:00.000Z",24,FALSE,15,56677830,"F",15,15,"Memphis Grizzlies","GG Jackson",0,0,0,0,0,0
0,0,0,0,0,0,0,0,0,"00",0,0,0,0,0,0,1038095,"2024-01-07T00:00:00.000Z",24,FALSE,15,38017728,"F",15,15,"Memphis Grizzlies","Jake LaRavia",0,0,0,0,0,0
0,0,0,0,0,0,0,0,0,"00",0,0,0,0,0,0,1038095,"2024-01-07T00:00:00.000Z",24,FALSE,15,3547095,"C-F",24,24,"Phoenix Suns","Udoka Azubuike",0,0,0,0,0,0
0,0,0,0,0,0,0,0,0,"00",0,0,0,0,0,0,1038095,"2024-01-07T00:00:00.000Z",24,FALSE,15,666451,"C",24,24,"Phoenix Suns","Bol Bol",0,0,0,0,0,0
0,0,0,0,0,0,0,0,0,"00",0,0,0,0,0,0,1038095,"2024-01-07T00:00:00.000Z",24,FALSE,15,178,"G",24,24,"Phoenix Suns","Eric Gordon",0,0,0,0,0,0
0,0,0,0,0,0,0,0,0,"00",0,0,0,0,0,0,1038095,"2024-01-07T00:00:00.000Z",24,FALSE,15,272,"G",24,24,"Phoenix Suns","Damion Lee",0,0,0,0,0,0
0,0,0,0,0,0,0,0,0,"00",0,0,0,0,0,0,1038095,"2024-01-07T00:00:00.000Z",24,FALSE,15,666729,"F",24,24,"Phoenix Suns","Nassir Little",0,0,0,0,0,0
0,0,0,0,0,0,0,0,0,"00",0,0,0,0,0,0,1038095,"2024-01-07T00:00:00.000Z",24,FALSE,15,3547253,"G",4,24,"Phoenix Suns","Theo Maledon",0,0,0,0,0,0
3,0,3,3,3,5,3,0,0,"22",0,2,9,3,0,0,1038095,"2024-01-07T00:00:00.000Z",24,FALSE,15,254,"G",15,15,"Memphis Grizzlies","Luke Kennard",0,12,15,12,6,17.1
0,0,0,0,0,0,0,0,0,"00",0,0,0,0,0,0,1038095,"2024-01-07T00:00:00.000Z",24,FALSE,15,666786,"G",15,15,"Memphis Grizzlies","Ja Morant",0,0,0,0,0,0
1,0,1,2,1,2,1,0,0,"27",4,0,3,5,0,2,1038089,"2024-01-07T00:00:00.000Z",6,FALSE,27,3547247,"F-G",6,6,"Cleveland Cavaliers","Isaac Okoro",0,8,9,4,6,8.5
1,0,2,2,0,3,0,0,0,"11",0,2,0,2,0,1,1038089,"2024-01-07T00:00:00.000Z",6,FALSE,27,666940,"F",6,6,"Cleveland Cavaliers","Dean Wade",0,2,3,1,3,2.9
2,1,11,0,0,19,11,7,7,"31",5,3,29,16,1,1,1038089,"2024-01-07T00:00:00.000Z",6,FALSE,27,9,"C",6,6,"Cleveland Cavaliers","Jarrett Allen",2,45,47,31,18,56.2
4,0,4,9,2,11,3,0,0,"37",1,2,8,5,2,2,1038089,"2024-01-07T00:00:00.000Z",6,FALSE,27,666908,"G",6,6,"Cleveland Cavaliers","Max Strus",2,13,17,12,9,24
9,0,2,10,1,18,7,4,2,"37",0,1,17,2,1,4,1038089,"2024-01-07T00:00:00.000Z",6,FALSE,27,322,"G",6,6,"Cleveland Cavaliers","Donovan Mitchell",1,19,28,26,11,31.9
0,0,0,0,0,0,0,0,0,"00",0,0,0,0,0,0,1038089,"2024-01-07T00:00:00.000Z",6,FALSE,27,56677847,"F",6,6,"Cleveland Cavaliers","Emoni Bates",0,0,0,0,0,0
0,0,0,0,0,0,0,0,0,"00",0,0,0,0,0,0,1038089,"2024-01-07T00:00:00.000Z",6,FALSE,27,248,"C",6,6,"Cleveland Cavaliers","Damian Jones",0,0,0,0,0,0
3,0,2,5,4,13,9,3,1,"26",0,2,23,2,2,4,1038089,"2024-01-07T00:00:00.000Z",6,FALSE,27,277,"G",6,6,"Cleveland Cavaliers","Caris LeVert",2,25,28,26,5,31.9
3,0,3,9,5,11,5,3,3,"23",0,0,18,3,0,0,1038089,"2024-01-07T00:00:00.000Z",6,FALSE,27,3547299,"G",6,6,"Cleveland Cavaliers","Sam Merrill",0,21,24,21,6,26.1
1,1,4,6,3,7,4,0,0,"27",0,2,11,4,0,1,1038089,"2024-01-07T00:00:00.000Z",6,FALSE,27,344,"F",6,6,"Cleveland Cavaliers","Georges Niang",1,15,16,12,5,19.3
1,1,1,0,0,0,0,0,0,"04",0,0,0,1,0,0,1038089,"2024-01-07T00:00:00.000Z",6,FALSE,27,56677872,"G",6,6,"Cleveland Cavaliers","Craig Porter",1,1,2,1,2,5.7
2,0,2,0,0,4,3,4,2,"17",2,4,8,4,0,1,1038089,"2024-01-07T00:00:00.000Z",6,FALSE,27,444,"C-F",6,6,"Cleveland Cavaliers","Tristan Thompson",0,12,14,10,6,14.8
0,0,0,0,0,0,0,0,0,"00",0,0,0,0,0,0,1038089,"2024-01-07T00:00:00.000Z",6,FALSE,27,666581,"G",6,6,"Cleveland Cavaliers","Darius Garland",0,0,0,0,0,0
4,0,4,5,2,9,4,1,1,"28",1,2,11,5,0,1,1038089,"2024-01-07T00:00:00.000Z",6,FALSE,27,38017699,"F",27,27,"San Antonio Spurs","Jeremy Sochan",0,16,20,15,9,22
3,5,9,5,2,13,6,11,10,"25",0,3,24,9,1,3,1038089,"2024-01-07T00:00:00.000Z",6,FALSE,27,56677822,"F-C",27,27,"San Antonio Spurs","Victor Wembanyama",6,33,36,27,12,54.3
2,0,3,9,4,19,9,0,0,"35",0,2,22,3,3,0,1038089,"2024-01-07T00:00:00.000Z",6,FALSE,27,3547246,"G-F",27,27,"San Antonio Spurs","Devin Vassell",3,25,27,24,5,37.6
5,0,2,2,2,8,7,2,2,"34",0,1,18,2,2,2,1038089,"2024-01-07T00:00:00.000Z",6,FALSE,27,3547274,"G",27,27,"San Antonio Spurs","Tre Jones",2,20,25,23,7,31.9
2,1,4,0,0,5,3,0,0,"22",2,3,6,6,1,1,1038089,"2024-01-07T00:00:00.000Z",6,FALSE,27,38017730,"F",27,27,"San Antonio Spurs","Dominick Barlow",2,12,14,8,8,21.2
2,0,1,3,0,5,1,0,0,"15",0,2,2,1,0,1,1038089,"2024-01-07T00:00:00.000Z",6,FALSE,27,38017692,"F",27,27,"San Antonio Spurs","Malaki Branham",0,3,5,4,3,5.2
0,0,0,0,0,0,0,0,0,"00",0,0,0,0,0,0,1038089,"2024-01-07T00:00:00.000Z",6,FALSE,27,3547163,"F",6,27,"San Antonio Spurs","Mamadi Diakite",0,0,0,0,0,0
0,0,0,0,0,0,0,0,0,"00",0,0,0,0,0,0,1038089,"2024-01-07T00:00:00.000Z",6,FALSE,27,180,"G",27,27,"San Antonio Spurs","Devonte' Graham",0,0,0,0,0,0
2,0,1,6,3,16,6,4,3,"33",3,3,18,4,1,0,1038089,"2024-01-07T00:00:00.000Z",6,FALSE,27,666682,"F",27,27,"San Antonio Spurs","Keldon Johnson",1,22,24,20,6,28.8
0,0,0,0,0,0,0,0,0,"00",0,0,0,0,0,0,1038089,"2024-01-07T00:00:00.000Z",6,FALSE,27,17896059,"F",27,27,"San Antonio Spurs","Sandro Mamukelashvili",0,0,0,0,0,0
0,0,0,0,0,0,0,0,0,"00",0,0,0,0,0,0,1038089,"2024-01-07T00:00:00.000Z",6,FALSE,27,305,"F",27,27,"San Antonio Spurs","Doug McDermott",0,0,0,0,0,0
1,0,4,4,1,7,4,0,0,"21",2,1,9,6,1,0,1038089,"2024-01-07T00:00:00.000Z",6,FALSE,27,359,"F",27,27,"San Antonio Spurs","Cedi Osman",1,15,16,10,7,20.7
0,0,2,1,0,2,1,2,1,"11",0,1,3,2,0,2,1038089,"2024-01-07T00:00:00.000Z",6,FALSE,27,38017693,"G",27,27,"San Antonio Spurs","Blake Wesley",0,5,5,3,2,3.4
0,0,0,0,0,0,0,0,0,"00",0,0,0,0,0,0,1038089,"2024-01-07T00:00:00.000Z",6,FALSE,27,666676,"G",6,6,"Cleveland Cavaliers","Ty Jerome",0,0,0,0,0,0
0,0,0,0,0,0,0,0,0,"00",0,0,0,0,0,0,1038089,"2024-01-07T00:00:00.000Z",6,FALSE,27,17896076,"F-C",6,6,"Cleveland Cavaliers","Evan Mobley",0,0,0,0,0,0
0,0,0,0,0,0,0,0,0,"00",0,0,0,0,0,0,1038089,"2024-01-07T00:00:00.000Z",6,FALSE,27,38017662,"F",6,6,"Cleveland Cavaliers","Isaiah Mobley",0,0,0,0,0,0
1,0,2,2,0,2,0,2,2,"16",0,0,2,2,1,1,1038089,"2024-01-07T00:00:00.000Z",6,FALSE,27,38017649,"F",27,27,"San Antonio Spurs","Julian Champagnie",1,4,5,3,3,7.9
0,0,0,0,0,0,0,0,0,"00",0,0,0,0,0,0,1038089,"2024-01-07T00:00:00.000Z",6,FALSE,27,17896049,"G",3,27,"San Antonio Spurs","David Duke Jr.",0,0,0,0,0,0
0,0,0,0,0,0,0,0,0,"00",0,0,0,0,0,0,1038089,"2024-01-07T00:00:00.000Z",6,FALSE,27,17895854,"G",27,27,"San Antonio Spurs","Charles Bassey",0,0,0,0,0,0
0,0,0,0,0,0,0,0,0,"00",0,0,0,0,0,0,1038089,"2024-01-07T00:00:00.000Z",6,FALSE,27,56677817,"G",27,27,"San Antonio Spurs","Sidy Cissoko",0,0,0,0,0,0
0,0,0,0,0,0,0,0,0,"00",0,0,0,0,0,0,1038089,"2024-01-07T00:00:00.000Z",6,FALSE,27,102,"F-C",27,27,"San Antonio Spurs","Zach Collins",0,0,0,0,0,0
3,1,5,8,3,11,5,5,4,"33",1,3,17,6,1,0,1038090,"2024-01-07T00:00:00.000Z",3,FALSE,25,666679,"F",3,3,"Brooklyn Nets","Cameron Johnson",2,23,26,20,9,34.7
2,0,3,7,3,8,3,0,0,"35",2,3,9,5,1,1,1038090,"2024-01-07T00:00:00.000Z",3,FALSE,25,158,"F",3,3,"Brooklyn Nets","Dorian Finney-Smith",1,14,16,11,7,20
3,4,9,0,0,8,8,2,0,"36",2,5,16,11,2,5,1038090,"2024-01-07T00:00:00.000Z",3,FALSE,25,666508,"F-C",3,3,"Brooklyn Nets","Nicolas Claxton",6,27,30,19,14,46.7
3,0,4,8,4,26,15,8,8,"44",0,0,42,4,0,3,1038090,"2024-01-07T00:00:00.000Z",3,FALSE,25,61,"F",3,3,"Brooklyn Nets","Mikal Bridges",0,46,49,45,7,48.3
5,0,2,4,1,6,1,2,2,"28",1,0,5,3,0,1,1038090,"2024-01-07T00:00:00.000Z",3,FALSE,25,130,"G",3,3,"Brooklyn Nets","Spencer Dinwiddie",0,8,13,10,8,15.1
0,0,0,0,0,0,0,0,0,"00",0,0,0,0,0,0,1038090,"2024-01-07T00:00:00.000Z",3,FALSE,25,174,"F-C",3,3,"Brooklyn Nets","Harry Giles III",0,0,0,0,0,0
1,0,3,4,2,5,3,0,0,"18",0,3,8,3,1,2,1038090,"2024-01-07T00:00:00.000Z",3,FALSE,25,351,"F",3,3,"Brooklyn Nets","Royce O'Neale",1,11,12,9,4,14.1
2,1,3,0,0,7,4,4,3,"17",3,3,11,6,0,0,1038090,"2024-01-07T00:00:00.000Z",3,FALSE,25,17896038,"C",3,3,"Brooklyn Nets","Day'Ron Sharpe",1,17,19,13,8,24.2
10,1,2,1,0,8,3,4,4,"29",0,6,10,2,2,1,1038090,"2024-01-07T00:00:00.000Z",3,FALSE,25,421,"G",3,3,"Brooklyn Nets","Dennis Smith Jr.",3,12,22,20,12,35.4
0,0,3,3,1,9,4,0,0,"18",0,0,9,3,0,1,1038090,"2024-01-07T00:00:00.000Z",3,FALSE,25,17896048,"G",3,3,"Brooklyn Nets","Cam Thomas",0,12,12,9,3,11.6
0,0,1,2,0,3,0,0,0,"06",0,2,0,1,0,0,1038090,"2024-01-07T00:00:00.000Z",3,FALSE,25,464,"G",3,3,"Brooklyn Nets","Lonnie Walker IV",0,1,1,0,1,1.2
0,0,0,0,0,0,0,0,0,"01",0,0,0,0,0,1,1038090,"2024-01-07T00:00:00.000Z",3,FALSE,25,17896058,"F",3,3,"Brooklyn Nets","Trendon Watford",0,0,0,0,0,-1
0,0,0,0,0,0,0,0,0,"00",0,0,0,0,0,0,1038090,"2024-01-07T00:00:00.000Z",3,FALSE,25,56677843,"F",3,3,"Brooklyn Nets","Noah Clowney",0,0,0,0,0,0
0,0,0,0,0,0,0,0,0,"00",0,0,0,0,0,0,1038090,"2024-01-07T00:00:00.000Z",3,FALSE,25,17896041,"G",3,3,"Brooklyn Nets","Keon Johnson",0,0,0,0,0,0
0,0,0,0,0,0,0,0,0,"00",0,0,0,0,0,0,1038090,"2024-01-07T00:00:00.000Z",3,FALSE,25,417,"G-F",3,3,"Brooklyn Nets","Ben Simmons",0,0,0,0,0,0
4,0,2,3,2,8,3,2,2,"30",1,2,10,3,0,2,1038090,"2024-01-07T00:00:00.000Z",3,FALSE,25,56677747,"G",25,25,"Portland Trail Blazers","Scoot Henderson",0,13,17,14,7,17.6
0,0,1,0,0,0,0,0,0,"09",2,3,0,3,0,0,1038090,"2024-01-07T00:00:00.000Z",3,FALSE,25,39613724,"C",25,25,"Portland Trail Blazers","Ibou Badji",0,3,3,0,3,3.6
0,0,2,0,0,2,0,0,0,"07",1,1,0,3,0,2,1038090,"2024-01-07T00:00:00.000Z",3,FALSE,25,56677791,"F",25,25,"Portland Trail Blazers","Kris Murray",0,3,3,0,3,1.6
1,1,1,6,3,14,7,7,4,"40",0,2,21,1,2,0,1038090,"2024-01-07T00:00:00.000Z",3,FALSE,25,38017690,"G",25,25,"Portland Trail Blazers","Shaedon Sharpe",3,22,23,22,2,32.7
0,0,0,0,0,0,0,0,0,"00",0,0,0,0,0,0,1038090,"2024-01-07T00:00:00.000Z",3,FALSE,25,56677841,"F",3,3,"Brooklyn Nets","Dariq Whitehead",0,0,0,0,0,0
0,0,0,0,0,0,0,0,0,"00",0,0,0,0,0,0,1038090,"2024-01-07T00:00:00.000Z",3,FALSE,25,56677722,"F",3,3,"Brooklyn Nets","Jalen Wilson",0,0,0,0,0,0
1,1,2,7,3,24,11,2,2,"42",0,2,27,2,1,0,1038090,"2024-01-07T00:00:00.000Z",3,FALSE,25,182,"F",25,25,"Portland Trail Blazers","Jerami Grant",2,29,30,28,3,36.9
1,0,5,2,0,4,1,4,3,"29",1,4,5,6,1,2,1038090,"2024-01-07T00:00:00.000Z",3,FALSE,25,56677850,"F",25,25,"Portland Trail Blazers","Toumani Camara",1,11,12,6,7,14.7
1,3,10,4,3,10,5,3,2,"41",3,4,15,13,1,1,1038090,"2024-01-07T00:00:00.000Z",3,FALSE,25,56783340,"C",25,25,"Portland Trail Blazers","Duop Reath",4,28,29,16,14,43.1
11,0,4,10,5,25,13,8,7,"45",0,2,38,4,0,2,1038090,"2024-01-07T00:00:00.000Z",3,FALSE,25,419,"G",25,25,"Portland Trail Blazers","Anfernee Simons",0,42,53,49,15,57.3
0,0,0,0,0,0,0,0,0,"00",0,0,0,0,0,0,1038090,"2024-01-07T00:00:00.000Z",3,FALSE,25,47957121,"F",25,25,"Portland Trail Blazers","Justin Minaya",0,0,0,0,0,0
0,0,0,0,0,0,0,0,0,"00",0,0,0,0,0,0,1038090,"2024-01-07T00:00:00.000Z",3,FALSE,25,56677829,"G-F",25,25,"Portland Trail Blazers","Rayan Rupert",0,0,0,0,0,0
0,0,0,0,0,0,0,0,0,"00",0,0,0,0,0,0,1038090,"2024-01-07T00:00:00.000Z",3,FALSE,25,38017711,"F",25,25,"Portland Trail Blazers","Jabari Walker",0,0,0,0,0,0
0,0,0,0,0,0,0,0,0,"00",0,0,0,0,0,0,1038090,"2024-01-07T00:00:00.000Z",3,FALSE,25,22,"C",25,25,"Portland Trail Blazers","Deandre Ayton",0,0,0,0,0,0
0,0,0,0,0,0,0,0,0,"00",0,0,0,0,0,0,1038090,"2024-01-07T00:00:00.000Z",3,FALSE,25,666476,"C",25,25,"Portland Trail Blazers","Moses Brown",0,0,0,0,0,0
2,0,2,6,4,8,5,4,4,"22",1,0,18,3,0,0,1038090,"2024-01-07T00:00:00.000Z",3,FALSE,25,65,"G",25,25,"Portland Trail Blazers","Malcolm Brogdon",0,21,23,20,5,24.6
0,0,0,0,0,0,0,0,0,"00",0,0,0,0,0,0,1038090,"2024-01-07T00:00:00.000Z",3,FALSE,25,666923,"G-F",25,25,"Portland Trail Blazers","Matisse Thybulle",0,0,0,0,0,0
0,0,0,0,0,0,0,0,0,"00",0,0,0,0,0,0,1038090,"2024-01-07T00:00:00.000Z",3,FALSE,25,476,"C-F",25,25,"Portland Trail Blazers","Robert Williams III",0,0,0,0,0,0
2,0,1,5,1,7,1,0,0,"24",0,1,3,1,0,0,1038098,"2024-01-08T00:00:00.000Z",4,FALSE,5,38017708,"G",4,4,"Charlotte Hornets","Bryce McGowens",0,4,6,5,3,7.2
5,2,6,8,4,18,9,3,2,"40",2,3,24,8,1,5,1038098,"2024-01-08T00:00:00.000Z",4,FALSE,5,62,"F",4,4,"Charlotte Hornets","Miles Bridges",3,32,37,29,13,45.1
1,3,7,0,0,6,5,0,0,"39",1,4,10,8,0,0,1038098,"2024-01-08T00:00:00.000Z",4,FALSE,5,3547282,"C",4,4,"Charlotte Hornets","Nick Richards",3,18,19,11,9,30.1
4,0,6,7,0,11,2,0,0,"31",0,4,4,6,1,3,1038098,"2024-01-08T00:00:00.000Z",4,FALSE,5,56677823,"F",4,4,"Charlotte Hornets","Brandon Miller",1,10,14,8,10,17.2
8,0,3,13,7,18,10,12,12,"44",0,2,39,3,0,0,1038098,"2024-01-08T00:00:00.000Z",4,FALSE,5,403,"G",4,4,"Charlotte Hornets","Terry Rozier",0,42,50,47,11,54.6
0,0,0,0,0,0,0,0,0,"00",0,0,0,0,0,0,1038098,"2024-01-08T00:00:00.000Z",4,FALSE,5,56677866,"F",4,4,"Charlotte Hornets","Leaky Black",0,0,0,0,0,0
2,0,2,1,1,1,1,0,0,"04",0,1,3,2,0,0,1038098,"2024-01-08T00:00:00.000Z",4,FALSE,5,17896037,"G",4,4,"Charlotte Hornets","James Bouknight",0,5,7,5,4,8.4
0,0,1,0,0,2,1,2,1,"15",3,3,3,4,0,1,1038098,"2024-01-08T00:00:00.000Z",4,FALSE,5,NA,NA,NA,4,"Charlotte Hornets","NA NA",0,7,7,3,4,6.8
0,0,0,0,0,0,0,0,0,"00",0,0,0,0,0,0,1038098,"2024-01-08T00:00:00.000Z",4,FALSE,5,347,"G",4,4,"Charlotte Hornets","Frank Ntilikina",0,0,0,0,0,0
1,0,0,0,0,4,1,0,0,"15",0,1,2,0,0,0,1038098,"2024-01-08T00:00:00.000Z",4,FALSE,5,422,"G",4,4,"Charlotte Hornets","Ish Smith",0,2,3,3,1,3.5
3,0,2,6,3,15,6,0,0,"32",2,2,15,4,1,3,1038098,"2024-01-08T00:00:00.000Z",4,FALSE,5,56677846,"G",4,4,"Charlotte Hornets","Nick Smith Jr.",1,19,22,18,7,24.3
0,0,0,1,0,2,1,0,0,"04",0,0,2,0,0,0,1038098,"2024-01-08T00:00:00.000Z",4,FALSE,5,87,"G",5,5,"Chicago Bulls","Jevon Carter",0,2,2,2,0,2
2,1,0,0,0,3,2,2,2,"18",1,3,6,1,0,1,1038098,"2024-01-08T00:00:00.000Z",4,FALSE,5,17895983,"G",5,5,"Chicago Bulls","Ayo Dosunmu",1,7,9,8,3,12.2
5,2,2,6,2,9,2,4,3,"36",1,1,9,3,0,2,1038098,"2024-01-08T00:00:00.000Z",4,FALSE,5,268,"G",5,5,"Chicago Bulls","Zach LaVine",2,12,17,14,8,24.1
0,0,0,0,0,0,0,0,0,"00",0,0,0,0,0,0,1038098,"2024-01-08T00:00:00.000Z",4,FALSE,5,56677857,"F",5,5,"Chicago Bulls","Julian Phillips",0,0,0,0,0,0
0,0,0,0,0,0,0,0,0,"00",0,0,0,0,0,0,1038098,"2024-01-08T00:00:00.000Z",4,FALSE,5,17896116,"G",5,5,"Chicago Bulls","Terry Taylor",0,0,0,0,0,0
1,0,1,1,0,1,0,2,2,"12",1,1,2,2,0,1,1038098,"2024-01-08T00:00:00.000Z",4,FALSE,5,38017719,"F",5,5,"Chicago Bulls","Dalen Terry",0,4,5,3,3,4.9
0,2,2,2,1,12,4,0,0,"21",6,1,9,8,0,0,1038098,"2024-01-08T00:00:00.000Z",4,FALSE,5,18678001,"F",4,4,"Charlotte Hornets","JT Thor",2,17,17,9,8,24.6
0,0,0,0,0,0,0,0,0,"00",0,0,0,0,0,0,1038098,"2024-01-08T00:00:00.000Z",4,FALSE,5,56677848,"G",4,4,"Charlotte Hornets","Amari Bailey",0,0,0,0,0,0
0,0,0,0,0,0,0,0,0,"00",0,0,0,0,0,0,1038098,"2024-01-08T00:00:00.000Z",4,FALSE,5,3547239,"G",4,4,"Charlotte Hornets","LaMelo Ball",0,0,0,0,0,0
0,0,0,0,0,0,0,0,0,"00",0,0,0,0,0,0,1038098,"2024-01-08T00:00:00.000Z",4,FALSE,5,204,"F",4,4,"Charlotte Hornets","Gordon Hayward",0,0,0,0,0,0
0,0,0,0,0,0,0,0,0,"00",0,0,0,0,0,0,1038098,"2024-01-08T00:00:00.000Z",4,FALSE,5,666748,"F",4,4,"Charlotte Hornets","Cody Martin",0,0,0,0,0,0
0,0,0,0,0,0,0,0,0,"00",0,0,0,0,0,0,1038098,"2024-01-08T00:00:00.000Z",4,FALSE,5,666950,"F",4,4,"Charlotte Hornets","P.J. Washington",0,0,0,0,0,0
0,0,0,0,0,0,0,0,0,"00",0,0,0,0,0,0,1038098,"2024-01-08T00:00:00.000Z",4,FALSE,5,38017698,"C",4,4,"Charlotte Hornets","Mark Williams",0,0,0,0,0,0
7,1,7,3,1,16,7,4,3,"44",0,0,18,7,3,2,1038098,"2024-01-08T00:00:00.000Z",4,FALSE,5,125,"G",5,5,"Chicago Bulls","DeMar DeRozan",4,25,32,25,14,46.9
0,1,4,2,1,6,2,4,3,"23",1,1,8,5,1,2,1038098,"2024-01-08T00:00:00.000Z",4,FALSE,5,3547248,"F",5,5,"Chicago Bulls","Patrick Williams",2,13,13,8,5,18
0,0,10,0,0,12,9,3,3,"22",5,1,21,15,0,2,1038098,"2024-01-08T00:00:00.000Z",4,FALSE,5,137,"C",5,5,"Chicago Bulls","Andre Drummond",0,36,36,21,15,37
3,1,2,3,1,7,2,0,0,"34",0,4,5,2,2,0,1038098,"2024-01-08T00:00:00.000Z",4,FALSE,5,89,"G",5,5,"Chicago Bulls","Alex Caruso",3,7,10,8,5,20.9
5,0,6,7,3,19,10,5,4,"42",0,3,27,6,0,1,1038098,"2024-01-08T00:00:00.000Z",4,FALSE,5,666956,"G",5,5,"Chicago Bulls","Coby White",0,33,38,32,11,40.7
4,1,7,3,1,18,10,0,0,"30",3,4,21,10,1,1,1038098,"2024-01-08T00:00:00.000Z",4,FALSE,5,460,"C",5,5,"Chicago Bulls","Nikola Vucevic",2,31,35,25,14,44
0,0,0,0,0,0,0,0,0,"00",0,0,0,0,0,0,1038098,"2024-01-08T00:00:00.000Z",4,FALSE,5,27,"G",5,5,"Chicago Bulls","Lonzo Ball",0,0,0,0,0,0
0,0,0,0,0,0,0,0,0,"00",0,0,0,0,0,0,1038098,"2024-01-08T00:00:00.000Z",4,FALSE,5,56677874,"F",5,5,"Chicago Bulls","Onuralp Bitim",0,0,0,0,0,0
0,0,0,0,0,0,0,0,0,"00",0,0,0,0,0,0,1038098,"2024-01-08T00:00:00.000Z",4,FALSE,5,110,"F",5,5,"Chicago Bulls","Torrey Craig",0,0,0,0,0,0
0,0,0,0,0,0,0,0,0,"00",0,0,0,0,0,0,1038098,"2024-01-08T00:00:00.000Z",4,FALSE,5,NA,NA,NA,5,"Chicago Bulls","NA NA",0,0,0,0,0,0
0,0,0,0,0,0,0,0,0,"00",0,0,0,0,0,0,1038098,"2024-01-08T00:00:00.000Z",4,FALSE,5,56677860,"F",5,5,"Chicago Bulls","Adama Sanogo",0,0,0,0,0,0
4,0,4,2,1,11,5,4,3,"39",0,1,14,4,1,2,1038101,"2024-01-08T00:00:00.000Z",16,FALSE,11,56677785,"G",16,16,"Miami Heat","Jaime Jaquez Jr.",1,18,22,18,8,25.8
6,2,5,5,1,9,2,4,1,"21",3,3,6,8,2,2,1038101,"2024-01-08T00:00:00.000Z",16,FALSE,11,38017696,"F",16,16,"Miami Heat","Nikola Jovic",4,14,20,12,14,34.6
3,0,11,0,0,12,9,7,4,"32",1,4,22,12,1,3,1038101,"2024-01-08T00:00:00.000Z",16,FALSE,11,4,"C-F",16,16,"Miami Heat","Bam Adebayo",1,34,37,25,15,40.9
3,0,1,10,5,20,10,3,3,"34",2,2,28,3,0,1,1038101,"2024-01-08T00:00:00.000Z",16,FALSE,11,666633,"G",16,16,"Miami Heat","Tyler Herro",0,31,34,31,6,35.1
1,2,1,1,1,3,2,2,1,"16",1,1,6,2,0,0,1038101,"2024-01-08T00:00:00.000Z",16,FALSE,11,286,"G",16,16,"Miami Heat","Kyle Lowry",2,8,9,7,3,15.9
4,0,4,3,1,7,4,7,6,"23",3,2,15,7,1,1,1038101,"2024-01-08T00:00:00.000Z",16,FALSE,11,285,"F-C",16,16,"Miami Heat","Kevin Love",1,22,26,19,11,31.4
2,1,2,3,2,6,4,2,2,"29",0,2,12,2,0,0,1038101,"2024-01-08T00:00:00.000Z",16,FALSE,11,391,"G-F",16,16,"Miami Heat","Josh Richardson",1,14,16,14,4,20.4
0,0,0,0,0,0,0,0,0,"00",0,0,0,0,0,0,1038101,"2024-01-08T00:00:00.000Z",16,FALSE,11,75,"G-F",11,11,"Houston Rockets","Reggie Bullock",0,0,0,0,0,0
2,1,0,1,0,4,2,2,1,"20",0,3,5,0,0,1,1038101,"2024-01-08T00:00:00.000Z",16,FALSE,11,188,"F",11,11,"Houston Rockets","Jeff Green",1,5,7,7,2,10
1,0,4,5,1,6,2,3,3,"23",0,2,8,4,1,0,1038101,"2024-01-08T00:00:00.000Z",16,FALSE,11,213,"G",11,11,"Houston Rockets","Aaron Holiday",1,12,13,9,5,17.3
0,0,0,0,0,0,0,0,0,"00",0,0,0,0,0,0,1038101,"2024-01-08T00:00:00.000Z",16,FALSE,11,19465326,"C",11,11,"Houston Rockets","Jock Landale",0,0,0,0,0,0
0,0,0,0,0,0,0,0,0,"00",0,0,0,0,0,0,1038101,"2024-01-08T00:00:00.000Z",16,FALSE,11,296,"C",11,11,"Houston Rockets","Boban Marjanovic",0,0,0,0,0,0
1,1,2,0,0,2,1,3,3,"11",0,3,5,2,1,2,1038101,"2024-01-08T00:00:00.000Z",16,FALSE,11,56677825,"G-F",11,11,"Houston Rockets","Amen Thompson",2,7,8,6,3,12.9
0,0,5,2,1,8,5,0,0,"17",1,4,11,6,1,1,1038101,"2024-01-08T00:00:00.000Z",16,FALSE,11,56677831,"F",11,11,"Houston Rockets","Cam Whitmore",1,17,17,11,6,20.2
0,0,0,0,0,0,0,0,0,"00",0,0,0,0,0,0,1038101,"2024-01-08T00:00:00.000Z",16,FALSE,11,47738533,"G",11,11,"Houston Rockets","Jeenathan Williams",0,0,0,0,0,0
0,0,0,0,0,0,0,0,0,"00",0,0,0,0,0,0,1038101,"2024-01-08T00:00:00.000Z",16,FALSE,11,357,"G",11,11,"Houston Rockets","Victor Oladipo",0,0,0,0,0,0
0,0,0,0,0,0,0,0,0,"00",0,0,0,0,0,0,1038101,"2024-01-08T00:00:00.000Z",16,FALSE,11,66,"G-F",11,11,"Houston Rockets","Dillon Brooks",0,0,0,0,0,0
0,0,0,0,0,0,0,0,0,"00",0,0,0,0,0,0,1038101,"2024-01-08T00:00:00.000Z",16,FALSE,11,38017695,"F",11,11,"Houston Rockets","Tari Eason",0,0,0,0,0,0
0,0,0,0,0,0,0,0,0,"00",0,0,0,0,0,0,1038101,"2024-01-08T00:00:00.000Z",16,FALSE,11,3547281,"G-F",11,11,"Houston Rockets","Nate Hinton",0,0,0,0,0,0
0,0,0,0,0,0,0,0,0,"00",0,0,0,0,0,0,1038101,"2024-01-08T00:00:00.000Z",16,FALSE,11,56677809,"F",11,11,"Houston Rockets","Jermaine Samuels Jr.",0,0,0,0,0,0
7,0,3,10,3,12,4,3,3,"30",0,6,14,3,1,1,1038101,"2024-01-08T00:00:00.000Z",16,FALSE,11,397,"F",16,16,"Miami Heat","Duncan Robinson",1,17,24,21,10,30.1
0,0,3,2,1,2,1,0,0,"16",0,0,3,3,0,0,1038101,"2024-01-08T00:00:00.000Z",16,FALSE,11,3092,"",16,16,"Miami Heat","Haywood Highsmith",0,6,6,3,3,6.6
0,0,0,0,0,0,0,0,0,"00",0,0,0,0,0,0,1038101,"2024-01-08T00:00:00.000Z",16,FALSE,11,74,"C",16,16,"Miami Heat","Thomas Bryant",0,0,0,0,0,0
0,0,0,0,0,0,0,0,0,"00",0,0,0,0,0,0,1038101,"2024-01-08T00:00:00.000Z",16,FALSE,11,38017734,"F",16,16,"Miami Heat","Jamal Cain",0,0,0,0,0,0
0,0,0,0,0,0,0,0,0,"00",0,0,0,0,0,0,1038101,"2024-01-08T00:00:00.000Z",16,FALSE,11,39398582,"C",16,16,"Miami Heat","Orlando Robinson",0,0,0,0,0,0
0,0,0,0,0,0,0,0,0,"00",0,0,0,0,0,0,1038101,"2024-01-08T00:00:00.000Z",16,FALSE,11,79,"G-F",16,16,"Miami Heat","Jimmy Butler",0,0,0,0,0,0
0,0,0,0,0,0,0,0,0,"00",0,0,0,0,0,0,1038101,"2024-01-08T00:00:00.000Z",16,FALSE,11,3547257,"G",16,16,"Miami Heat","R.J. Hampton",0,0,0,0,0,0
0,0,0,0,0,0,0,0,0,"00",0,0,0,0,0,0,1038101,"2024-01-08T00:00:00.000Z",16,FALSE,11,666747,"F",16,16,"Miami Heat","Caleb Martin",0,0,0,0,0,0
0,0,0,0,0,0,0,0,0,"00",0,0,0,0,0,0,1038101,"2024-01-08T00:00:00.000Z",16,FALSE,11,19465585,"G",16,16,"Miami Heat","Dru Smith",0,0,0,0,0,0
0,0,0,0,0,0,0,0,0,"00",0,0,0,0,0,0,1038101,"2024-01-08T00:00:00.000Z",16,FALSE,11,38017736,"F",16,16,"Miami Heat","Cole Swider",0,0,0,0,0,0
1,0,1,4,1,8,3,2,2,"34",3,5,9,4,1,0,1038101,"2024-01-08T00:00:00.000Z",16,FALSE,11,3547301,"F",11,11,"Houston Rockets","Jae'Sean Tate",1,13,14,10,5,18.3
0,0,3,5,1,13,3,3,3,"32",3,3,10,6,0,1,1038101,"2024-01-08T00:00:00.000Z",16,FALSE,11,38017684,"F",11,11,"Houston Rockets","Jabari Smith Jr.",0,16,16,10,6,16.2
2,0,7,2,1,15,9,4,3,"33",4,6,22,11,3,3,1038101,"2024-01-08T00:00:00.000Z",16,FALSE,11,17896062,"F-C",11,11,"Houston Rockets","Alperen Sengun",3,33,35,24,13,44.2
6,0,5,8,2,10,2,6,5,"31",0,3,11,5,0,3,1038101,"2024-01-08T00:00:00.000Z",16,FALSE,11,17895966,"G",11,11,"Houston Rockets","Jalen Green",0,16,22,17,11,23
7,2,3,14,7,22,10,5,5,"39",2,2,32,5,0,1,1038101,"2024-01-08T00:00:00.000Z",16,FALSE,11,458,"G",11,11,"Houston Rockets","Fred VanVleet",2,37,44,39,12,53.5
8,1,3,6,3,16,7,6,6,"34",0,1,23,3,2,3,1038102,"2024-01-08T00:00:00.000Z",17,FALSE,29,315,"F",17,17,"Milwaukee Bucks","Khris Middleton",3,26,34,31,11,44.6
11,0,6,2,0,20,10,9,5,"38",4,5,25,10,0,4,1038102,"2024-01-08T00:00:00.000Z",17,FALSE,29,15,"F",17,17,"Milwaukee Bucks","Giannis Antetokounmpo",0,35,46,36,21,49.5
3,2,5,6,3,11,5,0,0,"38",1,2,13,6,0,0,1038102,"2024-01-08T00:00:00.000Z",17,FALSE,29,283,"C",17,17,"Milwaukee Bucks","Brook Lopez",2,19,22,16,9,30.7
3,2,3,2,1,6,2,2,2,"26",2,2,7,5,0,1,1038102,"2024-01-08T00:00:00.000Z",17,FALSE,29,56677852,"G",17,17,"Milwaukee Bucks","Andre Jackson Jr.",2,12,15,10,8,22.5
2,1,3,8,5,12,6,0,0,"24",1,1,17,4,1,0,1038102,"2024-01-08T00:00:00.000Z",17,FALSE,29,38,"G",17,17,"Milwaukee Bucks","Malik Beasley",2,21,23,19,6,30.8
3,0,2,4,1,6,1,0,0,"14",0,1,3,2,2,0,1038102,"2024-01-08T00:00:00.000Z",17,FALSE,29,38017676,"F",17,17,"Milwaukee Bucks","MarJon Beauchamp",2,5,8,6,5,15.9
1,0,2,3,2,3,2,0,0,"22",0,3,6,2,0,0,1038102,"2024-01-08T00:00:00.000Z",17,FALSE,29,105,"G",17,17,"Milwaukee Bucks","Pat Connaughton",0,8,9,7,3,9.9
0,0,0,3,2,4,3,0,0,"11",1,0,8,1,0,0,1038102,"2024-01-08T00:00:00.000Z",17,FALSE,29,38017733,"G",17,17,"Milwaukee Bucks","A.J. Green",0,9,9,8,1,9.2
0,0,1,0,0,5,2,2,2,"15",1,1,6,2,1,1,1038102,"2024-01-08T00:00:00.000Z",17,FALSE,29,56677854,"F",17,17,"Milwaukee Bucks","Chris Livingston",1,8,8,6,2,10.4
0,0,0,0,0,0,0,0,0,"01",0,0,0,0,0,0,1038102,"2024-01-08T00:00:00.000Z",17,FALSE,29,284,"C",17,17,"Milwaukee Bucks","Robin Lopez",0,0,0,0,0,0
0,0,2,2,0,11,4,0,0,"16",1,4,8,3,0,0,1038102,"2024-01-08T00:00:00.000Z",17,FALSE,29,377,"F",17,17,"Milwaukee Bucks","Bobby Portis",0,11,11,8,3,11.6
1,1,3,5,1,6,2,0,0,"32",0,4,5,3,1,1,1038102,"2024-01-08T00:00:00.000Z",17,FALSE,29,38017739,"F",29,29,"Utah Jazz","Simone Fontecchio",2,8,9,6,4,15.1
2,2,10,10,4,15,5,8,7,"32",4,1,21,14,1,0,1038102,"2024-01-08T00:00:00.000Z",17,FALSE,29,297,"F",29,29,"Utah Jazz","Lauri Markkanen",3,35,37,23,16,49.8
1,0,3,7,3,15,8,0,0,"27",0,3,19,3,1,3,1038102,"2024-01-08T00:00:00.000Z",17,FALSE,29,101,"F-C",29,29,"Utah Jazz","John Collins",1,22,23,20,4,24.1
13,2,3,1,1,2,2,0,0,"24",1,1,5,4,1,1,1038102,"2024-01-08T00:00:00.000Z",17,FALSE,29,139,"G",29,29,"Utah Jazz","Kris Dunn",3,9,22,18,17,37.3
3,0,0,6,3,13,8,0,0,"18",0,0,19,0,1,0,1038102,"2024-01-08T00:00:00.000Z",17,FALSE,29,413,"G",29,29,"Utah Jazz","Collin Sexton",1,19,22,22,3,26.5
0,0,1,1,0,2,1,0,0,"15",0,1,2,1,0,0,1038102,"2024-01-08T00:00:00.000Z",17,FALSE,29,38017620,"G",29,29,"Utah Jazz","Ochai Agbaji",0,3,3,2,1,3.2
6,1,3,3,2,14,7,5,5,"31",1,0,21,4,0,1,1038102,"2024-01-08T00:00:00.000Z",17,FALSE,29,100,"G",29,29,"Utah Jazz","Jordan Clarkson",1,25,31,27,10,36.8
4,0,6,9,4,13,7,1,1,"23",0,0,19,6,0,2,1038102,"2024-01-08T00:00:00.000Z",17,FALSE,29,56677834,"G",29,29,"Utah Jazz","Keyonte George",0,25,29,23,10,30.2
0,0,0,0,0,0,0,0,0,"00",0,0,0,0,0,0,1038102,"2024-01-08T00:00:00.000Z",17,FALSE,29,666650,"G",29,29,"Utah Jazz","Talen Horton-Tucker",0,0,0,0,0,0
0,2,4,0,0,4,3,4,2,"21",2,1,8,6,1,0,1038102,"2024-01-08T00:00:00.000Z",17,FALSE,29,38017705,"C",29,29,"Utah Jazz","Walker Kessler",3,14,14,8,6,24.2
3,0,4,2,2,6,4,4,3,"17",2,4,13,6,0,2,1038102,"2024-01-08T00:00:00.000Z",17,FALSE,29,358,"F",29,29,"Utah Jazz","Kelly Olynyk",0,19,22,16,9,22.7
0,0,0,0,0,0,0,0,0,"00",0,0,0,0,0,0,1038102,"2024-01-08T00:00:00.000Z",17,FALSE,29,666881,"F",29,29,"Utah Jazz","Luka Samanic",0,0,0,0,0,0
0,0,0,0,0,0,0,0,0,"00",0,0,0,0,0,0,1038102,"2024-01-08T00:00:00.000Z",17,FALSE,29,11891374,"C",29,29,"Utah Jazz","Omer Yurtseven",0,0,0,0,0,0
0,0,0,0,0,0,0,0,0,"00",0,0,0,0,0,0,1038102,"2024-01-08T00:00:00.000Z",17,FALSE,29,17896023,"G",29,29,"Utah Jazz","Josh Christopher",0,0,0,0,0,0
0,0,0,0,0,0,0,0,0,"00",0,0,0,0,0,0,1038102,"2024-01-08T00:00:00.000Z",17,FALSE,29,56677824,"F",29,29,"Utah Jazz","Taylor Hendricks",0,0,0,0,0,0
0,0,0,0,0,0,0,0,0,"00",0,0,0,0,0,0,1038102,"2024-01-08T00:00:00.000Z",17,FALSE,29,38017630,"G",29,29,"Utah Jazz","Johnny Juzang",0,0,0,0,0,0
0,0,0,0,0,0,0,0,0,"00",0,0,0,0,0,0,1038102,"2024-01-08T00:00:00.000Z",17,FALSE,29,19465584,"F",29,29,"Utah Jazz","Micah Potter",0,0,0,0,0,0
0,0,0,0,0,0,0,0,0,"00",0,0,0,0,0,0,1038102,"2024-01-08T00:00:00.000Z",17,FALSE,29,56677842,"F",29,29,"Utah Jazz","Brice Sensabaugh",0,0,0,0,0,0
0,0,0,0,0,0,0,0,0,"00",0,0,0,0,0,0,1038102,"2024-01-08T00:00:00.000Z",17,FALSE,29,38017691,"G",17,17,"Milwaukee Bucks","TyTy Washington Jr.",0,0,0,0,0,0
0,0,0,0,0,0,0,0,0,"00",0,0,0,0,0,0,1038102,"2024-01-08T00:00:00.000Z",17,FALSE,29,112,"F",17,17,"Milwaukee Bucks","Jae Crowder",0,0,0,0,0,0
0,0,0,0,0,0,0,0,0,"00",0,0,0,0,0,0,1038102,"2024-01-08T00:00:00.000Z",17,FALSE,29,278,"G",17,17,"Milwaukee Bucks","Damian Lillard",0,0,0,0,0,0
0,0,0,0,0,0,0,0,0,"00",0,0,0,0,0,0,1038102,"2024-01-08T00:00:00.000Z",17,FALSE,29,368,"G",17,17,"Milwaukee Bucks","Cameron Payne",0,0,0,0,0,0
0,0,0,0,0,0,0,0,0,"01",0,0,0,0,0,0,1038102,"2024-01-08T00:00:00.000Z",17,FALSE,29,2148,"",17,17,"Milwaukee Bucks","Thanasis Antetokounmpo",0,0,0,0,0,0
3,0,2,6,3,9,5,2,1,"28",3,2,14,5,0,1,1038103,"2024-01-08T00:00:00.000Z",13,FALSE,24,666743,"G",13,13,"LA Clippers","Terance Mann",0,19,22,17,8,23.5
2,1,3,3,1,15,8,0,0,"32",0,1,17,3,5,3,1038103,"2024-01-08T00:00:00.000Z",13,FALSE,24,274,"F",13,13,"LA Clippers","Kawhi Leonard",6,20,22,19,5,38.6
3,1,6,0,0,9,8,6,3,"28",2,3,19,8,1,0,1038103,"2024-01-08T00:00:00.000Z",13,FALSE,24,493,"C",13,13,"LA Clippers","Ivica Zubac",2,27,30,22,11,39.1
0,0,6,9,4,19,10,2,1,"31",1,2,25,7,1,1,1038103,"2024-01-08T00:00:00.000Z",13,FALSE,24,172,"F",13,13,"LA Clippers","Paul George",1,32,32,25,7,35.4
10,0,7,4,3,8,6,4,4,"30",0,1,19,7,0,3,1038103,"2024-01-08T00:00:00.000Z",13,FALSE,24,192,"G",13,13,"LA Clippers","James Harden",0,26,36,29,17,39.4
0,0,0,1,1,2,2,0,0,"05",0,2,5,0,0,1,1038103,"2024-01-08T00:00:00.000Z",13,FALSE,24,17896022,"G",13,13,"LA Clippers","Brandon Boston Jr.",0,5,5,5,0,4
0,0,0,0,0,0,0,0,0,"05",0,1,0,0,1,0,1038103,"2024-01-08T00:00:00.000Z",13,FALSE,24,56677849,"F",13,13,"LA Clippers","Kobe Brown",1,0,0,0,0,3
0,0,2,1,1,5,4,0,0,"23",0,3,9,2,0,0,1038103,"2024-01-08T00:00:00.000Z",13,FALSE,24,666511,"G",13,13,"LA Clippers","Amir Coffey",0,11,11,9,2,11.4
0,0,0,0,0,0,0,0,0,"00",0,0,0,0,0,0,1038103,"2024-01-08T00:00:00.000Z",13,FALSE,24,17896031,"G",13,13,"LA Clippers","Nah'Shon Hyland",0,0,0,0,0,0
3,0,2,0,0,0,0,2,1,"05",0,0,1,2,0,0,1038103,"2024-01-08T00:00:00.000Z",13,FALSE,24,371,"F-C",13,13,"LA Clippers","Mason Plumlee",0,3,6,4,5,7.9
1,0,4,3,2,6,4,4,4,"24",1,1,14,5,0,1,1038103,"2024-01-08T00:00:00.000Z",13,FALSE,24,380,"F-G",13,13,"LA Clippers","Norman Powell",0,19,20,15,6,20.5
3,1,1,1,0,6,3,0,0,"14",2,3,6,3,1,1,1038103,"2024-01-08T00:00:00.000Z",13,FALSE,24,439,"F",13,13,"LA Clippers","Daniel Theis",2,9,12,9,6,19.1
0,0,0,0,0,0,0,0,0,"00",0,0,0,0,0,0,1038103,"2024-01-08T00:00:00.000Z",13,FALSE,24,450,"F",13,13,"LA Clippers","PJ Tucker",0,0,0,0,0,0
7,0,0,1,0,6,3,3,3,"15",2,2,9,2,2,1,1038103,"2024-01-08T00:00:00.000Z",13,FALSE,24,472,"G",13,13,"LA Clippers","Russell Westbrook",2,11,18,16,9,26.9
0,0,0,1,1,1,1,0,0,"02",0,1,3,0,0,0,1038103,"2024-01-08T00:00:00.000Z",13,FALSE,24,32,"F",24,24,"Phoenix Suns","Keita Bates-Diop",0,3,3,3,0,3
0,2,2,0,0,1,0,0,0,"16",2,2,0,4,0,0,1038103,"2024-01-08T00:00:00.000Z",13,FALSE,24,147,"F",24,24,"Phoenix Suns","Drew Eubanks",2,4,4,0,4,10.8
2,0,1,7,2,8,3,4,4,"25",0,1,12,1,0,1,1038103,"2024-01-08T00:00:00.000Z",13,FALSE,24,178,"G",24,24,"Phoenix Suns","Eric Gordon",0,13,15,14,3,15.2
0,1,2,0,0,1,1,2,2,"08",0,1,4,2,0,0,1038103,"2024-01-08T00:00:00.000Z",13,FALSE,24,314,"F",24,24,"Phoenix Suns","Chimezie Metu",1,6,6,4,2,9.4
2,0,0,1,0,3,2,0,0,"18",1,2,4,1,3,0,1038103,"2024-01-08T00:00:00.000Z",13,FALSE,24,356,"G",24,24,"Phoenix Suns","Josh Okogie",3,5,7,6,3,17.2
0,0,0,0,0,0,0,0,0,"00",0,0,0,0,0,0,1038103,"2024-01-08T00:00:00.000Z",13,FALSE,24,24417679,"G",13,13,"LA Clippers","Xavier Moon",0,0,0,0,0,0
0,0,0,0,0,0,0,0,0,"00",0,0,0,0,0,0,1038103,"2024-01-08T00:00:00.000Z",13,FALSE,24,17896051,"G",13,13,"LA Clippers","Joshua Primo",0,0,0,0,0,0
2,0,3,3,1,3,1,5,5,"31",0,1,8,3,0,1,1038103,"2024-01-08T00:00:00.000Z",13,FALSE,24,8,"G",24,24,"Phoenix Suns","Grayson Allen",0,11,13,10,5,13.6
2,1,7,6,3,17,10,8,7,"35",0,2,30,7,0,3,1038103,"2024-01-08T00:00:00.000Z",13,FALSE,24,140,"F",24,24,"Phoenix Suns","Kevin Durant",1,37,39,32,9,41.4
2,0,2,2,1,8,3,2,1,"21",1,1,8,3,1,0,1038103,"2024-01-08T00:00:00.000Z",13,FALSE,24,349,"C",24,24,"Phoenix Suns","Jusuf Nurkic",1,11,13,10,5,17.6
2,0,3,2,0,15,7,2,1,"35",0,4,15,3,2,2,1038103,"2024-01-08T00:00:00.000Z",13,FALSE,24,37,"G",24,24,"Phoenix Suns","Bradley Beal",2,18,20,17,5,25.6
5,0,0,6,2,14,8,2,2,"34",0,4,20,0,0,6,1038103,"2024-01-08T00:00:00.000Z",13,FALSE,24,57,"G",24,24,"Phoenix Suns","Devin Booker",0,20,25,25,5,21.5
0,0,0,0,0,0,0,0,0,"00",0,0,0,0,0,0,1038103,"2024-01-08T00:00:00.000Z",13,FALSE,24,272,"G",24,24,"Phoenix Suns","Damion Lee",0,0,0,0,0,0
0,0,0,0,0,0,0,0,0,"00",0,0,0,0,0,0,1038103,"2024-01-08T00:00:00.000Z",13,FALSE,24,38017725,"F",13,13,"LA Clippers","Moussa Diabate",0,0,0,0,0,0
0,0,0,0,0,0,0,0,0,"00",0,0,0,0,0,0,1038103,"2024-01-08T00:00:00.000Z",13,FALSE,24,56677856,"G",13,13,"LA Clippers","Jordan Miller",0,0,0,0,0,0
0,0,0,0,0,1,0,2,2,"05",1,0,2,1,0,1,1038103,"2024-01-08T00:00:00.000Z",13,FALSE,24,3547298,"G",24,24,"Phoenix Suns","Saben Lee",0,3,3,2,1,2.2
0,0,0,2,0,2,0,2,1,"05",0,1,1,0,0,0,1038103,"2024-01-08T00:00:00.000Z",13,FALSE,24,470,"G",24,24,"Phoenix Suns","Yuta Watanabe",0,1,1,1,0,1
0,0,0,0,0,0,0,0,0,"00",0,0,0,0,0,0,1038103,"2024-01-08T00:00:00.000Z",13,FALSE,24,3547095,"C-F",24,24,"Phoenix Suns","Udoka Azubuike",0,0,0,0,0,0
0,0,0,0,0,0,0,0,0,"00",0,0,0,0,0,0,1038103,"2024-01-08T00:00:00.000Z",13,FALSE,24,666451,"C",24,24,"Phoenix Suns","Bol Bol",0,0,0,0,0,0
0,0,0,0,0,3,2,0,0,"05",0,0,4,0,0,0,1038103,"2024-01-08T00:00:00.000Z",13,FALSE,24,18678058,"",24,24,"Phoenix Suns","Jordan Goodwin",0,4,4,4,0,4
0,0,0,0,0,0,0,0,0,"00",0,0,0,0,0,0,1038103,"2024-01-08T00:00:00.000Z",13,FALSE,24,666729,"F",24,24,"Phoenix Suns","Nassir Little",0,0,0,0,0,0
0,0,0,0,0,0,0,0,0,"00",0,0,0,0,0,0,1038103,"2024-01-08T00:00:00.000Z",13,FALSE,24,3547253,"G",4,24,"Phoenix Suns","Theo Maledon",0,0,0,0,0,0
4,0,4,3,2,8,5,6,5,"33",0,4,17,4,1,4,1038100,"2024-01-08T00:00:00.000Z",30,FALSE,21,3547242,"F",30,30,"Washington Wizards","Deni Avdija",1,21,25,21,8,26.8
5,0,11,5,0,24,10,2,2,"37",4,1,22,15,0,2,1038100,"2024-01-08T00:00:00.000Z",30,FALSE,21,265,"F",30,30,"Washington Wizards","Kyle Kuzma",0,37,42,27,20,45.5
1,1,5,0,0,7,3,3,3,"26",4,2,9,9,0,0,1038100,"2024-01-08T00:00:00.000Z",30,FALSE,21,666577,"F",30,30,"Washington Wizards","Daniel Gafford",1,18,19,10,10,24.3
5,0,0,8,4,17,8,5,4,"29",0,5,24,0,0,1,1038100,"2024-01-08T00:00:00.000Z",30,FALSE,21,666848,"G",30,30,"Washington Wizards","Jordan Poole",0,24,29,29,5,30.5
9,0,0,5,3,10,7,2,1,"31",0,1,18,0,3,2,1038100,"2024-01-08T00:00:00.000Z",30,FALSE,21,249,"G",30,30,"Washington Wizards","Tyus Jones",3,18,27,27,9,38.5
0,0,0,0,0,0,0,0,0,"00",0,0,0,0,0,0,1038100,"2024-01-08T00:00:00.000Z",30,FALSE,21,18677954,"G",30,30,"Washington Wizards","Jared Butler",0,0,0,0,0,0
3,2,4,2,1,4,1,2,2,"25",1,2,5,5,0,0,1038100,"2024-01-08T00:00:00.000Z",30,FALSE,21,56677844,"G",30,30,"Washington Wizards","Bilal Coulibaly",2,10,13,8,8,21.5
0,0,0,0,0,0,0,0,0,"00",0,0,0,0,0,0,1038100,"2024-01-08T00:00:00.000Z",30,FALSE,21,38017687,"G",30,30,"Washington Wizards","Johnny Davis",0,0,0,0,0,0
0,0,0,0,0,0,0,0,0,"00",0,0,0,0,0,0,1038100,"2024-01-08T00:00:00.000Z",30,FALSE,21,167,"F",30,30,"Washington Wizards","Danilo Gallinari",0,0,0,0,0,0
0,0,0,0,0,0,0,0,0,"00",0,0,0,0,0,0,1038100,"2024-01-08T00:00:00.000Z",30,FALSE,21,3547302,"F",30,30,"Washington Wizards","Anthony Gill",0,0,0,0,0,0
2,0,1,4,3,5,4,0,0,"18",0,1,11,1,0,1,1038100,"2024-01-08T00:00:00.000Z",30,FALSE,21,17896045,"F",30,30,"Washington Wizards","Corey Kispert",0,12,14,13,3,14.2
0,0,0,0,0,1,0,0,0,"08",1,1,0,1,1,1,1038100,"2024-01-08T00:00:00.000Z",30,FALSE,21,337,"F-C",30,30,"Washington Wizards","Mike Muscala",1,1,1,0,1,3.2
0,0,0,0,0,0,0,0,0,"00",0,0,0,0,0,0,1038100,"2024-01-08T00:00:00.000Z",30,FALSE,21,17896106,"F",30,30,"Washington Wizards","Eugene Omoruyi",0,0,0,0,0,0
1,2,1,4,1,7,3,9,8,"16",1,4,15,2,2,3,1038100,"2024-01-08T00:00:00.000Z",30,FALSE,21,414,"G",30,30,"Washington Wizards","Landry Shamet",4,17,18,16,3,27.9
2,0,0,1,1,6,3,0,0,"17",1,2,7,1,0,0,1038100,"2024-01-08T00:00:00.000Z",30,FALSE,21,487,"G",30,30,"Washington Wizards","Delon Wright",0,8,10,9,3,11.2
0,0,0,0,0,0,0,0,0,"00",0,0,0,0,0,0,1038100,"2024-01-08T00:00:00.000Z",30,FALSE,21,38017704,"F",30,30,"Washington Wizards","Patrick Baldwin Jr.",0,0,0,0,0,0
0,0,0,0,0,0,0,0,0,"00",0,0,0,0,0,0,1038100,"2024-01-08T00:00:00.000Z",30,FALSE,21,NA,NA,NA,30,"Washington Wizards","NA NA",0,0,0,0,0,0
0,0,0,0,0,0,0,0,0,"00",0,0,0,0,0,0,1038100,"2024-01-08T00:00:00.000Z",30,FALSE,21,38017712,"G",30,30,"Washington Wizards","Ryan Rollins",0,0,0,0,0,0
1,1,3,3,0,5,2,4,3,"27",0,4,7,3,0,2,1038100,"2024-01-08T00:00:00.000Z",30,FALSE,21,666541,"G",21,21,"Oklahoma City Thunder","Luguentz Dort",1,10,11,8,4,13.1
10,0,6,1,1,13,9,2,2,"34",1,3,21,7,2,3,1038100,"2024-01-08T00:00:00.000Z",30,FALSE,21,38017703,"G-F",21,21,"Oklahoma City Thunder","Jalen Williams",2,28,38,31,17,47.4
5,2,3,5,4,14,11,8,5,"32",1,3,31,4,0,1,1038100,"2024-01-08T00:00:00.000Z",30,FALSE,21,38017685,"C-F",21,21,"Oklahoma City Thunder","Chet Holmgren",2,35,40,36,9,48.3
5,1,5,3,2,17,11,10,8,"36",1,5,32,6,3,3,1038100,"2024-01-08T00:00:00.000Z",30,FALSE,21,175,"G",21,21,"Oklahoma City Thunder","Shai Gilgeous-Alexander",4,38,43,37,11,55.7
9,0,5,3,1,11,4,0,0,"26",1,2,9,6,2,1,1038100,"2024-01-08T00:00:00.000Z",30,FALSE,21,17896065,"G",21,21,"Oklahoma City Thunder","Josh Giddey",2,15,24,18,15,34.7
3,0,3,7,4,10,6,0,0,"21",1,0,16,4,0,1,1038100,"2024-01-08T00:00:00.000Z",30,FALSE,21,3547272,"G",21,21,"Oklahoma City Thunder","Isaiah Joe",0,20,23,19,7,24.3
0,0,0,0,0,0,0,0,0,"00",0,0,0,0,0,0,1038100,"2024-01-08T00:00:00.000Z",30,FALSE,21,17896036,"G",21,21,"Oklahoma City Thunder","Tre Mann",0,0,0,0,0,0
0,0,0,0,0,0,0,0,0,"00",0,0,0,0,0,0,1038100,"2024-01-08T00:00:00.000Z",30,FALSE,21,4197029,"G",21,21,"Oklahoma City Thunder","Vasilije Micic",0,0,0,0,0,0
0,0,0,0,0,0,0,0,0,"00",0,0,0,0,0,0,1038100,"2024-01-08T00:00:00.000Z",30,FALSE,21,3547271,"C",21,21,"Oklahoma City Thunder","Aleksej Pokusevski",0,0,0,0,0,0
2,3,1,4,1,7,2,0,0,"24",1,1,5,2,2,1,1038100,"2024-01-08T00:00:00.000Z",30,FALSE,21,56677833,"G",21,21,"Oklahoma City Thunder","Cason Wallace",5,7,9,7,4,24.4
0,0,0,0,0,0,0,0,0,"00",0,0,0,0,0,0,1038100,"2024-01-08T00:00:00.000Z",30,FALSE,21,27924547,"F",21,21,"Oklahoma City Thunder","Lindy Waters III",0,0,0,0,0,0
0,0,3,1,1,8,6,0,0,"23",2,1,13,5,1,1,1038100,"2024-01-08T00:00:00.000Z",30,FALSE,21,17896078,"G",21,21,"Oklahoma City Thunder","Aaron Wiggins",1,18,18,13,5,21
0,0,0,0,0,0,0,0,0,"00",0,0,0,0,0,0,1038100,"2024-01-08T00:00:00.000Z",30,FALSE,21,38017706,"F",21,21,"Oklahoma City Thunder","Jaylin Williams",0,0,0,0,0,0
2,0,1,1,0,3,1,0,0,"17",2,2,2,3,1,1,1038100,"2024-01-08T00:00:00.000Z",30,FALSE,21,480,"G-F",21,21,"Oklahoma City Thunder","Kenrich Williams",1,5,7,4,5,10.6
0,0,0,0,0,0,0,0,0,"00",0,0,0,0,0,0,1038100,"2024-01-08T00:00:00.000Z",30,FALSE,21,44,"F",21,21,"Oklahoma City Thunder","Davis Bertans",0,0,0,0,0,0
0,0,0,0,0,0,0,0,0,"00",0,0,0,0,0,0,1038100,"2024-01-08T00:00:00.000Z",30,FALSE,21,38017716,"F",21,21,"Oklahoma City Thunder","Ousmane Dieng",0,0,0,0,0,0
0,0,0,0,0,0,0,0,0,"00",0,0,0,0,0,0,1038100,"2024-01-08T00:00:00.000Z",30,FALSE,21,56677853,"F",21,21,"Oklahoma City Thunder","Keyontae Johnson",0,0,0,0,0,0
0,0,0,0,0,0,0,0,0,"00",0,0,0,0,0,0,1038100,"2024-01-08T00:00:00.000Z",30,FALSE,21,24572055,"C",21,21,"Oklahoma City Thunder","Olivier Sarr",0,0,0,0,0,0
2,1,2,5,3,10,6,3,2,"26",2,2,17,4,0,0,1038099,"2024-01-08T00:00:00.000Z",12,FALSE,2,3547250,"G-F",12,12,"Indiana Pacers","Aaron Nesmith",1,21,23,19,6,27.8
1,3,7,4,1,8,3,4,4,"27",2,1,11,9,0,2,1038099,"2024-01-08T00:00:00.000Z",12,FALSE,2,3547264,"F-C",12,12,"Indiana Pacers","Jalen Smith",3,20,21,12,10,30.3
1,0,6,3,1,13,7,2,1,"35",2,2,16,8,0,2,1038099,"2024-01-08T00:00:00.000Z",12,FALSE,2,452,"C-F",12,12,"Indiana Pacers","Myles Turner",0,24,25,17,9,25.1
2,0,2,1,1,6,1,4,4,"21",0,1,7,2,1,0,1038099,"2024-01-08T00:00:00.000Z",12,FALSE,2,69,"G",12,12,"Indiana Pacers","Bruce Brown",1,9,11,9,4,15.4
6,0,2,3,1,5,3,0,0,"13",0,1,7,2,0,2,1038099,"2024-01-08T00:00:00.000Z",12,FALSE,2,3547245,"G",12,12,"Indiana Pacers","Tyrese Haliburton",0,9,15,13,8,16.4
3,2,3,7,3,11,6,0,0,"25",1,3,15,4,1,1,1038099,"2024-01-08T00:00:00.000Z",12,FALSE,2,210,"G",12,12,"Indiana Pacers","Buddy Hield",3,19,22,18,7,32.3
0,2,1,0,0,0,0,0,0,"07",1,1,0,2,0,0,1038099,"2024-01-08T00:00:00.000Z",12,FALSE,2,17896035,"F",12,12,"Indiana Pacers","Isaiah Jackson",2,2,2,0,2,8.4
0,0,0,0,0,0,0,0,0,"00",0,0,0,0,0,0,1038099,"2024-01-08T00:00:00.000Z",12,FALSE,2,242,"F",12,12,"Indiana Pacers","James Johnson",0,0,0,0,0,0
3,0,4,9,5,15,8,7,5,"29",0,4,26,4,2,2,1038099,"2024-01-08T00:00:00.000Z",12,FALSE,2,38017686,"G-F",12,12,"Indiana Pacers","Bennedict Mathurin",2,30,33,29,7,39.3
7,0,3,2,0,12,6,0,0,"25",1,1,12,4,2,2,1038099,"2024-01-08T00:00:00.000Z",12,FALSE,2,304,"G",12,12,"Indiana Pacers","T.J. McConnell",2,16,23,19,11,31.3
3,0,0,2,1,6,4,0,0,"12",0,5,9,0,0,2,1038099,"2024-01-08T00:00:00.000Z",12,FALSE,2,38017507,"G-F",12,12,"Indiana Pacers","Andrew Nembhard",0,9,12,12,3,11.5
0,0,0,0,0,0,0,0,0,"00",0,0,0,0,0,0,1038099,"2024-01-08T00:00:00.000Z",12,FALSE,2,3547207,"F",12,12,"Indiana Pacers","Jordan Nwora",0,0,0,0,0,0
0,0,0,0,0,0,0,0,0,"00",0,0,0,0,0,0,1038099,"2024-01-08T00:00:00.000Z",12,FALSE,2,56677861,"G",12,12,"Indiana Pacers","Ben Sheppard",0,0,0,0,0,0
1,0,0,4,3,5,4,2,2,"20",0,2,13,0,0,0,1038099,"2024-01-08T00:00:00.000Z",12,FALSE,2,3547243,"F",12,12,"Indiana Pacers","Obi Toppin",0,13,14,14,1,14.5
0,0,0,0,0,0,0,0,0,"00",0,0,0,0,0,0,1038099,"2024-01-08T00:00:00.000Z",12,FALSE,2,56677832,"F",12,12,"Indiana Pacers","Jarace Walker",0,0,0,0,0,0
0,0,0,0,0,0,0,0,0,"00",0,0,0,0,0,0,1038099,"2024-01-08T00:00:00.000Z",12,FALSE,2,38017701,"G",12,12,"Indiana Pacers","Kendall Brown",0,0,0,0,0,0
0,0,0,0,0,0,0,0,0,"00",0,0,0,0,0,0,1038099,"2024-01-08T00:00:00.000Z",12,FALSE,2,56677778,"F-C",12,12,"Indiana Pacers","Oscar Tshiebwe",0,0,0,0,0,0
0,0,0,0,0,0,0,0,0,"00",0,0,0,0,0,0,1038099,"2024-01-08T00:00:00.000Z",12,FALSE,2,56677794,"G",12,12,"Indiana Pacers","Isaiah Wong",0,0,0,0,0,0
2,0,4,4,3,26,17,5,3,"38",1,2,40,5,0,5,1038099,"2024-01-08T00:00:00.000Z",12,FALSE,2,70,"G",2,2,"Boston Celtics","Jaylen Brown",0,45,47,42,7,44
0,1,6,4,3,5,4,0,0,"32",0,1,11,6,0,1,1038099,"2024-01-08T00:00:00.000Z",12,FALSE,2,219,"C-F",2,2,"Boston Celtics","Al Horford",1,17,17,11,6,20.2
7,3,3,4,1,13,6,7,6,"38",2,2,19,5,0,1,1038099,"2024-01-08T00:00:00.000Z",12,FALSE,2,378,"F-C",2,2,"Boston Celtics","Kristaps Porzingis",3,24,31,26,12,43.5
6,2,4,8,2,16,4,3,3,"36",0,3,13,4,0,1,1038099,"2024-01-08T00:00:00.000Z",12,FALSE,2,473,"G",2,2,"Boston Celtics","Derrick White",2,17,23,19,10,31.8
6,0,5,6,3,16,9,0,0,"38",1,2,21,6,1,3,1038099,"2024-01-08T00:00:00.000Z",12,FALSE,2,214,"G",2,2,"Boston Celtics","Jrue Holiday",1,27,33,27,12,37.2
0,0,0,0,0,0,0,0,0,"04",0,3,0,0,0,1,1038099,"2024-01-08T00:00:00.000Z",12,FALSE,2,17896094,"G",2,2,"Boston Celtics","Dalano Banton",0,0,0,0,0,-1
0,0,4,4,1,4,1,6,3,"16",2,3,6,6,2,0,1038099,"2024-01-08T00:00:00.000Z",12,FALSE,2,666468,"F",2,2,"Boston Celtics","Oshae Brissett",2,12,12,6,6,19.2
2,2,0,0,0,4,1,4,3,"10",2,2,5,2,0,1,1038099,"2024-01-08T00:00:00.000Z",12,FALSE,2,261,"F-C",2,2,"Boston Celtics","Luke Kornet",2,7,9,7,4,15.4
0,0,0,0,0,0,0,4,2,"05",1,0,2,1,0,1,1038099,"2024-01-08T00:00:00.000Z",12,FALSE,2,338,"G",2,2,"Boston Celtics","Svi Mykhailiuk",0,3,3,2,1,2.2
3,0,3,5,4,6,5,0,0,"23",4,2,14,7,0,1,1038099,"2024-01-08T00:00:00.000Z",12,FALSE,2,3547276,"G",2,2,"Boston Celtics","Payton Pritchard",0,21,24,17,10,25.9
0,0,0,0,0,0,0,0,0,"00",0,0,0,0,0,0,1038099,"2024-01-08T00:00:00.000Z",12,FALSE,2,17553967,"C",2,2,"Boston Celtics","Neemias Queta",0,0,0,0,0,0
0,0,0,0,0,0,0,0,0,"00",0,0,0,0,0,0,1038099,"2024-01-08T00:00:00.000Z",12,FALSE,2,3547279,"F",2,2,"Boston Celtics","Lamar Stevens",0,0,0,0,0,0
0,0,0,0,0,0,0,0,0,"00",0,0,0,0,0,0,1038099,"2024-01-08T00:00:00.000Z",12,FALSE,2,38017707,"G",2,2,"Boston Celtics","JD Davison",0,0,0,0,0,0
0,0,0,0,0,0,0,0,0,"00",0,0,0,0,0,0,1038099,"2024-01-08T00:00:00.000Z",12,FALSE,2,17896060,"F",2,2,"Boston Celtics","Sam Hauser",0,0,0,0,0,0
0,0,0,0,0,0,0,0,0,"00",0,0,0,0,0,0,1038099,"2024-01-08T00:00:00.000Z",12,FALSE,2,NA,NA,NA,2,"Boston Celtics","NA NA",0,0,0,0,0,0
0,0,0,0,0,0,0,0,0,"00",0,0,0,0,0,0,1038099,"2024-01-08T00:00:00.000Z",12,FALSE,2,434,"F",2,2,"Boston Celtics","Jayson Tatum",0,0,0,0,0,0
0,0,0,0,0,0,0,0,0,"00",0,0,0,0,0,0,1038099,"2024-01-08T00:00:00.000Z",12,FALSE,2,56677864,"G",2,2,"Boston Celtics","Jordan Walsh",0,0,0,0,0,0
2,0,0,2,1,3,1,0,0,"15",1,0,3,1,0,0,1038104,"2024-01-09T00:00:00.000Z",9,FALSE,26,17896071,"F",9,9,"Detroit Pistons","Isaiah Livers",0,4,6,5,3,7.2
2,0,4,7,4,14,10,3,2,"33",1,1,26,5,3,3,1038104,"2024-01-09T00:00:00.000Z",9,FALSE,26,54,"F",9,9,"Detroit Pistons","Bojan Bogdanovic",3,31,33,28,7,41
3,0,7,0,0,14,8,0,0,"24",3,4,16,10,0,3,1038104,"2024-01-09T00:00:00.000Z",9,FALSE,26,38017694,"C",9,9,"Detroit Pistons","Jalen Duren",0,26,29,19,13,29.5
6,0,0,9,2,17,7,8,6,"33",5,4,22,5,2,4,1038104,"2024-01-09T00:00:00.000Z",9,FALSE,26,38017682,"G",9,9,"Detroit Pistons","Jaden Ivey",2,27,33,28,11,39
7,0,3,1,0,4,1,2,2,"31",1,2,4,4,1,6,1038104,"2024-01-09T00:00:00.000Z",9,FALSE,26,3547241,"G",9,9,"Detroit Pistons","Killian Hayes",1,8,15,11,11,16.3
0,0,0,0,0,0,0,0,0,"00",0,0,0,0,0,0,1038104,"2024-01-09T00:00:00.000Z",9,FALSE,26,24,"F",9,9,"Detroit Pistons","Marvin Bagley III",0,0,0,0,0,0
2,2,5,9,5,17,13,1,1,"35",0,2,32,5,1,1,1038104,"2024-01-09T00:00:00.000Z",9,FALSE,26,38017688,"F",26,26,"Sacramento Kings","Keegan Murray",3,37,39,34,7,49
1,0,1,0,0,1,0,2,0,"14",0,0,0,1,0,0,1038104,"2024-01-09T00:00:00.000Z",9,FALSE,26,30,"F",26,26,"Sacramento Kings","Harrison Barnes",0,1,2,1,2,2.7
13,0,5,1,1,21,16,4,4,"38",5,3,37,10,3,5,1038104,"2024-01-09T00:00:00.000Z",9,FALSE,26,406,"F",26,26,"Sacramento Kings","Domantas Sabonis",3,47,60,50,23,72.5
5,1,5,6,0,11,2,0,0,"29",0,1,4,5,1,0,1038104,"2024-01-09T00:00:00.000Z",9,FALSE,26,221,"G",26,26,"Sacramento Kings","Kevin Huerter",2,9,14,9,10,23.5
4,0,3,7,4,19,10,2,2,"33",0,2,26,3,2,5,1038104,"2024-01-09T00:00:00.000Z",9,FALSE,26,161,"G",26,26,"Sacramento Kings","De'Aaron Fox",2,29,33,30,7,36.6
0,0,0,0,0,0,0,0,0,"00",0,0,0,0,0,0,1038104,"2024-01-09T00:00:00.000Z",9,FALSE,26,17896030,"G",26,26,"Sacramento Kings","Chris Duarte",0,0,0,0,0,0
1,0,0,0,0,0,0,0,0,"01",0,0,0,0,0,0,1038104,"2024-01-09T00:00:00.000Z",9,FALSE,26,17896044,"F",26,26,"Sacramento Kings","Kessler Edwards",0,0,1,1,1,1.5
0,0,0,0,0,0,0,0,0,"05",0,1,0,0,0,0,1038104,"2024-01-09T00:00:00.000Z",9,FALSE,26,38017714,"G",26,26,"Sacramento Kings","Keon Ellis",0,0,0,0,0,0
0,1,2,0,0,3,3,1,0,"10",1,1,6,3,0,1,1038104,"2024-01-09T00:00:00.000Z",9,FALSE,26,273,"C",26,26,"Sacramento Kings","Alex Len",1,9,9,6,3,11.6
3,0,7,3,1,4,1,4,3,"32",1,2,6,8,0,1,1038104,"2024-01-09T00:00:00.000Z",9,FALSE,26,290,"F",26,26,"Sacramento Kings","Trey Lyles",0,14,17,9,11,19.1
0,0,0,0,0,0,0,0,0,"00",0,0,0,0,0,0,1038104,"2024-01-09T00:00:00.000Z",9,FALSE,26,306,"C",26,26,"Sacramento Kings","JaVale McGee",0,0,0,0,0,0
0,0,0,0,0,0,0,0,0,"01",1,0,0,1,0,0,1038104,"2024-01-09T00:00:00.000Z",9,FALSE,26,17553994,"G",26,26,"Sacramento Kings","Davion Mitchell",0,1,1,0,1,1.2
9,2,2,6,2,15,9,0,0,"28",0,5,20,2,1,3,1038104,"2024-01-09T00:00:00.000Z",9,FALSE,26,324,"G",26,26,"Sacramento Kings","Malik Monk",3,22,31,29,11,41.9
0,0,0,0,0,0,0,0,0,"00",0,0,0,0,0,0,1038104,"2024-01-09T00:00:00.000Z",9,FALSE,26,4197162,"F",26,26,"Sacramento Kings","Aleksandar Vezenkov",0,0,0,0,0,0
0,0,0,0,0,0,0,0,0,"00",0,0,0,0,0,0,1038104,"2024-01-09T00:00:00.000Z",9,FALSE,26,17895990,"G",26,26,"Sacramento Kings","Jordan Ford",0,0,0,0,0,0
0,0,0,0,0,0,0,0,0,"00",0,0,0,0,0,0,1038104,"2024-01-09T00:00:00.000Z",9,FALSE,26,56677845,"G",26,26,"Sacramento Kings","Colby Jones",0,0,0,0,0,0
0,0,0,0,0,0,0,0,0,"00",0,0,0,0,0,0,1038104,"2024-01-09T00:00:00.000Z",9,FALSE,26,56677862,"F",26,26,"Sacramento Kings","Jalen Slawson",0,0,0,0,0,0
1,0,3,7,3,11,5,5,3,"20",0,0,16,3,1,2,1038104,"2024-01-09T00:00:00.000Z",9,FALSE,26,77,"G",9,9,"Detroit Pistons","Alec Burks",1,19,20,17,4,22.1
0,0,1,5,3,5,3,0,0,"09",0,2,9,1,0,0,1038104,"2024-01-09T00:00:00.000Z",9,FALSE,26,197,"F-G",9,9,"Detroit Pistons","Joe Harris",0,10,10,9,1,10.2
1,0,1,4,1,8,3,1,1,"20",1,1,8,2,1,2,1038104,"2024-01-09T00:00:00.000Z",9,FALSE,26,259,"F",9,9,"Detroit Pistons","Kevin Knox",1,10,11,9,3,12.9
4,1,2,2,0,4,0,2,2,"18",0,0,2,2,1,0,1038104,"2024-01-09T00:00:00.000Z",9,FALSE,26,56677792,"G",9,9,"Detroit Pistons","Marcus Sasser",2,4,8,6,6,16.4
0,0,0,0,0,0,0,0,0,"00",0,0,0,0,0,0,1038104,"2024-01-09T00:00:00.000Z",9,FALSE,26,3547267,"F-C",9,9,"Detroit Pistons","Isaiah Stewart",0,0,0,0,0,0
0,0,2,0,0,2,0,0,0,"13",0,3,0,2,3,0,1038104,"2024-01-09T00:00:00.000Z",9,FALSE,26,56677826,"G-F",9,9,"Detroit Pistons","Ausar Thompson",3,2,2,0,2,11.4
1,1,4,0,0,3,2,0,0,"24",1,2,4,5,0,1,1038104,"2024-01-09T00:00:00.000Z",9,FALSE,26,3547240,"C",9,9,"Detroit Pistons","James Wiseman",1,9,10,5,6,13.5
0,0,0,0,0,0,0,0,0,"00",0,0,0,0,0,0,1038104,"2024-01-09T00:00:00.000Z",9,FALSE,26,56677729,"G",9,9,"Detroit Pistons","Malcolm Cazalon",0,0,0,0,0,0
0,0,0,0,0,0,0,0,0,"00",0,0,0,0,0,0,1038104,"2024-01-09T00:00:00.000Z",9,FALSE,26,17896075,"G-F",9,9,"Detroit Pistons","Cade Cunningham",0,0,0,0,0,0
0,0,0,0,0,0,0,0,0,"00",0,0,0,0,0,0,1038104,"2024-01-09T00:00:00.000Z",9,FALSE,26,330,"G",9,9,"Detroit Pistons","Monte Morris",0,0,0,0,0,0
0,0,0,0,0,0,0,0,0,"00",0,0,0,0,0,0,1038104,"2024-01-09T00:00:00.000Z",9,FALSE,26,42097199,"G",9,9,"Detroit Pistons","Jared Rhoden",0,0,0,0,0,0
0,0,0,0,0,0,0,0,0,"00",0,0,0,0,0,0,1038104,"2024-01-09T00:00:00.000Z",9,FALSE,26,44477024,"G",9,9,"Detroit Pistons","Stanley Umude",0,0,0,0,0,0
1,0,4,1,0,3,0,0,0,"14",2,4,0,6,0,1,1038104,"2024-01-09T00:00:00.000Z",9,FALSE,26,666925,"F",29,26,"Sacramento Kings","Juan Toscano-Anderson",0,6,7,1,7,7.7
2,0,4,10,2,12,3,0,0,"34",3,2,8,7,0,0,1038105,"2024-01-09T00:00:00.000Z",22,FALSE,18,38017724,"G",22,22,"Orlando Magic","Caleb Houstan",0,15,17,10,9,19.4
3,1,2,4,1,22,8,4,1,"35",0,4,18,2,3,4,1038105,"2024-01-09T00:00:00.000Z",22,FALSE,18,38017683,"F",22,22,"Orlando Magic","Paolo Banchero",4,20,23,21,5,32.9
1,2,2,0,0,3,1,0,0,"17",4,4,2,6,1,1,1038105,"2024-01-09T00:00:00.000Z",22,FALSE,18,666442,"C",22,22,"Orlando Magic","Goga Bitadze",3,8,9,3,7,18.7
1,1,8,8,1,10,1,0,0,"27",2,2,3,10,0,0,1038105,"2024-01-09T00:00:00.000Z",22,FALSE,18,666818,"F",22,22,"Orlando Magic","Chuma Okeke",1,13,14,4,11,19.5
2,0,4,8,4,14,8,1,0,"27",1,2,20,5,3,2,1038105,"2024-01-09T00:00:00.000Z",22,FALSE,18,17896073,"G",22,22,"Orlando Magic","Jalen Suggs",3,25,27,22,7,36
0,0,0,1,0,4,1,0,0,"07",1,2,2,1,0,0,1038105,"2024-01-09T00:00:00.000Z",22,FALSE,18,3547251,"G",22,22,"Orlando Magic","Cole Anthony",0,3,3,2,1,3.2
4,1,1,3,1,4,1,0,0,"21",0,2,3,1,3,2,1038105,"2024-01-09T00:00:00.000Z",22,FALSE,18,56677827,"G",22,22,"Orlando Magic","Anthony Black",4,4,8,7,5,20.2
0,0,0,0,0,0,0,0,0,"00",0,0,0,0,0,0,1038105,"2024-01-09T00:00:00.000Z",22,FALSE,18,85,"F",22,22,"Orlando Magic","Wendell Carter Jr.",0,0,0,0,0,0
2,0,2,0,0,7,2,0,0,"13",1,0,4,3,0,0,1038105,"2024-01-09T00:00:00.000Z",22,FALSE,18,165,"G",22,22,"Orlando Magic","Markelle Fultz",0,7,9,6,5,10.6
0,0,0,0,0,0,0,0,0,"00",0,0,0,0,0,0,1038105,"2024-01-09T00:00:00.000Z",22,FALSE,18,226,"F",22,22,"Orlando Magic","Joe Ingles",0,0,0,0,0,0
3,0,2,4,3,9,3,2,2,"28",1,1,11,3,1,2,1038105,"2024-01-09T00:00:00.000Z",22,FALSE,18,17553983,"G",22,22,"Orlando Magic","Trevelin Queen",1,14,17,14,6,20.1
2,0,5,4,1,9,6,11,8,"31",3,3,21,8,2,1,1038105,"2024-01-09T00:00:00.000Z",22,FALSE,18,462,"C",22,22,"Orlando Magic","Moritz Wagner",2,29,31,23,10,38.6
0,0,0,0,0,0,0,0,0,"00",0,0,0,0,0,0,1038105,"2024-01-09T00:00:00.000Z",22,FALSE,18,196,"G",22,22,"Orlando Magic","Gary Harris",0,0,0,0,0,0
0,0,0,0,0,0,0,0,0,"00",0,0,0,0,0,0,1038105,"2024-01-09T00:00:00.000Z",22,FALSE,18,38017607,"G",22,22,"Orlando Magic","Kevon Harris",0,0,0,0,0,0
0,0,0,0,0,0,0,0,0,"00",0,0,0,0,0,0,1038105,"2024-01-09T00:00:00.000Z",22,FALSE,18,56677839,"G",22,22,"Orlando Magic","Jett Howard",0,0,0,0,0,0
0,0,0,0,0,0,0,0,0,"00",0,0,0,0,0,0,1038105,"2024-01-09T00:00:00.000Z",22,FALSE,18,229,"F",22,22,"Orlando Magic","Jonathan Isaac",0,0,0,0,0,0
0,0,0,0,0,0,0,0,0,"00",0,0,0,0,0,0,1038105,"2024-01-09T00:00:00.000Z",22,FALSE,18,666885,"F",22,22,"Orlando Magic","Admiral Schofield",0,0,0,0,0,0
0,0,0,0,0,0,0,0,0,"00",0,0,0,0,0,0,1038105,"2024-01-09T00:00:00.000Z",22,FALSE,18,17896026,"F",22,22,"Orlando Magic","Franz Wagner",0,0,0,0,0,0
1,0,9,5,2,10,6,1,1,"35",0,1,15,9,1,2,1038105,"2024-01-09T00:00:00.000Z",22,FALSE,18,3547259,"F",18,18,"Minnesota Timberwolves","Jaden McDaniels",1,24,25,16,10,28.3
5,0,5,5,5,19,11,1,1,"34",1,2,28,6,3,2,1038105,"2024-01-09T00:00:00.000Z",22,FALSE,18,447,"C",18,18,"Minnesota Timberwolves","Karl-Anthony Towns",3,34,39,33,11,49.7
1,3,11,0,0,10,8,6,5,"34",1,3,21,12,1,2,1038105,"2024-01-09T00:00:00.000Z",22,FALSE,18,176,"C",18,18,"Minnesota Timberwolves","Rudy Gobert",4,33,34,22,13,46.9
3,0,3,2,0,7,2,3,2,"26",1,3,6,4,0,5,1038105,"2024-01-09T00:00:00.000Z",22,FALSE,18,3547238,"G",18,18,"Minnesota Timberwolves","Anthony Edwards",0,10,13,9,7,10.3
10,0,3,6,3,8,3,2,2,"31",0,3,11,3,2,1,1038105,"2024-01-09T00:00:00.000Z",22,FALSE,18,104,"G",18,18,"Minnesota Timberwolves","Mike Conley",2,14,24,21,13,34.6
3,0,1,1,0,6,4,4,3,"21",0,1,11,1,0,0,1038105,"2024-01-09T00:00:00.000Z",22,FALSE,18,12,"F",18,18,"Minnesota Timberwolves","Kyle Anderson",0,12,15,14,4,16.7
0,0,0,0,0,0,0,0,0,"00",0,0,0,0,0,0,1038105,"2024-01-09T00:00:00.000Z",22,FALSE,18,17896056,"C",18,18,"Minnesota Timberwolves","Luka Garza",0,0,0,0,0,0
0,0,0,0,0,0,0,0,0,"00",0,0,0,0,0,0,1038105,"2024-01-09T00:00:00.000Z",22,FALSE,18,56677782,"F",18,18,"Minnesota Timberwolves","Leonard Miller",0,0,0,0,0,0
0,0,0,0,0,0,0,0,0,"00",0,0,0,0,0,0,1038105,"2024-01-09T00:00:00.000Z",22,FALSE,18,38017715,"F",18,18,"Minnesota Timberwolves","Josh Minott",0,0,0,0,0,0
0,0,0,0,0,0,0,0,0,"00",0,0,0,0,0,0,1038105,"2024-01-09T00:00:00.000Z",22,FALSE,18,17895968,"F",18,18,"Minnesota Timberwolves","Daishen Nix",0,0,0,0,0,0
0,0,0,0,0,0,0,0,0,"00",0,0,0,0,0,0,1038105,"2024-01-09T00:00:00.000Z",22,FALSE,18,38017700,"G",18,18,"Minnesota Timberwolves","Wendell Moore Jr.",0,0,0,0,0,0
0,0,0,0,0,0,0,0,0,"00",0,0,0,0,0,0,1038105,"2024-01-09T00:00:00.000Z",22,FALSE,18,56677851,"G",18,18,"Minnesota Timberwolves","Jaylen Clark",0,0,0,0,0,0
2,0,8,4,2,8,5,2,1,"21",2,3,13,10,0,3,1038105,"2024-01-09T00:00:00.000Z",22,FALSE,18,667378,"F-C",18,18,"Minnesota Timberwolves","Naz Reid",0,23,25,15,12,25
5,0,0,1,0,3,2,0,0,"16",0,1,4,0,1,1,1038105,"2024-01-09T00:00:00.000Z",22,FALSE,18,666767,"G",18,18,"Minnesota Timberwolves","Jordan McLaughlin",1,4,9,9,5,13.5
1,0,1,2,0,2,0,0,0,"02",0,0,0,1,0,0,1038105,"2024-01-09T00:00:00.000Z",22,FALSE,18,68,"F",18,18,"Minnesota Timberwolves","Troy Brown Jr.",0,1,2,1,2,2.7
0,0,0,0,0,2,2,0,0,"02",0,0,4,0,0,0,1038105,"2024-01-09T00:00:00.000Z",22,FALSE,18,320,"G",18,18,"Minnesota Timberwolves","Shake Milton",0,4,4,4,0,4
3,1,2,4,0,5,0,0,0,"18",0,1,0,2,0,2,1038105,"2024-01-09T00:00:00.000Z",22,FALSE,18,666400,"G",18,18,"Minnesota Timberwolves","Nickeil Alexander-Walker",1,2,5,3,5,7.9
0,1,2,6,4,12,9,2,1,"29",2,3,23,4,1,1,1038106,"2024-01-09T00:00:00.000Z",20,FALSE,25,18,"F",28,20,"New York Knicks","OG Anunoby",2,27,27,23,4,32.8
8,1,7,4,2,17,7,4,4,"32",0,1,20,7,0,2,1038106,"2024-01-09T00:00:00.000Z",20,FALSE,25,387,"F",20,20,"New York Knicks","Julius Randle",1,27,35,28,15,41.4
3,1,9,0,0,1,1,4,3,"28",5,3,5,14,3,2,1038106,"2024-01-09T00:00:00.000Z",20,FALSE,25,201,"F-C",20,20,"New York Knicks","Isaiah Hartenstein",4,19,22,8,17,36.3
7,0,2,7,1,11,3,6,5,"26",1,0,12,3,0,0,1038106,"2024-01-09T00:00:00.000Z",20,FALSE,25,73,"G",20,20,"New York Knicks","Jalen Brunson",0,15,22,19,10,26.1
2,0,4,8,3,9,4,2,2,"19",0,2,13,4,1,0,1038106,"2024-01-09T00:00:00.000Z",20,FALSE,25,131,"G",20,20,"New York Knicks","Donte DiVincenzo",1,17,19,15,6,23.8
1,1,4,3,0,9,1,0,0,"20",5,0,2,9,1,1,1038106,"2024-01-09T00:00:00.000Z",20,FALSE,25,3547249,"F",28,20,"New York Knicks","Precious Achiuwa",2,11,12,3,10,19.3
0,0,0,1,0,1,0,0,0,"06",0,2,0,0,0,0,1038106,"2024-01-09T00:00:00.000Z",20,FALSE,25,19,"G",20,20,"New York Knicks","Ryan Arcidiacono",0,0,0,0,0,0
0,0,0,1,0,1,0,2,2,"04",0,0,2,0,0,0,1038106,"2024-01-09T00:00:00.000Z",20,FALSE,25,3547275,"G",28,20,"New York Knicks","Malachi Flynn",0,2,2,2,0,2
0,0,0,0,0,0,0,0,0,"00",0,0,0,0,0,0,1038106,"2024-01-09T00:00:00.000Z",20,FALSE,25,160,"G-F",20,20,"New York Knicks","Evan Fournier",0,0,0,0,0,0
1,0,4,9,4,11,5,3,3,"21",0,1,17,4,3,2,1038106,"2024-01-09T00:00:00.000Z",20,FALSE,25,17895858,"G",20,20,"New York Knicks","Quentin Grimes",3,21,22,18,5,30.3
4,0,6,2,0,4,1,0,0,"26",1,3,2,7,0,3,1038106,"2024-01-09T00:00:00.000Z",20,FALSE,25,202,"G",20,20,"New York Knicks","Josh Hart",0,9,13,6,11,13.4
0,0,1,7,4,13,6,0,0,"22",1,1,16,2,1,2,1038106,"2024-01-09T00:00:00.000Z",20,FALSE,25,17896033,"G",20,20,"New York Knicks","Miles McBride",1,18,18,16,2,19.4
0,0,1,0,0,0,0,0,0,"07",0,0,0,1,1,1,1038106,"2024-01-09T00:00:00.000Z",20,FALSE,25,17896063,"F",20,20,"New York Knicks","Jericho Sims",1,1,1,0,1,3.2
0,0,0,0,0,0,0,0,0,"00",0,0,0,0,0,0,1038106,"2024-01-09T00:00:00.000Z",20,FALSE,25,666474,"G",20,20,"New York Knicks","Charles Brown",0,0,0,0,0,0
0,0,0,0,0,0,0,0,0,"00",0,0,0,0,0,0,1038106,"2024-01-09T00:00:00.000Z",20,FALSE,25,399,"C",20,20,"New York Knicks","Mitchell Robinson",0,0,0,0,0,0
0,0,0,0,0,0,0,0,0,"00",0,0,0,0,0,0,1038106,"2024-01-09T00:00:00.000Z",20,FALSE,25,56677795,"F",20,20,"New York Knicks","Jacob Toppin",0,0,0,0,0,0
0,0,0,0,0,0,0,0,0,"00",0,0,0,0,0,0,1038106,"2024-01-09T00:00:00.000Z",20,FALSE,25,17896089,"G",20,20,"New York Knicks","Duane Washington Jr.",0,0,0,0,0,0
2,2,3,3,1,4,2,0,0,"25",3,3,5,6,1,2,1038106,"2024-01-09T00:00:00.000Z",20,FALSE,25,56677850,"F",25,25,"Portland Trail Blazers","Toumani Camara",3,11,13,7,8,22.2
0,0,2,4,1,16,8,6,4,"28",0,2,21,2,0,1,1038106,"2024-01-09T00:00:00.000Z",20,FALSE,25,182,"F",25,25,"Portland Trail Blazers","Jerami Grant",0,23,23,21,2,22.4
0,0,5,3,1,6,3,0,0,"21",1,2,7,6,0,0,1038106,"2024-01-09T00:00:00.000Z",20,FALSE,25,56783340,"C",25,25,"Portland Trail Blazers","Duop Reath",0,13,13,7,6,14.2
4,0,3,3,1,8,3,2,1,"25",0,2,8,3,1,3,1038106,"2024-01-09T00:00:00.000Z",20,FALSE,25,56677747,"G",25,25,"Portland Trail Blazers","Scoot Henderson",1,11,15,12,7,17.6
3,0,4,7,2,14,4,2,2,"27",0,2,12,4,0,3,1038106,"2024-01-09T00:00:00.000Z",20,FALSE,25,419,"G",25,25,"Portland Trail Blazers","Anfernee Simons",0,16,19,15,7,18.3
3,2,4,0,0,5,2,2,0,"27",3,2,4,7,2,1,1038106,"2024-01-09T00:00:00.000Z",20,FALSE,25,39613724,"C",25,25,"Portland Trail Blazers","Ibou Badji",4,11,14,7,10,27.9
0,0,1,0,0,5,1,0,0,"13",0,2,2,1,0,1,1038106,"2024-01-09T00:00:00.000Z",20,FALSE,25,65,"G",25,25,"Portland Trail Blazers","Malcolm Brogdon",0,3,3,2,1,2.2
1,1,0,2,0,4,1,2,1,"12",1,1,3,1,0,1,1038106,"2024-01-09T00:00:00.000Z",20,FALSE,25,47957121,"F",25,25,"Portland Trail Blazers","Justin Minaya",1,4,5,4,2,7.7
1,0,1,3,0,10,3,3,3,"16",2,0,9,3,1,1,1038106,"2024-01-09T00:00:00.000Z",20,FALSE,25,56677791,"F",25,25,"Portland Trail Blazers","Kris Murray",1,12,13,10,4,16.1
1,0,4,1,0,5,2,0,0,"12",1,0,4,5,0,1,1038106,"2024-01-09T00:00:00.000Z",20,FALSE,25,56677829,"G-F",25,25,"Portland Trail Blazers","Rayan Rupert",0,9,10,5,6,10.5
4,1,3,2,0,8,4,1,1,"22",1,1,9,4,2,1,1038106,"2024-01-09T00:00:00.000Z",20,FALSE,25,38017690,"G",25,25,"Portland Trail Blazers","Shaedon Sharpe",3,13,17,13,8,27.8
0,0,0,0,0,0,0,0,0,"00",0,0,0,0,0,0,1038106,"2024-01-09T00:00:00.000Z",20,FALSE,25,666476,"C",25,25,"Portland Trail Blazers","Moses Brown",0,0,0,0,0,0
0,0,0,0,0,0,0,0,0,"00",0,0,0,0,0,0,1038106,"2024-01-09T00:00:00.000Z",20,FALSE,25,38017711,"F",25,25,"Portland Trail Blazers","Jabari Walker",0,0,0,0,0,0
0,0,0,0,0,0,0,0,0,"00",0,0,0,0,0,0,1038106,"2024-01-09T00:00:00.000Z",20,FALSE,25,476,"C-F",25,25,"Portland Trail Blazers","Robert Williams III",0,0,0,0,0,0
0,1,1,1,0,1,0,0,0,"12",0,0,0,1,1,0,1038106,"2024-01-09T00:00:00.000Z",20,FALSE,25,666923,"G-F",25,25,"Portland Trail Blazers","Matisse Thybulle",2,1,1,0,1,7.2
0,0,0,0,0,0,0,0,0,"00",0,0,0,0,0,0,1038106,"2024-01-09T00:00:00.000Z",20,FALSE,25,22,"C",25,25,"Portland Trail Blazers","Deandre Ayton",0,0,0,0,0,0
0,1,2,1,0,3,0,0,0,"23",1,1,0,3,0,0,1038107,"2024-01-09T00:00:00.000Z",7,FALSE,15,3547258,"G",7,7,"Dallas Mavericks","Josh Green",1,3,3,0,3,6.6
2,1,4,1,0,9,5,1,1,"36",0,1,11,4,0,0,1038107,"2024-01-09T00:00:00.000Z",7,FALSE,15,247,"F-G",7,7,"Dallas Mavericks","Derrick Jones Jr.",1,15,17,13,6,21.8
3,1,3,0,0,3,2,0,0,"22",1,3,4,4,2,2,1038107,"2024-01-09T00:00:00.000Z",7,FALSE,15,379,"F-C",7,7,"Dallas Mavericks","Dwight Powell",3,8,11,7,7,20.3
4,1,4,7,2,25,11,10,9,"40",4,3,33,8,4,3,1038107,"2024-01-09T00:00:00.000Z",7,FALSE,15,228,"G",7,7,"Dallas Mavericks","Kyrie Irving",5,41,45,37,12,60.6
6,0,6,8,2,21,9,15,11,"36",0,1,31,6,3,3,1038107,"2024-01-09T00:00:00.000Z",7,FALSE,15,132,"F-G",7,7,"Dallas Mavericks","Luka Doncic",3,37,43,37,12,53.2
0,0,0,1,0,2,1,0,0,"10",0,1,2,0,0,1,1038107,"2024-01-09T00:00:00.000Z",7,FALSE,15,114,"G",7,7,"Dallas Mavericks","Seth Curry",0,2,2,2,0,1
2,0,3,3,2,6,3,1,1,"30",0,3,9,3,0,1,1038107,"2024-01-09T00:00:00.000Z",7,FALSE,15,191,"G",7,7,"Dallas Mavericks","Tim Hardaway Jr.",0,12,14,11,5,14.6
1,0,1,4,2,7,4,0,0,"19",0,2,10,1,0,1,1038107,"2024-01-09T00:00:00.000Z",7,FALSE,15,38017679,"G",7,7,"Dallas Mavericks","Jaden Hardy",0,11,12,11,2,11.7
1,0,0,0,0,0,0,0,0,"03",1,0,0,1,0,0,1038107,"2024-01-09T00:00:00.000Z",7,FALSE,15,217,"F-C",7,7,"Dallas Mavericks","Richaun Holmes",0,1,2,1,2,2.7
0,0,0,0,0,0,0,0,0,"00",0,0,0,0,0,0,1038107,"2024-01-09T00:00:00.000Z",7,FALSE,15,257,"F",7,7,"Dallas Mavericks","Maxi Kleber",0,0,0,0,0,0
0,0,1,2,1,3,1,0,0,"05",1,1,3,2,0,0,1038107,"2024-01-09T00:00:00.000Z",7,FALSE,15,17554004,"G",7,7,"Dallas Mavericks","AJ Lawson",0,5,5,3,2,5.4
0,0,0,0,0,0,0,0,0,"06",0,0,0,0,0,0,1038107,"2024-01-09T00:00:00.000Z",7,FALSE,15,329,"F",7,7,"Dallas Mavericks","Markieff Morris",0,0,0,0,0,0
1,0,1,0,0,1,0,0,0,"03",0,0,0,1,0,0,1038107,"2024-01-09T00:00:00.000Z",7,FALSE,15,24489167,"G",25,7,"Dallas Mavericks","Brandon Williams",0,1,2,1,2,2.7
0,0,0,0,0,2,0,0,0,"07",0,1,0,0,0,1,1038107,"2024-01-09T00:00:00.000Z",7,FALSE,15,666965,"F",7,7,"Dallas Mavericks","Grant Williams",0,0,0,0,0,-1
0,0,0,0,0,0,0,0,0,"00",0,0,0,0,0,0,1038107,"2024-01-09T00:00:00.000Z",7,FALSE,15,17896028,"F",7,7,"Dallas Mavericks","Greg Brown III",0,0,0,0,0,0
0,0,0,0,0,0,0,0,0,"00",0,0,0,0,0,0,1038107,"2024-01-09T00:00:00.000Z",7,FALSE,15,151,"G",7,7,"Dallas Mavericks","Dante Exum",0,0,0,0,0,0
0,0,0,0,0,0,0,0,0,"00",0,0,0,0,0,0,1038107,"2024-01-09T00:00:00.000Z",7,FALSE,15,56677840,"C",7,7,"Dallas Mavericks","Dereck Lively II",0,0,0,0,0,0
0,0,0,0,0,0,0,0,0,"00",0,0,0,0,0,0,1038107,"2024-01-09T00:00:00.000Z",7,FALSE,15,56677859,"F",7,7,"Dallas Mavericks","Olivier-Maxence Prosper",0,0,0,0,0,0
4,0,4,4,3,7,5,1,1,"23",1,2,14,5,1,2,1038107,"2024-01-09T00:00:00.000Z",7,FALSE,15,254,"G",15,15,"Memphis Grizzlies","Luke Kennard",1,19,23,18,9,27
6,0,4,5,2,8,2,0,0,"30",2,5,6,6,3,3,1038107,"2024-01-09T00:00:00.000Z",7,FALSE,15,38017731,"G",15,15,"Memphis Grizzlies","Vince Williams Jr.",3,12,18,12,12,28.2
4,0,1,0,0,2,1,0,0,"18",1,2,2,2,0,2,1038107,"2024-01-09T00:00:00.000Z",7,FALSE,15,48,"C",15,15,"Memphis Grizzlies","Bismack Biyombo",0,4,8,6,6,8.4
4,0,7,9,2,27,11,9,8,"39",2,3,32,9,0,2,1038107,"2024-01-09T00:00:00.000Z",7,FALSE,15,3547287,"G",15,15,"Memphis Grizzlies","Desmond Bane",0,41,45,36,13,46.8
1,0,4,8,4,16,9,1,1,"21",0,0,23,4,2,1,1038107,"2024-01-09T00:00:00.000Z",7,FALSE,15,420,"G",15,15,"Memphis Grizzlies","Marcus Smart",2,27,28,24,5,34.3
0,0,0,0,0,0,0,0,0,"00",0,0,0,0,0,0,1038107,"2024-01-09T00:00:00.000Z",7,FALSE,15,17896067,"F",15,15,"Memphis Grizzlies","Santi Aldama",0,0,0,0,0,0
3,1,4,2,0,3,1,2,2,"25",3,0,4,7,0,0,1038107,"2024-01-09T00:00:00.000Z",7,FALSE,15,666703,"G-F",15,15,"Memphis Grizzlies","John Konchar",1,11,14,7,10,19.9
3,0,3,2,1,7,3,4,4,"25",2,2,11,5,0,2,1038107,"2024-01-09T00:00:00.000Z",7,FALSE,15,38017729,"F",15,15,"Memphis Grizzlies","David Roddy",0,16,19,14,8,19.5
2,2,5,1,0,9,6,4,2,"28",6,3,14,11,0,3,1038107,"2024-01-09T00:00:00.000Z",7,FALSE,15,3547285,"F",15,15,"Memphis Grizzlies","Xavier Tillman",2,25,27,16,13,33.2
0,0,3,5,2,9,6,0,0,"27",1,1,14,4,1,1,1038107,"2024-01-09T00:00:00.000Z",7,FALSE,15,17896027,"G-F",15,15,"Memphis Grizzlies","Ziaire Williams",1,18,18,14,4,20.8
0,0,0,1,0,2,0,0,0,"02",0,0,0,0,0,0,1038107,"2024-01-09T00:00:00.000Z",7,FALSE,15,56677830,"F",15,15,"Memphis Grizzlies","GG Jackson",0,0,0,0,0,0
0,0,1,0,0,1,0,0,0,"02",0,0,0,1,0,0,1038107,"2024-01-09T00:00:00.000Z",7,FALSE,15,38017728,"F",15,15,"Memphis Grizzlies","Jake LaRavia",0,1,1,0,1,1.2
0,0,0,0,0,0,0,0,0,"00",0,0,0,0,0,0,1038107,"2024-01-09T00:00:00.000Z",7,FALSE,15,3,"C",15,15,"Memphis Grizzlies","Steven Adams",0,0,0,0,0,0
0,0,0,0,0,0,0,0,0,"00",0,0,0,0,0,0,1038107,"2024-01-09T00:00:00.000Z",7,FALSE,15,666505,"F",15,15,"Memphis Grizzlies","Brandon Clarke",0,0,0,0,0,0
0,0,0,0,0,0,0,0,0,"00",0,0,0,0,0,0,1038107,"2024-01-09T00:00:00.000Z",7,FALSE,15,48248287,"G",15,15,"Memphis Grizzlies","Jacob Gilyard",0,0,0,0,0,0
0,0,0,0,0,0,0,0,0,"00",0,0,0,0,0,0,1038107,"2024-01-09T00:00:00.000Z",7,FALSE,15,231,"F-C",15,15,"Memphis Grizzlies","Jaren Jackson Jr.",0,0,0,0,0,0
0,0,0,0,0,0,0,0,0,"00",0,0,0,0,0,0,1038107,"2024-01-09T00:00:00.000Z",7,FALSE,15,666786,"G",15,15,"Memphis Grizzlies","Ja Morant",0,0,0,0,0,0
0,0,0,0,0,0,0,0,0,"00",0,0,0,0,0,0,1038107,"2024-01-09T00:00:00.000Z",7,FALSE,15,401,"G",15,15,"Memphis Grizzlies","Derrick Rose",0,0,0,0,0,0
0,1,1,6,4,7,4,2,1,"23",0,1,13,1,1,2,1038108,"2024-01-09T00:00:00.000Z",14,FALSE,28,666860,"F-G",14,14,"Los Angeles Lakers","Cameron Reddish",2,14,14,13,1,18.2
12,1,5,5,2,17,8,6,4,"35",0,0,22,5,1,3,1038108,"2024-01-09T00:00:00.000Z",14,FALSE,28,237,"F",14,14,"Los Angeles Lakers","LeBron James",2,27,39,34,17,49
6,1,10,2,2,17,13,14,13,"40",1,4,41,11,0,3,1038108,"2024-01-09T00:00:00.000Z",14,FALSE,28,117,"F-C",14,14,"Los Angeles Lakers","Anthony Davis",1,52,58,47,17,63.2
0,0,4,6,2,8,4,2,1,"34",0,2,11,4,2,0,1038108,"2024-01-09T00:00:00.000Z",14,FALSE,28,383,"F",14,14,"Los Angeles Lakers","Taurean Prince",2,15,15,11,4,21.8
7,0,3,6,1,10,3,4,4,"32",0,2,11,3,1,0,1038108,"2024-01-09T00:00:00.000Z",14,FALSE,28,17553995,"G",14,14,"Los Angeles Lakers","Austin Reaves",1,14,21,18,10,28.1
2,0,3,1,1,2,2,2,1,"18",1,0,6,4,0,0,1038108,"2024-01-09T00:00:00.000Z",14,FALSE,28,38017697,"G",14,14,"Los Angeles Lakers","Max Christie",0,10,12,8,6,13.8
5,0,0,6,2,8,4,2,1,"16",1,1,11,1,0,2,1038108,"2024-01-09T00:00:00.000Z",14,FALSE,28,405,"G",14,14,"Los Angeles Lakers","D'Angelo Russell",0,12,17,16,6,17.7
1,0,4,0,0,2,1,2,1,"18",2,1,3,6,0,3,1038108,"2024-01-09T00:00:00.000Z",14,FALSE,28,457,"F",14,14,"Los Angeles Lakers","Jarred Vanderbilt",0,9,10,4,7,8.7
1,1,4,4,2,10,5,2,2,"24",0,5,14,4,1,2,1038108,"2024-01-09T00:00:00.000Z",14,FALSE,28,486,"F",14,14,"Los Angeles Lakers","Christian Wood",2,18,19,15,5,24.3
5,0,9,3,1,13,10,3,2,"35",1,4,23,10,2,3,1038108,"2024-01-09T00:00:00.000Z",14,FALSE,28,666423,"F-G",20,28,"Toronto Raptors","RJ Barrett",2,33,38,28,15,45.5
3,1,4,5,3,17,10,3,2,"32",0,2,25,4,0,1,1038108,"2024-01-09T00:00:00.000Z",14,FALSE,28,416,"F",28,28,"Toronto Raptors","Pascal Siakam",1,29,32,28,7,36.3
4,1,4,1,0,9,5,0,0,"29",1,4,10,5,3,0,1038108,"2024-01-09T00:00:00.000Z",14,FALSE,28,489,"F",28,28,"Toronto Raptors","Thaddeus Young",4,15,19,14,9,34
6,2,2,7,3,20,11,2,1,"40",1,6,26,3,0,2,1038108,"2024-01-09T00:00:00.000Z",14,FALSE,28,17896055,"G-F",28,28,"Toronto Raptors","Scottie Barnes",2,29,35,32,9,42.6
5,0,4,6,4,14,8,3,1,"26",1,6,21,5,0,1,1038108,"2024-01-09T00:00:00.000Z",14,FALSE,28,3547269,"G",20,28,"Toronto Raptors","Immanuel Quickley",0,26,31,26,10,33.5
1,0,7,2,0,3,1,0,0,"14",0,1,2,7,2,3,1038108,"2024-01-09T00:00:00.000Z",14,FALSE,28,58,"F",28,28,"Toronto Raptors","Chris Boucher",2,9,10,3,8,14.9
0,0,0,0,0,0,0,0,0,"00",0,0,0,0,0,0,1038108,"2024-01-09T00:00:00.000Z",14,FALSE,28,666762,"F",28,28,"Toronto Raptors","Jalen McDaniels",0,0,0,0,0,0
3,0,0,2,0,2,0,0,0,"10",0,0,0,0,1,0,1038108,"2024-01-09T00:00:00.000Z",14,FALSE,28,2309958,"C-F",15,28,"Toronto Raptors","Jontay Porter",1,0,3,3,3,7.5
0,0,0,0,0,0,0,0,0,"00",0,0,0,0,0,0,1038108,"2024-01-09T00:00:00.000Z",14,FALSE,28,376,"F",28,28,"Toronto Raptors","Otto Porter Jr.",0,0,0,0,0,0
6,0,1,3,2,6,3,2,2,"30",1,2,10,2,0,2,1038108,"2024-01-09T00:00:00.000Z",14,FALSE,28,409,"G",28,28,"Toronto Raptors","Dennis Schroder",0,12,18,16,8,19.4
0,0,0,0,0,0,0,0,0,"00",0,0,0,0,0,0,1038108,"2024-01-09T00:00:00.000Z",14,FALSE,28,666609,"F",14,14,"Los Angeles Lakers","Rui Hachimura",0,0,0,0,0,0
0,0,0,0,0,0,0,0,0,"00",0,0,0,0,0,0,1038108,"2024-01-09T00:00:00.000Z",14,FALSE,28,1603383,"G",14,14,"Los Angeles Lakers","Gabe Vincent",0,0,0,0,0,0
0,0,0,0,0,0,0,0,0,"00",0,0,0,0,0,0,1038108,"2024-01-09T00:00:00.000Z",14,FALSE,28,436,"G-F",28,28,"Toronto Raptors","Garrett Temple",0,0,0,0,0,0
1,0,1,6,4,10,5,0,0,"24",0,1,14,1,0,0,1038108,"2024-01-09T00:00:00.000Z",14,FALSE,28,3089,"",28,28,"Toronto Raptors","Gary Trent Jr.",0,15,16,15,2,16.7
0,0,0,0,0,0,0,0,0,"00",0,0,0,0,0,0,1038108,"2024-01-09T00:00:00.000Z",14,FALSE,28,56677828,"G",28,28,"Toronto Raptors","Gradey Dick",0,0,0,0,0,0
0,0,0,0,0,0,0,0,0,"00",0,0,0,0,0,0,1038108,"2024-01-09T00:00:00.000Z",14,FALSE,28,56677805,"G",28,28,"Toronto Raptors","Javon Freeman-Liberty",0,0,0,0,0,0
0,0,0,0,0,0,0,0,0,"00",0,0,0,0,0,0,1038108,"2024-01-09T00:00:00.000Z",14,FALSE,28,38017710,"C",28,28,"Toronto Raptors","Christian Koloko",0,0,0,0,0,0
0,0,0,0,0,0,0,0,0,"00",0,0,0,0,0,0,1038108,"2024-01-09T00:00:00.000Z",14,FALSE,28,56677869,"G",28,28,"Toronto Raptors","Markquis Nowell",0,0,0,0,0,0
0,0,0,0,0,0,0,0,0,"00",0,0,0,0,0,0,1038108,"2024-01-09T00:00:00.000Z",14,FALSE,28,373,"C",28,28,"Toronto Raptors","Jakob Poeltl",0,0,0,0,0,0
0,0,0,0,0,0,0,0,0,"00",0,0,0,0,0,0,1038108,"2024-01-09T00:00:00.000Z",14,FALSE,28,666626,"C",14,14,"Los Angeles Lakers","Jaxson Hayes",0,0,0,0,0,0
0,0,0,0,0,0,0,0,0,"00",0,0,0,0,0,0,1038108,"2024-01-09T00:00:00.000Z",14,FALSE,28,56677835,"G",14,14,"Los Angeles Lakers","Jalen Hood-Schifino",0,0,0,0,0,0
0,0,0,0,0,0,0,0,0,"00",0,0,0,0,0,0,1038108,"2024-01-09T00:00:00.000Z",14,FALSE,28,56677836,"F",14,14,"Los Angeles Lakers","Maxwell Lewis",0,0,0,0,0,0
0,0,0,0,0,0,0,0,0,"00",0,0,0,0,0,0,1038108,"2024-01-09T00:00:00.000Z",14,FALSE,28,3547289,"G",25,14,"Los Angeles Lakers","Skylar Mays",0,0,0,0,0,0
0,0,0,0,0,0,0,0,0,"00",0,0,0,0,0,0,1038108,"2024-01-09T00:00:00.000Z",14,FALSE,28,666971,"G-F",20,14,"Los Angeles Lakers","Dylan Windler",0,0,0,0,0,0
0,0,0,0,0,0,0,0,0,"00",0,0,0,0,0,0,1038108,"2024-01-09T00:00:00.000Z",14,FALSE,28,56677738,"C",14,14,"Los Angeles Lakers","Colin Castleton",0,0,0,0,0,0
3,1,4,9,2,10,3,6,4,"32",2,3,12,6,1,0,1038115,"2024-01-10T00:00:00.000Z",5,FALSE,11,89,"G",5,5,"Chicago Bulls","Alex Caruso",2,18,21,15,9,29.7
4,0,4,6,3,19,5,6,6,"43",0,2,19,4,0,1,1038115,"2024-01-10T00:00:00.000Z",5,FALSE,11,125,"G",5,5,"Chicago Bulls","DeMar DeRozan",0,23,27,23,8,28.8
3,1,12,5,0,17,9,0,0,"40",3,4,18,15,0,0,1038115,"2024-01-10T00:00:00.000Z",5,FALSE,11,460,"C",5,5,"Chicago Bulls","Nikola Vucevic",1,33,36,21,18,43.5
7,1,12,8,4,15,8,6,5,"41",1,5,25,13,3,4,1038115,"2024-01-10T00:00:00.000Z",5,FALSE,11,268,"G",5,5,"Chicago Bulls","Zach LaVine",4,38,45,32,20,59.1
8,1,4,11,6,17,9,7,6,"43",0,1,30,4,0,4,1038115,"2024-01-10T00:00:00.000Z",5,FALSE,11,666956,"G",5,5,"Chicago Bulls","Coby White",1,34,42,38,12,45.8
0,0,0,0,0,0,0,0,0,"00",0,0,0,0,0,0,1038115,"2024-01-10T00:00:00.000Z",5,FALSE,11,87,"G",5,5,"Chicago Bulls","Jevon Carter",0,0,0,0,0,0
0,0,0,0,0,0,0,0,0,"00",0,0,0,0,0,0,1038115,"2024-01-10T00:00:00.000Z",5,FALSE,11,110,"F",5,5,"Chicago Bulls","Torrey Craig",0,0,0,0,0,0
3,0,2,4,2,8,3,0,0,"18",2,0,8,4,0,0,1038115,"2024-01-10T00:00:00.000Z",5,FALSE,11,17895983,"G",5,5,"Chicago Bulls","Ayo Dosunmu",0,12,15,11,7,17.3
0,0,0,0,0,2,2,0,0,"13",0,1,4,0,2,3,1038115,"2024-01-10T00:00:00.000Z",5,FALSE,11,137,"C",5,5,"Chicago Bulls","Andre Drummond",2,4,4,4,0,7
0,0,0,0,0,0,0,0,0,"00",0,0,0,0,0,0,1038115,"2024-01-10T00:00:00.000Z",5,FALSE,11,17896116,"G",5,5,"Chicago Bulls","Terry Taylor",0,0,0,0,0,0
1,0,0,1,1,1,1,0,0,"06",0,1,3,0,0,0,1038115,"2024-01-10T00:00:00.000Z",5,FALSE,11,38017719,"F",5,5,"Chicago Bulls","Dalen Terry",0,3,4,4,1,4.5
1,0,0,3,1,6,2,0,0,"29",0,2,5,0,3,2,1038115,"2024-01-10T00:00:00.000Z",5,FALSE,11,3547248,"F",5,5,"Chicago Bulls","Patrick Williams",3,5,6,6,1,13.5
0,0,0,0,0,0,0,0,0,"00",0,0,0,0,0,0,1038115,"2024-01-10T00:00:00.000Z",5,FALSE,11,27,"G",5,5,"Chicago Bulls","Lonzo Ball",0,0,0,0,0,0
0,0,0,0,0,0,0,0,0,"00",0,0,0,0,0,0,1038115,"2024-01-10T00:00:00.000Z",5,FALSE,11,56677874,"F",5,5,"Chicago Bulls","Onuralp Bitim",0,0,0,0,0,0
0,0,0,0,0,0,0,0,0,"00",0,0,0,0,0,0,1038115,"2024-01-10T00:00:00.000Z",5,FALSE,11,NA,NA,NA,5,"Chicago Bulls","NA NA",0,0,0,0,0,0
0,0,0,0,0,0,0,0,0,"00",0,0,0,0,0,0,1038115,"2024-01-10T00:00:00.000Z",5,FALSE,11,56677857,"F",5,5,"Chicago Bulls","Julian Phillips",0,0,0,0,0,0
0,0,0,0,0,0,0,0,0,"00",0,0,0,0,0,0,1038115,"2024-01-10T00:00:00.000Z",5,FALSE,11,56677860,"F",5,5,"Chicago Bulls","Adama Sanogo",0,0,0,0,0,0
0,0,1,2,0,3,1,2,1,"18",1,1,3,2,0,0,1038115,"2024-01-10T00:00:00.000Z",5,FALSE,11,3547301,"F",11,11,"Houston Rockets","Jae'Sean Tate",0,5,5,3,2,5.4
1,1,13,9,4,14,7,0,0,"47",2,3,18,15,0,2,1038115,"2024-01-10T00:00:00.000Z",5,FALSE,11,38017684,"F",11,11,"Houston Rockets","Jabari Smith Jr.",1,33,34,19,16,38.5
5,0,7,3,0,19,11,8,3,"41",2,5,25,9,2,2,1038115,"2024-01-10T00:00:00.000Z",5,FALSE,11,17896062,"F-C",11,11,"Houston Rockets","Alperen Sengun",2,34,39,30,14,47.3
0,0,0,0,0,0,0,0,0,"00",0,0,0,0,0,0,1038115,"2024-01-10T00:00:00.000Z",5,FALSE,11,75,"G-F",11,11,"Houston Rockets","Reggie Bullock",0,0,0,0,0,0
1,0,2,1,0,5,4,1,1,"19",1,1,9,3,0,1,1038115,"2024-01-10T00:00:00.000Z",5,FALSE,11,188,"F",11,11,"Houston Rockets","Jeff Green",0,12,13,10,4,13.1
0,0,1,1,0,3,1,2,2,"11",1,0,4,2,2,2,1038115,"2024-01-10T00:00:00.000Z",5,FALSE,11,213,"G",11,11,"Houston Rockets","Aaron Holiday",2,6,6,4,2,10.4
0,0,0,0,0,0,0,0,0,"00",0,0,0,0,0,0,1038115,"2024-01-10T00:00:00.000Z",5,FALSE,11,19465326,"C",11,11,"Houston Rockets","Jock Landale",0,0,0,0,0,0
0,0,0,0,0,0,0,0,0,"00",0,0,0,0,0,0,1038115,"2024-01-10T00:00:00.000Z",5,FALSE,11,296,"C",11,11,"Houston Rockets","Boban Marjanovic",0,0,0,0,0,0
3,0,2,3,0,7,3,0,0,"14",0,2,6,2,1,2,1038115,"2024-01-10T00:00:00.000Z",5,FALSE,11,56677825,"G-F",11,11,"Houston Rockets","Amen Thompson",1,8,11,9,5,13.9
1,0,4,5,2,12,6,2,2,"33",1,1,16,5,2,1,1038115,"2024-01-10T00:00:00.000Z",5,FALSE,11,56677831,"F",11,11,"Houston Rockets","Cam Whitmore",2,21,22,17,6,28.5
0,0,0,0,0,0,0,0,0,"00",0,0,0,0,0,0,1038115,"2024-01-10T00:00:00.000Z",5,FALSE,11,66,"G-F",11,11,"Houston Rockets","Dillon Brooks",0,0,0,0,0,0
0,0,0,0,0,0,0,0,0,"00",0,0,0,0,0,0,1038115,"2024-01-10T00:00:00.000Z",5,FALSE,11,38017695,"F",11,11,"Houston Rockets","Tari Eason",0,0,0,0,0,0
0,0,0,0,0,0,0,0,0,"00",0,0,0,0,0,0,1038115,"2024-01-10T00:00:00.000Z",5,FALSE,11,3547281,"G-F",11,11,"Houston Rockets","Nate Hinton",0,0,0,0,0,0
0,0,0,0,0,0,0,0,0,"00",0,0,0,0,0,0,1038115,"2024-01-10T00:00:00.000Z",5,FALSE,11,357,"G",11,11,"Houston Rockets","Victor Oladipo",0,0,0,0,0,0
0,0,0,0,0,0,0,0,0,"00",0,0,0,0,0,0,1038115,"2024-01-10T00:00:00.000Z",5,FALSE,11,56677809,"F",11,11,"Houston Rockets","Jermaine Samuels Jr.",0,0,0,0,0,0
0,0,0,0,0,0,0,0,0,"00",0,0,0,0,0,0,1038115,"2024-01-10T00:00:00.000Z",5,FALSE,11,47738533,"G",11,11,"Houston Rockets","Jeenathan Williams",0,0,0,0,0,0
8,0,5,7,2,19,8,1,0,"40",1,2,18,6,1,2,1038115,"2024-01-10T00:00:00.000Z",5,FALSE,11,17895966,"G",11,11,"Houston Rockets","Jalen Green",1,24,32,26,14,38.2
10,3,6,14,3,19,7,4,3,"42",0,3,20,6,1,2,1038115,"2024-01-10T00:00:00.000Z",5,FALSE,11,458,"G",11,11,"Houston Rockets","Fred VanVleet",4,26,36,30,16,52.2
7,2,1,4,2,18,10,7,7,"38",2,3,29,3,1,0,1038118,"2024-01-10T00:00:00.000Z",13,FALSE,28,274,"F",13,13,"LA Clippers","Kawhi Leonard",3,32,39,36,10,52.1
6,1,7,9,5,22,12,0,0,"38",0,4,29,7,2,0,1038118,"2024-01-10T00:00:00.000Z",13,FALSE,28,172,"F",13,13,"LA Clippers","Paul George",3,36,42,35,13,55.4
3,1,6,0,0,8,6,0,0,"31",5,2,12,11,0,2,1038118,"2024-01-10T00:00:00.000Z",13,FALSE,28,493,"C",13,13,"LA Clippers","Ivica Zubac",1,23,26,15,14,30.7
1,0,0,3,3,5,5,0,0,"24",2,1,13,2,0,1,1038118,"2024-01-10T00:00:00.000Z",13,FALSE,28,666743,"G",13,13,"LA Clippers","Terance Mann",0,15,16,14,3,15.9
11,0,5,7,2,13,5,2,2,"34",0,4,14,5,1,3,1038118,"2024-01-10T00:00:00.000Z",13,FALSE,28,192,"G",13,13,"LA Clippers","James Harden",1,19,30,25,16,36.5
0,0,0,0,0,0,0,0,0,"00",0,0,0,0,0,0,1038118,"2024-01-10T00:00:00.000Z",13,FALSE,28,17896022,"G",13,13,"LA Clippers","Brandon Boston Jr.",0,0,0,0,0,0
0,0,0,0,0,0,0,0,0,"00",0,0,0,0,0,0,1038118,"2024-01-10T00:00:00.000Z",13,FALSE,28,56677849,"F",13,13,"LA Clippers","Kobe Brown",0,0,0,0,0,0
1,0,1,2,0,5,3,0,0,"18",0,1,6,1,1,0,1038118,"2024-01-10T00:00:00.000Z",13,FALSE,28,666511,"G",13,13,"LA Clippers","Amir Coffey",1,7,8,7,2,11.7
0,0,0,0,0,0,0,0,0,"00",0,0,0,0,0,0,1038118,"2024-01-10T00:00:00.000Z",13,FALSE,28,17896031,"G",13,13,"LA Clippers","Nah'Shon Hyland",0,0,0,0,0,0
0,0,0,0,0,0,0,0,0,"00",0,0,0,0,0,0,1038118,"2024-01-10T00:00:00.000Z",13,FALSE,28,371,"F-C",13,13,"LA Clippers","Mason Plumlee",0,0,0,0,0,0
4,0,1,5,1,13,8,5,5,"34",0,1,22,1,0,2,1038118,"2024-01-10T00:00:00.000Z",13,FALSE,28,409,"G",28,28,"Toronto Raptors","Dennis Schroder",0,23,27,26,5,27.2
6,0,4,4,2,16,7,9,9,"36",0,1,25,4,1,1,1038118,"2024-01-10T00:00:00.000Z",13,FALSE,28,3547269,"G",20,28,"Toronto Raptors","Immanuel Quickley",1,29,35,31,10,40.8
0,0,1,1,0,3,1,1,1,"11",0,0,3,1,0,0,1038118,"2024-01-10T00:00:00.000Z",13,FALSE,28,58,"F",28,28,"Toronto Raptors","Chris Boucher",0,4,4,3,1,4.2
1,0,3,0,0,2,1,0,0,"13",0,2,2,3,1,0,1038118,"2024-01-10T00:00:00.000Z",13,FALSE,28,666762,"F",28,28,"Toronto Raptors","Jalen McDaniels",1,5,6,3,4,10.1
4,0,4,3,1,8,4,0,0,"18",3,4,9,7,0,3,1038118,"2024-01-10T00:00:00.000Z",13,FALSE,28,2309958,"C-F",15,28,"Toronto Raptors","Jontay Porter",0,16,20,13,11,20.4
1,0,3,8,3,11,4,2,2,"27",0,1,13,3,0,0,1038118,"2024-01-10T00:00:00.000Z",13,FALSE,28,380,"F-G",13,13,"LA Clippers","Norman Powell",0,16,17,14,4,18.1
1,1,2,0,0,2,1,2,2,"16",2,1,4,4,1,1,1038118,"2024-01-10T00:00:00.000Z",13,FALSE,28,439,"F",13,13,"LA Clippers","Daniel Theis",2,8,9,5,5,15.3
0,0,0,0,0,0,0,0,0,"00",0,0,0,0,0,0,1038118,"2024-01-10T00:00:00.000Z",13,FALSE,28,450,"F",13,13,"LA Clippers","PJ Tucker",0,0,0,0,0,0
3,0,0,1,0,9,3,0,0,"14",0,0,6,0,0,0,1038118,"2024-01-10T00:00:00.000Z",13,FALSE,28,472,"G",13,13,"LA Clippers","Russell Westbrook",0,6,9,9,3,10.5
0,0,0,0,0,0,0,0,0,"00",0,0,0,0,0,0,1038118,"2024-01-10T00:00:00.000Z",13,FALSE,28,38017725,"F",13,13,"LA Clippers","Moussa Diabate",0,0,0,0,0,0
0,0,0,0,0,0,0,0,0,"00",0,0,0,0,0,0,1038118,"2024-01-10T00:00:00.000Z",13,FALSE,28,56677856,"G",13,13,"LA Clippers","Jordan Miller",0,0,0,0,0,0
0,0,0,0,0,0,0,0,0,"00",0,0,0,0,0,0,1038118,"2024-01-10T00:00:00.000Z",13,FALSE,28,24417679,"G",13,13,"LA Clippers","Xavier Moon",0,0,0,0,0,0
0,0,0,0,0,0,0,0,0,"00",0,0,0,0,0,0,1038118,"2024-01-10T00:00:00.000Z",13,FALSE,28,17896051,"G",13,13,"LA Clippers","Joshua Primo",0,0,0,0,0,0
4,0,4,6,4,16,10,0,0,"37",1,4,24,5,0,4,1038118,"2024-01-10T00:00:00.000Z",13,FALSE,28,666423,"F-G",20,28,"Toronto Raptors","RJ Barrett",0,29,33,28,9,32
6,2,7,5,1,10,5,3,1,"35",0,1,12,7,0,2,1038118,"2024-01-10T00:00:00.000Z",13,FALSE,28,17896055,"G-F",28,28,"Toronto Raptors","Scottie Barnes",2,19,25,18,13,33.4
3,0,2,1,0,5,4,0,0,"23",2,1,8,4,2,2,1038118,"2024-01-10T00:00:00.000Z",13,FALSE,28,489,"F",28,28,"Toronto Raptors","Thaddeus Young",2,12,15,11,7,21.3
0,0,0,0,0,0,0,0,0,"00",0,0,0,0,0,0,1038118,"2024-01-10T00:00:00.000Z",13,FALSE,28,373,"C",28,28,"Toronto Raptors","Jakob Poeltl",0,0,0,0,0,0
0,0,0,0,0,0,0,0,0,"00",0,0,0,0,0,0,1038118,"2024-01-10T00:00:00.000Z",13,FALSE,28,376,"F",28,28,"Toronto Raptors","Otto Porter Jr.",0,0,0,0,0,0
0,0,0,0,0,0,0,0,0,"00",0,0,0,0,0,0,1038118,"2024-01-10T00:00:00.000Z",13,FALSE,28,416,"F",28,28,"Toronto Raptors","Pascal Siakam",0,0,0,0,0,0
1,0,2,1,1,2,1,0,0,"09",0,2,3,2,0,0,1038118,"2024-01-10T00:00:00.000Z",13,FALSE,28,436,"G-F",28,28,"Toronto Raptors","Garrett Temple",0,5,6,4,3,6.9
2,0,2,4,2,9,5,0,0,"24",1,1,12,3,0,0,1038118,"2024-01-10T00:00:00.000Z",13,FALSE,28,3089,"",28,28,"Toronto Raptors","Gary Trent Jr.",0,15,17,14,5,18.6
0,0,0,0,0,0,0,0,0,"00",0,0,0,0,0,0,1038118,"2024-01-10T00:00:00.000Z",13,FALSE,28,56677828,"G",28,28,"Toronto Raptors","Gradey Dick",0,0,0,0,0,0
0,0,0,0,0,0,0,0,0,"00",0,0,0,0,0,0,1038118,"2024-01-10T00:00:00.000Z",13,FALSE,28,56677805,"G",28,28,"Toronto Raptors","Javon Freeman-Liberty",0,0,0,0,0,0
0,0,0,0,0,0,0,0,0,"00",0,0,0,0,0,0,1038118,"2024-01-10T00:00:00.000Z",13,FALSE,28,38017710,"C",28,28,"Toronto Raptors","Christian Koloko",0,0,0,0,0,0
0,0,0,0,0,0,0,0,0,"00",0,0,0,0,0,0,1038118,"2024-01-10T00:00:00.000Z",13,FALSE,28,56677869,"G",28,28,"Toronto Raptors","Markquis Nowell",0,0,0,0,0,0
2,1,3,7,3,10,5,0,0,"24",1,1,13,4,0,3,1038117,"2024-01-10T00:00:00.000Z",10,FALSE,19,443,"G",10,10,"Golden State Warriors","Klay Thompson",1,17,19,15,6,20.8
4,1,3,1,0,7,4,6,4,"28",0,3,12,3,0,3,1038117,"2024-01-10T00:00:00.000Z",10,FALSE,19,17553979,"F",10,10,"Golden State Warriors","Jonathan Kuminga",1,15,19,16,7,21.6
0,1,5,0,0,3,3,2,1,"19",2,4,7,7,0,0,1038117,"2024-01-10T00:00:00.000Z",10,FALSE,19,282,"F",10,10,"Golden State Warriors","Kevon Looney",1,14,14,7,7,18.4
2,0,6,2,0,6,1,0,0,"25",3,1,2,9,0,2,1038117,"2024-01-10T00:00:00.000Z",10,FALSE,19,56677858,"G",10,10,"Golden State Warriors","Brandin Podziemski",0,11,13,4,11,13.8
6,0,1,8,3,13,4,4,4,"25",0,0,15,1,1,3,1038117,"2024-01-10T00:00:00.000Z",10,FALSE,19,115,"G",10,10,"Golden State Warriors","Stephen Curry",1,16,22,21,7,25.2
0,0,0,0,0,0,0,0,0,"00",0,0,0,0,0,0,1038117,"2024-01-10T00:00:00.000Z",10,FALSE,19,185,"F",10,10,"Golden State Warriors","Draymond Green",0,0,0,0,0,0
0,0,1,8,4,18,8,1,1,"25",1,3,21,2,1,0,1038117,"2024-01-10T00:00:00.000Z",10,FALSE,19,17553992,"G",10,10,"Golden State Warriors","Moses Moody",1,23,23,21,2,26.4
1,0,0,3,1,4,1,0,0,"08",1,0,3,1,0,0,1038117,"2024-01-10T00:00:00.000Z",10,FALSE,19,45658838,"G",10,10,"Golden State Warriors","Lester Quinones",0,4,5,4,2,5.7
2,0,2,3,1,8,2,0,0,"23",0,2,5,2,0,1,1038117,"2024-01-10T00:00:00.000Z",10,FALSE,19,475,"F-G",10,10,"Golden State Warriors","Andrew Wiggins",0,7,9,7,4,9.4
8,1,3,7,2,13,5,2,2,"26",0,0,14,3,2,0,1038117,"2024-01-10T00:00:00.000Z",10,FALSE,19,303,"G",19,19,"New Orleans Pelicans","CJ McCollum",3,17,25,22,11,38.6
4,2,4,7,4,7,4,0,0,"23",1,1,12,5,1,1,1038117,"2024-01-10T00:00:00.000Z",10,FALSE,19,17896024,"F",19,19,"New Orleans Pelicans","Herbert Jones",3,17,21,16,9,32
0,0,0,0,0,0,0,0,0,"00",0,0,0,0,0,0,1038117,"2024-01-10T00:00:00.000Z",10,FALSE,19,17896097,"G",19,19,"New Orleans Pelicans","Jose Alvarado",0,0,0,0,0,0
3,0,3,2,1,4,3,2,1,"23",0,2,8,3,1,1,1038117,"2024-01-10T00:00:00.000Z",10,FALSE,19,38017677,"G",19,19,"New Orleans Pelicans","Dyson Daniels",1,11,14,11,6,18.1
2,0,1,5,4,9,5,0,0,"21",0,1,14,1,0,0,1038117,"2024-01-10T00:00:00.000Z",10,FALSE,19,56677837,"G",19,19,"New Orleans Pelicans","Jordan Hawkins",0,15,17,16,3,18.2
0,0,0,1,0,1,0,0,0,"03",0,0,0,0,0,0,1038117,"2024-01-10T00:00:00.000Z",10,FALSE,19,38017663,"F",19,19,"New Orleans Pelicans","E.J. Liddell",0,0,0,0,0,0
2,0,3,0,0,6,5,2,2,"13",0,1,12,3,1,1,1038117,"2024-01-10T00:00:00.000Z",10,FALSE,19,3547293,"F",19,19,"New Orleans Pelicans","Naji Marshall",1,15,17,14,5,20.6
6,1,1,11,4,13,6,0,0,"24",3,2,16,4,0,0,1038117,"2024-01-10T00:00:00.000Z",10,FALSE,19,18677986,"F",19,19,"New Orleans Pelicans","Trey Murphy III",1,20,26,22,10,32.8
1,1,4,1,1,1,1,4,3,"19",1,0,6,5,2,1,1038117,"2024-01-10T00:00:00.000Z",10,FALSE,19,340,"F",19,19,"New Orleans Pelicans","Larry Nance Jr.",3,11,12,7,6,21.5
0,1,1,0,0,0,0,0,0,"06",0,0,0,1,0,0,1038117,"2024-01-10T00:00:00.000Z",10,FALSE,19,17896021,"F",19,19,"New Orleans Pelicans","Jeremiah Robinson-Earl",1,1,1,0,1,4.2
1,0,1,0,0,3,3,0,0,"08",2,2,6,3,0,1,1038117,"2024-01-10T00:00:00.000Z",10,FALSE,19,491,"C",19,19,"New Orleans Pelicans","Cody Zeller",0,9,10,7,4,10.1
0,0,0,0,0,0,0,0,0,"00",0,0,0,0,0,0,1038117,"2024-01-10T00:00:00.000Z",10,FALSE,19,3547260,"G",19,19,"New Orleans Pelicans","Kira Lewis Jr.",0,0,0,0,0,0
0,0,0,0,0,0,0,0,0,"00",0,0,0,0,0,0,1038117,"2024-01-10T00:00:00.000Z",10,FALSE,19,17896017,"F",19,19,"New Orleans Pelicans","Matt Ryan",0,0,0,0,0,0
0,0,0,0,0,0,0,0,0,"00",0,0,0,0,0,0,1038117,"2024-01-10T00:00:00.000Z",10,FALSE,19,38017726,"G",19,19,"New Orleans Pelicans","Dereon Seabron",0,0,0,0,0,0
1,0,3,3,0,3,0,2,2,"10",0,0,2,3,0,0,1038117,"2024-01-10T00:00:00.000Z",10,FALSE,19,57875092,"F",10,10,"Golden State Warriors","Gui Santos",0,5,6,3,4,7.1
0,0,0,0,0,0,0,0,0,"00",0,0,0,0,0,0,1038117,"2024-01-10T00:00:00.000Z",10,FALSE,19,17896070,"F",10,10,"Golden State Warriors","Usman Garuba",0,0,0,0,0,0
0,0,0,0,0,0,0,0,0,"00",0,0,0,0,0,0,1038117,"2024-01-10T00:00:00.000Z",10,FALSE,19,367,"G",10,10,"Golden State Warriors","Chris Paul",0,0,0,0,0,0
0,0,0,0,0,0,0,0,0,"00",0,0,0,0,0,0,1038117,"2024-01-10T00:00:00.000Z",10,FALSE,19,2189,"",10,10,"Golden State Warriors","Gary Payton II",0,0,0,0,0,0
0,0,0,0,0,0,0,0,0,"00",0,0,0,0,0,0,1038117,"2024-01-10T00:00:00.000Z",10,FALSE,19,398,"G",10,10,"Golden State Warriors","Jerome Robinson",0,0,0,0,0,0
1,0,4,3,1,12,5,2,2,"23",1,4,13,5,1,2,1038117,"2024-01-10T00:00:00.000Z",10,FALSE,19,227,"F",19,19,"New Orleans Pelicans","Brandon Ingram",1,18,19,14,6,21.5
7,0,4,0,0,12,8,5,3,"30",1,2,19,5,1,4,1038117,"2024-01-10T00:00:00.000Z",10,FALSE,19,666969,"F",19,19,"New Orleans Pelicans","Zion Williamson",1,24,31,26,12,34.5
2,1,5,3,2,13,9,2,1,"21",4,4,21,9,2,0,1038117,"2024-01-10T00:00:00.000Z",10,FALSE,19,455,"C",19,19,"New Orleans Pelicans","Jonas Valanciunas",3,30,32,23,11,43.8
1,1,2,0,0,11,9,1,1,"22",3,1,19,5,1,1,1038117,"2024-01-10T00:00:00.000Z",10,FALSE,19,56677799,"F",10,10,"Golden State Warriors","Trayce Jackson-Davis",2,24,25,20,6,31.5
3,0,2,2,0,3,1,2,2,"14",1,2,4,3,1,2,1038117,"2024-01-10T00:00:00.000Z",10,FALSE,19,407,"F",10,10,"Golden State Warriors","Dario Saric",1,7,10,7,6,13.1
2,0,1,2,0,3,1,0,0,"17",2,2,2,3,0,2,1038117,"2024-01-10T00:00:00.000Z",10,FALSE,19,251,"G",10,10,"Golden State Warriors","Cory Joseph",0,5,7,4,5,6.6
2,0,0,4,1,5,1,0,0,"21",0,0,3,0,0,3,1038116,"2024-01-10T00:00:00.000Z",29,FALSE,8,38017739,"F",29,29,"Utah Jazz","Simone Fontecchio",0,3,5,5,2,3
2,1,10,5,2,13,6,12,12,"33",2,2,26,12,0,0,1038116,"2024-01-10T00:00:00.000Z",29,FALSE,8,297,"F",29,29,"Utah Jazz","Lauri Markkanen",1,38,40,28,14,46.4
3,0,6,4,2,10,6,2,1,"24",0,2,15,6,1,1,1038116,"2024-01-10T00:00:00.000Z",29,FALSE,8,101,"F-C",29,29,"Utah Jazz","John Collins",1,21,24,18,9,28.7
4,1,1,4,2,14,8,4,4,"21",1,3,22,2,1,1,1038116,"2024-01-10T00:00:00.000Z",29,FALSE,8,413,"G",29,29,"Utah Jazz","Collin Sexton",2,24,28,26,6,35.4
3,1,3,1,1,2,2,0,0,"26",1,4,5,4,4,2,1038116,"2024-01-10T00:00:00.000Z",29,FALSE,8,139,"G",29,29,"Utah Jazz","Kris Dunn",5,9,12,8,7,27.3
1,2,3,1,0,2,0,0,0,"14",1,1,0,4,1,0,1038116,"2024-01-10T00:00:00.000Z",29,FALSE,8,38017620,"G",29,29,"Utah Jazz","Ochai Agbaji",3,4,5,1,5,15.3
9,0,2,8,3,19,12,1,0,"33",0,1,27,2,0,3,1038116,"2024-01-10T00:00:00.000Z",29,FALSE,8,100,"G",29,29,"Utah Jazz","Jordan Clarkson",0,29,38,36,11,39.9
3,0,1,4,1,7,2,2,1,"22",0,0,6,1,1,1,1038116,"2024-01-10T00:00:00.000Z",29,FALSE,8,56677834,"G",29,29,"Utah Jazz","Keyonte George",1,7,10,9,4,13.7
0,1,0,1,0,1,0,0,0,"03",0,0,0,0,0,1,1038116,"2024-01-10T00:00:00.000Z",29,FALSE,8,56677824,"F",29,29,"Utah Jazz","Taylor Hendricks",1,0,0,0,0,2
0,0,0,0,0,0,0,0,0,"00",0,0,0,0,0,0,1038116,"2024-01-10T00:00:00.000Z",29,FALSE,8,666650,"G",29,29,"Utah Jazz","Talen Horton-Tucker",0,0,0,0,0,0
1,0,1,1,1,3,2,4,3,"06",0,0,8,1,0,0,1038116,"2024-01-10T00:00:00.000Z",29,FALSE,8,38017727,"G",8,8,"Denver Nuggets","Collin Gillespie",0,9,10,9,2,10.7
1,0,0,3,1,3,1,0,0,"12",0,2,3,0,2,0,1038116,"2024-01-10T00:00:00.000Z",29,FALSE,8,215,"F-G",8,8,"Denver Nuggets","Justin Holiday",2,3,4,4,1,10.5
1,1,2,0,0,4,4,0,0,"15",2,4,8,4,2,1,1038116,"2024-01-10T00:00:00.000Z",29,FALSE,8,38017705,"C",29,29,"Utah Jazz","Walker Kessler",3,12,13,9,5,22.3
5,1,3,1,1,5,4,0,0,"19",0,2,9,3,2,1,1038116,"2024-01-10T00:00:00.000Z",29,FALSE,8,358,"F",29,29,"Utah Jazz","Kelly Olynyk",3,12,17,14,8,28.1
1,0,0,0,0,0,0,2,1,"03",0,0,1,0,0,0,1038116,"2024-01-10T00:00:00.000Z",29,FALSE,8,666881,"F",29,29,"Utah Jazz","Luka Samanic",0,1,2,2,1,2.5
0,0,0,0,0,0,0,0,0,"03",0,0,0,0,0,0,1038116,"2024-01-10T00:00:00.000Z",29,FALSE,8,56677842,"F",29,29,"Utah Jazz","Brice Sensabaugh",0,0,0,0,0,0
0,0,2,0,0,1,1,0,0,"03",0,0,2,2,0,2,1038116,"2024-01-10T00:00:00.000Z",29,FALSE,8,11891374,"C",29,29,"Utah Jazz","Omer Yurtseven",0,4,4,2,2,2.4
0,0,0,0,0,0,0,0,0,"00",0,0,0,0,0,0,1038116,"2024-01-10T00:00:00.000Z",29,FALSE,8,38017630,"G",29,29,"Utah Jazz","Johnny Juzang",0,0,0,0,0,0
0,0,0,0,0,0,0,0,0,"00",0,0,0,0,0,0,1038116,"2024-01-10T00:00:00.000Z",29,FALSE,8,19465584,"F",29,29,"Utah Jazz","Micah Potter",0,0,0,0,0,0
0,0,0,0,0,0,0,0,0,"00",0,0,0,0,0,0,1038116,"2024-01-10T00:00:00.000Z",29,FALSE,8,17896042,"G",13,29,"Utah Jazz","Jason Preston",0,0,0,0,0,0
1,0,3,3,1,9,2,0,0,"24",1,2,5,4,0,1,1038116,"2024-01-10T00:00:00.000Z",29,FALSE,8,375,"F",8,8,"Denver Nuggets","Michael Porter Jr.",0,9,10,6,5,10.3
4,0,3,2,2,6,5,0,0,"29",2,4,12,5,1,2,1038116,"2024-01-10T00:00:00.000Z",29,FALSE,8,177,"F",8,8,"Denver Nuggets","Aaron Gordon",1,17,21,16,9,25
6,0,10,1,1,9,8,12,10,"30",1,3,27,11,1,6,1038116,"2024-01-10T00:00:00.000Z",29,FALSE,8,246,"C",8,8,"Denver Nuggets","Nikola Jokic",1,38,44,33,17,46.2
1,0,0,1,0,2,1,0,0,"06",0,1,2,0,0,1,1038116,"2024-01-10T00:00:00.000Z",29,FALSE,8,17896103,"F-C",8,8,"Denver Nuggets","Jay Huff",0,2,3,3,1,2.5
2,0,0,4,1,7,2,0,0,"20",0,2,5,0,0,0,1038116,"2024-01-10T00:00:00.000Z",29,FALSE,8,236,"G",8,8,"Denver Nuggets","Reggie Jackson",0,5,7,7,2,8
0,1,3,0,0,3,1,4,3,"08",2,0,5,5,0,0,1038116,"2024-01-10T00:00:00.000Z",29,FALSE,8,250,"C",8,8,"Denver Nuggets","DeAndre Jordan",1,10,10,5,5,14
1,0,0,0,0,1,1,0,0,"06",2,0,2,2,0,0,1038116,"2024-01-10T00:00:00.000Z",29,FALSE,8,17896007,"G",8,8,"Denver Nuggets","Braxton Key",0,4,5,3,3,5.9
1,0,0,1,1,2,1,2,2,"06",0,2,5,0,1,0,1038116,"2024-01-10T00:00:00.000Z",29,FALSE,8,3547268,"F-C",8,8,"Denver Nuggets","Zeke Nnaji",1,5,6,6,1,9.5
0,0,1,5,1,8,1,0,0,"17",1,1,3,2,0,0,1038116,"2024-01-10T00:00:00.000Z",29,FALSE,8,38017721,"G",8,8,"Denver Nuggets","Peyton Watson",0,5,5,3,2,5.4
0,0,0,0,0,0,0,0,0,"00",0,0,0,0,0,0,1038116,"2024-01-10T00:00:00.000Z",29,FALSE,8,666489,"F",8,8,"Denver Nuggets","Vlatko Cancar",0,0,0,0,0,0
0,0,0,0,0,0,0,0,0,"00",0,0,0,0,0,0,1038116,"2024-01-10T00:00:00.000Z",29,FALSE,8,56677582,"G",8,8,"Denver Nuggets","Jalen Pickett",0,0,0,0,0,0
0,0,0,0,0,0,0,0,0,"00",0,0,0,0,0,0,1038116,"2024-01-10T00:00:00.000Z",29,FALSE,8,56677776,"G",8,8,"Denver Nuggets","Julian Strawther",0,0,0,0,0,0
0,0,0,0,0,0,0,0,0,"00",0,0,0,0,0,0,1038116,"2024-01-10T00:00:00.000Z",29,FALSE,8,56677871,"F",8,8,"Denver Nuggets","Hunter Tyson",0,0,0,0,0,0
1,1,1,5,2,9,4,2,2,"28",0,2,12,1,4,1,1038116,"2024-01-10T00:00:00.000Z",29,FALSE,8,81,"G",8,8,"Denver Nuggets","Kentavious Caldwell-Pope",5,13,14,13,2,28.7
6,2,1,5,1,15,6,4,4,"31",0,3,17,1,1,4,1038116,"2024-01-10T00:00:00.000Z",29,FALSE,8,335,"G",8,8,"Denver Nuggets","Jamal Murray",3,18,24,23,7,32.2
1,0,3,2,1,4,2,0,0,"17",0,1,5,3,1,1,1038116,"2024-01-10T00:00:00.000Z",29,FALSE,8,38017709,"G",8,8,"Denver Nuggets","Christian Braun",1,8,9,6,4,12.1
3,1,10,7,4,16,9,13,13,"43",1,1,35,11,2,2,1038109,"2024-01-10T00:00:00.000Z",2,FALSE,18,70,"G",2,2,"Boston Celtics","Jaylen Brown",3,46,49,38,14,59.7
2,0,4,11,6,26,13,14,13,"42",0,3,45,4,1,1,1038109,"2024-01-10T00:00:00.000Z",2,FALSE,18,434,"F",2,2,"Boston Celtics","Jayson Tatum",1,49,51,47,6,54.8
5,0,7,6,3,8,3,0,0,"38",1,3,9,8,0,1,1038109,"2024-01-10T00:00:00.000Z",2,FALSE,18,219,"C-F",2,2,"Boston Celtics","Al Horford",0,17,22,14,13,25.1
6,0,4,5,1,11,3,2,2,"44",2,5,9,6,0,2,1038109,"2024-01-10T00:00:00.000Z",2,FALSE,18,473,"G",2,2,"Boston Celtics","Derrick White",0,15,21,15,12,23.2
4,1,4,10,2,15,5,0,0,"40",1,3,12,5,2,2,1038109,"2024-01-10T00:00:00.000Z",2,FALSE,18,214,"G",2,2,"Boston Celtics","Jrue Holiday",3,17,21,16,9,31
0,0,0,0,0,0,0,0,0,"00",0,0,0,0,0,0,1038109,"2024-01-10T00:00:00.000Z",2,FALSE,18,17896094,"G",2,2,"Boston Celtics","Dalano Banton",0,0,0,0,0,0
0,0,2,0,0,0,0,0,0,"06",0,1,0,2,0,0,1038109,"2024-01-10T00:00:00.000Z",2,FALSE,18,666468,"F",2,2,"Boston Celtics","Oshae Brissett",0,2,2,0,2,2.4
0,1,4,5,2,6,2,0,0,"18",0,2,6,4,0,0,1038109,"2024-01-10T00:00:00.000Z",2,FALSE,18,17896060,"F",2,2,"Boston Celtics","Sam Hauser",1,10,10,6,4,13.8
0,1,3,0,0,4,3,2,2,"18",2,1,8,5,0,0,1038109,"2024-01-10T00:00:00.000Z",2,FALSE,18,261,"F-C",2,2,"Boston Celtics","Luke Kornet",1,13,13,8,5,17
0,0,0,0,0,0,0,0,0,"00",0,0,0,0,0,0,1038109,"2024-01-10T00:00:00.000Z",2,FALSE,18,338,"G",2,2,"Boston Celtics","Svi Mykhailiuk",0,0,0,0,0,0
1,0,1,3,1,4,1,0,0,"16",0,0,3,1,0,0,1038109,"2024-01-10T00:00:00.000Z",2,FALSE,18,3547276,"G",2,2,"Boston Celtics","Payton Pritchard",0,4,5,4,2,5.7
0,0,0,0,0,0,0,0,0,"00",0,0,0,0,0,0,1038109,"2024-01-10T00:00:00.000Z",2,FALSE,18,17553967,"C",2,2,"Boston Celtics","Neemias Queta",0,0,0,0,0,0
0,0,0,0,0,0,0,0,0,"00",0,0,0,0,0,0,1038109,"2024-01-10T00:00:00.000Z",2,FALSE,18,3547279,"F",2,2,"Boston Celtics","Lamar Stevens",0,0,0,0,0,0
0,0,0,0,0,0,0,0,0,"00",0,0,0,0,0,0,1038109,"2024-01-10T00:00:00.000Z",2,FALSE,18,38017707,"G",2,2,"Boston Celtics","JD Davison",0,0,0,0,0,0
0,0,0,0,0,0,0,0,0,"00",0,0,0,0,0,0,1038109,"2024-01-10T00:00:00.000Z",2,FALSE,18,NA,NA,NA,2,"Boston Celtics","NA NA",0,0,0,0,0,0
0,0,0,0,0,0,0,0,0,"00",0,0,0,0,0,0,1038109,"2024-01-10T00:00:00.000Z",2,FALSE,18,378,"F-C",2,2,"Boston Celtics","Kristaps Porzingis",0,0,0,0,0,0
0,0,0,0,0,0,0,0,0,"00",0,0,0,0,0,0,1038109,"2024-01-10T00:00:00.000Z",2,FALSE,18,56677864,"G",2,2,"Boston Celtics","Jordan Walsh",0,0,0,0,0,0
1,0,1,4,1,8,2,0,0,"24",0,6,5,1,0,1,1038109,"2024-01-10T00:00:00.000Z",2,FALSE,18,3547259,"F",18,18,"Minnesota Timberwolves","Jaden McDaniels",0,6,7,6,2,6.7
5,1,6,0,0,12,7,4,3,"39",2,5,17,8,1,0,1038109,"2024-01-10T00:00:00.000Z",2,FALSE,18,12,"F",18,18,"Minnesota Timberwolves","Kyle Anderson",2,25,30,22,13,40.1
6,0,12,7,2,17,8,7,7,"44",1,6,25,13,2,1,1038109,"2024-01-10T00:00:00.000Z",2,FALSE,18,447,"C",18,18,"Minnesota Timberwolves","Karl-Anthony Towns",2,38,44,31,19,54.6
3,0,6,6,3,25,11,4,4,"46",0,1,29,6,0,5,1038109,"2024-01-10T00:00:00.000Z",2,FALSE,18,3547238,"G",18,18,"Minnesota Timberwolves","Anthony Edwards",0,35,38,32,9,35.7
3,1,2,5,3,8,5,2,2,"40",2,4,15,4,1,1,1038109,"2024-01-10T00:00:00.000Z",2,FALSE,18,666400,"G",18,18,"Minnesota Timberwolves","Nickeil Alexander-Walker",2,19,22,18,7,29.3
1,0,1,2,0,3,1,0,0,"08",0,0,2,1,0,0,1038109,"2024-01-10T00:00:00.000Z",2,FALSE,18,68,"F",18,18,"Minnesota Timberwolves","Troy Brown Jr.",0,3,4,3,2,4.7
0,0,0,0,0,0,0,0,0,"00",0,0,0,0,0,0,1038109,"2024-01-10T00:00:00.000Z",2,FALSE,18,17896056,"C",18,18,"Minnesota Timberwolves","Luka Garza",0,0,0,0,0,0
0,0,2,3,2,5,2,0,0,"17",0,1,6,2,0,0,1038109,"2024-01-10T00:00:00.000Z",2,FALSE,18,666767,"G",18,18,"Minnesota Timberwolves","Jordan McLaughlin",0,8,8,6,2,8.4
0,1,2,0,0,2,1,1,0,"09",0,0,2,2,0,0,1038109,"2024-01-10T00:00:00.000Z",2,FALSE,18,320,"G",18,18,"Minnesota Timberwolves","Shake Milton",1,4,4,2,2,7.4
0,0,0,0,0,0,0,0,0,"00",0,0,0,0,0,0,1038109,"2024-01-10T00:00:00.000Z",2,FALSE,18,38017715,"F",18,18,"Minnesota Timberwolves","Josh Minott",0,0,0,0,0,0
0,0,0,0,0,0,0,0,0,"00",0,0,0,0,0,0,1038109,"2024-01-10T00:00:00.000Z",2,FALSE,18,38017700,"G",18,18,"Minnesota Timberwolves","Wendell Moore Jr.",0,0,0,0,0,0
0,0,0,0,0,0,0,0,0,"00",0,0,0,0,0,0,1038109,"2024-01-10T00:00:00.000Z",2,FALSE,18,17895968,"F",18,18,"Minnesota Timberwolves","Daishen Nix",0,0,0,0,0,0
3,3,7,7,3,15,7,2,2,"38",3,4,19,10,0,1,1038109,"2024-01-10T00:00:00.000Z",2,FALSE,18,667378,"F-C",18,18,"Minnesota Timberwolves","Naz Reid",3,29,32,22,13,43.5
0,0,0,0,0,0,0,0,0,"00",0,0,0,0,0,0,1038109,"2024-01-10T00:00:00.000Z",2,FALSE,18,56677851,"G",18,18,"Minnesota Timberwolves","Jaylen Clark",0,0,0,0,0,0
0,0,0,0,0,0,0,0,0,"00",0,0,0,0,0,0,1038109,"2024-01-10T00:00:00.000Z",2,FALSE,18,104,"G",18,18,"Minnesota Timberwolves","Mike Conley",0,0,0,0,0,0
0,0,0,0,0,0,0,0,0,"00",0,0,0,0,0,0,1038109,"2024-01-10T00:00:00.000Z",2,FALSE,18,56677782,"F",18,18,"Minnesota Timberwolves","Leonard Miller",0,0,0,0,0,0
0,0,0,0,0,0,0,0,0,"00",0,0,0,0,0,0,1038109,"2024-01-10T00:00:00.000Z",2,FALSE,18,176,"C",18,18,"Minnesota Timberwolves","Rudy Gobert",0,0,0,0,0,0
1,0,2,2,1,2,1,2,1,"10",0,0,4,2,0,1,1038110,"2024-01-10T00:00:00.000Z",4,FALSE,26,38017708,"G",4,4,"Charlotte Hornets","Bryce McGowens",0,6,7,5,3,6.9
6,0,6,8,4,21,10,0,0,"34",1,1,24,7,1,3,1038110,"2024-01-10T00:00:00.000Z",4,FALSE,26,62,"F",4,4,"Charlotte Hornets","Miles Bridges",1,31,37,30,13,41.4
3,1,5,0,0,5,3,2,2,"26",4,3,8,9,0,1,1038110,"2024-01-10T00:00:00.000Z",4,FALSE,26,3547282,"C",4,4,"Charlotte Hornets","Nick Richards",1,17,20,11,12,25.3
2,0,1,6,4,10,5,2,1,"28",0,1,15,1,0,0,1038110,"2024-01-10T00:00:00.000Z",4,FALSE,26,56677823,"F",4,4,"Charlotte Hornets","Brandon Miller",0,16,18,17,3,19.2
2,1,4,6,3,14,6,8,7,"32",0,1,22,4,1,0,1038110,"2024-01-10T00:00:00.000Z",4,FALSE,26,403,"G",4,4,"Charlotte Hornets","Terry Rozier",2,26,28,24,6,35.8
0,0,0,0,0,0,0,0,0,"06",0,0,0,0,0,0,1038110,"2024-01-10T00:00:00.000Z",4,FALSE,26,56677866,"F",4,4,"Charlotte Hornets","Leaky Black",0,0,0,0,0,0
1,0,0,6,2,8,3,0,0,"20",0,0,8,0,0,0,1038110,"2024-01-10T00:00:00.000Z",4,FALSE,26,17896037,"G",4,4,"Charlotte Hornets","James Bouknight",0,8,9,9,1,9.5
1,1,3,0,0,2,1,0,0,"22",1,4,2,4,0,1,1038110,"2024-01-10T00:00:00.000Z",4,FALSE,26,NA,NA,NA,4,"Charlotte Hornets","NA NA",1,6,7,3,5,10.3
0,0,0,0,0,0,0,0,0,"00",0,0,0,0,0,0,1038110,"2024-01-10T00:00:00.000Z",4,FALSE,26,347,"G",4,4,"Charlotte Hornets","Frank Ntilikina",0,0,0,0,0,0
0,0,1,0,0,3,1,0,0,"16",0,1,2,1,0,0,1038110,"2024-01-10T00:00:00.000Z",4,FALSE,26,422,"G",4,4,"Charlotte Hornets","Ish Smith",0,3,3,2,1,3.2
1,0,3,8,2,15,4,2,1,"25",0,3,11,3,0,2,1038110,"2024-01-10T00:00:00.000Z",4,FALSE,26,56677846,"G",4,4,"Charlotte Hornets","Nick Smith Jr.",0,14,15,12,4,14.1
0,0,3,2,0,7,1,0,0,"21",2,2,2,5,0,0,1038110,"2024-01-10T00:00:00.000Z",4,FALSE,26,18678001,"F",4,4,"Charlotte Hornets","JT Thor",0,7,7,2,5,8
0,0,0,0,0,0,0,0,0,"00",0,0,0,0,0,0,1038110,"2024-01-10T00:00:00.000Z",4,FALSE,26,56677848,"G",4,4,"Charlotte Hornets","Amari Bailey",0,0,0,0,0,0
0,0,0,0,0,0,0,0,0,"00",0,0,0,0,0,0,1038110,"2024-01-10T00:00:00.000Z",4,FALSE,26,3547239,"G",4,4,"Charlotte Hornets","LaMelo Ball",0,0,0,0,0,0
0,0,0,0,0,0,0,0,0,"00",0,0,0,0,0,0,1038110,"2024-01-10T00:00:00.000Z",4,FALSE,26,204,"F",4,4,"Charlotte Hornets","Gordon Hayward",0,0,0,0,0,0
0,0,0,0,0,0,0,0,0,"00",0,0,0,0,0,0,1038110,"2024-01-10T00:00:00.000Z",4,FALSE,26,666748,"F",4,4,"Charlotte Hornets","Cody Martin",0,0,0,0,0,0
0,0,0,0,0,0,0,0,0,"00",0,0,0,0,0,0,1038110,"2024-01-10T00:00:00.000Z",4,FALSE,26,666950,"F",4,4,"Charlotte Hornets","P.J. Washington",0,0,0,0,0,0
0,0,0,0,0,0,0,0,0,"00",0,0,0,0,0,0,1038110,"2024-01-10T00:00:00.000Z",4,FALSE,26,38017698,"C",4,4,"Charlotte Hornets","Mark Williams",0,0,0,0,0,0
3,1,6,7,3,18,11,0,0,"32",0,2,25,6,0,0,1038110,"2024-01-10T00:00:00.000Z",4,FALSE,26,38017688,"F",26,26,"Sacramento Kings","Keegan Murray",1,31,34,28,9,39.7
1,0,1,4,2,4,2,0,0,"22",1,0,6,2,0,1,1038110,"2024-01-10T00:00:00.000Z",4,FALSE,26,30,"F",26,26,"Sacramento Kings","Harrison Barnes",0,8,9,7,3,8.9
7,1,9,2,1,13,9,6,5,"28",1,2,24,10,0,2,1038110,"2024-01-10T00:00:00.000Z",4,FALSE,26,406,"F",26,26,"Sacramento Kings","Domantas Sabonis",1,34,41,31,17,47.5
0,0,0,0,0,0,0,0,0,"01",0,1,0,0,0,0,1038110,"2024-01-10T00:00:00.000Z",4,FALSE,26,221,"G",26,26,"Sacramento Kings","Kevin Huerter",0,0,0,0,0,0
3,1,1,7,3,14,8,2,0,"28",0,0,19,1,1,1,1038110,"2024-01-10T00:00:00.000Z",4,FALSE,26,161,"G",26,26,"Sacramento Kings","De'Aaron Fox",2,20,23,22,4,29.7
2,0,1,0,0,2,0,0,0,"14",1,2,0,2,0,0,1038110,"2024-01-10T00:00:00.000Z",4,FALSE,26,17896030,"G",26,26,"Sacramento Kings","Chris Duarte",0,2,4,2,4,5.4
1,1,1,3,1,3,1,0,0,"09",0,2,3,1,0,0,1038110,"2024-01-10T00:00:00.000Z",4,FALSE,26,38017714,"G",26,26,"Sacramento Kings","Keon Ellis",1,4,5,4,2,8.7
0,0,0,2,0,2,0,0,0,"14",1,0,0,1,0,0,1038110,"2024-01-10T00:00:00.000Z",4,FALSE,26,56677845,"G",26,26,"Sacramento Kings","Colby Jones",0,1,1,0,1,1.2
1,1,6,0,0,6,4,0,0,"15",4,2,8,10,1,1,1038110,"2024-01-10T00:00:00.000Z",4,FALSE,26,273,"C",26,26,"Sacramento Kings","Alex Len",2,18,19,9,11,26.5
2,0,4,4,2,4,2,4,2,"21",1,1,8,5,0,1,1038110,"2024-01-10T00:00:00.000Z",4,FALSE,26,290,"F",26,26,"Sacramento Kings","Trey Lyles",0,13,15,10,7,16
0,0,3,0,0,5,2,4,4,"05",4,0,8,7,0,2,1038110,"2024-01-10T00:00:00.000Z",4,FALSE,26,306,"C",26,26,"Sacramento Kings","JaVale McGee",0,15,15,8,7,14.4
0,0,1,0,0,1,0,0,0,"04",0,1,0,1,0,0,1038110,"2024-01-10T00:00:00.000Z",4,FALSE,26,17553994,"G",26,26,"Sacramento Kings","Davion Mitchell",0,1,1,0,1,1.2
4,2,4,5,1,13,6,7,7,"30",0,0,20,4,0,1,1038110,"2024-01-10T00:00:00.000Z",4,FALSE,26,324,"G",26,26,"Sacramento Kings","Malik Monk",2,24,28,24,8,35.8
0,1,2,1,0,4,1,0,0,"17",1,2,2,3,0,0,1038110,"2024-01-10T00:00:00.000Z",4,FALSE,26,666925,"F",29,26,"Sacramento Kings","Juan Toscano-Anderson",1,5,5,2,3,8.6
0,0,0,0,0,0,0,0,0,"00",0,0,0,0,0,0,1038110,"2024-01-10T00:00:00.000Z",4,FALSE,26,4197162,"F",26,26,"Sacramento Kings","Aleksandar Vezenkov",0,0,0,0,0,0
0,0,0,0,0,0,0,0,0,"00",0,0,0,0,0,0,1038110,"2024-01-10T00:00:00.000Z",4,FALSE,26,17896044,"F",26,26,"Sacramento Kings","Kessler Edwards",0,0,0,0,0,0
0,0,0,0,0,0,0,0,0,"00",0,0,0,0,0,0,1038110,"2024-01-10T00:00:00.000Z",4,FALSE,26,17895990,"G",26,26,"Sacramento Kings","Jordan Ford",0,0,0,0,0,0
0,0,0,0,0,0,0,0,0,"00",0,0,0,0,0,0,1038110,"2024-01-10T00:00:00.000Z",4,FALSE,26,56677862,"F",26,26,"Sacramento Kings","Jalen Slawson",0,0,0,0,0,0
0,0,2,3,2,3,2,0,0,"17",2,1,6,4,1,0,1038111,"2024-01-10T00:00:00.000Z",9,FALSE,27,17896071,"F",9,9,"Detroit Pistons","Isaiah Livers",1,10,10,6,4,13.8
2,0,2,5,3,13,8,0,0,"33",0,1,19,2,1,4,1038111,"2024-01-10T00:00:00.000Z",9,FALSE,27,54,"F",9,9,"Detroit Pistons","Bojan Bogdanovic",1,21,23,21,4,23.4
2,0,10,0,0,16,10,1,1,"30",2,4,21,12,0,1,1038111,"2024-01-10T00:00:00.000Z",9,FALSE,27,38017694,"C",9,9,"Detroit Pistons","Jalen Duren",0,33,35,23,14,37.4
5,2,3,10,2,18,7,5,3,"30",0,0,19,3,2,1,1038111,"2024-01-10T00:00:00.000Z",9,FALSE,27,38017682,"G",9,9,"Detroit Pistons","Jaden Ivey",4,22,27,24,8,41.1
12,0,3,0,0,8,2,0,0,"32",1,1,4,4,0,1,1038111,"2024-01-10T00:00:00.000Z",9,FALSE,27,3547241,"G",9,9,"Detroit Pistons","Killian Hayes",0,8,20,16,16,25.8
0,0,0,0,0,0,0,0,0,"00",0,0,0,0,0,0,1038111,"2024-01-10T00:00:00.000Z",9,FALSE,27,24,"F",9,9,"Detroit Pistons","Marvin Bagley III",0,0,0,0,0,0
2,0,2,5,1,13,5,4,4,"20",0,1,15,2,0,1,1038111,"2024-01-10T00:00:00.000Z",9,FALSE,27,77,"G",9,9,"Detroit Pistons","Alec Burks",0,17,19,17,4,19.4
0,0,1,0,0,0,0,0,0,"06",0,1,0,1,0,0,1038111,"2024-01-10T00:00:00.000Z",9,FALSE,27,197,"F-G",9,9,"Detroit Pistons","Joe Harris",0,1,1,0,1,1.2
0,0,1,5,2,11,5,0,0,"24",3,2,12,4,0,0,1038111,"2024-01-10T00:00:00.000Z",9,FALSE,27,259,"F",9,9,"Detroit Pistons","Kevin Knox",0,16,16,12,4,16.8
5,0,1,1,0,7,3,0,0,"16",1,2,6,2,0,1,1038111,"2024-01-10T00:00:00.000Z",9,FALSE,27,56677792,"G",9,9,"Detroit Pistons","Marcus Sasser",0,8,13,11,7,14.9
0,0,0,0,0,0,0,0,0,"00",0,0,0,0,0,0,1038111,"2024-01-10T00:00:00.000Z",9,FALSE,27,3547267,"F-C",9,9,"Detroit Pistons","Isaiah Stewart",0,0,0,0,0,0
1,1,6,3,0,6,1,1,1,"15",0,4,3,6,0,1,1038111,"2024-01-10T00:00:00.000Z",9,FALSE,27,56677826,"G-F",9,9,"Detroit Pistons","Ausar Thompson",1,9,10,4,7,13.7
3,0,3,0,0,1,1,2,1,"17",0,2,3,3,0,0,1038111,"2024-01-10T00:00:00.000Z",9,FALSE,27,3547240,"C",9,9,"Detroit Pistons","James Wiseman",0,6,9,6,6,11.1
0,0,0,0,0,0,0,0,0,"00",0,0,0,0,0,0,1038111,"2024-01-10T00:00:00.000Z",9,FALSE,27,56677729,"G",9,9,"Detroit Pistons","Malcolm Cazalon",0,0,0,0,0,0
0,0,0,0,0,0,0,0,0,"00",0,0,0,0,0,0,1038111,"2024-01-10T00:00:00.000Z",9,FALSE,27,17896075,"G-F",9,9,"Detroit Pistons","Cade Cunningham",0,0,0,0,0,0
0,0,0,0,0,0,0,0,0,"00",0,0,0,0,0,0,1038111,"2024-01-10T00:00:00.000Z",9,FALSE,27,330,"G",9,9,"Detroit Pistons","Monte Morris",0,0,0,0,0,0
0,0,0,0,0,0,0,0,0,"00",0,0,0,0,0,0,1038111,"2024-01-10T00:00:00.000Z",9,FALSE,27,42097199,"G",9,9,"Detroit Pistons","Jared Rhoden",0,0,0,0,0,0
0,0,0,0,0,0,0,0,0,"00",0,0,0,0,0,0,1038111,"2024-01-10T00:00:00.000Z",9,FALSE,27,44477024,"G",9,9,"Detroit Pistons","Stanley Umude",0,0,0,0,0,0
2,0,3,2,1,15,7,0,0,"28",1,1,15,4,0,1,1038111,"2024-01-10T00:00:00.000Z",9,FALSE,27,38017699,"F",27,27,"San Antonio Spurs","Jeremy Sochan",0,19,21,17,6,21.8
1,0,3,2,0,3,1,0,0,"21",1,2,2,4,2,0,1038111,"2024-01-10T00:00:00.000Z",9,FALSE,27,38017649,"F",27,27,"San Antonio Spurs","Julian Champagnie",2,6,7,3,5,14.3
0,0,2,5,4,6,5,0,0,"15",0,0,14,2,0,0,1038111,"2024-01-10T00:00:00.000Z",9,FALSE,27,305,"F",27,27,"San Antonio Spurs","Doug McDermott",0,16,16,14,2,16.4
3,0,5,3,1,6,4,3,2,"21",1,0,11,6,2,0,1038111,"2024-01-10T00:00:00.000Z",9,FALSE,27,359,"F",27,27,"San Antonio Spurs","Cedi Osman",2,17,20,14,9,28.7
0,0,1,0,0,4,4,1,1,"06",0,2,9,1,0,0,1038111,"2024-01-10T00:00:00.000Z",9,FALSE,27,38017693,"G",27,27,"San Antonio Spurs","Blake Wesley",0,10,10,9,1,10.2
0,0,0,0,0,0,0,0,0,"00",0,0,0,0,0,0,1038111,"2024-01-10T00:00:00.000Z",9,FALSE,27,17895854,"G",27,27,"San Antonio Spurs","Charles Bassey",0,0,0,0,0,0
0,0,0,0,0,0,0,0,0,"00",0,0,0,0,0,0,1038111,"2024-01-10T00:00:00.000Z",9,FALSE,27,56677817,"G",27,27,"San Antonio Spurs","Sidy Cissoko",0,0,0,0,0,0
0,0,0,0,0,0,0,0,0,"00",0,0,0,0,0,0,1038111,"2024-01-10T00:00:00.000Z",9,FALSE,27,102,"F-C",27,27,"San Antonio Spurs","Zach Collins",0,0,0,0,0,0
0,0,0,0,0,0,0,0,0,"00",0,0,0,0,0,0,1038111,"2024-01-10T00:00:00.000Z",9,FALSE,27,17896049,"G",3,27,"San Antonio Spurs","David Duke Jr.",0,0,0,0,0,0
10,0,9,4,0,16,6,5,4,"21",3,1,16,12,0,0,1038111,"2024-01-10T00:00:00.000Z",9,FALSE,27,56677822,"F-C",27,27,"San Antonio Spurs","Victor Wembanyama",0,28,38,26,22,45.4
5,0,3,5,1,12,6,4,3,"27",0,0,16,3,1,1,1038111,"2024-01-10T00:00:00.000Z",9,FALSE,27,3547246,"G-F",27,27,"San Antonio Spurs","Devin Vassell",1,19,24,21,8,29.1
5,1,2,1,0,9,5,1,1,"27",0,2,11,2,0,2,1038111,"2024-01-10T00:00:00.000Z",9,FALSE,27,3547274,"G",27,27,"San Antonio Spurs","Tre Jones",1,13,18,16,7,21.9
4,2,5,0,0,8,5,1,1,"24",3,3,11,8,0,0,1038111,"2024-01-10T00:00:00.000Z",9,FALSE,27,38017730,"F",27,27,"San Antonio Spurs","Dominick Barlow",2,19,23,15,12,32.6
3,0,1,3,1,7,2,2,2,"21",1,2,7,2,0,1,1038111,"2024-01-10T00:00:00.000Z",9,FALSE,27,38017692,"F",27,27,"San Antonio Spurs","Malaki Branham",0,9,12,10,5,12.9
0,0,1,0,0,0,0,2,1,"02",0,0,1,1,0,0,1038111,"2024-01-10T00:00:00.000Z",9,FALSE,27,3547163,"F",6,27,"San Antonio Spurs","Mamadi Diakite",0,2,2,1,1,2.2
0,0,0,0,0,0,0,0,0,"00",0,0,0,0,0,0,1038111,"2024-01-10T00:00:00.000Z",9,FALSE,27,180,"G",27,27,"San Antonio Spurs","Devonte' Graham",0,0,0,0,0,0
3,1,1,2,1,8,4,8,8,"25",0,2,17,1,2,0,1038111,"2024-01-10T00:00:00.000Z",9,FALSE,27,666682,"F",27,27,"San Antonio Spurs","Keldon Johnson",3,18,21,20,4,31.7
0,0,0,0,0,0,0,0,0,"02",0,0,0,0,0,0,1038111,"2024-01-10T00:00:00.000Z",9,FALSE,27,17896059,"F",27,27,"San Antonio Spurs","Sandro Mamukelashvili",0,0,0,0,0,0
1,0,3,5,2,9,3,2,2,"24",0,1,10,3,0,0,1038112,"2024-01-10T00:00:00.000Z",12,FALSE,30,3547250,"G-F",12,12,"Indiana Pacers","Aaron Nesmith",0,13,14,11,4,15.1
3,0,6,6,3,10,6,0,0,"28",1,2,15,7,0,2,1038112,"2024-01-10T00:00:00.000Z",12,FALSE,30,3547243,"F",12,12,"Indiana Pacers","Obi Toppin",0,22,25,18,10,25.9
3,2,7,5,1,15,7,3,3,"31",6,3,18,13,0,2,1038112,"2024-01-10T00:00:00.000Z",12,FALSE,30,452,"C-F",12,12,"Indiana Pacers","Myles Turner",2,31,34,21,16,42.1
6,1,9,2,1,11,5,5,5,"27",0,2,16,9,1,0,1038112,"2024-01-10T00:00:00.000Z",12,FALSE,30,69,"G",12,12,"Indiana Pacers","Bruce Brown",2,25,31,22,15,41.8
5,0,0,1,0,8,1,0,0,"26",2,3,2,2,2,5,1038112,"2024-01-10T00:00:00.000Z",12,FALSE,30,38017507,"G-F",12,12,"Indiana Pacers","Andrew Nembhard",2,4,9,7,7,12.9
0,0,0,0,0,0,0,0,0,"00",0,0,0,0,0,0,1038112,"2024-01-10T00:00:00.000Z",12,FALSE,30,38017701,"G",12,12,"Indiana Pacers","Kendall Brown",0,0,0,0,0,0
4,0,2,3,0,5,0,0,0,"19",1,1,0,3,0,1,1038112,"2024-01-10T00:00:00.000Z",12,FALSE,30,210,"G",12,12,"Indiana Pacers","Buddy Hield",0,3,7,4,7,8.6
1,3,1,0,0,4,4,6,4,"17",2,3,12,3,1,2,1038112,"2024-01-10T00:00:00.000Z",12,FALSE,30,17896035,"F",12,12,"Indiana Pacers","Isaiah Jackson",4,15,16,13,4,27.1
0,0,0,0,0,0,0,0,0,"00",0,0,0,0,0,0,1038112,"2024-01-10T00:00:00.000Z",12,FALSE,30,242,"F",12,12,"Indiana Pacers","James Johnson",0,0,0,0,0,0
0,0,5,1,0,13,4,8,8,"28",2,2,16,7,1,1,1038112,"2024-01-10T00:00:00.000Z",12,FALSE,30,38017686,"G-F",12,12,"Indiana Pacers","Bennedict Mathurin",1,23,23,16,7,26.4
8,0,2,0,0,10,7,0,0,"22",0,2,14,2,2,0,1038112,"2024-01-10T00:00:00.000Z",12,FALSE,30,304,"G",12,12,"Indiana Pacers","T.J. McConnell",2,16,24,22,10,34.4
0,0,5,2,1,7,4,0,0,"18",0,3,9,5,0,0,1038112,"2024-01-10T00:00:00.000Z",12,FALSE,30,3547207,"F",12,12,"Indiana Pacers","Jordan Nwora",0,14,14,9,5,15
0,0,0,0,0,0,0,0,0,"00",0,0,0,0,0,0,1038112,"2024-01-10T00:00:00.000Z",12,FALSE,30,56677861,"G",12,12,"Indiana Pacers","Ben Sheppard",0,0,0,0,0,0
0,0,0,0,0,0,0,0,0,"00",0,0,0,0,0,0,1038112,"2024-01-10T00:00:00.000Z",12,FALSE,30,3547264,"F-C",12,12,"Indiana Pacers","Jalen Smith",0,0,0,0,0,0
0,0,0,0,0,0,0,0,0,"00",0,0,0,0,0,0,1038112,"2024-01-10T00:00:00.000Z",12,FALSE,30,56677778,"F-C",12,12,"Indiana Pacers","Oscar Tshiebwe",0,0,0,0,0,0
0,0,0,0,0,0,0,0,0,"00",0,0,0,0,0,0,1038112,"2024-01-10T00:00:00.000Z",12,FALSE,30,3547245,"G",12,12,"Indiana Pacers","Tyrese Haliburton",0,0,0,0,0,0
0,0,0,0,0,0,0,0,0,"00",0,0,0,0,0,0,1038112,"2024-01-10T00:00:00.000Z",12,FALSE,30,56677832,"F",12,12,"Indiana Pacers","Jarace Walker",0,0,0,0,0,0
0,0,0,0,0,0,0,0,0,"00",0,0,0,0,0,0,1038112,"2024-01-10T00:00:00.000Z",12,FALSE,30,56677794,"G",12,12,"Indiana Pacers","Isaiah Wong",0,0,0,0,0,0
1,0,5,3,1,10,4,7,6,"25",0,5,15,5,1,1,1038112,"2024-01-10T00:00:00.000Z",12,FALSE,30,3547242,"F",30,30,"Washington Wizards","Deni Avdija",1,20,21,16,6,24.5
5,0,7,4,0,15,4,3,3,"34",3,0,11,10,2,3,1038112,"2024-01-10T00:00:00.000Z",12,FALSE,30,265,"F",30,30,"Washington Wizards","Kyle Kuzma",2,21,26,16,15,33.5
2,6,7,0,0,6,4,6,4,"37",1,4,12,8,2,3,1038112,"2024-01-10T00:00:00.000Z",12,FALSE,30,666577,"F",30,30,"Washington Wizards","Daniel Gafford",8,20,22,14,10,45.6
7,0,3,7,2,21,11,6,4,"34",1,3,28,4,3,1,1038112,"2024-01-10T00:00:00.000Z",12,FALSE,30,666848,"G",30,30,"Washington Wizards","Jordan Poole",3,32,39,35,11,51.3
4,1,3,5,1,12,5,0,0,"34",1,2,11,4,0,2,1038112,"2024-01-10T00:00:00.000Z",12,FALSE,30,249,"G",30,30,"Washington Wizards","Tyus Jones",1,15,19,15,8,22.8
0,0,0,0,0,0,0,0,0,"00",0,0,0,0,0,0,1038112,"2024-01-10T00:00:00.000Z",12,FALSE,30,38017704,"F",30,30,"Washington Wizards","Patrick Baldwin Jr.",0,0,0,0,0,0
0,0,0,0,0,0,0,0,0,"00",0,0,0,0,0,0,1038112,"2024-01-10T00:00:00.000Z",12,FALSE,30,NA,NA,NA,30,"Washington Wizards","NA NA",0,0,0,0,0,0
1,1,5,1,0,5,1,4,3,"22",1,4,5,6,0,0,1038112,"2024-01-10T00:00:00.000Z",12,FALSE,30,56677844,"G",30,30,"Washington Wizards","Bilal Coulibaly",1,11,12,6,7,16.7
0,0,0,0,0,0,0,0,0,"00",0,0,0,0,0,0,1038112,"2024-01-10T00:00:00.000Z",12,FALSE,30,38017687,"G",30,30,"Washington Wizards","Johnny Davis",0,0,0,0,0,0
0,0,0,0,0,0,0,0,0,"00",0,0,0,0,0,0,1038112,"2024-01-10T00:00:00.000Z",12,FALSE,30,128,"G",9,30,"Washington Wizards","Hamidou Diallo",0,0,0,0,0,0
2,0,1,8,3,11,6,0,0,"30",2,0,15,3,0,1,1038112,"2024-01-10T00:00:00.000Z",12,FALSE,30,17896045,"F",30,30,"Washington Wizards","Corey Kispert",0,18,20,17,5,20.6
0,0,1,2,0,4,2,0,0,"10",3,4,4,4,0,1,1038112,"2024-01-10T00:00:00.000Z",12,FALSE,30,337,"F-C",30,30,"Washington Wizards","Mike Muscala",0,8,8,4,4,7.8
2,0,0,1,0,4,1,4,1,"14",1,1,3,1,0,0,1038112,"2024-01-10T00:00:00.000Z",12,FALSE,30,487,"G",30,30,"Washington Wizards","Delon Wright",0,4,6,5,3,7.2
0,0,0,0,0,0,0,0,0,"00",0,0,0,0,0,0,1038112,"2024-01-10T00:00:00.000Z",12,FALSE,30,167,"F",30,30,"Washington Wizards","Danilo Gallinari",0,0,0,0,0,0
0,0,0,0,0,0,0,0,0,"00",0,0,0,0,0,0,1038112,"2024-01-10T00:00:00.000Z",12,FALSE,30,3547302,"F",30,30,"Washington Wizards","Anthony Gill",0,0,0,0,0,0
0,0,0,0,0,0,0,0,0,"00",0,0,0,0,0,0,1038112,"2024-01-10T00:00:00.000Z",12,FALSE,30,18677954,"G",30,30,"Washington Wizards","Jared Butler",0,0,0,0,0,0
0,0,0,0,0,0,0,0,0,"00",0,0,0,0,0,0,1038112,"2024-01-10T00:00:00.000Z",12,FALSE,30,17896106,"F",30,30,"Washington Wizards","Eugene Omoruyi",0,0,0,0,0,0
0,0,0,0,0,0,0,0,0,"00",0,0,0,0,0,0,1038112,"2024-01-10T00:00:00.000Z",12,FALSE,30,414,"G",30,30,"Washington Wizards","Landry Shamet",0,0,0,0,0,0
1,0,4,6,1,16,6,3,2,"37",6,1,15,10,0,1,1038113,"2024-01-10T00:00:00.000Z",1,FALSE,23,3547256,"F",1,1,"Atlanta Hawks","Saddiq Bey",0,25,26,16,11,27.5
7,2,14,4,3,13,8,6,6,"41",2,3,25,16,1,1,1038113,"2024-01-10T00:00:00.000Z",1,FALSE,23,17896040,"F",1,1,"Atlanta Hawks","Jalen Johnson",3,41,48,32,23,62.7
1,2,5,0,0,10,7,5,5,"36",6,5,19,11,0,2,1038113,"2024-01-10T00:00:00.000Z",1,FALSE,23,3547244,"F-C",1,1,"Atlanta Hawks","Onyeka Okongwu",2,30,31,20,12,37.7
5,0,5,7,5,18,8,4,4,"38",0,2,25,5,1,1,1038113,"2024-01-10T00:00:00.000Z",1,FALSE,23,334,"G",1,1,"Atlanta Hawks","Dejounte Murray",1,30,35,30,10,40.5
11,1,1,8,2,22,7,14,12,"43",0,2,28,1,1,5,1038113,"2024-01-10T00:00:00.000Z",1,FALSE,23,490,"G",1,1,"Atlanta Hawks","Trae Young",2,29,40,39,12,46.7
3,0,5,1,0,3,2,0,0,"19",0,3,4,5,0,0,1038113,"2024-01-10T00:00:00.000Z",1,FALSE,23,3547297,"G",1,1,"Atlanta Hawks","Trent Forrest",0,9,12,7,8,14.5
0,0,0,0,0,0,0,0,0,"00",0,0,0,0,0,0,1038113,"2024-01-10T00:00:00.000Z",1,FALSE,23,38017689,"F",1,1,"Atlanta Hawks","AJ Griffin",0,0,0,0,0,0
0,0,0,0,0,0,0,0,0,"00",0,0,0,0,0,0,1038113,"2024-01-10T00:00:00.000Z",1,FALSE,23,56677855,"G",1,1,"Atlanta Hawks","Seth Lundy",0,0,0,0,0,0
0,0,0,0,0,0,0,0,0,"00",0,0,0,0,0,0,1038113,"2024-01-10T00:00:00.000Z",1,FALSE,23,666754,"G",1,1,"Atlanta Hawks","Garrison Mathews",0,0,0,0,0,0
0,0,0,0,0,0,0,0,0,"00",0,0,0,0,0,0,1038113,"2024-01-10T00:00:00.000Z",1,FALSE,23,301,"G-F",1,1,"Atlanta Hawks","Wesley Matthews",0,0,0,0,0,0
2,3,2,2,1,4,2,2,1,"37",2,4,6,4,0,1,1038113,"2024-01-10T00:00:00.000Z",1,FALSE,23,33,"F-G",23,23,"Philadelphia 76ers","Nicolas Batum",3,10,12,8,6,21.8
4,1,8,2,1,24,12,7,7,"41",2,2,32,10,0,1,1038113,"2024-01-10T00:00:00.000Z",1,FALSE,23,200,"F",23,23,"Philadelphia 76ers","Tobias Harris",1,42,46,36,14,52
2,2,8,1,0,8,4,1,1,"19",1,2,9,9,1,0,1038113,"2024-01-10T00:00:00.000Z",1,FALSE,23,3547270,"F",23,23,"Philadelphia 76ers","Paul Reed",3,18,20,11,11,31.8
2,0,2,4,2,7,3,2,2,"21",1,0,10,3,0,1,1038113,"2024-01-10T00:00:00.000Z",1,FALSE,23,313,"G",23,23,"Philadelphia 76ers","De'Anthony Melton",0,13,15,12,5,15.6
2,3,2,1,0,4,2,2,1,"14",4,3,5,6,1,1,1038113,"2024-01-10T00:00:00.000Z",1,FALSE,23,28,"C",23,23,"Philadelphia 76ers","Mo Bamba",4,11,13,7,8,26.2
0,0,0,0,0,0,0,0,0,"00",0,0,0,0,0,0,1038113,"2024-01-10T00:00:00.000Z",1,FALSE,23,666656,"F",1,1,"Atlanta Hawks","De'Andre Hunter",0,0,0,0,0,0
0,0,0,0,0,0,0,0,0,"00",0,0,0,0,0,0,1038113,"2024-01-10T00:00:00.000Z",1,FALSE,23,4197387,"G",1,1,"Atlanta Hawks","Vit Krejci",0,0,0,0,0,0
0,0,0,0,0,0,0,0,0,"00",0,0,0,0,0,0,1038113,"2024-01-10T00:00:00.000Z",1,FALSE,23,38017732,"F",15,23,"Philadelphia 76ers","Kenneth Lofton Jr.",0,0,0,0,0,0
0,0,0,0,0,0,0,0,0,"00",0,0,0,0,0,0,1038113,"2024-01-10T00:00:00.000Z",1,FALSE,23,56677788,"G",23,23,"Philadelphia 76ers","Terquavion Smith",0,0,0,0,0,0
0,0,0,0,0,0,0,0,0,"06",0,2,0,0,0,0,1038113,"2024-01-10T00:00:00.000Z",1,FALSE,23,319,"G",1,1,"Atlanta Hawks","Patty Mills",0,0,0,0,0,0
0,0,0,0,0,0,0,0,0,"00",0,0,0,0,0,0,1038113,"2024-01-10T00:00:00.000Z",1,FALSE,23,56677838,"G",1,1,"Atlanta Hawks","Kobe Bufkin",0,0,0,0,0,0
0,0,0,0,0,0,0,0,0,"00",0,0,0,0,0,0,1038113,"2024-01-10T00:00:00.000Z",1,FALSE,23,83,"C",1,1,"Atlanta Hawks","Clint Capela",0,0,0,0,0,0
0,0,0,0,0,0,0,0,0,"00",0,0,0,0,0,0,1038113,"2024-01-10T00:00:00.000Z",1,FALSE,23,56677806,"F",1,1,"Atlanta Hawks","Mouhamed Gueye",0,0,0,0,0,0
2,0,2,2,1,4,3,2,2,"13",1,2,9,3,0,1,1038113,"2024-01-10T00:00:00.000Z",1,FALSE,23,45,"G",23,23,"Philadelphia 76ers","Patrick Beverley",0,12,14,11,5,14.6
0,0,0,0,0,0,0,0,0,"00",0,0,0,0,0,0,1038113,"2024-01-10T00:00:00.000Z",1,FALSE,23,2175,"",23,23,"Philadelphia 76ers","Danuel House Jr.",0,0,0,0,0,0
0,0,0,0,0,0,0,0,0,"00",0,0,0,0,0,0,1038113,"2024-01-10T00:00:00.000Z",1,FALSE,23,260,"G-F",23,23,"Philadelphia 76ers","Furkan Korkmaz",0,0,0,0,0,0
0,0,0,0,0,0,0,0,0,"06",0,1,0,0,0,1,1038113,"2024-01-10T00:00:00.000Z",1,FALSE,23,3547294,"F",23,23,"Philadelphia 76ers","Kenyon Martin Jr.",0,0,0,0,0,-1
1,0,3,8,3,9,4,6,6,"26",1,3,17,4,0,1,1038113,"2024-01-10T00:00:00.000Z",1,FALSE,23,328,"F",23,23,"Philadelphia 76ers","Marcus Morris",0,21,22,18,5,22.3
2,0,3,3,0,11,3,2,1,"32",0,3,7,3,1,1,1038113,"2024-01-10T00:00:00.000Z",1,FALSE,23,360,"F",23,23,"Philadelphia 76ers","Kelly Oubre Jr.",1,10,12,9,5,15.6
0,0,1,0,0,2,1,0,0,"13",0,2,2,1,1,0,1038113,"2024-01-10T00:00:00.000Z",1,FALSE,23,17896025,"G",23,23,"Philadelphia 76ers","Jaden Springer",1,3,3,2,1,6.2
0,0,0,0,0,0,0,0,0,"00",0,0,0,0,0,0,1038113,"2024-01-10T00:00:00.000Z",1,FALSE,23,56913527,"G",23,23,"Philadelphia 76ers","Ricky Council IV",0,0,0,0,0,0
0,0,0,0,0,0,0,0,0,"00",0,0,0,0,0,0,1038113,"2024-01-10T00:00:00.000Z",1,FALSE,23,145,"F-C",23,23,"Philadelphia 76ers","Joel Embiid",0,0,0,0,0,0
4,0,2,8,1,16,7,1,0,"28",0,1,15,2,2,1,1038113,"2024-01-10T00:00:00.000Z",1,FALSE,23,53,"G",1,1,"Atlanta Hawks","Bogdan Bogdanovic",2,17,21,19,6,28.4
0,3,3,0,0,4,3,9,2,"17",2,2,8,5,1,1,1038113,"2024-01-10T00:00:00.000Z",1,FALSE,23,666564,"F",1,1,"Atlanta Hawks","Bruno Fernando",4,13,13,8,5,25
9,0,7,11,4,29,12,9,7,"43",1,6,35,8,4,3,1038113,"2024-01-10T00:00:00.000Z",1,FALSE,23,3547254,"G",23,23,"Philadelphia 76ers","Tyrese Maxey",4,43,52,44,17,67.1
0,0,0,0,0,0,0,0,0,"00",0,0,0,0,0,0,1038113,"2024-01-10T00:00:00.000Z",1,FALSE,23,108,"F",23,23,"Philadelphia 76ers","Robert Covington",0,0,0,0,0,0
2,0,3,7,5,14,7,0,0,"35",2,2,19,5,1,0,1038114,"2024-01-10T00:00:00.000Z",16,FALSE,21,3092,"",16,16,"Miami Heat","Haywood Highsmith",1,24,26,21,7,31
4,1,5,5,3,8,5,2,2,"32",0,3,15,5,1,1,1038114,"2024-01-10T00:00:00.000Z",16,FALSE,21,38017696,"F",16,16,"Miami Heat","Nikola Jovic",2,20,24,19,9,32
6,2,6,0,0,16,9,7,7,"37",5,1,25,11,0,1,1038114,"2024-01-10T00:00:00.000Z",16,FALSE,21,4,"C-F",16,16,"Miami Heat","Bam Adebayo",2,36,42,31,17,52.2
2,0,5,5,3,9,6,9,6,"34",0,4,21,5,0,3,1038114,"2024-01-10T00:00:00.000Z",16,FALSE,21,56677785,"G",16,16,"Miami Heat","Jaime Jaquez Jr.",0,26,28,23,7,27
6,0,5,5,1,21,7,4,2,"36",0,1,17,5,3,1,1038114,"2024-01-10T00:00:00.000Z",16,FALSE,21,666633,"G",16,16,"Miami Heat","Tyler Herro",3,22,28,23,11,40
0,0,0,0,0,0,0,0,0,"00",0,0,0,0,0,0,1038114,"2024-01-10T00:00:00.000Z",16,FALSE,21,74,"C",16,16,"Miami Heat","Thomas Bryant",0,0,0,0,0,0
0,0,0,0,0,0,0,0,0,"00",0,0,0,0,0,0,1038114,"2024-01-10T00:00:00.000Z",16,FALSE,21,38017734,"F",16,16,"Miami Heat","Jamal Cain",0,0,0,0,0,0
0,0,0,0,0,0,0,0,0,"00",0,0,0,0,0,0,1038114,"2024-01-10T00:00:00.000Z",16,FALSE,21,56677853,"F",21,21,"Oklahoma City Thunder","Keyontae Johnson",0,0,0,0,0,0
0,0,0,0,0,0,0,0,0,"00",0,0,0,0,0,0,1038114,"2024-01-10T00:00:00.000Z",16,FALSE,21,24572055,"C",21,21,"Oklahoma City Thunder","Olivier Sarr",0,0,0,0,0,0
0,0,0,0,0,0,0,0,0,"00",0,0,0,0,0,0,1038114,"2024-01-10T00:00:00.000Z",16,FALSE,21,666747,"F",16,16,"Miami Heat","Caleb Martin",0,0,0,0,0,0
0,0,0,0,0,0,0,0,0,"00",0,0,0,0,0,0,1038114,"2024-01-10T00:00:00.000Z",16,FALSE,21,19465585,"G",16,16,"Miami Heat","Dru Smith",0,0,0,0,0,0
0,0,0,0,0,0,0,0,0,"00",0,0,0,0,0,0,1038114,"2024-01-10T00:00:00.000Z",16,FALSE,21,38017736,"F",16,16,"Miami Heat","Cole Swider",0,0,0,0,0,0
0,0,2,4,2,10,5,4,2,"26",0,3,14,2,0,0,1038114,"2024-01-10T00:00:00.000Z",16,FALSE,21,666541,"G",21,21,"Oklahoma City Thunder","Luguentz Dort",0,16,16,14,2,16.4
12,0,8,3,1,14,8,2,2,"35",1,2,19,9,1,1,1038114,"2024-01-10T00:00:00.000Z",16,FALSE,21,38017703,"G-F",21,21,"Oklahoma City Thunder","Jalen Williams",1,28,40,31,21,49.8
2,3,9,5,1,15,10,3,2,"33",0,4,23,9,0,2,1038114,"2024-01-10T00:00:00.000Z",16,FALSE,21,38017685,"C-F",21,21,"Oklahoma City Thunder","Chet Holmgren",3,32,34,25,11,43.8
0,0,1,6,3,7,4,0,0,"22",1,1,11,2,0,1,1038114,"2024-01-10T00:00:00.000Z",16,FALSE,21,3547272,"G",21,21,"Oklahoma City Thunder","Isaiah Joe",0,13,13,11,2,12.4
0,0,0,0,0,0,0,0,0,"00",0,0,0,0,0,0,1038114,"2024-01-10T00:00:00.000Z",16,FALSE,21,17896036,"G",21,21,"Oklahoma City Thunder","Tre Mann",0,0,0,0,0,0
5,0,1,0,0,2,2,0,0,"15",0,1,4,1,1,0,1038114,"2024-01-10T00:00:00.000Z",16,FALSE,21,4197029,"G",21,21,"Oklahoma City Thunder","Vasilije Micic",1,5,10,9,6,15.7
0,0,0,0,0,0,0,0,0,"00",0,0,0,0,0,0,1038114,"2024-01-10T00:00:00.000Z",16,FALSE,21,3547271,"C",21,21,"Oklahoma City Thunder","Aleksej Pokusevski",0,0,0,0,0,0
1,0,1,4,2,5,3,0,0,"18",1,2,8,2,0,1,1038114,"2024-01-10T00:00:00.000Z",16,FALSE,21,56677833,"G",21,21,"Oklahoma City Thunder","Cason Wallace",0,10,11,9,3,10.9
0,0,0,0,0,0,0,0,0,"00",0,0,0,0,0,0,1038114,"2024-01-10T00:00:00.000Z",16,FALSE,21,27924547,"F",21,21,"Oklahoma City Thunder","Lindy Waters III",0,0,0,0,0,0
0,0,0,0,0,4,1,0,0,"08",0,1,2,0,0,0,1038114,"2024-01-10T00:00:00.000Z",16,FALSE,21,17896078,"G",21,21,"Oklahoma City Thunder","Aaron Wiggins",0,2,2,2,0,2
4,0,2,2,1,2,1,0,0,"12",0,2,3,2,0,0,1038114,"2024-01-10T00:00:00.000Z",16,FALSE,21,38017706,"F",21,21,"Oklahoma City Thunder","Jaylin Williams",0,5,9,7,6,11.4
2,0,5,2,1,4,3,0,0,"17",1,0,7,6,0,2,1038114,"2024-01-10T00:00:00.000Z",16,FALSE,21,480,"G-F",21,21,"Oklahoma City Thunder","Kenrich Williams",0,13,15,9,8,15.2
0,0,0,0,0,0,0,0,0,"00",0,0,0,0,0,0,1038114,"2024-01-10T00:00:00.000Z",16,FALSE,21,44,"F",21,21,"Oklahoma City Thunder","Davis Bertans",0,0,0,0,0,0
0,0,0,0,0,0,0,0,0,"00",0,0,0,0,0,0,1038114,"2024-01-10T00:00:00.000Z",16,FALSE,21,38017716,"F",21,21,"Oklahoma City Thunder","Ousmane Dieng",0,0,0,0,0,0
0,0,0,0,0,0,0,0,0,"00",0,0,0,0,0,0,1038114,"2024-01-10T00:00:00.000Z",16,FALSE,21,3547257,"G",16,16,"Miami Heat","R.J. Hampton",0,0,0,0,0,0
2,0,4,2,0,6,3,6,6,"20",1,0,12,5,0,1,1038114,"2024-01-10T00:00:00.000Z",16,FALSE,21,285,"F-C",16,16,"Miami Heat","Kevin Love",0,17,19,14,7,20
2,0,1,5,2,7,3,0,0,"21",0,2,8,1,1,2,1038114,"2024-01-10T00:00:00.000Z",16,FALSE,21,391,"G-F",16,16,"Miami Heat","Josh Richardson",1,9,11,10,3,13.2
1,0,1,7,1,8,1,0,0,"25",0,0,3,1,2,1,1038114,"2024-01-10T00:00:00.000Z",16,FALSE,21,397,"F",16,16,"Miami Heat","Duncan Robinson",2,4,5,4,2,10.7
0,0,0,0,0,0,0,0,0,"00",0,0,0,0,0,0,1038114,"2024-01-10T00:00:00.000Z",16,FALSE,21,39398582,"C",16,16,"Miami Heat","Orlando Robinson",0,0,0,0,0,0
0,0,0,0,0,0,0,0,0,"00",0,0,0,0,0,0,1038114,"2024-01-10T00:00:00.000Z",16,FALSE,21,79,"G-F",16,16,"Miami Heat","Jimmy Butler",0,0,0,0,0,0
0,0,0,0,0,0,0,0,0,"00",0,0,0,0,0,0,1038114,"2024-01-10T00:00:00.000Z",16,FALSE,21,286,"G",16,16,"Miami Heat","Kyle Lowry",0,0,0,0,0,0
2,0,7,2,1,6,3,2,2,"20",0,0,9,7,1,2,1038114,"2024-01-10T00:00:00.000Z",16,FALSE,21,17896065,"G",21,21,"Oklahoma City Thunder","Josh Giddey",1,16,18,11,9,21.4
8,1,2,5,2,17,11,5,4,"34",0,3,28,2,1,3,1038114,"2024-01-10T00:00:00.000Z",16,FALSE,21,175,"G",21,21,"Oklahoma City Thunder","Shai Gilgeous-Alexander",2,30,38,36,10,45.4
0,1,1,5,2,12,4,2,2,"35",3,4,12,4,0,1,1038119,"2024-01-11T00:00:00.000Z",6,FALSE,3,3547247,"F-G",6,6,"Cleveland Cavaliers","Isaac Okoro",1,16,16,12,4,18.8
2,0,1,1,0,1,0,4,4,"27",0,5,4,1,2,0,1038119,"2024-01-11T00:00:00.000Z",6,FALSE,3,666940,"F",6,6,"Cleveland Cavaliers","Dean Wade",2,5,7,6,3,14.2
4,4,9,0,0,5,3,6,6,"38",3,5,12,12,2,1,1038119,"2024-01-11T00:00:00.000Z",6,FALSE,3,9,"C",6,6,"Cleveland Cavaliers","Jarrett Allen",6,24,28,16,16,49.4
0,0,0,2,0,2,0,0,0,"07",0,0,0,0,0,0,1038119,"2024-01-11T00:00:00.000Z",6,FALSE,3,666908,"G",6,6,"Cleveland Cavaliers","Max Strus",0,0,0,0,0,0
6,0,10,12,4,30,15,13,11,"40",2,1,45,12,4,7,1038119,"2024-01-11T00:00:00.000Z",6,FALSE,3,322,"G",6,6,"Cleveland Cavaliers","Donovan Mitchell",4,57,63,51,18,73.4
0,0,0,0,0,0,0,0,0,"00",0,0,0,0,0,0,1038119,"2024-01-11T00:00:00.000Z",6,FALSE,3,56677847,"F",6,6,"Cleveland Cavaliers","Emoni Bates",0,0,0,0,0,0
0,0,0,0,0,0,0,0,0,"00",0,0,0,0,0,0,1038119,"2024-01-11T00:00:00.000Z",6,FALSE,3,248,"C",6,6,"Cleveland Cavaliers","Damian Jones",0,0,0,0,0,0
1,1,3,9,3,14,5,12,8,"35",0,2,21,3,1,1,1038119,"2024-01-11T00:00:00.000Z",6,FALSE,3,277,"G",6,6,"Cleveland Cavaliers","Caris LeVert",2,24,25,22,4,31.1
1,0,7,11,2,12,2,0,0,"32",2,1,6,9,1,0,1038119,"2024-01-11T00:00:00.000Z",6,FALSE,3,3547299,"G",6,6,"Cleveland Cavaliers","Sam Merrill",1,15,16,7,10,21.3
2,0,3,4,2,6,3,2,2,"16",1,3,10,4,0,0,1038119,"2024-01-11T00:00:00.000Z",6,FALSE,3,344,"F",6,6,"Cleveland Cavaliers","Georges Niang",0,14,16,12,6,17.8
0,0,0,0,0,0,0,0,0,"00",0,0,0,0,0,0,1038119,"2024-01-11T00:00:00.000Z",6,FALSE,3,56677872,"G",6,6,"Cleveland Cavaliers","Craig Porter",0,0,0,0,0,0
0,0,1,0,0,0,0,4,1,"10",1,3,1,2,1,1,1038119,"2024-01-11T00:00:00.000Z",6,FALSE,3,444,"C-F",6,6,"Cleveland Cavaliers","Tristan Thompson",1,3,3,1,2,5.4
0,0,0,0,0,0,0,0,0,"00",0,0,0,0,0,0,1038119,"2024-01-11T00:00:00.000Z",6,FALSE,3,666581,"G",6,6,"Cleveland Cavaliers","Darius Garland",0,0,0,0,0,0
0,0,0,0,0,0,0,0,0,"00",0,0,0,0,0,0,1038119,"2024-01-11T00:00:00.000Z",6,FALSE,3,666676,"G",6,6,"Cleveland Cavaliers","Ty Jerome",0,0,0,0,0,0
0,0,0,0,0,0,0,0,0,"00",0,0,0,0,0,0,1038119,"2024-01-11T00:00:00.000Z",6,FALSE,3,17896076,"F-C",6,6,"Cleveland Cavaliers","Evan Mobley",0,0,0,0,0,0
0,1,0,1,0,1,0,0,0,"14",0,3,0,0,0,1,1038119,"2024-01-11T00:00:00.000Z",6,FALSE,3,158,"F",3,3,"Brooklyn Nets","Dorian Finney-Smith",1,0,0,0,0,2
1,0,8,0,0,9,6,2,1,"33",3,3,13,11,1,3,1038119,"2024-01-11T00:00:00.000Z",6,FALSE,3,666508,"F-C",3,3,"Brooklyn Nets","Nicolas Claxton",1,24,25,14,12,27.7
1,0,6,6,2,18,6,13,12,"32",0,3,26,6,1,4,1038119,"2024-01-11T00:00:00.000Z",6,FALSE,3,61,"F",3,3,"Brooklyn Nets","Mikal Bridges",1,32,33,27,7,33.7
3,0,2,2,0,3,1,0,0,"16",0,2,2,2,0,0,1038119,"2024-01-11T00:00:00.000Z",6,FALSE,3,130,"G",3,3,"Brooklyn Nets","Spencer Dinwiddie",0,4,7,5,5,8.9
1,0,2,2,0,2,0,0,0,"17",0,2,0,2,0,1,1038119,"2024-01-11T00:00:00.000Z",6,FALSE,3,351,"F",3,3,"Brooklyn Nets","Royce O'Neale",0,2,3,1,3,2.9
1,0,0,0,0,2,1,0,0,"03",1,0,2,1,0,1,1038119,"2024-01-11T00:00:00.000Z",6,FALSE,3,174,"F-C",3,3,"Brooklyn Nets","Harry Giles III",0,3,4,3,2,3.7
0,0,0,0,0,0,0,0,0,"00",0,0,0,0,0,0,1038119,"2024-01-11T00:00:00.000Z",6,FALSE,3,17896038,"C",3,3,"Brooklyn Nets","Day'Ron Sharpe",0,0,0,0,0,0
5,1,3,0,0,2,1,0,0,"23",1,1,2,4,0,1,1038119,"2024-01-11T00:00:00.000Z",6,FALSE,3,421,"G",3,3,"Brooklyn Nets","Dennis Smith Jr.",1,6,11,7,9,16.3
2,1,6,5,1,21,9,11,7,"35",0,3,26,6,0,0,1038119,"2024-01-11T00:00:00.000Z",6,FALSE,3,17896048,"G",3,3,"Brooklyn Nets","Cam Thomas",1,32,34,28,8,39.2
2,1,2,5,4,12,8,0,0,"25",1,3,20,3,1,2,1038119,"2024-01-11T00:00:00.000Z",6,FALSE,3,464,"G",3,3,"Brooklyn Nets","Lonnie Walker IV",2,23,25,22,5,30.6
1,0,2,1,0,5,4,0,0,"19",2,6,8,4,1,0,1038119,"2024-01-11T00:00:00.000Z",6,FALSE,3,17896058,"F",3,3,"Brooklyn Nets","Trendon Watford",1,12,13,9,5,17.3
0,0,0,0,0,0,0,0,0,"00",0,0,0,0,0,0,1038119,"2024-01-11T00:00:00.000Z",6,FALSE,3,56677843,"F",3,3,"Brooklyn Nets","Noah Clowney",0,0,0,0,0,0
0,0,0,0,0,0,0,0,0,"00",0,0,0,0,0,0,1038119,"2024-01-11T00:00:00.000Z",6,FALSE,3,17896041,"G",3,3,"Brooklyn Nets","Keon Johnson",0,0,0,0,0,0
0,0,0,0,0,0,0,0,0,"00",0,0,0,0,0,0,1038119,"2024-01-11T00:00:00.000Z",6,FALSE,3,38017662,"F",6,6,"Cleveland Cavaliers","Isaiah Mobley",0,0,0,0,0,0
1,0,1,5,1,7,1,2,0,"23",1,3,3,2,1,3,1038119,"2024-01-11T00:00:00.000Z",6,FALSE,3,666679,"F",3,3,"Brooklyn Nets","Cameron Johnson",1,5,6,4,3,6.9
0,0,0,0,0,0,0,0,0,"00",0,0,0,0,0,0,1038119,"2024-01-11T00:00:00.000Z",6,FALSE,3,417,"G-F",3,3,"Brooklyn Nets","Ben Simmons",0,0,0,0,0,0
0,0,0,0,0,0,0,0,0,"00",0,0,0,0,0,0,1038119,"2024-01-11T00:00:00.000Z",6,FALSE,3,56677841,"F",3,3,"Brooklyn Nets","Dariq Whitehead",0,0,0,0,0,0
0,0,0,0,0,0,0,0,0,"00",0,0,0,0,0,0,1038119,"2024-01-11T00:00:00.000Z",6,FALSE,3,56677722,"F",3,3,"Brooklyn Nets","Jalen Wilson",0,0,0,0,0,0
7,0,2,5,1,9,2,0,0,"20",0,2,5,2,1,0,1038120,"2024-01-11T00:00:00.000Z",17,FALSE,2,315,"F",17,17,"Milwaukee Bucks","Khris Middleton",1,7,14,12,9,20.9
6,1,7,0,0,13,10,5,4,"26",5,2,24,12,1,4,1038120,"2024-01-11T00:00:00.000Z",17,FALSE,2,15,"F",17,17,"Milwaukee Bucks","Giannis Antetokounmpo",2,36,42,30,18,49.4
3,2,4,4,2,8,6,2,1,"28",1,3,15,5,0,1,1038120,"2024-01-11T00:00:00.000Z",17,FALSE,2,283,"C",17,17,"Milwaukee Bucks","Brook Lopez",2,20,23,18,8,30.5
0,0,3,8,4,11,6,0,0,"27",1,0,16,4,0,0,1038120,"2024-01-11T00:00:00.000Z",17,FALSE,2,38,"G",17,17,"Milwaukee Bucks","Malik Beasley",0,20,20,16,4,20.8
4,0,4,8,3,12,6,6,6,"27",0,1,21,4,0,0,1038120,"2024-01-11T00:00:00.000Z",17,FALSE,2,278,"G",17,17,"Milwaukee Bucks","Damian Lillard",0,25,29,25,8,31.8
1,1,0,0,0,5,3,0,0,"09",1,4,6,1,0,2,1038120,"2024-01-11T00:00:00.000Z",17,FALSE,2,2148,"",17,17,"Milwaukee Bucks","Thanasis Antetokounmpo",1,7,8,7,2,9.7
0,1,1,2,0,2,0,0,0,"12",0,0,0,1,0,1,1038120,"2024-01-11T00:00:00.000Z",17,FALSE,2,38017676,"F",17,17,"Milwaukee Bucks","MarJon Beauchamp",1,1,1,0,1,3.2
3,0,0,0,0,1,1,0,0,"21",1,3,2,1,0,0,1038120,"2024-01-11T00:00:00.000Z",17,FALSE,2,105,"G",17,17,"Milwaukee Bucks","Pat Connaughton",0,3,6,5,4,7.7
2,1,1,5,2,6,3,1,1,"08",0,1,9,1,1,0,1038120,"2024-01-11T00:00:00.000Z",17,FALSE,2,38017733,"G",17,17,"Milwaukee Bucks","A.J. Green",2,10,12,11,3,19.2
4,0,2,2,0,2,0,0,0,"16",2,5,0,4,0,0,1038120,"2024-01-11T00:00:00.000Z",17,FALSE,2,56677852,"G",17,17,"Milwaukee Bucks","Andre Jackson Jr.",0,4,8,4,8,10.8
1,0,2,0,0,1,1,0,0,"09",0,0,2,2,0,1,1038120,"2024-01-11T00:00:00.000Z",17,FALSE,2,56677854,"F",17,17,"Milwaukee Bucks","Chris Livingston",0,4,5,3,3,4.9
0,0,0,0,0,0,0,0,0,"00",0,0,0,0,0,0,1038120,"2024-01-11T00:00:00.000Z",17,FALSE,2,284,"C",17,17,"Milwaukee Bucks","Robin Lopez",0,0,0,0,0,0
3,0,4,2,1,4,3,0,0,"15",0,0,7,4,0,0,1038120,"2024-01-11T00:00:00.000Z",17,FALSE,2,368,"G",17,17,"Milwaukee Bucks","Cameron Payne",0,11,14,10,7,16.3
0,0,11,6,5,18,11,2,1,"22",1,1,28,12,1,0,1038120,"2024-01-11T00:00:00.000Z",17,FALSE,2,377,"F",17,17,"Milwaukee Bucks","Bobby Portis",1,40,40,28,12,45.4
0,0,0,0,0,0,0,0,0,"00",0,0,0,0,0,0,1038120,"2024-01-11T00:00:00.000Z",17,FALSE,2,38017691,"G",17,17,"Milwaukee Bucks","TyTy Washington Jr.",0,0,0,0,0,0
0,0,0,0,0,0,0,0,0,"00",0,0,0,0,0,0,1038120,"2024-01-11T00:00:00.000Z",17,FALSE,2,112,"F",17,17,"Milwaukee Bucks","Jae Crowder",0,0,0,0,0,0
3,0,3,1,0,14,5,0,0,"18",1,1,10,4,0,0,1038120,"2024-01-11T00:00:00.000Z",17,FALSE,2,70,"G",2,2,"Boston Celtics","Jaylen Brown",0,14,17,13,7,19.3
3,0,1,1,0,6,2,4,3,"16",0,2,7,1,0,1,1038120,"2024-01-11T00:00:00.000Z",17,FALSE,2,434,"F",2,2,"Boston Celtics","Jayson Tatum",0,8,11,10,4,11.7
0,0,0,0,0,0,0,0,0,"00",0,0,0,0,0,0,1038120,"2024-01-11T00:00:00.000Z",17,FALSE,2,38017707,"G",2,2,"Boston Celtics","JD Davison",0,0,0,0,0,0
0,0,0,0,0,0,0,0,0,"00",0,0,0,0,0,0,1038120,"2024-01-11T00:00:00.000Z",17,FALSE,2,219,"C-F",2,2,"Boston Celtics","Al Horford",0,0,0,0,0,0
0,0,0,0,0,0,0,0,0,"00",0,0,0,0,0,0,1038120,"2024-01-11T00:00:00.000Z",17,FALSE,2,NA,NA,NA,2,"Boston Celtics","NA NA",0,0,0,0,0,0
0,0,0,0,0,0,0,0,0,"00",0,0,0,0,0,0,1038120,"2024-01-11T00:00:00.000Z",17,FALSE,2,56677864,"G",2,2,"Boston Celtics","Jordan Walsh",0,0,0,0,0,0
4,1,1,3,0,9,3,0,0,"21",1,2,6,2,1,1,1038120,"2024-01-11T00:00:00.000Z",17,FALSE,2,378,"F-C",2,2,"Boston Celtics","Kristaps Porzingis",2,8,12,10,6,19.4
0,0,1,1,0,4,1,0,0,"17",0,0,2,1,0,0,1038120,"2024-01-11T00:00:00.000Z",17,FALSE,2,473,"G",2,2,"Boston Celtics","Derrick White",0,3,3,2,1,3.2
2,0,3,4,0,9,2,2,2,"19",1,1,6,4,0,1,1038120,"2024-01-11T00:00:00.000Z",17,FALSE,2,214,"G",2,2,"Boston Celtics","Jrue Holiday",0,10,12,8,6,12.8
1,0,2,3,0,8,4,6,5,"17",0,0,13,2,0,0,1038120,"2024-01-11T00:00:00.000Z",17,FALSE,2,666468,"F",2,2,"Boston Celtics","Oshae Brissett",0,15,16,14,3,16.9
0,0,3,8,4,8,4,3,3,"24",1,1,15,4,1,1,1038120,"2024-01-11T00:00:00.000Z",17,FALSE,2,17896060,"F",2,2,"Boston Celtics","Sam Hauser",1,19,19,15,4,21.8
4,1,4,8,2,13,6,7,7,"31",0,1,21,4,0,1,1038120,"2024-01-11T00:00:00.000Z",17,FALSE,2,3547276,"G",2,2,"Boston Celtics","Payton Pritchard",1,25,29,25,8,33.8
1,0,0,0,0,0,0,0,0,"10",0,1,0,0,0,0,1038120,"2024-01-11T00:00:00.000Z",17,FALSE,2,261,"F-C",2,2,"Boston Celtics","Luke Kornet",0,0,1,1,1,1.5
3,1,1,2,1,5,1,2,1,"18",0,1,4,1,2,0,1038120,"2024-01-11T00:00:00.000Z",17,FALSE,2,17896094,"G",2,2,"Boston Celtics","Dalano Banton",3,5,8,7,4,18.7
1,0,1,3,2,5,3,2,1,"17",0,0,9,1,1,0,1038120,"2024-01-11T00:00:00.000Z",17,FALSE,2,338,"G",2,2,"Boston Celtics","Svi Mykhailiuk",1,10,11,10,2,14.7
0,1,3,0,0,6,1,4,3,"19",1,2,5,4,0,0,1038120,"2024-01-11T00:00:00.000Z",17,FALSE,2,3547279,"F",2,2,"Boston Celtics","Lamar Stevens",1,9,9,5,4,12.8
0,1,2,0,0,4,2,0,0,"13",2,1,4,4,0,2,1038120,"2024-01-11T00:00:00.000Z",17,FALSE,2,17553967,"C",2,2,"Boston Celtics","Neemias Queta",1,8,8,4,4,9.8
1,1,3,5,3,7,3,2,2,"19",0,2,11,3,1,1,1038121,"2024-01-11T00:00:00.000Z",21,FALSE,25,666541,"G",21,21,"Oklahoma City Thunder","Luguentz Dort",2,14,15,12,4,21.1
4,2,4,1,1,10,9,3,2,"19",3,0,21,7,0,1,1038121,"2024-01-11T00:00:00.000Z",21,FALSE,25,38017703,"G-F",21,21,"Oklahoma City Thunder","Jalen Williams",2,28,32,25,11,40.4
3,0,3,3,1,13,9,2,0,"20",1,2,19,4,1,0,1038121,"2024-01-11T00:00:00.000Z",21,FALSE,25,38017685,"C-F",21,21,"Oklahoma City Thunder","Chet Holmgren",1,23,26,22,7,31.3
12,3,10,0,0,5,5,3,3,"22",0,0,13,10,0,1,1038121,"2024-01-11T00:00:00.000Z",21,FALSE,25,17896065,"G",21,21,"Oklahoma City Thunder","Josh Giddey",3,23,35,25,22,51
4,1,4,3,1,15,11,8,8,"21",1,2,31,5,0,2,1038121,"2024-01-11T00:00:00.000Z",21,FALSE,25,175,"G",21,21,"Oklahoma City Thunder","Shai Gilgeous-Alexander",1,36,40,35,9,44
3,0,6,5,1,11,4,0,0,"23",0,2,9,6,1,1,1038121,"2024-01-11T00:00:00.000Z",21,FALSE,25,38017716,"F",21,21,"Oklahoma City Thunder","Ousmane Dieng",1,15,18,12,9,22.7
1,0,1,0,0,0,0,0,0,"07",0,0,0,1,1,0,1038121,"2024-01-11T00:00:00.000Z",21,FALSE,25,3547272,"G",21,21,"Oklahoma City Thunder","Isaiah Joe",1,1,2,1,2,5.7
2,0,1,0,0,0,0,2,2,"09",0,0,2,1,0,0,1038121,"2024-01-11T00:00:00.000Z",21,FALSE,25,4197029,"G",21,21,"Oklahoma City Thunder","Vasilije Micic",0,3,5,4,3,6.2
2,0,5,3,0,5,1,2,2,"17",1,0,4,6,0,0,1038121,"2024-01-11T00:00:00.000Z",21,FALSE,25,56677833,"G",21,21,"Oklahoma City Thunder","Cason Wallace",0,10,12,6,8,14.2
0,0,0,2,0,4,1,0,0,"10",0,0,2,0,0,0,1038121,"2024-01-11T00:00:00.000Z",21,FALSE,25,480,"G-F",21,21,"Oklahoma City Thunder","Kenrich Williams",0,2,2,2,0,2
2,3,3,0,0,0,0,0,0,"19",0,3,0,3,0,0,1038121,"2024-01-11T00:00:00.000Z",21,FALSE,25,39613724,"C",25,25,"Portland Trail Blazers","Ibou Badji",3,3,5,2,5,15.6
0,0,0,0,0,0,0,0,0,"00",0,0,0,0,0,0,1038121,"2024-01-11T00:00:00.000Z",21,FALSE,25,65,"G",25,25,"Portland Trail Blazers","Malcolm Brogdon",0,0,0,0,0,0
1,1,2,2,0,5,2,0,0,"14",0,0,4,2,2,0,1038121,"2024-01-11T00:00:00.000Z",21,FALSE,25,47957121,"F",25,25,"Portland Trail Blazers","Justin Minaya",3,6,7,5,3,16.9
0,0,2,5,1,10,4,0,0,"23",3,0,9,5,1,0,1038121,"2024-01-11T00:00:00.000Z",21,FALSE,25,56677791,"F",25,25,"Portland Trail Blazers","Kris Murray",1,14,14,9,5,18
2,0,3,2,1,6,1,0,0,"12",1,0,3,4,0,0,1038121,"2024-01-11T00:00:00.000Z",21,FALSE,25,56677829,"G-F",25,25,"Portland Trail Blazers","Rayan Rupert",0,7,9,5,6,10.8
1,0,3,6,1,14,3,0,0,"21",3,3,7,6,0,1,1038121,"2024-01-11T00:00:00.000Z",21,FALSE,25,38017690,"G",25,25,"Portland Trail Blazers","Shaedon Sharpe",0,13,14,8,7,14.7
1,0,0,4,0,5,1,2,2,"19",0,1,4,0,1,0,1038121,"2024-01-11T00:00:00.000Z",21,FALSE,25,666923,"G-F",25,25,"Portland Trail Blazers","Matisse Thybulle",1,4,5,5,1,8.5
0,0,0,0,0,0,0,0,0,"00",0,0,0,0,0,0,1038121,"2024-01-11T00:00:00.000Z",21,FALSE,25,22,"C",25,25,"Portland Trail Blazers","Deandre Ayton",0,0,0,0,0,0
0,0,0,0,0,0,0,0,0,"00",0,0,0,0,0,0,1038121,"2024-01-11T00:00:00.000Z",21,FALSE,25,666476,"C",25,25,"Portland Trail Blazers","Moses Brown",0,0,0,0,0,0
0,0,0,0,0,0,0,0,0,"00",0,0,0,0,0,0,1038121,"2024-01-11T00:00:00.000Z",21,FALSE,25,38017711,"F",25,25,"Portland Trail Blazers","Jabari Walker",0,0,0,0,0,0
0,0,0,0,0,0,0,0,0,"00",0,0,0,0,0,0,1038121,"2024-01-11T00:00:00.000Z",21,FALSE,25,476,"C-F",25,25,"Portland Trail Blazers","Robert Williams III",0,0,0,0,0,0
0,0,0,0,0,2,0,0,0,"07",0,0,0,0,1,0,1038121,"2024-01-11T00:00:00.000Z",21,FALSE,25,17896078,"G",21,21,"Oklahoma City Thunder","Aaron Wiggins",1,0,0,0,0,3
2,0,2,1,0,5,2,0,0,"18",1,1,4,3,0,2,1038121,"2024-01-11T00:00:00.000Z",21,FALSE,25,56677853,"F",21,21,"Oklahoma City Thunder","Keyontae Johnson",0,7,9,6,5,8.6
4,0,6,4,3,5,4,0,0,"18",1,0,11,7,0,1,1038121,"2024-01-11T00:00:00.000Z",21,FALSE,25,17896036,"G",21,21,"Oklahoma City Thunder","Tre Mann",0,18,22,15,11,24.4
2,1,2,4,2,5,2,0,0,"12",0,1,6,2,0,1,1038121,"2024-01-11T00:00:00.000Z",21,FALSE,25,27924547,"F",21,21,"Oklahoma City Thunder","Lindy Waters III",1,8,10,8,4,13.4
1,0,4,4,2,6,2,0,0,"18",0,0,6,4,1,2,1038121,"2024-01-11T00:00:00.000Z",21,FALSE,25,38017706,"F",21,21,"Oklahoma City Thunder","Jaylin Williams",1,10,11,7,5,13.3
0,0,0,0,0,0,0,0,0,"00",0,0,0,0,0,0,1038121,"2024-01-11T00:00:00.000Z",21,FALSE,25,44,"F",21,21,"Oklahoma City Thunder","Davis Bertans",0,0,0,0,0,0
0,0,0,0,0,0,0,0,0,"00",0,0,0,0,0,0,1038121,"2024-01-11T00:00:00.000Z",21,FALSE,25,3547271,"C",21,21,"Oklahoma City Thunder","Aleksej Pokusevski",0,0,0,0,0,0
0,0,0,0,0,0,0,0,0,"00",0,0,0,0,0,0,1038121,"2024-01-11T00:00:00.000Z",21,FALSE,25,24572055,"C",21,21,"Oklahoma City Thunder","Olivier Sarr",0,0,0,0,0,0
1,2,3,6,1,8,2,2,1,"32",1,3,6,4,2,2,1038121,"2024-01-11T00:00:00.000Z",21,FALSE,25,56677850,"F",25,25,"Portland Trail Blazers","Toumani Camara",4,10,11,7,5,22.3
2,1,2,3,1,10,4,0,0,"25",0,2,9,2,1,0,1038121,"2024-01-11T00:00:00.000Z",21,FALSE,25,182,"F",25,25,"Portland Trail Blazers","Jerami Grant",2,11,13,11,4,20.4
2,1,5,4,1,9,3,2,1,"24",2,2,8,7,0,0,1038121,"2024-01-11T00:00:00.000Z",21,FALSE,25,56783340,"C",25,25,"Portland Trail Blazers","Duop Reath",1,15,17,10,9,22.4
2,0,4,9,1,21,4,6,4,"31",2,3,13,6,1,3,1038121,"2024-01-11T00:00:00.000Z",21,FALSE,25,56677747,"G",25,25,"Portland Trail Blazers","Scoot Henderson",1,19,21,15,8,23.2
2,0,2,8,4,13,4,4,2,"20",1,2,14,3,0,3,1038121,"2024-01-11T00:00:00.000Z",21,FALSE,25,419,"G",25,25,"Portland Trail Blazers","Anfernee Simons",0,17,19,16,5,17.6
3,0,2,4,2,12,8,2,0,"35",0,2,18,2,1,0,1038122,"2024-01-11T00:00:00.000Z",7,FALSE,20,3547258,"G",7,7,"Dallas Mavericks","Josh Green",1,20,23,21,5,27.9
1,1,3,5,1,10,4,2,0,"35",1,2,9,4,0,1,1038122,"2024-01-11T00:00:00.000Z",7,FALSE,20,247,"F-G",7,7,"Dallas Mavericks","Derrick Jones Jr.",1,13,14,10,5,17.3
2,0,4,0,0,3,2,0,0,"28",5,5,4,9,1,0,1038122,"2024-01-11T00:00:00.000Z",7,FALSE,20,379,"F-C",7,7,"Dallas Mavericks","Dwight Powell",1,13,15,6,11,20.8
4,0,4,13,6,20,10,7,6,"39",2,2,32,6,2,2,1038122,"2024-01-11T00:00:00.000Z",7,FALSE,20,191,"G",7,7,"Dallas Mavericks","Tim Hardaway Jr.",2,38,42,36,10,49.2
10,0,4,10,6,26,15,9,8,"39",0,3,44,4,2,5,1038122,"2024-01-11T00:00:00.000Z",7,FALSE,20,228,"G",7,7,"Dallas Mavericks","Kyrie Irving",2,48,58,54,14,64.8
4,0,6,2,0,8,2,5,4,"23",0,2,8,6,0,0,1038122,"2024-01-11T00:00:00.000Z",7,FALSE,20,38017679,"G",7,7,"Dallas Mavericks","Jaden Hardy",0,14,18,12,10,21.2
0,0,0,0,0,1,0,2,2,"04",0,0,2,0,0,0,1038122,"2024-01-11T00:00:00.000Z",7,FALSE,20,329,"F",7,7,"Dallas Mavericks","Markieff Morris",0,2,2,2,0,2
3,1,3,6,2,7,3,3,3,"27",3,3,11,6,0,1,1038122,"2024-01-11T00:00:00.000Z",7,FALSE,20,666965,"F",7,7,"Dallas Mavericks","Grant Williams",1,17,20,14,9,24.7
5,0,5,7,2,23,12,7,6,"37",1,3,32,6,2,4,1038122,"2024-01-11T00:00:00.000Z",7,FALSE,20,387,"F",20,20,"New York Knicks","Julius Randle",2,38,43,37,11,48.7
3,0,10,0,0,3,2,4,4,"32",5,4,8,15,1,0,1038122,"2024-01-11T00:00:00.000Z",7,FALSE,20,201,"F-C",20,20,"New York Knicks","Isaiah Hartenstein",1,23,26,11,18,33.5
3,0,3,10,5,13,7,0,0,"30",1,4,19,4,2,2,1038122,"2024-01-11T00:00:00.000Z",7,FALSE,20,131,"G",20,20,"New York Knicks","Donte DiVincenzo",2,23,26,22,7,32.3
8,0,2,6,2,22,10,9,8,"39",0,3,30,2,1,4,1038122,"2024-01-11T00:00:00.000Z",7,FALSE,20,73,"G",20,20,"New York Knicks","Jalen Brunson",1,32,40,38,10,43.4
0,0,5,0,0,3,3,2,1,"16",1,4,7,6,1,2,1038122,"2024-01-11T00:00:00.000Z",7,FALSE,20,3547249,"F",28,20,"New York Knicks","Precious Achiuwa",1,13,13,7,6,15.2
0,0,0,0,0,0,0,0,0,"00",0,0,0,0,0,0,1038122,"2024-01-11T00:00:00.000Z",7,FALSE,20,19,"G",20,20,"New York Knicks","Ryan Arcidiacono",0,0,0,0,0,0
0,0,0,0,0,0,0,0,0,"00",0,0,0,0,0,0,1038122,"2024-01-11T00:00:00.000Z",7,FALSE,20,666474,"G",20,20,"New York Knicks","Charles Brown",0,0,0,0,0,0
0,0,0,0,0,0,0,0,0,"00",0,0,0,0,0,0,1038122,"2024-01-11T00:00:00.000Z",7,FALSE,20,3547275,"G",28,20,"New York Knicks","Malachi Flynn",0,0,0,0,0,0
0,0,0,0,0,0,0,0,0,"00",0,0,0,0,0,0,1038122,"2024-01-11T00:00:00.000Z",7,FALSE,20,160,"G-F",20,20,"New York Knicks","Evan Fournier",0,0,0,0,0,0
3,0,0,6,3,6,3,2,0,"15",0,1,9,0,0,0,1038122,"2024-01-11T00:00:00.000Z",7,FALSE,20,17895858,"G",20,20,"New York Knicks","Quentin Grimes",0,9,12,12,3,13.5
2,0,1,3,0,4,1,3,2,"23",3,3,4,4,0,1,1038122,"2024-01-11T00:00:00.000Z",7,FALSE,20,202,"G",20,20,"New York Knicks","Josh Hart",0,8,10,6,6,10.8
1,0,1,4,1,5,2,0,0,"09",1,2,5,2,0,0,1038122,"2024-01-11T00:00:00.000Z",7,FALSE,20,17896033,"G",20,20,"New York Knicks","Miles McBride",0,7,8,6,3,8.9
0,0,0,0,0,0,0,0,0,"00",0,0,0,0,0,0,1038122,"2024-01-11T00:00:00.000Z",7,FALSE,20,17896063,"F",20,20,"New York Knicks","Jericho Sims",0,0,0,0,0,0
0,0,0,0,0,0,0,0,0,"00",0,0,0,0,0,0,1038122,"2024-01-11T00:00:00.000Z",7,FALSE,20,399,"C",20,20,"New York Knicks","Mitchell Robinson",0,0,0,0,0,0
0,0,0,0,0,0,0,0,0,"00",0,0,0,0,0,0,1038122,"2024-01-11T00:00:00.000Z",7,FALSE,20,56677795,"F",20,20,"New York Knicks","Jacob Toppin",0,0,0,0,0,0
0,0,0,0,0,0,0,0,0,"00",0,0,0,0,0,0,1038122,"2024-01-11T00:00:00.000Z",7,FALSE,20,17896089,"G",20,20,"New York Knicks","Duane Washington Jr.",0,0,0,0,0,0
0,0,0,0,0,0,0,0,0,"00",0,0,0,0,0,0,1038122,"2024-01-11T00:00:00.000Z",7,FALSE,20,257,"F",7,7,"Dallas Mavericks","Maxi Kleber",0,0,0,0,0,0
0,0,0,0,0,0,0,0,0,"00",0,0,0,0,0,0,1038122,"2024-01-11T00:00:00.000Z",7,FALSE,20,56677840,"C",7,7,"Dallas Mavericks","Dereck Lively II",0,0,0,0,0,0
0,0,0,0,0,0,0,0,0,"00",0,0,0,0,0,0,1038122,"2024-01-11T00:00:00.000Z",7,FALSE,20,56677859,"F",7,7,"Dallas Mavericks","Olivier-Maxence Prosper",0,0,0,0,0,0
2,2,5,6,1,10,4,1,1,"39",1,1,10,6,0,1,1038122,"2024-01-11T00:00:00.000Z",7,FALSE,20,18,"F",28,20,"New York Knicks","OG Anunoby",2,16,18,12,8,25.2
0,0,1,1,0,1,0,0,0,"10",0,0,0,1,0,1,1038122,"2024-01-11T00:00:00.000Z",7,FALSE,20,114,"G",7,7,"Dallas Mavericks","Seth Curry",0,1,1,0,1,0.2
0,0,0,0,0,0,0,0,0,"00",0,0,0,0,0,0,1038122,"2024-01-11T00:00:00.000Z",7,FALSE,20,217,"F-C",7,7,"Dallas Mavericks","Richaun Holmes",0,0,0,0,0,0
0,0,0,0,0,0,0,0,0,"00",0,0,0,0,0,0,1038122,"2024-01-11T00:00:00.000Z",7,FALSE,20,17554004,"G",7,7,"Dallas Mavericks","AJ Lawson",0,0,0,0,0,0
0,0,0,0,0,0,0,0,0,"00",0,0,0,0,0,0,1038122,"2024-01-11T00:00:00.000Z",7,FALSE,20,24489167,"G",25,7,"Dallas Mavericks","Brandon Williams",0,0,0,0,0,0
0,0,0,0,0,0,0,0,0,"00",0,0,0,0,0,0,1038122,"2024-01-11T00:00:00.000Z",7,FALSE,20,17896028,"F",7,7,"Dallas Mavericks","Greg Brown III",0,0,0,0,0,0
0,0,0,0,0,0,0,0,0,"00",0,0,0,0,0,0,1038122,"2024-01-11T00:00:00.000Z",7,FALSE,20,132,"F-G",7,7,"Dallas Mavericks","Luka Doncic",0,0,0,0,0,0
0,0,0,0,0,0,0,0,0,"00",0,0,0,0,0,0,1038122,"2024-01-11T00:00:00.000Z",7,FALSE,20,151,"G",7,7,"Dallas Mavericks","Dante Exum",0,0,0,0,0,0
0,0,0,1,0,1,0,0,0,"09",0,1,0,0,0,0,1038123,"2024-01-11T00:00:00.000Z",14,FALSE,24,666860,"F-G",14,14,"Los Angeles Lakers","Cameron Reddish",0,0,0,0,0,0
9,0,5,4,0,11,3,7,4,"24",0,1,10,5,1,4,1038123,"2024-01-11T00:00:00.000Z",14,FALSE,24,237,"F",14,14,"Los Angeles Lakers","LeBron James",1,15,24,19,14,28.5
1,2,5,2,0,11,6,1,1,"32",0,4,13,5,1,3,1038123,"2024-01-11T00:00:00.000Z",14,FALSE,24,117,"F-C",14,14,"Los Angeles Lakers","Anthony Davis",3,18,19,14,6,26.5
2,0,5,8,3,10,4,0,0,"28",1,0,11,6,0,0,1038123,"2024-01-11T00:00:00.000Z",14,FALSE,24,383,"F",14,14,"Los Angeles Lakers","Taurean Prince",0,17,19,13,8,21.2
6,0,0,3,2,7,4,3,3,"30",1,2,13,1,1,3,1038123,"2024-01-11T00:00:00.000Z",14,FALSE,24,17553995,"G",14,14,"Los Angeles Lakers","Austin Reaves",1,14,20,19,7,23.2
4,0,7,3,1,8,4,6,5,"25",0,2,14,7,0,2,1038123,"2024-01-11T00:00:00.000Z",14,FALSE,24,38017697,"G",14,14,"Los Angeles Lakers","Max Christie",0,21,25,18,11,26.4
1,2,1,0,0,3,3,0,0,"13",1,6,6,2,0,2,1038123,"2024-01-11T00:00:00.000Z",14,FALSE,24,666626,"C",14,14,"Los Angeles Lakers","Jaxson Hayes",2,8,9,7,3,13.9
0,0,0,0,0,3,1,0,0,"05",0,0,2,0,0,0,1038123,"2024-01-11T00:00:00.000Z",14,FALSE,24,56677835,"G",14,14,"Los Angeles Lakers","Jalen Hood-Schifino",0,2,2,2,0,2
0,0,0,0,0,0,0,0,0,"00",0,0,0,0,0,0,1038123,"2024-01-11T00:00:00.000Z",14,FALSE,24,56677836,"F",14,14,"Los Angeles Lakers","Maxwell Lewis",0,0,0,0,0,0
1,0,0,2,2,6,5,0,0,"12",1,0,12,1,1,0,1038123,"2024-01-11T00:00:00.000Z",14,FALSE,24,3547289,"G",25,14,"Los Angeles Lakers","Skylar Mays",1,13,14,13,2,17.7
6,0,1,7,3,14,7,4,2,"27",0,2,19,1,2,3,1038123,"2024-01-11T00:00:00.000Z",14,FALSE,24,405,"G",14,14,"Los Angeles Lakers","D'Angelo Russell",2,20,26,25,7,32.2
2,0,6,3,1,5,2,4,1,"30",3,0,6,9,2,1,1038123,"2024-01-11T00:00:00.000Z",14,FALSE,24,457,"F",14,14,"Los Angeles Lakers","Jarred Vanderbilt",2,15,17,8,11,24.8
1,0,0,1,1,1,1,0,0,"05",0,1,3,0,0,0,1038123,"2024-01-11T00:00:00.000Z",14,FALSE,24,666971,"G-F",20,14,"Los Angeles Lakers","Dylan Windler",0,3,4,4,1,4.5
0,0,0,0,0,0,0,0,0,"00",0,0,0,0,0,0,1038123,"2024-01-11T00:00:00.000Z",14,FALSE,24,486,"F",14,14,"Los Angeles Lakers","Christian Wood",0,0,0,0,0,0
0,0,0,0,0,0,0,0,0,"00",0,0,0,0,0,0,1038123,"2024-01-11T00:00:00.000Z",14,FALSE,24,56677738,"C",14,14,"Los Angeles Lakers","Colin Castleton",0,0,0,0,0,0
0,0,0,0,0,0,0,0,0,"00",0,0,0,0,0,0,1038123,"2024-01-11T00:00:00.000Z",14,FALSE,24,666609,"F",14,14,"Los Angeles Lakers","Rui Hachimura",0,0,0,0,0,0
0,0,0,0,0,0,0,0,0,"00",0,0,0,0,0,0,1038123,"2024-01-11T00:00:00.000Z",14,FALSE,24,1603383,"G",14,14,"Los Angeles Lakers","Gabe Vincent",0,0,0,0,0,0
5,1,5,5,2,12,7,2,2,"32",0,0,18,5,3,1,1038123,"2024-01-11T00:00:00.000Z",14,FALSE,24,140,"F",24,24,"Phoenix Suns","Kevin Durant",4,23,28,23,10,42.5
3,0,4,6,1,8,2,0,0,"30",1,3,5,5,0,0,1038123,"2024-01-11T00:00:00.000Z",14,FALSE,24,8,"G",24,24,"Phoenix Suns","Grayson Allen",0,10,13,8,8,15.5
4,0,4,10,8,21,14,1,1,"32",2,3,37,6,1,3,1038123,"2024-01-11T00:00:00.000Z",14,FALSE,24,37,"G",24,24,"Phoenix Suns","Bradley Beal",1,43,47,41,10,50.2
5,0,5,6,2,22,11,7,7,"34",0,2,31,5,3,3,1038123,"2024-01-11T00:00:00.000Z",14,FALSE,24,57,"G",24,24,"Phoenix Suns","Devin Booker",3,36,41,36,10,50.5
0,0,0,0,0,1,1,0,0,"05",1,2,2,1,0,0,1038123,"2024-01-11T00:00:00.000Z",14,FALSE,24,3547095,"C-F",24,24,"Phoenix Suns","Udoka Azubuike",0,3,3,2,1,3.2
0,0,0,1,0,3,1,0,0,"05",0,0,2,0,0,0,1038123,"2024-01-11T00:00:00.000Z",14,FALSE,24,32,"F",24,24,"Phoenix Suns","Keita Bates-Diop",0,2,2,2,0,2
2,2,4,0,0,3,2,2,2,"17",2,1,6,6,2,0,1038123,"2024-01-11T00:00:00.000Z",14,FALSE,24,666451,"C",24,24,"Phoenix Suns","Bol Bol",4,12,14,8,8,28.2
1,0,0,0,0,1,0,0,0,"05",0,1,0,0,1,1,1038123,"2024-01-11T00:00:00.000Z",14,FALSE,24,18678058,"",24,24,"Phoenix Suns","Jordan Goodwin",1,0,1,1,1,3.5
0,0,1,9,1,11,2,0,0,"23",2,0,5,3,0,0,1038123,"2024-01-11T00:00:00.000Z",14,FALSE,24,178,"G",24,24,"Phoenix Suns","Eric Gordon",0,8,8,5,3,8.6
0,0,0,2,0,4,2,2,1,"12",0,1,5,0,1,0,1038123,"2024-01-11T00:00:00.000Z",14,FALSE,24,356,"G",24,24,"Phoenix Suns","Josh Okogie",1,5,5,5,0,8
2,0,8,0,0,6,3,4,3,"28",4,2,9,12,1,2,1038123,"2024-01-11T00:00:00.000Z",14,FALSE,24,349,"C",24,24,"Phoenix Suns","Jusuf Nurkic",1,21,23,11,14,27.4
0,0,0,0,0,1,1,1,1,"04",0,0,3,0,0,1,1038123,"2024-01-11T00:00:00.000Z",14,FALSE,24,666729,"F",24,24,"Phoenix Suns","Nassir Little",0,3,3,3,0,2
1,0,1,0,0,0,0,4,4,"08",1,0,4,2,0,0,1038123,"2024-01-11T00:00:00.000Z",14,FALSE,24,314,"F",24,24,"Phoenix Suns","Chimezie Metu",0,6,7,5,3,7.9
0,1,1,0,0,0,0,0,0,"05",0,1,0,1,0,1,1038123,"2024-01-11T00:00:00.000Z",14,FALSE,24,470,"G",24,24,"Phoenix Suns","Yuta Watanabe",1,1,1,0,1,3.2
0,0,0,0,0,0,0,0,0,"00",0,0,0,0,0,0,1038123,"2024-01-11T00:00:00.000Z",14,FALSE,24,147,"F",24,24,"Phoenix Suns","Drew Eubanks",0,0,0,0,0,0
0,0,0,0,0,0,0,0,0,"00",0,0,0,0,0,0,1038123,"2024-01-11T00:00:00.000Z",14,FALSE,24,272,"G",24,24,"Phoenix Suns","Damion Lee",0,0,0,0,0,0
0,0,0,0,0,0,0,0,0,"00",0,0,0,0,0,0,1038123,"2024-01-11T00:00:00.000Z",14,FALSE,24,3547298,"G",24,24,"Phoenix Suns","Saben Lee",0,0,0,0,0,0
0,0,0,0,0,0,0,0,0,"00",0,0,0,0,0,0,1038123,"2024-01-11T00:00:00.000Z",14,FALSE,24,3547253,"G",4,24,"Phoenix Suns","Theo Maledon",0,0,0,0,0,0
3,0,2,4,4,5,5,0,0,"26",4,2,14,6,0,0,1038124,"2024-01-12T00:00:00.000Z",23,FALSE,26,33,"F-G",23,23,"Philadelphia 76ers","Nicolas Batum",0,20,23,17,9,25.7
3,0,4,7,3,25,14,6,6,"37",3,0,37,7,3,3,1038124,"2024-01-12T00:00:00.000Z",23,FALSE,26,200,"F",23,23,"Philadelphia 76ers","Tobias Harris",3,44,47,40,10,55.9
2,3,3,1,0,9,3,2,2,"25",4,4,8,7,2,0,1038124,"2024-01-12T00:00:00.000Z",23,FALSE,26,3547270,"F",23,23,"Philadelphia 76ers","Paul Reed",5,15,17,10,9,34.4
3,0,3,8,2,9,2,0,0,"25",1,3,6,4,1,1,1038124,"2024-01-12T00:00:00.000Z",23,FALSE,26,313,"G",23,23,"Philadelphia 76ers","De'Anthony Melton",1,10,13,9,7,17.3
4,2,3,6,3,17,6,6,6,"40",0,3,21,3,3,3,1038124,"2024-01-12T00:00:00.000Z",23,FALSE,26,3547254,"G",23,23,"Philadelphia 76ers","Tyrese Maxey",5,24,28,25,7,42.6
0,4,1,2,2,6,4,2,1,"20",2,1,11,3,1,2,1038124,"2024-01-12T00:00:00.000Z",23,FALSE,26,28,"C",23,23,"Philadelphia 76ers","Mo Bamba",5,14,14,11,3,27.6
7,0,9,4,0,8,2,0,0,"27",0,2,4,9,0,3,1038124,"2024-01-12T00:00:00.000Z",23,FALSE,26,45,"G",23,23,"Philadelphia 76ers","Patrick Beverley",0,13,20,11,16,22.3
1,0,2,1,0,2,1,2,2,"14",0,3,4,2,0,0,1038124,"2024-01-12T00:00:00.000Z",23,FALSE,26,2175,"",23,23,"Philadelphia 76ers","Danuel House Jr.",0,6,7,5,3,7.9
0,0,0,0,0,0,0,0,0,"00",0,0,0,0,0,0,1038124,"2024-01-12T00:00:00.000Z",23,FALSE,26,38017732,"F",15,23,"Philadelphia 76ers","Kenneth Lofton Jr.",0,0,0,0,0,0
0,0,0,0,0,0,0,0,0,"00",0,0,0,0,0,0,1038124,"2024-01-12T00:00:00.000Z",23,FALSE,26,56677788,"G",23,23,"Philadelphia 76ers","Terquavion Smith",0,0,0,0,0,0
0,0,0,4,0,5,1,2,2,"21",2,1,4,2,1,1,1038124,"2024-01-12T00:00:00.000Z",23,FALSE,26,30,"F",26,26,"Sacramento Kings","Harrison Barnes",1,6,6,4,2,8.4
3,2,6,7,3,14,6,1,0,"35",2,2,15,8,1,2,1038124,"2024-01-12T00:00:00.000Z",23,FALSE,26,38017688,"F",26,26,"Sacramento Kings","Keegan Murray",3,23,26,18,11,36.1
5,0,7,0,0,10,6,2,2,"33",5,3,14,12,0,4,1038124,"2024-01-12T00:00:00.000Z",23,FALSE,26,406,"F",26,26,"Sacramento Kings","Domantas Sabonis",0,26,31,19,17,31.9
0,0,2,1,0,2,0,2,1,"10",1,1,1,3,0,1,1038124,"2024-01-12T00:00:00.000Z",23,FALSE,26,17896030,"G",26,26,"Sacramento Kings","Chris Duarte",0,4,4,1,3,3.6
4,0,4,7,2,15,5,11,9,"38",1,2,21,5,1,2,1038124,"2024-01-12T00:00:00.000Z",23,FALSE,26,161,"G",26,26,"Sacramento Kings","De'Aaron Fox",1,26,30,25,9,34
0,0,0,1,0,3,1,0,0,"06",1,1,2,1,0,0,1038124,"2024-01-12T00:00:00.000Z",23,FALSE,26,17896044,"F",26,26,"Sacramento Kings","Kessler Edwards",0,3,3,2,1,3.2
0,0,2,2,1,3,1,0,0,"10",0,1,3,2,0,2,1038124,"2024-01-12T00:00:00.000Z",23,FALSE,26,38017714,"G",26,26,"Sacramento Kings","Keon Ellis",0,5,5,3,2,3.4
3,0,2,1,0,4,0,0,0,"09",1,3,0,3,1,1,1038124,"2024-01-12T00:00:00.000Z",23,FALSE,26,56677845,"G",26,26,"Sacramento Kings","Colby Jones",1,3,6,3,6,10.1
1,0,2,0,0,1,1,0,0,"08",2,1,2,4,0,0,1038124,"2024-01-12T00:00:00.000Z",23,FALSE,26,273,"C",26,26,"Sacramento Kings","Alex Len",0,6,7,3,5,8.3
0,0,1,5,1,8,2,0,0,"22",2,1,5,3,0,0,1038124,"2024-01-12T00:00:00.000Z",23,FALSE,26,290,"F",26,26,"Sacramento Kings","Trey Lyles",0,8,8,5,3,8.6
0,1,4,1,0,2,0,2,2,"05",0,0,2,4,0,0,1038124,"2024-01-12T00:00:00.000Z",23,FALSE,26,306,"C",26,26,"Sacramento Kings","JaVale McGee",1,6,6,2,4,9.8
0,0,0,0,0,3,2,0,0,"06",0,0,4,0,0,0,1038124,"2024-01-12T00:00:00.000Z",23,FALSE,26,17553994,"G",26,26,"Sacramento Kings","Davion Mitchell",0,4,4,4,0,4
4,1,1,7,0,17,5,6,5,"27",0,1,15,1,2,2,1038124,"2024-01-12T00:00:00.000Z",23,FALSE,26,324,"G",26,26,"Sacramento Kings","Malik Monk",3,16,20,19,5,29.2
0,0,0,1,1,2,1,0,0,"02",0,1,3,0,0,0,1038124,"2024-01-12T00:00:00.000Z",23,FALSE,26,666925,"F",29,26,"Sacramento Kings","Juan Toscano-Anderson",0,3,3,3,0,3
0,0,0,1,0,5,1,0,0,"08",5,0,2,5,0,1,1038124,"2024-01-12T00:00:00.000Z",23,FALSE,26,4197162,"F",26,26,"Sacramento Kings","Aleksandar Vezenkov",0,7,7,2,5,7
0,0,0,0,0,0,0,0,0,"00",0,0,0,0,0,0,1038124,"2024-01-12T00:00:00.000Z",23,FALSE,26,17895990,"G",26,26,"Sacramento Kings","Jordan Ford",0,0,0,0,0,0
0,0,0,0,0,0,0,0,0,"00",0,0,0,0,0,0,1038124,"2024-01-12T00:00:00.000Z",23,FALSE,26,221,"G",26,26,"Sacramento Kings","Kevin Huerter",0,0,0,0,0,0
0,0,0,0,0,0,0,0,0,"00",0,0,0,0,0,0,1038124,"2024-01-12T00:00:00.000Z",23,FALSE,26,56677862,"F",26,26,"Sacramento Kings","Jalen Slawson",0,0,0,0,0,0
1,0,0,2,1,3,1,0,0,"03",0,0,3,0,1,0,1038124,"2024-01-12T00:00:00.000Z",23,FALSE,26,260,"G-F",23,23,"Philadelphia 76ers","Furkan Korkmaz",1,3,4,4,1,7.5
0,0,0,0,0,1,1,0,0,"03",0,0,2,0,0,0,1038124,"2024-01-12T00:00:00.000Z",23,FALSE,26,3547294,"F",23,23,"Philadelphia 76ers","Kenyon Martin Jr.",0,2,2,2,0,2
0,0,4,0,0,5,0,0,0,"17",0,0,0,4,0,1,1038124,"2024-01-12T00:00:00.000Z",23,FALSE,26,328,"F",23,23,"Philadelphia 76ers","Marcus Morris",0,4,4,0,4,3.8
0,0,0,0,0,0,0,0,0,"00",0,0,0,0,0,0,1038124,"2024-01-12T00:00:00.000Z",23,FALSE,26,360,"F",23,23,"Philadelphia 76ers","Kelly Oubre Jr.",0,0,0,0,0,0
0,0,1,0,0,3,1,0,0,"03",0,1,2,1,0,0,1038124,"2024-01-12T00:00:00.000Z",23,FALSE,26,17896025,"G",23,23,"Philadelphia 76ers","Jaden Springer",0,3,3,2,1,3.2
0,0,0,0,0,0,0,0,0,"00",0,0,0,0,0,0,1038124,"2024-01-12T00:00:00.000Z",23,FALSE,26,56913527,"G",23,23,"Philadelphia 76ers","Ricky Council IV",0,0,0,0,0,0
0,0,0,0,0,0,0,0,0,"00",0,0,0,0,0,0,1038124,"2024-01-12T00:00:00.000Z",23,FALSE,26,108,"F",23,23,"Philadelphia 76ers","Robert Covington",0,0,0,0,0,0
0,0,0,0,0,0,0,0,0,"00",0,0,0,0,0,0,1038124,"2024-01-12T00:00:00.000Z",23,FALSE,26,145,"F-C",23,23,"Philadelphia 76ers","Joel Embiid",0,0,0,0,0,0
2,0,3,7,3,10,3,9,8,"31",1,1,17,4,1,0,1038125,"2024-01-12T00:00:00.000Z",1,FALSE,12,3547256,"F",1,1,"Atlanta Hawks","Saddiq Bey",1,21,23,19,6,27.8
3,0,4,2,1,11,7,3,1,"32",0,3,16,4,2,3,1038125,"2024-01-12T00:00:00.000Z",1,FALSE,12,17896040,"F",1,1,"Atlanta Hawks","Jalen Johnson",2,20,23,19,7,28.3
1,1,2,0,0,5,3,4,1,"22",3,1,7,5,1,0,1038125,"2024-01-12T00:00:00.000Z",1,FALSE,12,83,"C",1,1,"Atlanta Hawks","Clint Capela",2,12,13,8,6,20.5
4,0,4,6,3,18,13,0,0,"32",0,2,29,4,3,3,1038125,"2024-01-12T00:00:00.000Z",1,FALSE,12,334,"G",1,1,"Atlanta Hawks","Dejounte Murray",3,33,37,33,8,45.8
6,0,0,6,2,17,4,3,3,"30",3,1,13,3,2,5,1038125,"2024-01-12T00:00:00.000Z",1,FALSE,12,490,"G",1,1,"Atlanta Hawks","Trae Young",2,16,22,19,9,26.6
2,0,2,5,2,12,3,2,2,"25",3,2,10,5,3,2,1038125,"2024-01-12T00:00:00.000Z",1,FALSE,12,53,"G",1,1,"Atlanta Hawks","Bogdan Bogdanovic",3,15,17,12,7,26
6,0,0,0,0,5,2,0,0,"20",0,0,4,0,1,1,1038125,"2024-01-12T00:00:00.000Z",1,FALSE,12,3547297,"G",1,1,"Atlanta Hawks","Trent Forrest",1,4,10,10,6,15
1,0,0,0,0,4,3,0,0,"22",1,2,6,1,0,0,1038125,"2024-01-12T00:00:00.000Z",1,FALSE,12,3547244,"F-C",1,1,"Atlanta Hawks","Onyeka Okongwu",0,7,8,7,2,8.7
0,0,0,0,0,0,0,0,0,"00",0,0,0,0,0,0,1038125,"2024-01-12T00:00:00.000Z",1,FALSE,12,56677838,"G",1,1,"Atlanta Hawks","Kobe Bufkin",0,0,0,0,0,0
0,0,0,0,0,0,0,0,0,"00",0,0,0,0,0,0,1038125,"2024-01-12T00:00:00.000Z",1,FALSE,12,56677806,"F",1,1,"Atlanta Hawks","Mouhamed Gueye",0,0,0,0,0,0
0,0,0,0,0,0,0,0,0,"00",0,0,0,0,0,0,1038125,"2024-01-12T00:00:00.000Z",1,FALSE,12,666656,"F",1,1,"Atlanta Hawks","De'Andre Hunter",0,0,0,0,0,0
0,0,0,0,0,0,0,0,0,"00",0,0,0,0,0,0,1038125,"2024-01-12T00:00:00.000Z",1,FALSE,12,4197387,"G",1,1,"Atlanta Hawks","Vit Krejci",0,0,0,0,0,0
0,0,0,0,0,0,0,0,0,"00",0,0,0,0,0,0,1038125,"2024-01-12T00:00:00.000Z",1,FALSE,12,301,"G-F",1,1,"Atlanta Hawks","Wesley Matthews",0,0,0,0,0,0
0,0,3,3,3,6,5,0,0,"21",1,3,13,4,1,1,1038125,"2024-01-12T00:00:00.000Z",1,FALSE,12,3547250,"G-F",12,12,"Indiana Pacers","Aaron Nesmith",1,17,17,13,4,19.8
0,0,4,0,0,7,3,0,0,"19",3,1,6,7,0,0,1038125,"2024-01-12T00:00:00.000Z",1,FALSE,12,3547264,"F-C",12,12,"Indiana Pacers","Jalen Smith",0,13,13,6,7,14.4
4,2,5,3,0,9,5,3,2,"26",2,2,12,7,2,3,1038125,"2024-01-12T00:00:00.000Z",1,FALSE,12,452,"C-F",12,12,"Indiana Pacers","Myles Turner",4,19,23,16,11,35.4
4,0,1,3,2,9,5,0,0,"21",0,0,12,1,0,2,1038125,"2024-01-12T00:00:00.000Z",1,FALSE,12,69,"G",12,12,"Indiana Pacers","Bruce Brown",0,13,17,16,5,17.2
6,0,4,2,2,6,4,0,0,"23",0,2,10,4,2,4,1038125,"2024-01-12T00:00:00.000Z",1,FALSE,12,38017507,"G-F",12,12,"Indiana Pacers","Andrew Nembhard",2,14,20,16,10,25.8
0,0,0,0,0,0,0,0,0,"04",0,1,0,0,0,0,1038125,"2024-01-12T00:00:00.000Z",1,FALSE,12,38017701,"G",12,12,"Indiana Pacers","Kendall Brown",0,0,0,0,0,0
2,3,3,6,4,11,7,0,0,"23",0,3,18,3,0,2,1038125,"2024-01-12T00:00:00.000Z",1,FALSE,12,210,"G",12,12,"Indiana Pacers","Buddy Hield",3,21,23,20,5,31.6
2,4,4,0,0,7,6,0,0,"18",1,3,12,5,4,2,1038125,"2024-01-12T00:00:00.000Z",1,FALSE,12,17896035,"F",12,12,"Indiana Pacers","Isaiah Jackson",8,17,19,14,7,43
0,0,0,0,0,0,0,0,0,"00",0,0,0,0,0,0,1038125,"2024-01-12T00:00:00.000Z",1,FALSE,12,242,"F",12,12,"Indiana Pacers","James Johnson",0,0,0,0,0,0
0,0,0,0,0,0,0,0,0,"00",0,0,0,0,0,0,1038125,"2024-01-12T00:00:00.000Z",1,FALSE,12,56677832,"F",12,12,"Indiana Pacers","Jarace Walker",0,0,0,0,0,0
0,0,0,0,0,0,0,0,0,"00",0,0,0,0,0,0,1038125,"2024-01-12T00:00:00.000Z",1,FALSE,12,56677794,"G",12,12,"Indiana Pacers","Isaiah Wong",0,0,0,0,0,0
3,0,0,1,0,9,6,5,3,"27",1,2,15,1,0,5,1038125,"2024-01-12T00:00:00.000Z",1,FALSE,12,38017686,"G-F",12,12,"Indiana Pacers","Bennedict Mathurin",0,16,19,18,4,15.7
14,1,4,0,0,5,3,0,0,"25",0,0,6,4,3,5,1038125,"2024-01-12T00:00:00.000Z",1,FALSE,12,304,"G",12,12,"Indiana Pacers","T.J. McConnell",4,10,24,20,18,38.8
2,0,1,0,0,1,0,0,0,"04",0,0,0,1,0,0,1038125,"2024-01-12T00:00:00.000Z",1,FALSE,12,3547207,"F",12,12,"Indiana Pacers","Jordan Nwora",0,1,3,2,3,4.2
0,0,0,0,0,0,0,0,0,"04",0,0,0,0,0,0,1038125,"2024-01-12T00:00:00.000Z",1,FALSE,12,56677861,"G",12,12,"Indiana Pacers","Ben Sheppard",0,0,0,0,0,0
4,0,4,0,0,7,7,4,4,"21",2,4,18,6,0,1,1038125,"2024-01-12T00:00:00.000Z",1,FALSE,12,3547243,"F",12,12,"Indiana Pacers","Obi Toppin",0,24,28,22,10,30.2
0,0,1,0,0,2,2,0,0,"04",0,0,4,1,0,0,1038125,"2024-01-12T00:00:00.000Z",1,FALSE,12,56677778,"F-C",12,12,"Indiana Pacers","Oscar Tshiebwe",0,5,5,4,1,5.2
0,0,0,0,0,0,0,0,0,"00",0,0,0,0,0,0,1038125,"2024-01-12T00:00:00.000Z",1,FALSE,12,3547245,"G",12,12,"Indiana Pacers","Tyrese Haliburton",0,0,0,0,0,0
0,0,0,1,0,3,1,0,0,"14",1,1,2,1,1,0,1038125,"2024-01-12T00:00:00.000Z",1,FALSE,12,319,"G",1,1,"Atlanta Hawks","Patty Mills",1,3,3,2,1,6.2
0,0,0,1,0,1,0,2,2,"04",0,0,2,0,0,0,1038125,"2024-01-12T00:00:00.000Z",1,FALSE,12,56677855,"G",1,1,"Atlanta Hawks","Seth Lundy",0,2,2,2,0,2
0,0,0,1,0,2,1,0,0,"04",0,0,2,0,0,0,1038125,"2024-01-12T00:00:00.000Z",1,FALSE,12,38017689,"F",1,1,"Atlanta Hawks","AJ Griffin",0,2,2,2,0,2
0,0,1,1,0,1,0,0,0,"04",0,0,0,1,0,0,1038125,"2024-01-12T00:00:00.000Z",1,FALSE,12,666564,"F",1,1,"Atlanta Hawks","Bruno Fernando",0,1,1,0,1,1.2
0,0,0,0,0,0,0,0,0,"00",0,0,0,0,0,0,1038125,"2024-01-12T00:00:00.000Z",1,FALSE,12,666754,"G",1,1,"Atlanta Hawks","Garrison Mathews",0,0,0,0,0,0
2,2,7,4,2,9,7,3,3,"35",0,1,19,7,1,1,1038126,"2024-01-12T00:00:00.000Z",9,FALSE,11,259,"F",9,9,"Detroit Pistons","Kevin Knox",3,26,28,21,9,38.4
1,0,7,8,3,13,6,2,1,"29",0,1,16,7,0,3,1038126,"2024-01-12T00:00:00.000Z",9,FALSE,11,3547267,"F-C",9,9,"Detroit Pistons","Isaiah Stewart",0,23,24,17,8,22.9
3,1,6,0,0,12,7,2,1,"32",2,3,15,8,2,2,1038126,"2024-01-12T00:00:00.000Z",9,FALSE,11,38017694,"C",9,9,"Detroit Pistons","Jalen Duren",3,23,26,18,11,36.1
8,1,2,6,1,19,8,4,1,"28",4,3,18,6,0,2,1038126,"2024-01-12T00:00:00.000Z",9,FALSE,11,38017682,"G",9,9,"Detroit Pistons","Jaden Ivey",1,24,32,26,14,38.2
8,1,4,2,0,6,2,1,1,"29",0,1,5,4,1,1,1038126,"2024-01-12T00:00:00.000Z",9,FALSE,11,3547241,"G",9,9,"Detroit Pistons","Killian Hayes",2,9,17,13,12,26.8
1,0,3,0,0,6,4,4,3,"12",1,2,11,4,1,0,1038126,"2024-01-12T00:00:00.000Z",9,FALSE,11,24,"F",9,9,"Detroit Pistons","Marvin Bagley III",1,15,16,12,5,20.3
1,2,0,9,5,14,7,0,0,"30",0,3,19,0,0,2,1038126,"2024-01-12T00:00:00.000Z",9,FALSE,11,77,"G",9,9,"Detroit Pistons","Alec Burks",2,19,20,20,1,24.5
0,0,0,0,0,0,0,0,0,"00",0,0,0,0,0,0,1038126,"2024-01-12T00:00:00.000Z",9,FALSE,11,197,"F-G",9,9,"Detroit Pistons","Joe Harris",0,0,0,0,0,0
1,2,0,4,1,4,1,0,0,"16",0,3,3,0,0,0,1038126,"2024-01-12T00:00:00.000Z",9,FALSE,11,17896071,"F",9,9,"Detroit Pistons","Isaiah Livers",2,3,4,4,1,10.5
7,0,0,1,0,2,0,0,0,"11",1,2,0,1,1,1,1038126,"2024-01-12T00:00:00.000Z",9,FALSE,11,56677792,"G",9,9,"Detroit Pistons","Marcus Sasser",1,1,8,7,8,13.7
0,0,6,1,0,3,2,0,0,"18",2,2,4,8,0,1,1038126,"2024-01-12T00:00:00.000Z",9,FALSE,11,56677826,"G-F",9,9,"Detroit Pistons","Ausar Thompson",0,12,12,4,8,12.6
0,0,0,0,0,0,0,0,0,"00",0,0,0,0,0,0,1038126,"2024-01-12T00:00:00.000Z",9,FALSE,11,44477024,"G",9,9,"Detroit Pistons","Stanley Umude",0,0,0,0,0,0
0,0,0,0,0,0,0,0,0,"00",0,0,0,0,0,0,1038126,"2024-01-12T00:00:00.000Z",9,FALSE,11,3547240,"C",9,9,"Detroit Pistons","James Wiseman",0,0,0,0,0,0
0,0,0,0,0,0,0,0,0,"00",0,0,0,0,0,0,1038126,"2024-01-12T00:00:00.000Z",9,FALSE,11,54,"F",9,9,"Detroit Pistons","Bojan Bogdanovic",0,0,0,0,0,0
0,0,0,0,0,0,0,0,0,"00",0,0,0,0,0,0,1038126,"2024-01-12T00:00:00.000Z",9,FALSE,11,56677729,"G",9,9,"Detroit Pistons","Malcolm Cazalon",0,0,0,0,0,0
0,0,0,0,0,0,0,0,0,"00",0,0,0,0,0,0,1038126,"2024-01-12T00:00:00.000Z",9,FALSE,11,17896075,"G-F",9,9,"Detroit Pistons","Cade Cunningham",0,0,0,0,0,0
0,0,0,0,0,0,0,0,0,"00",0,0,0,0,0,0,1038126,"2024-01-12T00:00:00.000Z",9,FALSE,11,330,"G",9,9,"Detroit Pistons","Monte Morris",0,0,0,0,0,0
0,0,0,0,0,0,0,0,0,"00",0,0,0,0,0,0,1038126,"2024-01-12T00:00:00.000Z",9,FALSE,11,42097199,"G",9,9,"Detroit Pistons","Jared Rhoden",0,0,0,0,0,0
1,0,5,0,0,2,1,0,0,"20",2,1,2,7,0,1,1038126,"2024-01-12T00:00:00.000Z",9,FALSE,11,3547301,"F",11,11,"Houston Rockets","Jae'Sean Tate",0,9,10,3,8,10.9
1,2,6,3,1,15,7,4,4,"41",5,0,19,11,1,1,1038126,"2024-01-12T00:00:00.000Z",9,FALSE,11,38017684,"F",11,11,"Houston Rockets","Jabari Smith Jr.",3,30,31,20,12,41.7
1,0,6,1,0,19,12,7,5,"37",0,3,29,6,1,4,1038126,"2024-01-12T00:00:00.000Z",9,FALSE,11,17896062,"F-C",11,11,"Houston Rockets","Alperen Sengun",1,35,36,30,7,36.7
3,1,3,9,2,25,9,9,8,"39",2,3,28,5,1,1,1038126,"2024-01-12T00:00:00.000Z",9,FALSE,11,17895966,"G",11,11,"Houston Rockets","Jalen Green",2,33,36,31,8,43.5
12,2,3,9,3,15,7,3,3,"43",1,5,20,4,2,0,1038126,"2024-01-12T00:00:00.000Z",9,FALSE,11,458,"G",11,11,"Houston Rockets","Fred VanVleet",4,24,36,32,16,54.8
1,0,4,3,1,3,1,0,0,"21",0,0,3,4,1,1,1038126,"2024-01-12T00:00:00.000Z",9,FALSE,11,75,"G-F",11,11,"Houston Rockets","Reggie Bullock",1,7,8,4,5,11.3
0,0,2,0,0,2,2,2,2,"13",0,2,6,2,0,1,1038126,"2024-01-12T00:00:00.000Z",9,FALSE,11,188,"F",11,11,"Houston Rockets","Jeff Green",0,8,8,6,2,7.4
0,0,1,0,0,0,0,0,0,"03",0,0,0,1,0,0,1038126,"2024-01-12T00:00:00.000Z",9,FALSE,11,213,"G",11,11,"Houston Rockets","Aaron Holiday",0,1,1,0,1,1.2
0,0,0,0,0,0,0,0,0,"00",0,0,0,0,0,0,1038126,"2024-01-12T00:00:00.000Z",9,FALSE,11,19465326,"C",11,11,"Houston Rockets","Jock Landale",0,0,0,0,0,0
0,0,0,0,0,0,0,0,0,"00",0,0,0,0,0,0,1038126,"2024-01-12T00:00:00.000Z",9,FALSE,11,296,"C",11,11,"Houston Rockets","Boban Marjanovic",0,0,0,0,0,0
2,0,1,0,0,2,1,0,0,"08",0,0,2,1,1,0,1038126,"2024-01-12T00:00:00.000Z",9,FALSE,11,56677825,"G-F",11,11,"Houston Rockets","Amen Thompson",1,3,5,4,3,9.2
0,0,1,5,1,7,1,0,0,"15",0,2,3,1,0,0,1038126,"2024-01-12T00:00:00.000Z",9,FALSE,11,56677831,"F",11,11,"Houston Rockets","Cam Whitmore",0,4,4,3,1,4.2
0,0,0,0,0,0,0,0,0,"00",0,0,0,0,0,0,1038126,"2024-01-12T00:00:00.000Z",9,FALSE,11,56677809,"F",11,11,"Houston Rockets","Jermaine Samuels Jr.",0,0,0,0,0,0
0,0,0,0,0,0,0,0,0,"00",0,0,0,0,0,0,1038126,"2024-01-12T00:00:00.000Z",9,FALSE,11,47738533,"G",11,11,"Houston Rockets","Jeenathan Williams",0,0,0,0,0,0
0,0,0,0,0,0,0,0,0,"00",0,0,0,0,0,0,1038126,"2024-01-12T00:00:00.000Z",9,FALSE,11,66,"G-F",11,11,"Houston Rockets","Dillon Brooks",0,0,0,0,0,0
0,0,0,0,0,0,0,0,0,"00",0,0,0,0,0,0,1038126,"2024-01-12T00:00:00.000Z",9,FALSE,11,38017695,"F",11,11,"Houston Rockets","Tari Eason",0,0,0,0,0,0
0,0,0,0,0,0,0,0,0,"00",0,0,0,0,0,0,1038126,"2024-01-12T00:00:00.000Z",9,FALSE,11,3547281,"G-F",11,11,"Houston Rockets","Nate Hinton",0,0,0,0,0,0
0,0,0,0,0,0,0,0,0,"00",0,0,0,0,0,0,1038126,"2024-01-12T00:00:00.000Z",9,FALSE,11,357,"G",11,11,"Houston Rockets","Victor Oladipo",0,0,0,0,0,0
5,0,5,5,2,21,15,8,7,"41",1,5,39,6,0,1,1038128,"2024-01-12T00:00:00.000Z",5,FALSE,10,125,"G",5,5,"Chicago Bulls","DeMar DeRozan",0,45,50,44,11,52.7
2,1,1,6,2,6,2,0,0,"29",1,0,6,2,0,0,1038128,"2024-01-12T00:00:00.000Z",5,FALSE,10,89,"G",5,5,"Chicago Bulls","Alex Caruso",1,8,10,8,4,14.4
2,0,5,5,2,12,6,0,0,"33",2,1,14,7,0,3,1038128,"2024-01-12T00:00:00.000Z",5,FALSE,10,460,"C",5,5,"Chicago Bulls","Nikola Vucevic",0,21,23,16,9,22.4
7,1,8,8,4,15,9,3,3,"35",0,3,25,8,0,1,1038128,"2024-01-12T00:00:00.000Z",5,FALSE,10,268,"G",5,5,"Chicago Bulls","Zach LaVine",1,33,40,32,15,47.1
7,0,4,7,5,13,9,3,2,"37",0,4,25,4,0,1,1038128,"2024-01-12T00:00:00.000Z",5,FALSE,10,666956,"G",5,5,"Chicago Bulls","Coby White",0,29,36,32,11,39.3
0,0,0,0,0,0,0,0,0,"00",0,0,0,0,0,0,1038128,"2024-01-12T00:00:00.000Z",5,FALSE,10,87,"G",5,5,"Chicago Bulls","Jevon Carter",0,0,0,0,0,0
0,0,0,0,0,0,0,0,0,"00",0,0,0,0,0,0,1038128,"2024-01-12T00:00:00.000Z",5,FALSE,10,110,"F",5,5,"Chicago Bulls","Torrey Craig",0,0,0,0,0,0
0,0,0,3,2,4,2,0,0,"17",0,4,6,0,0,3,1038128,"2024-01-12T00:00:00.000Z",5,FALSE,10,17895983,"G",5,5,"Chicago Bulls","Ayo Dosunmu",0,6,6,6,0,3
1,1,5,0,0,2,2,2,1,"12",0,0,5,5,0,0,1038128,"2024-01-12T00:00:00.000Z",5,FALSE,10,137,"C",5,5,"Chicago Bulls","Andre Drummond",1,10,11,6,6,15.5
0,0,0,0,0,0,0,0,0,"00",0,0,0,0,0,0,1038128,"2024-01-12T00:00:00.000Z",5,FALSE,10,17896116,"G",5,5,"Chicago Bulls","Terry Taylor",0,0,0,0,0,0
0,0,0,3,0,5,1,0,0,"07",1,1,2,1,0,1,1038128,"2024-01-12T00:00:00.000Z",5,FALSE,10,38017719,"F",5,5,"Chicago Bulls","Dalen Terry",0,3,3,2,1,2.2
7,0,2,3,1,8,4,0,0,"29",1,3,9,3,1,2,1038128,"2024-01-12T00:00:00.000Z",5,FALSE,10,3547248,"F",5,5,"Chicago Bulls","Patrick Williams",1,12,19,16,10,24.1
0,0,0,0,0,0,0,0,0,"00",0,0,0,0,0,0,1038128,"2024-01-12T00:00:00.000Z",5,FALSE,10,27,"G",5,5,"Chicago Bulls","Lonzo Ball",0,0,0,0,0,0
0,0,0,0,0,0,0,0,0,"00",0,0,0,0,0,0,1038128,"2024-01-12T00:00:00.000Z",5,FALSE,10,56677874,"F",5,5,"Chicago Bulls","Onuralp Bitim",0,0,0,0,0,0
0,0,0,0,0,0,0,0,0,"00",0,0,0,0,0,0,1038128,"2024-01-12T00:00:00.000Z",5,FALSE,10,NA,NA,NA,5,"Chicago Bulls","NA NA",0,0,0,0,0,0
0,0,0,0,0,0,0,0,0,"00",0,0,0,0,0,0,1038128,"2024-01-12T00:00:00.000Z",5,FALSE,10,56677857,"F",5,5,"Chicago Bulls","Julian Phillips",0,0,0,0,0,0
0,0,0,0,0,0,0,0,0,"00",0,0,0,0,0,0,1038128,"2024-01-12T00:00:00.000Z",5,FALSE,10,56677860,"F",5,5,"Chicago Bulls","Adama Sanogo",0,0,0,0,0,0
8,1,2,5,1,13,8,0,0,"31",3,2,17,5,2,0,1038128,"2024-01-12T00:00:00.000Z",5,FALSE,10,475,"F-G",10,10,"Golden State Warriors","Andrew Wiggins",3,22,30,25,13,44
6,0,6,3,2,6,4,4,2,"28",1,2,12,7,1,0,1038128,"2024-01-12T00:00:00.000Z",5,FALSE,10,407,"F",10,10,"Golden State Warriors","Dario Saric",1,19,25,18,13,32.4
1,1,2,0,0,4,4,2,1,"27",3,2,9,5,0,0,1038128,"2024-01-12T00:00:00.000Z",5,FALSE,10,282,"F",10,10,"Golden State Warriors","Kevon Looney",1,14,15,10,6,19.5
6,1,4,15,7,19,9,6,5,"34",2,1,30,6,1,1,1038128,"2024-01-12T00:00:00.000Z",5,FALSE,10,443,"G",10,10,"Golden State Warriors","Klay Thompson",2,36,42,36,12,51.2
9,0,5,15,6,24,8,5,5,"35",0,1,27,5,1,1,1038128,"2024-01-12T00:00:00.000Z",5,FALSE,10,115,"G",10,10,"Golden State Warriors","Stephen Curry",1,32,41,36,14,48.5
4,0,2,4,0,8,2,1,1,"27",1,3,5,3,0,0,1038128,"2024-01-12T00:00:00.000Z",5,FALSE,10,56677858,"G",10,10,"Golden State Warriors","Brandin Podziemski",0,8,12,9,7,14.6
2,1,4,0,0,5,4,7,5,"17",3,2,13,7,1,1,1038128,"2024-01-12T00:00:00.000Z",5,FALSE,10,56677799,"F",10,10,"Golden State Warriors","Trayce Jackson-Davis",2,20,22,15,9,29.4
1,0,5,4,4,12,9,3,2,"24",0,2,24,5,1,0,1038128,"2024-01-12T00:00:00.000Z",5,FALSE,10,17553979,"F",10,10,"Golden State Warriors","Jonathan Kuminga",1,29,30,25,6,34.5
2,0,1,1,0,3,1,0,0,"13",0,1,2,1,0,0,1038128,"2024-01-12T00:00:00.000Z",5,FALSE,10,251,"G",10,10,"Golden State Warriors","Cory Joseph",0,3,5,4,3,6.2
0,0,0,0,0,0,0,2,1,"04",0,0,1,0,0,0,1038128,"2024-01-12T00:00:00.000Z",5,FALSE,10,398,"G",10,10,"Golden State Warriors","Jerome Robinson",0,1,1,1,0,1
0,0,0,0,0,0,0,0,0,"00",0,0,0,0,0,0,1038128,"2024-01-12T00:00:00.000Z",5,FALSE,10,185,"F",10,10,"Golden State Warriors","Draymond Green",0,0,0,0,0,0
0,0,0,0,0,0,0,0,0,"00",0,0,0,0,0,0,1038128,"2024-01-12T00:00:00.000Z",5,FALSE,10,45658838,"G",10,10,"Golden State Warriors","Lester Quinones",0,0,0,0,0,0
0,0,0,0,0,0,0,0,0,"00",0,0,0,0,0,0,1038128,"2024-01-12T00:00:00.000Z",5,FALSE,10,17896070,"F",10,10,"Golden State Warriors","Usman Garuba",0,0,0,0,0,0
0,0,0,0,0,0,0,0,0,"00",0,0,0,0,0,0,1038128,"2024-01-12T00:00:00.000Z",5,FALSE,10,17553992,"G",10,10,"Golden State Warriors","Moses Moody",0,0,0,0,0,0
0,0,0,0,0,0,0,0,0,"00",0,0,0,0,0,0,1038128,"2024-01-12T00:00:00.000Z",5,FALSE,10,367,"G",10,10,"Golden State Warriors","Chris Paul",0,0,0,0,0,0
0,0,0,0,0,0,0,0,0,"00",0,0,0,0,0,0,1038128,"2024-01-12T00:00:00.000Z",5,FALSE,10,2189,"",10,10,"Golden State Warriors","Gary Payton II",0,0,0,0,0,0
0,0,0,0,0,0,0,0,0,"00",0,0,0,0,0,0,1038128,"2024-01-12T00:00:00.000Z",5,FALSE,10,57875092,"F",10,10,"Golden State Warriors","Gui Santos",0,0,0,0,0,0
4,0,5,5,3,11,7,0,0,"27",1,3,17,6,1,2,1038129,"2024-01-12T00:00:00.000Z",15,FALSE,13,38017729,"F",15,15,"Memphis Grizzlies","David Roddy",1,23,27,21,10,31.2
2,0,1,5,3,12,5,0,0,"19",2,2,13,3,0,1,1038129,"2024-01-12T00:00:00.000Z",15,FALSE,13,17896027,"G-F",15,15,"Memphis Grizzlies","Ziaire Williams",0,16,18,15,5,18.6
1,0,1,5,2,6,2,0,0,"26",2,2,6,3,1,1,1038129,"2024-01-12T00:00:00.000Z",15,FALSE,13,38017731,"G",15,15,"Memphis Grizzlies","Vince Williams Jr.",1,9,10,7,4,13.1
1,1,4,8,1,20,6,10,8,"30",2,1,21,6,1,1,1038129,"2024-01-12T00:00:00.000Z",15,FALSE,13,231,"F-C",15,15,"Memphis Grizzlies","Jaren Jackson Jr.",2,27,28,22,7,34.7
2,2,5,2,1,10,8,7,3,"31",4,1,20,9,1,2,1038129,"2024-01-12T00:00:00.000Z",15,FALSE,13,3547285,"F",15,15,"Memphis Grizzlies","Xavier Tillman",3,29,31,22,11,40.8
6,0,6,5,3,7,4,0,0,"29",1,2,11,7,0,1,1038129,"2024-01-12T00:00:00.000Z",15,FALSE,13,254,"G",15,15,"Memphis Grizzlies","Luke Kennard",0,18,24,17,13,27.4
3,0,1,6,3,11,3,7,6,"23",0,3,15,1,1,0,1038129,"2024-01-12T00:00:00.000Z",15,FALSE,13,3547287,"G",15,15,"Memphis Grizzlies","Desmond Bane",1,16,19,18,4,23.7
0,0,0,0,0,0,0,0,0,"00",0,0,0,0,0,0,1038129,"2024-01-12T00:00:00.000Z",15,FALSE,13,17896067,"F",15,15,"Memphis Grizzlies","Santi Aldama",0,0,0,0,0,0
8,0,1,2,0,2,0,0,0,"20",0,1,0,1,0,1,1038129,"2024-01-12T00:00:00.000Z",15,FALSE,13,48248287,"G",15,15,"Memphis Grizzlies","Jacob Gilyard",0,1,9,8,9,12.2
1,0,2,1,0,5,1,3,2,"09",3,1,4,5,0,0,1038129,"2024-01-12T00:00:00.000Z",15,FALSE,13,56677830,"F",15,15,"Memphis Grizzlies","GG Jackson",0,9,10,5,6,11.5
1,0,1,1,0,1,0,0,0,"06",0,1,0,1,0,0,1038129,"2024-01-12T00:00:00.000Z",15,FALSE,13,666703,"G-F",15,15,"Memphis Grizzlies","John Konchar",0,1,2,1,2,2.7
1,1,2,4,2,10,5,0,0,"20",2,4,12,4,0,0,1038129,"2024-01-12T00:00:00.000Z",15,FALSE,13,38017728,"F",15,15,"Memphis Grizzlies","Jake LaRavia",1,16,17,13,5,21.3
0,0,0,0,0,0,0,0,0,"00",0,0,0,0,0,0,1038129,"2024-01-12T00:00:00.000Z",15,FALSE,13,666505,"F",15,15,"Memphis Grizzlies","Brandon Clarke",0,0,0,0,0,0
0,0,0,0,0,0,0,0,0,"00",0,0,0,0,0,0,1038129,"2024-01-12T00:00:00.000Z",15,FALSE,13,666786,"G",15,15,"Memphis Grizzlies","Ja Morant",0,0,0,0,0,0
0,0,0,0,0,0,0,0,0,"00",0,0,0,0,0,0,1038129,"2024-01-12T00:00:00.000Z",15,FALSE,13,401,"G",15,15,"Memphis Grizzlies","Derrick Rose",0,0,0,0,0,0
0,0,0,0,0,0,0,0,0,"00",0,0,0,0,0,0,1038129,"2024-01-12T00:00:00.000Z",15,FALSE,13,420,"G",15,15,"Memphis Grizzlies","Marcus Smart",0,0,0,0,0,0
4,2,7,5,2,16,10,0,0,"29",0,3,22,7,2,1,1038129,"2024-01-12T00:00:00.000Z",15,FALSE,13,274,"F",13,13,"LA Clippers","Kawhi Leonard",4,29,33,26,11,47.4
1,0,3,10,7,18,12,6,6,"35",0,3,37,3,2,4,1038129,"2024-01-12T00:00:00.000Z",15,FALSE,13,172,"F",13,13,"LA Clippers","Paul George",2,40,41,38,4,44.1
1,0,2,1,1,6,6,1,0,"26",0,0,13,2,2,1,1038129,"2024-01-12T00:00:00.000Z",15,FALSE,13,666511,"G",13,13,"LA Clippers","Amir Coffey",2,15,16,14,3,21.9
0,0,5,2,0,8,5,1,1,"24",0,2,11,5,0,1,1038129,"2024-01-12T00:00:00.000Z",15,FALSE,13,380,"F-G",13,13,"LA Clippers","Norman Powell",0,16,16,11,5,16
2,0,1,3,1,11,5,3,1,"16",1,1,12,2,0,1,1038129,"2024-01-12T00:00:00.000Z",15,FALSE,13,472,"G",13,13,"LA Clippers","Russell Westbrook",0,14,16,14,4,16.4
0,0,0,0,0,0,0,0,0,"00",0,0,0,0,0,0,1038129,"2024-01-12T00:00:00.000Z",15,FALSE,13,3,"C",15,15,"Memphis Grizzlies","Steven Adams",0,0,0,0,0,0
0,2,7,0,0,5,2,2,2,"22",4,3,6,11,0,0,1038129,"2024-01-12T00:00:00.000Z",15,FALSE,13,493,"C",13,13,"LA Clippers","Ivica Zubac",2,17,17,6,11,25.2
0,0,3,4,1,8,3,0,0,"26",2,0,7,5,0,1,1038129,"2024-01-12T00:00:00.000Z",15,FALSE,13,666743,"G",13,13,"LA Clippers","Terance Mann",0,12,12,7,5,12
9,0,1,4,2,7,3,3,3,"28",0,0,11,1,1,3,1038129,"2024-01-12T00:00:00.000Z",15,FALSE,13,192,"G",13,13,"LA Clippers","James Harden",1,12,21,20,10,25.7
4,3,3,1,1,4,2,4,2,"22",2,2,7,5,2,0,1038129,"2024-01-12T00:00:00.000Z",15,FALSE,13,439,"F",13,13,"LA Clippers","Daniel Theis",5,12,16,11,9,34
0,0,0,1,0,3,0,0,0,"04",0,2,0,0,0,0,1038129,"2024-01-12T00:00:00.000Z",15,FALSE,13,17896022,"G",13,13,"LA Clippers","Brandon Boston Jr.",0,0,0,0,0,0
1,0,0,0,0,1,0,0,0,"04",0,0,0,0,0,0,1038129,"2024-01-12T00:00:00.000Z",15,FALSE,13,56677849,"F",13,13,"LA Clippers","Kobe Brown",0,0,1,1,1,1.5
0,0,0,0,0,0,0,0,0,"00",0,0,0,0,0,0,1038129,"2024-01-12T00:00:00.000Z",15,FALSE,13,17896031,"G",13,13,"LA Clippers","Nah'Shon Hyland",0,0,0,0,0,0
0,0,0,0,0,2,1,0,0,"04",2,0,2,2,0,0,1038129,"2024-01-12T00:00:00.000Z",15,FALSE,13,56677856,"G",13,13,"LA Clippers","Jordan Miller",0,4,4,2,2,4.4
0,0,0,0,0,0,0,0,0,"00",0,0,0,0,0,0,1038129,"2024-01-12T00:00:00.000Z",15,FALSE,13,371,"F-C",13,13,"LA Clippers","Mason Plumlee",0,0,0,0,0,0
0,0,0,0,0,0,0,0,0,"00",0,0,0,0,0,0,1038129,"2024-01-12T00:00:00.000Z",15,FALSE,13,450,"F",13,13,"LA Clippers","PJ Tucker",0,0,0,0,0,0
0,0,0,0,0,0,0,0,0,"00",0,0,0,0,0,0,1038129,"2024-01-12T00:00:00.000Z",15,FALSE,13,38017725,"F",13,13,"LA Clippers","Moussa Diabate",0,0,0,0,0,0
0,0,0,0,0,0,0,0,0,"00",0,0,0,0,0,0,1038129,"2024-01-12T00:00:00.000Z",15,FALSE,13,24417679,"G",13,13,"LA Clippers","Xavier Moon",0,0,0,0,0,0
0,0,0,0,0,0,0,0,0,"00",0,0,0,0,0,0,1038129,"2024-01-12T00:00:00.000Z",15,FALSE,13,17896051,"G",13,13,"LA Clippers","Joshua Primo",0,0,0,0,0,0
3,0,2,3,1,8,4,0,0,"24",0,1,9,2,2,4,1038130,"2024-01-12T00:00:00.000Z",18,FALSE,25,3547259,"F",18,18,"Minnesota Timberwolves","Jaden McDaniels",2,11,14,12,5,17.9
1,0,7,3,3,8,7,7,6,"28",1,2,23,8,2,0,1038130,"2024-01-12T00:00:00.000Z",18,FALSE,25,447,"C",18,18,"Minnesota Timberwolves","Karl-Anthony Towns",2,31,32,24,9,40.1
0,2,12,0,0,11,9,8,6,"29",5,2,24,17,0,1,1038130,"2024-01-12T00:00:00.000Z",18,FALSE,25,176,"C",18,18,"Minnesota Timberwolves","Rudy Gobert",2,41,41,24,17,49.4
6,1,3,3,0,9,4,2,1,"27",0,2,9,3,1,0,1038130,"2024-01-12T00:00:00.000Z",18,FALSE,25,3547238,"G",18,18,"Minnesota Timberwolves","Anthony Edwards",2,12,18,15,9,27.6
10,0,4,5,3,7,3,0,0,"20",0,1,9,4,0,0,1038130,"2024-01-12T00:00:00.000Z",18,FALSE,25,104,"G",18,18,"Minnesota Timberwolves","Mike Conley",0,13,23,19,14,28.8
3,0,2,2,0,3,1,0,0,"19",0,1,2,2,2,2,1038130,"2024-01-12T00:00:00.000Z",18,FALSE,25,666400,"G",18,18,"Minnesota Timberwolves","Nickeil Alexander-Walker",2,4,7,5,5,12.9
1,0,2,0,0,2,1,0,0,"15",0,2,2,2,0,2,1038130,"2024-01-12T00:00:00.000Z",18,FALSE,25,12,"F",18,18,"Minnesota Timberwolves","Kyle Anderson",0,4,5,3,3,3.9
3,0,1,5,2,5,2,0,0,"09",1,1,6,2,0,3,1038130,"2024-01-12T00:00:00.000Z",18,FALSE,25,68,"F",18,18,"Minnesota Timberwolves","Troy Brown Jr.",0,8,11,9,5,9.9
5,0,0,2,0,3,1,0,0,"13",0,2,2,0,1,2,1038130,"2024-01-12T00:00:00.000Z",18,FALSE,25,666767,"G",18,18,"Minnesota Timberwolves","Jordan McLaughlin",1,2,7,7,5,10.5
0,1,2,2,0,4,2,0,0,"08",0,2,4,2,1,1,1038130,"2024-01-12T00:00:00.000Z",18,FALSE,25,56677782,"F",18,18,"Minnesota Timberwolves","Leonard Miller",2,6,6,4,2,11.4
2,0,0,0,0,5,3,0,0,"10",0,1,6,0,0,0,1038130,"2024-01-12T00:00:00.000Z",18,FALSE,25,320,"G",18,18,"Minnesota Timberwolves","Shake Milton",0,6,8,8,2,9
0,1,0,0,0,3,0,2,2,"09",0,2,2,0,1,0,1038130,"2024-01-12T00:00:00.000Z",18,FALSE,25,38017715,"F",18,18,"Minnesota Timberwolves","Josh Minott",2,2,2,2,0,8
0,0,0,0,0,2,2,0,0,"08",0,2,4,0,2,0,1038130,"2024-01-12T00:00:00.000Z",18,FALSE,25,38017700,"G",18,18,"Minnesota Timberwolves","Wendell Moore Jr.",2,4,4,4,0,10
0,0,0,0,0,0,0,0,0,"00",0,0,0,0,0,0,1038130,"2024-01-12T00:00:00.000Z",18,FALSE,25,17895968,"F",18,18,"Minnesota Timberwolves","Daishen Nix",0,0,0,0,0,0
1,0,2,6,2,10,5,5,2,"21",0,2,14,2,2,0,1038130,"2024-01-12T00:00:00.000Z",18,FALSE,25,667378,"F-C",18,18,"Minnesota Timberwolves","Naz Reid",2,16,17,15,3,23.9
0,0,0,0,0,0,0,0,0,"00",0,0,0,0,0,0,1038130,"2024-01-12T00:00:00.000Z",18,FALSE,25,56677851,"G",18,18,"Minnesota Timberwolves","Jaylen Clark",0,0,0,0,0,0
0,0,0,0,0,0,0,0,0,"00",0,0,0,0,0,0,1038130,"2024-01-12T00:00:00.000Z",18,FALSE,25,17896056,"C",18,18,"Minnesota Timberwolves","Luka Garza",0,0,0,0,0,0
0,1,3,3,1,8,5,4,3,"25",2,1,14,5,0,3,1038130,"2024-01-12T00:00:00.000Z",18,FALSE,25,56677850,"F",25,25,"Portland Trail Blazers","Toumani Camara",1,19,19,14,5,20
1,0,0,7,2,15,4,3,3,"31",0,3,13,0,2,0,1038130,"2024-01-12T00:00:00.000Z",18,FALSE,25,182,"F",25,25,"Portland Trail Blazers","Jerami Grant",2,13,14,14,1,20.5
0,1,3,6,2,14,6,3,0,"24",3,4,14,6,1,1,1038130,"2024-01-12T00:00:00.000Z",18,FALSE,25,56783340,"C",25,25,"Portland Trail Blazers","Duop Reath",2,20,20,14,6,26.2
4,0,2,0,0,4,3,7,2,"25",0,2,8,2,0,6,1038130,"2024-01-12T00:00:00.000Z",18,FALSE,25,56677747,"G",25,25,"Portland Trail Blazers","Scoot Henderson",0,10,14,12,6,10.4
2,1,0,1,1,1,1,0,0,"09",0,0,3,0,1,0,1038130,"2024-01-12T00:00:00.000Z",18,FALSE,25,47957121,"F",25,25,"Portland Trail Blazers","Justin Minaya",2,3,5,5,2,12
1,0,0,0,0,1,0,2,2,"09",0,0,2,0,1,0,1038130,"2024-01-12T00:00:00.000Z",18,FALSE,25,56677791,"F",25,25,"Portland Trail Blazers","Kris Murray",1,2,3,3,1,6.5
1,0,1,0,0,2,1,2,1,"07",0,0,3,1,0,0,1038130,"2024-01-12T00:00:00.000Z",18,FALSE,25,56677829,"G-F",25,25,"Portland Trail Blazers","Rayan Rupert",0,4,5,4,2,5.7
0,0,1,2,1,3,1,0,0,"14",0,1,3,1,2,0,1038130,"2024-01-12T00:00:00.000Z",18,FALSE,25,666923,"G-F",25,25,"Portland Trail Blazers","Matisse Thybulle",2,4,4,3,1,10.2
3,0,11,2,1,11,6,4,4,"32",2,4,17,13,1,4,1038130,"2024-01-12T00:00:00.000Z",18,FALSE,25,38017711,"F",25,25,"Portland Trail Blazers","Jabari Walker",1,30,33,20,16,36.1
0,0,0,0,0,0,0,0,0,"00",0,0,0,0,0,0,1038130,"2024-01-12T00:00:00.000Z",18,FALSE,25,22,"C",25,25,"Portland Trail Blazers","Deandre Ayton",0,0,0,0,0,0
0,0,0,0,0,0,0,0,0,"00",0,0,0,0,0,0,1038130,"2024-01-12T00:00:00.000Z",18,FALSE,25,666476,"C",25,25,"Portland Trail Blazers","Moses Brown",0,0,0,0,0,0
0,0,0,0,0,0,0,0,0,"00",0,0,0,0,0,0,1038130,"2024-01-12T00:00:00.000Z",18,FALSE,25,38017690,"G",25,25,"Portland Trail Blazers","Shaedon Sharpe",0,0,0,0,0,0
0,0,0,0,0,0,0,0,0,"00",0,0,0,0,0,0,1038130,"2024-01-12T00:00:00.000Z",18,FALSE,25,476,"C-F",25,25,"Portland Trail Blazers","Robert Williams III",0,0,0,0,0,0
3,1,2,2,0,10,0,5,5,"29",0,0,5,2,0,3,1038130,"2024-01-12T00:00:00.000Z",18,FALSE,25,419,"G",25,25,"Portland Trail Blazers","Anfernee Simons",1,7,10,8,5,11.9
0,1,3,0,0,1,1,0,0,"09",3,3,2,6,0,1,1038130,"2024-01-12T00:00:00.000Z",18,FALSE,25,39613724,"C",25,25,"Portland Trail Blazers","Ibou Badji",1,8,8,2,6,11.2
3,0,2,5,2,7,2,4,3,"26",0,1,9,2,0,1,1038130,"2024-01-12T00:00:00.000Z",18,FALSE,25,65,"G",25,25,"Portland Trail Blazers","Malcolm Brogdon",0,11,14,12,5,14.9
1,1,9,5,2,12,8,3,2,"33",1,2,20,10,1,1,1038131,"2024-01-12T00:00:00.000Z",8,FALSE,19,375,"F",8,8,"Denver Nuggets","Michael Porter Jr.",2,30,31,21,11,38.5
2,0,2,2,0,12,7,3,1,"31",3,2,15,5,0,2,1038131,"2024-01-12T00:00:00.000Z",8,FALSE,19,177,"F",8,8,"Denver Nuggets","Aaron Gordon",0,20,22,17,7,22
14,1,7,2,1,17,11,4,4,"32",3,4,27,10,0,2,1038131,"2024-01-12T00:00:00.000Z",8,FALSE,19,246,"C",8,8,"Denver Nuggets","Nikola Jokic",1,37,51,41,24,61
3,0,2,6,3,9,4,0,0,"31",0,0,11,2,2,0,1038131,"2024-01-12T00:00:00.000Z",8,FALSE,19,81,"G",8,8,"Denver Nuggets","Kentavious Caldwell-Pope",2,13,16,14,5,23.9
9,0,2,5,3,15,8,1,1,"34",0,3,20,2,0,2,1038131,"2024-01-12T00:00:00.000Z",8,FALSE,19,335,"G",8,8,"Denver Nuggets","Jamal Murray",0,22,31,29,11,33.9
0,0,5,4,1,4,1,2,1,"17",1,2,4,6,0,3,1038131,"2024-01-12T00:00:00.000Z",8,FALSE,19,38017709,"G",8,8,"Denver Nuggets","Christian Braun",0,10,10,4,6,8.2
0,0,0,0,0,1,1,0,0,"02",0,1,2,0,0,0,1038131,"2024-01-12T00:00:00.000Z",8,FALSE,19,38017727,"G",8,8,"Denver Nuggets","Collin Gillespie",0,2,2,2,0,2
0,0,0,0,0,0,0,0,0,"02",0,0,0,0,0,1,1038131,"2024-01-12T00:00:00.000Z",8,FALSE,19,215,"F-G",8,8,"Denver Nuggets","Justin Holiday",0,0,0,0,0,-1
0,0,1,0,0,0,0,0,0,"02",0,1,0,1,0,0,1038131,"2024-01-12T00:00:00.000Z",8,FALSE,19,17896103,"F-C",8,8,"Denver Nuggets","Jay Huff",0,1,1,0,1,1.2
0,0,0,0,0,0,0,0,0,"02",0,0,0,0,0,0,1038131,"2024-01-12T00:00:00.000Z",8,FALSE,19,56677837,"G",19,19,"New Orleans Pelicans","Jordan Hawkins",0,0,0,0,0,0
1,0,1,0,0,0,0,0,0,"02",0,0,0,1,0,0,1038131,"2024-01-12T00:00:00.000Z",8,FALSE,19,38017663,"F",19,19,"New Orleans Pelicans","E.J. Liddell",0,1,2,1,2,2.7
0,0,1,2,0,5,2,2,2,"12",1,0,6,2,0,0,1038131,"2024-01-12T00:00:00.000Z",8,FALSE,19,3547293,"F",19,19,"New Orleans Pelicans","Naji Marshall",0,8,8,6,2,8.4
0,0,2,5,2,10,5,0,0,"24",0,1,12,2,1,3,1038131,"2024-01-12T00:00:00.000Z",8,FALSE,19,236,"G",8,8,"Denver Nuggets","Reggie Jackson",1,14,14,12,2,14.4
1,1,6,0,0,2,2,2,2,"14",1,1,6,7,0,0,1038131,"2024-01-12T00:00:00.000Z",8,FALSE,19,250,"C",8,8,"Denver Nuggets","DeAndre Jordan",1,13,14,7,8,18.9
0,0,0,0,0,0,0,0,0,"01",0,0,0,0,0,1,1038131,"2024-01-12T00:00:00.000Z",8,FALSE,19,17896007,"G",8,8,"Denver Nuggets","Braxton Key",0,0,0,0,0,-1
0,0,0,0,0,1,0,0,0,"02",0,0,0,0,0,0,1038131,"2024-01-12T00:00:00.000Z",8,FALSE,19,3547268,"F-C",8,8,"Denver Nuggets","Zeke Nnaji",0,0,0,0,0,0
0,1,2,4,2,7,3,0,0,"15",1,1,8,3,1,0,1038131,"2024-01-12T00:00:00.000Z",8,FALSE,19,38017721,"G",8,8,"Denver Nuggets","Peyton Watson",2,11,11,8,3,17.6
0,0,0,0,0,0,0,0,0,"00",0,0,0,0,0,0,1038131,"2024-01-12T00:00:00.000Z",8,FALSE,19,666489,"F",8,8,"Denver Nuggets","Vlatko Cancar",0,0,0,0,0,0
0,0,0,0,0,0,0,0,0,"00",0,0,0,0,0,0,1038131,"2024-01-12T00:00:00.000Z",8,FALSE,19,56677582,"G",8,8,"Denver Nuggets","Jalen Pickett",0,0,0,0,0,0
0,0,0,0,0,0,0,0,0,"00",0,0,0,0,0,0,1038131,"2024-01-12T00:00:00.000Z",8,FALSE,19,56677776,"G",8,8,"Denver Nuggets","Julian Strawther",0,0,0,0,0,0
0,0,0,0,0,0,0,0,0,"00",0,0,0,0,0,0,1038131,"2024-01-12T00:00:00.000Z",8,FALSE,19,56677871,"F",8,8,"Denver Nuggets","Hunter Tyson",0,0,0,0,0,0
6,0,4,1,0,11,4,2,1,"34",0,2,9,4,0,2,1038131,"2024-01-12T00:00:00.000Z",8,FALSE,19,227,"F",19,19,"New Orleans Pelicans","Brandon Ingram",0,13,19,15,10,20.8
5,1,4,0,0,22,13,6,4,"35",2,1,30,6,0,1,1038131,"2024-01-12T00:00:00.000Z",8,FALSE,19,666969,"F",19,19,"New Orleans Pelicans","Zion Williamson",1,36,41,35,11,46.7
1,0,4,3,1,11,5,6,6,"26",2,3,17,6,0,0,1038131,"2024-01-12T00:00:00.000Z",8,FALSE,19,455,"C",19,19,"New Orleans Pelicans","Jonas Valanciunas",0,23,24,18,7,25.7
1,1,1,2,2,4,3,0,0,"19",0,1,8,1,0,1,1038131,"2024-01-12T00:00:00.000Z",8,FALSE,19,17896024,"F",19,19,"New Orleans Pelicans","Herbert Jones",1,9,10,9,2,12.7
7,0,5,8,3,10,4,2,1,"30",0,2,12,5,1,2,1038131,"2024-01-12T00:00:00.000Z",8,FALSE,19,303,"G",19,19,"New Orleans Pelicans","CJ McCollum",1,17,24,19,12,29.5
1,0,0,3,2,7,3,2,2,"17",1,0,10,1,1,1,1038131,"2024-01-12T00:00:00.000Z",8,FALSE,19,17896097,"G",19,19,"New Orleans Pelicans","Jose Alvarado",1,11,12,11,2,14.7
3,0,2,2,0,4,1,2,0,"15",2,0,2,4,3,0,1038131,"2024-01-12T00:00:00.000Z",8,FALSE,19,38017677,"G",19,19,"New Orleans Pelicans","Dyson Daniels",3,6,9,5,7,20.3
4,0,3,8,2,9,2,0,0,"28",0,0,6,3,2,0,1038131,"2024-01-12T00:00:00.000Z",8,FALSE,19,18677986,"F",19,19,"New Orleans Pelicans","Trey Murphy III",2,9,13,10,7,21.6
1,1,2,4,3,6,5,0,0,"20",0,1,13,2,2,1,1038131,"2024-01-12T00:00:00.000Z",8,FALSE,19,340,"F",19,19,"New Orleans Pelicans","Larry Nance Jr.",3,15,16,14,3,24.9
0,0,0,0,0,0,0,0,0,"00",0,0,0,0,0,0,1038131,"2024-01-12T00:00:00.000Z",8,FALSE,19,491,"C",19,19,"New Orleans Pelicans","Cody Zeller",0,0,0,0,0,0
0,0,0,0,0,0,0,0,0,"00",0,0,0,0,0,0,1038131,"2024-01-12T00:00:00.000Z",8,FALSE,19,3547260,"G",19,19,"New Orleans Pelicans","Kira Lewis Jr.",0,0,0,0,0,0
0,0,0,0,0,0,0,0,0,"00",0,0,0,0,0,0,1038131,"2024-01-12T00:00:00.000Z",8,FALSE,19,17896021,"F",19,19,"New Orleans Pelicans","Jeremiah Robinson-Earl",0,0,0,0,0,0
0,0,0,0,0,0,0,0,0,"00",0,0,0,0,0,0,1038131,"2024-01-12T00:00:00.000Z",8,FALSE,19,17896017,"F",19,19,"New Orleans Pelicans","Matt Ryan",0,0,0,0,0,0
0,0,0,0,0,0,0,0,0,"00",0,0,0,0,0,0,1038131,"2024-01-12T00:00:00.000Z",8,FALSE,19,38017726,"G",19,19,"New Orleans Pelicans","Dereon Seabron",0,0,0,0,0,0
0,1,1,5,3,9,5,0,0,"23",1,0,13,2,0,0,1038132,"2024-01-12T00:00:00.000Z",29,FALSE,28,38017739,"F",29,29,"Utah Jazz","Simone Fontecchio",1,15,15,13,2,18.4
2,0,6,6,4,11,7,5,4,"29",3,2,22,9,1,3,1038132,"2024-01-12T00:00:00.000Z",29,FALSE,28,297,"F",29,29,"Utah Jazz","Lauri Markkanen",1,31,33,24,11,35.8
1,0,6,1,0,3,2,0,0,"14",1,4,4,7,0,1,1038132,"2024-01-12T00:00:00.000Z",29,FALSE,28,101,"F-C",29,29,"Utah Jazz","John Collins",0,11,12,5,8,12.9
5,0,2,3,3,10,5,8,7,"20",0,0,20,2,2,2,1038132,"2024-01-12T00:00:00.000Z",29,FALSE,28,413,"G",29,29,"Utah Jazz","Collin Sexton",2,22,27,25,7,33.9
5,2,3,1,0,4,3,0,0,"17",2,3,6,5,1,2,1038132,"2024-01-12T00:00:00.000Z",29,FALSE,28,139,"G",29,29,"Utah Jazz","Kris Dunn",3,11,16,11,10,26.5
1,2,4,7,2,8,3,0,0,"22",1,1,8,5,0,0,1038132,"2024-01-12T00:00:00.000Z",29,FALSE,28,38017620,"G",29,29,"Utah Jazz","Ochai Agbaji",2,13,14,9,6,21.5
5,0,1,9,5,16,8,0,0,"31",0,1,21,1,0,0,1038132,"2024-01-12T00:00:00.000Z",29,FALSE,28,100,"G",29,29,"Utah Jazz","Jordan Clarkson",0,22,27,26,6,29.7
6,0,3,5,0,10,3,3,3,"24",0,0,9,3,0,3,1038132,"2024-01-12T00:00:00.000Z",29,FALSE,28,56677834,"G",29,29,"Utah Jazz","Keyonte George",0,12,18,15,9,18.6
1,0,1,2,2,2,2,0,0,"04",0,1,6,1,1,0,1038132,"2024-01-12T00:00:00.000Z",29,FALSE,28,56677824,"F",29,29,"Utah Jazz","Taylor Hendricks",1,7,8,7,2,11.7
0,0,0,0,0,0,0,0,0,"00",0,0,0,0,0,0,1038132,"2024-01-12T00:00:00.000Z",29,FALSE,28,666650,"G",29,29,"Utah Jazz","Talen Horton-Tucker",0,0,0,0,0,0
1,3,4,0,0,5,5,4,2,"20",2,4,12,6,1,0,1038132,"2024-01-12T00:00:00.000Z",29,FALSE,28,38017705,"C",29,29,"Utah Jazz","Walker Kessler",4,18,19,13,7,32.7
5,0,8,2,1,7,4,4,2,"21",2,3,11,10,1,1,1038132,"2024-01-12T00:00:00.000Z",29,FALSE,28,358,"F",29,29,"Utah Jazz","Kelly Olynyk",1,21,26,16,15,32.5
0,0,1,0,0,2,1,2,2,"06",0,2,4,1,0,1,1038132,"2024-01-12T00:00:00.000Z",29,FALSE,28,666881,"F",29,29,"Utah Jazz","Luka Samanic",0,5,5,4,1,4.2
2,0,0,2,1,4,2,0,0,"04",0,1,5,0,0,0,1038132,"2024-01-12T00:00:00.000Z",29,FALSE,28,56677842,"F",29,29,"Utah Jazz","Brice Sensabaugh",0,5,7,7,2,8
0,0,2,0,0,2,2,0,0,"05",2,1,4,4,0,0,1038132,"2024-01-12T00:00:00.000Z",29,FALSE,28,11891374,"C",29,29,"Utah Jazz","Omer Yurtseven",0,8,8,4,4,8.8
0,0,0,0,0,0,0,0,0,"00",0,0,0,0,0,0,1038132,"2024-01-12T00:00:00.000Z",29,FALSE,28,38017630,"G",29,29,"Utah Jazz","Johnny Juzang",0,0,0,0,0,0
0,0,0,0,0,0,0,0,0,"00",0,0,0,0,0,0,1038132,"2024-01-12T00:00:00.000Z",29,FALSE,28,19465584,"F",29,29,"Utah Jazz","Micah Potter",0,0,0,0,0,0
0,0,0,0,0,0,0,0,0,"00",0,0,0,0,0,0,1038132,"2024-01-12T00:00:00.000Z",29,FALSE,28,17896042,"G",13,29,"Utah Jazz","Jason Preston",0,0,0,0,0,0
2,3,7,2,0,9,2,0,0,"30",0,4,4,7,1,2,1038132,"2024-01-12T00:00:00.000Z",29,FALSE,28,666423,"F-G",20,28,"Toronto Raptors","RJ Barrett",4,11,13,6,9,25.4
2,0,4,6,5,14,8,8,6,"30",0,1,27,4,0,2,1038132,"2024-01-12T00:00:00.000Z",29,FALSE,28,416,"F",28,28,"Toronto Raptors","Pascal Siakam",0,31,33,29,6,32.8
2,0,2,0,0,1,0,0,0,"12",0,5,0,2,0,0,1038132,"2024-01-12T00:00:00.000Z",29,FALSE,28,489,"F",28,28,"Toronto Raptors","Thaddeus Young",0,2,4,2,4,5.4
3,3,2,4,2,13,6,11,5,"28",1,3,19,3,0,3,1038132,"2024-01-12T00:00:00.000Z",29,FALSE,28,17896055,"G-F",28,28,"Toronto Raptors","Scottie Barnes",3,22,25,22,6,33.1
0,0,2,3,3,8,4,4,4,"25",1,1,15,3,0,1,1038132,"2024-01-12T00:00:00.000Z",29,FALSE,28,3547269,"G",20,28,"Toronto Raptors","Immanuel Quickley",0,18,18,15,3,17.6
0,0,0,3,1,4,2,2,2,"12",0,1,7,0,0,1,1038132,"2024-01-12T00:00:00.000Z",29,FALSE,28,58,"F",28,28,"Toronto Raptors","Chris Boucher",0,7,7,7,0,6
2,0,1,2,0,3,0,0,0,"12",0,1,0,1,0,0,1038132,"2024-01-12T00:00:00.000Z",29,FALSE,28,56677828,"G",28,28,"Toronto Raptors","Gradey Dick",0,1,3,2,3,4.2
0,0,1,0,0,5,4,10,7,"08",2,0,15,3,1,1,1038132,"2024-01-12T00:00:00.000Z",29,FALSE,28,666762,"F",28,28,"Toronto Raptors","Jalen McDaniels",1,18,18,15,3,20.6
6,2,4,4,1,8,3,2,2,"31",2,1,9,6,2,0,1038132,"2024-01-12T00:00:00.000Z",29,FALSE,28,2309958,"C-F",15,28,"Toronto Raptors","Jontay Porter",4,15,21,15,12,37.2
4,0,0,7,4,9,4,0,0,"23",0,2,12,0,1,1,1038132,"2024-01-12T00:00:00.000Z",29,FALSE,28,409,"G",28,28,"Toronto Raptors","Dennis Schroder",1,12,16,16,4,20
2,0,0,1,0,1,0,0,0,"07",1,1,0,1,0,1,1038132,"2024-01-12T00:00:00.000Z",29,FALSE,28,436,"G-F",28,28,"Toronto Raptors","Garrett Temple",0,1,3,2,3,3.2
2,0,0,2,1,6,2,0,0,"22",1,1,5,1,0,1,1038132,"2024-01-12T00:00:00.000Z",29,FALSE,28,3089,"",28,28,"Toronto Raptors","Gary Trent Jr.",0,6,8,7,3,8.2
0,0,0,0,0,0,0,0,0,"00",0,0,0,0,0,0,1038132,"2024-01-12T00:00:00.000Z",29,FALSE,28,56677805,"G",28,28,"Toronto Raptors","Javon Freeman-Liberty",0,0,0,0,0,0
0,0,0,0,0,0,0,0,0,"00",0,0,0,0,0,0,1038132,"2024-01-12T00:00:00.000Z",29,FALSE,28,38017710,"C",28,28,"Toronto Raptors","Christian Koloko",0,0,0,0,0,0
0,0,0,0,0,0,0,0,0,"00",0,0,0,0,0,0,1038132,"2024-01-12T00:00:00.000Z",29,FALSE,28,56677869,"G",28,28,"Toronto Raptors","Markquis Nowell",0,0,0,0,0,0
0,0,0,0,0,0,0,0,0,"00",0,0,0,0,0,0,1038132,"2024-01-12T00:00:00.000Z",29,FALSE,28,373,"C",28,28,"Toronto Raptors","Jakob Poeltl",0,0,0,0,0,0
0,0,0,0,0,0,0,0,0,"00",0,0,0,0,0,0,1038132,"2024-01-12T00:00:00.000Z",29,FALSE,28,376,"F",28,28,"Toronto Raptors","Otto Porter Jr.",0,0,0,0,0,0
4,1,6,2,1,7,5,3,2,"25",0,0,13,6,2,1,1038133,"2024-01-12T00:00:00.000Z",27,FALSE,4,38017699,"F",27,27,"San Antonio Spurs","Jeremy Sochan",3,19,23,17,10,34.2
1,0,2,7,2,8,2,3,3,"20",0,2,9,2,0,1,1038133,"2024-01-12T00:00:00.000Z",27,FALSE,4,38017649,"F",27,27,"San Antonio Spurs","Julian Champagnie",0,11,12,10,3,11.9
1,2,8,3,2,14,9,6,6,"20",3,2,26,11,0,3,1038133,"2024-01-12T00:00:00.000Z",27,FALSE,4,56677822,"F-C",27,27,"San Antonio Spurs","Victor Wembanyama",2,37,38,27,12,43.7
5,0,3,3,1,10,4,3,3,"26",0,2,12,3,2,2,1038133,"2024-01-12T00:00:00.000Z",27,FALSE,4,3547246,"G-F",27,27,"San Antonio Spurs","Devin Vassell",2,15,20,17,8,27.1
7,0,3,1,0,4,2,2,2,"22",0,3,6,3,1,0,1038133,"2024-01-12T00:00:00.000Z",27,FALSE,4,3547274,"G",27,27,"San Antonio Spurs","Tre Jones",1,9,16,13,10,23.1
1,3,4,0,0,4,1,6,3,"17",2,2,5,6,0,0,1038133,"2024-01-12T00:00:00.000Z",27,FALSE,4,38017730,"F",27,27,"San Antonio Spurs","Dominick Barlow",3,11,12,6,7,22.7
4,0,2,3,2,7,3,0,0,"20",0,0,8,2,0,2,1038133,"2024-01-12T00:00:00.000Z",27,FALSE,4,38017692,"F",27,27,"San Antonio Spurs","Malaki Branham",0,10,14,12,6,14.4
1,0,0,0,0,3,3,2,2,"10",0,0,8,0,0,0,1038133,"2024-01-12T00:00:00.000Z",27,FALSE,4,3547163,"F",6,27,"San Antonio Spurs","Mamadi Diakite",0,8,9,9,1,9.5
2,0,0,4,2,5,3,0,0,"10",0,1,8,0,1,0,1038133,"2024-01-12T00:00:00.000Z",27,FALSE,4,180,"G",27,27,"San Antonio Spurs","Devonte' Graham",1,8,10,10,2,14
1,0,2,7,2,11,3,2,2,"19",0,2,10,2,1,2,1038133,"2024-01-12T00:00:00.000Z",27,FALSE,4,666682,"F",27,27,"San Antonio Spurs","Keldon Johnson",1,12,13,11,3,14.9
0,1,1,0,0,1,0,2,1,"10",1,1,1,2,0,0,1038133,"2024-01-12T00:00:00.000Z",27,FALSE,4,17896059,"F",27,27,"San Antonio Spurs","Sandro Mamukelashvili",1,3,3,1,2,6.4
0,0,2,6,4,6,4,3,2,"11",0,0,14,2,0,0,1038133,"2024-01-12T00:00:00.000Z",27,FALSE,4,305,"F",27,27,"San Antonio Spurs","Doug McDermott",0,16,16,14,2,16.4
1,0,3,2,2,4,4,2,1,"14",1,2,11,4,1,3,1038133,"2024-01-12T00:00:00.000Z",27,FALSE,4,359,"F",27,27,"San Antonio Spurs","Cedi Osman",1,15,16,12,5,17.3
1,0,0,1,0,5,0,2,1,"09",2,1,1,2,1,1,1038133,"2024-01-12T00:00:00.000Z",27,FALSE,4,56677823,"F",4,4,"Charlotte Hornets","Brandon Miller",1,3,4,2,3,6.9
0,0,8,4,1,13,4,5,5,"33",1,1,14,9,1,1,1038133,"2024-01-12T00:00:00.000Z",27,FALSE,4,62,"F",4,4,"Charlotte Hornets","Miles Bridges",1,23,23,14,9,26.8
1,1,3,0,0,8,5,2,2,"22",5,3,12,8,0,0,1038133,"2024-01-12T00:00:00.000Z",27,FALSE,4,3547282,"C",4,4,"Charlotte Hornets","Nick Richards",1,20,21,13,9,26.1
5,0,3,9,3,14,5,16,15,"27",0,4,28,3,5,6,1038133,"2024-01-12T00:00:00.000Z",27,FALSE,4,3547239,"G",4,4,"Charlotte Hornets","LaMelo Ball",5,31,36,33,8,48.1
2,1,2,9,3,14,6,2,1,"28",0,2,16,2,2,1,1038133,"2024-01-12T00:00:00.000Z",27,FALSE,4,403,"G",4,4,"Charlotte Hornets","Terry Rozier",3,18,20,18,4,29.4
6,0,2,0,0,4,0,0,0,"22",0,0,0,2,1,2,1038133,"2024-01-12T00:00:00.000Z",27,FALSE,4,422,"G",4,4,"Charlotte Hornets","Ish Smith",1,2,8,6,8,12.4
0,0,2,3,1,7,2,0,0,"19",2,3,5,4,0,1,1038133,"2024-01-12T00:00:00.000Z",27,FALSE,4,18678001,"F",4,4,"Charlotte Hornets","JT Thor",0,9,9,5,4,8.8
0,0,0,0,0,0,0,0,0,"00",0,0,0,0,0,0,1038133,"2024-01-12T00:00:00.000Z",27,FALSE,4,204,"F",4,4,"Charlotte Hornets","Gordon Hayward",0,0,0,0,0,0
0,0,0,0,0,0,0,0,0,"00",0,0,0,0,0,0,1038133,"2024-01-12T00:00:00.000Z",27,FALSE,4,347,"G",4,4,"Charlotte Hornets","Frank Ntilikina",0,0,0,0,0,0
0,0,0,0,0,0,0,0,0,"00",0,0,0,0,0,0,1038133,"2024-01-12T00:00:00.000Z",27,FALSE,4,666950,"F",4,4,"Charlotte Hornets","P.J. Washington",0,0,0,0,0,0
0,0,0,0,0,0,0,0,0,"00",0,0,0,0,0,0,1038133,"2024-01-12T00:00:00.000Z",27,FALSE,4,38017698,"C",4,4,"Charlotte Hornets","Mark Williams",0,0,0,0,0,0
3,0,2,0,0,3,2,0,0,"16",0,3,4,2,1,0,1038133,"2024-01-12T00:00:00.000Z",27,FALSE,4,38017693,"G",27,27,"San Antonio Spurs","Blake Wesley",1,6,9,7,5,13.9
0,0,0,0,0,0,0,0,0,"00",0,0,0,0,0,0,1038133,"2024-01-12T00:00:00.000Z",27,FALSE,4,17895854,"G",27,27,"San Antonio Spurs","Charles Bassey",0,0,0,0,0,0
0,0,0,0,0,0,0,0,0,"00",0,0,0,0,0,0,1038133,"2024-01-12T00:00:00.000Z",27,FALSE,4,56677817,"G",27,27,"San Antonio Spurs","Sidy Cissoko",0,0,0,0,0,0
0,0,0,0,0,0,0,0,0,"00",0,0,0,0,0,0,1038133,"2024-01-12T00:00:00.000Z",27,FALSE,4,102,"F-C",27,27,"San Antonio Spurs","Zach Collins",0,0,0,0,0,0
0,0,0,0,0,0,0,0,0,"00",0,0,0,0,0,0,1038133,"2024-01-12T00:00:00.000Z",27,FALSE,4,17896049,"G",3,27,"San Antonio Spurs","David Duke Jr.",0,0,0,0,0,0
2,0,3,0,0,4,0,0,0,"19",4,6,0,7,0,2,1038133,"2024-01-12T00:00:00.000Z",27,FALSE,4,NA,NA,NA,4,"Charlotte Hornets","NA NA",0,7,9,2,9,9.4
0,0,0,1,0,2,1,0,0,"07",0,1,2,0,0,0,1038133,"2024-01-12T00:00:00.000Z",27,FALSE,4,56677866,"F",4,4,"Charlotte Hornets","Leaky Black",0,2,2,2,0,2
5,0,4,3,1,9,4,0,0,"24",2,2,9,6,0,1,1038133,"2024-01-12T00:00:00.000Z",27,FALSE,4,56677846,"G",4,4,"Charlotte Hornets","Nick Smith Jr.",0,15,20,14,11,22.7
0,1,1,2,0,2,0,0,0,"06",0,0,0,1,0,0,1038133,"2024-01-12T00:00:00.000Z",27,FALSE,4,17896037,"G",4,4,"Charlotte Hornets","James Bouknight",1,1,1,0,1,4.2
0,0,0,0,0,0,0,0,0,"00",0,0,0,0,0,0,1038133,"2024-01-12T00:00:00.000Z",27,FALSE,4,666748,"F",4,4,"Charlotte Hornets","Cody Martin",0,0,0,0,0,0
0,0,0,2,1,7,5,1,1,"24",0,1,12,0,1,4,1038133,"2024-01-12T00:00:00.000Z",27,FALSE,4,38017708,"G",4,4,"Charlotte Hornets","Bryce McGowens",1,12,12,12,0,11
0,0,0,0,0,0,0,0,0,"00",0,0,0,0,0,0,1038133,"2024-01-12T00:00:00.000Z",27,FALSE,4,56677848,"G",4,4,"Charlotte Hornets","Amari Bailey",0,0,0,0,0,0
1,0,6,3,1,5,2,2,2,"32",2,2,7,8,1,1,1038127,"2024-01-12T00:00:00.000Z",16,FALSE,22,3092,"",16,16,"Miami Heat","Haywood Highsmith",1,15,16,8,9,20.1
4,0,3,4,1,8,1,2,1,"25",0,2,4,3,0,2,1038127,"2024-01-12T00:00:00.000Z",16,FALSE,22,38017696,"F",16,16,"Miami Heat","Nikola Jovic",0,7,11,8,7,11.6
7,1,7,0,0,17,8,6,5,"39",4,3,21,11,0,4,1038127,"2024-01-12T00:00:00.000Z",16,FALSE,22,4,"C-F",16,16,"Miami Heat","Bam Adebayo",1,32,39,28,18,43.7
3,0,3,10,4,19,9,1,1,"42",1,1,23,4,1,3,1038127,"2024-01-12T00:00:00.000Z",16,FALSE,22,397,"F",16,16,"Miami Heat","Duncan Robinson",1,27,30,26,7,32.3
3,0,3,2,0,16,8,3,3,"37",4,3,19,7,1,3,1038127,"2024-01-12T00:00:00.000Z",16,FALSE,22,56677785,"G",16,16,"Miami Heat","Jaime Jaquez Jr.",1,26,29,22,10,31.9
0,0,0,0,0,0,0,0,0,"00",0,0,0,0,0,0,1038127,"2024-01-12T00:00:00.000Z",16,FALSE,22,74,"C",16,16,"Miami Heat","Thomas Bryant",0,0,0,0,0,0
0,0,0,0,0,0,0,0,0,"00",0,0,0,0,0,0,1038127,"2024-01-12T00:00:00.000Z",16,FALSE,22,38017734,"F",16,16,"Miami Heat","Jamal Cain",0,0,0,0,0,0
0,0,0,0,0,0,0,0,0,"00",0,0,0,0,0,0,1038127,"2024-01-12T00:00:00.000Z",16,FALSE,22,3547257,"G",16,16,"Miami Heat","R.J. Hampton",0,0,0,0,0,0
1,0,2,4,1,6,2,1,0,"16",1,3,5,3,1,1,1038127,"2024-01-12T00:00:00.000Z",16,FALSE,22,285,"F-C",16,16,"Miami Heat","Kevin Love",1,8,9,6,4,12.1
2,0,4,2,1,6,3,4,4,"24",0,1,11,4,1,0,1038127,"2024-01-12T00:00:00.000Z",16,FALSE,22,666747,"F",16,16,"Miami Heat","Caleb Martin",1,15,17,13,6,21.8
2,0,1,1,0,6,4,1,1,"25",0,2,9,1,1,2,1038127,"2024-01-12T00:00:00.000Z",16,FALSE,22,391,"G-F",16,16,"Miami Heat","Josh Richardson",1,10,12,11,3,14.2
0,0,0,0,0,0,0,0,0,"00",0,0,0,0,0,0,1038127,"2024-01-12T00:00:00.000Z",16,FALSE,22,39398582,"C",16,16,"Miami Heat","Orlando Robinson",0,0,0,0,0,0
0,0,0,0,0,0,0,0,0,"00",0,0,0,0,0,0,1038127,"2024-01-12T00:00:00.000Z",16,FALSE,22,79,"G-F",16,16,"Miami Heat","Jimmy Butler",0,0,0,0,0,0
0,0,0,0,0,0,0,0,0,"00",0,0,0,0,0,0,1038127,"2024-01-12T00:00:00.000Z",16,FALSE,22,666633,"G",16,16,"Miami Heat","Tyler Herro",0,0,0,0,0,0
0,0,0,0,0,0,0,0,0,"00",0,0,0,0,0,0,1038127,"2024-01-12T00:00:00.000Z",16,FALSE,22,286,"G",16,16,"Miami Heat","Kyle Lowry",0,0,0,0,0,0
0,0,0,0,0,0,0,0,0,"00",0,0,0,0,0,0,1038127,"2024-01-12T00:00:00.000Z",16,FALSE,22,19465585,"G",16,16,"Miami Heat","Dru Smith",0,0,0,0,0,0
0,0,0,0,0,0,0,0,0,"00",0,0,0,0,0,0,1038127,"2024-01-12T00:00:00.000Z",16,FALSE,22,38017736,"F",16,16,"Miami Heat","Cole Swider",0,0,0,0,0,0
3,0,1,9,3,9,3,0,0,"32",1,4,9,2,0,0,1038127,"2024-01-12T00:00:00.000Z",16,FALSE,22,38017724,"G",22,22,"Orlando Magic","Caleb Houstan",0,11,14,12,5,15.9
6,0,5,7,1,26,10,6,4,"36",3,2,25,8,0,4,1038127,"2024-01-12T00:00:00.000Z",16,FALSE,22,38017683,"F",22,22,"Orlando Magic","Paolo Banchero",0,33,39,31,14,39.6
1,1,9,0,0,1,1,2,0,"20",0,1,2,9,1,0,1038127,"2024-01-12T00:00:00.000Z",16,FALSE,22,666442,"C",22,22,"Orlando Magic","Goga Bitadze",2,11,12,3,10,20.3
0,0,0,0,0,0,0,0,0,"00",0,0,0,0,0,0,1038127,"2024-01-12T00:00:00.000Z",16,FALSE,22,666885,"F",22,22,"Orlando Magic","Admiral Schofield",0,0,0,0,0,0
0,0,0,0,0,0,0,0,0,"00",0,0,0,0,0,0,1038127,"2024-01-12T00:00:00.000Z",16,FALSE,22,17896026,"F",22,22,"Orlando Magic","Franz Wagner",0,0,0,0,0,0
0,3,0,4,0,5,1,0,0,"14",0,3,2,0,0,0,1038127,"2024-01-12T00:00:00.000Z",16,FALSE,22,17896073,"G",22,22,"Orlando Magic","Jalen Suggs",3,2,2,2,0,11
0,1,2,2,0,8,2,2,1,"27",1,1,5,3,2,0,1038127,"2024-01-12T00:00:00.000Z",16,FALSE,22,3547251,"G",22,22,"Orlando Magic","Cole Anthony",3,8,8,5,3,17.6
1,0,3,0,0,1,0,2,1,"09",0,0,1,3,1,0,1038127,"2024-01-12T00:00:00.000Z",16,FALSE,22,56677827,"G",22,22,"Orlando Magic","Anthony Black",1,4,5,2,4,9.1
0,0,0,0,0,0,0,0,0,"00",0,0,0,0,0,0,1038127,"2024-01-12T00:00:00.000Z",16,FALSE,22,85,"F",22,22,"Orlando Magic","Wendell Carter Jr.",0,0,0,0,0,0
3,1,1,0,0,2,1,2,1,"17",2,2,3,3,2,2,1038127,"2024-01-12T00:00:00.000Z",16,FALSE,22,165,"G",22,22,"Orlando Magic","Markelle Fultz",3,6,9,6,6,18.1
6,0,0,8,4,10,5,1,0,"20",0,2,14,0,3,2,1038127,"2024-01-12T00:00:00.000Z",16,FALSE,22,226,"F",22,22,"Orlando Magic","Joe Ingles",3,14,20,20,6,30
0,0,1,1,0,1,0,0,0,"07",0,0,0,1,0,1,1038127,"2024-01-12T00:00:00.000Z",16,FALSE,22,17553983,"G",22,22,"Orlando Magic","Trevelin Queen",0,1,1,0,1,0.2
4,1,4,1,0,9,7,5,5,"29",1,5,19,5,1,1,1038127,"2024-01-12T00:00:00.000Z",16,FALSE,22,462,"C",22,22,"Orlando Magic","Moritz Wagner",2,24,28,23,9,36
0,0,0,0,0,0,0,0,0,"00",0,0,0,0,0,0,1038127,"2024-01-12T00:00:00.000Z",16,FALSE,22,196,"G",22,22,"Orlando Magic","Gary Harris",0,0,0,0,0,0
0,0,0,0,0,0,0,0,0,"00",0,0,0,0,0,0,1038127,"2024-01-12T00:00:00.000Z",16,FALSE,22,38017607,"G",22,22,"Orlando Magic","Kevon Harris",0,0,0,0,0,0
0,0,0,0,0,0,0,0,0,"00",0,0,0,0,0,0,1038127,"2024-01-12T00:00:00.000Z",16,FALSE,22,56677839,"G",22,22,"Orlando Magic","Jett Howard",0,0,0,0,0,0
0,0,0,0,0,0,0,0,0,"00",0,0,0,0,0,0,1038127,"2024-01-12T00:00:00.000Z",16,FALSE,22,229,"F",22,22,"Orlando Magic","Jonathan Isaac",0,0,0,0,0,0
2,1,2,8,4,10,6,0,0,"29",2,0,16,4,0,1,1038127,"2024-01-12T00:00:00.000Z",16,FALSE,22,666818,"F",22,22,"Orlando Magic","Chuma Okeke",1,20,22,18,6,25.8
10,1,2,5,3,13,10,2,1,"33",1,2,24,3,1,3,1038137,"2024-01-13T00:00:00.000Z",17,FALSE,10,315,"F",17,17,"Milwaukee Bucks","Khris Middleton",2,27,37,34,13,45.6
5,0,5,3,1,22,13,8,6,"37",3,3,33,8,0,4,1038137,"2024-01-13T00:00:00.000Z",17,FALSE,10,15,"F",17,17,"Milwaukee Bucks","Giannis Antetokounmpo",0,41,46,38,13,46.1
6,2,6,5,1,9,5,0,0,"34",2,1,11,8,0,1,1038137,"2024-01-13T00:00:00.000Z",17,FALSE,10,283,"C",17,17,"Milwaukee Bucks","Brook Lopez",2,19,25,17,14,34.6
1,0,2,6,3,8,4,0,0,"28",2,1,11,4,2,1,1038137,"2024-01-13T00:00:00.000Z",17,FALSE,10,38,"G",17,17,"Milwaukee Bucks","Malik Beasley",2,15,16,12,5,22.3
7,0,6,5,2,19,9,7,7,"38",0,1,27,6,2,1,1038137,"2024-01-13T00:00:00.000Z",17,FALSE,10,278,"G",17,17,"Milwaukee Bucks","Damian Lillard",2,33,40,34,13,49.7
0,0,0,0,0,0,0,0,0,"00",0,0,0,0,0,0,1038137,"2024-01-13T00:00:00.000Z",17,FALSE,10,2148,"",17,17,"Milwaukee Bucks","Thanasis Antetokounmpo",0,0,0,0,0,0
0,0,0,0,0,0,0,0,0,"00",0,0,0,0,0,0,1038137,"2024-01-13T00:00:00.000Z",17,FALSE,10,38017676,"F",17,17,"Milwaukee Bucks","MarJon Beauchamp",0,0,0,0,0,0
2,1,2,3,1,4,1,0,0,"21",0,1,3,2,1,0,1038137,"2024-01-13T00:00:00.000Z",17,FALSE,10,105,"G",17,17,"Milwaukee Bucks","Pat Connaughton",2,5,7,5,4,14.4
0,0,0,0,0,0,0,0,0,"00",0,0,0,0,0,0,1038137,"2024-01-13T00:00:00.000Z",17,FALSE,10,38017733,"G",17,17,"Milwaukee Bucks","A.J. Green",0,0,0,0,0,0
2,1,4,0,0,8,5,0,0,"27",6,1,10,10,0,1,1038137,"2024-01-13T00:00:00.000Z",17,FALSE,10,56677852,"G",17,17,"Milwaukee Bucks","Andre Jackson Jr.",1,20,22,12,12,27
0,0,8,4,2,11,4,0,0,"21",0,5,10,8,0,1,1038137,"2024-01-13T00:00:00.000Z",17,FALSE,10,377,"F",17,17,"Milwaukee Bucks","Bobby Portis",0,18,18,10,8,18.6
0,0,0,0,0,0,0,0,0,"00",0,0,0,0,0,0,1038137,"2024-01-13T00:00:00.000Z",17,FALSE,10,17896070,"F",10,10,"Golden State Warriors","Usman Garuba",0,0,0,0,0,0
0,0,0,0,0,0,0,0,0,"00",0,0,0,0,0,0,1038137,"2024-01-13T00:00:00.000Z",17,FALSE,10,185,"F",10,10,"Golden State Warriors","Draymond Green",0,0,0,0,0,0
1,2,2,0,0,8,6,2,0,"18",0,0,12,2,1,0,1038137,"2024-01-13T00:00:00.000Z",17,FALSE,10,56677799,"F",10,10,"Golden State Warriors","Trayce Jackson-Davis",3,14,15,13,3,24.9
2,0,3,2,1,2,1,0,0,"18",0,1,3,3,0,1,1038137,"2024-01-13T00:00:00.000Z",17,FALSE,10,251,"G",10,10,"Golden State Warriors","Cory Joseph",0,6,8,5,5,8.6
2,1,3,3,2,18,10,6,6,"30",0,2,28,3,1,0,1038137,"2024-01-13T00:00:00.000Z",17,FALSE,10,17553979,"F",10,10,"Golden State Warriors","Jonathan Kuminga",2,31,33,30,5,40.6
2,0,2,1,1,5,2,2,1,"18",2,2,6,4,0,1,1038137,"2024-01-13T00:00:00.000Z",17,FALSE,10,45658838,"G",10,10,"Golden State Warriors","Lester Quinones",0,10,12,8,6,12.8
0,0,0,0,0,0,0,0,0,"00",0,0,0,0,0,0,1038137,"2024-01-13T00:00:00.000Z",17,FALSE,10,398,"G",10,10,"Golden State Warriors","Jerome Robinson",0,0,0,0,0,0
0,0,0,0,0,0,0,0,0,"00",0,0,0,0,0,0,1038137,"2024-01-13T00:00:00.000Z",17,FALSE,10,115,"G",10,10,"Golden State Warriors","Stephen Curry",0,0,0,0,0,0
0,0,0,0,0,0,0,0,0,"00",0,0,0,0,0,0,1038137,"2024-01-13T00:00:00.000Z",17,FALSE,10,17553992,"G",10,10,"Golden State Warriors","Moses Moody",0,0,0,0,0,0
0,0,0,0,0,0,0,0,0,"00",0,0,0,0,0,0,1038137,"2024-01-13T00:00:00.000Z",17,FALSE,10,367,"G",10,10,"Golden State Warriors","Chris Paul",0,0,0,0,0,0
0,0,0,0,0,0,0,0,0,"00",0,0,0,0,0,0,1038137,"2024-01-13T00:00:00.000Z",17,FALSE,10,2189,"",10,10,"Golden State Warriors","Gary Payton II",0,0,0,0,0,0
0,0,0,0,0,0,0,0,0,"00",0,0,0,0,0,0,1038137,"2024-01-13T00:00:00.000Z",17,FALSE,10,57875092,"F",10,10,"Golden State Warriors","Gui Santos",0,0,0,0,0,0
0,0,0,0,0,0,0,0,0,"00",0,0,0,0,0,0,1038137,"2024-01-13T00:00:00.000Z",17,FALSE,10,112,"F",17,17,"Milwaukee Bucks","Jae Crowder",0,0,0,0,0,0
1,0,1,2,1,12,3,0,0,"32",3,3,7,4,0,0,1038137,"2024-01-13T00:00:00.000Z",17,FALSE,10,475,"F-G",10,10,"Golden State Warriors","Andrew Wiggins",0,11,12,8,5,13.3
6,0,6,5,1,9,5,2,1,"34",0,1,12,6,1,3,1038137,"2024-01-13T00:00:00.000Z",17,FALSE,10,407,"F",10,10,"Golden State Warriors","Dario Saric",1,18,24,18,12,28.2
3,1,2,0,0,6,3,0,0,"18",4,2,6,6,0,0,1038137,"2024-01-13T00:00:00.000Z",17,FALSE,10,282,"F",10,10,"Golden State Warriors","Kevon Looney",1,12,15,9,9,20.7
3,0,1,17,6,23,7,1,1,"36",2,2,21,3,0,2,1038137,"2024-01-13T00:00:00.000Z",17,FALSE,10,443,"G",10,10,"Golden State Warriors","Klay Thompson",0,24,27,24,6,27.1
3,0,9,5,3,14,10,1,0,"36",1,3,23,10,2,1,1038137,"2024-01-13T00:00:00.000Z",17,FALSE,10,56677858,"G",10,10,"Golden State Warriors","Brandin Podziemski",2,33,36,26,13,44.5
0,0,0,0,0,0,0,0,0,"01",0,0,0,0,0,0,1038137,"2024-01-13T00:00:00.000Z",17,FALSE,10,56677854,"F",17,17,"Milwaukee Bucks","Chris Livingston",0,0,0,0,0,0
0,0,0,0,0,0,0,0,0,"00",0,0,0,0,0,0,1038137,"2024-01-13T00:00:00.000Z",17,FALSE,10,284,"C",17,17,"Milwaukee Bucks","Robin Lopez",0,0,0,0,0,0
0,0,0,0,0,0,0,0,0,"00",0,0,0,0,0,0,1038137,"2024-01-13T00:00:00.000Z",17,FALSE,10,368,"G",17,17,"Milwaukee Bucks","Cameron Payne",0,0,0,0,0,0
0,0,0,0,0,0,0,0,0,"00",0,0,0,0,0,0,1038137,"2024-01-13T00:00:00.000Z",17,FALSE,10,38017691,"G",17,17,"Milwaukee Bucks","TyTy Washington Jr.",0,0,0,0,0,0
2,1,2,5,2,8,4,2,2,"33",1,5,12,3,1,1,1038138,"2024-01-13T00:00:00.000Z",21,FALSE,22,666541,"G",21,21,"Oklahoma City Thunder","Luguentz Dort",2,15,17,14,5,23.6
2,0,4,3,1,16,7,1,1,"33",2,1,16,6,0,2,1038138,"2024-01-13T00:00:00.000Z",21,FALSE,22,38017703,"G-F",21,21,"Oklahoma City Thunder","Jalen Williams",0,22,24,18,8,24.2
3,2,6,5,1,14,7,0,0,"32",2,0,15,8,1,2,1038138,"2024-01-13T00:00:00.000Z",21,FALSE,22,38017685,"C-F",21,21,"Oklahoma City Thunder","Chet Holmgren",3,23,26,18,11,36.1
4,0,7,5,1,12,4,4,3,"27",1,1,12,8,1,0,1038138,"2024-01-13T00:00:00.000Z",21,FALSE,22,17896065,"G",21,21,"Oklahoma City Thunder","Josh Giddey",1,20,24,16,12,30.6
7,1,4,4,0,20,13,12,11,"36",2,2,37,6,3,0,1038138,"2024-01-13T00:00:00.000Z",21,FALSE,22,175,"G",21,21,"Oklahoma City Thunder","Shai Gilgeous-Alexander",4,43,50,44,13,66.7
0,0,0,0,0,0,0,0,0,"00",0,0,0,0,0,0,1038138,"2024-01-13T00:00:00.000Z",21,FALSE,22,44,"F",21,21,"Oklahoma City Thunder","Davis Bertans",0,0,0,0,0,0
1,3,4,3,0,6,3,1,1,"17",0,2,7,4,0,2,1038138,"2024-01-13T00:00:00.000Z",21,FALSE,22,17553983,"G",22,22,"Orlando Magic","Trevelin Queen",3,11,12,8,5,20.3
0,0,0,0,0,0,0,0,0,"00",0,0,0,0,0,0,1038138,"2024-01-13T00:00:00.000Z",21,FALSE,22,666885,"F",22,22,"Orlando Magic","Admiral Schofield",0,0,0,0,0,0
2,1,4,3,0,6,2,0,0,"18",0,1,4,4,0,3,1038138,"2024-01-13T00:00:00.000Z",21,FALSE,22,462,"C",22,22,"Orlando Magic","Moritz Wagner",1,8,10,6,6,11.8
0,0,0,0,0,0,0,0,0,"00",0,0,0,0,0,0,1038138,"2024-01-13T00:00:00.000Z",21,FALSE,22,165,"G",22,22,"Orlando Magic","Markelle Fultz",0,0,0,0,0,0
0,0,0,0,0,0,0,0,0,"00",0,0,0,0,0,0,1038138,"2024-01-13T00:00:00.000Z",21,FALSE,22,196,"G",22,22,"Orlando Magic","Gary Harris",0,0,0,0,0,0
0,0,0,0,0,0,0,0,0,"00",0,0,0,0,0,0,1038138,"2024-01-13T00:00:00.000Z",21,FALSE,22,38017607,"G",22,22,"Orlando Magic","Kevon Harris",0,0,0,0,0,0
0,0,1,2,0,2,0,0,0,"09",1,0,0,2,0,1,1038138,"2024-01-13T00:00:00.000Z",21,FALSE,22,38017716,"F",21,21,"Oklahoma City Thunder","Ousmane Dieng",0,2,2,0,2,1.4
1,0,2,4,1,8,4,0,0,"16",0,1,9,2,0,1,1038138,"2024-01-13T00:00:00.000Z",21,FALSE,22,3547272,"G",21,21,"Oklahoma City Thunder","Isaiah Joe",0,11,12,10,3,11.9
0,0,0,0,0,0,0,0,0,"00",0,0,0,0,0,0,1038138,"2024-01-13T00:00:00.000Z",21,FALSE,22,56677853,"F",21,21,"Oklahoma City Thunder","Keyontae Johnson",0,0,0,0,0,0
0,0,0,0,0,0,0,0,0,"00",0,0,0,0,0,0,1038138,"2024-01-13T00:00:00.000Z",21,FALSE,22,17896036,"G",21,21,"Oklahoma City Thunder","Tre Mann",0,0,0,0,0,0
1,0,2,2,1,5,3,0,0,"11",0,1,7,2,1,1,1038138,"2024-01-13T00:00:00.000Z",21,FALSE,22,4197029,"G",21,21,"Oklahoma City Thunder","Vasilije Micic",1,9,10,8,3,12.9
0,0,1,4,0,5,0,2,1,"20",2,3,1,3,0,0,1038138,"2024-01-13T00:00:00.000Z",21,FALSE,22,56677833,"G",21,21,"Oklahoma City Thunder","Cason Wallace",0,4,4,1,3,4.6
1,0,0,0,0,2,0,0,0,"07",1,4,0,1,2,0,1038138,"2024-01-13T00:00:00.000Z",21,FALSE,22,17896078,"G",21,21,"Oklahoma City Thunder","Aaron Wiggins",2,1,2,1,2,8.7
0,0,0,0,0,0,0,0,0,"00",0,0,0,0,0,0,1038138,"2024-01-13T00:00:00.000Z",21,FALSE,22,38017706,"F",21,21,"Oklahoma City Thunder","Jaylin Williams",0,0,0,0,0,0
2,0,5,2,1,2,1,0,0,"16",0,1,3,5,0,0,1038138,"2024-01-13T00:00:00.000Z",21,FALSE,22,480,"G-F",21,21,"Oklahoma City Thunder","Kenrich Williams",0,8,10,5,7,12
0,0,0,0,0,0,0,0,0,"00",0,0,0,0,0,0,1038138,"2024-01-13T00:00:00.000Z",21,FALSE,22,3547271,"C",21,21,"Oklahoma City Thunder","Aleksej Pokusevski",0,0,0,0,0,0
0,0,0,0,0,0,0,0,0,"00",0,0,0,0,0,0,1038138,"2024-01-13T00:00:00.000Z",21,FALSE,22,24572055,"C",21,21,"Oklahoma City Thunder","Olivier Sarr",0,0,0,0,0,0
0,0,0,0,0,0,0,0,0,"00",0,0,0,0,0,0,1038138,"2024-01-13T00:00:00.000Z",21,FALSE,22,27924547,"F",21,21,"Oklahoma City Thunder","Lindy Waters III",0,0,0,0,0,0
2,0,2,12,4,13,5,0,0,"35",1,0,14,3,1,3,1038138,"2024-01-13T00:00:00.000Z",21,FALSE,22,38017724,"G",22,22,"Orlando Magic","Caleb Houstan",1,17,19,16,5,20.6
8,2,7,4,0,19,8,7,4,"36",2,4,20,9,0,2,1038138,"2024-01-13T00:00:00.000Z",21,FALSE,22,38017683,"F",22,22,"Orlando Magic","Paolo Banchero",2,29,37,28,17,46.8
2,0,7,1,0,6,4,0,0,"22",2,2,8,9,2,1,1038138,"2024-01-13T00:00:00.000Z",21,FALSE,22,666442,"C",22,22,"Orlando Magic","Goga Bitadze",2,17,19,10,11,26.8
2,0,3,5,1,6,2,0,0,"19",1,1,5,4,0,0,1038138,"2024-01-13T00:00:00.000Z",21,FALSE,22,666818,"F",22,22,"Orlando Magic","Chuma Okeke",0,9,11,7,6,12.8
0,0,3,3,1,8,4,0,0,"20",1,3,9,4,0,1,1038138,"2024-01-13T00:00:00.000Z",21,FALSE,22,17896073,"G",22,22,"Orlando Magic","Jalen Suggs",0,13,13,9,4,12.8
1,1,4,1,0,8,5,6,3,"33",0,2,13,4,1,1,1038138,"2024-01-13T00:00:00.000Z",21,FALSE,22,56677827,"G",22,22,"Orlando Magic","Anthony Black",2,17,18,14,5,24.3
2,1,2,3,1,11,6,2,1,"25",2,4,14,4,1,2,1038138,"2024-01-13T00:00:00.000Z",21,FALSE,22,3547251,"G",22,22,"Orlando Magic","Cole Anthony",2,18,20,16,6,25.8
0,0,0,0,0,0,0,0,0,"00",0,0,0,0,0,0,1038138,"2024-01-13T00:00:00.000Z",21,FALSE,22,85,"F",22,22,"Orlando Magic","Wendell Carter Jr.",0,0,0,0,0,0
1,0,3,0,0,1,0,8,6,"15",2,3,6,5,0,0,1038138,"2024-01-13T00:00:00.000Z",21,FALSE,22,229,"F",22,22,"Orlando Magic","Jonathan Isaac",0,11,12,7,6,13.5
0,0,0,0,0,0,0,0,0,"00",0,0,0,0,0,0,1038138,"2024-01-13T00:00:00.000Z",21,FALSE,22,56677839,"G",22,22,"Orlando Magic","Jett Howard",0,0,0,0,0,0
0,0,0,0,0,0,0,0,0,"00",0,0,0,0,0,0,1038138,"2024-01-13T00:00:00.000Z",21,FALSE,22,226,"F",22,22,"Orlando Magic","Joe Ingles",0,0,0,0,0,0
0,0,0,0,0,0,0,0,0,"00",0,0,0,0,0,0,1038138,"2024-01-13T00:00:00.000Z",21,FALSE,22,17896026,"F",22,22,"Orlando Magic","Franz Wagner",0,0,0,0,0,0
8,1,5,7,1,13,5,8,6,"36",3,1,17,8,2,4,1038136,"2024-01-13T00:00:00.000Z",15,FALSE,20,38017731,"G",15,15,"Memphis Grizzlies","Vince Williams Jr.",3,25,33,25,16,43.6
1,0,3,4,2,12,6,0,0,"35",1,4,14,4,2,2,1038136,"2024-01-13T00:00:00.000Z",15,FALSE,20,38017729,"F",15,15,"Memphis Grizzlies","David Roddy",2,18,19,15,5,24.3
5,1,5,2,0,15,6,0,0,"36",0,4,12,5,6,2,1038136,"2024-01-13T00:00:00.000Z",15,FALSE,20,3547285,"F",15,15,"Memphis Grizzlies","Xavier Tillman",7,17,22,17,10,44.5
2,0,3,8,2,13,6,0,0,"33",0,2,14,3,0,0,1038136,"2024-01-13T00:00:00.000Z",15,FALSE,20,254,"G",15,15,"Memphis Grizzlies","Luke Kennard",0,17,19,16,5,20.6
7,0,1,6,1,8,2,0,0,"32",1,4,5,2,2,0,1038136,"2024-01-13T00:00:00.000Z",15,FALSE,20,48248287,"G",15,15,"Memphis Grizzlies","Jacob Gilyard",2,7,14,12,9,23.9
0,0,0,0,0,0,0,0,0,"00",0,0,0,0,0,0,1038136,"2024-01-13T00:00:00.000Z",15,FALSE,20,17896067,"F",15,15,"Memphis Grizzlies","Santi Aldama",0,0,0,0,0,0
0,0,0,0,0,0,0,0,0,"00",0,0,0,0,0,0,1038136,"2024-01-13T00:00:00.000Z",15,FALSE,20,3547287,"G",15,15,"Memphis Grizzlies","Desmond Bane",0,0,0,0,0,0
1,1,4,4,2,14,9,0,0,"27",2,0,20,6,0,2,1038136,"2024-01-13T00:00:00.000Z",15,FALSE,20,56677830,"F",15,15,"Memphis Grizzlies","GG Jackson",1,26,27,21,7,29.7
0,0,0,0,0,0,0,0,0,"00",0,0,0,0,0,0,1038136,"2024-01-13T00:00:00.000Z",15,FALSE,20,231,"F-C",15,15,"Memphis Grizzlies","Jaren Jackson Jr.",0,0,0,0,0,0
1,2,2,3,0,4,0,0,0,"20",1,1,0,3,1,0,1038136,"2024-01-13T00:00:00.000Z",15,FALSE,20,666703,"G-F",15,15,"Memphis Grizzlies","John Konchar",3,3,4,1,4,14.1
0,0,0,0,0,0,0,2,2,"01",0,0,2,0,0,0,1038136,"2024-01-13T00:00:00.000Z",15,FALSE,20,38017728,"F",15,15,"Memphis Grizzlies","Jake LaRavia",0,2,2,2,0,2
2,0,3,4,1,8,2,5,5,"20",1,0,10,4,1,2,1038136,"2024-01-13T00:00:00.000Z",15,FALSE,20,17896027,"G-F",15,15,"Memphis Grizzlies","Ziaire Williams",1,14,16,12,6,18.8
0,0,0,0,0,0,0,0,0,"00",0,0,0,0,0,0,1038136,"2024-01-13T00:00:00.000Z",15,FALSE,20,3,"C",15,15,"Memphis Grizzlies","Steven Adams",0,0,0,0,0,0
0,0,0,0,0,0,0,0,0,"00",0,0,0,0,0,0,1038136,"2024-01-13T00:00:00.000Z",15,FALSE,20,666505,"F",15,15,"Memphis Grizzlies","Brandon Clarke",0,0,0,0,0,0
0,0,0,0,0,0,0,0,0,"00",0,0,0,0,0,0,1038136,"2024-01-13T00:00:00.000Z",15,FALSE,20,666786,"G",15,15,"Memphis Grizzlies","Ja Morant",0,0,0,0,0,0
0,0,0,0,0,0,0,0,0,"00",0,0,0,0,0,0,1038136,"2024-01-13T00:00:00.000Z",15,FALSE,20,401,"G",15,15,"Memphis Grizzlies","Derrick Rose",0,0,0,0,0,0
0,0,0,0,0,0,0,0,0,"00",0,0,0,0,0,0,1038136,"2024-01-13T00:00:00.000Z",15,FALSE,20,420,"G",15,15,"Memphis Grizzlies","Marcus Smart",0,0,0,0,0,0
2,4,3,4,1,15,7,4,3,"32",2,1,18,5,1,4,1038136,"2024-01-13T00:00:00.000Z",15,FALSE,20,18,"F",28,20,"New York Knicks","OG Anunoby",5,23,25,20,7,38
5,1,6,6,1,21,9,6,5,"35",5,2,24,11,0,6,1038136,"2024-01-13T00:00:00.000Z",15,FALSE,20,387,"F",20,20,"New York Knicks","Julius Randle",1,35,40,29,16,41.7
2,4,13,0,0,6,5,4,2,"42",7,1,12,20,2,3,1038136,"2024-01-13T00:00:00.000Z",15,FALSE,20,201,"F-C",20,20,"New York Knicks","Isaiah Hartenstein",6,32,34,14,22,54
4,0,3,11,3,14,4,3,2,"33",0,2,13,3,4,2,1038136,"2024-01-13T00:00:00.000Z",15,FALSE,20,131,"G",20,20,"New York Knicks","Donte DiVincenzo",4,16,20,17,7,32.6
5,1,6,7,4,10,7,2,1,"38",0,3,19,6,1,3,1038136,"2024-01-13T00:00:00.000Z",15,FALSE,20,17896033,"G",20,20,"New York Knicks","Miles McBride",2,25,30,24,11,36.7
0,1,0,0,0,0,0,0,0,"06",1,0,0,1,0,1,1038136,"2024-01-13T00:00:00.000Z",15,FALSE,20,3547249,"F",28,20,"New York Knicks","Precious Achiuwa",1,1,1,0,1,3.2
0,0,0,0,0,0,0,0,0,"00",0,0,0,0,0,0,1038136,"2024-01-13T00:00:00.000Z",15,FALSE,20,19,"G",20,20,"New York Knicks","Ryan Arcidiacono",0,0,0,0,0,0
0,0,0,0,0,0,0,0,0,"00",0,0,0,0,0,0,1038136,"2024-01-13T00:00:00.000Z",15,FALSE,20,666474,"G",20,20,"New York Knicks","Charles Brown",0,0,0,0,0,0
0,0,0,0,0,0,0,0,0,"00",0,0,0,0,0,0,1038136,"2024-01-13T00:00:00.000Z",15,FALSE,20,73,"G",20,20,"New York Knicks","Jalen Brunson",0,0,0,0,0,0
3,0,1,2,1,5,4,0,0,"10",0,3,9,1,1,1,1038136,"2024-01-13T00:00:00.000Z",15,FALSE,20,3547275,"G",28,20,"New York Knicks","Malachi Flynn",1,10,13,12,4,16.7
0,0,0,0,0,0,0,0,0,"00",0,0,0,0,0,0,1038136,"2024-01-13T00:00:00.000Z",15,FALSE,20,160,"G-F",20,20,"New York Knicks","Evan Fournier",0,0,0,0,0,0
1,0,2,4,1,5,1,0,0,"15",0,1,3,2,0,0,1038136,"2024-01-13T00:00:00.000Z",15,FALSE,20,17895858,"G",20,20,"New York Knicks","Quentin Grimes",0,5,6,4,3,6.9
3,0,7,4,2,7,3,0,0,"29",0,2,8,7,2,2,1038136,"2024-01-13T00:00:00.000Z",15,FALSE,20,202,"G",20,20,"New York Knicks","Josh Hart",2,15,18,11,10,24.9
0,0,0,0,0,0,0,0,0,"00",0,0,0,0,0,0,1038136,"2024-01-13T00:00:00.000Z",15,FALSE,20,17896063,"F",20,20,"New York Knicks","Jericho Sims",0,0,0,0,0,0
0,0,0,0,0,0,0,0,0,"00",0,0,0,0,0,0,1038136,"2024-01-13T00:00:00.000Z",15,FALSE,20,17896089,"G",20,20,"New York Knicks","Duane Washington Jr.",0,0,0,0,0,0
0,0,0,0,0,0,0,0,0,"00",0,0,0,0,0,0,1038136,"2024-01-13T00:00:00.000Z",15,FALSE,20,399,"C",20,20,"New York Knicks","Mitchell Robinson",0,0,0,0,0,0
0,0,0,0,0,0,0,0,0,"00",0,0,0,0,0,0,1038136,"2024-01-13T00:00:00.000Z",15,FALSE,20,56677795,"F",20,20,"New York Knicks","Jacob Toppin",0,0,0,0,0,0
2,2,5,6,4,15,11,10,6,"29",1,5,32,6,2,3,1038134,"2024-01-13T00:00:00.000Z",2,FALSE,11,70,"G",2,2,"Boston Celtics","Jaylen Brown",4,38,40,34,8,51.2
5,1,7,7,4,17,9,7,5,"30",1,2,27,8,1,2,1038134,"2024-01-13T00:00:00.000Z",2,FALSE,11,434,"F",2,2,"Boston Celtics","Jayson Tatum",2,35,40,32,13,48.1
5,3,6,5,3,11,6,2,2,"28",1,3,17,7,1,2,1038134,"2024-01-13T00:00:00.000Z",2,FALSE,11,378,"F-C",2,2,"Boston Celtics","Kristaps Porzingis",4,24,29,22,12,42.9
5,0,2,5,3,9,5,0,0,"25",1,1,13,3,2,0,1038134,"2024-01-13T00:00:00.000Z",2,FALSE,11,473,"G",2,2,"Boston Celtics","Derrick White",2,16,21,18,8,30.1
3,0,4,4,1,10,4,2,2,"26",2,2,11,6,0,1,1038134,"2024-01-13T00:00:00.000Z",2,FALSE,11,214,"G",2,2,"Boston Celtics","Jrue Holiday",0,17,20,14,9,21.7
0,0,0,0,0,0,0,0,0,"00",0,0,0,0,0,0,1038134,"2024-01-13T00:00:00.000Z",2,FALSE,11,17896094,"G",2,2,"Boston Celtics","Dalano Banton",0,0,0,0,0,0
2,0,4,1,1,2,2,0,0,"09",0,1,5,4,1,0,1038134,"2024-01-13T00:00:00.000Z",2,FALSE,11,666468,"F",2,2,"Boston Celtics","Oshae Brissett",1,9,11,7,6,15.8
0,0,6,8,2,9,2,0,0,"20",0,0,6,6,0,0,1038134,"2024-01-13T00:00:00.000Z",2,FALSE,11,17896060,"F",2,2,"Boston Celtics","Sam Hauser",0,12,12,6,6,13.2
1,1,4,2,1,3,2,2,2,"20",0,0,7,4,0,0,1038134,"2024-01-13T00:00:00.000Z",2,FALSE,11,219,"C-F",2,2,"Boston Celtics","Al Horford",1,11,12,8,5,16.3
0,1,0,0,0,2,1,0,0,"14",1,5,2,1,0,0,1038134,"2024-01-13T00:00:00.000Z",2,FALSE,11,261,"F-C",2,2,"Boston Celtics","Luke Kornet",1,3,3,2,1,6.2
0,0,0,3,2,5,2,0,0,"09",1,1,6,1,0,0,1038134,"2024-01-13T00:00:00.000Z",2,FALSE,11,338,"G",2,2,"Boston Celtics","Svi Mykhailiuk",0,7,7,6,1,7.2
4,0,2,6,3,10,7,2,2,"23",2,1,19,4,0,2,1038134,"2024-01-13T00:00:00.000Z",2,FALSE,11,3547276,"G",2,2,"Boston Celtics","Payton Pritchard",0,23,27,23,8,27.8
0,0,0,0,0,3,0,0,0,"07",0,0,0,0,0,2,1038134,"2024-01-13T00:00:00.000Z",2,FALSE,11,3547279,"F",2,2,"Boston Celtics","Lamar Stevens",0,0,0,0,0,-2
0,0,0,0,0,0,0,0,0,"00",0,0,0,0,0,0,1038134,"2024-01-13T00:00:00.000Z",2,FALSE,11,38017707,"G",2,2,"Boston Celtics","JD Davison",0,0,0,0,0,0
0,0,0,0,0,0,0,0,0,"00",0,0,0,0,0,0,1038134,"2024-01-13T00:00:00.000Z",2,FALSE,11,NA,NA,NA,2,"Boston Celtics","NA NA",0,0,0,0,0,0
0,0,0,0,0,0,0,0,0,"00",0,0,0,0,0,0,1038134,"2024-01-13T00:00:00.000Z",2,FALSE,11,17553967,"C",2,2,"Boston Celtics","Neemias Queta",0,0,0,0,0,0
0,0,0,0,0,0,0,0,0,"00",0,0,0,0,0,0,1038134,"2024-01-13T00:00:00.000Z",2,FALSE,11,56677864,"G",2,2,"Boston Celtics","Jordan Walsh",0,0,0,0,0,0
0,0,0,1,0,8,3,6,6,"25",1,4,12,1,1,0,1038134,"2024-01-13T00:00:00.000Z",2,FALSE,11,66,"G-F",11,11,"Houston Rockets","Dillon Brooks",1,13,13,12,1,16.2
2,0,5,4,0,11,4,1,1,"27",1,2,9,6,0,2,1038134,"2024-01-13T00:00:00.000Z",2,FALSE,11,38017684,"F",11,11,"Houston Rockets","Jabari Smith Jr.",0,15,17,11,8,17.2
3,0,8,2,0,17,8,3,3,"24",2,3,19,10,4,3,1038134,"2024-01-13T00:00:00.000Z",2,FALSE,11,17896062,"F-C",11,11,"Houston Rockets","Alperen Sengun",4,29,32,22,13,44.5
1,0,3,5,2,9,3,2,2,"20",0,0,10,3,0,1,1038134,"2024-01-13T00:00:00.000Z",2,FALSE,11,17895966,"G",11,11,"Houston Rockets","Jalen Green",0,13,14,11,4,14.1
7,1,0,3,1,6,2,0,0,"23",1,2,5,1,0,0,1038134,"2024-01-13T00:00:00.000Z",2,FALSE,11,458,"G",11,11,"Houston Rockets","Fred VanVleet",1,6,13,12,8,19.7
1,1,3,1,1,1,1,0,0,"08",0,1,3,3,0,0,1038134,"2024-01-13T00:00:00.000Z",2,FALSE,11,75,"G-F",11,11,"Houston Rockets","Reggie Bullock",1,6,7,4,4,11.1
1,0,1,1,1,5,3,2,2,"14",0,1,9,1,0,0,1038134,"2024-01-13T00:00:00.000Z",2,FALSE,11,188,"F",11,11,"Houston Rockets","Jeff Green",0,10,11,10,2,11.7
1,0,0,3,0,6,2,2,1,"09",0,0,5,0,0,0,1038134,"2024-01-13T00:00:00.000Z",2,FALSE,11,213,"G",11,11,"Houston Rockets","Aaron Holiday",0,5,6,6,1,6.5
1,0,0,3,0,6,1,0,0,"12",3,0,2,3,0,0,1038134,"2024-01-13T00:00:00.000Z",2,FALSE,11,19465326,"C",11,11,"Houston Rockets","Jock Landale",0,5,6,3,4,7.1
0,0,2,0,0,5,1,1,0,"07",1,1,2,3,0,0,1038134,"2024-01-13T00:00:00.000Z",2,FALSE,11,296,"C",11,11,"Houston Rockets","Boban Marjanovic",0,5,5,2,3,5.6
0,0,0,0,0,0,0,0,0,"09",0,1,0,0,1,1,1038134,"2024-01-13T00:00:00.000Z",2,FALSE,11,3547301,"F",11,11,"Houston Rockets","Jae'Sean Tate",1,0,0,0,0,2
3,0,7,0,0,10,3,4,4,"25",3,0,10,10,3,4,1038134,"2024-01-13T00:00:00.000Z",2,FALSE,11,56677825,"G-F",11,11,"Houston Rockets","Amen Thompson",3,20,23,13,13,31.5
0,1,7,7,2,13,7,8,6,"28",1,2,22,8,2,1,1038134,"2024-01-13T00:00:00.000Z",2,FALSE,11,56677831,"F",11,11,"Houston Rockets","Cam Whitmore",3,30,30,22,8,39.6
0,0,0,0,0,3,2,1,1,"09",3,1,5,3,0,0,1038134,"2024-01-13T00:00:00.000Z",2,FALSE,11,47738533,"G",11,11,"Houston Rockets","Jeenathan Williams",0,8,8,5,3,8.6
0,0,0,0,0,0,0,0,0,"00",0,0,0,0,0,0,1038134,"2024-01-13T00:00:00.000Z",2,FALSE,11,38017695,"F",11,11,"Houston Rockets","Tari Eason",0,0,0,0,0,0
0,0,0,0,0,0,0,0,0,"00",0,0,0,0,0,0,1038134,"2024-01-13T00:00:00.000Z",2,FALSE,11,3547281,"G-F",11,11,"Houston Rockets","Nate Hinton",0,0,0,0,0,0
0,0,0,0,0,0,0,0,0,"00",0,0,0,0,0,0,1038134,"2024-01-13T00:00:00.000Z",2,FALSE,11,357,"G",11,11,"Houston Rockets","Victor Oladipo",0,0,0,0,0,0
0,0,0,0,0,0,0,0,0,"00",0,0,0,0,0,0,1038134,"2024-01-13T00:00:00.000Z",2,FALSE,11,56677809,"F",11,11,"Houston Rockets","Jermaine Samuels Jr.",0,0,0,0,0,0
0,0,1,7,2,13,5,4,4,"27",6,1,16,7,4,1,1038135,"2024-01-13T00:00:00.000Z",1,FALSE,30,3547256,"F",1,1,"Atlanta Hawks","Saddiq Bey",4,23,23,16,7,35.4
3,2,6,3,1,7,2,0,0,"36",0,3,5,6,0,4,1038135,"2024-01-13T00:00:00.000Z",1,FALSE,30,17896040,"F",1,1,"Atlanta Hawks","Jalen Johnson",2,11,14,8,9,18.7
0,1,6,0,0,8,2,0,0,"24",2,1,4,8,0,0,1038135,"2024-01-13T00:00:00.000Z",1,FALSE,30,83,"C",1,1,"Atlanta Hawks","Clint Capela",1,12,12,4,8,16.6
3,0,5,6,1,15,4,4,4,"31",0,1,13,5,0,2,1038135,"2024-01-13T00:00:00.000Z",1,FALSE,30,334,"G",1,1,"Atlanta Hawks","Dejounte Murray",0,18,21,16,8,21.5
10,1,1,10,2,19,6,9,7,"36",1,5,21,2,1,1,1038135,"2024-01-13T00:00:00.000Z",1,FALSE,30,490,"G",1,1,"Atlanta Hawks","Trae Young",2,23,33,31,12,43.4
2,0,2,8,3,13,5,1,1,"24",1,2,14,3,3,0,1038135,"2024-01-13T00:00:00.000Z",1,FALSE,30,53,"G",1,1,"Atlanta Hawks","Bogdan Bogdanovic",3,17,19,16,5,29.6
0,0,2,0,0,1,1,2,2,"05",0,0,4,2,0,1,1038135,"2024-01-13T00:00:00.000Z",1,FALSE,30,666564,"F",1,1,"Atlanta Hawks","Bruno Fernando",0,6,6,4,2,5.4
1,0,2,0,0,4,1,4,2,"13",0,1,4,2,1,2,1038135,"2024-01-13T00:00:00.000Z",1,FALSE,30,3547297,"G",1,1,"Atlanta Hawks","Trent Forrest",1,6,7,5,3,8.9
0,0,1,1,0,1,0,0,0,"05",0,0,0,1,0,0,1038135,"2024-01-13T00:00:00.000Z",1,FALSE,30,38017689,"F",1,1,"Atlanta Hawks","AJ Griffin",0,1,1,0,1,1.2
0,0,2,0,0,1,0,2,1,"05",0,1,1,2,0,0,1038135,"2024-01-13T00:00:00.000Z",1,FALSE,30,56677855,"G",1,1,"Atlanta Hawks","Seth Lundy",0,3,3,1,2,3.4
1,0,2,5,2,6,3,2,0,"15",0,1,8,2,0,1,1038135,"2024-01-13T00:00:00.000Z",1,FALSE,30,666754,"G",1,1,"Atlanta Hawks","Garrison Mathews",0,10,11,9,3,10.9
1,3,4,0,0,5,3,5,3,"19",6,4,9,10,0,2,1038135,"2024-01-13T00:00:00.000Z",1,FALSE,30,3547244,"F-C",1,1,"Atlanta Hawks","Onyeka Okongwu",3,19,20,10,11,29.5
0,0,0,0,0,0,0,0,0,"00",0,0,0,0,0,0,1038135,"2024-01-13T00:00:00.000Z",1,FALSE,30,38017687,"G",30,30,"Washington Wizards","Johnny Davis",0,0,0,0,0,0
0,0,0,0,0,0,0,0,0,"00",0,0,0,0,0,0,1038135,"2024-01-13T00:00:00.000Z",1,FALSE,30,17896106,"F",30,30,"Washington Wizards","Eugene Omoruyi",0,0,0,0,0,0
0,0,0,0,0,0,0,0,0,"00",0,0,0,0,0,0,1038135,"2024-01-13T00:00:00.000Z",1,FALSE,30,3547302,"F",30,30,"Washington Wizards","Anthony Gill",0,0,0,0,0,0
0,0,0,0,0,0,0,0,0,"00",0,0,0,0,0,0,1038135,"2024-01-13T00:00:00.000Z",1,FALSE,30,337,"F-C",30,30,"Washington Wizards","Mike Muscala",0,0,0,0,0,0
0,0,0,0,0,0,0,0,0,"00",0,0,0,0,0,0,1038135,"2024-01-13T00:00:00.000Z",1,FALSE,30,414,"G",30,30,"Washington Wizards","Landry Shamet",0,0,0,0,0,0
0,0,0,0,0,0,0,0,0,"00",0,0,0,0,0,0,1038135,"2024-01-13T00:00:00.000Z",1,FALSE,30,18677954,"G",30,30,"Washington Wizards","Jared Butler",0,0,0,0,0,0
0,0,0,0,0,0,0,0,0,"00",0,0,0,0,0,0,1038135,"2024-01-13T00:00:00.000Z",1,FALSE,30,319,"G",1,1,"Atlanta Hawks","Patty Mills",0,0,0,0,0,0
0,0,0,0,0,0,0,0,0,"00",0,0,0,0,0,0,1038135,"2024-01-13T00:00:00.000Z",1,FALSE,30,56677838,"G",1,1,"Atlanta Hawks","Kobe Bufkin",0,0,0,0,0,0
0,0,0,0,0,0,0,0,0,"00",0,0,0,0,0,0,1038135,"2024-01-13T00:00:00.000Z",1,FALSE,30,56677806,"F",1,1,"Atlanta Hawks","Mouhamed Gueye",0,0,0,0,0,0
0,0,0,0,0,0,0,0,0,"00",0,0,0,0,0,0,1038135,"2024-01-13T00:00:00.000Z",1,FALSE,30,666656,"F",1,1,"Atlanta Hawks","De'Andre Hunter",0,0,0,0,0,0
0,0,0,0,0,0,0,0,0,"00",0,0,0,0,0,0,1038135,"2024-01-13T00:00:00.000Z",1,FALSE,30,4197387,"G",1,1,"Atlanta Hawks","Vit Krejci",0,0,0,0,0,0
0,0,0,0,0,0,0,0,0,"00",0,0,0,0,0,0,1038135,"2024-01-13T00:00:00.000Z",1,FALSE,30,301,"G-F",1,1,"Atlanta Hawks","Wesley Matthews",0,0,0,0,0,0
9,1,13,2,1,12,7,5,4,"37",1,5,19,14,1,3,1038135,"2024-01-13T00:00:00.000Z",1,FALSE,30,3547242,"F",30,30,"Washington Wizards","Deni Avdija",2,33,42,28,23,52.3
4,1,3,5,3,20,10,7,6,"27",3,0,29,6,0,2,1038135,"2024-01-13T00:00:00.000Z",1,FALSE,30,265,"F",30,30,"Washington Wizards","Kyle Kuzma",1,35,39,33,10,43.2
0,2,6,0,0,4,4,2,2,"30",0,0,10,6,1,1,1038135,"2024-01-13T00:00:00.000Z",1,FALSE,30,666577,"F",30,30,"Washington Wizards","Daniel Gafford",3,16,16,10,6,25.2
2,1,2,6,2,16,8,2,2,"26",0,1,20,2,1,1,1038135,"2024-01-13T00:00:00.000Z",1,FALSE,30,666848,"G",30,30,"Washington Wizards","Jordan Poole",2,22,24,22,4,30.4
7,1,2,3,0,9,4,0,0,"26",1,0,8,3,1,0,1038135,"2024-01-13T00:00:00.000Z",1,FALSE,30,249,"G",30,30,"Washington Wizards","Tyus Jones",2,11,18,15,10,28.1
3,1,6,2,1,8,3,6,5,"28",0,4,12,6,2,1,1038135,"2024-01-13T00:00:00.000Z",1,FALSE,30,56677844,"G",30,30,"Washington Wizards","Bilal Coulibaly",3,18,21,15,9,31.7
0,1,6,3,0,8,3,4,2,"18",3,5,8,9,0,2,1038135,"2024-01-13T00:00:00.000Z",1,FALSE,30,38017704,"F",30,30,"Washington Wizards","Patrick Baldwin Jr.",1,17,17,8,9,19.8
2,0,3,5,3,8,4,0,0,"17",1,3,11,4,0,1,1038135,"2024-01-13T00:00:00.000Z",1,FALSE,30,17896045,"F",30,30,"Washington Wizards","Corey Kispert",0,15,17,13,6,17.8
1,0,0,0,0,2,1,0,0,"04",2,1,2,2,2,1,1038135,"2024-01-13T00:00:00.000Z",1,FALSE,30,128,"G",9,30,"Washington Wizards","Hamidou Diallo",2,4,5,3,3,10.9
0,0,0,0,0,0,0,0,0,"00",0,0,0,0,0,0,1038135,"2024-01-13T00:00:00.000Z",1,FALSE,30,167,"F",30,30,"Washington Wizards","Danilo Gallinari",0,0,0,0,0,0
4,1,1,3,2,7,3,0,0,"22",1,1,8,2,2,0,1038135,"2024-01-13T00:00:00.000Z",1,FALSE,30,487,"G",30,30,"Washington Wizards","Delon Wright",3,10,14,12,6,25.4
0,0,0,3,0,3,0,0,0,"05",0,2,0,0,0,0,1038135,"2024-01-13T00:00:00.000Z",1,FALSE,30,NA,NA,NA,30,"Washington Wizards","NA NA",0,0,0,0,0,0
4,0,4,3,1,8,3,2,2,"33",2,2,9,6,0,3,1038139,"2024-01-13T00:00:00.000Z",7,FALSE,19,3547258,"G",7,7,"Dallas Mavericks","Josh Green",0,15,19,13,10,19.2
1,0,4,5,3,10,8,5,5,"28",0,4,24,4,0,1,1038139,"2024-01-13T00:00:00.000Z",7,FALSE,19,247,"F-G",7,7,"Dallas Mavericks","Derrick Jones Jr.",0,28,29,25,5,29.3
8,0,4,0,0,1,0,2,2,"34",5,5,2,9,3,1,1038139,"2024-01-13T00:00:00.000Z",7,FALSE,19,379,"F-C",7,7,"Dallas Mavericks","Dwight Powell",3,11,19,10,17,32.8
0,0,4,8,3,17,8,6,5,"39",0,3,24,4,0,0,1038139,"2024-01-13T00:00:00.000Z",7,FALSE,19,191,"G",7,7,"Dallas Mavericks","Tim Hardaway Jr.",0,28,28,24,4,28.8
6,0,5,14,5,27,12,4,4,"40",0,2,33,5,1,1,1038139,"2024-01-13T00:00:00.000Z",7,FALSE,19,228,"G",7,7,"Dallas Mavericks","Kyrie Irving",1,38,44,39,11,50
0,0,0,2,1,3,1,0,0,"12",0,3,3,0,1,0,1038139,"2024-01-13T00:00:00.000Z",7,FALSE,19,114,"G",7,7,"Dallas Mavericks","Seth Curry",1,3,3,3,0,6
1,0,2,4,2,8,3,0,0,"23",0,1,8,2,0,2,1038139,"2024-01-13T00:00:00.000Z",7,FALSE,19,38017679,"G",7,7,"Dallas Mavericks","Jaden Hardy",0,10,11,9,3,9.9
0,0,0,0,0,0,0,0,0,"00",0,0,0,0,0,0,1038139,"2024-01-13T00:00:00.000Z",7,FALSE,19,217,"F-C",7,7,"Dallas Mavericks","Richaun Holmes",0,0,0,0,0,0
1,0,1,2,0,3,1,0,0,"11",1,0,2,2,1,1,1038139,"2024-01-13T00:00:00.000Z",7,FALSE,19,257,"F",7,7,"Dallas Mavericks","Maxi Kleber",1,4,5,3,3,7.9
1,0,1,1,0,3,1,1,1,"06",0,0,3,1,0,1,1038139,"2024-01-13T00:00:00.000Z",7,FALSE,19,17554004,"G",7,7,"Dallas Mavericks","AJ Lawson",0,4,5,4,2,4.7
1,1,0,2,0,2,0,0,0,"14",1,5,0,1,0,2,1038139,"2024-01-13T00:00:00.000Z",7,FALSE,19,666965,"F",7,7,"Dallas Mavericks","Grant Williams",1,1,2,1,2,3.7
0,0,0,0,0,0,0,0,0,"00",0,0,0,0,0,0,1038139,"2024-01-13T00:00:00.000Z",7,FALSE,19,56677859,"F",7,7,"Dallas Mavericks","Olivier-Maxence Prosper",0,0,0,0,0,0
3,2,3,3,1,13,5,6,4,"32",2,5,15,5,0,1,1038139,"2024-01-13T00:00:00.000Z",7,FALSE,19,17896024,"F",19,19,"New Orleans Pelicans","Herbert Jones",2,20,23,18,8,30.5
1,0,5,4,2,12,5,2,1,"31",1,3,13,6,0,2,1038139,"2024-01-13T00:00:00.000Z",7,FALSE,19,3547293,"F",19,19,"New Orleans Pelicans","Naji Marshall",0,19,20,14,7,19.7
7,2,7,0,0,6,4,9,6,"28",5,4,14,12,0,0,1038139,"2024-01-13T00:00:00.000Z",7,FALSE,19,455,"C",19,19,"New Orleans Pelicans","Jonas Valanciunas",2,26,33,21,19,44.9
4,0,2,12,6,19,11,8,6,"36",3,3,34,5,2,3,1038139,"2024-01-13T00:00:00.000Z",7,FALSE,19,56677837,"G",19,19,"New Orleans Pelicans","Jordan Hawkins",2,39,43,38,9,49
7,0,4,1,0,7,4,2,2,"38",2,2,10,6,0,2,1038139,"2024-01-13T00:00:00.000Z",7,FALSE,19,38017677,"G",19,19,"New Orleans Pelicans","Dyson Daniels",0,16,23,17,13,25.7
4,0,2,8,3,12,5,2,1,"26",0,2,14,2,1,0,1038139,"2024-01-13T00:00:00.000Z",7,FALSE,19,17896097,"G",19,19,"New Orleans Pelicans","Jose Alvarado",1,16,20,18,6,25.4
0,0,2,1,0,2,0,2,2,"07",0,0,2,2,0,1,1038139,"2024-01-13T00:00:00.000Z",7,FALSE,19,3547260,"G",19,19,"New Orleans Pelicans","Kira Lewis Jr.",0,4,4,2,2,3.4
3,0,1,0,0,4,4,6,6,"20",1,0,14,2,2,0,1038139,"2024-01-13T00:00:00.000Z",7,FALSE,19,340,"F",19,19,"New Orleans Pelicans","Larry Nance Jr.",2,16,19,17,5,26.9
0,0,4,1,0,4,1,0,0,"22",0,1,2,4,2,1,1038139,"2024-01-13T00:00:00.000Z",7,FALSE,19,17896021,"F",19,19,"New Orleans Pelicans","Jeremiah Robinson-Earl",2,6,6,2,4,11.8
0,0,0,0,0,0,0,0,0,"00",0,0,0,0,0,0,1038139,"2024-01-13T00:00:00.000Z",7,FALSE,19,38017726,"G",19,19,"New Orleans Pelicans","Dereon Seabron",0,0,0,0,0,0
0,0,0,0,0,0,0,0,0,"00",0,0,0,0,0,0,1038139,"2024-01-13T00:00:00.000Z",7,FALSE,19,666969,"F",19,19,"New Orleans Pelicans","Zion Williamson",0,0,0,0,0,0
0,0,0,0,0,0,0,0,0,"00",0,0,0,0,0,0,1038139,"2024-01-13T00:00:00.000Z",7,FALSE,19,329,"F",7,7,"Dallas Mavericks","Markieff Morris",0,0,0,0,0,0
0,0,0,0,0,0,0,0,0,"00",0,0,0,0,0,0,1038139,"2024-01-13T00:00:00.000Z",7,FALSE,19,24489167,"G",25,7,"Dallas Mavericks","Brandon Williams",0,0,0,0,0,0
0,0,0,0,0,0,0,0,0,"00",0,0,0,0,0,0,1038139,"2024-01-13T00:00:00.000Z",7,FALSE,19,17896028,"F",7,7,"Dallas Mavericks","Greg Brown III",0,0,0,0,0,0
0,0,0,0,0,0,0,0,0,"00",0,0,0,0,0,0,1038139,"2024-01-13T00:00:00.000Z",7,FALSE,19,132,"F-G",7,7,"Dallas Mavericks","Luka Doncic",0,0,0,0,0,0
0,0,0,0,0,0,0,0,0,"00",0,0,0,0,0,0,1038139,"2024-01-13T00:00:00.000Z",7,FALSE,19,151,"G",7,7,"Dallas Mavericks","Dante Exum",0,0,0,0,0,0
0,0,0,0,0,0,0,0,0,"00",0,0,0,0,0,0,1038139,"2024-01-13T00:00:00.000Z",7,FALSE,19,56677840,"C",7,7,"Dallas Mavericks","Dereck Lively II",0,0,0,0,0,0
0,0,0,0,0,0,0,0,0,"00",0,0,0,0,0,0,1038139,"2024-01-13T00:00:00.000Z",7,FALSE,19,38017663,"F",19,19,"New Orleans Pelicans","E.J. Liddell",0,0,0,0,0,0
0,0,0,0,0,0,0,0,0,"00",0,0,0,0,0,0,1038139,"2024-01-13T00:00:00.000Z",7,FALSE,19,18677986,"F",19,19,"New Orleans Pelicans","Trey Murphy III",0,0,0,0,0,0
0,0,0,0,0,0,0,0,0,"00",0,0,0,0,0,0,1038139,"2024-01-13T00:00:00.000Z",7,FALSE,19,491,"C",19,19,"New Orleans Pelicans","Cody Zeller",0,0,0,0,0,0
0,0,0,0,0,0,0,0,0,"00",0,0,0,0,0,0,1038139,"2024-01-13T00:00:00.000Z",7,FALSE,19,227,"F",19,19,"New Orleans Pelicans","Brandon Ingram",0,0,0,0,0,0
0,0,0,0,0,0,0,0,0,"00",0,0,0,0,0,0,1038139,"2024-01-13T00:00:00.000Z",7,FALSE,19,303,"G",19,19,"New Orleans Pelicans","CJ McCollum",0,0,0,0,0,0
0,0,0,0,0,0,0,0,0,"00",0,0,0,0,0,0,1038139,"2024-01-13T00:00:00.000Z",7,FALSE,19,17896017,"F",19,19,"New Orleans Pelicans","Matt Ryan",0,0,0,0,0,0
4,0,5,3,1,5,1,3,3,"17",0,1,6,5,0,1,1038140,"2024-01-13T00:00:00.000Z",27,FALSE,5,38017649,"F",27,27,"San Antonio Spurs","Julian Champagnie",0,11,15,10,9,17
2,0,3,6,2,15,4,1,1,"31",4,3,11,7,0,1,1038140,"2024-01-13T00:00:00.000Z",27,FALSE,5,38017699,"F",27,27,"San Antonio Spurs","Jeremy Sochan",0,18,20,13,9,21.4
3,1,2,0,0,5,2,2,1,"22",4,1,5,6,1,0,1038140,"2024-01-13T00:00:00.000Z",27,FALSE,5,38017730,"F",27,27,"San Antonio Spurs","Dominick Barlow",2,11,14,8,9,22.7
2,0,4,8,1,13,1,3,2,"34",0,0,5,4,1,2,1038140,"2024-01-13T00:00:00.000Z",27,FALSE,5,3547246,"G-F",27,27,"San Antonio Spurs","Devin Vassell",1,9,11,7,6,13.8
4,0,8,6,4,13,10,6,6,"32",1,2,30,9,0,1,1038140,"2024-01-13T00:00:00.000Z",27,FALSE,5,3547274,"G",27,27,"San Antonio Spurs","Tre Jones",0,39,43,34,13,45.8
1,0,1,8,2,15,6,0,0,"22",0,0,14,1,3,1,1038140,"2024-01-13T00:00:00.000Z",27,FALSE,5,38017692,"F",27,27,"San Antonio Spurs","Malaki Branham",3,15,16,15,2,24.7
0,0,0,0,0,0,0,0,0,"00",0,0,0,0,0,0,1038140,"2024-01-13T00:00:00.000Z",27,FALSE,5,3547163,"F",6,27,"San Antonio Spurs","Mamadi Diakite",0,0,0,0,0,0
0,0,0,0,0,0,0,0,0,"00",0,0,0,0,0,0,1038140,"2024-01-13T00:00:00.000Z",27,FALSE,5,180,"G",27,27,"San Antonio Spurs","Devonte' Graham",0,0,0,0,0,0
5,0,4,5,4,14,8,6,6,"30",0,2,26,4,0,2,1038140,"2024-01-13T00:00:00.000Z",27,FALSE,5,666682,"F",27,27,"San Antonio Spurs","Keldon Johnson",0,30,35,31,9,36.3
1,2,5,3,1,7,3,2,1,"18",3,5,8,8,1,0,1038140,"2024-01-13T00:00:00.000Z",27,FALSE,5,17896059,"F",27,27,"San Antonio Spurs","Sandro Mamukelashvili",3,16,17,9,9,28.1
1,0,2,5,3,5,3,0,0,"23",0,3,9,2,1,0,1038140,"2024-01-13T00:00:00.000Z",27,FALSE,5,359,"F",27,27,"San Antonio Spurs","Cedi Osman",1,11,12,10,3,15.9
4,0,4,5,2,19,8,2,2,"35",0,1,20,4,0,1,1038140,"2024-01-13T00:00:00.000Z",27,FALSE,5,125,"G",5,5,"Chicago Bulls","DeMar DeRozan",0,24,28,24,8,29.8
6,3,5,4,3,5,3,2,2,"33",0,1,11,5,2,1,1038140,"2024-01-13T00:00:00.000Z",27,FALSE,5,89,"G",5,5,"Chicago Bulls","Alex Caruso",5,16,22,17,11,40
5,3,13,5,2,17,10,3,2,"31",3,2,24,16,0,1,1038140,"2024-01-13T00:00:00.000Z",27,FALSE,5,460,"C",5,5,"Chicago Bulls","Nikola Vucevic",3,40,45,29,21,58.7
7,0,6,5,1,8,3,4,3,"36",0,3,10,6,1,2,1038140,"2024-01-13T00:00:00.000Z",27,FALSE,5,268,"G",5,5,"Chicago Bulls","Zach LaVine",1,16,23,17,13,28.7
4,1,2,3,0,13,6,4,3,"32",0,2,15,2,0,0,1038140,"2024-01-13T00:00:00.000Z",27,FALSE,5,666956,"G",5,5,"Chicago Bulls","Coby White",1,17,21,19,6,26.4
0,0,1,9,4,12,5,0,0,"24",0,2,14,1,0,3,1038140,"2024-01-13T00:00:00.000Z",27,FALSE,5,87,"G",5,5,"Chicago Bulls","Jevon Carter",0,15,15,14,1,12.2
0,0,0,0,0,0,0,0,0,"00",0,0,0,0,0,0,1038140,"2024-01-13T00:00:00.000Z",27,FALSE,5,110,"F",5,5,"Chicago Bulls","Torrey Craig",0,0,0,0,0,0
4,0,2,3,3,9,8,2,2,"29",0,4,21,2,1,1,1038140,"2024-01-13T00:00:00.000Z",27,FALSE,5,17895983,"G",5,5,"Chicago Bulls","Ayo Dosunmu",1,23,27,25,6,31.4
1,1,7,0,0,7,3,3,1,"17",4,2,7,11,1,0,1038140,"2024-01-13T00:00:00.000Z",27,FALSE,5,137,"C",5,5,"Chicago Bulls","Andre Drummond",2,18,19,8,12,27.7
0,0,0,0,0,0,0,0,0,"00",0,0,0,0,0,0,1038140,"2024-01-13T00:00:00.000Z",27,FALSE,5,17896116,"G",5,5,"Chicago Bulls","Terry Taylor",0,0,0,0,0,0
0,0,0,0,0,0,0,0,0,"03",0,1,0,0,0,0,1038140,"2024-01-13T00:00:00.000Z",27,FALSE,5,38017719,"F",5,5,"Chicago Bulls","Dalen Terry",0,0,0,0,0,0
0,0,0,0,0,0,0,0,0,"00",0,0,0,0,0,0,1038140,"2024-01-13T00:00:00.000Z",27,FALSE,5,3547248,"F",5,5,"Chicago Bulls","Patrick Williams",0,0,0,0,0,0
0,0,0,0,0,0,0,0,0,"00",0,0,0,0,0,0,1038140,"2024-01-13T00:00:00.000Z",27,FALSE,5,56677860,"F",5,5,"Chicago Bulls","Adama Sanogo",0,0,0,0,0,0
3,0,1,2,0,3,1,0,0,"11",0,2,2,1,0,0,1038140,"2024-01-13T00:00:00.000Z",27,FALSE,5,38017693,"G",27,27,"San Antonio Spurs","Blake Wesley",0,3,6,5,4,7.7
0,0,0,0,0,0,0,0,0,"00",0,0,0,0,0,0,1038140,"2024-01-13T00:00:00.000Z",27,FALSE,5,17895854,"G",27,27,"San Antonio Spurs","Charles Bassey",0,0,0,0,0,0
0,0,0,0,0,0,0,0,0,"00",0,0,0,0,0,0,1038140,"2024-01-13T00:00:00.000Z",27,FALSE,5,56677817,"G",27,27,"San Antonio Spurs","Sidy Cissoko",0,0,0,0,0,0
0,0,0,0,0,0,0,0,0,"00",0,0,0,0,0,0,1038140,"2024-01-13T00:00:00.000Z",27,FALSE,5,102,"F-C",27,27,"San Antonio Spurs","Zach Collins",0,0,0,0,0,0
0,0,0,0,0,0,0,0,0,"00",0,0,0,0,0,0,1038140,"2024-01-13T00:00:00.000Z",27,FALSE,5,17896049,"G",3,27,"San Antonio Spurs","David Duke Jr.",0,0,0,0,0,0
0,0,0,0,0,0,0,0,0,"00",0,0,0,0,0,0,1038140,"2024-01-13T00:00:00.000Z",27,FALSE,5,305,"F",27,27,"San Antonio Spurs","Doug McDermott",0,0,0,0,0,0
0,0,0,0,0,0,0,0,0,"00",0,0,0,0,0,0,1038140,"2024-01-13T00:00:00.000Z",27,FALSE,5,56677822,"F-C",27,27,"San Antonio Spurs","Victor Wembanyama",0,0,0,0,0,0
0,0,0,0,0,0,0,0,0,"00",0,0,0,0,0,0,1038140,"2024-01-13T00:00:00.000Z",27,FALSE,5,27,"G",5,5,"Chicago Bulls","Lonzo Ball",0,0,0,0,0,0
0,0,0,0,0,0,0,0,0,"00",0,0,0,0,0,0,1038140,"2024-01-13T00:00:00.000Z",27,FALSE,5,56677874,"F",5,5,"Chicago Bulls","Onuralp Bitim",0,0,0,0,0,0
0,0,0,0,0,0,0,0,0,"00",0,0,0,0,0,0,1038140,"2024-01-13T00:00:00.000Z",27,FALSE,5,NA,NA,NA,5,"Chicago Bulls","NA NA",0,0,0,0,0,0
0,0,0,0,0,0,0,0,0,"00",0,0,0,0,0,0,1038140,"2024-01-13T00:00:00.000Z",27,FALSE,5,56677857,"F",5,5,"Chicago Bulls","Julian Phillips",0,0,0,0,0,0
4,0,2,3,0,5,0,0,0,"24",2,3,0,4,0,1,1038141,"2024-01-13T00:00:00.000Z",29,FALSE,14,38017739,"F",29,29,"Utah Jazz","Simone Fontecchio",0,4,8,4,8,9.8
5,1,7,6,3,17,8,11,10,"33",3,0,29,10,2,0,1038141,"2024-01-13T00:00:00.000Z",29,FALSE,14,297,"F",29,29,"Utah Jazz","Lauri Markkanen",3,39,44,34,15,57.5
2,1,11,4,3,9,7,2,2,"34",2,5,19,13,3,1,1038141,"2024-01-13T00:00:00.000Z",29,FALSE,14,101,"F-C",29,29,"Utah Jazz","John Collins",4,32,34,21,15,48.6
5,0,3,4,1,13,8,10,10,"28",1,5,27,4,0,1,1038141,"2024-01-13T00:00:00.000Z",29,FALSE,14,413,"G",29,29,"Utah Jazz","Collin Sexton",0,31,36,32,9,38.3
3,0,0,2,1,4,3,0,0,"17",0,2,7,0,1,2,1038141,"2024-01-13T00:00:00.000Z",29,FALSE,14,139,"G",29,29,"Utah Jazz","Kris Dunn",1,7,10,10,3,12.5
4,1,2,6,1,18,6,8,8,"31",2,2,21,4,0,2,1038141,"2024-01-13T00:00:00.000Z",29,FALSE,14,100,"G",29,29,"Utah Jazz","Jordan Clarkson",1,25,29,25,8,32.8
3,0,3,9,3,11,5,6,6,"26",0,0,19,3,1,1,1038141,"2024-01-13T00:00:00.000Z",29,FALSE,14,56677834,"G",29,29,"Utah Jazz","Keyonte George",1,22,25,22,6,29.1
0,1,4,0,0,4,2,2,0,"14",2,2,4,6,0,0,1038141,"2024-01-13T00:00:00.000Z",29,FALSE,14,38017705,"C",29,29,"Utah Jazz","Walker Kessler",1,10,10,4,6,14.2
0,0,0,0,0,0,0,0,0,"00",0,0,0,0,0,0,1038141,"2024-01-13T00:00:00.000Z",29,FALSE,14,11891374,"C",29,29,"Utah Jazz","Omer Yurtseven",0,0,0,0,0,0
0,0,0,0,0,0,0,0,0,"00",0,0,0,0,0,0,1038141,"2024-01-13T00:00:00.000Z",29,FALSE,14,56677824,"F",29,29,"Utah Jazz","Taylor Hendricks",0,0,0,0,0,0
0,0,0,0,0,0,0,0,0,"00",0,0,0,0,0,0,1038141,"2024-01-13T00:00:00.000Z",29,FALSE,14,38017630,"G",29,29,"Utah Jazz","Johnny Juzang",0,0,0,0,0,0
0,0,0,0,0,0,0,0,0,"00",0,0,0,0,0,0,1038141,"2024-01-13T00:00:00.000Z",29,FALSE,14,19465584,"F",29,29,"Utah Jazz","Micah Potter",0,0,0,0,0,0
0,0,0,0,0,0,0,0,0,"00",0,0,0,0,0,0,1038141,"2024-01-13T00:00:00.000Z",29,FALSE,14,17896042,"G",13,29,"Utah Jazz","Jason Preston",0,0,0,0,0,0
0,0,0,0,0,0,0,0,0,"00",0,0,0,0,0,0,1038141,"2024-01-13T00:00:00.000Z",29,FALSE,14,56677842,"F",29,29,"Utah Jazz","Brice Sensabaugh",0,0,0,0,0,0
1,1,1,4,2,8,5,0,0,"30",0,3,12,1,0,0,1038141,"2024-01-13T00:00:00.000Z",29,FALSE,14,383,"F",14,14,"Los Angeles Lakers","Taurean Prince",1,13,14,13,2,17.7
0,0,0,0,0,0,0,0,0,"00",0,0,0,0,0,0,1038141,"2024-01-13T00:00:00.000Z",29,FALSE,14,56677738,"C",14,14,"Los Angeles Lakers","Colin Castleton",0,0,0,0,0,0
3,0,0,1,1,2,1,0,0,"14",0,3,3,0,1,0,1038141,"2024-01-13T00:00:00.000Z",29,FALSE,14,38017697,"G",14,14,"Los Angeles Lakers","Max Christie",1,3,6,6,3,10.5
1,0,2,2,0,12,6,6,5,"19",1,0,17,3,1,0,1038141,"2024-01-13T00:00:00.000Z",29,FALSE,14,666609,"F",14,14,"Los Angeles Lakers","Rui Hachimura",1,20,21,18,4,25.1
0,0,0,0,0,0,0,0,0,"00",0,0,0,0,0,0,1038141,"2024-01-13T00:00:00.000Z",29,FALSE,14,666626,"C",14,14,"Los Angeles Lakers","Jaxson Hayes",0,0,0,0,0,0
0,0,0,0,0,0,0,0,0,"00",0,0,0,0,0,0,1038141,"2024-01-13T00:00:00.000Z",29,FALSE,14,56677835,"G",14,14,"Los Angeles Lakers","Jalen Hood-Schifino",0,0,0,0,0,0
2,0,1,0,0,2,0,0,0,"10",0,2,0,1,1,0,1038141,"2024-01-13T00:00:00.000Z",29,FALSE,14,3547289,"G",25,14,"Los Angeles Lakers","Skylar Mays",1,1,3,2,3,7.2
1,0,1,1,1,2,2,0,0,"23",2,4,5,3,1,2,1038141,"2024-01-13T00:00:00.000Z",29,FALSE,14,457,"F",14,14,"Los Angeles Lakers","Jarred Vanderbilt",1,8,9,6,4,11.1
1,1,8,6,2,10,5,3,3,"22",1,1,15,9,0,0,1038141,"2024-01-13T00:00:00.000Z",29,FALSE,14,486,"F",14,14,"Los Angeles Lakers","Christian Wood",1,24,25,16,10,30.3
0,0,0,0,0,0,0,0,0,"00",0,0,0,0,0,0,1038141,"2024-01-13T00:00:00.000Z",29,FALSE,14,237,"F",14,14,"Los Angeles Lakers","LeBron James",0,0,0,0,0,0
0,0,0,0,0,0,0,0,0,"00",0,0,0,0,0,0,1038141,"2024-01-13T00:00:00.000Z",29,FALSE,14,56677836,"F",14,14,"Los Angeles Lakers","Maxwell Lewis",0,0,0,0,0,0
0,0,0,0,0,0,0,0,0,"00",0,0,0,0,0,0,1038141,"2024-01-13T00:00:00.000Z",29,FALSE,14,1603383,"G",14,14,"Los Angeles Lakers","Gabe Vincent",0,0,0,0,0,0
0,0,0,0,0,0,0,0,0,"00",0,0,0,0,0,0,1038141,"2024-01-13T00:00:00.000Z",29,FALSE,14,666971,"G-F",20,14,"Los Angeles Lakers","Dylan Windler",0,0,0,0,0,0
11,4,13,1,0,21,5,6,5,"39",2,1,15,15,1,6,1038141,"2024-01-13T00:00:00.000Z",29,FALSE,14,117,"F-C",14,14,"Los Angeles Lakers","Anthony Davis",5,30,41,26,26,58.5
2,0,3,2,1,8,7,6,4,"31",1,6,19,4,0,1,1038141,"2024-01-13T00:00:00.000Z",29,FALSE,14,17553995,"G",14,14,"Los Angeles Lakers","Austin Reaves",0,23,25,21,6,25.8
8,2,3,11,6,26,15,3,3,"41",0,3,39,3,1,3,1038141,"2024-01-13T00:00:00.000Z",29,FALSE,14,405,"G",14,14,"Los Angeles Lakers","D'Angelo Russell",3,42,50,47,11,60.6
0,1,3,2,0,5,1,0,0,"18",1,0,2,4,0,0,1038141,"2024-01-13T00:00:00.000Z",29,FALSE,14,38017620,"G",29,29,"Utah Jazz","Ochai Agbaji",1,6,6,2,4,9.8
2,0,4,1,0,8,2,0,0,"15",1,1,4,5,0,2,1038141,"2024-01-13T00:00:00.000Z",29,FALSE,14,358,"F",29,29,"Utah Jazz","Kelly Olynyk",0,9,11,6,7,11
0,0,0,0,0,0,0,0,0,"00",0,0,0,0,0,0,1038141,"2024-01-13T00:00:00.000Z",29,FALSE,14,666650,"G",29,29,"Utah Jazz","Talen Horton-Tucker",0,0,0,0,0,0
0,0,0,0,0,0,0,0,0,"00",0,0,0,0,0,0,1038141,"2024-01-13T00:00:00.000Z",29,FALSE,14,666881,"F",29,29,"Utah Jazz","Luka Samanic",0,0,0,0,0,0
0,0,1,1,0,1,0,0,0,"11",0,0,0,1,0,0,1038141,"2024-01-13T00:00:00.000Z",29,FALSE,14,666860,"F-G",14,14,"Los Angeles Lakers","Cameron Reddish",0,1,1,0,1,1.2
2,0,0,2,0,4,1,0,0,"23",2,1,2,2,0,0,1038146,"2024-01-14T00:00:00.000Z",25,FALSE,24,56677850,"F",25,25,"Portland Trail Blazers","Toumani Camara",0,4,6,4,4,7.4
1,0,6,3,2,6,4,2,1,"29",2,2,11,8,0,1,1038146,"2024-01-14T00:00:00.000Z",25,FALSE,24,38017711,"F",25,25,"Portland Trail Blazers","Jabari Walker",0,19,20,12,9,21.1
1,1,4,6,2,15,7,1,1,"39",2,4,17,6,2,2,1038146,"2024-01-14T00:00:00.000Z",25,FALSE,24,56783340,"C",25,25,"Portland Trail Blazers","Duop Reath",3,23,24,18,7,32.7
9,0,3,9,4,31,11,9,7,"40",4,3,33,7,3,3,1038146,"2024-01-14T00:00:00.000Z",25,FALSE,24,56677747,"G",25,25,"Portland Trail Blazers","Scoot Henderson",3,40,49,42,16,60.9
5,0,5,12,6,18,8,7,6,"41",0,2,28,5,0,3,1038146,"2024-01-14T00:00:00.000Z",25,FALSE,24,419,"G",25,25,"Portland Trail Blazers","Anfernee Simons",0,33,38,33,10,38.5
0,0,0,0,0,0,0,0,0,"00",0,0,0,0,0,0,1038146,"2024-01-14T00:00:00.000Z",25,FALSE,24,65,"G",25,25,"Portland Trail Blazers","Malcolm Brogdon",0,0,0,0,0,0
0,0,0,0,0,0,0,0,0,"00",0,0,0,0,0,0,1038146,"2024-01-14T00:00:00.000Z",25,FALSE,24,666476,"C",25,25,"Portland Trail Blazers","Moses Brown",0,0,0,0,0,0
0,0,0,0,0,0,0,0,0,"00",0,0,0,0,0,0,1038146,"2024-01-14T00:00:00.000Z",25,FALSE,24,182,"F",25,25,"Portland Trail Blazers","Jerami Grant",0,0,0,0,0,0
0,0,2,1,0,1,0,2,1,"17",0,5,1,2,0,0,1038146,"2024-01-14T00:00:00.000Z",25,FALSE,24,47957121,"F",25,25,"Portland Trail Blazers","Justin Minaya",0,3,3,1,2,3.4
3,0,1,6,3,9,5,1,0,"37",0,2,13,1,3,3,1038146,"2024-01-14T00:00:00.000Z",25,FALSE,24,56677791,"F",25,25,"Portland Trail Blazers","Kris Murray",3,14,17,16,4,24.7
2,0,3,3,3,5,4,0,0,"14",2,2,11,5,0,1,1038146,"2024-01-14T00:00:00.000Z",25,FALSE,24,56677829,"G-F",25,25,"Portland Trail Blazers","Rayan Rupert",0,16,18,13,7,19
0,0,1,0,0,1,0,0,0,"04",0,0,0,1,0,0,1038146,"2024-01-14T00:00:00.000Z",25,FALSE,24,147,"F",24,24,"Phoenix Suns","Drew Eubanks",0,1,1,0,1,1.2
0,0,0,0,0,0,0,0,0,"00",0,0,0,0,0,0,1038146,"2024-01-14T00:00:00.000Z",25,FALSE,24,18678058,"",24,24,"Phoenix Suns","Jordan Goodwin",0,0,0,0,0,0
0,0,0,0,0,0,0,0,0,"00",0,0,0,0,0,0,1038146,"2024-01-14T00:00:00.000Z",25,FALSE,24,666923,"G-F",25,25,"Portland Trail Blazers","Matisse Thybulle",0,0,0,0,0,0
0,0,0,0,0,0,0,0,0,"00",0,0,0,0,0,0,1038146,"2024-01-14T00:00:00.000Z",25,FALSE,24,22,"C",25,25,"Portland Trail Blazers","Deandre Ayton",0,0,0,0,0,0
0,0,0,0,0,0,0,0,0,"00",0,0,0,0,0,0,1038146,"2024-01-14T00:00:00.000Z",25,FALSE,24,39613724,"C",25,25,"Portland Trail Blazers","Ibou Badji",0,0,0,0,0,0
0,0,0,0,0,0,0,0,0,"00",0,0,0,0,0,0,1038146,"2024-01-14T00:00:00.000Z",25,FALSE,24,38017690,"G",25,25,"Portland Trail Blazers","Shaedon Sharpe",0,0,0,0,0,0
0,0,0,0,0,0,0,0,0,"00",0,0,0,0,0,0,1038146,"2024-01-14T00:00:00.000Z",25,FALSE,24,476,"C-F",25,25,"Portland Trail Blazers","Robert Williams III",0,0,0,0,0,0
6,0,4,5,2,16,8,3,3,"38",1,4,21,5,0,3,1038146,"2024-01-14T00:00:00.000Z",25,FALSE,24,140,"F",24,24,"Phoenix Suns","Kevin Durant",0,26,32,27,11,33
1,2,3,6,4,6,4,8,8,"33",1,2,20,4,0,4,1038146,"2024-01-14T00:00:00.000Z",25,FALSE,24,8,"G",24,24,"Phoenix Suns","Grayson Allen",2,24,25,21,5,28.3
3,0,1,1,0,3,2,0,0,"13",1,1,4,2,0,0,1038146,"2024-01-14T00:00:00.000Z",25,FALSE,24,32,"F",24,24,"Phoenix Suns","Keita Bates-Diop",0,6,9,7,5,10.9
0,0,0,0,0,0,0,0,0,"00",0,0,0,0,0,0,1038146,"2024-01-14T00:00:00.000Z",25,FALSE,24,3547298,"G",24,24,"Phoenix Suns","Saben Lee",0,0,0,0,0,0
0,0,0,0,0,0,0,0,0,"00",0,0,0,0,0,0,1038146,"2024-01-14T00:00:00.000Z",25,FALSE,24,666729,"F",24,24,"Phoenix Suns","Nassir Little",0,0,0,0,0,0
0,2,3,1,1,3,3,2,1,"17",0,3,8,3,1,0,1038146,"2024-01-14T00:00:00.000Z",25,FALSE,24,314,"F",24,24,"Phoenix Suns","Chimezie Metu",3,11,11,8,3,20.6
0,0,1,0,0,0,0,0,0,"07",0,1,0,1,0,0,1038146,"2024-01-14T00:00:00.000Z",25,FALSE,24,356,"G",24,24,"Phoenix Suns","Josh Okogie",0,1,1,0,1,1.2
0,0,0,0,0,0,0,0,0,"00",0,0,0,0,0,0,1038146,"2024-01-14T00:00:00.000Z",25,FALSE,24,470,"G",24,24,"Phoenix Suns","Yuta Watanabe",0,0,0,0,0,0
0,0,0,0,0,0,0,0,0,"00",0,0,0,0,0,0,1038146,"2024-01-14T00:00:00.000Z",25,FALSE,24,3547095,"C-F",24,24,"Phoenix Suns","Udoka Azubuike",0,0,0,0,0,0
0,0,0,0,0,0,0,0,0,"00",0,0,0,0,0,0,1038146,"2024-01-14T00:00:00.000Z",25,FALSE,24,666451,"C",24,24,"Phoenix Suns","Bol Bol",0,0,0,0,0,0
0,0,0,0,0,0,0,0,0,"00",0,0,0,0,0,0,1038146,"2024-01-14T00:00:00.000Z",25,FALSE,24,272,"G",24,24,"Phoenix Suns","Damion Lee",0,0,0,0,0,0
0,0,0,0,0,0,0,0,0,"00",0,0,0,0,0,0,1038146,"2024-01-14T00:00:00.000Z",25,FALSE,24,3547253,"G",4,24,"Phoenix Suns","Theo Maledon",0,0,0,0,0,0
1,1,9,0,0,8,5,6,4,"27",4,3,14,13,3,1,1038146,"2024-01-14T00:00:00.000Z",25,FALSE,24,349,"C",24,24,"Phoenix Suns","Jusuf Nurkic",4,27,28,15,14,42.1
5,0,4,6,4,13,9,3,1,"38",0,4,23,4,2,4,1038146,"2024-01-14T00:00:00.000Z",25,FALSE,24,37,"G",24,24,"Phoenix Suns","Bradley Beal",2,27,32,28,9,37.3
7,0,6,6,1,22,14,5,5,"39",0,2,34,6,0,0,1038146,"2024-01-14T00:00:00.000Z",25,FALSE,24,57,"G",24,24,"Phoenix Suns","Devin Booker",0,40,47,41,13,51.7
4,0,2,3,1,4,1,0,0,"24",0,0,3,2,1,0,1038146,"2024-01-14T00:00:00.000Z",25,FALSE,24,178,"G",24,24,"Phoenix Suns","Eric Gordon",1,5,9,7,6,14.4
5,2,8,11,7,15,9,0,0,"37",0,1,25,8,1,1,1038142,"2024-01-14T00:00:00.000Z",8,FALSE,12,375,"F",8,8,"Denver Nuggets","Michael Porter Jr.",3,33,38,30,13,50.1
3,0,9,1,0,10,7,8,6,"37",1,0,20,10,0,2,1038142,"2024-01-14T00:00:00.000Z",8,FALSE,12,177,"F",8,8,"Denver Nuggets","Aaron Gordon",0,30,33,23,13,34.5
9,1,9,0,0,13,12,2,1,"33",3,3,25,12,2,7,1038142,"2024-01-14T00:00:00.000Z",8,FALSE,12,246,"C",8,8,"Denver Nuggets","Nikola Jokic",3,37,46,34,21,54.9
1,0,2,3,2,4,3,3,3,"37",0,2,11,2,2,1,1038142,"2024-01-14T00:00:00.000Z",8,FALSE,12,81,"G",8,8,"Denver Nuggets","Kentavious Caldwell-Pope",2,13,14,12,3,19.9
8,0,1,4,1,18,11,4,2,"36",0,3,25,1,1,5,1038142,"2024-01-14T00:00:00.000Z",8,FALSE,12,335,"G",8,8,"Denver Nuggets","Jamal Murray",1,26,34,33,9,36.2
0,0,2,1,0,5,1,2,0,"15",0,1,2,2,0,0,1038142,"2024-01-14T00:00:00.000Z",8,FALSE,12,38017709,"G",8,8,"Denver Nuggets","Christian Braun",0,4,4,2,2,4.4
0,0,0,0,0,0,0,0,0,"00",0,0,0,0,0,0,1038142,"2024-01-14T00:00:00.000Z",8,FALSE,12,38017727,"G",8,8,"Denver Nuggets","Collin Gillespie",0,0,0,0,0,0
0,0,0,0,0,0,0,0,0,"01",0,0,0,0,0,0,1038142,"2024-01-14T00:00:00.000Z",8,FALSE,12,215,"F-G",8,8,"Denver Nuggets","Justin Holiday",0,0,0,0,0,0
0,0,0,0,0,0,0,0,0,"00",0,0,0,0,0,0,1038142,"2024-01-14T00:00:00.000Z",8,FALSE,12,17896103,"F-C",8,8,"Denver Nuggets","Jay Huff",0,0,0,0,0,0
4,0,0,0,0,3,3,4,3,"23",0,1,9,0,1,3,1038142,"2024-01-14T00:00:00.000Z",8,FALSE,12,236,"G",8,8,"Denver Nuggets","Reggie Jackson",1,9,13,13,4,15
1,0,2,0,0,0,0,0,0,"07",0,4,0,2,0,2,1038142,"2024-01-14T00:00:00.000Z",8,FALSE,12,250,"C",8,8,"Denver Nuggets","DeAndre Jordan",0,2,3,1,3,1.9
0,0,0,0,0,0,0,0,0,"00",0,0,0,0,0,0,1038142,"2024-01-14T00:00:00.000Z",8,FALSE,12,17896007,"G",8,8,"Denver Nuggets","Braxton Key",0,0,0,0,0,0
0,0,0,0,0,0,0,0,0,"00",0,0,0,0,0,0,1038142,"2024-01-14T00:00:00.000Z",8,FALSE,12,3547268,"F-C",8,8,"Denver Nuggets","Zeke Nnaji",0,0,0,0,0,0
0,0,3,0,0,3,0,0,0,"14",0,3,0,3,1,0,1038142,"2024-01-14T00:00:00.000Z",8,FALSE,12,38017721,"G",8,8,"Denver Nuggets","Peyton Watson",1,3,3,0,3,6.6
0,0,0,0,0,0,0,0,0,"00",0,0,0,0,0,0,1038142,"2024-01-14T00:00:00.000Z",8,FALSE,12,666489,"F",8,8,"Denver Nuggets","Vlatko Cancar",0,0,0,0,0,0
0,0,0,0,0,0,0,0,0,"00",0,0,0,0,0,0,1038142,"2024-01-14T00:00:00.000Z",8,FALSE,12,56677582,"G",8,8,"Denver Nuggets","Jalen Pickett",0,0,0,0,0,0
0,0,0,0,0,0,0,0,0,"00",0,0,0,0,0,0,1038142,"2024-01-14T00:00:00.000Z",8,FALSE,12,56677776,"G",8,8,"Denver Nuggets","Julian Strawther",0,0,0,0,0,0
0,0,0,0,0,0,0,0,0,"00",0,0,0,0,0,0,1038142,"2024-01-14T00:00:00.000Z",8,FALSE,12,56677871,"F",8,8,"Denver Nuggets","Hunter Tyson",0,0,0,0,0,0
1,0,2,9,2,13,6,2,2,"28",0,2,16,2,2,1,1038142,"2024-01-14T00:00:00.000Z",8,FALSE,12,210,"G",12,12,"Indiana Pacers","Buddy Hield",2,18,19,17,3,24.9
3,0,1,1,0,7,4,1,0,"25",2,2,8,3,0,0,1038142,"2024-01-14T00:00:00.000Z",8,FALSE,12,3547264,"F-C",12,12,"Indiana Pacers","Jalen Smith",0,11,14,11,6,16.1
1,1,3,4,0,11,5,3,2,"26",1,5,12,4,2,3,1038142,"2024-01-14T00:00:00.000Z",8,FALSE,12,452,"C-F",12,12,"Indiana Pacers","Myles Turner",3,16,17,13,5,24.3
6,0,5,2,1,16,8,3,1,"33",5,3,18,10,3,2,1038142,"2024-01-14T00:00:00.000Z",8,FALSE,12,69,"G",12,12,"Indiana Pacers","Bruce Brown",3,28,34,24,16,46
7,0,1,1,0,8,4,6,4,"29",1,0,12,2,0,2,1038142,"2024-01-14T00:00:00.000Z",8,FALSE,12,38017507,"G-F",12,12,"Indiana Pacers","Andrew Nembhard",0,14,21,19,9,22.9
0,0,0,0,0,0,0,0,0,"00",0,0,0,0,0,0,1038142,"2024-01-14T00:00:00.000Z",8,FALSE,12,38017701,"G",12,12,"Indiana Pacers","Kendall Brown",0,0,0,0,0,0
1,0,4,0,0,9,6,0,0,"20",3,3,12,7,2,2,1038142,"2024-01-14T00:00:00.000Z",8,FALSE,12,17896035,"F",12,12,"Indiana Pacers","Isaiah Jackson",2,19,20,13,8,25.9
0,0,0,0,0,0,0,0,0,"00",0,0,0,0,0,0,1038142,"2024-01-14T00:00:00.000Z",8,FALSE,12,242,"F",12,12,"Indiana Pacers","James Johnson",0,0,0,0,0,0
2,0,2,3,1,9,3,5,5,"22",1,3,12,3,0,2,1038142,"2024-01-14T00:00:00.000Z",8,FALSE,12,38017686,"G-F",12,12,"Indiana Pacers","Bennedict Mathurin",0,15,17,14,5,16.6
5,0,1,2,0,9,2,2,1,"19",1,0,5,2,0,1,1038142,"2024-01-14T00:00:00.000Z",8,FALSE,12,304,"G",12,12,"Indiana Pacers","T.J. McConnell",0,7,12,10,7,13.9
1,0,1,4,1,5,1,0,0,"13",0,1,3,1,1,0,1038142,"2024-01-14T00:00:00.000Z",8,FALSE,12,3547207,"F",12,12,"Indiana Pacers","Jordan Nwora",1,4,5,4,2,8.7
0,0,0,0,0,0,0,0,0,"00",0,0,0,0,0,0,1038142,"2024-01-14T00:00:00.000Z",8,FALSE,12,56677861,"G",12,12,"Indiana Pacers","Ben Sheppard",0,0,0,0,0,0
0,0,3,3,3,5,4,0,0,"25",0,2,11,3,1,0,1038142,"2024-01-14T00:00:00.000Z",8,FALSE,12,3547243,"F",12,12,"Indiana Pacers","Obi Toppin",1,14,14,11,3,17.6
0,0,0,0,0,0,0,0,0,"00",0,0,0,0,0,0,1038142,"2024-01-14T00:00:00.000Z",8,FALSE,12,56677778,"F-C",12,12,"Indiana Pacers","Oscar Tshiebwe",0,0,0,0,0,0
0,0,0,0,0,0,0,0,0,"00",0,0,0,0,0,0,1038142,"2024-01-14T00:00:00.000Z",8,FALSE,12,56677832,"F",12,12,"Indiana Pacers","Jarace Walker",0,0,0,0,0,0
0,0,0,0,0,0,0,0,0,"00",0,0,0,0,0,0,1038142,"2024-01-14T00:00:00.000Z",8,FALSE,12,3547245,"G",12,12,"Indiana Pacers","Tyrese Haliburton",0,0,0,0,0,0
0,0,0,0,0,0,0,0,0,"00",0,0,0,0,0,0,1038142,"2024-01-14T00:00:00.000Z",8,FALSE,12,3547250,"G-F",12,12,"Indiana Pacers","Aaron Nesmith",0,0,0,0,0,0
0,0,0,0,0,0,0,0,0,"00",0,0,0,0,0,0,1038142,"2024-01-14T00:00:00.000Z",8,FALSE,12,56677794,"G",12,12,"Indiana Pacers","Isaiah Wong",0,0,0,0,0,0
2,0,4,0,0,11,7,1,1,"15",1,1,15,5,1,0,1038143,"2024-01-14T00:00:00.000Z",16,FALSE,4,56677785,"G",16,16,"Miami Heat","Jaime Jaquez Jr.",1,20,22,17,7,27
2,2,6,2,1,6,2,0,0,"28",1,3,5,7,0,3,1038143,"2024-01-14T00:00:00.000Z",16,FALSE,4,38017696,"F",16,16,"Miami Heat","Nikola Jovic",2,12,14,7,9,19.4
7,1,10,1,0,17,9,8,6,"35",0,3,24,10,0,2,1038143,"2024-01-14T00:00:00.000Z",16,FALSE,4,4,"C-F",16,16,"Miami Heat","Bam Adebayo",1,34,41,31,17,47.5
4,0,6,9,4,15,7,4,3,"28",1,1,21,7,1,3,1038143,"2024-01-14T00:00:00.000Z",16,FALSE,4,666633,"G",16,16,"Miami Heat","Tyler Herro",1,28,32,25,11,35.4
3,1,4,1,0,3,0,0,0,"26",0,1,0,4,0,2,1038143,"2024-01-14T00:00:00.000Z",16,FALSE,4,286,"G",16,16,"Miami Heat","Kyle Lowry",1,4,7,3,7,10.3
0,0,0,0,0,0,0,0,0,"00",0,0,0,0,0,0,1038143,"2024-01-14T00:00:00.000Z",16,FALSE,4,74,"C",16,16,"Miami Heat","Thomas Bryant",0,0,0,0,0,0
2,1,2,1,1,5,3,0,0,"31",0,0,7,2,2,0,1038143,"2024-01-14T00:00:00.000Z",16,FALSE,4,3092,"",16,16,"Miami Heat","Haywood Highsmith",3,9,11,9,4,21.4
0,0,0,0,0,0,0,0,0,"00",0,0,0,0,0,0,1038143,"2024-01-14T00:00:00.000Z",16,FALSE,4,285,"F-C",16,16,"Miami Heat","Kevin Love",0,0,0,0,0,0
2,0,3,2,0,5,1,0,0,"25",0,2,2,3,1,1,1038143,"2024-01-14T00:00:00.000Z",16,FALSE,4,666747,"F",16,16,"Miami Heat","Caleb Martin",1,5,7,4,5,10.6
0,0,1,3,2,8,4,1,1,"20",1,1,11,2,0,1,1038143,"2024-01-14T00:00:00.000Z",16,FALSE,4,391,"G-F",16,16,"Miami Heat","Josh Richardson",0,13,13,11,2,12.4
5,1,4,6,3,11,7,2,2,"30",0,2,19,4,1,2,1038143,"2024-01-14T00:00:00.000Z",16,FALSE,4,397,"F",16,16,"Miami Heat","Duncan Robinson",2,23,28,24,9,35.3
0,0,0,0,0,0,0,0,0,"02",0,1,0,0,0,0,1038143,"2024-01-14T00:00:00.000Z",16,FALSE,4,39398582,"C",16,16,"Miami Heat","Orlando Robinson",0,0,0,0,0,0
0,0,0,0,0,0,0,0,0,"00",0,0,0,0,0,0,1038143,"2024-01-14T00:00:00.000Z",16,FALSE,4,79,"G-F",16,16,"Miami Heat","Jimmy Butler",0,0,0,0,0,0
0,0,0,0,0,0,0,0,0,"00",0,0,0,0,0,0,1038143,"2024-01-14T00:00:00.000Z",16,FALSE,4,38017734,"F",16,16,"Miami Heat","Jamal Cain",0,0,0,0,0,0
0,0,0,0,0,0,0,0,0,"00",0,0,0,0,0,0,1038143,"2024-01-14T00:00:00.000Z",16,FALSE,4,3547257,"G",16,16,"Miami Heat","R.J. Hampton",0,0,0,0,0,0
0,0,0,0,0,0,0,0,0,"00",0,0,0,0,0,0,1038143,"2024-01-14T00:00:00.000Z",16,FALSE,4,19465585,"G",16,16,"Miami Heat","Dru Smith",0,0,0,0,0,0
0,0,0,0,0,0,0,0,0,"00",0,0,0,0,0,0,1038143,"2024-01-14T00:00:00.000Z",16,FALSE,4,38017736,"F",16,16,"Miami Heat","Cole Swider",0,0,0,0,0,0
2,2,0,2,1,3,1,0,0,"23",2,1,3,2,0,3,1038143,"2024-01-14T00:00:00.000Z",16,FALSE,4,666748,"F",4,4,"Charlotte Hornets","Cody Martin",2,5,7,5,4,11.4
1,0,6,7,1,17,8,3,3,"38",1,0,20,7,1,3,1038143,"2024-01-14T00:00:00.000Z",16,FALSE,4,62,"F",4,4,"Charlotte Hornets","Miles Bridges",1,27,28,21,8,29.9
0,0,8,0,0,5,1,0,0,"27",0,4,2,8,0,1,1038143,"2024-01-14T00:00:00.000Z",16,FALSE,4,3547282,"C",4,4,"Charlotte Hornets","Nick Richards",0,10,10,2,8,10.6
7,0,3,11,4,23,8,6,6,"35",2,2,26,5,0,1,1038143,"2024-01-14T00:00:00.000Z",16,FALSE,4,403,"G",4,4,"Charlotte Hornets","Terry Rozier",0,31,38,33,12,41.5
5,0,8,12,3,24,9,0,0,"31",2,3,21,10,3,2,1038143,"2024-01-14T00:00:00.000Z",16,FALSE,4,3547239,"G",4,4,"Charlotte Hornets","LaMelo Ball",3,31,36,26,15,47.5
0,0,0,0,0,0,0,0,0,"02",0,0,0,0,0,0,1038143,"2024-01-14T00:00:00.000Z",16,FALSE,4,56677866,"F",4,4,"Charlotte Hornets","Leaky Black",0,0,0,0,0,0
0,0,0,0,0,1,0,2,1,"02",0,0,1,0,0,0,1038143,"2024-01-14T00:00:00.000Z",16,FALSE,4,17896037,"G",4,4,"Charlotte Hornets","James Bouknight",0,1,1,1,0,1
0,0,1,1,0,2,1,0,0,"05",1,0,2,2,0,0,1038143,"2024-01-14T00:00:00.000Z",16,FALSE,4,38017708,"G",4,4,"Charlotte Hornets","Bryce McGowens",0,4,4,2,2,4.4
0,0,0,0,0,1,1,0,0,"11",2,3,2,2,0,0,1038143,"2024-01-14T00:00:00.000Z",16,FALSE,4,NA,NA,NA,4,"Charlotte Hornets","NA NA",0,4,4,2,2,4.4
0,0,0,0,0,0,0,0,0,"00",0,0,0,0,0,0,1038143,"2024-01-14T00:00:00.000Z",16,FALSE,4,56677823,"F",4,4,"Charlotte Hornets","Brandon Miller",0,0,0,0,0,0
0,0,1,0,0,1,0,2,1,"12",1,0,1,2,0,0,1038143,"2024-01-14T00:00:00.000Z",16,FALSE,4,422,"G",4,4,"Charlotte Hornets","Ish Smith",0,3,3,1,2,3.4
0,0,2,2,0,5,2,0,0,"16",0,0,4,2,0,2,1038143,"2024-01-14T00:00:00.000Z",16,FALSE,4,56677846,"G",4,4,"Charlotte Hornets","Nick Smith Jr.",0,6,6,4,2,4.4
1,1,0,0,0,6,0,0,0,"10",4,1,0,4,0,0,1038143,"2024-01-14T00:00:00.000Z",16,FALSE,4,18678001,"F",4,4,"Charlotte Hornets","JT Thor",1,4,5,1,5,9.3
1,0,4,5,1,7,2,2,0,"28",2,3,5,6,1,1,1038143,"2024-01-14T00:00:00.000Z",16,FALSE,4,666950,"F",4,4,"Charlotte Hornets","P.J. Washington",1,11,12,6,7,15.7
0,0,0,0,0,0,0,0,0,"00",0,0,0,0,0,0,1038143,"2024-01-14T00:00:00.000Z",16,FALSE,4,56677848,"G",4,4,"Charlotte Hornets","Amari Bailey",0,0,0,0,0,0
0,0,0,0,0,0,0,0,0,"00",0,0,0,0,0,0,1038143,"2024-01-14T00:00:00.000Z",16,FALSE,4,204,"F",4,4,"Charlotte Hornets","Gordon Hayward",0,0,0,0,0,0
0,0,0,0,0,0,0,0,0,"00",0,0,0,0,0,0,1038143,"2024-01-14T00:00:00.000Z",16,FALSE,4,347,"G",4,4,"Charlotte Hornets","Frank Ntilikina",0,0,0,0,0,0
0,0,0,0,0,0,0,0,0,"00",0,0,0,0,0,0,1038143,"2024-01-14T00:00:00.000Z",16,FALSE,4,38017698,"C",4,4,"Charlotte Hornets","Mark Williams",0,0,0,0,0,0
1,0,0,0,0,0,0,0,0,"10",0,5,0,0,0,2,1038144,"2024-01-14T00:00:00.000Z",17,FALSE,26,56677852,"G",17,17,"Milwaukee Bucks","Andre Jackson Jr.",0,0,1,1,1,-0.5
10,0,9,2,0,16,9,14,9,"40",1,4,27,10,3,4,1038144,"2024-01-14T00:00:00.000Z",17,FALSE,26,15,"F",17,17,"Milwaukee Bucks","Giannis Antetokounmpo",3,37,47,37,20,59
3,3,8,6,3,15,7,0,0,"40",1,2,17,9,0,0,1038144,"2024-01-14T00:00:00.000Z",17,FALSE,26,283,"C",17,17,"Milwaukee Bucks","Brook Lopez",3,26,29,20,12,41.3
5,0,4,9,5,12,7,4,4,"45",0,5,23,4,1,1,1038144,"2024-01-14T00:00:00.000Z",17,FALSE,26,38,"G",17,17,"Milwaukee Bucks","Malik Beasley",1,27,32,28,9,37.3
8,0,4,13,5,23,9,6,6,"41",0,0,29,4,0,4,1038144,"2024-01-14T00:00:00.000Z",17,FALSE,26,278,"G",17,17,"Milwaukee Bucks","Damian Lillard",0,33,41,37,12,41.8
0,0,0,0,0,0,0,0,0,"00",0,0,0,0,0,0,1038144,"2024-01-14T00:00:00.000Z",17,FALSE,26,17896030,"G",26,26,"Sacramento Kings","Chris Duarte",0,0,0,0,0,0
0,0,0,0,0,0,0,0,0,"00",0,0,0,0,0,0,1038144,"2024-01-14T00:00:00.000Z",17,FALSE,26,17896044,"F",26,26,"Sacramento Kings","Kessler Edwards",0,0,0,0,0,0
0,0,0,0,0,0,0,0,0,"00",0,0,0,0,0,0,1038144,"2024-01-14T00:00:00.000Z",17,FALSE,26,38017714,"G",26,26,"Sacramento Kings","Keon Ellis",0,0,0,0,0,0
1,0,2,1,0,4,2,0,0,"11",3,3,4,5,0,0,1038144,"2024-01-14T00:00:00.000Z",17,FALSE,26,273,"C",26,26,"Sacramento Kings","Alex Len",0,9,10,5,6,11.5
2,0,6,7,3,8,3,0,0,"33",1,3,9,7,0,0,1038144,"2024-01-14T00:00:00.000Z",17,FALSE,26,290,"F",26,26,"Sacramento Kings","Trey Lyles",0,16,18,11,9,20.4
0,0,0,0,0,0,0,0,0,"00",0,0,0,0,0,0,1038144,"2024-01-14T00:00:00.000Z",17,FALSE,26,306,"C",26,26,"Sacramento Kings","JaVale McGee",0,0,0,0,0,0
0,0,0,0,0,0,0,0,0,"00",0,0,0,0,0,0,1038144,"2024-01-14T00:00:00.000Z",17,FALSE,26,17553994,"G",26,26,"Sacramento Kings","Davion Mitchell",0,0,0,0,0,0
0,0,0,0,0,0,0,0,0,"00",0,0,0,0,0,0,1038144,"2024-01-14T00:00:00.000Z",17,FALSE,26,2148,"",17,17,"Milwaukee Bucks","Thanasis Antetokounmpo",0,0,0,0,0,0
0,0,0,0,0,0,0,0,0,"00",0,0,0,0,0,0,1038144,"2024-01-14T00:00:00.000Z",17,FALSE,26,38017676,"F",17,17,"Milwaukee Bucks","MarJon Beauchamp",0,0,0,0,0,0
2,0,3,3,1,3,1,2,2,"33",0,3,5,3,0,0,1038144,"2024-01-14T00:00:00.000Z",17,FALSE,26,105,"G",17,17,"Milwaukee Bucks","Pat Connaughton",0,8,10,7,5,11.6
0,0,0,4,1,5,1,2,2,"18",0,2,5,0,0,0,1038144,"2024-01-14T00:00:00.000Z",17,FALSE,26,38017733,"G",17,17,"Milwaukee Bucks","A.J. Green",0,5,5,5,0,5
0,0,0,0,0,0,0,0,0,"00",0,0,0,0,0,0,1038144,"2024-01-14T00:00:00.000Z",17,FALSE,26,284,"C",17,17,"Milwaukee Bucks","Robin Lopez",0,0,0,0,0,0
1,0,0,4,3,7,5,2,2,"12",0,0,15,0,1,0,1038144,"2024-01-14T00:00:00.000Z",17,FALSE,26,368,"G",17,17,"Milwaukee Bucks","Cameron Payne",1,15,16,16,1,19.5
1,0,8,2,2,11,9,2,2,"26",2,1,22,10,0,2,1038144,"2024-01-14T00:00:00.000Z",17,FALSE,26,377,"F",17,17,"Milwaukee Bucks","Bobby Portis",0,32,33,23,11,33.5
1,0,1,4,1,9,6,1,1,"32",0,0,14,1,1,0,1038144,"2024-01-14T00:00:00.000Z",17,FALSE,26,30,"F",26,26,"Sacramento Kings","Harrison Barnes",1,15,16,15,2,19.7
15,1,10,1,1,10,9,2,2,"45",3,3,21,13,1,3,1038144,"2024-01-14T00:00:00.000Z",17,FALSE,26,406,"F",26,26,"Sacramento Kings","Domantas Sabonis",2,34,49,36,28,62.1
3,0,10,9,6,14,10,0,0,"39",0,4,26,10,1,1,1038144,"2024-01-14T00:00:00.000Z",17,FALSE,26,221,"G",26,26,"Sacramento Kings","Kevin Huerter",1,36,39,29,13,44.5
5,0,1,6,2,26,12,7,6,"43",1,4,32,2,3,4,1038144,"2024-01-14T00:00:00.000Z",17,FALSE,26,161,"G",26,26,"Sacramento Kings","De'Aaron Fox",3,34,39,37,7,46.9
0,0,0,0,0,0,0,0,0,"00",0,0,0,0,0,0,1038144,"2024-01-14T00:00:00.000Z",17,FALSE,26,666925,"F",29,26,"Sacramento Kings","Juan Toscano-Anderson",0,0,0,0,0,0
0,0,1,2,0,4,2,0,0,"06",0,0,4,1,0,0,1038144,"2024-01-14T00:00:00.000Z",17,FALSE,26,4197162,"F",26,26,"Sacramento Kings","Aleksandar Vezenkov",0,5,5,4,1,5.2
0,0,0,0,0,0,0,0,0,"00",0,0,0,0,0,0,1038144,"2024-01-14T00:00:00.000Z",17,FALSE,26,17895990,"G",26,26,"Sacramento Kings","Jordan Ford",0,0,0,0,0,0
0,0,0,0,0,0,0,0,0,"00",0,0,0,0,0,0,1038144,"2024-01-14T00:00:00.000Z",17,FALSE,26,56677845,"G",26,26,"Sacramento Kings","Colby Jones",0,0,0,0,0,0
0,0,0,0,0,0,0,0,0,"00",0,0,0,0,0,0,1038144,"2024-01-14T00:00:00.000Z",17,FALSE,26,56677862,"F",26,26,"Sacramento Kings","Jalen Slawson",0,0,0,0,0,0
0,0,0,0,0,0,0,0,0,"00",0,0,0,0,0,0,1038144,"2024-01-14T00:00:00.000Z",17,FALSE,26,315,"F",17,17,"Milwaukee Bucks","Khris Middleton",0,0,0,0,0,0
0,1,1,2,0,9,2,0,0,"20",0,1,4,1,0,0,1038144,"2024-01-14T00:00:00.000Z",17,FALSE,26,38017688,"F",26,26,"Sacramento Kings","Keegan Murray",1,5,5,4,1,8.2
7,0,6,9,4,21,9,10,6,"36",1,1,28,7,0,1,1038144,"2024-01-14T00:00:00.000Z",17,FALSE,26,324,"G",26,26,"Sacramento Kings","Malik Monk",0,35,42,35,14,45.9
0,0,0,0,0,0,0,0,0,"00",0,0,0,0,0,0,1038144,"2024-01-14T00:00:00.000Z",17,FALSE,26,38017691,"G",17,17,"Milwaukee Bucks","TyTy Washington Jr.",0,0,0,0,0,0
0,0,0,0,0,0,0,0,0,"00",0,0,0,0,0,0,1038144,"2024-01-14T00:00:00.000Z",17,FALSE,26,112,"F",17,17,"Milwaukee Bucks","Jae Crowder",0,0,0,0,0,0
0,0,0,0,0,0,0,0,0,"00",0,0,0,0,0,0,1038144,"2024-01-14T00:00:00.000Z",17,FALSE,26,56677854,"F",17,17,"Milwaukee Bucks","Chris Livingston",0,0,0,0,0,0
4,0,3,3,2,10,6,0,0,"35",1,2,14,4,2,4,1038145,"2024-01-14T00:00:00.000Z",18,FALSE,13,3547259,"F",18,18,"Minnesota Timberwolves","Jaden McDaniels",2,18,22,18,8,26.8
5,0,6,4,2,12,7,2,1,"37",0,4,17,6,0,4,1038145,"2024-01-14T00:00:00.000Z",18,FALSE,13,447,"C",18,18,"Minnesota Timberwolves","Karl-Anthony Towns",0,23,28,22,11,27.7
0,4,15,0,0,5,4,14,7,"37",3,4,15,18,0,1,1038145,"2024-01-14T00:00:00.000Z",18,FALSE,13,176,"C",18,18,"Minnesota Timberwolves","Rudy Gobert",4,33,33,15,18,47.6
6,0,8,4,2,16,10,12,11,"38",1,1,33,9,2,5,1038145,"2024-01-14T00:00:00.000Z",18,FALSE,13,3547238,"G",18,18,"Minnesota Timberwolves","Anthony Edwards",2,42,48,39,15,53.8
5,0,1,6,2,7,2,0,0,"32",1,2,6,2,1,2,1038145,"2024-01-14T00:00:00.000Z",18,FALSE,13,104,"G",18,18,"Minnesota Timberwolves","Mike Conley",1,8,13,11,7,16.9
1,1,0,5,2,6,2,0,0,"20",0,4,6,0,0,0,1038145,"2024-01-14T00:00:00.000Z",18,FALSE,13,666400,"G",18,18,"Minnesota Timberwolves","Nickeil Alexander-Walker",1,6,7,7,1,10.5
3,0,1,1,1,6,4,3,1,"27",0,4,10,1,1,0,1038145,"2024-01-14T00:00:00.000Z",18,FALSE,13,12,"F",18,18,"Minnesota Timberwolves","Kyle Anderson",1,11,14,13,4,18.7
0,0,0,0,0,0,0,0,0,"00",0,0,0,0,0,0,1038145,"2024-01-14T00:00:00.000Z",18,FALSE,13,68,"F",18,18,"Minnesota Timberwolves","Troy Brown Jr.",0,0,0,0,0,0
0,0,0,0,0,0,0,0,0,"00",0,0,0,0,0,0,1038145,"2024-01-14T00:00:00.000Z",18,FALSE,13,666767,"G",18,18,"Minnesota Timberwolves","Jordan McLaughlin",0,0,0,0,0,0
0,0,0,0,0,0,0,0,0,"00",0,0,0,0,0,0,1038145,"2024-01-14T00:00:00.000Z",18,FALSE,13,493,"C",13,13,"LA Clippers","Ivica Zubac",0,0,0,0,0,0
0,0,1,1,0,2,1,0,0,"19",2,3,2,3,0,0,1038145,"2024-01-14T00:00:00.000Z",18,FALSE,13,666743,"G",13,13,"LA Clippers","Terance Mann",0,5,5,2,3,5.6
8,2,1,9,2,14,4,5,4,"36",0,3,14,1,2,4,1038145,"2024-01-14T00:00:00.000Z",18,FALSE,13,192,"G",13,13,"LA Clippers","James Harden",4,15,23,22,9,35.2
0,0,0,0,0,0,0,0,0,"00",0,0,0,0,0,0,1038145,"2024-01-14T00:00:00.000Z",18,FALSE,13,17896022,"G",13,13,"LA Clippers","Brandon Boston Jr.",0,0,0,0,0,0
0,0,0,0,0,1,0,0,0,"09",1,0,0,1,1,1,1038145,"2024-01-14T00:00:00.000Z",18,FALSE,13,666511,"G",13,13,"LA Clippers","Amir Coffey",1,1,1,0,1,3.2
0,0,0,0,0,0,0,0,0,"00",0,0,0,0,0,0,1038145,"2024-01-14T00:00:00.000Z",18,FALSE,13,17896031,"G",13,13,"LA Clippers","Nah'Shon Hyland",0,0,0,0,0,0
0,0,3,0,0,5,4,0,0,"16",0,4,8,3,1,0,1038145,"2024-01-14T00:00:00.000Z",18,FALSE,13,371,"F-C",13,13,"LA Clippers","Mason Plumlee",1,11,11,8,3,14.6
0,2,1,9,6,12,9,0,0,"30",0,1,24,1,0,1,1038145,"2024-01-14T00:00:00.000Z",18,FALSE,13,380,"F-G",13,13,"LA Clippers","Norman Powell",2,25,25,24,1,30.2
0,0,0,0,0,0,0,0,0,"00",0,0,0,0,0,0,1038145,"2024-01-14T00:00:00.000Z",18,FALSE,13,450,"F",13,13,"LA Clippers","PJ Tucker",0,0,0,0,0,0
13,0,5,2,2,8,3,5,4,"29",3,4,12,8,2,3,1038145,"2024-01-14T00:00:00.000Z",18,FALSE,13,472,"G",13,13,"LA Clippers","Russell Westbrook",2,20,33,25,21,44.1
0,0,0,0,0,0,0,0,0,"00",0,0,0,0,0,0,1038145,"2024-01-14T00:00:00.000Z",18,FALSE,13,56677849,"F",13,13,"LA Clippers","Kobe Brown",0,0,0,0,0,0
0,0,0,0,0,0,0,0,0,"00",0,0,0,0,0,0,1038145,"2024-01-14T00:00:00.000Z",18,FALSE,13,38017725,"F",13,13,"LA Clippers","Moussa Diabate",0,0,0,0,0,0
0,0,0,0,0,0,0,0,0,"00",0,0,0,0,0,0,1038145,"2024-01-14T00:00:00.000Z",18,FALSE,13,56677856,"G",13,13,"LA Clippers","Jordan Miller",0,0,0,0,0,0
0,0,0,0,0,0,0,0,0,"00",0,0,0,0,0,0,1038145,"2024-01-14T00:00:00.000Z",18,FALSE,13,24417679,"G",13,13,"LA Clippers","Xavier Moon",0,0,0,0,0,0
0,0,0,0,0,0,0,0,0,"00",0,0,0,0,0,0,1038145,"2024-01-14T00:00:00.000Z",18,FALSE,13,17896051,"G",13,13,"LA Clippers","Joshua Primo",0,0,0,0,0,0
0,0,0,0,0,0,0,0,0,"00",0,0,0,0,0,0,1038145,"2024-01-14T00:00:00.000Z",18,FALSE,13,56677782,"F",18,18,"Minnesota Timberwolves","Leonard Miller",0,0,0,0,0,0
0,0,0,0,0,0,0,0,0,"00",0,0,0,0,0,0,1038145,"2024-01-14T00:00:00.000Z",18,FALSE,13,320,"G",18,18,"Minnesota Timberwolves","Shake Milton",0,0,0,0,0,0
0,0,0,0,0,0,0,0,0,"00",0,0,0,0,0,0,1038145,"2024-01-14T00:00:00.000Z",18,FALSE,13,38017715,"F",18,18,"Minnesota Timberwolves","Josh Minott",0,0,0,0,0,0
0,0,0,0,0,0,0,0,0,"00",0,0,0,0,0,0,1038145,"2024-01-14T00:00:00.000Z",18,FALSE,13,38017700,"G",18,18,"Minnesota Timberwolves","Wendell Moore Jr.",0,0,0,0,0,0
1,0,1,3,2,5,3,0,0,"14",0,2,8,1,2,1,1038145,"2024-01-14T00:00:00.000Z",18,FALSE,13,667378,"F-C",18,18,"Minnesota Timberwolves","Naz Reid",2,9,10,9,2,15.7
0,0,0,0,0,0,0,0,0,"00",0,0,0,0,0,0,1038145,"2024-01-14T00:00:00.000Z",18,FALSE,13,56677851,"G",18,18,"Minnesota Timberwolves","Jaylen Clark",0,0,0,0,0,0
0,0,0,0,0,0,0,0,0,"00",0,0,0,0,0,0,1038145,"2024-01-14T00:00:00.000Z",18,FALSE,13,17896056,"C",18,18,"Minnesota Timberwolves","Luka Garza",0,0,0,0,0,0
4,0,9,3,2,19,9,6,6,"37",0,4,26,9,2,1,1038145,"2024-01-14T00:00:00.000Z",18,FALSE,13,274,"F",13,13,"LA Clippers","Kawhi Leonard",2,35,39,30,13,47.8
3,0,4,13,4,19,5,2,2,"42",0,2,16,4,0,1,1038145,"2024-01-14T00:00:00.000Z",18,FALSE,13,172,"F",13,13,"LA Clippers","Paul George",0,20,23,19,7,24.3
0,0,3,2,1,3,1,0,0,"22",1,3,3,4,1,0,1038145,"2024-01-14T00:00:00.000Z",18,FALSE,13,439,"F",13,13,"LA Clippers","Daniel Theis",1,7,7,3,4,10.8
0,0,0,0,0,0,0,0,0,"00",0,0,0,0,0,0,1038145,"2024-01-14T00:00:00.000Z",18,FALSE,13,17895968,"F",18,18,"Minnesota Timberwolves","Daishen Nix",0,0,0,0,0,0
0,0,2,8,0,13,3,0,0,"23",0,3,6,2,0,0,1038154,"2024-01-15T00:00:00.000Z",3,FALSE,16,666679,"F",3,3,"Brooklyn Nets","Cameron Johnson",0,8,8,6,2,8.4
2,2,5,5,1,6,1,2,2,"28",2,0,5,7,0,0,1038154,"2024-01-15T00:00:00.000Z",3,FALSE,16,158,"F",3,3,"Brooklyn Nets","Dorian Finney-Smith",2,12,14,7,9,22.4
2,2,11,0,0,9,4,1,1,"43",3,1,9,14,0,1,1038154,"2024-01-15T00:00:00.000Z",3,FALSE,16,666508,"F-C",3,3,"Brooklyn Nets","Nicolas Claxton",2,23,25,11,16,33.8
6,2,7,10,2,24,10,4,4,"44",2,1,26,9,2,1,1038154,"2024-01-15T00:00:00.000Z",3,FALSE,16,61,"F",3,3,"Brooklyn Nets","Mikal Bridges",4,35,41,32,15,56.8
1,0,0,6,1,6,1,0,0,"20",0,2,3,0,3,1,1038154,"2024-01-15T00:00:00.000Z",3,FALSE,16,130,"G",3,3,"Brooklyn Nets","Spencer Dinwiddie",3,3,4,4,1,12.5
0,0,0,0,0,0,0,0,0,"00",0,0,0,0,0,0,1038154,"2024-01-15T00:00:00.000Z",3,FALSE,16,174,"F-C",3,3,"Brooklyn Nets","Harry Giles III",0,0,0,0,0,0
5,1,8,10,5,10,5,0,0,"30",1,4,15,9,0,0,1038154,"2024-01-15T00:00:00.000Z",3,FALSE,16,351,"F",3,3,"Brooklyn Nets","Royce O'Neale",1,24,29,20,14,36.3
0,0,0,0,0,0,0,0,0,"00",0,0,0,0,0,0,1038154,"2024-01-15T00:00:00.000Z",3,FALSE,16,417,"G-F",3,3,"Brooklyn Nets","Ben Simmons",0,0,0,0,0,0
0,0,0,0,0,0,0,0,0,"00",0,0,0,0,0,0,1038154,"2024-01-15T00:00:00.000Z",3,FALSE,16,56677841,"F",3,3,"Brooklyn Nets","Dariq Whitehead",0,0,0,0,0,0
0,0,0,0,0,0,0,0,0,"00",0,0,0,0,0,0,1038154,"2024-01-15T00:00:00.000Z",3,FALSE,16,56677722,"F",3,3,"Brooklyn Nets","Jalen Wilson",0,0,0,0,0,0
4,0,3,0,0,12,8,16,15,"40",2,2,31,5,2,1,1038154,"2024-01-15T00:00:00.000Z",3,FALSE,16,79,"G-F",16,16,"Miami Heat","Jimmy Butler",2,36,40,35,9,48
2,0,3,3,1,4,2,0,0,"19",0,0,5,3,0,0,1038154,"2024-01-15T00:00:00.000Z",3,FALSE,16,38017696,"F",16,16,"Miami Heat","Nikola Jovic",0,8,10,7,5,11.6
4,1,18,1,0,17,5,2,1,"44",2,2,11,20,1,2,1038154,"2024-01-15T00:00:00.000Z",3,FALSE,16,4,"C-F",16,16,"Miami Heat","Bam Adebayo",2,31,35,15,24,45
2,0,10,11,4,22,11,4,3,"37",1,3,29,11,0,4,1038154,"2024-01-15T00:00:00.000Z",3,FALSE,16,666633,"G",16,16,"Miami Heat","Tyler Herro",0,40,42,31,13,41.2
1,0,0,0,0,0,0,0,0,"05",0,0,0,0,0,0,1038154,"2024-01-15T00:00:00.000Z",3,FALSE,16,74,"C",16,16,"Miami Heat","Thomas Bryant",0,0,1,1,1,1.5
0,0,1,1,0,2,0,0,0,"12",0,2,0,1,0,0,1038154,"2024-01-15T00:00:00.000Z",3,FALSE,16,3092,"",16,16,"Miami Heat","Haywood Highsmith",0,1,1,0,1,1.2
1,1,3,4,1,8,3,2,2,"34",0,1,9,3,1,1,1038154,"2024-01-15T00:00:00.000Z",3,FALSE,16,666747,"F",16,16,"Miami Heat","Caleb Martin",2,12,13,10,4,19.1
1,1,4,6,2,13,3,1,1,"28",1,2,9,5,0,1,1038154,"2024-01-15T00:00:00.000Z",3,FALSE,16,391,"G-F",16,16,"Miami Heat","Josh Richardson",1,14,15,10,6,18.5
2,1,2,3,0,4,0,0,0,"22",0,1,0,2,1,2,1038154,"2024-01-15T00:00:00.000Z",3,FALSE,16,397,"F",16,16,"Miami Heat","Duncan Robinson",2,2,4,2,4,9.4
0,0,0,0,0,0,0,0,0,"00",0,0,0,0,0,0,1038154,"2024-01-15T00:00:00.000Z",3,FALSE,16,39398582,"C",16,16,"Miami Heat","Orlando Robinson",0,0,0,0,0,0
0,0,0,0,0,0,0,0,0,"00",0,0,0,0,0,0,1038154,"2024-01-15T00:00:00.000Z",3,FALSE,16,38017736,"F",16,16,"Miami Heat","Cole Swider",0,0,0,0,0,0
0,0,0,0,0,0,0,0,0,"00",0,0,0,0,0,0,1038154,"2024-01-15T00:00:00.000Z",3,FALSE,16,38017734,"F",16,16,"Miami Heat","Jamal Cain",0,0,0,0,0,0
0,0,0,0,0,0,0,0,0,"00",0,0,0,0,0,0,1038154,"2024-01-15T00:00:00.000Z",3,FALSE,16,3547257,"G",16,16,"Miami Heat","R.J. Hampton",0,0,0,0,0,0
0,0,0,0,0,0,0,0,0,"00",0,0,0,0,0,0,1038154,"2024-01-15T00:00:00.000Z",3,FALSE,16,56677785,"G",16,16,"Miami Heat","Jaime Jaquez Jr.",0,0,0,0,0,0
0,0,0,0,0,0,0,0,0,"00",0,0,0,0,0,0,1038154,"2024-01-15T00:00:00.000Z",3,FALSE,16,285,"F-C",16,16,"Miami Heat","Kevin Love",0,0,0,0,0,0
0,0,0,0,0,0,0,0,0,"00",0,0,0,0,0,0,1038154,"2024-01-15T00:00:00.000Z",3,FALSE,16,17896038,"C",3,3,"Brooklyn Nets","Day'Ron Sharpe",0,0,0,0,0,0
5,1,4,4,1,8,3,2,1,"32",1,2,8,5,4,2,1038154,"2024-01-15T00:00:00.000Z",3,FALSE,16,421,"G",3,3,"Brooklyn Nets","Dennis Smith Jr.",5,13,18,13,10,34.5
3,0,2,10,2,20,7,7,7,"32",0,2,23,2,0,2,1038154,"2024-01-15T00:00:00.000Z",3,FALSE,16,17896048,"G",3,3,"Brooklyn Nets","Cam Thomas",0,25,28,26,5,27.9
1,1,2,2,0,3,0,0,0,"09",0,1,0,2,0,1,1038154,"2024-01-15T00:00:00.000Z",3,FALSE,16,464,"G",3,3,"Brooklyn Nets","Lonnie Walker IV",1,2,3,1,3,5.9
1,0,0,0,0,1,0,0,0,"04",1,1,0,1,0,0,1038154,"2024-01-15T00:00:00.000Z",3,FALSE,16,17896058,"F",3,3,"Brooklyn Nets","Trendon Watford",0,1,2,1,2,2.7
0,0,0,0,0,0,0,0,0,"00",0,0,0,0,0,0,1038154,"2024-01-15T00:00:00.000Z",3,FALSE,16,56677843,"F",3,3,"Brooklyn Nets","Noah Clowney",0,0,0,0,0,0
0,0,0,0,0,0,0,0,0,"00",0,0,0,0,0,0,1038154,"2024-01-15T00:00:00.000Z",3,FALSE,16,17896041,"G",3,3,"Brooklyn Nets","Keon Johnson",0,0,0,0,0,0
0,0,0,0,0,0,0,0,0,"00",0,0,0,0,0,0,1038154,"2024-01-15T00:00:00.000Z",3,FALSE,16,19465585,"G",16,16,"Miami Heat","Dru Smith",0,0,0,0,0,0
5,0,4,2,0,5,1,0,0,"24",0,3,2,4,1,1,1038154,"2024-01-15T00:00:00.000Z",3,FALSE,16,286,"G",16,16,"Miami Heat","Kyle Lowry",1,6,11,7,9,16.3
2,0,4,3,2,5,3,0,0,"24",0,2,8,4,0,1,1038156,"2024-01-15T00:00:00.000Z",29,FALSE,12,38017739,"F",29,29,"Utah Jazz","Simone Fontecchio",0,12,14,10,6,14.8
3,0,8,4,2,15,10,10,10,"28",2,1,32,10,0,1,1038156,"2024-01-15T00:00:00.000Z",29,FALSE,12,297,"F",29,29,"Utah Jazz","Lauri Markkanen",0,42,45,35,13,47.5
1,0,2,2,0,8,3,4,4,"20",4,0,10,6,0,1,1038156,"2024-01-15T00:00:00.000Z",29,FALSE,12,101,"F-C",29,29,"Utah Jazz","John Collins",0,16,17,11,7,17.7
5,0,2,5,4,17,11,4,4,"24",1,2,30,3,0,1,1038156,"2024-01-15T00:00:00.000Z",29,FALSE,12,413,"G",29,29,"Utah Jazz","Collin Sexton",0,33,38,35,8,40.1
6,1,1,0,0,3,2,0,0,"21",1,3,4,2,2,1,1038156,"2024-01-15T00:00:00.000Z",29,FALSE,12,139,"G",29,29,"Utah Jazz","Kris Dunn",3,6,12,10,8,23.4
2,0,3,3,0,13,6,6,5,"27",0,1,17,3,2,2,1038156,"2024-01-15T00:00:00.000Z",29,FALSE,12,100,"G",29,29,"Utah Jazz","Jordan Clarkson",2,20,22,19,5,27.6
5,0,0,7,3,11,6,5,4,"24",0,1,19,0,1,2,1038156,"2024-01-15T00:00:00.000Z",29,FALSE,12,56677834,"G",29,29,"Utah Jazz","Keyonte George",1,19,24,24,5,27.5
1,5,4,0,0,2,2,2,0,"25",1,0,4,5,0,1,1038156,"2024-01-15T00:00:00.000Z",29,FALSE,12,38017705,"C",29,29,"Utah Jazz","Walker Kessler",5,9,10,5,6,25.5
0,0,2,0,0,0,0,0,0,"03",0,0,0,2,0,0,1038156,"2024-01-15T00:00:00.000Z",29,FALSE,12,11891374,"C",29,29,"Utah Jazz","Omer Yurtseven",0,2,2,0,2,2.4
0,0,0,0,0,0,0,0,0,"00",0,0,0,0,0,0,1038156,"2024-01-15T00:00:00.000Z",29,FALSE,12,56677824,"F",29,29,"Utah Jazz","Taylor Hendricks",0,0,0,0,0,0
0,0,0,0,0,0,0,0,0,"00",0,0,0,0,0,0,1038156,"2024-01-15T00:00:00.000Z",29,FALSE,12,38017630,"G",29,29,"Utah Jazz","Johnny Juzang",0,0,0,0,0,0
0,0,0,0,0,0,0,0,0,"00",0,0,0,0,0,0,1038156,"2024-01-15T00:00:00.000Z",29,FALSE,12,19465584,"F",29,29,"Utah Jazz","Micah Potter",0,0,0,0,0,0
0,0,0,0,0,0,0,0,0,"00",0,0,0,0,0,0,1038156,"2024-01-15T00:00:00.000Z",29,FALSE,12,17896042,"G",13,29,"Utah Jazz","Jason Preston",0,0,0,0,0,0
0,0,0,0,0,0,0,0,0,"00",0,0,0,0,0,0,1038156,"2024-01-15T00:00:00.000Z",29,FALSE,12,56677842,"F",29,29,"Utah Jazz","Brice Sensabaugh",0,0,0,0,0,0
0,0,1,5,3,8,5,1,1,"23",1,1,14,2,0,1,1038156,"2024-01-15T00:00:00.000Z",29,FALSE,12,210,"G",12,12,"Indiana Pacers","Buddy Hield",0,16,16,14,2,15.4
1,0,0,1,0,5,2,6,4,"12",2,3,8,2,0,0,1038156,"2024-01-15T00:00:00.000Z",29,FALSE,12,38017701,"G",12,12,"Indiana Pacers","Kendall Brown",0,10,11,9,3,11.9
1,1,3,0,0,2,0,2,1,"08",1,4,1,4,0,1,1038156,"2024-01-15T00:00:00.000Z",29,FALSE,12,17896035,"F",12,12,"Indiana Pacers","Isaiah Jackson",1,5,6,2,5,9.3
0,0,0,0,0,0,0,0,0,"01",0,0,0,0,0,0,1038156,"2024-01-15T00:00:00.000Z",29,FALSE,12,242,"F",12,12,"Indiana Pacers","James Johnson",0,0,0,0,0,0
5,0,4,0,0,6,3,2,2,"19",1,1,8,5,1,3,1038156,"2024-01-15T00:00:00.000Z",29,FALSE,12,304,"G",12,12,"Indiana Pacers","T.J. McConnell",1,13,18,13,10,21.5
2,0,2,4,0,10,3,2,1,"17",1,2,7,3,0,1,1038156,"2024-01-15T00:00:00.000Z",29,FALSE,12,3547207,"F",12,12,"Indiana Pacers","Jordan Nwora",0,10,12,9,5,12.6
3,0,1,5,0,7,1,2,2,"25",2,4,4,3,0,0,1038156,"2024-01-15T00:00:00.000Z",29,FALSE,12,56677861,"G",12,12,"Indiana Pacers","Ben Sheppard",0,7,10,7,6,12.1
2,0,2,0,0,3,1,0,0,"13",1,1,2,3,1,0,1038156,"2024-01-15T00:00:00.000Z",29,FALSE,12,3547243,"F",12,12,"Indiana Pacers","Obi Toppin",1,5,7,4,5,11.6
0,0,2,0,0,5,1,2,2,"12",4,0,4,6,2,0,1038156,"2024-01-15T00:00:00.000Z",29,FALSE,12,56677778,"F-C",12,12,"Indiana Pacers","Oscar Tshiebwe",2,10,10,4,6,17.2
4,2,2,5,2,11,3,0,0,"26",2,2,8,4,4,1,1038156,"2024-01-15T00:00:00.000Z",29,FALSE,12,56677832,"F",12,12,"Indiana Pacers","Jarace Walker",6,12,16,12,8,35.8
0,0,3,2,1,8,4,4,3,"17",1,5,12,4,0,2,1038156,"2024-01-15T00:00:00.000Z",29,FALSE,12,452,"C-F",12,12,"Indiana Pacers","Myles Turner",0,16,16,12,4,14.8
2,0,0,1,0,10,5,1,1,"25",1,1,11,1,0,0,1038156,"2024-01-15T00:00:00.000Z",29,FALSE,12,38017686,"G-F",12,12,"Indiana Pacers","Bennedict Mathurin",0,12,14,13,3,15.2
4,0,0,3,1,10,5,3,3,"23",0,2,14,0,1,2,1038156,"2024-01-15T00:00:00.000Z",29,FALSE,12,38017507,"G-F",12,12,"Indiana Pacers","Andrew Nembhard",1,14,18,18,4,21
0,1,4,1,0,4,1,2,2,"24",0,2,4,4,0,1,1038156,"2024-01-15T00:00:00.000Z",29,FALSE,12,38017620,"G",29,29,"Utah Jazz","Ochai Agbaji",1,8,8,4,4,10.8
4,1,5,0,0,3,1,2,2,"17",1,4,4,6,0,3,1038156,"2024-01-15T00:00:00.000Z",29,FALSE,12,358,"F",29,29,"Utah Jazz","Kelly Olynyk",1,10,14,8,10,17.2
0,0,0,0,0,0,0,0,0,"00",0,0,0,0,0,0,1038156,"2024-01-15T00:00:00.000Z",29,FALSE,12,666650,"G",29,29,"Utah Jazz","Talen Horton-Tucker",0,0,0,0,0,0
0,0,1,0,0,0,0,0,0,"03",0,1,0,1,0,0,1038156,"2024-01-15T00:00:00.000Z",29,FALSE,12,666881,"F",29,29,"Utah Jazz","Luka Samanic",0,1,1,0,1,1.2
0,0,0,0,0,0,0,0,0,"00",0,0,0,0,0,0,1038156,"2024-01-15T00:00:00.000Z",29,FALSE,12,69,"G",12,12,"Indiana Pacers","Bruce Brown",0,0,0,0,0,0
0,0,0,0,0,0,0,0,0,"00",0,0,0,0,0,0,1038156,"2024-01-15T00:00:00.000Z",29,FALSE,12,3547245,"G",12,12,"Indiana Pacers","Tyrese Haliburton",0,0,0,0,0,0
0,0,0,0,0,0,0,0,0,"00",0,0,0,0,0,0,1038156,"2024-01-15T00:00:00.000Z",29,FALSE,12,3547250,"G-F",12,12,"Indiana Pacers","Aaron Nesmith",0,0,0,0,0,0
0,0,0,0,0,0,0,0,0,"00",0,0,0,0,0,0,1038156,"2024-01-15T00:00:00.000Z",29,FALSE,12,56677794,"G",12,12,"Indiana Pacers","Isaiah Wong",0,0,0,0,0,0
3,1,5,5,2,10,5,0,0,"19",1,5,12,6,0,2,1038156,"2024-01-15T00:00:00.000Z",29,FALSE,12,3547264,"F-C",12,12,"Indiana Pacers","Jalen Smith",1,18,21,15,9,24.7
4,0,9,4,0,19,11,3,2,"36",0,4,24,9,0,0,1038155,"2024-01-15T00:00:00.000Z",28,FALSE,2,666423,"F-G",20,28,"Toronto Raptors","RJ Barrett",0,33,37,28,13,40.8
4,0,3,6,0,15,5,8,7,"36",2,1,17,5,1,0,1038155,"2024-01-15T00:00:00.000Z",28,FALSE,2,416,"F",28,28,"Toronto Raptors","Pascal Siakam",1,22,26,21,9,32
3,1,3,2,0,5,1,0,0,"15",1,4,2,4,0,1,1038155,"2024-01-15T00:00:00.000Z",28,FALSE,2,2309958,"C-F",15,28,"Toronto Raptors","Jontay Porter",1,6,9,5,7,13.3
2,0,11,2,0,12,5,0,0,"41",2,2,10,13,2,4,1038155,"2024-01-15T00:00:00.000Z",28,FALSE,2,17896055,"G-F",28,28,"Toronto Raptors","Scottie Barnes",2,23,25,12,15,30.6
3,1,6,7,2,20,8,4,3,"37",0,3,21,6,1,0,1038155,"2024-01-15T00:00:00.000Z",28,FALSE,2,3547269,"G",20,28,"Toronto Raptors","Immanuel Quickley",2,27,30,24,9,38.7
0,0,1,4,0,6,1,2,2,"14",1,1,4,2,0,0,1038155,"2024-01-15T00:00:00.000Z",28,FALSE,2,58,"F",28,28,"Toronto Raptors","Chris Boucher",0,6,6,4,2,6.4
0,0,0,0,0,0,0,0,0,"00",0,0,0,0,0,0,1038155,"2024-01-15T00:00:00.000Z",28,FALSE,2,56677828,"G",28,28,"Toronto Raptors","Gradey Dick",0,0,0,0,0,0
0,0,1,3,1,5,2,2,0,"12",1,0,5,2,0,0,1038155,"2024-01-15T00:00:00.000Z",28,FALSE,2,666762,"F",28,28,"Toronto Raptors","Jalen McDaniels",0,7,7,5,2,7.4
0,0,0,0,0,0,0,0,0,"00",0,0,0,0,0,0,1038155,"2024-01-15T00:00:00.000Z",28,FALSE,2,376,"F",28,28,"Toronto Raptors","Otto Porter Jr.",0,0,0,0,0,0
0,0,0,0,0,0,0,0,0,"00",0,0,0,0,0,0,1038155,"2024-01-15T00:00:00.000Z",28,FALSE,2,56677805,"G",28,28,"Toronto Raptors","Javon Freeman-Liberty",0,0,0,0,0,0
0,0,0,0,0,0,0,0,0,"00",0,0,0,0,0,0,1038155,"2024-01-15T00:00:00.000Z",28,FALSE,2,38017710,"C",28,28,"Toronto Raptors","Christian Koloko",0,0,0,0,0,0
0,0,0,0,0,0,0,0,0,"00",0,0,0,0,0,0,1038155,"2024-01-15T00:00:00.000Z",28,FALSE,2,56677869,"G",28,28,"Toronto Raptors","Markquis Nowell",0,0,0,0,0,0
0,0,0,0,0,0,0,0,0,"00",0,0,0,0,0,0,1038155,"2024-01-15T00:00:00.000Z",28,FALSE,2,373,"C",28,28,"Toronto Raptors","Jakob Poeltl",0,0,0,0,0,0
0,0,0,0,0,0,0,0,0,"00",0,0,0,0,0,0,1038155,"2024-01-15T00:00:00.000Z",28,FALSE,2,3089,"",28,28,"Toronto Raptors","Gary Trent Jr.",0,0,0,0,0,0
6,1,14,6,1,19,7,4,4,"37",0,2,19,14,1,1,1038155,"2024-01-15T00:00:00.000Z",28,FALSE,2,434,"F",2,2,"Boston Celtics","Jayson Tatum",2,33,39,25,20,49.8
2,0,7,3,1,9,5,2,2,"33",0,4,13,7,0,2,1038155,"2024-01-15T00:00:00.000Z",28,FALSE,2,409,"G",28,28,"Toronto Raptors","Dennis Schroder",0,20,22,15,9,22.4
0,0,0,0,0,0,0,0,0,"00",0,0,0,0,0,0,1038155,"2024-01-15T00:00:00.000Z",28,FALSE,2,436,"G-F",28,28,"Toronto Raptors","Garrett Temple",0,0,0,0,0,0
7,0,2,1,0,4,0,0,0,"16",2,2,0,4,2,0,1038155,"2024-01-15T00:00:00.000Z",28,FALSE,2,489,"F",28,28,"Toronto Raptors","Thaddeus Young",2,4,11,7,11,21.3
0,0,0,0,0,0,0,0,0,"00",0,0,0,0,0,0,1038155,"2024-01-15T00:00:00.000Z",28,FALSE,2,56677864,"G",2,2,"Boston Celtics","Jordan Walsh",0,0,0,0,0,0
2,0,9,4,2,10,4,0,0,"35",2,3,10,11,1,1,1038155,"2024-01-15T00:00:00.000Z",28,FALSE,2,219,"C-F",2,2,"Boston Celtics","Al Horford",1,21,23,12,13,28.2
2,2,6,4,1,6,2,12,10,"32",0,4,15,6,0,6,1038155,"2024-01-15T00:00:00.000Z",28,FALSE,2,378,"F-C",2,2,"Boston Celtics","Kristaps Porzingis",2,21,23,17,8,25.2
1,0,2,11,5,18,7,3,3,"37",0,1,22,2,0,3,1038155,"2024-01-15T00:00:00.000Z",28,FALSE,2,473,"G",2,2,"Boston Celtics","Derrick White",0,24,25,23,3,22.9
7,2,5,6,4,14,7,4,4,"34",1,2,22,6,1,1,1038155,"2024-01-15T00:00:00.000Z",28,FALSE,2,214,"G",2,2,"Boston Celtics","Jrue Holiday",3,28,35,29,13,47.7
0,1,5,1,1,2,1,0,0,"16",0,0,3,5,0,0,1038155,"2024-01-15T00:00:00.000Z",28,FALSE,2,17896060,"F",2,2,"Boston Celtics","Sam Hauser",1,8,8,3,5,12
0,1,3,0,0,2,2,0,0,"18",0,1,4,3,0,0,1038155,"2024-01-15T00:00:00.000Z",28,FALSE,2,261,"F-C",2,2,"Boston Celtics","Luke Kornet",1,7,7,4,3,10.6
2,0,3,6,1,7,1,0,0,"24",0,2,3,3,0,0,1038155,"2024-01-15T00:00:00.000Z",28,FALSE,2,3547276,"G",2,2,"Boston Celtics","Payton Pritchard",0,6,8,5,5,9.6
0,0,1,1,1,4,2,2,2,"07",2,1,7,3,0,0,1038155,"2024-01-15T00:00:00.000Z",28,FALSE,2,666468,"F",2,2,"Boston Celtics","Oshae Brissett",0,10,10,7,3,10.6
0,0,0,0,0,0,0,0,0,"00",0,0,0,0,0,0,1038155,"2024-01-15T00:00:00.000Z",28,FALSE,2,17896094,"G",2,2,"Boston Celtics","Dalano Banton",0,0,0,0,0,0
0,0,0,0,0,0,0,0,0,"00",0,0,0,0,0,0,1038155,"2024-01-15T00:00:00.000Z",28,FALSE,2,338,"G",2,2,"Boston Celtics","Svi Mykhailiuk",0,0,0,0,0,0
0,0,0,0,0,0,0,0,0,"00",0,0,0,0,0,0,1038155,"2024-01-15T00:00:00.000Z",28,FALSE,2,17553967,"C",2,2,"Boston Celtics","Neemias Queta",0,0,0,0,0,0
0,0,0,0,0,0,0,0,0,"00",0,0,0,0,0,0,1038155,"2024-01-15T00:00:00.000Z",28,FALSE,2,3547279,"F",2,2,"Boston Celtics","Lamar Stevens",0,0,0,0,0,0
0,0,0,0,0,0,0,0,0,"00",0,0,0,0,0,0,1038155,"2024-01-15T00:00:00.000Z",28,FALSE,2,70,"G",2,2,"Boston Celtics","Jaylen Brown",0,0,0,0,0,0
0,0,0,0,0,0,0,0,0,"00",0,0,0,0,0,0,1038155,"2024-01-15T00:00:00.000Z",28,FALSE,2,38017707,"G",2,2,"Boston Celtics","JD Davison",0,0,0,0,0,0
0,0,0,0,0,0,0,0,0,"00",0,0,0,0,0,0,1038155,"2024-01-15T00:00:00.000Z",28,FALSE,2,NA,NA,NA,2,"Boston Celtics","NA NA",0,0,0,0,0,0
3,1,2,5,1,6,1,0,0,"31",0,2,3,2,0,0,1038157,"2024-01-15T00:00:00.000Z",14,FALSE,21,383,"F",14,14,"Los Angeles Lakers","Taurean Prince",1,5,8,6,5,12.9
6,0,7,2,1,20,12,1,0,"39",0,1,25,7,0,5,1038157,"2024-01-15T00:00:00.000Z",14,FALSE,21,237,"F",14,14,"Los Angeles Lakers","LeBron James",0,32,38,31,13,37.4
5,1,12,1,0,17,9,10,9,"38",3,3,27,15,2,2,1038157,"2024-01-15T00:00:00.000Z",14,FALSE,21,117,"F-C",14,14,"Los Angeles Lakers","Anthony Davis",3,42,47,32,20,59.5
7,1,3,3,1,10,6,2,2,"33",0,0,15,3,0,2,1038157,"2024-01-15T00:00:00.000Z",14,FALSE,21,17553995,"G",14,14,"Los Angeles Lakers","Austin Reaves",1,18,25,22,10,30.1
7,1,1,7,2,12,5,2,2,"36",1,2,14,2,2,5,1038157,"2024-01-15T00:00:00.000Z",14,FALSE,21,405,"G",14,14,"Los Angeles Lakers","D'Angelo Russell",3,16,23,21,9,30.9
0,0,0,1,0,2,0,0,0,"11",1,1,0,1,0,1,1038157,"2024-01-15T00:00:00.000Z",14,FALSE,21,38017697,"G",14,14,"Los Angeles Lakers","Max Christie",0,1,1,0,1,0.2
0,2,2,3,2,8,5,0,0,"20",1,1,12,3,0,1,1038157,"2024-01-15T00:00:00.000Z",14,FALSE,21,666609,"F",14,14,"Los Angeles Lakers","Rui Hachimura",2,15,15,12,3,20.6
0,0,0,0,0,0,0,0,0,"00",0,0,0,0,0,0,1038157,"2024-01-15T00:00:00.000Z",14,FALSE,21,666626,"C",14,14,"Los Angeles Lakers","Jaxson Hayes",0,0,0,0,0,0
0,0,0,0,0,0,0,0,0,"00",0,0,0,0,0,0,1038157,"2024-01-15T00:00:00.000Z",14,FALSE,21,666971,"G-F",20,14,"Los Angeles Lakers","Dylan Windler",0,0,0,0,0,0
1,3,5,2,1,7,4,2,2,"14",2,2,11,7,0,1,1038157,"2024-01-15T00:00:00.000Z",14,FALSE,21,486,"F",14,14,"Los Angeles Lakers","Christian Wood",3,18,19,12,8,28.9
0,0,0,0,0,0,0,0,0,"00",0,0,0,0,0,0,1038157,"2024-01-15T00:00:00.000Z",14,FALSE,21,56677738,"C",14,14,"Los Angeles Lakers","Colin Castleton",0,0,0,0,0,0
0,0,0,0,0,0,0,0,0,"00",0,0,0,0,0,0,1038157,"2024-01-15T00:00:00.000Z",14,FALSE,21,56677835,"G",14,14,"Los Angeles Lakers","Jalen Hood-Schifino",0,0,0,0,0,0
0,0,0,0,0,0,0,0,0,"00",0,0,0,0,0,0,1038157,"2024-01-15T00:00:00.000Z",14,FALSE,21,56677836,"F",14,14,"Los Angeles Lakers","Maxwell Lewis",0,0,0,0,0,0
0,0,0,0,0,0,0,0,0,"00",0,0,0,0,0,0,1038157,"2024-01-15T00:00:00.000Z",14,FALSE,21,666860,"F-G",14,14,"Los Angeles Lakers","Cameron Reddish",0,0,0,0,0,0
0,0,0,0,0,0,0,0,0,"00",0,0,0,0,0,0,1038157,"2024-01-15T00:00:00.000Z",14,FALSE,21,1603383,"G",14,14,"Los Angeles Lakers","Gabe Vincent",0,0,0,0,0,0
1,0,3,8,3,9,4,0,0,"29",4,2,11,7,1,1,1038157,"2024-01-15T00:00:00.000Z",14,FALSE,21,666541,"G",21,21,"Oklahoma City Thunder","Luguentz Dort",1,18,19,12,8,22.9
6,0,1,4,2,18,10,4,3,"35",2,1,25,3,3,1,1038157,"2024-01-15T00:00:00.000Z",14,FALSE,21,38017703,"G-F",21,21,"Oklahoma City Thunder","Jalen Williams",3,28,34,31,9,45.6
4,3,7,4,1,9,4,0,0,"30",1,5,9,8,1,3,1038157,"2024-01-15T00:00:00.000Z",14,FALSE,21,38017685,"C-F",21,21,"Oklahoma City Thunder","Chet Holmgren",4,17,21,13,12,33.6
0,0,0,0,0,0,0,0,0,"00",0,0,0,0,0,0,1038157,"2024-01-15T00:00:00.000Z",14,FALSE,21,3547289,"G",25,14,"Los Angeles Lakers","Skylar Mays",0,0,0,0,0,0
2,0,4,0,0,2,2,1,1,"18",0,0,5,4,3,0,1038157,"2024-01-15T00:00:00.000Z",14,FALSE,21,457,"F",14,14,"Los Angeles Lakers","Jarred Vanderbilt",3,9,11,7,6,21.8
6,1,3,6,1,19,9,5,5,"34",0,3,24,3,1,3,1038157,"2024-01-15T00:00:00.000Z",14,FALSE,21,175,"G",21,21,"Oklahoma City Thunder","Shai Gilgeous-Alexander",2,27,33,30,9,39.6
0,0,0,0,0,0,0,0,0,"00",0,0,0,0,0,0,1038157,"2024-01-15T00:00:00.000Z",14,FALSE,21,44,"F",21,21,"Oklahoma City Thunder","Davis Bertans",0,0,0,0,0,0
0,0,2,4,1,5,2,0,0,"12",1,2,5,3,0,1,1038157,"2024-01-15T00:00:00.000Z",14,FALSE,21,38017716,"F",21,21,"Oklahoma City Thunder","Ousmane Dieng",0,8,8,5,3,7.6
1,0,5,6,0,10,2,0,0,"20",2,1,4,7,2,1,1038157,"2024-01-15T00:00:00.000Z",14,FALSE,21,3547272,"G",21,21,"Oklahoma City Thunder","Isaiah Joe",2,11,12,5,8,18.9
1,0,1,2,2,4,2,0,0,"15",0,2,6,1,0,0,1038157,"2024-01-15T00:00:00.000Z",14,FALSE,21,4197029,"G",21,21,"Oklahoma City Thunder","Vasilije Micic",0,7,8,7,2,8.7
1,1,0,4,1,6,2,0,0,"20",0,0,5,0,2,1,1038157,"2024-01-15T00:00:00.000Z",14,FALSE,21,56677833,"G",21,21,"Oklahoma City Thunder","Cason Wallace",3,5,6,6,1,14.5
0,0,0,3,1,3,1,0,0,"06",1,0,3,1,0,0,1038157,"2024-01-15T00:00:00.000Z",14,FALSE,21,38017706,"F",21,21,"Oklahoma City Thunder","Jaylin Williams",0,4,4,3,1,4.2
0,0,2,3,1,5,2,0,0,"17",0,1,5,2,1,0,1038157,"2024-01-15T00:00:00.000Z",14,FALSE,21,480,"G-F",21,21,"Oklahoma City Thunder","Kenrich Williams",1,7,7,5,2,10.4
0,0,0,0,0,0,0,0,0,"00",0,0,0,0,0,0,1038157,"2024-01-15T00:00:00.000Z",14,FALSE,21,17896036,"G",21,21,"Oklahoma City Thunder","Tre Mann",0,0,0,0,0,0
0,0,0,0,0,0,0,0,0,"00",0,0,0,0,0,0,1038157,"2024-01-15T00:00:00.000Z",14,FALSE,21,24572055,"C",21,21,"Oklahoma City Thunder","Olivier Sarr",0,0,0,0,0,0
0,0,0,0,0,0,0,0,0,"00",0,0,0,0,0,0,1038157,"2024-01-15T00:00:00.000Z",14,FALSE,21,17896078,"G",21,21,"Oklahoma City Thunder","Aaron Wiggins",0,0,0,0,0,0
0,0,0,0,0,0,0,0,0,"00",0,0,0,0,0,0,1038157,"2024-01-15T00:00:00.000Z",14,FALSE,21,56677853,"F",21,21,"Oklahoma City Thunder","Keyontae Johnson",0,0,0,0,0,0
0,0,0,0,0,0,0,0,0,"00",0,0,0,0,0,0,1038157,"2024-01-15T00:00:00.000Z",14,FALSE,21,3547271,"C",21,21,"Oklahoma City Thunder","Aleksej Pokusevski",0,0,0,0,0,0
0,0,0,0,0,0,0,0,0,"00",0,0,0,0,0,0,1038157,"2024-01-15T00:00:00.000Z",14,FALSE,21,27924547,"F",21,21,"Oklahoma City Thunder","Lindy Waters III",0,0,0,0,0,0
3,1,3,5,2,8,2,2,2,"22",2,1,8,5,0,0,1038157,"2024-01-15T00:00:00.000Z",14,FALSE,21,17896065,"G",21,21,"Oklahoma City Thunder","Josh Giddey",1,13,16,11,8,21.5
3,1,3,3,1,7,2,0,0,"28",2,2,5,5,2,0,1038147,"2024-01-15T00:00:00.000Z",23,FALSE,11,33,"F-G",23,23,"Philadelphia 76ers","Nicolas Batum",3,10,13,8,8,24.5
2,0,3,3,2,7,3,2,2,"31",0,2,10,3,0,1,1038147,"2024-01-15T00:00:00.000Z",23,FALSE,11,200,"F",23,23,"Philadelphia 76ers","Tobias Harris",0,13,15,12,5,15.6
3,1,8,5,1,21,12,17,16,"31",2,5,41,10,1,2,1038147,"2024-01-15T00:00:00.000Z",23,FALSE,11,145,"F-C",23,23,"Philadelphia 76ers","Joel Embiid",2,51,54,44,13,61.5
0,0,2,3,1,8,3,0,0,"26",0,3,7,2,4,1,1038147,"2024-01-15T00:00:00.000Z",23,FALSE,11,360,"F",23,23,"Philadelphia 76ers","Kelly Oubre Jr.",4,9,9,7,2,20.4
7,0,1,10,6,18,8,5,5,"35",0,4,27,1,0,2,1038147,"2024-01-15T00:00:00.000Z",23,FALSE,11,3547254,"G",23,23,"Philadelphia 76ers","Tyrese Maxey",0,28,35,34,8,36.7
6,1,5,4,1,8,3,6,4,"29",0,2,11,5,1,3,1038147,"2024-01-15T00:00:00.000Z",23,FALSE,11,45,"G",23,23,"Philadelphia 76ers","Patrick Beverley",2,16,22,17,11,29
1,0,3,1,1,4,2,1,1,"18",2,4,6,5,0,0,1038147,"2024-01-15T00:00:00.000Z",23,FALSE,11,2175,"",23,23,"Philadelphia 76ers","Danuel House Jr.",0,11,12,7,6,13.5
0,0,0,0,0,2,1,1,0,"06",0,0,2,0,0,0,1038147,"2024-01-15T00:00:00.000Z",23,FALSE,11,260,"G-F",23,23,"Philadelphia 76ers","Furkan Korkmaz",0,2,2,2,0,2
0,0,1,0,0,1,0,0,0,"06",0,1,0,1,0,0,1038147,"2024-01-15T00:00:00.000Z",23,FALSE,11,3547294,"F",23,23,"Philadelphia 76ers","Kenyon Martin Jr.",0,1,1,0,1,1.2
1,0,5,2,2,3,3,0,0,"14",0,1,8,5,0,0,1038147,"2024-01-15T00:00:00.000Z",23,FALSE,11,328,"F",23,23,"Philadelphia 76ers","Marcus Morris",0,13,14,9,6,15.5
2,1,2,0,0,4,3,2,1,"16",2,0,7,4,0,1,1038147,"2024-01-15T00:00:00.000Z",23,FALSE,11,3547270,"F",23,23,"Philadelphia 76ers","Paul Reed",1,11,13,9,6,16.8
0,2,1,1,0,5,0,2,1,"13",1,1,1,2,0,1,1038147,"2024-01-15T00:00:00.000Z",23,FALSE,11,188,"F",11,11,"Houston Rockets","Jeff Green",2,3,3,1,2,8.4
1,0,1,1,0,1,0,0,0,"06",0,0,0,1,0,0,1038147,"2024-01-15T00:00:00.000Z",23,FALSE,11,213,"G",11,11,"Houston Rockets","Aaron Holiday",0,1,2,1,2,2.7
0,3,0,0,0,2,2,0,0,"09",1,0,4,1,1,0,1038147,"2024-01-15T00:00:00.000Z",23,FALSE,11,19465326,"C",11,11,"Houston Rockets","Jock Landale",4,5,5,4,1,17.2
0,0,0,0,0,0,0,0,0,"00",0,0,0,0,0,0,1038147,"2024-01-15T00:00:00.000Z",23,FALSE,11,28,"C",23,23,"Philadelphia 76ers","Mo Bamba",0,0,0,0,0,0
0,0,0,0,0,0,0,0,0,"00",0,0,0,0,0,0,1038147,"2024-01-15T00:00:00.000Z",23,FALSE,11,56913527,"G",23,23,"Philadelphia 76ers","Ricky Council IV",0,0,0,0,0,0
0,0,0,0,0,0,0,0,0,"00",0,0,0,0,0,0,1038147,"2024-01-15T00:00:00.000Z",23,FALSE,11,108,"F",23,23,"Philadelphia 76ers","Robert Covington",0,0,0,0,0,0
0,0,0,0,0,0,0,0,0,"00",0,0,0,0,0,0,1038147,"2024-01-15T00:00:00.000Z",23,FALSE,11,38017732,"F",15,23,"Philadelphia 76ers","Kenneth Lofton Jr.",0,0,0,0,0,0
0,0,0,0,0,0,0,0,0,"00",0,0,0,0,0,0,1038147,"2024-01-15T00:00:00.000Z",23,FALSE,11,313,"G",23,23,"Philadelphia 76ers","De'Anthony Melton",0,0,0,0,0,0
0,0,0,0,0,0,0,0,0,"00",0,0,0,0,0,0,1038147,"2024-01-15T00:00:00.000Z",23,FALSE,11,56677788,"G",23,23,"Philadelphia 76ers","Terquavion Smith",0,0,0,0,0,0
0,0,0,0,0,0,0,0,0,"00",0,0,0,0,0,0,1038147,"2024-01-15T00:00:00.000Z",23,FALSE,11,17896025,"G",23,23,"Philadelphia 76ers","Jaden Springer",0,0,0,0,0,0
0,0,4,3,2,9,7,4,2,"31",2,2,18,6,2,0,1038147,"2024-01-15T00:00:00.000Z",23,FALSE,11,66,"G-F",11,11,"Houston Rockets","Dillon Brooks",2,24,24,18,6,31.2
2,0,6,1,0,9,5,5,3,"31",1,3,13,7,0,2,1038147,"2024-01-15T00:00:00.000Z",23,FALSE,11,38017684,"F",11,11,"Houston Rockets","Jabari Smith Jr.",0,20,22,15,9,22.4
6,2,4,1,1,15,7,6,4,"30",5,1,19,9,1,5,1038147,"2024-01-15T00:00:00.000Z",23,FALSE,11,17896062,"F-C",11,11,"Houston Rockets","Alperen Sengun",3,28,34,25,15,42.8
3,0,5,7,1,16,7,7,5,"27",0,2,20,5,0,2,1038147,"2024-01-15T00:00:00.000Z",23,FALSE,11,17895966,"G",11,11,"Houston Rockets","Jalen Green",0,25,28,23,8,28.5
5,2,1,4,2,5,2,4,2,"33",0,4,8,1,0,1,1038147,"2024-01-15T00:00:00.000Z",23,FALSE,11,458,"G",11,11,"Houston Rockets","Fred VanVleet",2,9,14,13,6,21.7
0,0,0,0,0,0,0,0,0,"00",0,0,0,0,0,0,1038147,"2024-01-15T00:00:00.000Z",23,FALSE,11,75,"G-F",11,11,"Houston Rockets","Reggie Bullock",0,0,0,0,0,0
0,0,0,0,0,0,0,0,0,"00",0,0,0,0,0,0,1038147,"2024-01-15T00:00:00.000Z",23,FALSE,11,296,"C",11,11,"Houston Rockets","Boban Marjanovic",0,0,0,0,0,0
2,0,3,3,0,4,1,0,0,"13",1,4,2,4,0,0,1038147,"2024-01-15T00:00:00.000Z",23,FALSE,11,3547301,"F",11,11,"Houston Rockets","Jae'Sean Tate",0,6,8,4,6,9.8
0,0,1,1,0,8,7,1,0,"19",2,2,14,3,1,1,1038147,"2024-01-15T00:00:00.000Z",23,FALSE,11,56677825,"G-F",11,11,"Houston Rockets","Amen Thompson",1,17,17,14,3,19.6
1,0,4,5,2,12,6,1,0,"23",2,3,14,6,1,0,1038147,"2024-01-15T00:00:00.000Z",23,FALSE,11,56677831,"F",11,11,"Houston Rockets","Cam Whitmore",1,20,21,15,7,25.7
1,0,0,0,0,2,0,2,2,"05",1,1,2,1,1,1,1038147,"2024-01-15T00:00:00.000Z",23,FALSE,11,47738533,"G",11,11,"Houston Rockets","Jeenathan Williams",1,3,4,3,2,6.7
0,0,0,0,0,0,0,0,0,"00",0,0,0,0,0,0,1038147,"2024-01-15T00:00:00.000Z",23,FALSE,11,38017695,"F",11,11,"Houston Rockets","Tari Eason",0,0,0,0,0,0
0,0,0,0,0,0,0,0,0,"00",0,0,0,0,0,0,1038147,"2024-01-15T00:00:00.000Z",23,FALSE,11,3547281,"G-F",11,11,"Houston Rockets","Nate Hinton",0,0,0,0,0,0
0,0,0,0,0,0,0,0,0,"00",0,0,0,0,0,0,1038147,"2024-01-15T00:00:00.000Z",23,FALSE,11,357,"G",11,11,"Houston Rockets","Victor Oladipo",0,0,0,0,0,0
0,0,0,0,0,0,0,0,0,"00",0,0,0,0,0,0,1038147,"2024-01-15T00:00:00.000Z",23,FALSE,11,56677809,"F",11,11,"Houston Rockets","Jermaine Samuels Jr.",0,0,0,0,0,0
3,0,3,5,3,8,4,6,2,"30",1,5,13,4,0,1,1038148,"2024-01-15T00:00:00.000Z",7,FALSE,19,3547258,"G",7,7,"Dallas Mavericks","Josh Green",0,17,20,16,7,21.3
1,2,5,2,0,3,1,2,2,"19",0,5,4,5,0,1,1038148,"2024-01-15T00:00:00.000Z",7,FALSE,19,257,"F",7,7,"Dallas Mavericks","Maxi Kleber",2,9,10,5,6,16.5
1,0,5,0,0,2,2,2,2,"26",7,4,6,12,0,2,1038148,"2024-01-15T00:00:00.000Z",7,FALSE,19,56677840,"C",7,7,"Dallas Mavericks","Dereck Lively II",0,18,19,7,13,19.9
2,0,2,15,9,23,11,10,10,"41",0,0,41,2,1,4,1038148,"2024-01-15T00:00:00.000Z",7,FALSE,19,191,"G",7,7,"Dallas Mavericks","Tim Hardaway Jr.",1,43,45,43,4,45.4
7,1,7,9,3,28,13,15,13,"41",0,1,42,7,0,3,1038148,"2024-01-15T00:00:00.000Z",7,FALSE,19,228,"G",7,7,"Dallas Mavericks","Kyrie Irving",1,49,56,49,14,60.9
0,0,0,1,0,2,0,0,0,"07",0,1,0,0,0,0,1038148,"2024-01-15T00:00:00.000Z",7,FALSE,19,114,"G",7,7,"Dallas Mavericks","Seth Curry",0,0,0,0,0,0
1,0,3,5,1,7,2,0,0,"15",1,2,5,4,0,0,1038148,"2024-01-15T00:00:00.000Z",7,FALSE,19,38017679,"G",7,7,"Dallas Mavericks","Jaden Hardy",0,9,10,6,5,11.3
0,0,0,0,0,0,0,0,0,"00",0,0,0,0,0,0,1038148,"2024-01-15T00:00:00.000Z",7,FALSE,19,217,"F-C",7,7,"Dallas Mavericks","Richaun Holmes",0,0,0,0,0,0
0,1,0,2,1,3,1,0,0,"14",1,1,3,1,0,0,1038148,"2024-01-15T00:00:00.000Z",7,FALSE,19,17554004,"G",7,7,"Dallas Mavericks","AJ Lawson",1,4,4,3,1,7.2
0,0,0,0,0,0,0,0,0,"00",0,0,0,0,0,0,1038148,"2024-01-15T00:00:00.000Z",7,FALSE,19,329,"F",7,7,"Dallas Mavericks","Markieff Morris",0,0,0,0,0,0
2,2,1,0,0,2,2,0,0,"16",3,5,4,4,0,0,1038148,"2024-01-15T00:00:00.000Z",7,FALSE,19,379,"F-C",7,7,"Dallas Mavericks","Dwight Powell",2,8,10,6,6,17.8
0,0,0,0,0,0,0,0,0,"00",0,0,0,0,0,0,1038148,"2024-01-15T00:00:00.000Z",7,FALSE,19,56677859,"F",7,7,"Dallas Mavericks","Olivier-Maxence Prosper",0,0,0,0,0,0
0,0,0,0,0,0,0,0,0,"00",0,0,0,0,0,0,1038148,"2024-01-15T00:00:00.000Z",7,FALSE,19,24489167,"G",25,7,"Dallas Mavericks","Brandon Williams",0,0,0,0,0,0
7,0,3,4,1,7,3,0,0,"31",0,5,7,3,3,0,1038148,"2024-01-15T00:00:00.000Z",7,FALSE,19,666965,"F",7,7,"Dallas Mavericks","Grant Williams",3,10,17,14,10,30.1
0,0,0,0,0,0,0,0,0,"00",0,0,0,0,0,0,1038148,"2024-01-15T00:00:00.000Z",7,FALSE,19,17896028,"F",7,7,"Dallas Mavericks","Greg Brown III",0,0,0,0,0,0
0,0,0,0,0,0,0,0,0,"00",0,0,0,0,0,0,1038148,"2024-01-15T00:00:00.000Z",7,FALSE,19,132,"F-G",7,7,"Dallas Mavericks","Luka Doncic",0,0,0,0,0,0
0,0,0,0,0,0,0,0,0,"00",0,0,0,0,0,0,1038148,"2024-01-15T00:00:00.000Z",7,FALSE,19,151,"G",7,7,"Dallas Mavericks","Dante Exum",0,0,0,0,0,0
0,0,0,0,0,0,0,0,0,"00",0,0,0,0,0,0,1038148,"2024-01-15T00:00:00.000Z",7,FALSE,19,247,"F-G",7,7,"Dallas Mavericks","Derrick Jones Jr.",0,0,0,0,0,0
5,0,5,4,0,14,3,8,6,"32",0,3,12,5,1,1,1038148,"2024-01-15T00:00:00.000Z",7,FALSE,19,227,"F",19,19,"New Orleans Pelicans","Brandon Ingram",1,17,22,17,10,27.5
3,0,1,0,0,17,12,11,6,"32",0,2,30,1,1,3,1038148,"2024-01-15T00:00:00.000Z",7,FALSE,19,666969,"F",19,19,"New Orleans Pelicans","Zion Williamson",1,31,34,33,4,35.7
2,2,2,0,0,5,2,2,2,"20",4,4,6,6,0,3,1038148,"2024-01-15T00:00:00.000Z",7,FALSE,19,455,"C",19,19,"New Orleans Pelicans","Jonas Valanciunas",2,12,14,8,8,19.2
3,0,2,1,1,5,4,1,1,"29",1,2,10,3,0,0,1038148,"2024-01-15T00:00:00.000Z",7,FALSE,19,17896024,"F",19,19,"New Orleans Pelicans","Herbert Jones",0,13,16,13,6,18.1
4,0,6,7,3,17,9,2,2,"29",0,5,23,6,1,0,1038148,"2024-01-15T00:00:00.000Z",7,FALSE,19,303,"G",19,19,"New Orleans Pelicans","CJ McCollum",1,29,33,27,10,39.2
0,0,0,0,0,0,0,0,0,"00",0,0,0,0,0,0,1038148,"2024-01-15T00:00:00.000Z",7,FALSE,19,17896097,"G",19,19,"New Orleans Pelicans","Jose Alvarado",0,0,0,0,0,0
2,0,1,1,0,2,1,0,0,"19",2,3,2,3,0,0,1038148,"2024-01-15T00:00:00.000Z",7,FALSE,19,38017677,"G",19,19,"New Orleans Pelicans","Dyson Daniels",0,5,7,4,5,8.6
0,0,1,2,1,4,3,2,2,"21",0,3,9,1,1,0,1038148,"2024-01-15T00:00:00.000Z",7,FALSE,19,56677837,"G",19,19,"New Orleans Pelicans","Jordan Hawkins",1,10,10,9,1,13.2
0,0,1,0,0,1,0,0,0,"09",0,5,0,1,1,1,1038148,"2024-01-15T00:00:00.000Z",7,FALSE,19,3547293,"F",19,19,"New Orleans Pelicans","Naji Marshall",1,1,1,0,1,3.2
0,0,3,4,1,5,2,12,9,"23",0,0,14,3,1,0,1038148,"2024-01-15T00:00:00.000Z",7,FALSE,19,18677986,"F",19,19,"New Orleans Pelicans","Trey Murphy III",1,17,17,14,3,20.6
2,0,7,4,1,11,5,3,3,"26",1,1,14,8,3,1,1038148,"2024-01-15T00:00:00.000Z",7,FALSE,19,340,"F",19,19,"New Orleans Pelicans","Larry Nance Jr.",3,22,24,16,10,34.6
0,0,0,0,0,0,0,0,0,"00",0,0,0,0,0,0,1038148,"2024-01-15T00:00:00.000Z",7,FALSE,19,491,"C",19,19,"New Orleans Pelicans","Cody Zeller",0,0,0,0,0,0
0,0,0,0,0,0,0,0,0,"00",0,0,0,0,0,0,1038148,"2024-01-15T00:00:00.000Z",7,FALSE,19,3547260,"G",19,19,"New Orleans Pelicans","Kira Lewis Jr.",0,0,0,0,0,0
0,0,0,0,0,0,0,0,0,"00",0,0,0,0,0,0,1038148,"2024-01-15T00:00:00.000Z",7,FALSE,19,38017663,"F",19,19,"New Orleans Pelicans","E.J. Liddell",0,0,0,0,0,0
0,0,0,0,0,0,0,0,0,"00",0,0,0,0,0,0,1038148,"2024-01-15T00:00:00.000Z",7,FALSE,19,17896021,"F",19,19,"New Orleans Pelicans","Jeremiah Robinson-Earl",0,0,0,0,0,0
0,0,0,0,0,0,0,0,0,"00",0,0,0,0,0,0,1038148,"2024-01-15T00:00:00.000Z",7,FALSE,19,17896017,"F",19,19,"New Orleans Pelicans","Matt Ryan",0,0,0,0,0,0
0,0,0,0,0,0,0,0,0,"00",0,0,0,0,0,0,1038148,"2024-01-15T00:00:00.000Z",7,FALSE,19,38017726,"G",19,19,"New Orleans Pelicans","Dereon Seabron",0,0,0,0,0,0
4,0,1,4,3,11,5,4,4,"44",1,2,17,2,0,2,1038149,"2024-01-15T00:00:00.000Z",20,FALSE,22,18,"F",28,20,"New York Knicks","OG Anunoby",0,19,23,21,6,23.4
5,0,5,9,2,18,5,5,3,"38",1,3,15,6,0,0,1038149,"2024-01-15T00:00:00.000Z",20,FALSE,22,387,"F",20,20,"New York Knicks","Julius Randle",0,21,26,20,11,29.7
3,0,7,0,0,6,3,1,1,"28",5,5,7,12,0,2,1038149,"2024-01-15T00:00:00.000Z",20,FALSE,22,201,"F-C",20,20,"New York Knicks","Isaiah Hartenstein",0,19,22,10,15,23.9
4,1,4,8,2,12,5,6,3,"24",2,2,15,6,0,0,1038149,"2024-01-15T00:00:00.000Z",20,FALSE,22,131,"G",20,20,"New York Knicks","Donte DiVincenzo",1,21,25,19,10,31.2
1,1,2,10,4,17,8,0,0,"36",0,4,20,2,2,1,1038149,"2024-01-15T00:00:00.000Z",20,FALSE,22,17896033,"G",20,20,"New York Knicks","Miles McBride",3,22,23,21,3,31.9
1,1,2,0,0,4,2,2,2,"20",3,0,6,5,0,1,1038149,"2024-01-15T00:00:00.000Z",20,FALSE,22,3547249,"F",28,20,"New York Knicks","Precious Achiuwa",1,11,12,7,6,15.5
0,0,0,0,0,0,0,0,0,"00",0,0,0,0,0,0,1038149,"2024-01-15T00:00:00.000Z",20,FALSE,22,19,"G",20,20,"New York Knicks","Ryan Arcidiacono",0,0,0,0,0,0
0,0,0,0,0,0,0,0,0,"00",0,0,0,0,0,0,1038149,"2024-01-15T00:00:00.000Z",20,FALSE,22,56677795,"F",20,20,"New York Knicks","Jacob Toppin",0,0,0,0,0,0
0,0,0,0,0,0,0,0,0,"00",0,0,0,0,0,0,1038149,"2024-01-15T00:00:00.000Z",20,FALSE,22,17896089,"G",20,20,"New York Knicks","Duane Washington Jr.",0,0,0,0,0,0
3,0,5,2,0,19,9,5,2,"33",1,1,20,6,0,2,1038149,"2024-01-15T00:00:00.000Z",20,FALSE,22,38017683,"F",22,22,"Orlando Magic","Paolo Banchero",0,26,29,23,9,29.7
0,0,0,7,1,7,1,5,4,"21",1,4,7,1,0,0,1038149,"2024-01-15T00:00:00.000Z",20,FALSE,22,38017724,"G",22,22,"Orlando Magic","Caleb Houstan",0,8,8,7,1,8.2
3,0,7,0,0,3,1,2,1,"29",4,3,3,11,0,0,1038149,"2024-01-15T00:00:00.000Z",20,FALSE,22,666442,"C",22,22,"Orlando Magic","Goga Bitadze",0,14,17,6,14,20.7
0,1,1,5,4,7,5,1,1,"26",2,1,15,3,0,0,1038149,"2024-01-15T00:00:00.000Z",20,FALSE,22,666818,"F",22,22,"Orlando Magic","Chuma Okeke",1,18,18,15,3,21.6
0,0,0,0,0,0,0,0,0,"00",0,0,0,0,0,0,1038149,"2024-01-15T00:00:00.000Z",20,FALSE,22,56677827,"G",22,22,"Orlando Magic","Anthony Black",0,0,0,0,0,0
0,0,0,0,0,0,0,0,0,"00",0,0,0,0,0,0,1038149,"2024-01-15T00:00:00.000Z",20,FALSE,22,73,"G",20,20,"New York Knicks","Jalen Brunson",0,0,0,0,0,0
0,0,0,4,0,4,0,4,2,"12",0,0,2,0,0,0,1038149,"2024-01-15T00:00:00.000Z",20,FALSE,22,3547275,"G",28,20,"New York Knicks","Malachi Flynn",0,2,2,2,0,2
0,0,0,0,0,0,0,0,0,"00",0,0,0,0,0,0,1038149,"2024-01-15T00:00:00.000Z",20,FALSE,22,160,"G-F",20,20,"New York Knicks","Evan Fournier",0,0,0,0,0,0
1,0,2,3,2,4,3,0,0,"14",0,2,8,2,1,2,1038149,"2024-01-15T00:00:00.000Z",20,FALSE,22,17895858,"G",20,20,"New York Knicks","Quentin Grimes",1,10,11,9,3,12.9
1,0,5,2,0,7,2,0,0,"24",1,2,4,6,0,1,1038149,"2024-01-15T00:00:00.000Z",20,FALSE,22,202,"G",20,20,"New York Knicks","Josh Hart",0,10,11,5,7,11.7
0,0,0,0,0,0,0,0,0,"00",0,0,0,0,0,0,1038149,"2024-01-15T00:00:00.000Z",20,FALSE,22,17896063,"F",20,20,"New York Knicks","Jericho Sims",0,0,0,0,0,0
0,0,0,0,0,0,0,0,0,"00",0,0,0,0,0,0,1038149,"2024-01-15T00:00:00.000Z",20,FALSE,22,666474,"G",20,20,"New York Knicks","Charles Brown",0,0,0,0,0,0
0,0,0,0,0,0,0,0,0,"00",0,0,0,0,0,0,1038149,"2024-01-15T00:00:00.000Z",20,FALSE,22,399,"C",20,20,"New York Knicks","Mitchell Robinson",0,0,0,0,0,0
0,1,6,2,1,4,2,0,0,"16",1,1,5,7,0,0,1038149,"2024-01-15T00:00:00.000Z",20,FALSE,22,229,"F",22,22,"Orlando Magic","Jonathan Isaac",1,12,12,5,7,16.4
0,0,0,0,0,0,0,0,0,"00",0,0,0,0,0,0,1038149,"2024-01-15T00:00:00.000Z",20,FALSE,22,17553983,"G",22,22,"Orlando Magic","Trevelin Queen",0,0,0,0,0,0
0,0,0,0,0,0,0,0,0,"00",0,0,0,0,0,0,1038149,"2024-01-15T00:00:00.000Z",20,FALSE,22,462,"C",22,22,"Orlando Magic","Moritz Wagner",0,0,0,0,0,0
0,0,0,0,0,0,0,0,0,"00",0,0,0,0,0,0,1038149,"2024-01-15T00:00:00.000Z",20,FALSE,22,196,"G",22,22,"Orlando Magic","Gary Harris",0,0,0,0,0,0
0,0,0,0,0,0,0,0,0,"00",0,0,0,0,0,0,1038149,"2024-01-15T00:00:00.000Z",20,FALSE,22,38017607,"G",22,22,"Orlando Magic","Kevon Harris",0,0,0,0,0,0
0,0,0,0,0,0,0,0,0,"00",0,0,0,0,0,0,1038149,"2024-01-15T00:00:00.000Z",20,FALSE,22,56677839,"G",22,22,"Orlando Magic","Jett Howard",0,0,0,0,0,0
0,0,0,0,0,0,0,0,0,"00",0,0,0,0,0,0,1038149,"2024-01-15T00:00:00.000Z",20,FALSE,22,666885,"F",22,22,"Orlando Magic","Admiral Schofield",0,0,0,0,0,0
0,0,0,0,0,0,0,0,0,"00",0,0,0,0,0,0,1038149,"2024-01-15T00:00:00.000Z",20,FALSE,22,17896026,"F",22,22,"Orlando Magic","Franz Wagner",0,0,0,0,0,0
4,0,5,6,1,8,1,2,1,"27",0,3,4,5,0,2,1038149,"2024-01-15T00:00:00.000Z",20,FALSE,22,17896073,"G",22,22,"Orlando Magic","Jalen Suggs",0,9,13,8,9,14
4,0,1,1,0,6,3,0,0,"20",0,2,6,1,0,1,1038149,"2024-01-15T00:00:00.000Z",20,FALSE,22,226,"F",22,22,"Orlando Magic","Joe Ingles",0,7,11,10,5,12.2
7,0,4,0,0,8,3,0,0,"23",1,2,6,5,0,0,1038149,"2024-01-15T00:00:00.000Z",20,FALSE,22,165,"G",22,22,"Orlando Magic","Markelle Fultz",0,11,18,13,12,22.5
0,1,2,3,1,11,7,2,2,"19",1,1,17,3,0,0,1038149,"2024-01-15T00:00:00.000Z",20,FALSE,22,85,"F",22,22,"Orlando Magic","Wendell Carter Jr.",1,20,20,17,3,23.6
5,0,2,3,0,12,6,4,3,"26",2,2,15,4,2,2,1038149,"2024-01-15T00:00:00.000Z",20,FALSE,22,3547251,"G",22,22,"Orlando Magic","Cole Anthony",2,19,24,20,9,31.3
2,0,1,7,1,9,3,4,3,"33",4,3,10,5,0,0,1038151,"2024-01-15T00:00:00.000Z",1,FALSE,27,3547256,"F",1,1,"Atlanta Hawks","Saddiq Bey",0,15,17,12,7,19
7,0,10,2,1,13,7,1,1,"38",0,3,16,10,6,5,1038151,"2024-01-15T00:00:00.000Z",1,FALSE,27,17896040,"F",1,1,"Atlanta Hawks","Jalen Johnson",6,26,33,23,17,51.5
0,4,5,0,0,7,5,6,3,"25",6,2,13,11,0,1,1038151,"2024-01-15T00:00:00.000Z",1,FALSE,27,83,"C",1,1,"Atlanta Hawks","Clint Capela",4,24,24,13,11,37.2
0,1,13,6,1,15,6,0,0,"33",0,3,13,13,0,2,1038151,"2024-01-15T00:00:00.000Z",1,FALSE,27,334,"G",1,1,"Atlanta Hawks","Dejounte Murray",1,26,26,13,13,29.6
13,1,6,11,6,24,11,9,8,"38",0,0,36,6,1,3,1038151,"2024-01-15T00:00:00.000Z",1,FALSE,27,490,"G",1,1,"Atlanta Hawks","Trae Young",2,42,55,49,19,65.7
1,0,2,6,1,10,2,0,0,"25",0,2,5,2,1,3,1038151,"2024-01-15T00:00:00.000Z",1,FALSE,27,53,"G",1,1,"Atlanta Hawks","Bogdan Bogdanovic",1,7,8,6,3,8.9
0,0,2,1,1,3,1,0,0,"12",1,2,3,3,0,0,1038151,"2024-01-15T00:00:00.000Z",1,FALSE,27,3547297,"G",1,1,"Atlanta Hawks","Trent Forrest",0,6,6,3,3,6.6
0,0,0,0,0,0,0,0,0,"00",0,0,0,0,0,0,1038151,"2024-01-15T00:00:00.000Z",1,FALSE,27,4197387,"G",1,1,"Atlanta Hawks","Vit Krejci",0,0,0,0,0,0
0,0,0,0,0,0,0,0,0,"00",0,0,0,0,0,0,1038151,"2024-01-15T00:00:00.000Z",1,FALSE,27,301,"G-F",1,1,"Atlanta Hawks","Wesley Matthews",0,0,0,0,0,0
1,0,1,8,5,8,5,0,0,"20",0,1,15,1,1,0,1038151,"2024-01-15T00:00:00.000Z",1,FALSE,27,38017649,"F",27,27,"San Antonio Spurs","Julian Champagnie",1,16,17,16,2,20.7
4,2,5,4,2,16,8,5,5,"38",3,4,23,8,2,4,1038151,"2024-01-15T00:00:00.000Z",1,FALSE,27,38017699,"F",27,27,"San Antonio Spurs","Jeremy Sochan",4,31,35,27,12,46.6
1,5,11,5,1,18,12,1,1,"27",2,2,26,13,2,3,1038151,"2024-01-15T00:00:00.000Z",1,FALSE,27,56677822,"F-C",27,27,"San Antonio Spurs","Victor Wembanyama",7,39,40,27,14,61.1
4,1,3,5,0,11,2,0,0,"31",1,0,4,4,0,0,1038151,"2024-01-15T00:00:00.000Z",1,FALSE,27,3547246,"G-F",27,27,"San Antonio Spurs","Devin Vassell",1,8,12,8,8,17.8
12,0,1,1,0,8,3,0,0,"30",0,0,6,1,3,3,1038151,"2024-01-15T00:00:00.000Z",1,FALSE,27,3547274,"G",27,27,"San Antonio Spurs","Tre Jones",3,7,19,18,13,31.2
1,0,7,0,0,4,1,4,2,"17",0,2,4,7,1,0,1038151,"2024-01-15T00:00:00.000Z",1,FALSE,27,38017730,"F",27,27,"San Antonio Spurs","Dominick Barlow",1,11,12,5,8,16.9
0,0,0,1,0,4,2,0,0,"10",0,1,4,0,0,0,1038151,"2024-01-15T00:00:00.000Z",1,FALSE,27,38017692,"F",27,27,"San Antonio Spurs","Malaki Branham",0,4,4,4,0,4
0,0,0,0,0,0,0,0,0,"00",0,0,0,0,0,0,1038151,"2024-01-15T00:00:00.000Z",1,FALSE,27,3547163,"F",6,27,"San Antonio Spurs","Mamadi Diakite",0,0,0,0,0,0
0,0,0,0,0,0,0,0,0,"00",0,0,0,0,0,0,1038151,"2024-01-15T00:00:00.000Z",1,FALSE,27,180,"G",27,27,"San Antonio Spurs","Devonte' Graham",0,0,0,0,0,0
0,0,4,5,0,11,1,5,3,"26",2,4,5,6,1,5,1038151,"2024-01-15T00:00:00.000Z",1,FALSE,27,666682,"F",27,27,"San Antonio Spurs","Keldon Johnson",1,11,11,5,6,10.2
0,0,0,1,0,1,0,0,0,"01",0,0,0,0,0,0,1038151,"2024-01-15T00:00:00.000Z",1,FALSE,27,17896059,"F",27,27,"San Antonio Spurs","Sandro Mamukelashvili",0,0,0,0,0,0
0,0,1,5,2,5,2,0,0,"15",0,1,6,1,0,0,1038151,"2024-01-15T00:00:00.000Z",1,FALSE,27,305,"F",27,27,"San Antonio Spurs","Doug McDermott",0,7,7,6,1,7.2
0,0,1,5,1,5,1,0,0,"12",0,3,3,1,0,1,1038151,"2024-01-15T00:00:00.000Z",1,FALSE,27,359,"F",27,27,"San Antonio Spurs","Cedi Osman",0,4,4,3,1,3.2
3,0,1,2,0,4,1,2,1,"13",1,0,3,2,0,1,1038151,"2024-01-15T00:00:00.000Z",1,FALSE,27,38017693,"G",27,27,"San Antonio Spurs","Blake Wesley",0,5,8,6,5,8.9
0,0,0,0,0,0,0,0,0,"00",0,0,0,0,0,0,1038151,"2024-01-15T00:00:00.000Z",1,FALSE,27,17895854,"G",27,27,"San Antonio Spurs","Charles Bassey",0,0,0,0,0,0
0,0,0,0,0,0,0,0,0,"00",0,0,0,0,0,0,1038151,"2024-01-15T00:00:00.000Z",1,FALSE,27,56677817,"G",27,27,"San Antonio Spurs","Sidy Cissoko",0,0,0,0,0,0
0,0,0,0,0,0,0,0,0,"00",0,0,0,0,0,0,1038151,"2024-01-15T00:00:00.000Z",1,FALSE,27,102,"F-C",27,27,"San Antonio Spurs","Zach Collins",0,0,0,0,0,0
0,0,0,0,0,0,0,0,0,"00",0,0,0,0,0,0,1038151,"2024-01-15T00:00:00.000Z",1,FALSE,27,17896049,"G",3,27,"San Antonio Spurs","David Duke Jr.",0,0,0,0,0,0
0,0,0,0,0,0,0,0,0,"00",0,0,0,0,0,0,1038151,"2024-01-15T00:00:00.000Z",1,FALSE,27,38017689,"F",1,1,"Atlanta Hawks","AJ Griffin",0,0,0,0,0,0
0,0,0,0,0,0,0,0,0,"00",0,0,0,0,0,0,1038151,"2024-01-15T00:00:00.000Z",1,FALSE,27,56677855,"G",1,1,"Atlanta Hawks","Seth Lundy",0,0,0,0,0,0
0,0,0,0,0,0,0,0,0,"00",0,0,0,0,0,0,1038151,"2024-01-15T00:00:00.000Z",1,FALSE,27,319,"G",1,1,"Atlanta Hawks","Patty Mills",0,0,0,0,0,0
0,0,0,0,0,0,0,0,0,"00",0,0,0,0,0,0,1038151,"2024-01-15T00:00:00.000Z",1,FALSE,27,56677838,"G",1,1,"Atlanta Hawks","Kobe Bufkin",0,0,0,0,0,0
0,0,0,0,0,0,0,0,0,"00",0,0,0,0,0,0,1038151,"2024-01-15T00:00:00.000Z",1,FALSE,27,56677806,"F",1,1,"Atlanta Hawks","Mouhamed Gueye",0,0,0,0,0,0
0,0,0,0,0,0,0,0,0,"00",0,0,0,0,0,0,1038151,"2024-01-15T00:00:00.000Z",1,FALSE,27,666656,"F",1,1,"Atlanta Hawks","De'Andre Hunter",0,0,0,0,0,0
1,0,4,1,0,8,3,1,1,"23",2,4,7,6,0,2,1038151,"2024-01-15T00:00:00.000Z",1,FALSE,27,3547244,"F-C",1,1,"Atlanta Hawks","Onyeka Okongwu",0,13,14,8,7,13.7
0,0,0,4,2,4,2,0,0,"13",0,0,6,0,0,0,1038151,"2024-01-15T00:00:00.000Z",1,FALSE,27,666754,"G",1,1,"Atlanta Hawks","Garrison Mathews",0,6,6,6,0,6
0,0,0,0,0,0,0,0,0,"00",0,0,0,0,0,0,1038151,"2024-01-15T00:00:00.000Z",1,FALSE,27,666564,"F",1,1,"Atlanta Hawks","Bruno Fernando",0,0,0,0,0,0
4,1,4,6,3,11,6,10,9,"38",3,2,24,7,2,3,1038152,"2024-01-15T00:00:00.000Z",15,FALSE,10,38017731,"G",15,15,"Memphis Grizzlies","Vince Williams Jr.",3,31,35,28,11,44.4
5,1,5,14,3,20,4,8,7,"33",0,1,18,5,4,1,1038152,"2024-01-15T00:00:00.000Z",15,FALSE,10,231,"F-C",15,15,"Memphis Grizzlies","Jaren Jackson Jr.",5,23,28,23,10,45.5
3,2,3,2,0,6,1,0,0,"30",1,0,2,4,1,0,1038152,"2024-01-15T00:00:00.000Z",15,FALSE,10,3547285,"F",15,15,"Memphis Grizzlies","Xavier Tillman",3,6,9,5,7,20.3
0,0,1,5,1,6,1,4,1,"20",2,2,4,3,1,1,1038152,"2024-01-15T00:00:00.000Z",15,FALSE,10,17896027,"G-F",15,15,"Memphis Grizzlies","Ziaire Williams",1,7,7,4,3,9.6
5,0,1,7,2,9,2,5,5,"32",1,1,11,2,1,1,1038152,"2024-01-15T00:00:00.000Z",15,FALSE,10,254,"G",15,15,"Memphis Grizzlies","Luke Kennard",1,13,18,16,7,22.9
1,3,6,4,1,6,3,5,4,"17",0,2,11,6,0,1,1038152,"2024-01-15T00:00:00.000Z",15,FALSE,10,17896067,"F",15,15,"Memphis Grizzlies","Santi Aldama",3,17,18,12,7,27.7
3,1,2,4,3,7,4,0,0,"19",0,0,11,2,2,0,1038152,"2024-01-15T00:00:00.000Z",15,FALSE,10,48248287,"G",15,15,"Memphis Grizzlies","Jacob Gilyard",3,13,16,14,5,26.9
1,2,5,8,5,9,6,8,6,"29",1,3,23,6,2,2,1038152,"2024-01-15T00:00:00.000Z",15,FALSE,10,56677830,"F",15,15,"Memphis Grizzlies","GG Jackson",4,29,30,24,7,41.7
0,0,0,0,0,0,0,0,0,"00",0,0,0,0,0,0,1038152,"2024-01-15T00:00:00.000Z",15,FALSE,10,666703,"G-F",15,15,"Memphis Grizzlies","John Konchar",0,0,0,0,0,0
0,0,0,0,0,0,0,0,0,"00",0,0,0,0,0,0,1038152,"2024-01-15T00:00:00.000Z",15,FALSE,10,38017728,"F",15,15,"Memphis Grizzlies","Jake LaRavia",0,0,0,0,0,0
3,1,7,5,3,6,3,4,4,"23",0,5,13,7,0,4,1038152,"2024-01-15T00:00:00.000Z",15,FALSE,10,407,"F",10,10,"Golden State Warriors","Dario Saric",1,20,23,16,10,24.9
2,0,4,0,0,4,4,0,0,"18",1,1,8,5,1,1,1038152,"2024-01-15T00:00:00.000Z",15,FALSE,10,282,"F",10,10,"Golden State Warriors","Kevon Looney",1,13,15,10,7,19
3,0,0,4,1,10,4,0,0,"34",0,1,9,0,0,0,1038152,"2024-01-15T00:00:00.000Z",15,FALSE,10,443,"G",10,10,"Golden State Warriors","Klay Thompson",0,9,12,12,3,13.5
2,0,4,4,2,12,5,0,0,"22",3,1,12,7,0,2,1038152,"2024-01-15T00:00:00.000Z",15,FALSE,10,38017729,"F",15,15,"Memphis Grizzlies","David Roddy",0,19,21,14,9,21.4
0,0,0,0,0,0,0,0,0,"00",0,0,0,0,0,0,1038152,"2024-01-15T00:00:00.000Z",15,FALSE,10,401,"G",15,15,"Memphis Grizzlies","Derrick Rose",0,0,0,0,0,0
0,0,0,0,0,0,0,0,0,"00",0,0,0,0,0,0,1038152,"2024-01-15T00:00:00.000Z",15,FALSE,10,3,"C",15,15,"Memphis Grizzlies","Steven Adams",0,0,0,0,0,0
0,0,0,0,0,0,0,0,0,"00",0,0,0,0,0,0,1038152,"2024-01-15T00:00:00.000Z",15,FALSE,10,3547287,"G",15,15,"Memphis Grizzlies","Desmond Bane",0,0,0,0,0,0
0,0,0,0,0,0,0,0,0,"00",0,0,0,0,0,0,1038152,"2024-01-15T00:00:00.000Z",15,FALSE,10,666505,"F",15,15,"Memphis Grizzlies","Brandon Clarke",0,0,0,0,0,0
0,0,0,0,0,0,0,0,0,"00",0,0,0,0,0,0,1038152,"2024-01-15T00:00:00.000Z",15,FALSE,10,666786,"G",15,15,"Memphis Grizzlies","Ja Morant",0,0,0,0,0,0
0,0,0,0,0,0,0,0,0,"00",0,0,0,0,0,0,1038152,"2024-01-15T00:00:00.000Z",15,FALSE,10,420,"G",15,15,"Memphis Grizzlies","Marcus Smart",0,0,0,0,0,0
1,2,4,3,1,13,7,2,1,"31",1,1,16,5,0,1,1038152,"2024-01-15T00:00:00.000Z",15,FALSE,10,475,"F-G",10,10,"Golden State Warriors","Andrew Wiggins",2,21,22,17,6,28.5
1,0,0,0,0,0,0,0,0,"05",0,0,0,0,0,0,1038152,"2024-01-15T00:00:00.000Z",15,FALSE,10,45658838,"G",10,10,"Golden State Warriors","Lester Quinones",0,0,1,1,1,1.5
0,0,0,0,0,0,0,0,0,"00",0,0,0,0,0,0,1038152,"2024-01-15T00:00:00.000Z",15,FALSE,10,398,"G",10,10,"Golden State Warriors","Jerome Robinson",0,0,0,0,0,0
8,1,3,9,3,20,11,1,1,"33",1,4,26,4,2,5,1038152,"2024-01-15T00:00:00.000Z",15,FALSE,10,115,"G",10,10,"Golden State Warriors","Stephen Curry",3,30,38,34,12,46.8
0,0,9,5,1,18,9,1,1,"29",2,3,20,11,0,3,1038152,"2024-01-15T00:00:00.000Z",15,FALSE,10,17553979,"F",10,10,"Golden State Warriors","Jonathan Kuminga",0,31,31,20,11,30.2
4,0,2,3,0,12,4,0,0,"27",2,4,8,4,0,2,1038152,"2024-01-15T00:00:00.000Z",15,FALSE,10,56677858,"G",10,10,"Golden State Warriors","Brandin Podziemski",0,12,16,12,8,16.8
4,0,7,1,1,4,2,2,2,"23",0,4,7,7,1,3,1038152,"2024-01-15T00:00:00.000Z",15,FALSE,10,185,"F",10,10,"Golden State Warriors","Draymond Green",1,14,18,11,11,21.4
1,0,0,1,0,1,0,0,0,"07",0,0,0,0,0,0,1038152,"2024-01-15T00:00:00.000Z",15,FALSE,10,251,"G",10,10,"Golden State Warriors","Cory Joseph",0,0,1,1,1,1.5
1,2,2,0,0,2,0,0,0,"10",0,2,0,2,0,0,1038152,"2024-01-15T00:00:00.000Z",15,FALSE,10,56677799,"F",10,10,"Golden State Warriors","Trayce Jackson-Davis",2,2,3,1,3,9.9
0,0,0,0,0,0,0,0,0,"00",0,0,0,0,0,0,1038152,"2024-01-15T00:00:00.000Z",15,FALSE,10,57875092,"F",10,10,"Golden State Warriors","Gui Santos",0,0,0,0,0,0
0,0,0,0,0,0,0,0,0,"00",0,0,0,0,0,0,1038152,"2024-01-15T00:00:00.000Z",15,FALSE,10,17896070,"F",10,10,"Golden State Warriors","Usman Garuba",0,0,0,0,0,0
0,0,0,0,0,0,0,0,0,"00",0,0,0,0,0,0,1038152,"2024-01-15T00:00:00.000Z",15,FALSE,10,17553992,"G",10,10,"Golden State Warriors","Moses Moody",0,0,0,0,0,0
0,0,0,0,0,0,0,0,0,"00",0,0,0,0,0,0,1038152,"2024-01-15T00:00:00.000Z",15,FALSE,10,367,"G",10,10,"Golden State Warriors","Chris Paul",0,0,0,0,0,0
0,0,0,0,0,0,0,0,0,"00",0,0,0,0,0,0,1038152,"2024-01-15T00:00:00.000Z",15,FALSE,10,2189,"",10,10,"Golden State Warriors","Gary Payton II",0,0,0,0,0,0
1,0,4,6,1,12,3,0,0,"25",1,1,7,5,0,1,1038153,"2024-01-15T00:00:00.000Z",6,FALSE,5,3547247,"F-G",6,6,"Cleveland Cavaliers","Isaac Okoro",0,12,13,8,6,13.5
3,0,6,10,4,10,4,0,0,"26",1,2,12,7,3,0,1038153,"2024-01-15T00:00:00.000Z",6,FALSE,5,666940,"F",6,6,"Cleveland Cavaliers","Dean Wade",3,19,22,15,10,33.9
3,1,9,0,0,5,4,2,2,"34",5,1,10,14,2,2,1038153,"2024-01-15T00:00:00.000Z",6,FALSE,5,9,"C",6,6,"Cleveland Cavaliers","Jarrett Allen",3,24,27,13,17,38.3
4,1,4,6,0,8,1,0,0,"35",1,2,2,5,0,2,1038153,"2024-01-15T00:00:00.000Z",6,FALSE,5,666908,"G",6,6,"Cleveland Cavaliers","Max Strus",1,7,11,6,9,15
7,0,1,10,4,21,11,8,8,"37",2,0,34,3,2,2,1038153,"2024-01-15T00:00:00.000Z",6,FALSE,5,322,"G",6,6,"Cleveland Cavaliers","Donovan Mitchell",2,37,44,41,10,52.1
0,0,0,0,0,0,0,0,0,"00",0,0,0,0,0,0,1038153,"2024-01-15T00:00:00.000Z",6,FALSE,5,56677847,"F",6,6,"Cleveland Cavaliers","Emoni Bates",0,0,0,0,0,0
0,0,0,0,0,0,0,0,0,"00",0,0,0,0,0,0,1038153,"2024-01-15T00:00:00.000Z",6,FALSE,5,248,"C",6,6,"Cleveland Cavaliers","Damian Jones",0,0,0,0,0,0
7,1,6,10,4,17,6,0,0,"30",1,2,16,7,0,3,1038153,"2024-01-15T00:00:00.000Z",6,FALSE,5,277,"G",6,6,"Cleveland Cavaliers","Caris LeVert",1,23,30,23,14,34.9
3,2,3,5,1,15,5,9,7,"38",1,0,18,4,1,7,1038153,"2024-01-15T00:00:00.000Z",6,FALSE,5,666956,"G",5,5,"Chicago Bulls","Coby White",3,22,25,21,7,29.3
0,0,1,3,1,4,2,0,0,"11",1,1,5,2,0,0,1038153,"2024-01-15T00:00:00.000Z",6,FALSE,5,87,"G",5,5,"Chicago Bulls","Jevon Carter",0,7,7,5,2,7.4
0,0,0,0,0,0,0,0,0,"00",0,0,0,0,0,0,1038153,"2024-01-15T00:00:00.000Z",6,FALSE,5,110,"F",5,5,"Chicago Bulls","Torrey Craig",0,0,0,0,0,0
3,0,2,2,1,7,3,3,3,"19",1,3,10,3,0,0,1038153,"2024-01-15T00:00:00.000Z",6,FALSE,5,17895983,"G",5,5,"Chicago Bulls","Ayo Dosunmu",0,13,16,13,6,18.1
1,2,7,0,0,3,3,4,2,"22",3,2,8,10,2,2,1038153,"2024-01-15T00:00:00.000Z",6,FALSE,5,137,"C",5,5,"Chicago Bulls","Andre Drummond",4,18,19,9,11,31.5
0,0,1,1,0,1,0,0,0,"05",0,1,0,1,0,0,1038153,"2024-01-15T00:00:00.000Z",6,FALSE,5,17896116,"G",5,5,"Chicago Bulls","Terry Taylor",0,1,1,0,1,1.2
0,0,0,2,0,3,0,0,0,"04",0,0,0,0,0,0,1038153,"2024-01-15T00:00:00.000Z",6,FALSE,5,38017719,"F",5,5,"Chicago Bulls","Dalen Terry",0,0,0,0,0,0
0,0,0,0,0,0,0,0,0,"00",0,0,0,0,0,0,1038153,"2024-01-15T00:00:00.000Z",6,FALSE,5,3547248,"F",5,5,"Chicago Bulls","Patrick Williams",0,0,0,0,0,0
2,0,2,6,4,7,5,1,1,"20",1,4,15,3,2,0,1038153,"2024-01-15T00:00:00.000Z",6,FALSE,5,3547299,"G",6,6,"Cleveland Cavaliers","Sam Merrill",2,18,20,17,5,27.6
0,1,2,9,3,11,3,0,0,"19",0,2,9,2,0,1,1038153,"2024-01-15T00:00:00.000Z",6,FALSE,5,344,"F",6,6,"Cleveland Cavaliers","Georges Niang",1,11,11,9,2,13.4
0,0,0,0,0,0,0,0,0,"00",0,0,0,0,0,0,1038153,"2024-01-15T00:00:00.000Z",6,FALSE,5,56677872,"G",6,6,"Cleveland Cavaliers","Craig Porter",0,0,0,0,0,0
1,0,1,0,0,4,2,0,0,"14",1,0,4,2,0,0,1038153,"2024-01-15T00:00:00.000Z",6,FALSE,5,444,"C-F",6,6,"Cleveland Cavaliers","Tristan Thompson",0,6,7,5,3,7.9
0,0,0,0,0,0,0,0,0,"00",0,0,0,0,0,0,1038153,"2024-01-15T00:00:00.000Z",6,FALSE,5,666581,"G",6,6,"Cleveland Cavaliers","Darius Garland",0,0,0,0,0,0
0,0,0,0,0,0,0,0,0,"00",0,0,0,0,0,0,1038153,"2024-01-15T00:00:00.000Z",6,FALSE,5,666676,"G",6,6,"Cleveland Cavaliers","Ty Jerome",0,0,0,0,0,0
0,0,0,0,0,0,0,0,0,"00",0,0,0,0,0,0,1038153,"2024-01-15T00:00:00.000Z",6,FALSE,5,17896076,"F-C",6,6,"Cleveland Cavaliers","Evan Mobley",0,0,0,0,0,0
0,0,0,0,0,0,0,0,0,"00",0,0,0,0,0,0,1038153,"2024-01-15T00:00:00.000Z",6,FALSE,5,38017662,"F",6,6,"Cleveland Cavaliers","Isaiah Mobley",0,0,0,0,0,0
3,1,3,5,2,9,4,0,0,"31",0,1,10,3,3,2,1038153,"2024-01-15T00:00:00.000Z",6,FALSE,5,89,"G",5,5,"Chicago Bulls","Alex Caruso",4,13,16,13,6,28.1
3,1,6,1,0,8,3,0,0,"38",0,3,6,6,2,2,1038153,"2024-01-15T00:00:00.000Z",6,FALSE,5,125,"G",5,5,"Chicago Bulls","DeMar DeRozan",3,12,15,9,9,24.7
4,0,10,7,1,19,8,0,0,"37",0,3,17,10,0,2,1038153,"2024-01-15T00:00:00.000Z",6,FALSE,5,460,"C",5,5,"Chicago Bulls","Nikola Vucevic",0,27,31,21,14,33
4,0,4,6,3,14,7,0,0,"35",0,3,17,4,0,3,1038153,"2024-01-15T00:00:00.000Z",6,FALSE,5,268,"G",5,5,"Chicago Bulls","Zach LaVine",0,21,25,21,8,24.8
0,0,0,0,0,0,0,0,0,"00",0,0,0,0,0,0,1038153,"2024-01-15T00:00:00.000Z",6,FALSE,5,56677874,"F",5,5,"Chicago Bulls","Onuralp Bitim",0,0,0,0,0,0
0,0,0,0,0,0,0,0,0,"00",0,0,0,0,0,0,1038153,"2024-01-15T00:00:00.000Z",6,FALSE,5,NA,NA,NA,5,"Chicago Bulls","NA NA",0,0,0,0,0,0
0,0,0,0,0,0,0,0,0,"00",0,0,0,0,0,0,1038153,"2024-01-15T00:00:00.000Z",6,FALSE,5,56677857,"F",5,5,"Chicago Bulls","Julian Phillips",0,0,0,0,0,0
0,0,0,0,0,0,0,0,0,"00",0,0,0,0,0,0,1038153,"2024-01-15T00:00:00.000Z",6,FALSE,5,56677860,"F",5,5,"Chicago Bulls","Adama Sanogo",0,0,0,0,0,0
0,0,0,0,0,0,0,0,0,"00",0,0,0,0,0,0,1038153,"2024-01-15T00:00:00.000Z",6,FALSE,5,27,"G",5,5,"Chicago Bulls","Lonzo Ball",0,0,0,0,0,0
4,2,2,2,1,8,4,4,3,"28",0,1,12,2,0,3,1038150,"2024-01-15T00:00:00.000Z",30,FALSE,9,3547242,"F",30,30,"Washington Wizards","Deni Avdija",2,14,18,16,6,23.4
4,2,8,9,3,21,7,4,4,"33",0,2,21,8,3,0,1038150,"2024-01-15T00:00:00.000Z",30,FALSE,9,265,"F",30,30,"Washington Wizards","Kyle Kuzma",5,29,33,25,12,51.6
3,2,3,0,0,6,4,0,0,"26",3,3,8,6,1,2,1038150,"2024-01-15T00:00:00.000Z",30,FALSE,9,666577,"F",30,30,"Washington Wizards","Daniel Gafford",3,14,17,11,9,26.7
2,0,0,7,2,14,6,2,2,"32",0,3,16,0,0,1,1038150,"2024-01-15T00:00:00.000Z",30,FALSE,9,666848,"G",30,30,"Washington Wizards","Jordan Poole",0,16,18,18,2,18
7,0,4,10,4,19,9,0,0,"31",2,0,22,6,1,0,1038150,"2024-01-15T00:00:00.000Z",30,FALSE,9,249,"G",30,30,"Washington Wizards","Tyus Jones",1,28,35,29,13,42.7
1,0,3,3,3,3,3,0,0,"13",0,2,9,3,1,0,1038150,"2024-01-15T00:00:00.000Z",30,FALSE,9,38017704,"F",30,30,"Washington Wizards","Patrick Baldwin Jr.",1,12,13,10,4,17.1
0,0,0,0,0,0,0,0,0,"00",0,0,0,0,0,0,1038150,"2024-01-15T00:00:00.000Z",30,FALSE,9,NA,NA,NA,30,"Washington Wizards","NA NA",0,0,0,0,0,0
2,0,3,1,0,4,1,0,0,"27",1,2,2,4,0,0,1038150,"2024-01-15T00:00:00.000Z",30,FALSE,9,56677844,"G",30,30,"Washington Wizards","Bilal Coulibaly",0,6,8,4,6,9.8
0,0,0,0,0,0,0,0,0,"01",0,0,0,0,0,0,1038150,"2024-01-15T00:00:00.000Z",30,FALSE,9,38017687,"G",30,30,"Washington Wizards","Johnny Davis",0,0,0,0,0,0
0,0,0,0,0,0,0,0,0,"01",0,0,0,0,0,0,1038150,"2024-01-15T00:00:00.000Z",30,FALSE,9,128,"G",9,30,"Washington Wizards","Hamidou Diallo",0,0,0,0,0,0
0,0,0,1,1,2,1,0,0,"03",1,0,3,1,0,1,1038150,"2024-01-15T00:00:00.000Z",30,FALSE,9,3547302,"F",30,30,"Washington Wizards","Anthony Gill",0,4,4,3,1,3.2
3,0,2,3,2,5,3,0,0,"15",0,3,8,2,0,1,1038150,"2024-01-15T00:00:00.000Z",30,FALSE,9,17896045,"F",30,30,"Washington Wizards","Corey Kispert",0,10,13,11,5,13.9
0,1,0,3,2,7,4,1,1,"14",0,1,11,0,1,0,1038150,"2024-01-15T00:00:00.000Z",30,FALSE,9,414,"G",30,30,"Washington Wizards","Landry Shamet",2,11,11,11,0,17
0,0,0,0,0,0,0,0,0,"00",0,0,0,0,0,0,1038150,"2024-01-15T00:00:00.000Z",30,FALSE,9,18677954,"G",30,30,"Washington Wizards","Jared Butler",0,0,0,0,0,0
0,0,0,0,0,0,0,0,0,"00",0,0,0,0,0,0,1038150,"2024-01-15T00:00:00.000Z",30,FALSE,9,17896071,"F",9,30,"Washington Wizards","Isaiah Livers",0,0,0,0,0,0
0,0,0,0,0,0,0,0,0,"00",0,0,0,0,0,0,1038150,"2024-01-15T00:00:00.000Z",30,FALSE,9,17896106,"F",30,30,"Washington Wizards","Eugene Omoruyi",0,0,0,0,0,0
1,0,0,4,1,7,1,2,2,"33",2,0,5,2,0,1,1038150,"2024-01-15T00:00:00.000Z",30,FALSE,9,259,"F",9,9,"Detroit Pistons","Kevin Knox",0,7,8,6,3,7.9
4,2,2,6,1,17,7,2,1,"38",4,4,16,6,1,3,1038150,"2024-01-15T00:00:00.000Z",30,FALSE,9,3547267,"F-C",9,9,"Detroit Pistons","Isaiah Stewart",3,22,26,20,10,35.2
4,1,17,0,0,8,8,5,4,"26",2,3,20,19,0,2,1038150,"2024-01-15T00:00:00.000Z",30,FALSE,9,38017694,"C",9,9,"Detroit Pistons","Jalen Duren",1,39,43,24,23,49.8
6,3,6,7,2,18,9,7,4,"32",1,0,24,7,0,5,1038150,"2024-01-15T00:00:00.000Z",30,FALSE,9,38017682,"G",9,9,"Detroit Pistons","Jaden Ivey",3,31,37,30,13,45.4
6,0,1,1,0,4,2,0,0,"24",0,1,4,1,0,1,1038150,"2024-01-15T00:00:00.000Z",30,FALSE,9,3547241,"G",9,9,"Detroit Pistons","Killian Hayes",0,5,11,10,7,13.2
0,0,0,0,0,0,0,0,0,"00",0,0,0,0,0,0,1038150,"2024-01-15T00:00:00.000Z",30,FALSE,9,54,"F",9,9,"Detroit Pistons","Bojan Bogdanovic",0,0,0,0,0,0
2,0,2,12,8,17,11,4,4,"29",0,2,34,2,0,1,1038150,"2024-01-15T00:00:00.000Z",30,FALSE,9,77,"G",9,9,"Detroit Pistons","Alec Burks",0,36,38,36,4,38.4
0,0,0,0,0,0,0,0,0,"00",0,0,0,0,0,0,1038150,"2024-01-15T00:00:00.000Z",30,FALSE,9,167,"F",30,9,"Detroit Pistons","Danilo Gallinari",0,0,0,0,0,0
0,0,0,0,0,0,0,0,0,"00",0,0,0,0,0,0,1038150,"2024-01-15T00:00:00.000Z",30,FALSE,9,330,"G",9,9,"Detroit Pistons","Monte Morris",0,0,0,0,0,0
0,0,0,0,0,0,0,0,0,"00",0,0,0,0,0,0,1038150,"2024-01-15T00:00:00.000Z",30,FALSE,9,337,"F-C",30,9,"Detroit Pistons","Mike Muscala",0,0,0,0,0,0
0,0,0,0,0,0,0,0,0,"00",0,0,0,0,0,0,1038150,"2024-01-15T00:00:00.000Z",30,FALSE,9,42097199,"G",9,9,"Detroit Pistons","Jared Rhoden",0,0,0,0,0,0
1,0,0,0,0,0,0,0,0,"05",0,0,0,0,0,1,1038150,"2024-01-15T00:00:00.000Z",30,FALSE,9,197,"F-G",9,9,"Detroit Pistons","Joe Harris",0,0,1,1,1,0.5
4,2,2,0,0,7,3,0,0,"11",0,0,6,2,0,1,1038150,"2024-01-15T00:00:00.000Z",30,FALSE,9,56677792,"G",9,9,"Detroit Pistons","Marcus Sasser",2,8,12,10,6,19.4
2,0,7,1,0,8,6,3,2,"27",1,2,14,8,3,0,1038150,"2024-01-15T00:00:00.000Z",30,FALSE,9,56677826,"G-F",9,9,"Detroit Pistons","Ausar Thompson",3,22,24,16,10,35.6
0,0,0,0,0,0,0,0,0,"00",0,0,0,0,0,0,1038150,"2024-01-15T00:00:00.000Z",30,FALSE,9,44477024,"G",9,9,"Detroit Pistons","Stanley Umude",0,0,0,0,0,0
0,2,3,0,0,4,3,0,0,"15",2,1,6,5,0,0,1038150,"2024-01-15T00:00:00.000Z",30,FALSE,9,3547240,"C",9,9,"Detroit Pistons","James Wiseman",2,11,11,6,5,18
0,0,0,0,0,0,0,0,0,"00",0,0,0,0,0,0,1038150,"2024-01-15T00:00:00.000Z",30,FALSE,9,56677729,"G",9,9,"Detroit Pistons","Malcolm Cazalon",0,0,0,0,0,0
0,0,0,0,0,0,0,0,0,"00",0,0,0,0,0,0,1038150,"2024-01-15T00:00:00.000Z",30,FALSE,9,17896075,"G-F",9,9,"Detroit Pistons","Cade Cunningham",0,0,0,0,0,0
4,0,0,2,1,6,2,0,0,"16",1,2,5,1,1,0,1038150,"2024-01-15T00:00:00.000Z",30,FALSE,9,487,"G",30,30,"Washington Wizards","Delon Wright",1,6,10,9,5,15.2
0,0,0,0,0,0,0,0,0,"00",0,0,0,0,0,0,1038150,"2024-01-15T00:00:00.000Z",30,FALSE,9,24,"F",9,30,"Washington Wizards","Marvin Bagley III",0,0,0,0,0,0
6,2,5,14,9,17,10,0,0,"37",0,1,29,5,2,2,1038159,"2024-01-16T00:00:00.000Z",24,FALSE,26,8,"G",24,24,"Phoenix Suns","Grayson Allen",4,34,40,35,11,54
4,2,4,8,4,16,7,9,9,"39",1,3,27,5,0,7,1038159,"2024-01-16T00:00:00.000Z",24,FALSE,26,140,"F",24,24,"Phoenix Suns","Kevin Durant",2,32,36,31,9,38
3,1,12,0,0,5,4,2,2,"28",3,3,10,15,0,1,1038159,"2024-01-16T00:00:00.000Z",24,FALSE,26,349,"C",24,24,"Phoenix Suns","Jusuf Nurkic",1,25,28,13,18,34.5
5,0,2,4,0,14,6,2,1,"38",1,2,13,3,2,1,1038159,"2024-01-16T00:00:00.000Z",24,FALSE,26,37,"G",24,24,"Phoenix Suns","Bradley Beal",2,16,21,18,8,29.1
11,0,4,3,1,14,5,6,5,"38",0,4,16,4,0,2,1038159,"2024-01-16T00:00:00.000Z",24,FALSE,26,57,"G",24,24,"Phoenix Suns","Devin Booker",0,20,31,27,15,35.3
2,0,3,7,3,10,5,0,0,"24",0,0,13,3,2,2,1038159,"2024-01-16T00:00:00.000Z",24,FALSE,26,178,"G",24,24,"Phoenix Suns","Eric Gordon",2,16,18,15,5,23.6
1,0,5,1,0,5,3,0,0,"10",0,1,6,5,0,1,1038159,"2024-01-16T00:00:00.000Z",24,FALSE,26,314,"F",24,24,"Phoenix Suns","Chimezie Metu",0,11,12,7,6,12.5
0,0,1,0,0,1,1,1,1,"10",3,0,3,4,1,0,1038159,"2024-01-16T00:00:00.000Z",24,FALSE,26,147,"F",24,24,"Phoenix Suns","Drew Eubanks",1,7,7,3,4,10.8
0,1,2,0,0,3,1,0,0,"16",0,1,2,2,0,0,1038159,"2024-01-16T00:00:00.000Z",24,FALSE,26,356,"G",24,24,"Phoenix Suns","Josh Okogie",1,4,4,2,2,7.4
0,0,0,0,0,0,0,0,0,"00",0,0,0,0,0,0,1038159,"2024-01-16T00:00:00.000Z",24,FALSE,26,3547095,"C-F",24,24,"Phoenix Suns","Udoka Azubuike",0,0,0,0,0,0
0,0,0,0,0,0,0,0,0,"00",0,0,0,0,0,0,1038159,"2024-01-16T00:00:00.000Z",24,FALSE,26,32,"F",24,24,"Phoenix Suns","Keita Bates-Diop",0,0,0,0,0,0
0,0,0,0,0,0,0,0,0,"00",0,0,0,0,0,0,1038159,"2024-01-16T00:00:00.000Z",24,FALSE,26,18678058,"",24,24,"Phoenix Suns","Jordan Goodwin",0,0,0,0,0,0
0,0,0,0,0,0,0,0,0,"00",0,0,0,0,0,0,1038159,"2024-01-16T00:00:00.000Z",24,FALSE,26,666729,"F",24,24,"Phoenix Suns","Nassir Little",0,0,0,0,0,0
0,0,0,0,0,0,0,0,0,"00",0,0,0,0,0,0,1038159,"2024-01-16T00:00:00.000Z",24,FALSE,26,470,"G",24,24,"Phoenix Suns","Yuta Watanabe",0,0,0,0,0,0
0,0,0,0,0,0,0,0,0,"00",0,0,0,0,0,0,1038159,"2024-01-16T00:00:00.000Z",24,FALSE,26,666451,"C",24,24,"Phoenix Suns","Bol Bol",0,0,0,0,0,0
0,0,0,0,0,0,0,0,0,"00",0,0,0,0,0,0,1038159,"2024-01-16T00:00:00.000Z",24,FALSE,26,272,"G",24,24,"Phoenix Suns","Damion Lee",0,0,0,0,0,0
0,0,0,0,0,0,0,0,0,"00",0,0,0,0,0,0,1038159,"2024-01-16T00:00:00.000Z",24,FALSE,26,3547298,"G",24,24,"Phoenix Suns","Saben Lee",0,0,0,0,0,0
0,0,0,0,0,0,0,0,0,"00",0,0,0,0,0,0,1038159,"2024-01-16T00:00:00.000Z",24,FALSE,26,3547253,"G",4,24,"Phoenix Suns","Theo Maledon",0,0,0,0,0,0
3,1,3,5,3,12,7,2,1,"35",1,3,18,4,1,1,1038159,"2024-01-16T00:00:00.000Z",24,FALSE,26,38017688,"F",26,26,"Sacramento Kings","Keegan Murray",2,22,25,21,7,32.3
3,0,3,6,2,9,3,0,0,"34",0,2,8,3,0,2,1038159,"2024-01-16T00:00:00.000Z",24,FALSE,26,30,"F",26,26,"Sacramento Kings","Harrison Barnes",0,11,14,11,6,14.1
11,1,10,1,1,11,9,4,2,"39",2,2,21,12,0,2,1038159,"2024-01-16T00:00:00.000Z",24,FALSE,26,406,"F",26,26,"Sacramento Kings","Domantas Sabonis",1,33,44,32,23,52.9
2,1,3,6,2,9,4,0,0,"26",0,4,10,3,2,0,1038159,"2024-01-16T00:00:00.000Z",24,FALSE,26,221,"G",26,26,"Sacramento Kings","Kevin Huerter",3,13,15,12,5,25.6
6,0,1,10,6,24,12,5,3,"37",1,2,33,2,2,1,1038159,"2024-01-16T00:00:00.000Z",24,FALSE,26,161,"G",26,26,"Sacramento Kings","De'Aaron Fox",2,35,41,39,8,49.4
8,1,3,7,2,16,5,1,1,"29",0,2,13,3,0,5,1038159,"2024-01-16T00:00:00.000Z",24,FALSE,26,324,"G",26,26,"Sacramento Kings","Malik Monk",1,16,24,21,11,26.6
0,0,2,2,0,2,0,0,0,"14",0,1,0,2,1,0,1038159,"2024-01-16T00:00:00.000Z",24,FALSE,26,290,"F",26,26,"Sacramento Kings","Trey Lyles",1,2,2,0,2,5.4
1,0,1,3,2,9,6,0,0,"18",1,1,14,2,1,1,1038159,"2024-01-16T00:00:00.000Z",24,FALSE,26,4197162,"F",26,26,"Sacramento Kings","Aleksandar Vezenkov",1,16,17,15,3,19.9
0,0,0,0,0,0,0,0,0,"08",0,3,0,0,0,2,1038159,"2024-01-16T00:00:00.000Z",24,FALSE,26,273,"C",26,26,"Sacramento Kings","Alex Len",0,0,0,0,0,-2
0,0,0,0,0,0,0,0,0,"00",0,0,0,0,0,0,1038159,"2024-01-16T00:00:00.000Z",24,FALSE,26,17896030,"G",26,26,"Sacramento Kings","Chris Duarte",0,0,0,0,0,0
0,0,0,0,0,0,0,0,0,"00",0,0,0,0,0,0,1038159,"2024-01-16T00:00:00.000Z",24,FALSE,26,17896044,"F",26,26,"Sacramento Kings","Kessler Edwards",0,0,0,0,0,0
0,0,0,0,0,0,0,0,0,"00",0,0,0,0,0,0,1038159,"2024-01-16T00:00:00.000Z",24,FALSE,26,38017714,"G",26,26,"Sacramento Kings","Keon Ellis",0,0,0,0,0,0
0,0,0,0,0,0,0,0,0,"00",0,0,0,0,0,0,1038159,"2024-01-16T00:00:00.000Z",24,FALSE,26,306,"C",26,26,"Sacramento Kings","JaVale McGee",0,0,0,0,0,0
0,0,0,0,0,0,0,0,0,"00",0,0,0,0,0,0,1038159,"2024-01-16T00:00:00.000Z",24,FALSE,26,17553994,"G",26,26,"Sacramento Kings","Davion Mitchell",0,0,0,0,0,0
0,0,0,0,0,0,0,0,0,"00",0,0,0,0,0,0,1038159,"2024-01-16T00:00:00.000Z",24,FALSE,26,666925,"F",29,26,"Sacramento Kings","Juan Toscano-Anderson",0,0,0,0,0,0
0,0,0,0,0,0,0,0,0,"00",0,0,0,0,0,0,1038159,"2024-01-16T00:00:00.000Z",24,FALSE,26,17895990,"G",26,26,"Sacramento Kings","Jordan Ford",0,0,0,0,0,0
0,0,0,0,0,0,0,0,0,"00",0,0,0,0,0,0,1038159,"2024-01-16T00:00:00.000Z",24,FALSE,26,56677845,"G",26,26,"Sacramento Kings","Colby Jones",0,0,0,0,0,0
0,0,0,0,0,0,0,0,0,"00",0,0,0,0,0,0,1038159,"2024-01-16T00:00:00.000Z",24,FALSE,26,56677862,"F",26,26,"Sacramento Kings","Jalen Slawson",0,0,0,0,0,0
0,0,0,0,0,0,0,0,0,"00",0,0,0,0,0,0,1038160,"2024-01-16T00:00:00.000Z",13,FALSE,21,27924547,"F",21,21,"Oklahoma City Thunder","Lindy Waters III",0,0,0,0,0,0
0,0,0,0,0,0,0,0,0,"00",0,0,0,0,0,0,1038160,"2024-01-16T00:00:00.000Z",13,FALSE,21,3547271,"C",21,21,"Oklahoma City Thunder","Aleksej Pokusevski",0,0,0,0,0,0
5,0,7,12,6,24,15,4,2,"34",0,2,38,7,3,0,1038160,"2024-01-16T00:00:00.000Z",13,FALSE,21,172,"F",13,13,"LA Clippers","Paul George",3,45,50,43,12,62.9
6,1,5,4,3,10,6,2,1,"37",1,0,16,6,0,3,1038160,"2024-01-16T00:00:00.000Z",13,FALSE,21,274,"F",13,13,"LA Clippers","Kawhi Leonard",1,22,28,22,12,32.2
2,3,3,0,0,5,5,7,4,"28",2,2,14,5,0,0,1038160,"2024-01-16T00:00:00.000Z",13,FALSE,21,371,"F-C",13,13,"LA Clippers","Mason Plumlee",3,19,21,16,7,32
4,2,1,2,1,6,3,0,0,"24",2,4,7,3,0,1,1038160,"2024-01-16T00:00:00.000Z",13,FALSE,21,666743,"G",13,13,"LA Clippers","Terance Mann",2,10,14,11,7,21.6
8,1,5,10,4,14,5,2,2,"41",0,2,16,5,0,1,1038160,"2024-01-16T00:00:00.000Z",13,FALSE,21,192,"G",13,13,"LA Clippers","James Harden",1,21,29,24,13,36
4,0,1,3,0,8,4,4,3,"22",1,0,11,2,1,2,1038160,"2024-01-16T00:00:00.000Z",13,FALSE,21,472,"G",13,13,"LA Clippers","Russell Westbrook",1,13,17,15,6,20.4
0,3,3,2,1,6,4,0,0,"20",5,3,9,8,0,2,1038160,"2024-01-16T00:00:00.000Z",13,FALSE,21,439,"F",13,13,"LA Clippers","Daniel Theis",3,17,17,9,8,25.6
0,0,2,3,3,4,3,0,0,"15",1,2,9,3,0,0,1038160,"2024-01-16T00:00:00.000Z",13,FALSE,21,666511,"G",13,13,"LA Clippers","Amir Coffey",0,12,12,9,3,12.6
1,0,0,7,2,10,2,4,2,"19",0,3,8,0,1,0,1038160,"2024-01-16T00:00:00.000Z",13,FALSE,21,380,"F-G",13,13,"LA Clippers","Norman Powell",1,8,9,9,1,12.5
0,0,0,0,0,0,0,0,0,"00",0,0,0,0,0,0,1038160,"2024-01-16T00:00:00.000Z",13,FALSE,21,17896022,"G",13,13,"LA Clippers","Brandon Boston Jr.",0,0,0,0,0,0
0,0,0,0,0,0,0,0,0,"00",0,0,0,0,0,0,1038160,"2024-01-16T00:00:00.000Z",13,FALSE,21,17896031,"G",13,13,"LA Clippers","Nah'Shon Hyland",0,0,0,0,0,0
0,0,0,0,0,0,0,0,0,"00",0,0,0,0,0,0,1038160,"2024-01-16T00:00:00.000Z",13,FALSE,21,450,"F",13,13,"LA Clippers","PJ Tucker",0,0,0,0,0,0
0,0,0,0,0,0,0,0,0,"00",0,0,0,0,0,0,1038160,"2024-01-16T00:00:00.000Z",13,FALSE,21,56677849,"F",13,13,"LA Clippers","Kobe Brown",0,0,0,0,0,0
0,0,0,0,0,0,0,0,0,"00",0,0,0,0,0,0,1038160,"2024-01-16T00:00:00.000Z",13,FALSE,21,38017725,"F",13,13,"LA Clippers","Moussa Diabate",0,0,0,0,0,0
0,0,0,0,0,0,0,0,0,"00",0,0,0,0,0,0,1038160,"2024-01-16T00:00:00.000Z",13,FALSE,21,56677856,"G",13,13,"LA Clippers","Jordan Miller",0,0,0,0,0,0
0,0,0,0,0,0,0,0,0,"00",0,0,0,0,0,0,1038160,"2024-01-16T00:00:00.000Z",13,FALSE,21,24417679,"G",13,13,"LA Clippers","Xavier Moon",0,0,0,0,0,0
0,0,0,0,0,0,0,0,0,"00",0,0,0,0,0,0,1038160,"2024-01-16T00:00:00.000Z",13,FALSE,21,17896051,"G",13,13,"LA Clippers","Joshua Primo",0,0,0,0,0,0
0,0,0,0,0,0,0,0,0,"00",0,0,0,0,0,0,1038160,"2024-01-16T00:00:00.000Z",13,FALSE,21,493,"C",13,13,"LA Clippers","Ivica Zubac",0,0,0,0,0,0
1,0,1,8,5,10,6,2,2,"33",0,2,19,1,0,3,1038160,"2024-01-16T00:00:00.000Z",13,FALSE,21,666541,"G",21,21,"Oklahoma City Thunder","Luguentz Dort",0,20,21,20,2,18.7
7,0,3,3,2,14,10,3,3,"33",0,5,25,3,0,4,1038160,"2024-01-16T00:00:00.000Z",13,FALSE,21,38017703,"G-F",21,21,"Oklahoma City Thunder","Jalen Williams",0,28,35,32,10,35.1
5,1,5,2,0,10,2,6,4,"33",0,4,8,5,0,1,1038160,"2024-01-16T00:00:00.000Z",13,FALSE,21,38017685,"C-F",21,21,"Oklahoma City Thunder","Chet Holmgren",1,13,18,13,10,23.5
4,0,3,3,1,9,4,0,0,"19",1,0,9,4,0,0,1038160,"2024-01-16T00:00:00.000Z",13,FALSE,21,17896065,"G",21,21,"Oklahoma City Thunder","Josh Giddey",0,13,17,13,8,19.8
4,2,1,3,0,16,6,8,7,"34",1,4,19,2,0,2,1038160,"2024-01-16T00:00:00.000Z",13,FALSE,21,175,"G",21,21,"Oklahoma City Thunder","Shai Gilgeous-Alexander",2,21,25,23,6,31.4
1,1,4,4,1,4,1,0,0,"16",2,1,3,6,1,1,1038160,"2024-01-16T00:00:00.000Z",13,FALSE,21,480,"G-F",21,21,"Oklahoma City Thunder","Kenrich Williams",2,9,10,4,7,16.7
3,0,3,6,5,7,5,0,0,"24",3,2,15,6,2,0,1038160,"2024-01-16T00:00:00.000Z",13,FALSE,21,3547272,"G",21,21,"Oklahoma City Thunder","Isaiah Joe",2,21,24,18,9,32.7
0,0,1,1,0,1,0,0,0,"04",0,0,0,1,0,1,1038160,"2024-01-16T00:00:00.000Z",13,FALSE,21,38017716,"F",21,21,"Oklahoma City Thunder","Ousmane Dieng",0,1,1,0,1,0.2
1,1,0,2,1,4,2,0,0,"15",2,1,5,2,1,0,1038160,"2024-01-16T00:00:00.000Z",13,FALSE,21,56677833,"G",21,21,"Oklahoma City Thunder","Cason Wallace",2,7,8,6,3,14.9
2,0,4,1,1,4,3,0,0,"17",0,0,7,4,1,0,1038160,"2024-01-16T00:00:00.000Z",13,FALSE,21,17896078,"G",21,21,"Oklahoma City Thunder","Aaron Wiggins",1,11,13,9,6,17.8
2,0,1,1,0,4,3,1,1,"11",0,0,7,1,0,0,1038160,"2024-01-16T00:00:00.000Z",13,FALSE,21,4197029,"G",21,21,"Oklahoma City Thunder","Vasilije Micic",0,8,10,9,3,11.2
0,0,0,0,0,0,0,0,0,"01",0,0,0,0,0,0,1038160,"2024-01-16T00:00:00.000Z",13,FALSE,21,24572055,"C",21,21,"Oklahoma City Thunder","Olivier Sarr",0,0,0,0,0,0
0,0,0,0,0,0,0,0,0,"00",0,0,0,0,0,0,1038160,"2024-01-16T00:00:00.000Z",13,FALSE,21,44,"F",21,21,"Oklahoma City Thunder","Davis Bertans",0,0,0,0,0,0
0,0,0,0,0,0,0,0,0,"00",0,0,0,0,0,0,1038160,"2024-01-16T00:00:00.000Z",13,FALSE,21,17896036,"G",21,21,"Oklahoma City Thunder","Tre Mann",0,0,0,0,0,0
0,0,0,0,0,0,0,0,0,"00",0,0,0,0,0,0,1038160,"2024-01-16T00:00:00.000Z",13,FALSE,21,38017706,"F",21,21,"Oklahoma City Thunder","Jaylin Williams",0,0,0,0,0,0
0,0,0,0,0,0,0,0,0,"00",0,0,0,0,0,0,1038160,"2024-01-16T00:00:00.000Z",13,FALSE,21,56677853,"F",21,21,"Oklahoma City Thunder","Keyontae Johnson",0,0,0,0,0,0
4,2,5,4,2,10,8,6,6,"38",0,2,24,5,1,0,1038158,"2024-01-16T00:00:00.000Z",23,FALSE,8,200,"F",23,23,"Philadelphia 76ers","Tobias Harris",3,29,33,28,9,45
0,0,0,0,0,0,0,0,0,"00",0,0,0,0,0,0,1038158,"2024-01-16T00:00:00.000Z",23,FALSE,8,56677776,"G",8,8,"Denver Nuggets","Julian Strawther",0,0,0,0,0,0
2,2,3,3,2,4,3,0,0,"35",1,3,8,4,0,2,1038158,"2024-01-16T00:00:00.000Z",23,FALSE,8,33,"F-G",23,23,"Philadelphia 76ers","Nicolas Batum",2,12,14,10,6,19.8
10,1,6,6,3,22,13,15,12,"39",1,4,41,7,0,3,1038158,"2024-01-16T00:00:00.000Z",23,FALSE,8,145,"F-C",23,23,"Philadelphia 76ers","Joel Embiid",1,48,58,51,17,64.4
0,0,5,4,1,9,5,1,0,"26",0,4,11,5,1,2,1038158,"2024-01-16T00:00:00.000Z",23,FALSE,8,360,"F",23,23,"Philadelphia 76ers","Kelly Oubre Jr.",1,16,16,11,5,18
9,0,4,9,4,20,9,7,3,"43",1,2,25,5,2,1,1038158,"2024-01-16T00:00:00.000Z",23,FALSE,8,3547254,"G",23,23,"Philadelphia 76ers","Tyrese Maxey",2,30,39,34,14,49.5
0,0,1,2,1,3,1,5,4,"19",1,3,7,2,0,0,1038158,"2024-01-16T00:00:00.000Z",23,FALSE,8,328,"F",23,23,"Philadelphia 76ers","Marcus Morris",0,9,9,7,2,9.4
0,0,0,0,0,0,0,0,0,"00",0,0,0,0,0,0,1038158,"2024-01-16T00:00:00.000Z",23,FALSE,8,56677582,"G",8,8,"Denver Nuggets","Jalen Pickett",0,0,0,0,0,0
2,0,2,3,2,7,3,0,0,"27",0,2,8,2,2,0,1038158,"2024-01-16T00:00:00.000Z",23,FALSE,8,45,"G",23,23,"Philadelphia 76ers","Patrick Beverley",2,10,12,10,4,19.4
0,0,0,0,0,0,0,0,0,"04",0,0,0,0,0,0,1038158,"2024-01-16T00:00:00.000Z",23,FALSE,8,260,"G-F",23,23,"Philadelphia 76ers","Furkan Korkmaz",0,0,0,0,0,0
0,2,1,0,0,1,1,0,0,"09",1,1,2,2,0,0,1038158,"2024-01-16T00:00:00.000Z",23,FALSE,8,3547270,"F",23,23,"Philadelphia 76ers","Paul Reed",2,4,4,2,2,10.4
0,0,0,0,0,0,0,0,0,"00",0,0,0,0,0,0,1038158,"2024-01-16T00:00:00.000Z",23,FALSE,8,56913527,"G",23,23,"Philadelphia 76ers","Ricky Council IV",0,0,0,0,0,0
0,0,0,0,0,0,0,0,0,"00",0,0,0,0,0,0,1038158,"2024-01-16T00:00:00.000Z",23,FALSE,8,2175,"",23,23,"Philadelphia 76ers","Danuel House Jr.",0,0,0,0,0,0
0,0,0,0,0,0,0,0,0,"00",0,0,0,0,0,0,1038158,"2024-01-16T00:00:00.000Z",23,FALSE,8,3547294,"F",23,23,"Philadelphia 76ers","Kenyon Martin Jr.",0,0,0,0,0,0
0,0,0,0,0,0,0,0,0,"00",0,0,0,0,0,0,1038158,"2024-01-16T00:00:00.000Z",23,FALSE,8,56677788,"G",23,23,"Philadelphia 76ers","Terquavion Smith",0,0,0,0,0,0
0,0,0,0,0,0,0,0,0,"00",0,0,0,0,0,0,1038158,"2024-01-16T00:00:00.000Z",23,FALSE,8,28,"C",23,23,"Philadelphia 76ers","Mo Bamba",0,0,0,0,0,0
0,0,0,0,0,0,0,0,0,"00",0,0,0,0,0,0,1038158,"2024-01-16T00:00:00.000Z",23,FALSE,8,108,"F",23,23,"Philadelphia 76ers","Robert Covington",0,0,0,0,0,0
0,0,0,0,0,0,0,0,0,"00",0,0,0,0,0,0,1038158,"2024-01-16T00:00:00.000Z",23,FALSE,8,38017732,"F",15,23,"Philadelphia 76ers","Kenneth Lofton Jr.",0,0,0,0,0,0
0,0,0,0,0,0,0,0,0,"00",0,0,0,0,0,0,1038158,"2024-01-16T00:00:00.000Z",23,FALSE,8,313,"G",23,23,"Philadelphia 76ers","De'Anthony Melton",0,0,0,0,0,0
0,0,0,0,0,0,0,0,0,"00",0,0,0,0,0,0,1038158,"2024-01-16T00:00:00.000Z",23,FALSE,8,17896025,"G",23,23,"Philadelphia 76ers","Jaden Springer",0,0,0,0,0,0
0,0,5,8,4,12,6,5,4,"34",0,3,20,5,1,1,1038158,"2024-01-16T00:00:00.000Z",23,FALSE,8,375,"F",8,8,"Denver Nuggets","Michael Porter Jr.",1,25,25,20,5,28
4,0,3,1,0,11,7,6,2,"38",3,5,16,6,0,2,1038158,"2024-01-16T00:00:00.000Z",23,FALSE,8,177,"F",8,8,"Denver Nuggets","Aaron Gordon",0,22,26,20,10,27.2
3,1,8,2,0,20,11,4,3,"38",11,3,25,19,1,4,1038158,"2024-01-16T00:00:00.000Z",23,FALSE,8,246,"C",8,8,"Denver Nuggets","Nikola Jokic",2,44,47,28,22,54.3
2,0,5,7,2,13,5,1,1,"33",0,2,13,5,1,0,1038158,"2024-01-16T00:00:00.000Z",23,FALSE,8,81,"G",8,8,"Denver Nuggets","Kentavious Caldwell-Pope",1,18,20,15,7,25
10,1,2,3,1,16,7,2,2,"38",1,0,17,3,0,2,1038158,"2024-01-16T00:00:00.000Z",23,FALSE,8,335,"G",8,8,"Denver Nuggets","Jamal Murray",1,20,30,27,13,36.6
2,0,2,3,2,6,3,2,2,"20",0,0,10,2,1,1,1038158,"2024-01-16T00:00:00.000Z",23,FALSE,8,236,"G",8,8,"Denver Nuggets","Reggie Jackson",1,12,14,12,4,17.4
0,1,4,3,2,5,3,3,3,"18",0,3,11,4,0,0,1038158,"2024-01-16T00:00:00.000Z",23,FALSE,8,38017709,"G",8,8,"Denver Nuggets","Christian Braun",1,15,15,11,4,18.8
2,0,0,2,1,4,1,2,2,"11",1,0,5,1,0,0,1038158,"2024-01-16T00:00:00.000Z",23,FALSE,8,38017721,"G",8,8,"Denver Nuggets","Peyton Watson",0,6,8,7,3,9.2
0,0,1,0,0,2,2,0,0,"10",0,3,4,1,0,0,1038158,"2024-01-16T00:00:00.000Z",23,FALSE,8,250,"C",8,8,"Denver Nuggets","DeAndre Jordan",0,5,5,4,1,5.2
0,0,0,0,0,0,0,0,0,"00",0,0,0,0,0,0,1038158,"2024-01-16T00:00:00.000Z",23,FALSE,8,38017727,"G",8,8,"Denver Nuggets","Collin Gillespie",0,0,0,0,0,0
0,0,0,0,0,0,0,0,0,"00",0,0,0,0,0,0,1038158,"2024-01-16T00:00:00.000Z",23,FALSE,8,215,"F-G",8,8,"Denver Nuggets","Justin Holiday",0,0,0,0,0,0
0,0,0,0,0,0,0,0,0,"00",0,0,0,0,0,0,1038158,"2024-01-16T00:00:00.000Z",23,FALSE,8,17896103,"F-C",8,8,"Denver Nuggets","Jay Huff",0,0,0,0,0,0
0,0,0,0,0,0,0,0,0,"00",0,0,0,0,0,0,1038158,"2024-01-16T00:00:00.000Z",23,FALSE,8,17896007,"G",8,8,"Denver Nuggets","Braxton Key",0,0,0,0,0,0
0,0,0,0,0,0,0,0,0,"00",0,0,0,0,0,0,1038158,"2024-01-16T00:00:00.000Z",23,FALSE,8,3547268,"F-C",8,8,"Denver Nuggets","Zeke Nnaji",0,0,0,0,0,0
0,0,0,0,0,0,0,0,0,"00",0,0,0,0,0,0,1038158,"2024-01-16T00:00:00.000Z",23,FALSE,8,666489,"F",8,8,"Denver Nuggets","Vlatko Cancar",0,0,0,0,0,0
0,0,0,0,0,0,0,0,0,"00",0,0,0,0,0,0,1038158,"2024-01-16T00:00:00.000Z",23,FALSE,8,56677871,"F",8,8,"Denver Nuggets","Hunter Tyson",0,0,0,0,0,0
1,0,4,4,2,26,14,0,0,"36",4,1,30,8,0,2,1038170,"2024-01-17T00:00:00.000Z",25,FALSE,3,182,"F",25,25,"Portland Trail Blazers","Jerami Grant",0,38,39,31,9,39.1
0,0,6,1,1,4,1,2,1,"30",0,2,4,6,1,0,1038170,"2024-01-17T00:00:00.000Z",25,FALSE,3,38017711,"F",25,25,"Portland Trail Blazers","Jabari Walker",1,10,10,4,6,14.2
3,0,5,4,2,9,7,1,1,"25",2,4,17,7,0,1,1038170,"2024-01-17T00:00:00.000Z",25,FALSE,3,56783340,"C",25,25,"Portland Trail Blazers","Duop Reath",0,24,27,20,10,28.9
4,0,4,7,1,20,8,4,3,"39",0,2,20,4,0,0,1038170,"2024-01-17T00:00:00.000Z",25,FALSE,3,419,"G",25,25,"Portland Trail Blazers","Anfernee Simons",0,24,28,24,8,30.8
6,0,5,6,2,12,6,2,2,"30",0,2,16,5,1,0,1038170,"2024-01-17T00:00:00.000Z",25,FALSE,3,65,"G",25,25,"Portland Trail Blazers","Malcolm Brogdon",1,21,27,22,11,34
0,0,0,0,0,0,0,0,0,"00",0,0,0,0,0,0,1038170,"2024-01-17T00:00:00.000Z",25,FALSE,3,22,"C",25,25,"Portland Trail Blazers","Deandre Ayton",0,0,0,0,0,0
0,2,1,0,0,1,1,0,0,"13",1,0,2,2,0,0,1038170,"2024-01-17T00:00:00.000Z",25,FALSE,3,39613724,"C",25,25,"Portland Trail Blazers","Ibou Badji",2,4,4,2,2,10.4
1,0,4,0,0,4,3,0,0,"20",2,2,6,6,0,0,1038170,"2024-01-17T00:00:00.000Z",25,FALSE,3,56677850,"F",25,25,"Portland Trail Blazers","Toumani Camara",0,12,13,7,7,14.7
3,0,2,2,0,6,1,5,5,"23",1,0,7,3,0,5,1038170,"2024-01-17T00:00:00.000Z",25,FALSE,3,56677747,"G",25,25,"Portland Trail Blazers","Scoot Henderson",0,10,13,10,6,10.1
0,0,0,0,0,0,0,0,0,"00",0,0,0,0,0,0,1038170,"2024-01-17T00:00:00.000Z",25,FALSE,3,47957121,"F",25,25,"Portland Trail Blazers","Justin Minaya",0,0,0,0,0,0
0,0,0,0,0,0,0,0,0,"03",0,0,0,0,0,1,1038170,"2024-01-17T00:00:00.000Z",25,FALSE,3,56677791,"F",25,25,"Portland Trail Blazers","Kris Murray",0,0,0,0,0,-1
0,0,0,0,0,0,0,0,0,"00",0,0,0,0,0,0,1038170,"2024-01-17T00:00:00.000Z",25,FALSE,3,56677829,"G-F",25,25,"Portland Trail Blazers","Rayan Rupert",0,0,0,0,0,0
3,0,0,3,1,4,1,0,0,"21",0,3,3,0,0,0,1038170,"2024-01-17T00:00:00.000Z",25,FALSE,3,666923,"G-F",25,25,"Portland Trail Blazers","Matisse Thybulle",0,3,6,6,3,7.5
0,0,0,0,0,0,0,0,0,"00",0,0,0,0,0,0,1038170,"2024-01-17T00:00:00.000Z",25,FALSE,3,666476,"C",25,25,"Portland Trail Blazers","Moses Brown",0,0,0,0,0,0
0,0,0,0,0,0,0,0,0,"00",0,0,0,0,0,0,1038170,"2024-01-17T00:00:00.000Z",25,FALSE,3,38017690,"G",25,25,"Portland Trail Blazers","Shaedon Sharpe",0,0,0,0,0,0
0,0,0,0,0,0,0,0,0,"00",0,0,0,0,0,0,1038170,"2024-01-17T00:00:00.000Z",25,FALSE,3,476,"C-F",25,25,"Portland Trail Blazers","Robert Williams III",0,0,0,0,0,0
5,1,2,3,1,9,6,0,0,"27",1,1,13,3,0,0,1038170,"2024-01-17T00:00:00.000Z",25,FALSE,3,666679,"F",3,3,"Brooklyn Nets","Cameron Johnson",1,16,21,18,8,27.1
1,0,4,4,1,5,2,2,2,"32",1,1,7,5,2,1,1038170,"2024-01-17T00:00:00.000Z",25,FALSE,3,158,"F",3,3,"Brooklyn Nets","Dorian Finney-Smith",2,12,13,8,6,19.5
0,1,10,0,0,5,4,10,4,"32",2,3,12,12,3,1,1038170,"2024-01-17T00:00:00.000Z",25,FALSE,3,666508,"F-C",3,3,"Brooklyn Nets","Nicolas Claxton",4,24,24,12,12,37.4
4,1,4,9,3,18,7,6,4,"34",0,4,21,4,0,1,1038170,"2024-01-17T00:00:00.000Z",25,FALSE,3,61,"F",3,3,"Brooklyn Nets","Mikal Bridges",1,25,29,25,8,33.8
0,0,0,0,0,0,0,0,0,"00",0,0,0,0,0,0,1038170,"2024-01-17T00:00:00.000Z",25,FALSE,3,56677841,"F",3,3,"Brooklyn Nets","Dariq Whitehead",0,0,0,0,0,0
0,0,0,0,0,0,0,0,0,"00",0,0,0,0,0,0,1038170,"2024-01-17T00:00:00.000Z",25,FALSE,3,56677722,"F",3,3,"Brooklyn Nets","Jalen Wilson",0,0,0,0,0,0
7,0,2,4,3,8,5,7,6,"32",0,2,19,2,1,1,1038170,"2024-01-17T00:00:00.000Z",25,FALSE,3,130,"G",3,3,"Brooklyn Nets","Spencer Dinwiddie",1,21,28,26,9,33.9
0,0,0,0,0,0,0,0,0,"00",0,0,0,0,0,0,1038170,"2024-01-17T00:00:00.000Z",25,FALSE,3,174,"F-C",3,3,"Brooklyn Nets","Harry Giles III",0,0,0,0,0,0
3,0,3,3,0,4,1,0,0,"20",0,1,2,3,0,2,1038170,"2024-01-17T00:00:00.000Z",25,FALSE,3,351,"F",3,3,"Brooklyn Nets","Royce O'Neale",0,5,8,5,6,8.1
0,0,0,0,0,0,0,0,0,"00",0,0,0,0,0,0,1038170,"2024-01-17T00:00:00.000Z",25,FALSE,3,17896038,"C",3,3,"Brooklyn Nets","Day'Ron Sharpe",0,0,0,0,0,0
2,0,1,1,0,4,1,0,0,"14",2,1,2,3,2,1,1038170,"2024-01-17T00:00:00.000Z",25,FALSE,3,421,"G",3,3,"Brooklyn Nets","Dennis Smith Jr.",2,5,7,4,5,13.6
4,0,0,4,2,7,2,2,2,"22",0,0,8,0,0,1,1038170,"2024-01-17T00:00:00.000Z",25,FALSE,3,17896048,"G",3,3,"Brooklyn Nets","Cam Thomas",0,8,12,12,4,13
0,0,1,7,3,10,5,0,0,"19",0,0,13,1,1,1,1038170,"2024-01-17T00:00:00.000Z",25,FALSE,3,464,"G",3,3,"Brooklyn Nets","Lonnie Walker IV",1,14,14,13,1,16.2
2,0,0,3,2,3,2,0,0,"08",0,1,6,0,0,1,1038170,"2024-01-17T00:00:00.000Z",25,FALSE,3,17896058,"F",3,3,"Brooklyn Nets","Trendon Watford",0,6,8,8,2,8
0,0,0,0,0,0,0,0,0,"00",0,0,0,0,0,0,1038170,"2024-01-17T00:00:00.000Z",25,FALSE,3,56677843,"F",3,3,"Brooklyn Nets","Noah Clowney",0,0,0,0,0,0
0,0,0,0,0,0,0,0,0,"00",0,0,0,0,0,0,1038170,"2024-01-17T00:00:00.000Z",25,FALSE,3,17896041,"G",3,3,"Brooklyn Nets","Keon Johnson",0,0,0,0,0,0
0,0,0,0,0,0,0,0,0,"00",0,0,0,0,0,0,1038170,"2024-01-17T00:00:00.000Z",25,FALSE,3,417,"G-F",3,3,"Brooklyn Nets","Ben Simmons",0,0,0,0,0,0
3,1,5,7,3,13,7,4,3,"32",0,2,20,5,0,1,1038161,"2024-01-17T00:00:00.000Z",9,FALSE,18,54,"F",9,9,"Detroit Pistons","Bojan Bogdanovic",1,25,28,23,8,32.5
2,3,3,5,2,9,4,2,2,"25",1,0,12,4,1,2,1038161,"2024-01-17T00:00:00.000Z",9,FALSE,18,3547267,"F-C",9,9,"Detroit Pistons","Isaiah Stewart",4,16,18,14,6,29.8
3,0,9,0,0,14,8,1,0,"31",2,4,16,11,0,2,1038161,"2024-01-17T00:00:00.000Z",9,FALSE,18,38017694,"C",9,9,"Detroit Pistons","Jalen Duren",0,27,30,19,14,31.7
6,0,4,6,4,22,13,2,2,"36",0,4,32,4,1,2,1038161,"2024-01-17T00:00:00.000Z",9,FALSE,18,38017682,"G",9,9,"Detroit Pistons","Jaden Ivey",1,36,42,38,10,46.8
8,0,1,0,0,4,4,0,0,"26",0,3,8,1,0,0,1038161,"2024-01-17T00:00:00.000Z",9,FALSE,18,3547241,"G",9,9,"Detroit Pistons","Killian Hayes",0,9,17,16,9,21.2
1,1,6,2,0,6,3,5,1,"22",3,0,7,9,0,0,1038161,"2024-01-17T00:00:00.000Z",9,FALSE,18,56677826,"G-F",9,9,"Detroit Pistons","Ausar Thompson",1,16,17,8,10,22.3
0,0,0,0,0,0,0,0,0,"00",0,0,0,0,0,0,1038161,"2024-01-17T00:00:00.000Z",9,FALSE,18,56677782,"F",18,18,"Minnesota Timberwolves","Leonard Miller",0,0,0,0,0,0
0,0,0,0,0,0,0,0,0,"00",0,0,0,0,0,0,1038161,"2024-01-17T00:00:00.000Z",9,FALSE,18,38017715,"F",18,18,"Minnesota Timberwolves","Josh Minott",0,0,0,0,0,0
0,0,0,0,0,0,0,0,0,"00",0,0,0,0,0,0,1038161,"2024-01-17T00:00:00.000Z",9,FALSE,18,17895968,"F",18,18,"Minnesota Timberwolves","Daishen Nix",0,0,0,0,0,0
1,0,0,4,1,10,3,5,5,"20",1,1,12,1,2,0,1038161,"2024-01-17T00:00:00.000Z",9,FALSE,18,77,"G",9,9,"Detroit Pistons","Alec Burks",2,13,14,13,2,20.7
2,0,1,2,1,3,2,0,0,"21",0,2,5,1,0,1,1038161,"2024-01-17T00:00:00.000Z",9,FALSE,18,259,"F",9,9,"Detroit Pistons","Kevin Knox",0,6,8,7,3,8.2
2,0,1,2,1,4,2,0,0,"12",0,2,5,1,0,4,1038161,"2024-01-17T00:00:00.000Z",9,FALSE,18,56677792,"G",9,9,"Detroit Pistons","Marcus Sasser",0,6,8,7,3,5.2
2,2,2,3,0,4,0,0,0,"15",1,0,0,3,0,0,1038161,"2024-01-17T00:00:00.000Z",9,FALSE,18,337,"F-C",30,9,"Detroit Pistons","Mike Muscala",2,3,5,2,5,12.6
0,0,0,0,0,0,0,0,0,"00",0,0,0,0,0,0,1038161,"2024-01-17T00:00:00.000Z",9,FALSE,18,167,"F",30,9,"Detroit Pistons","Danilo Gallinari",0,0,0,0,0,0
0,0,0,0,0,0,0,0,0,"00",0,0,0,0,0,0,1038161,"2024-01-17T00:00:00.000Z",9,FALSE,18,197,"F-G",9,9,"Detroit Pistons","Joe Harris",0,0,0,0,0,0
0,0,0,0,0,0,0,0,0,"00",0,0,0,0,0,0,1038161,"2024-01-17T00:00:00.000Z",9,FALSE,18,44477024,"G",9,9,"Detroit Pistons","Stanley Umude",0,0,0,0,0,0
0,0,0,0,0,0,0,0,0,"00",0,0,0,0,0,0,1038161,"2024-01-17T00:00:00.000Z",9,FALSE,18,3547240,"C",9,9,"Detroit Pistons","James Wiseman",0,0,0,0,0,0
0,0,0,0,0,0,0,0,0,"00",0,0,0,0,0,0,1038161,"2024-01-17T00:00:00.000Z",9,FALSE,18,56677729,"G",9,9,"Detroit Pistons","Malcolm Cazalon",0,0,0,0,0,0
0,0,0,0,0,0,0,0,0,"00",0,0,0,0,0,0,1038161,"2024-01-17T00:00:00.000Z",9,FALSE,18,17896075,"G-F",9,9,"Detroit Pistons","Cade Cunningham",0,0,0,0,0,0
0,0,2,0,0,1,0,2,0,"08",0,1,0,2,0,0,1038161,"2024-01-17T00:00:00.000Z",9,FALSE,18,666767,"G",18,18,"Minnesota Timberwolves","Jordan McLaughlin",0,2,2,0,2,2.4
0,0,0,0,0,0,0,0,0,"01",0,0,0,0,0,0,1038161,"2024-01-17T00:00:00.000Z",9,FALSE,18,68,"F",18,18,"Minnesota Timberwolves","Troy Brown Jr.",0,0,0,0,0,0
0,0,0,0,0,0,0,0,0,"00",0,0,0,0,0,0,1038161,"2024-01-17T00:00:00.000Z",9,FALSE,18,17896056,"C",18,18,"Minnesota Timberwolves","Luka Garza",0,0,0,0,0,0
0,0,0,0,0,0,0,0,0,"01",0,0,0,0,0,0,1038161,"2024-01-17T00:00:00.000Z",9,FALSE,18,320,"G",18,18,"Minnesota Timberwolves","Shake Milton",0,0,0,0,0,0
0,0,0,0,0,0,0,0,0,"00",0,0,0,0,0,0,1038161,"2024-01-17T00:00:00.000Z",9,FALSE,18,38017700,"G",18,18,"Minnesota Timberwolves","Wendell Moore Jr.",0,0,0,0,0,0
4,0,4,5,5,17,10,2,2,"31",2,2,27,6,0,1,1038161,"2024-01-17T00:00:00.000Z",9,FALSE,18,447,"C",18,18,"Minnesota Timberwolves","Karl-Anthony Towns",0,33,37,31,10,39.2
2,1,11,0,0,11,8,4,3,"38",5,4,19,16,0,1,1038161,"2024-01-17T00:00:00.000Z",9,FALSE,18,176,"C",18,18,"Minnesota Timberwolves","Rudy Gobert",1,35,37,21,18,43.2
8,0,5,8,3,24,10,4,4,"34",0,3,27,5,0,3,1038161,"2024-01-17T00:00:00.000Z",9,FALSE,18,3547238,"G",18,18,"Minnesota Timberwolves","Anthony Edwards",0,32,40,35,13,42
7,1,3,6,2,8,3,1,0,"29",0,0,8,3,1,1,1038161,"2024-01-17T00:00:00.000Z",9,FALSE,18,104,"G",18,18,"Minnesota Timberwolves","Mike Conley",2,11,18,15,10,27.1
9,2,3,0,0,6,2,0,0,"22",0,2,4,3,1,1,1038161,"2024-01-17T00:00:00.000Z",9,FALSE,18,12,"F",18,18,"Minnesota Timberwolves","Kyle Anderson",3,7,16,13,12,29.1
1,0,4,4,1,9,3,4,2,"23",0,0,9,4,3,1,1038161,"2024-01-17T00:00:00.000Z",9,FALSE,18,667378,"F-C",18,18,"Minnesota Timberwolves","Naz Reid",3,13,14,10,5,23.3
1,1,1,3,1,6,3,0,0,"23",0,2,7,1,1,0,1038161,"2024-01-17T00:00:00.000Z",9,FALSE,18,666400,"G",18,18,"Minnesota Timberwolves","Nickeil Alexander-Walker",2,8,9,8,2,15.7
0,0,0,0,0,0,0,0,0,"00",0,0,0,0,0,0,1038161,"2024-01-17T00:00:00.000Z",9,FALSE,18,56677851,"G",18,18,"Minnesota Timberwolves","Jaylen Clark",0,0,0,0,0,0
0,0,0,0,0,0,0,0,0,"00",0,0,0,0,0,0,1038161,"2024-01-17T00:00:00.000Z",9,FALSE,18,330,"G",9,9,"Detroit Pistons","Monte Morris",0,0,0,0,0,0
0,0,0,0,0,0,0,0,0,"00",0,0,0,0,0,0,1038161,"2024-01-17T00:00:00.000Z",9,FALSE,18,42097199,"G",9,9,"Detroit Pistons","Jared Rhoden",0,0,0,0,0,0
0,0,1,4,3,11,8,4,4,"30",1,0,23,2,1,0,1038161,"2024-01-17T00:00:00.000Z",9,FALSE,18,3547259,"F",18,18,"Minnesota Timberwolves","Jaden McDaniels",1,25,25,23,2,28.4
0,0,2,5,1,7,1,4,4,"35",2,2,7,4,0,0,1038162,"2024-01-17T00:00:00.000Z",1,FALSE,22,3547256,"F",1,1,"Atlanta Hawks","Saddiq Bey",0,11,11,7,4,11.8
3,0,9,2,1,9,3,5,3,"38",0,3,10,9,2,4,1038162,"2024-01-17T00:00:00.000Z",1,FALSE,22,17896040,"F",1,1,"Atlanta Hawks","Jalen Johnson",2,19,22,13,12,27.3
0,0,3,0,0,6,6,0,0,"27",0,3,12,3,1,1,1038162,"2024-01-17T00:00:00.000Z",1,FALSE,22,83,"C",1,1,"Atlanta Hawks","Clint Capela",1,15,15,12,3,17.6
5,0,4,4,1,18,11,3,3,"36",1,1,26,5,2,5,1038162,"2024-01-17T00:00:00.000Z",1,FALSE,22,334,"G",1,1,"Atlanta Hawks","Dejounte Murray",2,31,36,31,10,40.5
12,0,2,6,1,14,5,7,7,"39",1,3,18,3,1,8,1038162,"2024-01-17T00:00:00.000Z",1,FALSE,22,490,"G",1,1,"Atlanta Hawks","Trae Young",1,21,33,30,15,34.6
1,1,3,4,2,7,4,2,2,"24",1,1,12,4,1,1,1038162,"2024-01-17T00:00:00.000Z",1,FALSE,22,53,"G",1,1,"Atlanta Hawks","Bogdan Bogdanovic",2,16,17,13,5,23.3
0,1,6,1,0,12,7,1,1,"27",3,3,15,9,0,2,1038162,"2024-01-17T00:00:00.000Z",1,FALSE,22,3547244,"F-C",1,1,"Atlanta Hawks","Onyeka Okongwu",1,24,24,15,9,26.8
0,0,2,3,2,3,2,0,0,"14",2,1,6,4,1,2,1038162,"2024-01-17T00:00:00.000Z",1,FALSE,22,666754,"G",1,1,"Atlanta Hawks","Garrison Mathews",1,10,10,6,4,11.8
0,0,0,0,0,0,0,0,0,"00",0,0,0,0,0,0,1038162,"2024-01-17T00:00:00.000Z",1,FALSE,22,666564,"F",1,1,"Atlanta Hawks","Bruno Fernando",0,0,0,0,0,0
0,0,0,0,0,0,0,0,0,"00",0,0,0,0,0,0,1038162,"2024-01-17T00:00:00.000Z",1,FALSE,22,3547297,"G",1,1,"Atlanta Hawks","Trent Forrest",0,0,0,0,0,0
1,1,4,4,0,9,3,0,0,"30",3,1,6,7,3,1,1038162,"2024-01-17T00:00:00.000Z",1,FALSE,22,666818,"F",22,22,"Orlando Magic","Chuma Okeke",4,13,14,7,8,26.9
1,0,2,3,3,7,6,2,1,"27",2,3,16,4,0,2,1038162,"2024-01-17T00:00:00.000Z",1,FALSE,22,17896073,"G",22,22,"Orlando Magic","Jalen Suggs",0,20,21,17,5,20.3
3,0,4,5,1,5,1,0,0,"20",0,4,3,4,1,3,1038162,"2024-01-17T00:00:00.000Z",1,FALSE,22,226,"F",22,22,"Orlando Magic","Joe Ingles",1,7,10,6,7,12.3
1,0,3,0,0,8,5,0,0,"30",1,5,10,4,3,4,1038162,"2024-01-17T00:00:00.000Z",1,FALSE,22,165,"G",22,22,"Orlando Magic","Markelle Fultz",3,14,15,11,5,21.3
2,1,3,4,3,7,6,4,3,"24",2,1,18,5,2,0,1038162,"2024-01-17T00:00:00.000Z",1,FALSE,22,85,"F",22,22,"Orlando Magic","Wendell Carter Jr.",3,23,25,20,7,36
1,3,1,6,1,10,3,4,3,"22",0,1,10,1,1,1,1038162,"2024-01-17T00:00:00.000Z",1,FALSE,22,3547251,"G",22,22,"Orlando Magic","Cole Anthony",4,11,12,11,2,23.7
0,0,0,0,0,0,0,0,0,"01",0,0,0,0,0,0,1038162,"2024-01-17T00:00:00.000Z",1,FALSE,22,56677827,"G",22,22,"Orlando Magic","Anthony Black",0,0,0,0,0,0
2,0,0,0,0,2,1,0,0,"10",0,0,2,0,2,0,1038162,"2024-01-17T00:00:00.000Z",1,FALSE,22,229,"F",22,22,"Orlando Magic","Jonathan Isaac",2,2,4,4,2,11
0,0,0,0,0,0,0,0,0,"00",0,0,0,0,0,0,1038162,"2024-01-17T00:00:00.000Z",1,FALSE,22,17553983,"G",22,22,"Orlando Magic","Trevelin Queen",0,0,0,0,0,0
0,0,0,0,0,0,0,0,0,"00",0,0,0,0,0,0,1038162,"2024-01-17T00:00:00.000Z",1,FALSE,22,462,"C",22,22,"Orlando Magic","Moritz Wagner",0,0,0,0,0,0
0,0,0,0,0,0,0,0,0,"00",0,0,0,0,0,0,1038162,"2024-01-17T00:00:00.000Z",1,FALSE,22,196,"G",22,22,"Orlando Magic","Gary Harris",0,0,0,0,0,0
0,0,0,0,0,0,0,0,0,"00",0,0,0,0,0,0,1038162,"2024-01-17T00:00:00.000Z",1,FALSE,22,38017607,"G",22,22,"Orlando Magic","Kevon Harris",0,0,0,0,0,0
0,0,0,0,0,0,0,0,0,"00",0,0,0,0,0,0,1038162,"2024-01-17T00:00:00.000Z",1,FALSE,22,56677839,"G",22,22,"Orlando Magic","Jett Howard",0,0,0,0,0,0
0,0,0,0,0,0,0,0,0,"00",0,0,0,0,0,0,1038162,"2024-01-17T00:00:00.000Z",1,FALSE,22,666885,"F",22,22,"Orlando Magic","Admiral Schofield",0,0,0,0,0,0
0,0,0,0,0,0,0,0,0,"00",0,0,0,0,0,0,1038162,"2024-01-17T00:00:00.000Z",1,FALSE,22,56677855,"G",1,1,"Atlanta Hawks","Seth Lundy",0,0,0,0,0,0
0,0,0,0,0,0,0,0,0,"00",0,0,0,0,0,0,1038162,"2024-01-17T00:00:00.000Z",1,FALSE,22,319,"G",1,1,"Atlanta Hawks","Patty Mills",0,0,0,0,0,0
0,0,0,0,0,0,0,0,0,"00",0,0,0,0,0,0,1038162,"2024-01-17T00:00:00.000Z",1,FALSE,22,56677838,"G",1,1,"Atlanta Hawks","Kobe Bufkin",0,0,0,0,0,0
0,0,0,0,0,0,0,0,0,"00",0,0,0,0,0,0,1038162,"2024-01-17T00:00:00.000Z",1,FALSE,22,56677806,"F",1,1,"Atlanta Hawks","Mouhamed Gueye",0,0,0,0,0,0
0,0,0,0,0,0,0,0,0,"00",0,0,0,0,0,0,1038162,"2024-01-17T00:00:00.000Z",1,FALSE,22,666656,"F",1,1,"Atlanta Hawks","De'Andre Hunter",0,0,0,0,0,0
0,0,0,0,0,0,0,0,0,"00",0,0,0,0,0,0,1038162,"2024-01-17T00:00:00.000Z",1,FALSE,22,4197387,"G",1,1,"Atlanta Hawks","Vit Krejci",0,0,0,0,0,0
0,0,0,0,0,0,0,0,0,"00",0,0,0,0,0,0,1038162,"2024-01-17T00:00:00.000Z",1,FALSE,22,301,"G-F",1,1,"Atlanta Hawks","Wesley Matthews",0,0,0,0,0,0
0,0,0,7,1,7,1,1,0,"14",1,3,3,1,1,0,1038162,"2024-01-17T00:00:00.000Z",1,FALSE,22,38017724,"G",22,22,"Orlando Magic","Caleb Houstan",1,4,4,3,1,7.2
4,1,4,5,1,25,8,11,9,"38",0,1,26,4,2,1,1038162,"2024-01-17T00:00:00.000Z",1,FALSE,22,38017683,"F",22,22,"Orlando Magic","Paolo Banchero",3,30,34,30,8,44.8
3,2,3,1,0,8,5,0,0,"24",7,3,10,10,1,1,1038162,"2024-01-17T00:00:00.000Z",1,FALSE,22,666442,"C",22,22,"Orlando Magic","Goga Bitadze",3,20,23,13,13,34.5
0,0,0,0,0,0,0,0,0,"00",0,0,0,0,0,0,1038162,"2024-01-17T00:00:00.000Z",1,FALSE,22,17896026,"F",22,22,"Orlando Magic","Franz Wagner",0,0,0,0,0,0
0,0,0,0,0,0,0,0,0,"00",0,0,0,0,0,0,1038162,"2024-01-17T00:00:00.000Z",1,FALSE,22,38017689,"F",1,1,"Atlanta Hawks","AJ Griffin",0,0,0,0,0,0
2,0,5,8,3,21,9,5,3,"32",0,2,24,5,0,2,1038163,"2024-01-17T00:00:00.000Z",2,FALSE,27,434,"F",2,2,"Boston Celtics","Jayson Tatum",0,29,31,26,7,31
0,0,3,4,3,4,3,0,0,"25",0,2,9,3,1,0,1038163,"2024-01-17T00:00:00.000Z",2,FALSE,27,219,"C-F",2,2,"Boston Celtics","Al Horford",1,12,12,9,3,15.6
0,0,0,0,0,0,0,0,0,"00",0,0,0,0,0,0,1038163,"2024-01-17T00:00:00.000Z",2,FALSE,27,17896049,"G",3,27,"San Antonio Spurs","David Duke Jr.",0,0,0,0,0,0
4,3,6,0,0,5,3,0,0,"30",3,2,6,9,1,2,1038163,"2024-01-17T00:00:00.000Z",2,FALSE,27,261,"F-C",2,2,"Boston Celtics","Luke Kornet",4,15,19,10,13,32.8
5,1,6,6,3,16,8,2,2,"31",1,2,21,7,1,3,1038163,"2024-01-17T00:00:00.000Z",2,FALSE,27,70,"G",2,2,"Boston Celtics","Jaylen Brown",2,28,33,26,12,39.9
4,0,4,7,6,14,8,0,0,"31",0,0,22,4,0,1,1038163,"2024-01-17T00:00:00.000Z",2,FALSE,27,214,"G",2,2,"Boston Celtics","Jrue Holiday",0,26,30,26,8,31.8
4,0,2,4,2,10,4,2,2,"27",1,2,12,3,1,0,1038163,"2024-01-17T00:00:00.000Z",2,FALSE,27,3547276,"G",2,2,"Boston Celtics","Payton Pritchard",1,15,19,16,7,24.6
1,0,3,1,0,5,2,4,3,"13",1,0,7,4,0,1,1038163,"2024-01-17T00:00:00.000Z",2,FALSE,27,666468,"F",2,2,"Boston Celtics","Oshae Brissett",0,11,12,8,5,12.3
2,0,4,4,1,6,3,0,0,"20",0,0,7,4,0,2,1038163,"2024-01-17T00:00:00.000Z",2,FALSE,27,17896060,"F",2,2,"Boston Celtics","Sam Hauser",0,11,13,9,6,12.8
0,0,1,1,0,2,0,2,1,"04",1,0,1,2,0,0,1038163,"2024-01-17T00:00:00.000Z",2,FALSE,27,17896094,"G",2,2,"Boston Celtics","Dalano Banton",0,3,3,1,2,3.4
0,0,0,0,0,0,0,2,2,"03",1,0,2,1,0,0,1038163,"2024-01-17T00:00:00.000Z",2,FALSE,27,38017707,"G",2,2,"Boston Celtics","JD Davison",0,3,3,2,1,3.2
0,0,0,2,0,2,0,0,0,"04",0,0,0,0,0,0,1038163,"2024-01-17T00:00:00.000Z",2,FALSE,27,338,"G",2,2,"Boston Celtics","Svi Mykhailiuk",0,0,0,0,0,0
0,2,4,0,0,4,2,2,2,"12",4,5,6,8,0,0,1038163,"2024-01-17T00:00:00.000Z",2,FALSE,27,17553967,"C",2,2,"Boston Celtics","Neemias Queta",2,14,14,6,8,21.6
0,0,0,0,0,0,0,0,0,"05",0,0,0,0,1,1,1038163,"2024-01-17T00:00:00.000Z",2,FALSE,27,3547279,"F",2,2,"Boston Celtics","Lamar Stevens",1,0,0,0,0,2
0,0,4,1,0,1,0,0,0,"03",0,0,0,4,0,0,1038163,"2024-01-17T00:00:00.000Z",2,FALSE,27,56677864,"G",2,2,"Boston Celtics","Jordan Walsh",0,4,4,0,4,4.8
0,0,0,0,0,0,0,0,0,"00",0,0,0,0,0,0,1038163,"2024-01-17T00:00:00.000Z",2,FALSE,27,NA,NA,NA,2,"Boston Celtics","NA NA",0,0,0,0,0,0
0,0,0,0,0,0,0,0,0,"00",0,0,0,0,0,0,1038163,"2024-01-17T00:00:00.000Z",2,FALSE,27,378,"F-C",2,2,"Boston Celtics","Kristaps Porzingis",0,0,0,0,0,0
0,0,0,0,0,0,0,0,0,"00",0,0,0,0,0,0,1038163,"2024-01-17T00:00:00.000Z",2,FALSE,27,473,"G",2,2,"Boston Celtics","Derrick White",0,0,0,0,0,0
0,0,4,2,1,8,4,0,0,"17",1,1,9,5,0,1,1038163,"2024-01-17T00:00:00.000Z",2,FALSE,27,38017649,"F",27,27,"San Antonio Spurs","Julian Champagnie",0,14,14,9,5,14
4,1,4,4,1,9,2,0,0,"31",3,2,5,7,3,0,1038163,"2024-01-17T00:00:00.000Z",2,FALSE,27,38017699,"F",27,27,"San Antonio Spurs","Jeremy Sochan",4,12,16,9,11,31.4
1,1,3,6,2,19,10,6,5,"27",2,2,27,5,0,5,1038163,"2024-01-17T00:00:00.000Z",2,FALSE,27,56677822,"F-C",27,27,"San Antonio Spurs","Victor Wembanyama",1,32,33,28,6,32.5
3,0,2,5,0,15,7,8,7,"32",0,1,21,2,1,1,1038163,"2024-01-17T00:00:00.000Z",2,FALSE,27,3547246,"G-F",27,27,"San Antonio Spurs","Devin Vassell",1,23,26,24,5,29.9
10,0,4,5,1,9,4,0,0,"27",0,2,9,4,0,2,1038163,"2024-01-17T00:00:00.000Z",2,FALSE,27,3547274,"G",27,27,"San Antonio Spurs","Tre Jones",0,13,23,19,14,26.8
2,0,2,2,1,4,2,0,0,"23",0,1,5,2,1,0,1038163,"2024-01-17T00:00:00.000Z",2,FALSE,27,666682,"F",27,27,"San Antonio Spurs","Keldon Johnson",1,7,9,7,4,13.4
0,0,2,2,1,6,2,0,0,"21",2,1,5,4,0,0,1038163,"2024-01-17T00:00:00.000Z",2,FALSE,27,38017730,"F",27,27,"San Antonio Spurs","Dominick Barlow",0,9,9,5,4,9.8
1,0,1,3,0,9,4,0,0,"16",0,0,8,1,0,0,1038163,"2024-01-17T00:00:00.000Z",2,FALSE,27,38017692,"F",27,27,"San Antonio Spurs","Malaki Branham",0,9,10,9,2,10.7
1,1,1,0,0,2,1,2,1,"05",1,1,3,2,0,0,1038163,"2024-01-17T00:00:00.000Z",2,FALSE,27,3547163,"F",6,27,"San Antonio Spurs","Mamadi Diakite",1,5,6,4,3,9.9
0,0,1,2,0,2,0,0,0,"05",0,0,0,1,0,0,1038163,"2024-01-17T00:00:00.000Z",2,FALSE,27,180,"G",27,27,"San Antonio Spurs","Devonte' Graham",0,1,1,0,1,1.2
0,0,2,1,0,2,1,0,0,"05",0,0,2,2,0,0,1038163,"2024-01-17T00:00:00.000Z",2,FALSE,27,17896059,"F",27,27,"San Antonio Spurs","Sandro Mamukelashvili",0,4,4,2,2,4.4
1,0,0,2,0,4,1,0,0,"12",0,1,2,0,0,0,1038163,"2024-01-17T00:00:00.000Z",2,FALSE,27,305,"F",27,27,"San Antonio Spurs","Doug McDermott",0,2,3,3,1,3.5
1,0,3,0,0,2,1,0,0,"12",2,2,2,5,0,0,1038163,"2024-01-17T00:00:00.000Z",2,FALSE,27,359,"F",27,27,"San Antonio Spurs","Cedi Osman",0,7,8,3,6,9.5
2,0,1,0,0,2,0,0,0,"07",0,1,0,1,0,1,1038163,"2024-01-17T00:00:00.000Z",2,FALSE,27,38017693,"G",27,27,"San Antonio Spurs","Blake Wesley",0,1,3,2,3,3.2
0,0,0,0,0,0,0,0,0,"00",0,0,0,0,0,0,1038163,"2024-01-17T00:00:00.000Z",2,FALSE,27,17895854,"G",27,27,"San Antonio Spurs","Charles Bassey",0,0,0,0,0,0
0,0,0,0,0,0,0,0,0,"00",0,0,0,0,0,0,1038163,"2024-01-17T00:00:00.000Z",2,FALSE,27,56677817,"G",27,27,"San Antonio Spurs","Sidy Cissoko",0,0,0,0,0,0
0,0,0,0,0,0,0,0,0,"00",0,0,0,0,0,0,1038163,"2024-01-17T00:00:00.000Z",2,FALSE,27,102,"F-C",27,27,"San Antonio Spurs","Zach Collins",0,0,0,0,0,0
7,1,2,0,0,7,5,1,0,"26",1,2,10,3,1,0,1038164,"2024-01-17T00:00:00.000Z",6,FALSE,17,3547247,"F-G",6,6,"Cleveland Cavaliers","Isaac Okoro",2,13,20,17,10,30.1
1,0,0,5,2,9,5,1,1,"13",0,0,13,0,1,0,1038164,"2024-01-17T00:00:00.000Z",6,FALSE,17,368,"G",17,17,"Milwaukee Bucks","Cameron Payne",1,13,14,14,1,17.5
3,0,4,4,1,11,6,4,3,"21",2,0,16,6,1,1,1038164,"2024-01-17T00:00:00.000Z",6,FALSE,17,377,"F",17,17,"Milwaukee Bucks","Bobby Portis",1,22,25,19,9,29.7
0,0,0,0,0,0,0,0,0,"00",0,0,0,0,0,0,1038164,"2024-01-17T00:00:00.000Z",6,FALSE,17,15,"F",17,17,"Milwaukee Bucks","Giannis Antetokounmpo",0,0,0,0,0,0
0,0,0,0,0,0,0,0,0,"00",0,0,0,0,0,0,1038164,"2024-01-17T00:00:00.000Z",6,FALSE,17,38017691,"G",17,17,"Milwaukee Bucks","TyTy Washington Jr.",0,0,0,0,0,0
7,0,4,8,4,19,12,4,3,"26",1,1,31,5,3,1,1038164,"2024-01-17T00:00:00.000Z",6,FALSE,17,322,"G",6,6,"Cleveland Cavaliers","Donovan Mitchell",3,36,43,38,12,55.5
4,0,2,2,0,7,1,3,2,"21",1,1,4,3,0,2,1038164,"2024-01-17T00:00:00.000Z",6,FALSE,17,277,"G",6,6,"Cleveland Cavaliers","Caris LeVert",0,7,11,8,7,11.6
5,0,2,6,2,8,4,0,0,"22",3,1,10,5,0,0,1038164,"2024-01-17T00:00:00.000Z",6,FALSE,17,3547299,"G",6,6,"Cleveland Cavaliers","Sam Merrill",0,15,20,15,10,23.5
3,0,7,0,0,4,3,0,0,"19",2,0,6,9,0,2,1038164,"2024-01-17T00:00:00.000Z",6,FALSE,17,444,"C-F",6,6,"Cleveland Cavaliers","Tristan Thompson",0,15,18,9,12,19.3
2,0,5,6,5,14,13,3,2,"27",0,2,33,5,0,1,1038164,"2024-01-17T00:00:00.000Z",6,FALSE,17,344,"F",6,6,"Cleveland Cavaliers","Georges Niang",0,38,40,35,7,41
0,0,3,4,1,5,2,1,0,"21",0,0,5,3,1,2,1038164,"2024-01-17T00:00:00.000Z",6,FALSE,17,666940,"F",6,6,"Cleveland Cavaliers","Dean Wade",1,8,8,5,3,9.6
3,1,10,0,0,15,9,3,3,"26",3,0,21,13,0,1,1038164,"2024-01-17T00:00:00.000Z",6,FALSE,17,9,"C",6,6,"Cleveland Cavaliers","Jarrett Allen",1,34,37,24,16,43.1
3,1,6,1,0,4,2,2,2,"22",0,1,6,6,0,0,1038164,"2024-01-17T00:00:00.000Z",6,FALSE,17,666908,"G",6,6,"Cleveland Cavaliers","Max Strus",1,12,15,9,9,20.7
0,0,6,1,0,4,3,0,0,"23",2,2,6,8,0,1,1038164,"2024-01-17T00:00:00.000Z",6,FALSE,17,56677852,"G",17,17,"Milwaukee Bucks","Andre Jackson Jr.",0,14,14,6,8,14.6
0,0,0,0,0,0,0,0,0,"00",0,0,0,0,0,0,1038164,"2024-01-17T00:00:00.000Z",6,FALSE,17,666676,"G",6,6,"Cleveland Cavaliers","Ty Jerome",0,0,0,0,0,0
0,0,1,1,0,3,0,0,0,"10",0,1,0,1,0,0,1038164,"2024-01-17T00:00:00.000Z",6,FALSE,17,248,"C",6,6,"Cleveland Cavaliers","Damian Jones",0,1,1,0,1,1.2
2,0,2,0,0,7,4,2,1,"20",0,0,9,2,0,1,1038164,"2024-01-17T00:00:00.000Z",6,FALSE,17,56677872,"G",6,6,"Cleveland Cavaliers","Craig Porter",0,11,13,11,4,13.4
0,0,0,0,0,0,0,0,0,"00",0,0,0,0,0,0,1038164,"2024-01-17T00:00:00.000Z",6,FALSE,17,56677847,"F",6,6,"Cleveland Cavaliers","Emoni Bates",0,0,0,0,0,0
0,0,0,0,0,0,0,0,0,"00",0,0,0,0,0,0,1038164,"2024-01-17T00:00:00.000Z",6,FALSE,17,666581,"G",6,6,"Cleveland Cavaliers","Darius Garland",0,0,0,0,0,0
0,0,0,0,0,0,0,0,0,"00",0,0,0,0,0,0,1038164,"2024-01-17T00:00:00.000Z",6,FALSE,17,17896076,"F-C",6,6,"Cleveland Cavaliers","Evan Mobley",0,0,0,0,0,0
1,1,1,3,2,4,3,0,0,"14",0,0,8,1,0,0,1038164,"2024-01-17T00:00:00.000Z",6,FALSE,17,105,"G",17,17,"Milwaukee Bucks","Pat Connaughton",1,9,10,9,2,13.7
2,0,2,0,0,3,0,0,0,"23",1,1,0,3,0,1,1038164,"2024-01-17T00:00:00.000Z",6,FALSE,17,38017676,"F",17,17,"Milwaukee Bucks","MarJon Beauchamp",0,3,5,2,5,5.6
0,0,1,10,4,13,5,2,1,"19",0,1,15,1,1,0,1038164,"2024-01-17T00:00:00.000Z",6,FALSE,17,112,"F",17,17,"Milwaukee Bucks","Jae Crowder",1,16,16,15,1,19.2
1,1,0,0,0,0,0,0,0,"06",0,1,0,0,0,1,1038164,"2024-01-17T00:00:00.000Z",6,FALSE,17,2148,"",17,17,"Milwaukee Bucks","Thanasis Antetokounmpo",1,0,1,1,1,3.5
1,0,1,4,1,5,1,0,0,"13",1,2,3,2,0,0,1038164,"2024-01-17T00:00:00.000Z",6,FALSE,17,38017733,"G",17,17,"Milwaukee Bucks","A.J. Green",0,5,6,4,3,6.9
0,0,1,0,0,1,0,0,0,"09",0,2,0,1,0,0,1038164,"2024-01-17T00:00:00.000Z",6,FALSE,17,56677854,"F",17,17,"Milwaukee Bucks","Chris Livingston",0,1,1,0,1,1.2
0,0,0,0,0,0,0,0,0,"00",0,0,0,0,0,0,1038164,"2024-01-17T00:00:00.000Z",6,FALSE,17,38017662,"F",6,6,"Cleveland Cavaliers","Isaiah Mobley",0,0,0,0,0,0
2,1,2,3,0,10,1,0,0,"20",0,3,2,2,0,3,1038164,"2024-01-17T00:00:00.000Z",6,FALSE,17,315,"F",17,17,"Milwaukee Bucks","Khris Middleton",1,4,6,4,4,7.4
1,3,4,3,1,7,5,0,0,"25",0,2,11,4,1,2,1038164,"2024-01-17T00:00:00.000Z",6,FALSE,17,283,"C",17,17,"Milwaukee Bucks","Brook Lopez",4,15,16,12,5,27.3
1,0,4,3,0,6,1,0,0,"22",1,3,2,5,0,0,1038164,"2024-01-17T00:00:00.000Z",6,FALSE,17,38,"G",17,17,"Milwaukee Bucks","Malik Beasley",0,7,8,3,6,9.5
5,0,1,5,1,20,7,3,2,"25",1,1,17,2,2,1,1038164,"2024-01-17T00:00:00.000Z",6,FALSE,17,278,"G",17,17,"Milwaukee Bucks","Damian Lillard",2,19,24,22,7,31.9
1,0,0,1,0,2,1,0,0,"07",1,0,2,1,0,0,1038164,"2024-01-17T00:00:00.000Z",6,FALSE,17,284,"C",17,17,"Milwaukee Bucks","Robin Lopez",0,3,4,3,2,4.7
0,0,0,0,0,0,0,0,0,"00",0,0,0,0,0,0,1038165,"2024-01-17T00:00:00.000Z",20,FALSE,11,75,"G-F",11,11,"Houston Rockets","Reggie Bullock",0,0,0,0,0,0
0,0,0,0,0,0,0,0,0,"00",0,0,0,0,0,0,1038165,"2024-01-17T00:00:00.000Z",20,FALSE,11,38017695,"F",11,11,"Houston Rockets","Tari Eason",0,0,0,0,0,0
0,0,0,0,0,0,0,0,0,"00",0,0,0,0,0,0,1038165,"2024-01-17T00:00:00.000Z",20,FALSE,11,3547281,"G-F",11,11,"Houston Rockets","Nate Hinton",0,0,0,0,0,0
0,0,0,0,0,0,0,0,0,"00",0,0,0,0,0,0,1038165,"2024-01-17T00:00:00.000Z",20,FALSE,11,357,"G",11,11,"Houston Rockets","Victor Oladipo",0,0,0,0,0,0
0,0,0,0,0,0,0,0,0,"00",0,0,0,0,0,0,1038165,"2024-01-17T00:00:00.000Z",20,FALSE,11,56677809,"F",11,11,"Houston Rockets","Jermaine Samuels Jr.",0,0,0,0,0,0
0,1,5,5,2,10,5,3,3,"43",0,2,15,5,4,1,1038165,"2024-01-17T00:00:00.000Z",20,FALSE,11,18,"F",28,20,"New York Knicks","OG Anunoby",5,20,20,15,5,35
4,1,6,8,4,18,11,6,5,"34",2,4,31,8,0,4,1038165,"2024-01-17T00:00:00.000Z",20,FALSE,11,387,"F",20,20,"New York Knicks","Julius Randle",1,39,43,35,12,45.6
5,2,9,0,0,5,3,1,1,"41",2,4,7,11,2,2,1038165,"2024-01-17T00:00:00.000Z",20,FALSE,11,201,"F-C",20,20,"New York Knicks","Isaiah Hartenstein",4,18,23,12,16,37.7
7,0,3,9,4,21,11,7,4,"37",0,2,30,3,0,2,1038165,"2024-01-17T00:00:00.000Z",20,FALSE,11,73,"G",20,20,"New York Knicks","Jalen Brunson",0,33,40,37,10,42.1
5,0,2,4,1,7,2,0,0,"19",0,1,5,2,0,2,1038165,"2024-01-17T00:00:00.000Z",20,FALSE,11,131,"G",20,20,"New York Knicks","Donte DiVincenzo",0,7,12,10,7,12.9
1,0,9,2,0,11,5,0,0,"30",4,2,10,13,0,0,1038165,"2024-01-17T00:00:00.000Z",20,FALSE,11,202,"G",20,20,"New York Knicks","Josh Hart",0,23,24,11,14,27.1
1,0,1,6,2,8,2,5,5,"17",2,1,11,3,0,0,1038165,"2024-01-17T00:00:00.000Z",20,FALSE,11,17895858,"G",20,20,"New York Knicks","Quentin Grimes",0,14,15,12,4,16.1
1,0,1,3,0,4,0,0,0,"11",0,1,0,1,0,1,1038165,"2024-01-17T00:00:00.000Z",20,FALSE,11,17896033,"G",20,20,"New York Knicks","Miles McBride",0,1,2,1,2,1.7
0,0,0,0,0,0,0,0,0,"00",0,0,0,0,0,0,1038165,"2024-01-17T00:00:00.000Z",20,FALSE,11,17896063,"F",20,20,"New York Knicks","Jericho Sims",0,0,0,0,0,0
0,0,0,0,0,0,0,0,0,"00",0,0,0,0,0,0,1038165,"2024-01-17T00:00:00.000Z",20,FALSE,11,666474,"G",20,20,"New York Knicks","Charles Brown",0,0,0,0,0,0
0,0,0,0,0,0,0,0,0,"00",0,0,0,0,0,0,1038165,"2024-01-17T00:00:00.000Z",20,FALSE,11,399,"C",20,20,"New York Knicks","Mitchell Robinson",0,0,0,0,0,0
0,0,0,0,0,0,0,0,0,"00",0,0,0,0,0,0,1038165,"2024-01-17T00:00:00.000Z",20,FALSE,11,56677795,"F",20,20,"New York Knicks","Jacob Toppin",0,0,0,0,0,0
0,0,0,0,0,0,0,0,0,"00",0,0,0,0,0,0,1038165,"2024-01-17T00:00:00.000Z",20,FALSE,11,17896089,"G",20,20,"New York Knicks","Duane Washington Jr.",0,0,0,0,0,0
0,1,1,6,1,13,4,2,2,"40",0,3,11,1,1,1,1038165,"2024-01-17T00:00:00.000Z",20,FALSE,11,66,"G-F",11,11,"Houston Rockets","Dillon Brooks",2,12,12,11,1,17.2
0,2,4,2,1,4,2,4,4,"22",1,2,9,5,0,0,1038165,"2024-01-17T00:00:00.000Z",20,FALSE,11,188,"F",11,11,"Houston Rockets","Jeff Green",2,14,14,9,5,21
1,0,1,0,0,0,0,0,0,"04",0,0,0,1,0,0,1038165,"2024-01-17T00:00:00.000Z",20,FALSE,11,213,"G",11,11,"Houston Rockets","Aaron Holiday",0,1,2,1,2,2.7
0,0,0,0,0,0,0,0,0,"00",0,0,0,0,0,0,1038165,"2024-01-17T00:00:00.000Z",20,FALSE,11,19465326,"C",11,11,"Houston Rockets","Jock Landale",0,0,0,0,0,0
0,0,0,0,0,0,0,0,0,"00",0,0,0,0,0,0,1038165,"2024-01-17T00:00:00.000Z",20,FALSE,11,296,"C",11,11,"Houston Rockets","Boban Marjanovic",0,0,0,0,0,0
0,0,0,0,0,0,0,0,0,"00",0,0,0,0,0,0,1038165,"2024-01-17T00:00:00.000Z",20,FALSE,11,47738533,"G",11,11,"Houston Rockets","Jeenathan Williams",0,0,0,0,0,0
1,0,4,2,1,9,5,0,0,"31",2,2,11,6,1,0,1038165,"2024-01-17T00:00:00.000Z",20,FALSE,11,38017684,"F",11,11,"Houston Rockets","Jabari Smith Jr.",1,17,18,12,7,22.7
5,3,7,1,0,16,7,7,4,"40",3,3,18,10,1,3,1038165,"2024-01-17T00:00:00.000Z",20,FALSE,11,17896062,"F-C",11,11,"Houston Rockets","Alperen Sengun",4,28,33,23,15,46.5
1,0,7,5,0,15,6,3,3,"29",0,2,15,7,1,5,1038165,"2024-01-17T00:00:00.000Z",20,FALSE,11,17895966,"G",11,11,"Houston Rockets","Jalen Green",1,22,23,16,8,22.9
12,0,3,12,5,19,8,3,3,"41",0,3,24,3,1,1,1038165,"2024-01-17T00:00:00.000Z",20,FALSE,11,458,"G",11,11,"Houston Rockets","Fred VanVleet",1,27,39,36,15,47.6
2,0,2,1,0,2,1,0,0,"14",0,0,2,2,0,0,1038165,"2024-01-17T00:00:00.000Z",20,FALSE,11,3547301,"F",11,11,"Houston Rockets","Jae'Sean Tate",0,4,6,4,4,7.4
0,1,3,0,0,2,0,0,0,"06",1,3,0,4,0,0,1038165,"2024-01-17T00:00:00.000Z",20,FALSE,11,3547249,"F",28,20,"New York Knicks","Precious Achiuwa",1,4,4,0,4,7.8
0,0,0,0,0,0,0,0,0,"01",0,0,0,0,0,0,1038165,"2024-01-17T00:00:00.000Z",20,FALSE,11,19,"G",20,20,"New York Knicks","Ryan Arcidiacono",0,0,0,0,0,0
0,0,0,0,0,0,0,0,0,"01",0,0,0,0,0,0,1038165,"2024-01-17T00:00:00.000Z",20,FALSE,11,3547275,"G",28,20,"New York Knicks","Malachi Flynn",0,0,0,0,0,0
0,0,0,0,0,0,0,0,0,"00",0,0,0,0,0,0,1038165,"2024-01-17T00:00:00.000Z",20,FALSE,11,160,"G-F",20,20,"New York Knicks","Evan Fournier",0,0,0,0,0,0
0,0,2,1,0,3,0,0,0,"09",0,1,0,2,0,0,1038165,"2024-01-17T00:00:00.000Z",20,FALSE,11,56677831,"F",11,11,"Houston Rockets","Cam Whitmore",0,2,2,0,2,2.4
1,2,1,0,0,3,2,0,0,"10",0,2,4,1,1,0,1038165,"2024-01-17T00:00:00.000Z",20,FALSE,11,56677825,"G-F",11,11,"Houston Rockets","Amen Thompson",3,5,6,5,2,15.7
0,0,0,0,0,0,0,0,0,"00",0,0,0,0,0,0,1038166,"2024-01-17T00:00:00.000Z",28,FALSE,16,19465585,"G",16,16,"Miami Heat","Dru Smith",0,0,0,0,0,0
3,0,5,3,1,14,9,13,7,"36",3,1,26,8,0,0,1038166,"2024-01-17T00:00:00.000Z",28,FALSE,16,666423,"F-G",20,28,"Toronto Raptors","RJ Barrett",0,34,37,29,11,40.1
8,1,3,6,1,16,9,1,1,"34",2,2,20,5,2,5,1038166,"2024-01-17T00:00:00.000Z",28,FALSE,16,17896055,"G-F",28,28,"Toronto Raptors","Scottie Barnes",3,25,33,28,13,42
2,2,2,4,2,7,2,0,0,"18",2,3,6,4,0,0,1038166,"2024-01-17T00:00:00.000Z",28,FALSE,16,2309958,"C-F",15,28,"Toronto Raptors","Jontay Porter",2,10,12,8,6,19.8
0,0,2,9,8,13,10,0,0,"31",0,1,28,2,1,0,1038166,"2024-01-17T00:00:00.000Z",28,FALSE,16,3089,"",28,28,"Toronto Raptors","Gary Trent Jr.",1,30,30,28,2,33.4
9,0,7,6,3,16,6,2,2,"30",1,1,17,8,0,2,1038166,"2024-01-17T00:00:00.000Z",28,FALSE,16,3547269,"G",20,28,"Toronto Raptors","Immanuel Quickley",0,25,34,26,17,38.1
2,0,6,0,0,6,2,2,1,"28",2,3,5,8,1,0,1038166,"2024-01-17T00:00:00.000Z",28,FALSE,16,489,"F",28,28,"Toronto Raptors","Thaddeus Young",1,13,15,7,10,20.6
6,0,1,5,3,6,3,0,0,"27",0,1,9,1,1,1,1038166,"2024-01-17T00:00:00.000Z",28,FALSE,16,409,"G",28,28,"Toronto Raptors","Dennis Schroder",1,10,16,15,7,21.2
4,0,0,2,2,2,2,0,0,"12",0,2,6,0,2,2,1038166,"2024-01-17T00:00:00.000Z",28,FALSE,16,56677828,"G",28,28,"Toronto Raptors","Gradey Dick",2,6,10,10,4,16
0,1,5,1,0,3,1,0,0,"18",2,0,2,7,0,0,1038166,"2024-01-17T00:00:00.000Z",28,FALSE,16,58,"F",28,28,"Toronto Raptors","Chris Boucher",1,9,9,2,7,13.4
0,0,0,0,0,3,1,0,0,"02",1,0,2,1,0,0,1038166,"2024-01-17T00:00:00.000Z",28,FALSE,16,56677805,"G",28,28,"Toronto Raptors","Javon Freeman-Liberty",0,3,3,2,1,3.2
0,0,0,1,0,1,0,0,0,"02",0,0,0,0,1,0,1038166,"2024-01-17T00:00:00.000Z",28,FALSE,16,666762,"F",28,28,"Toronto Raptors","Jalen McDaniels",1,0,0,0,0,3
0,0,1,1,0,1,0,0,0,"02",0,0,0,1,1,0,1038166,"2024-01-17T00:00:00.000Z",28,FALSE,16,436,"G-F",28,28,"Toronto Raptors","Garrett Temple",1,1,1,0,1,4.2
0,0,0,0,0,0,0,0,0,"00",0,0,0,0,0,0,1038166,"2024-01-17T00:00:00.000Z",28,FALSE,16,38017710,"C",28,28,"Toronto Raptors","Christian Koloko",0,0,0,0,0,0
0,0,0,0,0,0,0,0,0,"00",0,0,0,0,0,0,1038166,"2024-01-17T00:00:00.000Z",28,FALSE,16,56677869,"G",28,28,"Toronto Raptors","Markquis Nowell",0,0,0,0,0,0
0,0,0,0,0,0,0,0,0,"00",0,0,0,0,0,0,1038166,"2024-01-17T00:00:00.000Z",28,FALSE,16,373,"C",28,28,"Toronto Raptors","Jakob Poeltl",0,0,0,0,0,0
0,0,0,0,0,0,0,0,0,"00",0,0,0,0,0,0,1038166,"2024-01-17T00:00:00.000Z",28,FALSE,16,376,"F",28,28,"Toronto Raptors","Otto Porter Jr.",0,0,0,0,0,0
0,0,0,0,0,0,0,0,0,"00",0,0,0,0,0,0,1038166,"2024-01-17T00:00:00.000Z",28,FALSE,16,416,"F",28,28,"Toronto Raptors","Pascal Siakam",0,0,0,0,0,0
5,0,3,0,0,11,6,5,4,"31",2,0,16,5,2,1,1038166,"2024-01-17T00:00:00.000Z",28,FALSE,16,79,"G-F",16,16,"Miami Heat","Jimmy Butler",2,21,26,21,10,34.5
0,2,1,4,1,7,2,0,0,"23",0,3,5,1,1,1,1038166,"2024-01-17T00:00:00.000Z",28,FALSE,16,391,"G-F",16,16,"Miami Heat","Josh Richardson",3,6,6,5,1,14.2
0,1,1,1,0,2,1,0,0,"12",2,0,2,3,0,0,1038166,"2024-01-17T00:00:00.000Z",28,FALSE,16,3092,"",16,16,"Miami Heat","Haywood Highsmith",1,5,5,2,3,8.6
1,0,2,5,2,11,6,0,0,"21",1,0,14,3,0,2,1038166,"2024-01-17T00:00:00.000Z",28,FALSE,16,397,"F",16,16,"Miami Heat","Duncan Robinson",0,17,18,15,4,17.1
0,0,0,0,0,1,1,0,0,"05",0,1,2,0,0,0,1038166,"2024-01-17T00:00:00.000Z",28,FALSE,16,74,"C",16,16,"Miami Heat","Thomas Bryant",0,2,2,2,0,2
1,0,1,0,0,0,0,0,0,"02",0,0,0,1,0,0,1038166,"2024-01-17T00:00:00.000Z",28,FALSE,16,39398582,"C",16,16,"Miami Heat","Orlando Robinson",0,1,2,1,2,2.7
0,0,0,1,0,2,1,0,0,"02",0,0,2,0,0,1,1038166,"2024-01-17T00:00:00.000Z",28,FALSE,16,38017736,"F",16,16,"Miami Heat","Cole Swider",0,2,2,2,0,1
0,0,0,0,0,0,0,0,0,"00",0,0,0,0,0,0,1038166,"2024-01-17T00:00:00.000Z",28,FALSE,16,38017734,"F",16,16,"Miami Heat","Jamal Cain",0,0,0,0,0,0
2,1,4,2,1,9,4,2,1,"21",3,1,10,7,0,2,1038166,"2024-01-17T00:00:00.000Z",28,FALSE,16,38017696,"F",16,16,"Miami Heat","Nikola Jovic",1,17,19,12,9,22.4
4,0,4,0,0,13,7,3,2,"36",1,3,16,5,1,2,1038166,"2024-01-17T00:00:00.000Z",28,FALSE,16,4,"C-F",16,16,"Miami Heat","Bam Adebayo",1,21,25,20,9,29
3,0,6,9,2,20,7,0,0,"32",1,2,16,7,0,3,1038166,"2024-01-17T00:00:00.000Z",28,FALSE,16,666633,"G",16,16,"Miami Heat","Tyler Herro",0,23,26,19,10,25.9
3,1,1,6,0,9,2,0,0,"29",1,2,4,2,0,1,1038166,"2024-01-17T00:00:00.000Z",28,FALSE,16,286,"G",16,16,"Miami Heat","Kyle Lowry",1,6,9,7,5,12.9
5,0,2,0,0,5,4,2,2,"26",1,1,10,3,0,1,1038166,"2024-01-17T00:00:00.000Z",28,FALSE,16,666747,"F",16,16,"Miami Heat","Caleb Martin",0,13,18,15,8,20.1
0,0,0,0,0,0,0,0,0,"00",0,0,0,0,0,0,1038166,"2024-01-17T00:00:00.000Z",28,FALSE,16,3547257,"G",16,16,"Miami Heat","R.J. Hampton",0,0,0,0,0,0
0,0,0,0,0,0,0,0,0,"00",0,0,0,0,0,0,1038166,"2024-01-17T00:00:00.000Z",28,FALSE,16,56677785,"G",16,16,"Miami Heat","Jaime Jaquez Jr.",0,0,0,0,0,0
0,0,0,0,0,0,0,0,0,"00",0,0,0,0,0,0,1038166,"2024-01-17T00:00:00.000Z",28,FALSE,16,285,"F-C",16,16,"Miami Heat","Kevin Love",0,0,0,0,0,0
10,0,9,11,7,19,8,5,5,"34",1,3,28,10,3,2,1038167,"2024-01-17T00:00:00.000Z",19,FALSE,4,227,"F",19,19,"New Orleans Pelicans","Brandon Ingram",3,38,48,38,20,62
9,0,3,0,0,12,5,4,3,"27",3,1,13,6,3,2,1038167,"2024-01-17T00:00:00.000Z",19,FALSE,4,666969,"F",19,19,"New Orleans Pelicans","Zion Williamson",3,19,28,22,15,40.7
0,1,1,0,0,2,1,2,2,"13",1,4,4,2,0,1,1038167,"2024-01-17T00:00:00.000Z",19,FALSE,4,NA,NA,NA,4,"Charlotte Hornets","NA NA",1,6,6,4,2,8.4
1,0,1,1,0,1,0,0,0,"03",0,0,0,1,0,1,1038167,"2024-01-17T00:00:00.000Z",19,FALSE,4,347,"G",4,4,"Charlotte Hornets","Frank Ntilikina",0,1,2,1,2,1.7
2,1,1,0,0,1,1,0,0,"11",0,0,2,1,0,0,1038167,"2024-01-17T00:00:00.000Z",19,FALSE,4,422,"G",4,4,"Charlotte Hornets","Ish Smith",1,3,5,4,3,9.2
3,0,1,2,1,5,1,0,0,"17",2,1,3,3,0,1,1038167,"2024-01-17T00:00:00.000Z",19,FALSE,4,56677846,"G",4,4,"Charlotte Hornets","Nick Smith Jr.",0,6,9,6,6,10.1
1,1,1,1,0,1,0,0,0,"07",1,0,0,2,0,1,1038167,"2024-01-17T00:00:00.000Z",19,FALSE,4,18678001,"F",4,4,"Charlotte Hornets","JT Thor",1,2,3,1,3,5.9
2,2,1,4,1,9,3,0,0,"24",4,3,7,5,1,1,1038167,"2024-01-17T00:00:00.000Z",19,FALSE,4,666950,"F",4,4,"Charlotte Hornets","P.J. Washington",3,12,14,9,7,24
0,0,0,0,0,0,0,0,0,"00",0,0,0,0,0,0,1038167,"2024-01-17T00:00:00.000Z",19,FALSE,4,56677848,"G",4,4,"Charlotte Hornets","Amari Bailey",0,0,0,0,0,0
0,0,0,0,0,0,0,0,0,"00",0,0,0,0,0,0,1038167,"2024-01-17T00:00:00.000Z",19,FALSE,4,204,"F",4,4,"Charlotte Hornets","Gordon Hayward",0,0,0,0,0,0
0,0,0,0,0,0,0,0,0,"00",0,0,0,0,0,0,1038167,"2024-01-17T00:00:00.000Z",19,FALSE,4,38017708,"G",4,4,"Charlotte Hornets","Bryce McGowens",0,0,0,0,0,0
0,0,0,0,0,0,0,0,0,"00",0,0,0,0,0,0,1038167,"2024-01-17T00:00:00.000Z",19,FALSE,4,56677823,"F",4,4,"Charlotte Hornets","Brandon Miller",0,0,0,0,0,0
0,0,0,0,0,0,0,0,0,"00",0,0,0,0,0,0,1038167,"2024-01-17T00:00:00.000Z",19,FALSE,4,38017698,"C",4,4,"Charlotte Hornets","Mark Williams",0,0,0,0,0,0
0,0,4,0,0,3,1,2,2,"25",3,1,4,7,0,1,1038167,"2024-01-17T00:00:00.000Z",19,FALSE,4,455,"C",19,19,"New Orleans Pelicans","Jonas Valanciunas",0,11,11,4,7,11.4
1,0,1,3,2,5,3,2,1,"24",0,0,9,1,2,0,1038167,"2024-01-17T00:00:00.000Z",19,FALSE,4,17896024,"F",19,19,"New Orleans Pelicans","Herbert Jones",2,10,11,10,2,17.7
6,2,3,9,4,15,8,2,2,"29",3,2,22,6,0,1,1038167,"2024-01-17T00:00:00.000Z",19,FALSE,4,303,"G",19,19,"New Orleans Pelicans","CJ McCollum",2,28,34,28,12,43.2
1,0,0,1,0,2,0,0,0,"13",2,1,0,2,0,2,1038167,"2024-01-17T00:00:00.000Z",19,FALSE,4,38017677,"G",19,19,"New Orleans Pelicans","Dyson Daniels",0,2,3,1,3,1.9
1,0,5,12,5,13,6,2,1,"24",0,2,18,5,1,2,1038167,"2024-01-17T00:00:00.000Z",19,FALSE,4,18677986,"F",19,19,"New Orleans Pelicans","Trey Murphy III",1,23,24,19,6,26.5
1,0,4,9,6,12,7,2,1,"24",2,1,21,6,1,2,1038167,"2024-01-17T00:00:00.000Z",19,FALSE,4,56677837,"G",19,19,"New Orleans Pelicans","Jordan Hawkins",1,27,28,22,7,30.7
2,1,4,1,1,3,3,0,0,"18",2,1,7,6,0,0,1038167,"2024-01-17T00:00:00.000Z",19,FALSE,4,340,"F",19,19,"New Orleans Pelicans","Larry Nance Jr.",1,13,15,9,8,20.2
0,0,0,0,0,0,0,2,2,"03",0,2,2,0,0,0,1038167,"2024-01-17T00:00:00.000Z",19,FALSE,4,17896097,"G",19,19,"New Orleans Pelicans","Jose Alvarado",0,2,2,2,0,2
1,0,1,1,0,5,3,2,2,"17",0,0,8,1,1,0,1038167,"2024-01-17T00:00:00.000Z",19,FALSE,4,3547293,"F",19,19,"New Orleans Pelicans","Naji Marshall",1,9,10,9,2,13.7
0,0,0,0,0,0,0,0,0,"02",1,0,0,1,0,0,1038167,"2024-01-17T00:00:00.000Z",19,FALSE,4,491,"C",19,19,"New Orleans Pelicans","Cody Zeller",0,1,1,0,1,1.2
0,0,0,0,0,0,0,0,0,"00",0,0,0,0,0,0,1038167,"2024-01-17T00:00:00.000Z",19,FALSE,4,3547260,"G",19,19,"New Orleans Pelicans","Kira Lewis Jr.",0,0,0,0,0,0
0,0,0,0,0,0,0,0,0,"00",0,0,0,0,0,0,1038167,"2024-01-17T00:00:00.000Z",19,FALSE,4,38017663,"F",19,19,"New Orleans Pelicans","E.J. Liddell",0,0,0,0,0,0
0,0,0,0,0,0,0,0,0,"00",0,0,0,0,0,0,1038167,"2024-01-17T00:00:00.000Z",19,FALSE,4,17896021,"F",19,19,"New Orleans Pelicans","Jeremiah Robinson-Earl",0,0,0,0,0,0
0,0,0,0,0,0,0,0,0,"00",0,0,0,0,0,0,1038167,"2024-01-17T00:00:00.000Z",19,FALSE,4,17896017,"F",19,19,"New Orleans Pelicans","Matt Ryan",0,0,0,0,0,0
0,0,0,0,0,0,0,0,0,"00",0,0,0,0,0,0,1038167,"2024-01-17T00:00:00.000Z",19,FALSE,4,38017726,"G",19,19,"New Orleans Pelicans","Dereon Seabron",0,0,0,0,0,0
4,0,3,5,1,9,2,2,2,"28",1,2,7,4,2,0,1038167,"2024-01-17T00:00:00.000Z",19,FALSE,4,666748,"F",4,4,"Charlotte Hornets","Cody Martin",2,11,15,11,8,23.8
3,0,4,7,3,20,8,0,0,"35",0,1,19,4,0,2,1038167,"2024-01-17T00:00:00.000Z",19,FALSE,4,62,"F",4,4,"Charlotte Hornets","Miles Bridges",0,23,26,22,7,26.3
2,2,7,0,0,5,4,2,2,"31",5,2,10,12,0,0,1038167,"2024-01-17T00:00:00.000Z",19,FALSE,4,3547282,"C",4,4,"Charlotte Hornets","Nick Richards",2,22,24,12,14,33.4
4,1,1,11,7,15,9,0,0,"32",1,1,25,2,1,1,1038167,"2024-01-17T00:00:00.000Z",19,FALSE,4,403,"G",4,4,"Charlotte Hornets","Terry Rozier",2,27,31,29,6,38.4
7,0,5,12,4,19,8,10,9,"31",0,5,29,5,2,4,1038167,"2024-01-17T00:00:00.000Z",19,FALSE,4,3547239,"G",4,4,"Charlotte Hornets","LaMelo Ball",2,34,41,36,12,47.5
0,0,0,0,0,0,0,2,0,"04",0,0,0,0,1,1,1038167,"2024-01-17T00:00:00.000Z",19,FALSE,4,56677866,"F",4,4,"Charlotte Hornets","Leaky Black",1,0,0,0,0,2
0,0,0,2,2,3,2,0,0,"04",0,0,6,0,0,0,1038167,"2024-01-17T00:00:00.000Z",19,FALSE,4,17896037,"G",4,4,"Charlotte Hornets","James Bouknight",0,6,6,6,0,6
1,0,1,3,0,8,3,5,3,"20",0,4,9,1,0,0,1038169,"2024-01-17T00:00:00.000Z",14,FALSE,7,383,"F",14,14,"Los Angeles Lakers","Taurean Prince",0,10,11,10,2,11.7
8,0,7,7,3,19,10,2,2,"33",1,1,25,8,1,3,1038169,"2024-01-17T00:00:00.000Z",14,FALSE,7,237,"F",14,14,"Los Angeles Lakers","LeBron James",1,33,41,33,16,46.6
9,1,7,0,0,17,12,5,4,"33",5,2,28,12,1,1,1038169,"2024-01-17T00:00:00.000Z",14,FALSE,7,117,"F-C",14,14,"Los Angeles Lakers","Anthony Davis",2,40,49,37,21,60.9
7,0,3,2,2,8,6,0,0,"29",0,2,14,3,1,3,1038169,"2024-01-17T00:00:00.000Z",14,FALSE,7,17553995,"G",14,14,"Los Angeles Lakers","Austin Reaves",1,17,24,21,10,28.1
3,0,3,7,5,20,11,2,2,"36",1,0,29,4,0,1,1038169,"2024-01-17T00:00:00.000Z",14,FALSE,7,405,"G",14,14,"Los Angeles Lakers","D'Angelo Russell",0,33,36,32,7,37.3
0,0,2,1,1,2,2,0,0,"14",0,0,5,2,0,0,1038169,"2024-01-17T00:00:00.000Z",14,FALSE,7,38017697,"G",14,14,"Los Angeles Lakers","Max Christie",0,7,7,5,2,7.4
1,0,3,4,1,6,2,2,1,"22",1,1,6,4,2,0,1038169,"2024-01-17T00:00:00.000Z",14,FALSE,7,666609,"F",14,14,"Los Angeles Lakers","Rui Hachimura",2,10,11,7,5,18.3
0,0,0,0,0,0,0,0,0,"00",0,0,0,0,0,0,1038169,"2024-01-17T00:00:00.000Z",14,FALSE,7,56677859,"F",7,7,"Dallas Mavericks","Olivier-Maxence Prosper",0,0,0,0,0,0
0,0,0,0,0,0,0,0,0,"00",0,0,0,0,0,0,1038169,"2024-01-17T00:00:00.000Z",14,FALSE,7,56677835,"G",14,14,"Los Angeles Lakers","Jalen Hood-Schifino",0,0,0,0,0,0
0,0,0,0,0,0,0,0,0,"00",0,0,0,0,0,0,1038169,"2024-01-17T00:00:00.000Z",14,FALSE,7,56677836,"F",14,14,"Los Angeles Lakers","Maxwell Lewis",0,0,0,0,0,0
0,0,0,0,0,0,0,0,0,"00",0,0,0,0,0,0,1038169,"2024-01-17T00:00:00.000Z",14,FALSE,7,1603383,"G",14,14,"Los Angeles Lakers","Gabe Vincent",0,0,0,0,0,0
0,0,0,0,0,0,0,0,0,"00",0,0,0,0,0,0,1038169,"2024-01-17T00:00:00.000Z",14,FALSE,7,666971,"G-F",20,14,"Los Angeles Lakers","Dylan Windler",0,0,0,0,0,0
1,0,2,7,0,17,5,2,2,"28",2,2,12,4,1,4,1038169,"2024-01-17T00:00:00.000Z",14,FALSE,7,191,"G",7,7,"Dallas Mavericks","Tim Hardaway Jr.",1,16,17,13,5,17.3
0,1,0,2,2,3,3,0,0,"27",1,2,8,1,0,0,1038169,"2024-01-17T00:00:00.000Z",14,FALSE,7,247,"F-G",7,7,"Dallas Mavericks","Derrick Jones Jr.",1,9,9,8,1,12.2
2,0,6,0,0,9,8,0,0,"28",5,2,16,11,1,2,1038169,"2024-01-17T00:00:00.000Z",14,FALSE,7,56677840,"C",7,7,"Dallas Mavericks","Dereck Lively II",1,27,29,18,13,33.2
0,0,0,0,0,0,0,0,0,"00",0,0,0,0,0,0,1038169,"2024-01-17T00:00:00.000Z",14,FALSE,7,217,"F-C",7,7,"Dallas Mavericks","Richaun Holmes",0,0,0,0,0,0
1,0,0,0,0,1,0,0,0,"05",0,1,0,0,1,0,1038169,"2024-01-17T00:00:00.000Z",14,FALSE,7,666626,"C",14,14,"Los Angeles Lakers","Jaxson Hayes",1,0,1,1,1,4.5
1,0,0,0,0,2,1,0,0,"05",0,1,2,0,0,0,1038169,"2024-01-17T00:00:00.000Z",14,FALSE,7,3547289,"G",25,14,"Los Angeles Lakers","Skylar Mays",0,2,3,3,1,3.5
0,0,0,0,0,0,0,0,0,"00",0,0,0,0,0,0,1038169,"2024-01-17T00:00:00.000Z",14,FALSE,7,666860,"F-G",14,14,"Los Angeles Lakers","Cameron Reddish",0,0,0,0,0,0
1,0,8,1,0,3,1,8,5,"26",1,3,7,9,1,1,1038169,"2024-01-17T00:00:00.000Z",14,FALSE,7,457,"F",14,14,"Los Angeles Lakers","Jarred Vanderbilt",1,16,17,8,10,21.3
1,0,2,3,0,5,1,0,0,"17",0,0,2,2,1,1,1038169,"2024-01-17T00:00:00.000Z",14,FALSE,7,486,"F",14,14,"Los Angeles Lakers","Christian Wood",1,4,5,3,3,7.9
0,0,0,0,0,0,0,0,0,"00",0,0,0,0,0,0,1038169,"2024-01-17T00:00:00.000Z",14,FALSE,7,56677738,"C",14,14,"Los Angeles Lakers","Colin Castleton",0,0,0,0,0,0
0,0,0,0,0,1,1,0,0,"05",0,0,2,0,0,0,1038169,"2024-01-17T00:00:00.000Z",14,FALSE,7,17554004,"G",7,7,"Dallas Mavericks","AJ Lawson",0,2,2,2,0,2
0,0,0,0,0,0,0,0,0,"00",0,0,0,0,0,0,1038169,"2024-01-17T00:00:00.000Z",14,FALSE,7,329,"F",7,7,"Dallas Mavericks","Markieff Morris",0,0,0,0,0,0
0,0,2,0,0,0,0,2,1,"07",2,1,1,4,0,1,1038169,"2024-01-17T00:00:00.000Z",14,FALSE,7,379,"F-C",7,7,"Dallas Mavericks","Dwight Powell",0,5,5,1,4,4.8
2,0,1,2,1,3,2,0,0,"05",0,0,5,1,0,0,1038169,"2024-01-17T00:00:00.000Z",14,FALSE,7,24489167,"G",25,7,"Dallas Mavericks","Brandon Williams",0,6,8,7,3,9.2
2,0,3,6,2,6,2,2,2,"26",0,3,8,3,0,0,1038169,"2024-01-17T00:00:00.000Z",14,FALSE,7,666965,"F",7,7,"Dallas Mavericks","Grant Williams",0,11,13,10,5,14.6
0,0,0,0,0,0,0,0,0,"00",0,0,0,0,0,0,1038169,"2024-01-17T00:00:00.000Z",14,FALSE,7,17896028,"F",7,7,"Dallas Mavericks","Greg Brown III",0,0,0,0,0,0
0,0,0,0,0,0,0,0,0,"00",0,0,0,0,0,0,1038169,"2024-01-17T00:00:00.000Z",14,FALSE,7,151,"G",7,7,"Dallas Mavericks","Dante Exum",0,0,0,0,0,0
0,0,0,0,0,0,0,0,0,"00",0,0,0,0,0,0,1038169,"2024-01-17T00:00:00.000Z",14,FALSE,7,3547258,"G",7,7,"Dallas Mavericks","Josh Green",0,0,0,0,0,0
10,2,13,9,2,24,12,9,7,"36",0,2,33,13,2,4,1038169,"2024-01-17T00:00:00.000Z",14,FALSE,7,132,"F-G",7,7,"Dallas Mavericks","Luka Doncic",4,46,56,43,23,71.6
6,0,5,5,1,16,4,3,3,"32",0,2,12,5,0,2,1038169,"2024-01-17T00:00:00.000Z",14,FALSE,7,228,"G",7,7,"Dallas Mavericks","Kyrie Irving",0,17,23,18,11,25
0,0,0,5,1,7,3,0,0,"20",0,0,7,0,0,1,1038169,"2024-01-17T00:00:00.000Z",14,FALSE,7,38017679,"G",7,7,"Dallas Mavericks","Jaden Hardy",0,7,7,7,0,6
0,0,0,1,0,2,0,0,0,"05",0,0,0,0,0,0,1038169,"2024-01-17T00:00:00.000Z",14,FALSE,7,114,"G",7,7,"Dallas Mavericks","Seth Curry",0,0,0,0,0,0
3,2,0,3,2,3,2,0,0,"21",1,5,6,1,0,1,1038169,"2024-01-17T00:00:00.000Z",14,FALSE,7,257,"F",7,7,"Dallas Mavericks","Maxi Kleber",2,7,10,9,4,16.7
5,1,6,5,1,16,7,0,0,"39",0,2,15,6,2,3,1038171,"2024-01-18T00:00:00.000Z",20,FALSE,30,265,"F",30,30,"Washington Wizards","Kyle Kuzma",3,21,26,20,11,35.7
2,3,5,0,0,16,10,5,0,"39",6,3,20,11,2,3,1038171,"2024-01-18T00:00:00.000Z",20,FALSE,30,24,"F",9,30,"Washington Wizards","Marvin Bagley III",5,31,33,22,13,48.2
15,0,4,3,0,6,1,0,0,"37",0,2,2,4,3,1,1038171,"2024-01-18T00:00:00.000Z",20,FALSE,30,249,"G",30,30,"Washington Wizards","Tyus Jones",3,6,21,17,19,37.3
2,0,4,9,2,19,7,8,8,"34",0,1,24,4,1,0,1038171,"2024-01-18T00:00:00.000Z",20,FALSE,30,666848,"G",30,30,"Washington Wizards","Jordan Poole",1,28,30,26,6,34.8
2,0,3,0,0,0,0,0,0,"06",0,1,0,3,0,1,1038171,"2024-01-18T00:00:00.000Z",20,FALSE,30,38017704,"F",30,30,"Washington Wizards","Patrick Baldwin Jr.",0,3,5,2,5,5.6
0,0,0,0,0,0,0,0,0,"00",0,0,0,0,0,0,1038171,"2024-01-18T00:00:00.000Z",20,FALSE,30,NA,NA,NA,30,"Washington Wizards","NA NA",0,0,0,0,0,0
2,0,2,3,1,4,1,2,2,"17",0,3,5,2,0,0,1038171,"2024-01-18T00:00:00.000Z",20,FALSE,30,56677844,"G",30,30,"Washington Wizards","Bilal Coulibaly",0,7,9,7,4,10.4
0,0,0,0,0,0,0,0,0,"00",0,0,0,0,0,0,1038171,"2024-01-18T00:00:00.000Z",20,FALSE,30,38017687,"G",30,30,"Washington Wizards","Johnny Davis",0,0,0,0,0,0
0,0,0,0,0,0,0,0,0,"00",0,0,0,0,0,0,1038171,"2024-01-18T00:00:00.000Z",20,FALSE,30,128,"G",9,30,"Washington Wizards","Hamidou Diallo",0,0,0,0,0,0
1,2,7,5,3,9,6,4,4,"43",0,3,19,7,0,1,1038171,"2024-01-18T00:00:00.000Z",20,FALSE,30,18,"F",28,20,"New York Knicks","OG Anunoby",2,26,27,20,8,33.9
5,0,7,8,3,17,8,4,2,"39",1,2,21,8,0,5,1038171,"2024-01-18T00:00:00.000Z",20,FALSE,30,387,"F",20,20,"New York Knicks","Julius Randle",0,29,34,26,13,33.1
3,1,12,0,0,5,3,0,0,"38",5,2,6,17,2,2,1038171,"2024-01-18T00:00:00.000Z",20,FALSE,30,201,"F-C",20,20,"New York Knicks","Isaiah Hartenstein",3,23,26,9,20,37.9
8,1,7,4,2,27,14,13,11,"40",1,2,41,8,2,6,1038171,"2024-01-18T00:00:00.000Z",20,FALSE,30,73,"G",20,20,"New York Knicks","Jalen Brunson",3,49,57,49,16,65.6
3,1,3,12,5,15,6,2,2,"38",0,4,19,3,0,3,1038171,"2024-01-18T00:00:00.000Z",20,FALSE,30,131,"G",20,20,"New York Knicks","Donte DiVincenzo",1,22,25,22,6,27.1
0,0,1,0,0,1,1,0,0,"09",0,1,2,1,1,0,1038171,"2024-01-18T00:00:00.000Z",20,FALSE,30,3547249,"F",28,20,"New York Knicks","Precious Achiuwa",1,3,3,2,1,6.2
0,0,0,0,0,0,0,0,0,"00",0,0,0,0,0,0,1038171,"2024-01-18T00:00:00.000Z",20,FALSE,30,19,"G",20,20,"New York Knicks","Ryan Arcidiacono",0,0,0,0,0,0
0,0,0,0,0,0,0,0,0,"00",0,0,0,0,0,0,1038171,"2024-01-18T00:00:00.000Z",20,FALSE,30,3547275,"G",28,20,"New York Knicks","Malachi Flynn",0,0,0,0,0,0
0,0,1,3,0,4,0,0,0,"06",0,2,0,1,0,0,1038171,"2024-01-18T00:00:00.000Z",20,FALSE,30,160,"G-F",20,20,"New York Knicks","Evan Fournier",0,1,1,0,1,1.2
2,0,1,5,0,5,0,0,0,"19",0,1,0,1,0,0,1038171,"2024-01-18T00:00:00.000Z",20,FALSE,30,17895858,"G",20,20,"New York Knicks","Quentin Grimes",0,1,3,2,3,4.2
0,0,1,1,0,3,1,3,3,"08",0,1,5,1,1,0,1038171,"2024-01-18T00:00:00.000Z",20,FALSE,30,17896033,"G",20,20,"New York Knicks","Miles McBride",1,6,6,5,1,9.2
0,0,0,0,0,0,0,0,0,"00",0,0,0,0,0,0,1038171,"2024-01-18T00:00:00.000Z",20,FALSE,30,17896063,"F",20,20,"New York Knicks","Jericho Sims",0,0,0,0,0,0
0,0,0,0,0,0,0,0,0,"00",0,0,0,0,0,0,1038171,"2024-01-18T00:00:00.000Z",20,FALSE,30,666474,"G",20,20,"New York Knicks","Charles Brown",0,0,0,0,0,0
0,0,0,0,0,0,0,0,0,"00",0,0,0,0,0,0,1038171,"2024-01-18T00:00:00.000Z",20,FALSE,30,202,"G",20,20,"New York Knicks","Josh Hart",0,0,0,0,0,0
0,0,0,0,0,0,0,0,0,"00",0,0,0,0,0,0,1038171,"2024-01-18T00:00:00.000Z",20,FALSE,30,399,"C",20,20,"New York Knicks","Mitchell Robinson",0,0,0,0,0,0
0,0,0,0,0,0,0,0,0,"00",0,0,0,0,0,0,1038171,"2024-01-18T00:00:00.000Z",20,FALSE,30,56677795,"F",20,20,"New York Knicks","Jacob Toppin",0,0,0,0,0,0
0,0,0,0,0,0,0,0,0,"00",0,0,0,0,0,0,1038171,"2024-01-18T00:00:00.000Z",20,FALSE,30,17896089,"G",20,20,"New York Knicks","Duane Washington Jr.",0,0,0,0,0,0
1,0,6,3,0,13,5,5,5,"26",2,6,15,8,0,2,1038171,"2024-01-18T00:00:00.000Z",20,FALSE,30,3547242,"F",30,30,"Washington Wizards","Deni Avdija",0,23,24,16,9,24.1
0,0,0,0,0,0,0,0,0,"00",0,0,0,0,0,0,1038171,"2024-01-18T00:00:00.000Z",20,FALSE,30,3547302,"F",30,30,"Washington Wizards","Anthony Gill",0,0,0,0,0,0
0,0,4,3,2,5,4,0,0,"17",0,0,10,4,0,0,1038171,"2024-01-18T00:00:00.000Z",20,FALSE,30,17896045,"F",30,30,"Washington Wizards","Corey Kispert",0,14,14,10,4,14.8
0,0,0,0,0,0,0,0,0,"00",0,0,0,0,0,0,1038171,"2024-01-18T00:00:00.000Z",20,FALSE,30,17896071,"F",9,30,"Washington Wizards","Isaiah Livers",0,0,0,0,0,0
1,0,0,4,3,6,5,0,0,"14",1,5,13,1,0,2,1038171,"2024-01-18T00:00:00.000Z",20,FALSE,30,414,"G",30,30,"Washington Wizards","Landry Shamet",0,14,15,14,2,13.7
1,0,2,1,1,5,1,2,2,"11",0,1,5,2,1,0,1038171,"2024-01-18T00:00:00.000Z",20,FALSE,30,487,"G",30,30,"Washington Wizards","Delon Wright",1,7,8,6,3,11.9
0,0,0,0,0,0,0,0,0,"00",0,0,0,0,0,0,1038171,"2024-01-18T00:00:00.000Z",20,FALSE,30,18677954,"G",30,30,"Washington Wizards","Jared Butler",0,0,0,0,0,0
0,0,0,0,0,0,0,0,0,"00",0,0,0,0,0,0,1038171,"2024-01-18T00:00:00.000Z",20,FALSE,30,666577,"F",30,30,"Washington Wizards","Daniel Gafford",0,0,0,0,0,0
0,0,0,0,0,0,0,0,0,"00",0,0,0,0,0,0,1038171,"2024-01-18T00:00:00.000Z",20,FALSE,30,17896106,"F",30,30,"Washington Wizards","Eugene Omoruyi",0,0,0,0,0,0
6,0,4,6,1,16,6,5,4,"35",0,2,17,4,1,1,1038172,"2024-01-18T00:00:00.000Z",28,FALSE,5,666423,"F-G",20,28,"Toronto Raptors","RJ Barrett",1,21,27,23,10,32.8
6,3,6,6,2,18,11,9,7,"37",1,1,31,7,3,6,1038172,"2024-01-18T00:00:00.000Z",28,FALSE,5,17896055,"G-F",28,28,"Toronto Raptors","Scottie Barnes",6,38,44,37,13,60.4
4,2,3,5,2,6,3,2,2,"20",1,2,10,4,1,1,1038172,"2024-01-18T00:00:00.000Z",28,FALSE,5,2309958,"C-F",15,28,"Toronto Raptors","Jontay Porter",3,14,18,14,8,28.8
2,0,2,4,0,8,3,0,0,"30",0,3,6,2,0,2,1038172,"2024-01-18T00:00:00.000Z",28,FALSE,5,3089,"",28,28,"Toronto Raptors","Gary Trent Jr.",0,8,10,8,4,9.4
3,0,3,7,2,10,4,2,2,"35",0,2,12,3,1,2,1038172,"2024-01-18T00:00:00.000Z",28,FALSE,5,3547269,"G",20,28,"Toronto Raptors","Immanuel Quickley",1,15,18,15,6,21.1
2,0,7,3,1,4,2,2,1,"17",2,1,6,9,0,2,1038172,"2024-01-18T00:00:00.000Z",28,FALSE,5,58,"F",28,28,"Toronto Raptors","Chris Boucher",0,15,17,8,11,17.8
1,0,5,3,1,10,7,0,0,"25",2,4,15,7,1,0,1038172,"2024-01-18T00:00:00.000Z",28,FALSE,5,69,"G",12,28,"Toronto Raptors","Bruce Brown",1,22,23,16,8,27.9
0,0,0,0,0,0,0,0,0,"00",0,0,0,0,0,0,1038172,"2024-01-18T00:00:00.000Z",28,FALSE,5,56677828,"G",28,28,"Toronto Raptors","Gradey Dick",0,0,0,0,0,0
0,0,0,0,0,0,0,0,0,"00",0,0,0,0,0,0,1038172,"2024-01-18T00:00:00.000Z",28,FALSE,5,56677805,"G",28,28,"Toronto Raptors","Javon Freeman-Liberty",0,0,0,0,0,0
0,0,0,0,0,0,0,0,0,"00",0,0,0,0,0,0,1038172,"2024-01-18T00:00:00.000Z",28,FALSE,5,3547260,"G",19,28,"Toronto Raptors","Kira Lewis Jr.",0,0,0,0,0,0
0,0,0,0,0,0,0,0,0,"00",0,0,0,0,0,0,1038172,"2024-01-18T00:00:00.000Z",28,FALSE,5,666762,"F",28,28,"Toronto Raptors","Jalen McDaniels",0,0,0,0,0,0
0,0,0,0,0,0,0,0,0,"00",0,0,0,0,0,0,1038172,"2024-01-18T00:00:00.000Z",28,FALSE,5,3547207,"F",12,28,"Toronto Raptors","Jordan Nwora",0,0,0,0,0,0
5,0,0,4,1,7,3,0,0,"26",0,1,7,0,0,0,1038172,"2024-01-18T00:00:00.000Z",28,FALSE,5,409,"G",28,28,"Toronto Raptors","Dennis Schroder",0,7,12,12,5,14.5
0,0,0,0,0,0,0,0,0,"00",0,0,0,0,0,0,1038172,"2024-01-18T00:00:00.000Z",28,FALSE,5,436,"G-F",28,28,"Toronto Raptors","Garrett Temple",0,0,0,0,0,0
2,0,1,0,0,4,3,0,0,"15",1,2,6,2,0,0,1038172,"2024-01-18T00:00:00.000Z",28,FALSE,5,489,"F",28,28,"Toronto Raptors","Thaddeus Young",0,8,10,8,4,11.4
0,0,0,0,0,0,0,0,0,"00",0,0,0,0,0,0,1038172,"2024-01-18T00:00:00.000Z",28,FALSE,5,56677869,"G",28,28,"Toronto Raptors","Markquis Nowell",0,0,0,0,0,0
0,0,0,0,0,0,0,0,0,"00",0,0,0,0,0,0,1038172,"2024-01-18T00:00:00.000Z",28,FALSE,5,373,"C",28,28,"Toronto Raptors","Jakob Poeltl",0,0,0,0,0,0
0,0,0,0,0,0,0,0,0,"00",0,0,0,0,0,0,1038172,"2024-01-18T00:00:00.000Z",28,FALSE,5,376,"F",28,28,"Toronto Raptors","Otto Porter Jr.",0,0,0,0,0,0
4,2,3,4,2,6,4,0,0,"28",0,4,10,3,2,1,1038172,"2024-01-18T00:00:00.000Z",28,FALSE,5,89,"G",5,5,"Chicago Bulls","Alex Caruso",4,13,17,14,7,30.6
6,0,6,4,0,20,9,7,6,"38",1,2,24,7,1,2,1038172,"2024-01-18T00:00:00.000Z",28,FALSE,5,125,"G",5,5,"Chicago Bulls","DeMar DeRozan",1,31,37,30,13,42.4
7,1,9,3,0,20,12,0,0,"35",4,1,24,13,2,0,1038172,"2024-01-18T00:00:00.000Z",28,FALSE,5,460,"C",5,5,"Chicago Bulls","Nikola Vucevic",3,37,44,31,20,59.1
3,0,2,3,1,7,3,1,1,"24",0,4,8,2,0,2,1038172,"2024-01-18T00:00:00.000Z",28,FALSE,5,268,"G",5,5,"Chicago Bulls","Zach LaVine",0,10,13,11,5,12.9
4,0,6,6,1,19,10,3,2,"35",2,2,23,8,2,2,1038172,"2024-01-18T00:00:00.000Z",28,FALSE,5,666956,"G",5,5,"Chicago Bulls","Coby White",2,31,35,27,12,42.6
0,0,0,0,0,0,0,0,0,"03",0,0,0,0,0,0,1038172,"2024-01-18T00:00:00.000Z",28,FALSE,5,87,"G",5,5,"Chicago Bulls","Jevon Carter",0,0,0,0,0,0
0,0,0,0,0,0,0,0,0,"00",0,0,0,0,0,0,1038172,"2024-01-18T00:00:00.000Z",28,FALSE,5,110,"F",5,5,"Chicago Bulls","Torrey Craig",0,0,0,0,0,0
5,1,1,1,0,9,4,2,2,"32",1,2,10,2,0,0,1038172,"2024-01-18T00:00:00.000Z",28,FALSE,5,17895983,"G",5,5,"Chicago Bulls","Ayo Dosunmu",1,12,17,15,7,22.9
0,1,4,0,0,1,1,4,3,"10",0,1,5,4,0,1,1038172,"2024-01-18T00:00:00.000Z",28,FALSE,5,137,"C",5,5,"Chicago Bulls","Andre Drummond",1,9,9,5,4,11.8
0,0,0,0,0,0,0,0,0,"00",0,0,0,0,0,0,1038172,"2024-01-18T00:00:00.000Z",28,FALSE,5,17896116,"G",5,5,"Chicago Bulls","Terry Taylor",0,0,0,0,0,0
0,0,2,0,0,0,0,0,0,"12",1,3,0,3,0,2,1038172,"2024-01-18T00:00:00.000Z",28,FALSE,5,38017719,"F",5,5,"Chicago Bulls","Dalen Terry",0,3,3,0,3,1.6
1,0,0,3,2,9,5,0,0,"23",0,3,12,0,0,0,1038172,"2024-01-18T00:00:00.000Z",28,FALSE,5,3547248,"F",5,5,"Chicago Bulls","Patrick Williams",0,12,13,13,1,13.5
0,0,0,0,0,0,0,0,0,"00",0,0,0,0,0,0,1038172,"2024-01-18T00:00:00.000Z",28,FALSE,5,27,"G",5,5,"Chicago Bulls","Lonzo Ball",0,0,0,0,0,0
0,0,0,0,0,0,0,0,0,"00",0,0,0,0,0,0,1038172,"2024-01-18T00:00:00.000Z",28,FALSE,5,56677874,"F",5,5,"Chicago Bulls","Onuralp Bitim",0,0,0,0,0,0
0,0,0,0,0,0,0,0,0,"00",0,0,0,0,0,0,1038172,"2024-01-18T00:00:00.000Z",28,FALSE,5,NA,NA,NA,5,"Chicago Bulls","NA NA",0,0,0,0,0,0
0,0,0,0,0,0,0,0,0,"00",0,0,0,0,0,0,1038172,"2024-01-18T00:00:00.000Z",28,FALSE,5,56677857,"F",5,5,"Chicago Bulls","Julian Phillips",0,0,0,0,0,0
0,0,0,0,0,0,0,0,0,"00",0,0,0,0,0,0,1038172,"2024-01-18T00:00:00.000Z",28,FALSE,5,56677860,"F",5,5,"Chicago Bulls","Adama Sanogo",0,0,0,0,0,0
1,0,1,1,0,2,1,0,0,"22",0,1,2,1,0,1,1038175,"2024-01-18T00:00:00.000Z",26,FALSE,12,30,"F",26,26,"Sacramento Kings","Harrison Barnes",0,3,4,3,2,3.7
0,1,6,5,1,18,11,5,4,"38",3,3,27,9,2,1,1038175,"2024-01-18T00:00:00.000Z",26,FALSE,12,38017688,"F",26,26,"Sacramento Kings","Keegan Murray",3,36,36,27,9,45.8
10,1,11,1,0,13,8,8,5,"38",0,5,21,11,0,3,1038175,"2024-01-18T00:00:00.000Z",26,FALSE,12,406,"F",26,26,"Sacramento Kings","Domantas Sabonis",1,32,42,31,21,49.2
4,1,2,12,7,17,11,2,2,"39",0,4,31,2,2,2,1038175,"2024-01-18T00:00:00.000Z",26,FALSE,12,221,"G",26,26,"Sacramento Kings","Kevin Huerter",3,33,37,35,6,46.4
6,0,5,7,3,20,8,9,5,"40",0,2,24,5,2,1,1038175,"2024-01-18T00:00:00.000Z",26,FALSE,12,161,"G",26,26,"Sacramento Kings","De'Aaron Fox",2,29,35,30,11,44
0,0,0,0,0,0,0,0,0,"00",0,0,0,0,0,0,1038175,"2024-01-18T00:00:00.000Z",26,FALSE,12,17896030,"G",26,26,"Sacramento Kings","Chris Duarte",0,0,0,0,0,0
0,0,0,0,0,0,0,0,0,"00",0,0,0,0,0,0,1038175,"2024-01-18T00:00:00.000Z",26,FALSE,12,17896044,"F",26,26,"Sacramento Kings","Kessler Edwards",0,0,0,0,0,0
0,0,0,0,0,0,0,0,0,"02",0,0,0,0,0,0,1038175,"2024-01-18T00:00:00.000Z",26,FALSE,12,38017714,"G",26,26,"Sacramento Kings","Keon Ellis",0,0,0,0,0,0
0,0,0,0,0,1,0,0,0,"05",0,1,0,0,0,2,1038175,"2024-01-18T00:00:00.000Z",26,FALSE,12,273,"C",26,26,"Sacramento Kings","Alex Len",0,0,0,0,0,-2
2,0,2,2,0,2,0,0,0,"19",1,0,0,3,1,0,1038175,"2024-01-18T00:00:00.000Z",26,FALSE,12,290,"F",26,26,"Sacramento Kings","Trey Lyles",1,3,5,2,5,9.6
0,0,0,0,0,0,0,0,0,"00",0,0,0,0,0,0,1038175,"2024-01-18T00:00:00.000Z",26,FALSE,12,306,"C",26,26,"Sacramento Kings","JaVale McGee",0,0,0,0,0,0
0,0,0,0,0,0,0,0,0,"00",0,0,0,0,0,0,1038175,"2024-01-18T00:00:00.000Z",26,FALSE,12,17553994,"G",26,26,"Sacramento Kings","Davion Mitchell",0,0,0,0,0,0
4,2,2,6,2,9,3,6,1,"26",1,3,9,3,0,1,1038175,"2024-01-18T00:00:00.000Z",26,FALSE,12,324,"G",26,26,"Sacramento Kings","Malik Monk",2,12,16,13,7,23.6
0,0,0,0,0,0,0,0,0,"00",0,0,0,0,0,0,1038175,"2024-01-18T00:00:00.000Z",26,FALSE,12,666925,"F",29,26,"Sacramento Kings","Juan Toscano-Anderson",0,0,0,0,0,0
0,1,1,3,2,3,2,2,1,"11",2,1,7,3,1,0,1038175,"2024-01-18T00:00:00.000Z",26,FALSE,12,4197162,"F",26,26,"Sacramento Kings","Aleksandar Vezenkov",2,10,10,7,3,16.6
0,0,0,0,0,0,0,0,0,"00",0,0,0,0,0,0,1038175,"2024-01-18T00:00:00.000Z",26,FALSE,12,17895990,"G",26,26,"Sacramento Kings","Jordan Ford",0,0,0,0,0,0
0,0,0,0,0,0,0,0,0,"00",0,0,0,0,0,0,1038175,"2024-01-18T00:00:00.000Z",26,FALSE,12,56677845,"G",26,26,"Sacramento Kings","Colby Jones",0,0,0,0,0,0
0,0,0,0,0,0,0,0,0,"00",0,0,0,0,0,0,1038175,"2024-01-18T00:00:00.000Z",26,FALSE,12,56677862,"F",26,26,"Sacramento Kings","Jalen Slawson",0,0,0,0,0,0
8,1,6,6,2,9,4,2,2,"36",0,2,12,6,1,2,1038175,"2024-01-18T00:00:00.000Z",26,FALSE,12,210,"G",12,12,"Indiana Pacers","Buddy Hield",2,18,26,20,14,35.2
1,1,12,2,1,7,6,4,4,"25",1,3,17,13,0,0,1038175,"2024-01-18T00:00:00.000Z",26,FALSE,12,3547264,"F-C",12,12,"Indiana Pacers","Jalen Smith",1,30,31,18,14,37.1
1,1,2,4,1,12,6,7,5,"32",0,4,18,2,0,1,1038175,"2024-01-18T00:00:00.000Z",26,FALSE,12,452,"C-F",12,12,"Indiana Pacers","Myles Turner",1,20,21,19,3,23.9
4,2,2,6,2,21,11,1,1,"37",1,2,25,3,1,3,1038175,"2024-01-18T00:00:00.000Z",26,FALSE,12,38017686,"G-F",12,12,"Indiana Pacers","Bennedict Mathurin",3,28,32,29,7,40.6
10,0,1,0,0,14,9,3,2,"33",0,2,20,1,1,4,1038175,"2024-01-18T00:00:00.000Z",26,FALSE,12,304,"G",12,12,"Indiana Pacers","T.J. McConnell",1,21,31,30,11,35.2
0,0,0,0,0,0,0,0,0,"00",0,0,0,0,0,0,1038175,"2024-01-18T00:00:00.000Z",26,FALSE,12,38017701,"G",12,12,"Indiana Pacers","Kendall Brown",0,0,0,0,0,0
1,0,0,0,0,2,1,0,0,"05",1,1,2,1,0,0,1038175,"2024-01-18T00:00:00.000Z",26,FALSE,12,17896035,"F",12,12,"Indiana Pacers","Isaiah Jackson",0,3,4,3,2,4.7
2,0,4,3,2,5,2,2,1,"28",0,4,7,4,2,0,1038175,"2024-01-18T00:00:00.000Z",26,FALSE,12,56677861,"G",12,12,"Indiana Pacers","Ben Sheppard",2,11,13,9,6,20.8
4,1,3,4,2,6,4,0,0,"24",0,1,10,3,0,0,1038175,"2024-01-18T00:00:00.000Z",26,FALSE,12,3547243,"F",12,12,"Indiana Pacers","Obi Toppin",1,13,17,14,7,22.6
0,0,0,0,0,0,0,0,0,"00",0,0,0,0,0,0,1038175,"2024-01-18T00:00:00.000Z",26,FALSE,12,56677778,"F-C",12,12,"Indiana Pacers","Oscar Tshiebwe",0,0,0,0,0,0
2,0,1,8,3,13,6,0,0,"20",1,1,15,2,0,2,1038175,"2024-01-18T00:00:00.000Z",26,FALSE,12,56677832,"F",12,12,"Indiana Pacers","Jarace Walker",0,17,19,17,4,18.4
0,0,0,0,0,0,0,0,0,"00",0,0,0,0,0,0,1038175,"2024-01-18T00:00:00.000Z",26,FALSE,12,3547245,"G",12,12,"Indiana Pacers","Tyrese Haliburton",0,0,0,0,0,0
0,0,0,0,0,0,0,0,0,"00",0,0,0,0,0,0,1038175,"2024-01-18T00:00:00.000Z",26,FALSE,12,38017507,"G-F",12,12,"Indiana Pacers","Andrew Nembhard",0,0,0,0,0,0
0,0,0,0,0,0,0,0,0,"00",0,0,0,0,0,0,1038175,"2024-01-18T00:00:00.000Z",26,FALSE,12,3547250,"G-F",12,12,"Indiana Pacers","Aaron Nesmith",0,0,0,0,0,0
0,0,0,0,0,0,0,0,0,"00",0,0,0,0,0,0,1038175,"2024-01-18T00:00:00.000Z",26,FALSE,12,416,"F",28,12,"Indiana Pacers","Pascal Siakam",0,0,0,0,0,0
0,0,0,0,0,0,0,0,0,"00",0,0,0,0,0,0,1038175,"2024-01-18T00:00:00.000Z",26,FALSE,12,56677794,"G",12,12,"Indiana Pacers","Isaiah Wong",0,0,0,0,0,0
0,1,1,1,0,1,0,0,0,"11",1,2,0,2,2,1,1038173,"2024-01-18T00:00:00.000Z",29,FALSE,21,38017706,"F",21,21,"Oklahoma City Thunder","Jaylin Williams",3,2,2,0,2,10.4
2,0,3,3,1,7,4,0,0,"17",1,2,9,4,1,1,1038173,"2024-01-18T00:00:00.000Z",29,FALSE,21,480,"G-F",21,21,"Oklahoma City Thunder","Kenrich Williams",1,13,15,11,6,18.8
0,0,0,0,0,0,0,0,0,"00",0,0,0,0,0,0,1038173,"2024-01-18T00:00:00.000Z",29,FALSE,21,38017716,"F",21,21,"Oklahoma City Thunder","Ousmane Dieng",0,0,0,0,0,0
0,0,0,0,0,0,0,0,0,"00",0,0,0,0,0,0,1038173,"2024-01-18T00:00:00.000Z",29,FALSE,21,666541,"G",21,21,"Oklahoma City Thunder","Luguentz Dort",0,0,0,0,0,0
0,0,0,0,0,0,0,0,0,"00",0,0,0,0,0,0,1038173,"2024-01-18T00:00:00.000Z",29,FALSE,21,56677853,"F",21,21,"Oklahoma City Thunder","Keyontae Johnson",0,0,0,0,0,0
2,0,3,7,2,9,4,2,2,"29",2,2,12,5,1,1,1038173,"2024-01-18T00:00:00.000Z",29,FALSE,21,38017739,"F",29,29,"Utah Jazz","Simone Fontecchio",1,17,19,14,7,23
4,0,9,4,2,13,7,11,10,"36",1,0,26,10,1,1,1038173,"2024-01-18T00:00:00.000Z",29,FALSE,21,297,"F",29,29,"Utah Jazz","Lauri Markkanen",1,36,40,30,14,46
1,1,4,5,1,11,7,6,6,"24",0,5,21,4,0,2,1038173,"2024-01-18T00:00:00.000Z",29,FALSE,21,101,"F-C",29,29,"Utah Jazz","John Collins",1,25,26,22,5,28.3
7,0,0,7,4,19,10,10,7,"34",1,4,31,1,1,2,1038173,"2024-01-18T00:00:00.000Z",29,FALSE,21,413,"G",29,29,"Utah Jazz","Collin Sexton",1,32,39,38,8,43.7
6,0,1,0,0,2,0,0,0,"13",0,4,0,1,0,1,1038173,"2024-01-18T00:00:00.000Z",29,FALSE,21,139,"G",29,29,"Utah Jazz","Kris Dunn",0,1,7,6,7,9.2
5,0,0,5,3,18,7,1,1,"35",2,1,18,2,0,1,1038173,"2024-01-18T00:00:00.000Z",29,FALSE,21,100,"G",29,29,"Utah Jazz","Jordan Clarkson",0,20,25,23,7,26.9
2,0,1,2,1,5,1,0,0,"14",0,0,3,1,0,2,1038173,"2024-01-18T00:00:00.000Z",29,FALSE,21,56677834,"G",29,29,"Utah Jazz","Keyonte George",0,4,6,5,3,5.2
0,0,0,0,0,0,0,0,0,"00",0,0,0,0,0,0,1038173,"2024-01-18T00:00:00.000Z",29,FALSE,21,56677824,"F",29,29,"Utah Jazz","Taylor Hendricks",0,0,0,0,0,0
0,0,0,0,0,0,0,0,0,"00",0,0,0,0,0,0,1038173,"2024-01-18T00:00:00.000Z",29,FALSE,21,666650,"G",29,29,"Utah Jazz","Talen Horton-Tucker",0,0,0,0,0,0
4,0,2,2,0,7,3,1,1,"17",0,3,7,2,1,1,1038173,"2024-01-18T00:00:00.000Z",29,FALSE,21,358,"F",29,29,"Utah Jazz","Kelly Olynyk",1,9,13,11,6,17.4
0,0,0,0,0,0,0,0,0,"00",0,0,0,0,0,0,1038173,"2024-01-18T00:00:00.000Z",29,FALSE,21,666881,"F",29,29,"Utah Jazz","Luka Samanic",0,0,0,0,0,0
0,0,0,0,0,0,0,0,0,"00",0,0,0,0,0,0,1038173,"2024-01-18T00:00:00.000Z",29,FALSE,21,56677842,"F",29,29,"Utah Jazz","Brice Sensabaugh",0,0,0,0,0,0
0,0,0,0,0,0,0,0,0,"00",0,0,0,0,0,0,1038173,"2024-01-18T00:00:00.000Z",29,FALSE,21,11891374,"C",29,29,"Utah Jazz","Omer Yurtseven",0,0,0,0,0,0
0,0,0,0,0,0,0,0,0,"00",0,0,0,0,0,0,1038173,"2024-01-18T00:00:00.000Z",29,FALSE,21,38017630,"G",29,29,"Utah Jazz","Johnny Juzang",0,0,0,0,0,0
0,0,0,0,0,0,0,0,0,"00",0,0,0,0,0,0,1038173,"2024-01-18T00:00:00.000Z",29,FALSE,21,19465584,"F",29,29,"Utah Jazz","Micah Potter",0,0,0,0,0,0
0,0,0,0,0,0,0,0,0,"00",0,0,0,0,0,0,1038173,"2024-01-18T00:00:00.000Z",29,FALSE,21,17896042,"G",13,29,"Utah Jazz","Jason Preston",0,0,0,0,0,0
1,1,2,5,4,7,6,0,0,"32",2,3,16,4,1,1,1038173,"2024-01-18T00:00:00.000Z",29,FALSE,21,56677833,"G",21,21,"Oklahoma City Thunder","Cason Wallace",2,20,21,17,5,27.3
8,2,3,5,4,14,11,2,1,"37",0,6,27,3,2,2,1038173,"2024-01-18T00:00:00.000Z",29,FALSE,21,38017703,"G-F",21,21,"Oklahoma City Thunder","Jalen Williams",4,30,38,35,11,52.6
6,1,5,1,0,15,8,17,15,"35",1,4,31,6,1,4,1038173,"2024-01-18T00:00:00.000Z",29,FALSE,21,175,"G",21,21,"Oklahoma City Thunder","Shai Gilgeous-Alexander",2,37,43,37,12,49.2
1,0,1,4,2,4,2,0,0,"12",1,1,6,2,0,0,1038173,"2024-01-18T00:00:00.000Z",29,FALSE,21,3547272,"G",21,21,"Oklahoma City Thunder","Isaiah Joe",0,8,9,7,3,9.9
5,1,2,1,0,3,1,2,2,"22",0,3,4,2,0,0,1038173,"2024-01-18T00:00:00.000Z",29,FALSE,21,17896078,"G",21,21,"Oklahoma City Thunder","Aaron Wiggins",1,6,11,9,7,16.9
1,0,0,1,0,1,0,0,0,"03",0,1,0,0,0,0,1038173,"2024-01-18T00:00:00.000Z",29,FALSE,21,27924547,"F",21,21,"Oklahoma City Thunder","Lindy Waters III",0,0,1,1,1,1.5
1,0,0,0,0,2,2,2,2,"09",0,1,6,0,0,1,1038173,"2024-01-18T00:00:00.000Z",29,FALSE,21,4197029,"G",21,21,"Oklahoma City Thunder","Vasilije Micic",0,6,7,7,1,6.5
0,0,0,0,0,0,0,0,0,"00",0,0,0,0,0,0,1038173,"2024-01-18T00:00:00.000Z",29,FALSE,21,44,"F",21,21,"Oklahoma City Thunder","Davis Bertans",0,0,0,0,0,0
0,0,0,0,0,0,0,0,0,"00",0,0,0,0,0,0,1038173,"2024-01-18T00:00:00.000Z",29,FALSE,21,17896036,"G",21,21,"Oklahoma City Thunder","Tre Mann",0,0,0,0,0,0
0,0,0,0,0,0,0,0,0,"00",0,0,0,0,0,0,1038173,"2024-01-18T00:00:00.000Z",29,FALSE,21,3547271,"C",21,21,"Oklahoma City Thunder","Aleksej Pokusevski",0,0,0,0,0,0
0,0,0,0,0,0,0,0,0,"00",0,0,0,0,0,0,1038173,"2024-01-18T00:00:00.000Z",29,FALSE,21,24572055,"C",21,21,"Oklahoma City Thunder","Olivier Sarr",0,0,0,0,0,0
5,4,5,6,2,16,6,2,1,"32",0,3,15,5,0,3,1038173,"2024-01-18T00:00:00.000Z",29,FALSE,21,38017685,"C-F",21,21,"Oklahoma City Thunder","Chet Holmgren",4,20,25,20,10,37.5
6,0,9,5,1,16,8,3,3,"30",1,3,20,10,1,2,1038173,"2024-01-18T00:00:00.000Z",29,FALSE,21,17896065,"G",21,21,"Oklahoma City Thunder","Josh Giddey",1,30,36,26,16,42
1,3,6,0,0,4,3,2,1,"24",5,1,7,11,1,1,1038173,"2024-01-18T00:00:00.000Z",29,FALSE,21,38017705,"C",29,29,"Utah Jazz","Walker Kessler",4,18,19,8,12,32.7
1,0,1,0,0,1,1,3,2,"14",0,1,4,1,2,2,1038173,"2024-01-18T00:00:00.000Z",29,FALSE,21,38017620,"G",29,29,"Utah Jazz","Ochai Agbaji",2,5,6,5,2,10.7
0,1,2,2,1,9,5,0,0,"36",1,0,11,3,1,2,1038174,"2024-01-18T00:00:00.000Z",18,FALSE,15,3547259,"F",18,18,"Minnesota Timberwolves","Jaden McDaniels",2,14,14,11,3,18.6
2,1,7,5,2,12,5,3,2,"29",0,2,14,7,0,1,1038174,"2024-01-18T00:00:00.000Z",18,FALSE,15,447,"C",18,18,"Minnesota Timberwolves","Karl-Anthony Towns",1,21,23,16,9,27.4
4,6,7,1,0,10,5,10,7,"39",3,3,17,10,0,3,1038174,"2024-01-18T00:00:00.000Z",18,FALSE,15,176,"C",18,18,"Minnesota Timberwolves","Rudy Gobert",6,27,31,21,14,50
5,0,5,6,1,19,11,6,5,"34",0,2,28,5,1,3,1038174,"2024-01-18T00:00:00.000Z",18,FALSE,15,3547238,"G",18,18,"Minnesota Timberwolves","Anthony Edwards",1,33,38,33,10,41.5
10,0,2,6,3,11,7,0,0,"30",2,1,17,4,2,0,1038174,"2024-01-18T00:00:00.000Z",18,FALSE,15,104,"G",18,18,"Minnesota Timberwolves","Mike Conley",2,21,31,27,14,42.8
5,0,2,3,1,5,3,0,0,"24",0,0,7,2,0,2,1038174,"2024-01-18T00:00:00.000Z",18,FALSE,15,666400,"G",18,18,"Minnesota Timberwolves","Nickeil Alexander-Walker",0,9,14,12,7,14.9
3,0,3,0,0,3,1,2,2,"15",0,3,4,3,1,1,1038174,"2024-01-18T00:00:00.000Z",18,FALSE,15,12,"F",18,18,"Minnesota Timberwolves","Kyle Anderson",1,7,10,7,6,14.1
0,0,0,0,0,0,0,0,0,"00",0,0,0,0,0,0,1038174,"2024-01-18T00:00:00.000Z",18,FALSE,15,68,"F",18,18,"Minnesota Timberwolves","Troy Brown Jr.",0,0,0,0,0,0
0,0,0,0,0,0,0,0,0,"01",0,0,0,0,0,0,1038174,"2024-01-18T00:00:00.000Z",18,FALSE,15,17896056,"C",18,18,"Minnesota Timberwolves","Luka Garza",0,0,0,0,0,0
0,0,1,2,0,3,0,2,1,"10",2,2,1,3,0,1,1038174,"2024-01-18T00:00:00.000Z",18,FALSE,15,56677830,"F",15,15,"Memphis Grizzlies","GG Jackson",0,4,4,1,3,3.6
0,0,0,0,0,0,0,0,0,"00",0,0,0,0,0,0,1038174,"2024-01-18T00:00:00.000Z",18,FALSE,15,38017728,"F",15,15,"Memphis Grizzlies","Jake LaRavia",0,0,0,0,0,0
1,0,3,2,1,7,2,4,3,"23",1,2,8,4,0,0,1038174,"2024-01-18T00:00:00.000Z",18,FALSE,15,38017729,"F",15,15,"Memphis Grizzlies","David Roddy",0,12,13,9,5,14.3
0,0,0,0,0,0,0,0,0,"00",0,0,0,0,0,0,1038174,"2024-01-18T00:00:00.000Z",18,FALSE,15,401,"G",15,15,"Memphis Grizzlies","Derrick Rose",0,0,0,0,0,0
2,0,1,2,0,5,1,0,0,"12",0,1,2,1,2,2,1038174,"2024-01-18T00:00:00.000Z",18,FALSE,15,17896027,"G-F",15,15,"Memphis Grizzlies","Ziaire Williams",2,3,5,4,3,10.2
0,0,0,0,0,0,0,0,0,"00",0,0,0,0,0,0,1038174,"2024-01-18T00:00:00.000Z",18,FALSE,15,3,"C",15,15,"Memphis Grizzlies","Steven Adams",0,0,0,0,0,0
0,0,0,0,0,0,0,0,0,"00",0,0,0,0,0,0,1038174,"2024-01-18T00:00:00.000Z",18,FALSE,15,3547287,"G",15,15,"Memphis Grizzlies","Desmond Bane",0,0,0,0,0,0
0,0,0,0,0,0,0,0,0,"00",0,0,0,0,0,0,1038174,"2024-01-18T00:00:00.000Z",18,FALSE,15,666505,"F",15,15,"Memphis Grizzlies","Brandon Clarke",0,0,0,0,0,0
0,0,0,0,0,0,0,0,0,"00",0,0,0,0,0,0,1038174,"2024-01-18T00:00:00.000Z",18,FALSE,15,666786,"G",15,15,"Memphis Grizzlies","Ja Morant",0,0,0,0,0,0
0,0,0,0,0,0,0,0,0,"00",0,0,0,0,0,0,1038174,"2024-01-18T00:00:00.000Z",18,FALSE,15,38017656,"G",14,15,"Memphis Grizzlies","Scotty Pippen Jr.",0,0,0,0,0,0
0,0,0,0,0,0,0,0,0,"00",0,0,0,0,0,0,1038174,"2024-01-18T00:00:00.000Z",18,FALSE,15,420,"G",15,15,"Memphis Grizzlies","Marcus Smart",0,0,0,0,0,0
0,0,2,0,0,0,0,0,0,"07",0,0,0,2,1,2,1038174,"2024-01-18T00:00:00.000Z",18,FALSE,15,666767,"G",18,18,"Minnesota Timberwolves","Jordan McLaughlin",1,2,2,0,2,3.4
0,0,0,0,0,0,0,0,0,"00",0,0,0,0,0,0,1038174,"2024-01-18T00:00:00.000Z",18,FALSE,15,320,"G",18,18,"Minnesota Timberwolves","Shake Milton",0,0,0,0,0,0
0,0,0,0,0,0,0,0,0,"01",0,0,0,0,0,0,1038174,"2024-01-18T00:00:00.000Z",18,FALSE,15,38017700,"G",18,18,"Minnesota Timberwolves","Wendell Moore Jr.",0,0,0,0,0,0
1,1,3,5,4,13,8,0,0,"24",0,2,20,3,2,0,1038174,"2024-01-18T00:00:00.000Z",18,FALSE,15,667378,"F-C",18,18,"Minnesota Timberwolves","Naz Reid",3,23,24,21,4,34.1
0,0,0,0,0,0,0,0,0,"00",0,0,0,0,0,0,1038174,"2024-01-18T00:00:00.000Z",18,FALSE,15,56677851,"G",18,18,"Minnesota Timberwolves","Jaylen Clark",0,0,0,0,0,0
0,0,0,0,0,0,0,0,0,"00",0,0,0,0,0,0,1038174,"2024-01-18T00:00:00.000Z",18,FALSE,15,56677782,"F",18,18,"Minnesota Timberwolves","Leonard Miller",0,0,0,0,0,0
0,0,0,0,0,0,0,0,0,"00",0,0,0,0,0,0,1038174,"2024-01-18T00:00:00.000Z",18,FALSE,15,38017715,"F",18,18,"Minnesota Timberwolves","Josh Minott",0,0,0,0,0,0
3,0,1,2,0,3,0,0,0,"13",0,0,0,1,0,0,1038174,"2024-01-18T00:00:00.000Z",18,FALSE,15,48248287,"G",15,15,"Memphis Grizzlies","Jacob Gilyard",0,1,4,3,4,5.7
0,0,0,0,0,0,0,0,0,"00",0,0,0,0,0,0,1038174,"2024-01-18T00:00:00.000Z",18,FALSE,15,17895968,"F",18,18,"Minnesota Timberwolves","Daishen Nix",0,0,0,0,0,0
5,1,5,5,2,8,3,2,2,"35",2,3,10,7,3,2,1038174,"2024-01-18T00:00:00.000Z",18,FALSE,15,38017731,"G",15,15,"Memphis Grizzlies","Vince Williams Jr.",4,17,22,15,12,35.9
1,1,2,6,3,23,15,5,3,"27",1,5,36,3,0,3,1038174,"2024-01-18T00:00:00.000Z",18,FALSE,15,231,"F-C",15,15,"Memphis Grizzlies","Jaren Jackson Jr.",1,39,40,37,4,41.1
6,1,3,2,0,11,5,0,0,"36",2,1,10,5,1,2,1038174,"2024-01-18T00:00:00.000Z",18,FALSE,15,3547285,"F",15,15,"Memphis Grizzlies","Xavier Tillman",2,15,21,16,11,29
2,0,3,1,1,2,2,0,0,"27",0,4,5,3,1,1,1038174,"2024-01-18T00:00:00.000Z",18,FALSE,15,666703,"G-F",15,15,"Memphis Grizzlies","John Konchar",1,8,10,7,5,13.6
2,0,2,7,5,9,6,1,1,"32",0,1,18,2,1,1,1038174,"2024-01-18T00:00:00.000Z",18,FALSE,15,254,"G",15,15,"Memphis Grizzlies","Luke Kennard",1,20,22,20,4,25.4
0,1,5,5,2,14,5,3,1,"25",0,4,13,5,1,2,1038174,"2024-01-18T00:00:00.000Z",18,FALSE,15,17896067,"F",15,15,"Memphis Grizzlies","Santi Aldama",2,18,18,13,5,23
3,2,3,4,1,28,14,11,8,"43",1,2,37,4,1,1,1038182,"2024-01-19T00:00:00.000Z",25,FALSE,12,182,"F",25,25,"Portland Trail Blazers","Jerami Grant",3,41,44,40,7,54.3
3,1,10,2,0,11,4,6,5,"41",2,3,13,12,0,0,1038182,"2024-01-19T00:00:00.000Z",25,FALSE,12,38017711,"F",25,25,"Portland Trail Blazers","Jabari Walker",1,25,28,16,15,34.9
1,2,6,0,0,15,6,0,0,"30",2,1,12,8,0,1,1038182,"2024-01-19T00:00:00.000Z",25,FALSE,12,22,"C",25,25,"Portland Trail Blazers","Deandre Ayton",2,20,21,13,9,28.1
2,2,1,1,0,2,1,2,2,"28",0,3,4,1,1,0,1038182,"2024-01-19T00:00:00.000Z",25,FALSE,12,666923,"G-F",25,25,"Portland Trail Blazers","Matisse Thybulle",3,5,7,6,3,17.2
6,1,6,4,2,18,9,10,10,"37",1,3,30,7,1,1,1038182,"2024-01-19T00:00:00.000Z",25,FALSE,12,65,"G",25,25,"Portland Trail Blazers","Malcolm Brogdon",2,37,43,36,13,52.4
0,0,0,0,0,0,0,0,0,"00",0,0,0,0,0,0,1038182,"2024-01-19T00:00:00.000Z",25,FALSE,12,39613724,"C",25,25,"Portland Trail Blazers","Ibou Badji",0,0,0,0,0,0
0,0,3,0,0,3,1,2,2,"19",1,2,4,4,0,1,1038182,"2024-01-19T00:00:00.000Z",25,FALSE,12,56677850,"F",25,25,"Portland Trail Blazers","Toumani Camara",0,8,8,4,4,7.8
1,1,2,0,0,4,4,2,2,"08",0,2,10,2,0,2,1038182,"2024-01-19T00:00:00.000Z",25,FALSE,12,56677747,"G",25,25,"Portland Trail Blazers","Scoot Henderson",1,12,13,11,3,14.9
0,0,0,0,0,0,0,0,0,"00",0,0,0,0,0,0,1038182,"2024-01-19T00:00:00.000Z",25,FALSE,12,56677829,"G-F",25,25,"Portland Trail Blazers","Rayan Rupert",0,0,0,0,0,0
0,0,0,0,0,0,0,0,0,"00",0,0,0,0,0,0,1038182,"2024-01-19T00:00:00.000Z",25,FALSE,12,666476,"C",25,25,"Portland Trail Blazers","Moses Brown",0,0,0,0,0,0
0,0,0,0,0,0,0,0,0,"00",0,0,0,0,0,0,1038182,"2024-01-19T00:00:00.000Z",25,FALSE,12,38017690,"G",25,25,"Portland Trail Blazers","Shaedon Sharpe",0,0,0,0,0,0
0,0,0,0,0,0,0,0,0,"00",0,0,0,0,0,0,1038182,"2024-01-19T00:00:00.000Z",25,FALSE,12,419,"G",25,25,"Portland Trail Blazers","Anfernee Simons",0,0,0,0,0,0
0,0,0,0,0,0,0,0,0,"00",0,0,0,0,0,0,1038182,"2024-01-19T00:00:00.000Z",25,FALSE,12,476,"C-F",25,25,"Portland Trail Blazers","Robert Williams III",0,0,0,0,0,0
2,0,3,4,3,9,4,2,1,"28",1,6,12,4,0,2,1038182,"2024-01-19T00:00:00.000Z",25,FALSE,12,3547250,"G-F",12,12,"Indiana Pacers","Aaron Nesmith",0,16,18,14,6,17.8
3,1,6,3,1,14,9,6,2,"34",0,5,21,6,1,1,1038182,"2024-01-19T00:00:00.000Z",25,FALSE,12,416,"F",28,12,"Indiana Pacers","Pascal Siakam",2,27,30,24,9,37.7
1,5,10,10,6,17,10,3,3,"34",2,3,29,12,0,1,1038182,"2024-01-19T00:00:00.000Z",25,FALSE,12,452,"C-F",12,12,"Indiana Pacers","Myles Turner",5,41,42,30,13,58.9
0,0,0,0,0,0,0,0,0,"00",0,0,0,0,0,0,1038182,"2024-01-19T00:00:00.000Z",25,FALSE,12,38017701,"G",12,12,"Indiana Pacers","Kendall Brown",0,0,0,0,0,0
0,0,1,3,1,4,1,0,0,"11",0,1,3,1,1,0,1038182,"2024-01-19T00:00:00.000Z",25,FALSE,12,56677861,"G",12,12,"Indiana Pacers","Ben Sheppard",1,4,4,3,1,7.2
0,0,1,0,0,0,0,0,0,"02",0,0,0,1,0,0,1038182,"2024-01-19T00:00:00.000Z",25,FALSE,12,47957121,"F",25,25,"Portland Trail Blazers","Justin Minaya",0,1,1,0,1,1.2
0,0,3,1,1,2,2,0,0,"14",0,1,5,3,0,3,1038182,"2024-01-19T00:00:00.000Z",25,FALSE,12,56677791,"F",25,25,"Portland Trail Blazers","Kris Murray",0,8,8,5,3,5.6
2,2,3,0,0,1,1,2,1,"18",2,4,3,5,0,0,1038182,"2024-01-19T00:00:00.000Z",25,FALSE,12,56783340,"C",25,25,"Portland Trail Blazers","Duop Reath",2,8,10,5,7,18
0,0,0,0,0,0,0,0,0,"00",0,0,0,0,0,0,1038182,"2024-01-19T00:00:00.000Z",25,FALSE,12,17896035,"F",12,12,"Indiana Pacers","Isaiah Jackson",0,0,0,0,0,0
0,0,0,0,0,0,0,0,0,"00",0,0,0,0,0,0,1038182,"2024-01-19T00:00:00.000Z",25,FALSE,12,242,"F",12,12,"Indiana Pacers","James Johnson",0,0,0,0,0,0
0,0,0,0,0,0,0,0,0,"00",0,0,0,0,0,0,1038182,"2024-01-19T00:00:00.000Z",25,FALSE,12,38017507,"G-F",12,12,"Indiana Pacers","Andrew Nembhard",0,0,0,0,0,0
2,0,0,3,0,3,0,0,0,"11",0,2,0,0,0,2,1038182,"2024-01-19T00:00:00.000Z",25,FALSE,12,3547243,"F",12,12,"Indiana Pacers","Obi Toppin",0,0,2,2,2,1
0,0,0,0,0,0,0,0,0,"00",0,0,0,0,0,0,1038182,"2024-01-19T00:00:00.000Z",25,FALSE,12,56677778,"F-C",12,12,"Indiana Pacers","Oscar Tshiebwe",0,0,0,0,0,0
0,0,0,0,0,0,0,0,0,"00",0,0,0,0,0,0,1038182,"2024-01-19T00:00:00.000Z",25,FALSE,12,56677832,"F",12,12,"Indiana Pacers","Jarace Walker",0,0,0,0,0,0
0,0,0,0,0,0,0,0,0,"00",0,0,0,0,0,0,1038182,"2024-01-19T00:00:00.000Z",25,FALSE,12,56677794,"G",12,12,"Indiana Pacers","Isaiah Wong",0,0,0,0,0,0
7,0,5,11,6,13,6,0,0,"36",1,4,18,6,1,1,1038182,"2024-01-19T00:00:00.000Z",25,FALSE,12,210,"G",12,12,"Indiana Pacers","Buddy Hield",1,24,31,25,13,37.7
17,0,2,7,2,14,6,9,7,"35",0,1,21,2,0,0,1038182,"2024-01-19T00:00:00.000Z",25,FALSE,12,3547245,"G",12,12,"Indiana Pacers","Tyrese Haliburton",0,23,40,38,19,48.9
0,0,3,5,0,8,0,3,2,"24",0,1,2,3,0,3,1038182,"2024-01-19T00:00:00.000Z",25,FALSE,12,38017686,"G-F",12,12,"Indiana Pacers","Bennedict Mathurin",0,5,5,2,3,2.6
2,0,0,0,0,4,1,0,0,"13",0,1,2,0,0,2,1038182,"2024-01-19T00:00:00.000Z",25,FALSE,12,304,"G",12,12,"Indiana Pacers","T.J. McConnell",0,2,4,4,2,3
0,0,1,1,1,5,2,2,2,"14",2,2,7,3,0,1,1038182,"2024-01-19T00:00:00.000Z",25,FALSE,12,3547264,"F-C",12,12,"Indiana Pacers","Jalen Smith",0,10,10,7,3,9.6
2,0,3,4,2,7,3,2,2,"29",0,1,10,3,1,3,1038183,"2024-01-19T00:00:00.000Z",14,FALSE,3,383,"F",14,14,"Los Angeles Lakers","Taurean Prince",1,13,15,12,5,16.6
5,0,6,5,2,22,9,5,4,"34",5,1,24,11,0,4,1038183,"2024-01-19T00:00:00.000Z",14,FALSE,3,237,"F",14,14,"Los Angeles Lakers","LeBron James",0,35,40,29,16,40.7
6,2,8,1,0,13,9,11,8,"35",4,1,26,12,3,1,1038183,"2024-01-19T00:00:00.000Z",14,FALSE,3,117,"F-C",14,14,"Los Angeles Lakers","Anthony Davis",5,38,44,32,18,63.4
5,0,3,6,0,12,4,1,1,"33",0,2,9,3,1,0,1038183,"2024-01-19T00:00:00.000Z",14,FALSE,3,17553995,"G",14,14,"Los Angeles Lakers","Austin Reaves",1,12,17,14,8,23.1
7,0,1,5,3,14,7,3,3,"35",0,4,20,1,1,2,1038183,"2024-01-19T00:00:00.000Z",14,FALSE,3,405,"G",14,14,"Los Angeles Lakers","D'Angelo Russell",1,21,28,27,8,32.7
1,0,2,3,2,3,2,0,0,"19",0,1,6,2,0,1,1038183,"2024-01-19T00:00:00.000Z",14,FALSE,3,38017697,"G",14,14,"Los Angeles Lakers","Max Christie",0,8,9,7,3,8.9
1,0,1,3,0,6,0,0,0,"16",1,0,0,2,0,1,1038183,"2024-01-19T00:00:00.000Z",14,FALSE,3,666609,"F",14,14,"Los Angeles Lakers","Rui Hachimura",0,2,3,1,3,2.9
0,0,0,1,0,1,0,0,0,"03",0,0,0,0,0,0,1038183,"2024-01-19T00:00:00.000Z",14,FALSE,3,666626,"C",14,14,"Los Angeles Lakers","Jaxson Hayes",0,0,0,0,0,0
1,0,1,0,0,1,0,0,0,"03",0,1,0,1,0,1,1038183,"2024-01-19T00:00:00.000Z",14,FALSE,3,56677835,"G",14,14,"Los Angeles Lakers","Jalen Hood-Schifino",0,1,2,1,2,1.7
0,0,0,0,0,0,0,0,0,"03",0,0,0,0,0,0,1038183,"2024-01-19T00:00:00.000Z",14,FALSE,3,56677836,"F",14,14,"Los Angeles Lakers","Maxwell Lewis",0,0,0,0,0,0
0,0,5,2,2,5,5,0,0,"19",0,0,12,5,0,0,1038183,"2024-01-19T00:00:00.000Z",14,FALSE,3,457,"F",14,14,"Los Angeles Lakers","Jarred Vanderbilt",0,17,17,12,5,18
3,1,4,3,1,6,1,2,2,"11",0,0,5,4,1,1,1038183,"2024-01-19T00:00:00.000Z",14,FALSE,3,486,"F",14,14,"Los Angeles Lakers","Christian Wood",2,9,12,8,7,19.3
0,0,0,0,0,0,0,0,0,"00",0,0,0,0,0,0,1038183,"2024-01-19T00:00:00.000Z",14,FALSE,3,56677738,"C",14,14,"Los Angeles Lakers","Colin Castleton",0,0,0,0,0,0
0,0,0,0,0,0,0,0,0,"00",0,0,0,0,0,0,1038183,"2024-01-19T00:00:00.000Z",14,FALSE,3,3547289,"G",25,14,"Los Angeles Lakers","Skylar Mays",0,0,0,0,0,0
0,0,0,0,0,0,0,0,0,"00",0,0,0,0,0,0,1038183,"2024-01-19T00:00:00.000Z",14,FALSE,3,666860,"F-G",14,14,"Los Angeles Lakers","Cameron Reddish",0,0,0,0,0,0
0,0,0,0,0,0,0,0,0,"00",0,0,0,0,0,0,1038183,"2024-01-19T00:00:00.000Z",14,FALSE,3,1603383,"G",14,14,"Los Angeles Lakers","Gabe Vincent",0,0,0,0,0,0
0,0,0,0,0,0,0,0,0,"00",0,0,0,0,0,0,1038183,"2024-01-19T00:00:00.000Z",14,FALSE,3,666971,"G-F",20,14,"Los Angeles Lakers","Dylan Windler",0,0,0,0,0,0
1,2,3,5,0,8,1,2,1,"28",1,4,3,4,1,0,1038183,"2024-01-19T00:00:00.000Z",14,FALSE,3,158,"F",3,3,"Brooklyn Nets","Dorian Finney-Smith",3,7,8,4,5,18.3
5,0,1,4,2,9,4,0,0,"23",3,1,10,4,1,0,1038183,"2024-01-19T00:00:00.000Z",14,FALSE,3,666679,"F",3,3,"Brooklyn Nets","Cameron Johnson",1,14,19,15,9,25.3
1,2,12,0,0,16,11,0,0,"33",2,3,22,14,1,0,1038183,"2024-01-19T00:00:00.000Z",14,FALSE,3,666508,"F-C",3,3,"Brooklyn Nets","Nicolas Claxton",3,36,37,23,15,49.3
5,0,1,8,4,11,6,2,1,"35",0,1,17,1,2,2,1038183,"2024-01-19T00:00:00.000Z",14,FALSE,3,61,"F",3,3,"Brooklyn Nets","Mikal Bridges",2,18,23,22,6,29.7
4,0,3,8,4,11,5,5,5,"33",0,1,19,3,1,1,1038183,"2024-01-19T00:00:00.000Z",14,FALSE,3,130,"G",3,3,"Brooklyn Nets","Spencer Dinwiddie",1,22,26,23,7,30.6
3,0,1,4,3,7,6,0,0,"13",0,2,15,1,0,1,1038183,"2024-01-19T00:00:00.000Z",14,FALSE,3,464,"G",3,3,"Brooklyn Nets","Lonnie Walker IV",0,16,19,18,4,19.7
0,0,0,0,0,0,0,0,0,"00",0,0,0,0,0,0,1038183,"2024-01-19T00:00:00.000Z",14,FALSE,3,17896038,"C",3,3,"Brooklyn Nets","Day'Ron Sharpe",0,0,0,0,0,0
0,0,0,1,0,2,0,0,0,"04",1,0,0,1,0,0,1038183,"2024-01-19T00:00:00.000Z",14,FALSE,3,17896058,"F",3,3,"Brooklyn Nets","Trendon Watford",0,1,1,0,1,1.2
4,0,3,7,4,18,13,4,3,"32",0,2,33,3,1,1,1038183,"2024-01-19T00:00:00.000Z",14,FALSE,3,17896048,"G",3,3,"Brooklyn Nets","Cam Thomas",1,36,40,37,7,44.6
3,0,7,5,0,5,0,0,0,"17",0,1,0,7,1,0,1038183,"2024-01-19T00:00:00.000Z",14,FALSE,3,351,"F",3,3,"Brooklyn Nets","Royce O'Neale",1,7,10,3,10,15.9
0,0,1,1,0,1,0,0,0,"05",0,0,0,1,0,1,1038183,"2024-01-19T00:00:00.000Z",14,FALSE,3,174,"F-C",3,3,"Brooklyn Nets","Harry Giles III",0,1,1,0,1,0.2
5,0,1,4,2,7,4,1,1,"17",1,2,11,2,2,2,1038183,"2024-01-19T00:00:00.000Z",14,FALSE,3,421,"G",3,3,"Brooklyn Nets","Dennis Smith Jr.",2,13,18,16,7,24.9
0,0,0,0,0,0,0,0,0,"00",0,0,0,0,0,0,1038183,"2024-01-19T00:00:00.000Z",14,FALSE,3,56677722,"F",3,3,"Brooklyn Nets","Jalen Wilson",0,0,0,0,0,0
0,0,0,0,0,0,0,0,0,"00",0,0,0,0,0,0,1038183,"2024-01-19T00:00:00.000Z",14,FALSE,3,56677843,"F",3,3,"Brooklyn Nets","Noah Clowney",0,0,0,0,0,0
0,0,0,0,0,0,0,0,0,"00",0,0,0,0,0,0,1038183,"2024-01-19T00:00:00.000Z",14,FALSE,3,17896041,"G",3,3,"Brooklyn Nets","Keon Johnson",0,0,0,0,0,0
0,0,0,0,0,0,0,0,0,"00",0,0,0,0,0,0,1038183,"2024-01-19T00:00:00.000Z",14,FALSE,3,417,"G-F",3,3,"Brooklyn Nets","Ben Simmons",0,0,0,0,0,0
0,0,0,0,0,0,0,0,0,"00",0,0,0,0,0,0,1038183,"2024-01-19T00:00:00.000Z",14,FALSE,3,56677841,"F",3,3,"Brooklyn Nets","Dariq Whitehead",0,0,0,0,0,0
2,0,6,7,4,14,8,5,4,"35",3,0,24,9,2,3,1038176,"2024-01-19T00:00:00.000Z",4,FALSE,27,56677823,"F",4,4,"Charlotte Hornets","Brandon Miller",2,33,35,26,11,40.8
3,1,6,2,2,15,10,1,1,"39",0,3,23,6,0,2,1038176,"2024-01-19T00:00:00.000Z",4,FALSE,27,62,"F",4,4,"Charlotte Hornets","Miles Bridges",1,29,32,26,9,35.7
0,0,5,4,3,11,7,3,3,"28",1,4,20,6,1,2,1038176,"2024-01-19T00:00:00.000Z",4,FALSE,27,666950,"F",4,4,"Charlotte Hornets","P.J. Washington",1,26,26,20,6,28.2
8,0,5,7,1,18,7,2,2,"34",1,0,17,6,1,3,1038176,"2024-01-19T00:00:00.000Z",4,FALSE,27,403,"G",4,4,"Charlotte Hornets","Terry Rozier",1,23,31,25,14,36.2
8,0,0,6,4,13,10,5,4,"32",1,4,28,1,3,4,1038176,"2024-01-19T00:00:00.000Z",4,FALSE,27,3547239,"G",4,4,"Charlotte Hornets","LaMelo Ball",3,29,37,36,9,46.2
0,0,0,0,0,0,0,0,0,"00",0,0,0,0,0,0,1038176,"2024-01-19T00:00:00.000Z",4,FALSE,27,56677866,"F",4,4,"Charlotte Hornets","Leaky Black",0,0,0,0,0,0
0,0,0,0,0,0,0,0,0,"00",0,0,0,0,0,0,1038176,"2024-01-19T00:00:00.000Z",4,FALSE,27,17896037,"G",4,4,"Charlotte Hornets","James Bouknight",0,0,0,0,0,0
3,1,2,1,1,5,2,0,0,"25",1,3,5,3,2,2,1038176,"2024-01-19T00:00:00.000Z",4,FALSE,27,666748,"F",4,4,"Charlotte Hornets","Cody Martin",3,8,11,8,6,20.1
1,2,1,0,0,1,0,0,0,"20",2,1,0,3,0,0,1038176,"2024-01-19T00:00:00.000Z",4,FALSE,27,NA,NA,NA,4,"Charlotte Hornets","NA NA",2,3,4,1,4,11.1
0,0,0,0,0,0,0,0,0,"00",0,0,0,0,0,0,1038176,"2024-01-19T00:00:00.000Z",4,FALSE,27,347,"G",4,4,"Charlotte Hornets","Frank Ntilikina",0,0,0,0,0,0
0,0,0,0,0,0,0,0,0,"00",0,0,0,0,0,0,1038176,"2024-01-19T00:00:00.000Z",4,FALSE,27,422,"G",4,4,"Charlotte Hornets","Ish Smith",0,0,0,0,0,0
0,0,3,2,1,6,2,0,0,"18",1,1,5,4,0,1,1038176,"2024-01-19T00:00:00.000Z",4,FALSE,27,56677846,"G",4,4,"Charlotte Hornets","Nick Smith Jr.",0,9,9,5,4,8.8
0,0,2,0,0,1,1,0,0,"09",0,0,2,2,0,0,1038176,"2024-01-19T00:00:00.000Z",4,FALSE,27,18678001,"F",4,4,"Charlotte Hornets","JT Thor",0,4,4,2,2,4.4
0,0,0,0,0,0,0,0,0,"00",0,0,0,0,0,0,1038176,"2024-01-19T00:00:00.000Z",4,FALSE,27,56677848,"G",4,4,"Charlotte Hornets","Amari Bailey",0,0,0,0,0,0
0,0,0,0,0,0,0,0,0,"00",0,0,0,0,0,0,1038176,"2024-01-19T00:00:00.000Z",4,FALSE,27,204,"F",4,4,"Charlotte Hornets","Gordon Hayward",0,0,0,0,0,0
0,0,0,0,0,0,0,0,0,"00",0,0,0,0,0,0,1038176,"2024-01-19T00:00:00.000Z",4,FALSE,27,38017708,"G",4,4,"Charlotte Hornets","Bryce McGowens",0,0,0,0,0,0
0,0,0,0,0,0,0,0,0,"00",0,0,0,0,0,0,1038176,"2024-01-19T00:00:00.000Z",4,FALSE,27,3547282,"C",4,4,"Charlotte Hornets","Nick Richards",0,0,0,0,0,0
0,0,0,0,0,0,0,0,0,"00",0,0,0,0,0,0,1038176,"2024-01-19T00:00:00.000Z",4,FALSE,27,38017698,"C",4,4,"Charlotte Hornets","Mark Williams",0,0,0,0,0,0
3,1,1,4,1,7,4,0,0,"19",1,0,9,2,1,0,1038176,"2024-01-19T00:00:00.000Z",4,FALSE,27,38017649,"F",27,27,"San Antonio Spurs","Julian Champagnie",2,11,14,12,5,21.9
8,1,6,2,1,10,5,1,0,"34",2,2,11,8,1,3,1038176,"2024-01-19T00:00:00.000Z",4,FALSE,27,38017699,"F",27,27,"San Antonio Spurs","Jeremy Sochan",2,19,27,19,16,35.6
4,0,2,3,1,10,6,6,3,"26",2,5,16,4,1,4,1038176,"2024-01-19T00:00:00.000Z",4,FALSE,27,102,"F-C",27,27,"San Antonio Spurs","Zach Collins",1,20,24,20,8,25.8
7,0,5,8,4,13,6,2,1,"36",0,1,17,5,2,2,1038176,"2024-01-19T00:00:00.000Z",4,FALSE,27,3547246,"G-F",27,27,"San Antonio Spurs","Devin Vassell",2,22,29,24,12,37.5
4,0,2,3,2,11,6,2,2,"32",0,2,16,2,3,1,1038176,"2024-01-19T00:00:00.000Z",4,FALSE,27,3547274,"G",27,27,"San Antonio Spurs","Tre Jones",3,18,22,20,6,32.4
2,1,2,1,1,6,5,1,1,"19",2,0,12,4,0,1,1038176,"2024-01-19T00:00:00.000Z",4,FALSE,27,38017730,"F",27,27,"San Antonio Spurs","Dominick Barlow",1,16,18,14,6,21.8
0,0,1,0,0,0,0,0,0,"08",0,0,0,1,0,0,1038176,"2024-01-19T00:00:00.000Z",4,FALSE,27,38017692,"F",27,27,"San Antonio Spurs","Malaki Branham",0,1,1,0,1,1.2
0,0,0,0,0,0,0,0,0,"00",0,0,0,0,0,0,1038176,"2024-01-19T00:00:00.000Z",4,FALSE,27,3547163,"F",6,27,"San Antonio Spurs","Mamadi Diakite",0,0,0,0,0,0
0,0,0,0,0,0,0,0,0,"00",0,0,0,0,0,0,1038176,"2024-01-19T00:00:00.000Z",4,FALSE,27,180,"G",27,27,"San Antonio Spurs","Devonte' Graham",0,0,0,0,0,0
3,0,4,8,4,15,9,4,3,"29",0,3,25,4,0,1,1038176,"2024-01-19T00:00:00.000Z",4,FALSE,27,666682,"F",27,27,"San Antonio Spurs","Keldon Johnson",0,29,32,28,7,33.3
0,0,0,0,0,0,0,0,0,"00",0,0,0,0,0,0,1038176,"2024-01-19T00:00:00.000Z",4,FALSE,27,17896059,"F",27,27,"San Antonio Spurs","Sandro Mamukelashvili",0,0,0,0,0,0
2,0,0,1,0,2,0,0,0,"09",0,0,0,0,1,1,1038176,"2024-01-19T00:00:00.000Z",4,FALSE,27,305,"F",27,27,"San Antonio Spurs","Doug McDermott",1,0,2,2,2,5
1,0,3,1,1,4,2,0,0,"13",0,1,5,3,0,0,1038176,"2024-01-19T00:00:00.000Z",4,FALSE,27,359,"F",27,27,"San Antonio Spurs","Cedi Osman",0,8,9,6,4,10.1
2,0,1,1,0,6,4,1,1,"15",0,3,9,1,0,0,1038176,"2024-01-19T00:00:00.000Z",4,FALSE,27,38017693,"G",27,27,"San Antonio Spurs","Blake Wesley",0,10,12,11,3,13.2
0,0,0,0,0,0,0,0,0,"00",0,0,0,0,0,0,1038176,"2024-01-19T00:00:00.000Z",4,FALSE,27,17895854,"G",27,27,"San Antonio Spurs","Charles Bassey",0,0,0,0,0,0
0,0,0,0,0,0,0,0,0,"00",0,0,0,0,0,0,1038176,"2024-01-19T00:00:00.000Z",4,FALSE,27,56677817,"G",27,27,"San Antonio Spurs","Sidy Cissoko",0,0,0,0,0,0
0,0,0,0,0,0,0,0,0,"00",0,0,0,0,0,0,1038176,"2024-01-19T00:00:00.000Z",4,FALSE,27,17896049,"G",3,27,"San Antonio Spurs","David Duke Jr.",0,0,0,0,0,0
0,0,0,0,0,0,0,0,0,"00",0,0,0,0,0,0,1038176,"2024-01-19T00:00:00.000Z",4,FALSE,27,56677822,"F-C",27,27,"San Antonio Spurs","Victor Wembanyama",0,0,0,0,0,0
0,0,0,2,0,3,0,0,0,"15",2,0,0,2,0,1,1038177,"2024-01-19T00:00:00.000Z",22,FALSE,23,38017724,"G",22,22,"Orlando Magic","Caleb Houstan",0,2,2,0,2,1.4
6,0,7,1,0,12,5,4,4,"32",1,0,14,8,0,3,1038177,"2024-01-19T00:00:00.000Z",22,FALSE,23,38017683,"F",22,22,"Orlando Magic","Paolo Banchero",0,22,28,20,14,29.6
1,1,2,1,0,2,1,0,0,"16",0,4,2,2,1,1,1038177,"2024-01-19T00:00:00.000Z",22,FALSE,23,666442,"C",22,22,"Orlando Magic","Goga Bitadze",2,4,5,3,3,10.9
0,0,1,1,1,4,3,2,1,"20",0,3,8,1,1,1,1038177,"2024-01-19T00:00:00.000Z",22,FALSE,23,666818,"F",22,22,"Orlando Magic","Chuma Okeke",1,9,9,8,1,11.2
2,1,2,5,2,13,5,4,4,"25",0,1,16,2,1,1,1038177,"2024-01-19T00:00:00.000Z",22,FALSE,23,17896073,"G",22,22,"Orlando Magic","Jalen Suggs",2,18,20,18,4,26.4
3,0,1,1,0,5,0,3,3,"21",0,3,3,1,0,4,1038177,"2024-01-19T00:00:00.000Z",22,FALSE,23,3547251,"G",22,22,"Orlando Magic","Cole Anthony",0,4,7,6,4,4.7
3,1,3,2,1,2,1,4,4,"13",0,2,7,3,0,0,1038177,"2024-01-19T00:00:00.000Z",22,FALSE,23,56677827,"G",22,22,"Orlando Magic","Anthony Black",1,10,13,10,6,18.1
0,0,5,2,1,13,9,7,6,"26",6,4,25,11,0,3,1038177,"2024-01-19T00:00:00.000Z",22,FALSE,23,85,"F",22,22,"Orlando Magic","Wendell Carter Jr.",0,36,36,25,11,35.2
3,0,0,0,0,6,3,1,1,"22",1,3,7,1,0,1,1038177,"2024-01-19T00:00:00.000Z",22,FALSE,23,165,"G",22,22,"Orlando Magic","Markelle Fultz",0,8,11,10,4,11.7
0,0,1,0,0,0,0,0,0,"03",0,1,0,1,0,1,1038177,"2024-01-19T00:00:00.000Z",22,FALSE,23,38017607,"G",22,22,"Orlando Magic","Kevon Harris",0,1,1,0,1,0.2
0,0,0,2,1,3,2,0,0,"03",0,0,5,0,0,0,1038177,"2024-01-19T00:00:00.000Z",22,FALSE,23,56677839,"G",22,22,"Orlando Magic","Jett Howard",0,5,5,5,0,5
3,0,1,3,3,6,3,0,0,"22",0,2,9,1,0,0,1038177,"2024-01-19T00:00:00.000Z",22,FALSE,23,226,"F",22,22,"Orlando Magic","Joe Ingles",0,10,13,12,4,14.7
1,1,2,3,1,7,3,0,0,"13",1,0,7,3,0,0,1038177,"2024-01-19T00:00:00.000Z",22,FALSE,23,229,"F",22,22,"Orlando Magic","Jonathan Isaac",1,10,11,8,4,15.1
0,0,0,0,0,1,1,0,0,"03",0,0,2,0,0,0,1038177,"2024-01-19T00:00:00.000Z",22,FALSE,23,17553983,"G",22,22,"Orlando Magic","Trevelin Queen",0,2,2,2,0,2
2,0,0,0,0,1,1,2,2,"06",0,0,4,0,0,0,1038177,"2024-01-19T00:00:00.000Z",22,FALSE,23,462,"C",22,22,"Orlando Magic","Moritz Wagner",0,4,6,6,2,7
0,0,0,0,0,0,0,0,0,"00",0,0,0,0,0,0,1038177,"2024-01-19T00:00:00.000Z",22,FALSE,23,196,"G",22,22,"Orlando Magic","Gary Harris",0,0,0,0,0,0
0,0,0,0,0,0,0,0,0,"00",0,0,0,0,0,0,1038177,"2024-01-19T00:00:00.000Z",22,FALSE,23,666885,"F",22,22,"Orlando Magic","Admiral Schofield",0,0,0,0,0,0
0,0,0,0,0,0,0,0,0,"00",0,0,0,0,0,0,1038177,"2024-01-19T00:00:00.000Z",22,FALSE,23,17896026,"F",22,22,"Orlando Magic","Franz Wagner",0,0,0,0,0,0
5,0,0,2,1,2,1,0,0,"20",2,4,3,2,0,0,1038177,"2024-01-19T00:00:00.000Z",22,FALSE,23,33,"F-G",23,23,"Philadelphia 76ers","Nicolas Batum",0,5,10,8,7,12.9
3,1,4,3,1,10,3,5,5,"35",1,3,12,5,3,0,1038177,"2024-01-19T00:00:00.000Z",22,FALSE,23,200,"F",23,23,"Philadelphia 76ers","Tobias Harris",4,17,20,15,8,34.5
5,1,1,10,4,20,10,9,8,"34",2,1,32,3,3,2,1038177,"2024-01-19T00:00:00.000Z",22,FALSE,23,3547254,"G",23,23,"Philadelphia 76ers","Tyrese Maxey",4,35,40,37,8,53.1
4,2,5,3,1,7,2,0,0,"28",1,1,5,6,1,1,1038177,"2024-01-19T00:00:00.000Z",22,FALSE,23,45,"G",23,23,"Philadelphia 76ers","Patrick Beverley",3,11,15,9,10,26.2
0,0,0,0,0,0,0,2,1,"02",0,1,1,0,0,0,1038177,"2024-01-19T00:00:00.000Z",22,FALSE,23,56913527,"G",23,23,"Philadelphia 76ers","Ricky Council IV",0,1,1,1,0,1
1,0,0,1,0,1,0,0,0,"11",0,1,0,0,0,0,1038177,"2024-01-19T00:00:00.000Z",22,FALSE,23,2175,"",23,23,"Philadelphia 76ers","Danuel House Jr.",0,0,1,1,1,1.5
0,0,5,2,0,10,5,0,0,"26",4,1,10,9,0,2,1038177,"2024-01-19T00:00:00.000Z",22,FALSE,23,328,"F",23,23,"Philadelphia 76ers","Marcus Morris",0,19,19,10,9,18.8
0,0,2,1,0,3,1,0,0,"15",3,4,2,5,0,1,1038177,"2024-01-19T00:00:00.000Z",22,FALSE,23,3547270,"F",23,23,"Philadelphia 76ers","Paul Reed",0,7,7,2,5,7
2,0,6,2,1,22,12,11,11,"31",1,1,36,7,4,1,1038177,"2024-01-19T00:00:00.000Z",22,FALSE,23,145,"F-C",23,23,"Philadelphia 76ers","Joel Embiid",4,43,45,38,9,58.4
2,1,3,4,3,8,5,2,2,"32",1,5,15,4,0,0,1038177,"2024-01-19T00:00:00.000Z",22,FALSE,23,360,"F",23,23,"Philadelphia 76ers","Kelly Oubre Jr.",1,19,21,17,6,25.8
0,0,0,0,0,0,0,0,0,"00",0,0,0,0,0,0,1038177,"2024-01-19T00:00:00.000Z",22,FALSE,23,38017732,"F",15,23,"Philadelphia 76ers","Kenneth Lofton Jr.",0,0,0,0,0,0
0,0,0,0,0,0,0,0,0,"00",0,0,0,0,0,0,1038177,"2024-01-19T00:00:00.000Z",22,FALSE,23,313,"G",23,23,"Philadelphia 76ers","De'Anthony Melton",0,0,0,0,0,0
0,0,0,0,0,0,0,0,0,"00",0,0,0,0,0,0,1038177,"2024-01-19T00:00:00.000Z",22,FALSE,23,17896025,"G",23,23,"Philadelphia 76ers","Jaden Springer",0,0,0,0,0,0
0,0,0,0,0,0,0,0,0,"00",0,0,0,0,0,0,1038177,"2024-01-19T00:00:00.000Z",22,FALSE,23,108,"F",23,23,"Philadelphia 76ers","Robert Covington",0,0,0,0,0,0
1,0,0,0,0,0,0,0,0,"02",0,0,0,0,0,0,1038177,"2024-01-19T00:00:00.000Z",22,FALSE,23,260,"G-F",23,23,"Philadelphia 76ers","Furkan Korkmaz",0,0,1,1,1,1.5
0,0,0,0,0,1,1,0,0,"02",0,1,2,0,0,0,1038177,"2024-01-19T00:00:00.000Z",22,FALSE,23,3547294,"F",23,23,"Philadelphia 76ers","Kenyon Martin Jr.",0,2,2,2,0,2
0,0,0,2,2,2,2,0,0,"02",0,0,6,0,0,0,1038177,"2024-01-19T00:00:00.000Z",22,FALSE,23,56677788,"G",23,23,"Philadelphia 76ers","Terquavion Smith",0,6,6,6,0,6
0,0,0,0,0,0,0,0,0,"00",0,0,0,0,0,0,1038177,"2024-01-19T00:00:00.000Z",22,FALSE,23,28,"C",23,23,"Philadelphia 76ers","Mo Bamba",0,0,0,0,0,0
1,0,2,9,1,19,6,2,0,"36",0,3,13,2,2,0,1038178,"2024-01-19T00:00:00.000Z",2,FALSE,8,70,"G",2,2,"Boston Celtics","Jaylen Brown",2,15,16,14,3,22.9
5,0,6,8,1,24,9,3,3,"39",2,1,22,8,1,0,1038178,"2024-01-19T00:00:00.000Z",2,FALSE,8,434,"F",2,2,"Boston Celtics","Jayson Tatum",1,30,35,27,13,42.1
2,1,4,5,3,11,6,8,6,"36",4,4,21,8,0,0,1038178,"2024-01-19T00:00:00.000Z",2,FALSE,8,378,"F-C",2,2,"Boston Celtics","Kristaps Porzingis",1,29,31,23,10,36.6
5,1,2,12,5,18,9,1,1,"36",1,3,24,3,2,1,1038178,"2024-01-19T00:00:00.000Z",2,FALSE,8,473,"G",2,2,"Boston Celtics","Derrick White",3,27,32,29,8,43.1
3,0,1,3,1,7,3,0,0,"30",1,0,7,2,0,1,1038178,"2024-01-19T00:00:00.000Z",2,FALSE,8,214,"G",2,2,"Boston Celtics","Jrue Holiday",0,9,12,10,5,12.9
0,0,0,0,0,0,0,0,0,"00",0,0,0,0,0,0,1038178,"2024-01-19T00:00:00.000Z",2,FALSE,8,17896094,"G",2,2,"Boston Celtics","Dalano Banton",0,0,0,0,0,0
0,0,0,0,0,0,0,0,0,"00",0,0,0,0,0,0,1038178,"2024-01-19T00:00:00.000Z",2,FALSE,8,666468,"F",2,2,"Boston Celtics","Oshae Brissett",0,0,0,0,0,0
1,0,1,1,0,1,0,0,0,"16",0,2,0,1,0,0,1038178,"2024-01-19T00:00:00.000Z",2,FALSE,8,17896060,"F",2,2,"Boston Celtics","Sam Hauser",0,1,2,1,2,2.7
2,0,7,5,2,5,2,0,0,"27",3,3,6,10,0,0,1038178,"2024-01-19T00:00:00.000Z",2,FALSE,8,219,"C-F",2,2,"Boston Celtics","Al Horford",0,16,18,8,12,21
1,0,2,0,0,2,2,0,0,"08",0,0,4,2,0,0,1038178,"2024-01-19T00:00:00.000Z",2,FALSE,8,261,"F-C",2,2,"Boston Celtics","Luke Kornet",0,6,7,5,3,7.9
0,0,0,0,0,0,0,0,0,"00",0,0,0,0,0,0,1038178,"2024-01-19T00:00:00.000Z",2,FALSE,8,338,"G",2,2,"Boston Celtics","Svi Mykhailiuk",0,0,0,0,0,0
0,0,0,0,0,0,0,0,0,"00",0,0,0,0,0,0,1038178,"2024-01-19T00:00:00.000Z",2,FALSE,8,38017707,"G",2,2,"Boston Celtics","JD Davison",0,0,0,0,0,0
0,0,0,0,0,0,0,0,0,"00",0,0,0,0,0,0,1038178,"2024-01-19T00:00:00.000Z",2,FALSE,8,NA,NA,NA,2,"Boston Celtics","NA NA",0,0,0,0,0,0
0,0,0,0,0,0,0,0,0,"00",0,0,0,0,0,0,1038178,"2024-01-19T00:00:00.000Z",2,FALSE,8,56677864,"G",2,2,"Boston Celtics","Jordan Walsh",0,0,0,0,0,0
0,0,4,4,1,9,5,3,2,"37",4,3,13,8,0,1,1038178,"2024-01-19T00:00:00.000Z",2,FALSE,8,375,"F",8,8,"Denver Nuggets","Michael Porter Jr.",0,21,21,13,8,21.6
3,1,8,3,0,6,0,3,2,"41",2,3,2,10,0,1,1038178,"2024-01-19T00:00:00.000Z",2,FALSE,8,177,"F",8,8,"Denver Nuggets","Aaron Gordon",1,12,15,5,13,20.5
9,0,10,4,2,22,14,4,4,"38",2,1,34,12,0,4,1038178,"2024-01-19T00:00:00.000Z",2,FALSE,8,246,"C",8,8,"Denver Nuggets","Nikola Jokic",0,46,55,43,21,57.9
1,0,4,3,1,6,2,0,0,"37",1,1,5,5,0,0,1038178,"2024-01-19T00:00:00.000Z",2,FALSE,8,81,"G",8,8,"Denver Nuggets","Kentavious Caldwell-Pope",0,10,11,6,6,12.5
0,0,0,2,0,2,0,0,0,"05",0,0,0,0,0,0,1038178,"2024-01-19T00:00:00.000Z",2,FALSE,8,38017709,"G",8,8,"Denver Nuggets","Christian Braun",0,0,0,0,0,0
0,0,0,0,0,0,0,0,0,"00",0,0,0,0,0,0,1038178,"2024-01-19T00:00:00.000Z",2,FALSE,8,38017727,"G",8,8,"Denver Nuggets","Collin Gillespie",0,0,0,0,0,0
0,0,0,0,0,0,0,0,0,"03",0,0,0,0,0,0,1038178,"2024-01-19T00:00:00.000Z",2,FALSE,8,215,"F-G",8,8,"Denver Nuggets","Justin Holiday",0,0,0,0,0,0
0,0,0,0,0,0,0,0,0,"00",0,0,0,0,0,0,1038178,"2024-01-19T00:00:00.000Z",2,FALSE,8,17896103,"F-C",8,8,"Denver Nuggets","Jay Huff",0,0,0,0,0,0
2,0,1,2,0,4,2,0,0,"21",1,0,4,2,0,2,1038178,"2024-01-19T00:00:00.000Z",2,FALSE,8,236,"G",8,8,"Denver Nuggets","Reggie Jackson",0,6,8,6,4,7.4
0,0,0,0,0,0,0,0,0,"00",0,0,0,0,0,0,1038178,"2024-01-19T00:00:00.000Z",2,FALSE,8,250,"C",8,8,"Denver Nuggets","DeAndre Jordan",0,0,0,0,0,0
0,0,0,0,0,0,0,0,0,"00",0,0,0,0,0,0,1038178,"2024-01-19T00:00:00.000Z",2,FALSE,8,17896007,"G",8,8,"Denver Nuggets","Braxton Key",0,0,0,0,0,0
0,0,0,0,0,0,0,0,0,"00",0,0,0,0,0,0,1038178,"2024-01-19T00:00:00.000Z",2,FALSE,8,3547268,"F-C",8,8,"Denver Nuggets","Zeke Nnaji",0,0,0,0,0,0
0,0,0,0,0,0,0,0,0,"00",0,0,0,0,0,0,1038178,"2024-01-19T00:00:00.000Z",2,FALSE,8,56677871,"F",8,8,"Denver Nuggets","Hunter Tyson",0,0,0,0,0,0
0,2,2,6,1,11,4,0,0,"21",0,2,9,2,0,0,1038178,"2024-01-19T00:00:00.000Z",2,FALSE,8,38017721,"G",8,8,"Denver Nuggets","Peyton Watson",2,11,11,9,2,17.4
0,0,0,0,0,0,0,0,0,"00",0,0,0,0,0,0,1038178,"2024-01-19T00:00:00.000Z",2,FALSE,8,666489,"F",8,8,"Denver Nuggets","Vlatko Cancar",0,0,0,0,0,0
0,0,0,0,0,0,0,0,0,"00",0,0,0,0,0,0,1038178,"2024-01-19T00:00:00.000Z",2,FALSE,8,56677582,"G",8,8,"Denver Nuggets","Jalen Pickett",0,0,0,0,0,0
0,0,0,0,0,0,0,0,0,"00",0,0,0,0,0,0,1038178,"2024-01-19T00:00:00.000Z",2,FALSE,8,3547279,"F",2,2,"Boston Celtics","Lamar Stevens",0,0,0,0,0,0
1,0,1,1,1,2,1,0,0,"12",1,1,3,2,0,0,1038178,"2024-01-19T00:00:00.000Z",2,FALSE,8,3547276,"G",2,2,"Boston Celtics","Payton Pritchard",0,5,6,4,3,6.9
0,0,0,0,0,0,0,0,0,"00",0,0,0,0,0,0,1038178,"2024-01-19T00:00:00.000Z",2,FALSE,8,17553967,"C",2,2,"Boston Celtics","Neemias Queta",0,0,0,0,0,0
5,0,8,7,3,21,15,3,2,"37",0,3,35,8,0,1,1038178,"2024-01-19T00:00:00.000Z",2,FALSE,8,335,"G",8,8,"Denver Nuggets","Jamal Murray",0,43,48,40,13,51.1
0,0,0,0,0,0,0,0,0,"00",0,0,0,0,0,0,1038178,"2024-01-19T00:00:00.000Z",2,FALSE,8,56677776,"G",8,8,"Denver Nuggets","Julian Strawther",0,0,0,0,0,0
0,1,6,0,0,4,2,7,5,"22",5,2,9,11,0,0,1038179,"2024-01-19T00:00:00.000Z",16,FALSE,1,83,"C",1,1,"Atlanta Hawks","Clint Capela",1,20,20,9,11,25.2
1,0,3,7,3,15,6,2,2,"35",0,2,17,3,0,3,1038179,"2024-01-19T00:00:00.000Z",16,FALSE,1,53,"G",1,1,"Atlanta Hawks","Bogdan Bogdanovic",0,20,21,18,4,19.1
11,0,3,7,3,22,9,1,1,"40",0,2,22,3,2,2,1038179,"2024-01-19T00:00:00.000Z",16,FALSE,1,334,"G",1,1,"Atlanta Hawks","Dejounte Murray",2,25,36,33,14,46.1
0,0,0,0,0,0,0,0,0,"00",0,0,0,0,0,0,1038179,"2024-01-19T00:00:00.000Z",16,FALSE,1,666564,"F",1,1,"Atlanta Hawks","Bruno Fernando",0,0,0,0,0,0
3,0,1,2,1,4,1,0,0,"10",0,0,3,1,0,1,1038179,"2024-01-19T00:00:00.000Z",16,FALSE,1,3547297,"G",1,1,"Atlanta Hawks","Trent Forrest",0,4,7,6,4,7.7
0,0,0,0,0,0,0,0,0,"00",0,0,0,0,0,0,1038179,"2024-01-19T00:00:00.000Z",16,FALSE,1,38017689,"F",1,1,"Atlanta Hawks","AJ Griffin",0,0,0,0,0,0
0,0,0,0,0,0,0,0,0,"00",0,0,0,0,0,0,1038179,"2024-01-19T00:00:00.000Z",16,FALSE,1,56677855,"G",1,1,"Atlanta Hawks","Seth Lundy",0,0,0,0,0,0
3,0,3,4,3,5,3,0,0,"20",0,2,9,3,0,1,1038179,"2024-01-19T00:00:00.000Z",16,FALSE,1,666754,"G",1,1,"Atlanta Hawks","Garrison Mathews",0,12,15,12,6,16.1
2,0,3,5,3,6,4,0,0,"18",0,4,11,3,1,1,1038179,"2024-01-19T00:00:00.000Z",16,FALSE,1,319,"G",1,1,"Atlanta Hawks","Patty Mills",1,14,16,13,5,19.6
6,0,1,0,0,10,8,10,9,"36",4,2,25,5,2,4,1038179,"2024-01-19T00:00:00.000Z",16,FALSE,1,79,"G-F",16,16,"Miami Heat","Jimmy Butler",2,30,36,31,11,42
0,0,1,1,0,5,1,0,0,"15",2,2,2,3,0,0,1038179,"2024-01-19T00:00:00.000Z",16,FALSE,1,38017696,"F",16,16,"Miami Heat","Nikola Jovic",0,5,5,2,3,5.6
6,0,7,0,0,15,7,8,7,"39",2,4,21,9,1,3,1038179,"2024-01-19T00:00:00.000Z",16,FALSE,1,4,"C-F",16,16,"Miami Heat","Bam Adebayo",1,30,36,27,15,40.8
2,0,6,9,4,19,10,1,1,"34",0,4,25,6,1,2,1038179,"2024-01-19T00:00:00.000Z",16,FALSE,1,666633,"G",16,16,"Miami Heat","Tyler Herro",1,31,33,27,8,36.2
0,0,0,0,0,0,0,0,0,"00",0,0,0,0,0,0,1038179,"2024-01-19T00:00:00.000Z",16,FALSE,1,74,"C",16,16,"Miami Heat","Thomas Bryant",0,0,0,0,0,0
0,0,0,1,0,2,0,0,0,"10",0,0,0,0,1,0,1038179,"2024-01-19T00:00:00.000Z",16,FALSE,1,3092,"",16,16,"Miami Heat","Haywood Highsmith",1,0,0,0,0,3
1,1,5,3,2,9,4,0,0,"27",3,1,10,8,0,1,1038179,"2024-01-19T00:00:00.000Z",16,FALSE,1,666747,"F",16,16,"Miami Heat","Caleb Martin",1,18,19,11,9,23.1
1,0,4,3,0,5,0,0,0,"12",1,1,0,5,1,3,1038179,"2024-01-19T00:00:00.000Z",16,FALSE,1,285,"F-C",16,16,"Miami Heat","Kevin Love",1,5,6,1,6,7.5
4,0,2,3,0,4,1,0,0,"24",1,2,2,3,1,1,1038179,"2024-01-19T00:00:00.000Z",16,FALSE,1,286,"G",16,16,"Miami Heat","Kyle Lowry",1,5,9,6,7,13.6
0,1,3,4,2,5,2,3,3,"21",0,1,9,3,0,0,1038179,"2024-01-19T00:00:00.000Z",16,FALSE,1,391,"G-F",16,16,"Miami Heat","Josh Richardson",1,12,12,9,3,15.6
1,0,2,7,4,8,5,0,0,"22",0,0,14,2,0,2,1038179,"2024-01-19T00:00:00.000Z",16,FALSE,1,397,"F",16,16,"Miami Heat","Duncan Robinson",0,16,17,15,3,15.9
0,0,0,0,0,0,0,0,0,"00",0,0,0,0,0,0,1038179,"2024-01-19T00:00:00.000Z",16,FALSE,1,39398582,"C",16,16,"Miami Heat","Orlando Robinson",0,0,0,0,0,0
0,0,0,0,0,0,0,0,0,"00",0,0,0,0,0,0,1038179,"2024-01-19T00:00:00.000Z",16,FALSE,1,38017736,"F",16,16,"Miami Heat","Cole Swider",0,0,0,0,0,0
0,0,0,0,0,0,0,0,0,"00",0,0,0,0,0,0,1038179,"2024-01-19T00:00:00.000Z",16,FALSE,1,38017734,"F",16,16,"Miami Heat","Jamal Cain",0,0,0,0,0,0
0,0,0,0,0,0,0,0,0,"00",0,0,0,0,0,0,1038179,"2024-01-19T00:00:00.000Z",16,FALSE,1,3547257,"G",16,16,"Miami Heat","R.J. Hampton",0,0,0,0,0,0
0,0,0,0,0,0,0,0,0,"00",0,0,0,0,0,0,1038179,"2024-01-19T00:00:00.000Z",16,FALSE,1,56677785,"G",16,16,"Miami Heat","Jaime Jaquez Jr.",0,0,0,0,0,0
0,0,0,0,0,0,0,0,0,"00",0,0,0,0,0,0,1038179,"2024-01-19T00:00:00.000Z",16,FALSE,1,19465585,"G",16,16,"Miami Heat","Dru Smith",0,0,0,0,0,0
1,1,4,1,1,5,4,0,0,"26",1,5,9,5,1,2,1038179,"2024-01-19T00:00:00.000Z",16,FALSE,1,3547244,"F-C",1,1,"Atlanta Hawks","Onyeka Okongwu",2,14,15,10,6,20.5
0,0,0,0,0,0,0,0,0,"00",0,0,0,0,0,0,1038179,"2024-01-19T00:00:00.000Z",16,FALSE,1,56677838,"G",1,1,"Atlanta Hawks","Kobe Bufkin",0,0,0,0,0,0
0,0,0,0,0,0,0,0,0,"00",0,0,0,0,0,0,1038179,"2024-01-19T00:00:00.000Z",16,FALSE,1,56677806,"F",1,1,"Atlanta Hawks","Mouhamed Gueye",0,0,0,0,0,0
0,0,0,0,0,0,0,0,0,"00",0,0,0,0,0,0,1038179,"2024-01-19T00:00:00.000Z",16,FALSE,1,666656,"F",1,1,"Atlanta Hawks","De'Andre Hunter",0,0,0,0,0,0
0,0,0,0,0,0,0,0,0,"00",0,0,0,0,0,0,1038179,"2024-01-19T00:00:00.000Z",16,FALSE,1,4197387,"G",1,1,"Atlanta Hawks","Vit Krejci",0,0,0,0,0,0
0,0,0,0,0,0,0,0,0,"00",0,0,0,0,0,0,1038179,"2024-01-19T00:00:00.000Z",16,FALSE,1,301,"G-F",1,1,"Atlanta Hawks","Wesley Matthews",0,0,0,0,0,0
0,0,0,0,0,0,0,0,0,"00",0,0,0,0,0,0,1038179,"2024-01-19T00:00:00.000Z",16,FALSE,1,490,"G",1,1,"Atlanta Hawks","Trae Young",0,0,0,0,0,0
0,0,1,5,0,12,4,7,6,"36",1,2,14,2,0,1,1038179,"2024-01-19T00:00:00.000Z",16,FALSE,1,3547256,"F",1,1,"Atlanta Hawks","Saddiq Bey",0,16,16,14,2,15.4
2,0,5,4,1,14,7,0,0,"33",2,1,15,7,2,2,1038179,"2024-01-19T00:00:00.000Z",16,FALSE,1,17896040,"F",1,1,"Atlanta Hawks","Jalen Johnson",2,22,24,17,9,30.4
11,0,7,5,1,11,5,9,6,"33",0,2,17,7,0,2,1038180,"2024-01-19T00:00:00.000Z",19,FALSE,24,227,"F",19,19,"New Orleans Pelicans","Brandon Ingram",0,24,35,28,18,39.9
1,1,2,1,1,17,11,3,1,"33",1,2,24,3,0,2,1038180,"2024-01-19T00:00:00.000Z",19,FALSE,24,666969,"F",19,19,"New Orleans Pelicans","Zion Williamson",1,27,28,25,4,30.1
3,0,7,2,0,10,5,6,6,"26",4,3,16,11,0,2,1038180,"2024-01-19T00:00:00.000Z",19,FALSE,24,455,"C",19,19,"New Orleans Pelicans","Jonas Valanciunas",0,27,30,19,14,31.7
2,0,2,6,1,9,4,0,0,"23",1,1,9,3,0,1,1038180,"2024-01-19T00:00:00.000Z",19,FALSE,24,17896024,"F",19,19,"New Orleans Pelicans","Herbert Jones",0,12,14,11,5,14.6
4,2,4,7,1,13,5,3,2,"31",0,1,13,4,0,1,1038180,"2024-01-19T00:00:00.000Z",19,FALSE,24,303,"G",19,19,"New Orleans Pelicans","CJ McCollum",2,17,21,17,8,28.8
2,0,0,3,0,4,1,0,0,"07",0,1,2,0,0,0,1038180,"2024-01-19T00:00:00.000Z",19,FALSE,24,17896097,"G",19,19,"New Orleans Pelicans","Jose Alvarado",0,2,4,4,2,5
1,0,2,1,0,4,1,0,0,"11",1,2,2,3,2,1,1038180,"2024-01-19T00:00:00.000Z",19,FALSE,24,38017677,"G",19,19,"New Orleans Pelicans","Dyson Daniels",2,5,6,3,4,12.1
1,0,2,8,3,11,5,0,0,"17",0,0,13,2,0,1,1038180,"2024-01-19T00:00:00.000Z",19,FALSE,24,56677837,"G",19,19,"New Orleans Pelicans","Jordan Hawkins",0,15,16,14,3,15.9
1,0,0,2,1,4,1,2,2,"13",0,0,5,0,0,1,1038180,"2024-01-19T00:00:00.000Z",19,FALSE,24,3547293,"F",19,19,"New Orleans Pelicans","Naji Marshall",0,5,6,6,1,5.5
1,1,1,5,1,8,2,0,0,"24",1,3,5,2,1,0,1038180,"2024-01-19T00:00:00.000Z",19,FALSE,24,18677986,"F",19,19,"New Orleans Pelicans","Trey Murphy III",2,7,8,6,3,14.9
1,0,5,2,1,2,1,0,0,"18",0,1,3,5,0,0,1038180,"2024-01-19T00:00:00.000Z",19,FALSE,24,340,"F",19,19,"New Orleans Pelicans","Larry Nance Jr.",0,8,9,4,6,10.5
0,1,1,0,0,0,0,0,0,"04",1,0,0,2,1,0,1038180,"2024-01-19T00:00:00.000Z",19,FALSE,24,491,"C",19,19,"New Orleans Pelicans","Cody Zeller",2,2,2,0,2,8.4
0,0,2,1,0,1,0,0,0,"05",0,0,0,2,0,0,1038180,"2024-01-19T00:00:00.000Z",19,FALSE,24,32,"F",24,24,"Phoenix Suns","Keita Bates-Diop",0,2,2,0,2,2.4
0,0,0,0,0,0,0,0,0,"00",0,0,0,0,0,0,1038180,"2024-01-19T00:00:00.000Z",19,FALSE,24,147,"F",24,24,"Phoenix Suns","Drew Eubanks",0,0,0,0,0,0
1,0,0,0,0,2,1,0,0,"04",1,1,2,1,0,1,1038180,"2024-01-19T00:00:00.000Z",19,FALSE,24,18678058,"",24,24,"Phoenix Suns","Jordan Goodwin",0,3,4,3,2,3.7
0,0,2,8,1,9,2,0,0,"26",0,2,5,2,2,0,1038180,"2024-01-19T00:00:00.000Z",19,FALSE,24,178,"G",24,24,"Phoenix Suns","Eric Gordon",2,7,7,5,2,13.4
0,0,0,1,0,1,0,0,0,"04",0,0,0,0,0,0,1038180,"2024-01-19T00:00:00.000Z",19,FALSE,24,666729,"F",24,24,"Phoenix Suns","Nassir Little",0,0,0,0,0,0
1,1,3,1,0,4,0,2,2,"14",1,2,2,4,0,1,1038180,"2024-01-19T00:00:00.000Z",19,FALSE,24,314,"F",24,24,"Phoenix Suns","Chimezie Metu",1,6,7,3,5,10.3
2,0,2,1,1,1,1,2,0,"06",1,0,3,3,0,0,1038180,"2024-01-19T00:00:00.000Z",19,FALSE,24,356,"G",24,24,"Phoenix Suns","Josh Okogie",0,6,8,5,5,9.6
0,0,0,0,0,0,0,0,0,"00",0,0,0,0,0,0,1038180,"2024-01-19T00:00:00.000Z",19,FALSE,24,470,"G",24,24,"Phoenix Suns","Yuta Watanabe",0,0,0,0,0,0
0,0,0,0,0,0,0,0,0,"00",0,0,0,0,0,0,1038180,"2024-01-19T00:00:00.000Z",19,FALSE,24,666451,"C",24,24,"Phoenix Suns","Bol Bol",0,0,0,0,0,0
0,0,0,0,0,0,0,0,0,"00",0,0,0,0,0,0,1038180,"2024-01-19T00:00:00.000Z",19,FALSE,24,272,"G",24,24,"Phoenix Suns","Damion Lee",0,0,0,0,0,0
0,0,0,0,0,0,0,0,0,"00",0,0,0,0,0,0,1038180,"2024-01-19T00:00:00.000Z",19,FALSE,24,3547298,"G",24,24,"Phoenix Suns","Saben Lee",0,0,0,0,0,0
0,0,0,0,0,0,0,0,0,"00",0,0,0,0,0,0,1038180,"2024-01-19T00:00:00.000Z",19,FALSE,24,3547253,"G",4,24,"Phoenix Suns","Theo Maledon",0,0,0,0,0,0
0,0,0,0,0,0,0,0,0,"00",0,0,0,0,0,0,1038180,"2024-01-19T00:00:00.000Z",19,FALSE,24,17896021,"F",19,19,"New Orleans Pelicans","Jeremiah Robinson-Earl",0,0,0,0,0,0
0,0,0,0,0,0,0,0,0,"00",0,0,0,0,0,0,1038180,"2024-01-19T00:00:00.000Z",19,FALSE,24,17896017,"F",19,19,"New Orleans Pelicans","Matt Ryan",0,0,0,0,0,0
0,0,0,0,0,0,0,0,0,"00",0,0,0,0,0,0,1038180,"2024-01-19T00:00:00.000Z",19,FALSE,24,38017726,"G",19,19,"New Orleans Pelicans","Dereon Seabron",0,0,0,0,0,0
6,0,4,6,3,8,4,2,1,"32",0,1,12,4,2,0,1038180,"2024-01-19T00:00:00.000Z",19,FALSE,24,8,"G",24,24,"Phoenix Suns","Grayson Allen",2,16,22,18,10,31.8
2,2,4,8,3,19,11,1,1,"35",1,1,26,5,2,1,1038180,"2024-01-19T00:00:00.000Z",19,FALSE,24,140,"F",24,24,"Phoenix Suns","Kevin Durant",4,31,33,28,7,46
9,0,14,0,0,5,2,2,1,"35",1,3,5,15,1,3,1038180,"2024-01-19T00:00:00.000Z",19,FALSE,24,349,"C",24,24,"Phoenix Suns","Jusuf Nurkic",1,20,29,14,24,36.5
5,0,6,4,1,12,6,0,0,"30",1,4,13,7,0,0,1038180,"2024-01-19T00:00:00.000Z",19,FALSE,24,37,"G",24,24,"Phoenix Suns","Bradley Beal",0,20,25,18,12,28.9
1,0,1,0,0,1,1,2,1,"12",0,3,3,1,0,1,1038180,"2024-01-19T00:00:00.000Z",19,FALSE,24,3547095,"C-F",24,24,"Phoenix Suns","Udoka Azubuike",0,4,5,4,2,4.7
0,0,0,0,0,0,0,0,0,"00",0,0,0,0,0,0,1038180,"2024-01-19T00:00:00.000Z",19,FALSE,24,38017663,"F",19,19,"New Orleans Pelicans","E.J. Liddell",0,0,0,0,0,0
5,0,3,11,6,30,18,10,10,"37",1,0,52,4,0,1,1038180,"2024-01-19T00:00:00.000Z",19,FALSE,24,57,"G",24,24,"Phoenix Suns","Devin Booker",0,56,61,57,9,63.3
4,0,7,3,1,11,7,1,1,"32",0,2,16,7,1,1,1038186,"2024-01-20T00:00:00.000Z",30,FALSE,27,3547242,"F",30,30,"Washington Wizards","Deni Avdija",1,23,27,20,11,32.4
6,0,9,4,0,14,5,1,1,"29",3,0,11,12,1,2,1038186,"2024-01-20T00:00:00.000Z",30,FALSE,27,265,"F",30,30,"Washington Wizards","Kyle Kuzma",1,23,29,17,18,35.4
2,0,5,3,1,19,8,4,4,"36",7,5,21,12,1,2,1038186,"2024-01-20T00:00:00.000Z",30,FALSE,27,24,"F",9,30,"Washington Wizards","Marvin Bagley III",1,33,35,23,14,39.4
2,1,0,3,0,15,7,2,2,"29",0,4,16,0,2,1,1038186,"2024-01-20T00:00:00.000Z",30,FALSE,27,666848,"G",30,30,"Washington Wizards","Jordan Poole",3,16,18,18,2,27
6,0,2,2,1,12,5,2,2,"28",0,2,13,2,1,1,1038186,"2024-01-20T00:00:00.000Z",30,FALSE,27,249,"G",30,30,"Washington Wizards","Tyus Jones",1,15,21,19,8,26.4
0,1,2,3,2,3,2,2,1,"12",0,4,7,2,0,1,1038186,"2024-01-20T00:00:00.000Z",30,FALSE,27,38017704,"F",30,30,"Washington Wizards","Patrick Baldwin Jr.",1,9,9,7,2,11.4
0,0,0,0,0,0,0,0,0,"00",0,0,0,0,0,0,1038186,"2024-01-20T00:00:00.000Z",30,FALSE,27,NA,NA,NA,30,"Washington Wizards","NA NA",0,0,0,0,0,0
0,0,0,0,0,0,0,0,0,"00",0,0,0,0,0,0,1038186,"2024-01-20T00:00:00.000Z",30,FALSE,27,18677954,"G",30,30,"Washington Wizards","Jared Butler",0,0,0,0,0,0
1,1,2,2,2,9,6,2,0,"23",2,1,14,4,0,1,1038186,"2024-01-20T00:00:00.000Z",30,FALSE,27,56677844,"G",30,30,"Washington Wizards","Bilal Coulibaly",1,18,19,15,5,22.3
0,0,0,0,0,0,0,0,0,"00",0,0,0,0,0,0,1038186,"2024-01-20T00:00:00.000Z",30,FALSE,27,3547302,"F",30,30,"Washington Wizards","Anthony Gill",0,0,0,0,0,0
0,0,0,0,0,0,0,0,0,"00",0,0,0,0,0,0,1038186,"2024-01-20T00:00:00.000Z",30,FALSE,27,NA,NA,NA,30,"Washington Wizards","NA NA",0,0,0,0,0,0
2,0,2,6,1,10,4,7,7,"25",0,1,16,2,1,2,1038186,"2024-01-20T00:00:00.000Z",30,FALSE,27,17896045,"F",30,30,"Washington Wizards","Corey Kispert",1,18,20,18,4,22.4
0,0,0,0,0,0,0,0,0,"00",0,0,0,0,0,0,1038186,"2024-01-20T00:00:00.000Z",30,FALSE,27,17896071,"F",9,30,"Washington Wizards","Isaiah Livers",0,0,0,0,0,0
1,0,0,2,1,5,3,0,0,"06",1,2,7,1,0,0,1038186,"2024-01-20T00:00:00.000Z",30,FALSE,27,414,"G",30,30,"Washington Wizards","Landry Shamet",0,8,9,8,2,9.7
4,1,3,1,0,5,2,2,2,"20",1,0,6,4,3,0,1038186,"2024-01-20T00:00:00.000Z",30,FALSE,27,487,"G",30,30,"Washington Wizards","Delon Wright",4,10,14,10,8,28.8
0,0,0,0,0,0,0,0,0,"00",0,0,0,0,0,0,1038186,"2024-01-20T00:00:00.000Z",30,FALSE,27,38017687,"G",30,30,"Washington Wizards","Johnny Davis",0,0,0,0,0,0
0,0,0,0,0,0,0,0,0,"00",0,0,0,0,0,0,1038186,"2024-01-20T00:00:00.000Z",30,FALSE,27,666577,"F",30,30,"Washington Wizards","Daniel Gafford",0,0,0,0,0,0
0,0,0,0,0,0,0,0,0,"00",0,0,0,0,0,0,1038186,"2024-01-20T00:00:00.000Z",30,FALSE,27,17896106,"F",30,30,"Washington Wizards","Eugene Omoruyi",0,0,0,0,0,0
3,2,2,2,1,11,8,6,6,"28",2,4,23,4,1,0,1038186,"2024-01-20T00:00:00.000Z",30,FALSE,27,38017699,"F",27,27,"San Antonio Spurs","Jeremy Sochan",3,27,30,26,7,41.3
0,2,5,6,3,7,4,0,0,"23",2,2,11,7,0,2,1038186,"2024-01-20T00:00:00.000Z",30,FALSE,27,38017649,"F",27,27,"San Antonio Spurs","Julian Champagnie",2,18,18,11,7,23.4
4,6,7,5,2,21,10,4,2,"28",1,3,24,8,0,6,1038186,"2024-01-20T00:00:00.000Z",30,FALSE,27,56677822,"F-C",27,27,"San Antonio Spurs","Victor Wembanyama",6,32,36,28,12,51.6
5,0,5,6,4,14,8,3,1,"34",0,1,21,5,1,4,1038186,"2024-01-20T00:00:00.000Z",30,FALSE,27,3547246,"G-F",27,27,"San Antonio Spurs","Devin Vassell",1,26,31,26,10,33.5
12,0,5,3,0,9,4,3,3,"32",3,0,11,8,3,1,1038186,"2024-01-20T00:00:00.000Z",30,FALSE,27,3547274,"G",27,27,"San Antonio Spurs","Tre Jones",3,19,31,23,20,46.6
4,0,3,3,1,3,1,0,0,"17",0,1,3,3,0,0,1038186,"2024-01-20T00:00:00.000Z",30,FALSE,27,359,"F",27,27,"San Antonio Spurs","Cedi Osman",0,6,10,7,7,12.6
1,0,1,0,0,1,1,0,0,"05",0,1,2,1,0,1,1038186,"2024-01-20T00:00:00.000Z",30,FALSE,27,38017692,"F",27,27,"San Antonio Spurs","Malaki Branham",0,3,4,3,2,3.7
3,0,0,0,0,4,3,0,0,"15",1,1,6,1,1,1,1038186,"2024-01-20T00:00:00.000Z",30,FALSE,27,38017693,"G",27,27,"San Antonio Spurs","Blake Wesley",1,7,10,9,4,13.7
1,0,0,2,1,2,1,0,0,"10",0,2,3,0,0,0,1038186,"2024-01-20T00:00:00.000Z",30,FALSE,27,305,"F",27,27,"San Antonio Spurs","Doug McDermott",0,3,4,4,1,4.5
0,0,0,0,0,0,0,0,0,"00",0,0,0,0,0,0,1038186,"2024-01-20T00:00:00.000Z",30,FALSE,27,38017730,"F",27,27,"San Antonio Spurs","Dominick Barlow",0,0,0,0,0,0
0,0,0,0,0,0,0,0,0,"00",0,0,0,0,0,0,1038186,"2024-01-20T00:00:00.000Z",30,FALSE,27,3547163,"F",6,27,"San Antonio Spurs","Mamadi Diakite",0,0,0,0,0,0
0,0,0,0,0,0,0,0,0,"00",0,0,0,0,0,0,1038186,"2024-01-20T00:00:00.000Z",30,FALSE,27,180,"G",27,27,"San Antonio Spurs","Devonte' Graham",0,0,0,0,0,0
0,0,0,0,0,0,0,0,0,"00",0,0,0,0,0,0,1038186,"2024-01-20T00:00:00.000Z",30,FALSE,27,17896059,"F",27,27,"San Antonio Spurs","Sandro Mamukelashvili",0,0,0,0,0,0
0,0,0,0,0,0,0,0,0,"00",0,0,0,0,0,0,1038186,"2024-01-20T00:00:00.000Z",30,FALSE,27,17895854,"G",27,27,"San Antonio Spurs","Charles Bassey",0,0,0,0,0,0
0,0,0,0,0,0,0,0,0,"00",0,0,0,0,0,0,1038186,"2024-01-20T00:00:00.000Z",30,FALSE,27,56677817,"G",27,27,"San Antonio Spurs","Sidy Cissoko",0,0,0,0,0,0
0,0,0,0,0,0,0,0,0,"00",0,0,0,0,0,0,1038186,"2024-01-20T00:00:00.000Z",30,FALSE,27,17896049,"G",3,27,"San Antonio Spurs","David Duke Jr.",0,0,0,0,0,0
2,0,5,3,0,15,7,7,5,"28",4,2,19,9,0,1,1038186,"2024-01-20T00:00:00.000Z",30,FALSE,27,666682,"F",27,27,"San Antonio Spurs","Keldon Johnson",0,28,30,21,11,31.8
3,0,2,1,0,9,4,0,0,"20",1,2,8,3,0,1,1038186,"2024-01-20T00:00:00.000Z",30,FALSE,27,102,"F-C",27,27,"San Antonio Spurs","Zach Collins",0,11,14,11,6,15.1
2,0,4,6,0,12,0,0,0,"30",3,3,0,7,0,1,1038187,"2024-01-20T00:00:00.000Z",1,FALSE,6,3547256,"F",1,1,"Atlanta Hawks","Saddiq Bey",0,7,9,2,9,10.4
4,2,6,5,1,16,8,6,3,"34",1,2,20,7,1,1,1038187,"2024-01-20T00:00:00.000Z",1,FALSE,6,17896040,"F",1,1,"Atlanta Hawks","Jalen Johnson",3,27,31,24,11,42.4
0,2,4,0,0,8,3,0,0,"22",5,2,6,9,1,2,1038187,"2024-01-20T00:00:00.000Z",1,FALSE,6,83,"C",1,1,"Atlanta Hawks","Clint Capela",3,15,15,6,9,23.8
5,0,9,7,2,19,10,2,2,"35",0,2,24,9,1,2,1038187,"2024-01-20T00:00:00.000Z",1,FALSE,6,334,"G",1,1,"Atlanta Hawks","Dejounte Murray",1,33,38,29,14,43.3
5,0,1,4,3,12,6,0,0,"28",0,2,15,1,0,4,1038187,"2024-01-20T00:00:00.000Z",1,FALSE,6,490,"G",1,1,"Atlanta Hawks","Trae Young",0,16,21,20,6,19.7
4,0,2,6,1,11,5,4,3,"28",0,0,14,2,1,1,1038187,"2024-01-20T00:00:00.000Z",1,FALSE,6,53,"G",1,1,"Atlanta Hawks","Bogdan Bogdanovic",1,16,20,18,6,24.4
1,0,1,1,0,1,0,0,0,"03",0,0,0,1,0,0,1038187,"2024-01-20T00:00:00.000Z",1,FALSE,6,666564,"F",1,1,"Atlanta Hawks","Bruno Fernando",0,1,2,1,2,2.7
0,0,1,0,0,1,0,0,0,"06",0,0,0,1,0,0,1038187,"2024-01-20T00:00:00.000Z",1,FALSE,6,3547297,"G",1,1,"Atlanta Hawks","Trent Forrest",0,1,1,0,1,1.2
0,0,0,1,0,2,1,0,0,"03",0,0,2,0,0,0,1038187,"2024-01-20T00:00:00.000Z",1,FALSE,6,38017689,"F",1,1,"Atlanta Hawks","AJ Griffin",0,2,2,2,0,2
0,0,0,2,1,2,1,0,0,"03",0,0,3,0,0,0,1038187,"2024-01-20T00:00:00.000Z",1,FALSE,6,56677855,"G",1,1,"Atlanta Hawks","Seth Lundy",0,3,3,3,0,3
0,0,0,3,2,3,2,0,0,"10",0,1,6,0,1,0,1038187,"2024-01-20T00:00:00.000Z",1,FALSE,6,319,"G",1,1,"Atlanta Hawks","Patty Mills",1,6,6,6,0,9
2,0,4,0,0,3,0,2,1,"23",2,3,1,6,0,0,1038187,"2024-01-20T00:00:00.000Z",1,FALSE,6,3547244,"F-C",1,1,"Atlanta Hawks","Onyeka Okongwu",0,7,9,3,8,11.2
0,0,0,0,0,0,0,0,0,"03",0,0,0,0,0,0,1038187,"2024-01-20T00:00:00.000Z",1,FALSE,6,248,"C",6,6,"Cleveland Cavaliers","Damian Jones",0,0,0,0,0,0
0,0,0,0,0,0,0,0,0,"00",0,0,0,0,0,0,1038187,"2024-01-20T00:00:00.000Z",1,FALSE,6,277,"G",6,6,"Cleveland Cavaliers","Caris LeVert",0,0,0,0,0,0
0,0,0,0,0,2,0,0,0,"03",0,0,0,0,0,0,1038187,"2024-01-20T00:00:00.000Z",1,FALSE,6,NA,NA,NA,6,"Cleveland Cavaliers","NA NA",0,0,0,0,0,0
2,1,5,8,4,9,5,0,0,"21",0,2,14,5,0,0,1038187,"2024-01-20T00:00:00.000Z",1,FALSE,6,344,"F",6,6,"Cleveland Cavaliers","Georges Niang",1,19,21,16,7,26
3,0,5,1,0,3,1,2,2,"21",0,2,4,5,0,3,1038187,"2024-01-20T00:00:00.000Z",1,FALSE,6,56677872,"G",6,6,"Cleveland Cavaliers","Craig Porter",0,9,12,7,8,11.5
2,1,5,1,0,4,3,0,0,"14",0,0,6,5,0,0,1038187,"2024-01-20T00:00:00.000Z",1,FALSE,6,444,"C-F",6,6,"Cleveland Cavaliers","Tristan Thompson",1,11,13,8,7,18
0,0,0,0,0,0,0,0,0,"00",0,0,0,0,0,0,1038187,"2024-01-20T00:00:00.000Z",1,FALSE,6,56677847,"F",6,6,"Cleveland Cavaliers","Emoni Bates",0,0,0,0,0,0
0,0,0,0,0,0,0,0,0,"00",0,0,0,0,0,0,1038187,"2024-01-20T00:00:00.000Z",1,FALSE,6,666581,"G",6,6,"Cleveland Cavaliers","Darius Garland",0,0,0,0,0,0
0,0,0,0,0,0,0,0,0,"00",0,0,0,0,0,0,1038187,"2024-01-20T00:00:00.000Z",1,FALSE,6,666676,"G",6,6,"Cleveland Cavaliers","Ty Jerome",0,0,0,0,0,0
0,0,0,0,0,0,0,0,0,"00",0,0,0,0,0,0,1038187,"2024-01-20T00:00:00.000Z",1,FALSE,6,17896076,"F-C",6,6,"Cleveland Cavaliers","Evan Mobley",0,0,0,0,0,0
0,0,0,0,0,0,0,0,0,"00",0,0,0,0,0,0,1038187,"2024-01-20T00:00:00.000Z",1,FALSE,6,38017662,"F",6,6,"Cleveland Cavaliers","Isaiah Mobley",0,0,0,0,0,0
2,0,2,3,1,3,1,1,1,"15",0,0,4,2,0,0,1038187,"2024-01-20T00:00:00.000Z",1,FALSE,6,666754,"G",1,1,"Atlanta Hawks","Garrison Mathews",0,6,8,6,4,9.4
0,0,0,0,0,0,0,0,0,"00",0,0,0,0,0,0,1038187,"2024-01-20T00:00:00.000Z",1,FALSE,6,56677838,"G",1,1,"Atlanta Hawks","Kobe Bufkin",0,0,0,0,0,0
0,0,0,0,0,0,0,0,0,"00",0,0,0,0,0,0,1038187,"2024-01-20T00:00:00.000Z",1,FALSE,6,56677806,"F",1,1,"Atlanta Hawks","Mouhamed Gueye",0,0,0,0,0,0
0,0,0,0,0,0,0,0,0,"00",0,0,0,0,0,0,1038187,"2024-01-20T00:00:00.000Z",1,FALSE,6,666656,"F",1,1,"Atlanta Hawks","De'Andre Hunter",0,0,0,0,0,0
0,0,0,0,0,0,0,0,0,"00",0,0,0,0,0,0,1038187,"2024-01-20T00:00:00.000Z",1,FALSE,6,4197387,"G",1,1,"Atlanta Hawks","Vit Krejci",0,0,0,0,0,0
0,0,0,0,0,0,0,0,0,"00",0,0,0,0,0,0,1038187,"2024-01-20T00:00:00.000Z",1,FALSE,6,301,"G-F",1,1,"Atlanta Hawks","Wesley Matthews",0,0,0,0,0,0
2,0,5,3,1,9,5,3,1,"33",0,3,12,5,2,2,1038187,"2024-01-20T00:00:00.000Z",1,FALSE,6,3547247,"F-G",6,6,"Cleveland Cavaliers","Isaac Okoro",2,17,19,14,7,25
0,0,4,6,5,7,6,0,0,"26",1,1,17,5,1,0,1038187,"2024-01-20T00:00:00.000Z",1,FALSE,6,666940,"F",6,6,"Cleveland Cavaliers","Dean Wade",1,22,22,17,5,26
2,3,10,0,0,8,6,2,2,"33",1,2,14,11,3,4,1038187,"2024-01-20T00:00:00.000Z",1,FALSE,6,9,"C",6,6,"Cleveland Cavaliers","Jarrett Allen",6,25,27,16,13,44.2
7,0,1,4,1,10,5,2,2,"20",2,1,13,3,1,2,1038187,"2024-01-20T00:00:00.000Z",1,FALSE,6,666908,"G",6,6,"Cleveland Cavaliers","Max Strus",1,16,23,20,10,28.1
8,1,6,6,0,17,6,6,6,"36",0,3,18,6,0,1,1038187,"2024-01-20T00:00:00.000Z",1,FALSE,6,322,"G",6,6,"Cleveland Cavaliers","Donovan Mitchell",1,24,32,26,14,39.2
6,0,4,14,5,16,6,1,1,"30",0,2,18,4,0,1,1038187,"2024-01-20T00:00:00.000Z",1,FALSE,6,3547299,"G",6,6,"Cleveland Cavaliers","Sam Merrill",0,22,28,24,10,30.8
2,0,1,7,3,15,5,8,6,"32",0,5,19,1,0,1,1038184,"2024-01-20T00:00:00.000Z",9,FALSE,17,54,"F",9,9,"Detroit Pistons","Bojan Bogdanovic",0,20,22,21,3,22.2
0,0,3,2,1,5,1,0,0,"16",0,3,3,3,1,0,1038184,"2024-01-20T00:00:00.000Z",9,FALSE,17,259,"F",9,9,"Detroit Pistons","Kevin Knox",1,6,6,3,3,9.6
1,0,7,0,0,8,4,0,0,"30",2,5,8,9,1,1,1038184,"2024-01-20T00:00:00.000Z",9,FALSE,17,38017694,"C",9,9,"Detroit Pistons","Jalen Duren",1,17,18,9,10,22.3
6,1,4,5,2,16,6,7,4,"32",2,5,18,6,0,3,1038184,"2024-01-20T00:00:00.000Z",9,FALSE,17,38017682,"G",9,9,"Detroit Pistons","Jaden Ivey",1,24,30,24,12,34.2
5,0,1,0,0,3,1,0,0,"18",0,3,2,1,1,1,1038184,"2024-01-20T00:00:00.000Z",9,FALSE,17,3547241,"G",9,9,"Detroit Pistons","Killian Hayes",1,3,8,7,6,12.7
6,0,7,14,7,20,9,8,8,"30",0,2,33,7,1,0,1038184,"2024-01-20T00:00:00.000Z",9,FALSE,17,77,"G",9,9,"Detroit Pistons","Alec Burks",1,40,46,39,13,53.4
3,0,1,1,1,1,1,5,5,"16",0,0,8,1,0,0,1038184,"2024-01-20T00:00:00.000Z",9,FALSE,17,167,"F",30,9,"Detroit Pistons","Danilo Gallinari",0,9,12,11,4,13.7
0,0,0,0,0,0,0,0,0,"00",0,0,0,0,0,0,1038184,"2024-01-20T00:00:00.000Z",9,FALSE,17,197,"F-G",9,9,"Detroit Pistons","Joe Harris",0,0,0,0,0,0
1,0,1,4,4,4,4,2,1,"14",0,2,13,1,1,1,1038184,"2024-01-20T00:00:00.000Z",9,FALSE,17,337,"F-C",30,9,"Detroit Pistons","Mike Muscala",1,14,15,14,2,17.7
5,0,2,2,1,6,3,2,2,"16",0,1,9,2,1,0,1038184,"2024-01-20T00:00:00.000Z",9,FALSE,17,56677792,"G",9,9,"Detroit Pistons","Marcus Sasser",1,11,16,14,7,21.9
0,0,0,0,0,0,0,0,0,"00",0,0,0,0,0,0,1038184,"2024-01-20T00:00:00.000Z",9,FALSE,17,3547267,"F-C",9,9,"Detroit Pistons","Isaiah Stewart",0,0,0,0,0,0
1,1,4,2,2,15,10,0,0,"32",5,4,22,9,0,1,1038184,"2024-01-20T00:00:00.000Z",9,FALSE,17,56677826,"G-F",9,9,"Detroit Pistons","Ausar Thompson",1,31,32,23,10,36.3
0,0,1,0,0,1,0,0,0,"04",0,0,0,1,0,0,1038184,"2024-01-20T00:00:00.000Z",9,FALSE,17,3547240,"C",9,9,"Detroit Pistons","James Wiseman",0,1,1,0,1,1.2
0,0,0,0,0,0,0,0,0,"00",0,0,0,0,0,0,1038184,"2024-01-20T00:00:00.000Z",9,FALSE,17,56677729,"G",9,9,"Detroit Pistons","Malcolm Cazalon",0,0,0,0,0,0
4,2,5,7,3,12,5,6,4,"33",0,4,17,5,1,1,1038184,"2024-01-20T00:00:00.000Z",9,FALSE,17,315,"F",17,17,"Milwaukee Bucks","Khris Middleton",3,22,26,21,9,37
9,1,7,1,0,16,10,22,11,"38",3,1,31,10,2,5,1038184,"2024-01-20T00:00:00.000Z",9,FALSE,17,15,"F",17,17,"Milwaukee Bucks","Giannis Antetokounmpo",3,41,50,40,19,60.5
4,3,8,4,1,13,7,5,4,"37",2,1,19,10,1,0,1038184,"2024-01-20T00:00:00.000Z",9,FALSE,17,283,"C",17,17,"Milwaukee Bucks","Brook Lopez",4,29,33,23,14,49
0,0,0,0,0,0,0,0,0,"00",0,0,0,0,0,0,1038184,"2024-01-20T00:00:00.000Z",9,FALSE,17,17896075,"G-F",9,9,"Detroit Pistons","Cade Cunningham",0,0,0,0,0,0
0,0,0,0,0,0,0,0,0,"00",0,0,0,0,0,0,1038184,"2024-01-20T00:00:00.000Z",9,FALSE,17,330,"G",9,9,"Detroit Pistons","Monte Morris",0,0,0,0,0,0
0,0,0,0,0,0,0,0,0,"00",0,0,0,0,0,0,1038184,"2024-01-20T00:00:00.000Z",9,FALSE,17,42097199,"G",9,9,"Detroit Pistons","Jared Rhoden",0,0,0,0,0,0
0,0,0,0,0,0,0,0,0,"00",0,0,0,0,0,0,1038184,"2024-01-20T00:00:00.000Z",9,FALSE,17,44477024,"G",9,9,"Detroit Pistons","Stanley Umude",0,0,0,0,0,0
1,0,2,4,1,9,5,0,0,"34",0,4,11,2,0,2,1038184,"2024-01-20T00:00:00.000Z",9,FALSE,17,38,"G",17,17,"Milwaukee Bucks","Malik Beasley",0,13,14,12,3,12.9
11,0,6,11,5,22,12,16,16,"37",0,3,45,6,1,1,1038184,"2024-01-20T00:00:00.000Z",9,FALSE,17,278,"G",17,17,"Milwaukee Bucks","Damian Lillard",1,51,62,56,17,70.7
0,0,0,0,0,0,0,0,0,"00",0,0,0,0,0,0,1038184,"2024-01-20T00:00:00.000Z",9,FALSE,17,2148,"",17,17,"Milwaukee Bucks","Thanasis Antetokounmpo",0,0,0,0,0,0
0,0,0,0,0,0,0,0,0,"00",0,0,0,0,0,0,1038184,"2024-01-20T00:00:00.000Z",9,FALSE,17,38017676,"F",17,17,"Milwaukee Bucks","MarJon Beauchamp",0,0,0,0,0,0
1,0,4,3,2,5,4,0,0,"14",0,1,10,4,0,1,1038184,"2024-01-20T00:00:00.000Z",9,FALSE,17,105,"G",17,17,"Milwaukee Bucks","Pat Connaughton",0,14,15,11,5,15.3
0,0,2,2,0,3,1,0,0,"14",0,2,2,2,1,0,1038184,"2024-01-20T00:00:00.000Z",9,FALSE,17,112,"F",17,17,"Milwaukee Bucks","Jae Crowder",1,4,4,2,2,7.4
0,0,0,0,0,0,0,0,0,"00",0,0,0,0,0,0,1038184,"2024-01-20T00:00:00.000Z",9,FALSE,17,38017733,"G",17,17,"Milwaukee Bucks","A.J. Green",0,0,0,0,0,0
0,0,4,0,0,1,1,0,0,"16",3,2,2,7,0,0,1038184,"2024-01-20T00:00:00.000Z",9,FALSE,17,56677852,"G",17,17,"Milwaukee Bucks","Andre Jackson Jr.",0,9,9,2,7,10.4
0,0,0,0,0,0,0,0,0,"00",0,0,0,0,0,0,1038184,"2024-01-20T00:00:00.000Z",9,FALSE,17,284,"C",17,17,"Milwaukee Bucks","Robin Lopez",0,0,0,0,0,0
0,0,0,0,0,0,0,0,0,"00",0,0,0,0,0,0,1038184,"2024-01-20T00:00:00.000Z",9,FALSE,17,368,"G",17,17,"Milwaukee Bucks","Cameron Payne",0,0,0,0,0,0
0,0,3,0,0,4,2,0,0,"17",0,0,4,3,0,0,1038184,"2024-01-20T00:00:00.000Z",9,FALSE,17,377,"F",17,17,"Milwaukee Bucks","Bobby Portis",0,7,7,4,3,7.6
0,0,0,0,0,0,0,0,0,"00",0,0,0,0,0,0,1038184,"2024-01-20T00:00:00.000Z",9,FALSE,17,56677854,"F",17,17,"Milwaukee Bucks","Chris Livingston",0,0,0,0,0,0
0,0,0,0,0,0,0,0,0,"00",0,0,0,0,0,0,1038184,"2024-01-20T00:00:00.000Z",9,FALSE,17,38017691,"G",17,17,"Milwaukee Bucks","TyTy Washington Jr.",0,0,0,0,0,0
3,1,5,10,2,17,8,5,5,"35",2,1,23,7,0,1,1038185,"2024-01-20T00:00:00.000Z",4,FALSE,23,56677823,"F",4,4,"Charlotte Hornets","Brandon Miller",1,30,33,26,10,37.9
3,1,11,10,5,22,9,2,2,"40",0,2,25,11,0,2,1038185,"2024-01-20T00:00:00.000Z",4,FALSE,23,62,"F",4,4,"Charlotte Hornets","Miles Bridges",1,36,39,28,14,43.7
0,0,3,4,1,8,3,2,2,"26",0,6,9,3,0,2,1038185,"2024-01-20T00:00:00.000Z",4,FALSE,23,666950,"F",4,4,"Charlotte Hornets","P.J. Washington",0,12,12,9,3,10.6
3,4,6,3,0,7,2,0,0,"29",0,2,4,6,1,2,1038185,"2024-01-20T00:00:00.000Z",4,FALSE,23,666748,"F",4,4,"Charlotte Hornets","Cody Martin",5,10,13,7,9,28.7
6,0,9,5,0,18,9,5,1,"35",0,2,19,9,1,3,1038185,"2024-01-20T00:00:00.000Z",4,FALSE,23,403,"G",4,4,"Charlotte Hornets","Terry Rozier",1,28,34,25,15,38.8
0,0,0,0,0,0,0,0,0,"00",0,0,0,0,0,0,1038185,"2024-01-20T00:00:00.000Z",4,FALSE,23,56677866,"F",4,4,"Charlotte Hornets","Leaky Black",0,0,0,0,0,0
0,0,0,0,0,0,0,0,0,"00",0,0,0,0,0,0,1038185,"2024-01-20T00:00:00.000Z",4,FALSE,23,17896037,"G",4,4,"Charlotte Hornets","James Bouknight",0,0,0,0,0,0
0,0,0,0,0,0,0,0,0,"02",0,0,0,0,0,0,1038185,"2024-01-20T00:00:00.000Z",4,FALSE,23,38017708,"G",4,4,"Charlotte Hornets","Bryce McGowens",0,0,0,0,0,0
2,0,1,0,0,0,0,0,0,"18",2,6,0,3,0,3,1038185,"2024-01-20T00:00:00.000Z",4,FALSE,23,NA,NA,NA,4,"Charlotte Hornets","NA NA",0,3,5,2,5,3.6
0,0,0,0,0,0,0,0,0,"00",0,0,0,0,0,0,1038185,"2024-01-20T00:00:00.000Z",4,FALSE,23,347,"G",4,4,"Charlotte Hornets","Frank Ntilikina",0,0,0,0,0,0
5,0,2,0,0,4,1,0,0,"19",0,0,2,2,0,2,1038185,"2024-01-20T00:00:00.000Z",4,FALSE,23,422,"G",4,4,"Charlotte Hornets","Ish Smith",0,4,9,7,7,9.9
1,0,0,2,0,4,0,0,0,"15",0,0,0,0,0,1,1038185,"2024-01-20T00:00:00.000Z",4,FALSE,23,56677846,"G",4,4,"Charlotte Hornets","Nick Smith Jr.",0,0,1,1,1,0.5
0,1,3,3,1,5,3,0,0,"21",3,1,7,6,1,0,1038185,"2024-01-20T00:00:00.000Z",4,FALSE,23,18678001,"F",4,4,"Charlotte Hornets","JT Thor",2,13,13,7,6,20.2
0,0,0,0,0,0,0,0,0,"00",0,0,0,0,0,0,1038185,"2024-01-20T00:00:00.000Z",4,FALSE,23,56677848,"G",4,4,"Charlotte Hornets","Amari Bailey",0,0,0,0,0,0
0,0,0,0,0,0,0,0,0,"00",0,0,0,0,0,0,1038185,"2024-01-20T00:00:00.000Z",4,FALSE,23,3547239,"G",4,4,"Charlotte Hornets","LaMelo Ball",0,0,0,0,0,0
0,0,0,0,0,0,0,0,0,"00",0,0,0,0,0,0,1038185,"2024-01-20T00:00:00.000Z",4,FALSE,23,204,"F",4,4,"Charlotte Hornets","Gordon Hayward",0,0,0,0,0,0
0,0,0,0,0,0,0,0,0,"00",0,0,0,0,0,0,1038185,"2024-01-20T00:00:00.000Z",4,FALSE,23,3547282,"C",4,4,"Charlotte Hornets","Nick Richards",0,0,0,0,0,0
0,0,0,0,0,0,0,0,0,"00",0,0,0,0,0,0,1038185,"2024-01-20T00:00:00.000Z",4,FALSE,23,38017698,"C",4,4,"Charlotte Hornets","Mark Williams",0,0,0,0,0,0
1,2,2,3,1,6,4,0,0,"29",3,1,9,5,2,0,1038185,"2024-01-20T00:00:00.000Z",4,FALSE,23,33,"F-G",23,23,"Philadelphia 76ers","Nicolas Batum",4,14,15,10,6,28.5
6,0,4,3,1,15,7,7,6,"36",1,0,21,5,0,2,1038185,"2024-01-20T00:00:00.000Z",4,FALSE,23,200,"F",23,23,"Philadelphia 76ers","Tobias Harris",0,26,32,27,11,34
5,3,9,1,0,23,11,12,11,"37",1,2,33,10,0,3,1038185,"2024-01-20T00:00:00.000Z",4,FALSE,23,145,"F-C",23,23,"Philadelphia 76ers","Joel Embiid",3,43,48,38,15,58.5
0,0,8,5,1,7,2,0,0,"27",0,3,5,8,2,2,1038185,"2024-01-20T00:00:00.000Z",4,FALSE,23,360,"F",23,23,"Philadelphia 76ers","Kelly Oubre Jr.",2,13,13,5,8,18.6
8,0,3,9,1,22,7,2,1,"42",0,2,16,3,2,0,1038185,"2024-01-20T00:00:00.000Z",4,FALSE,23,3547254,"G",23,23,"Philadelphia 76ers","Tyrese Maxey",2,19,27,24,11,37.6
0,0,0,0,0,0,0,0,0,"01",0,0,0,0,0,0,1038185,"2024-01-20T00:00:00.000Z",4,FALSE,23,56913527,"G",23,23,"Philadelphia 76ers","Ricky Council IV",0,0,0,0,0,0
0,1,3,1,1,4,3,3,2,"27",0,3,9,3,1,2,1038185,"2024-01-20T00:00:00.000Z",4,FALSE,23,2175,"",23,23,"Philadelphia 76ers","Danuel House Jr.",2,12,12,9,3,16.6
1,0,4,0,0,2,1,0,0,"15",0,1,2,4,0,0,1038185,"2024-01-20T00:00:00.000Z",4,FALSE,23,260,"G-F",23,23,"Philadelphia 76ers","Furkan Korkmaz",0,6,7,3,5,8.3
0,0,0,0,0,0,0,0,0,"00",0,0,0,0,0,0,1038185,"2024-01-20T00:00:00.000Z",4,FALSE,23,3547294,"F",23,23,"Philadelphia 76ers","Kenyon Martin Jr.",0,0,0,0,0,0
0,0,0,3,0,4,0,0,0,"14",0,0,0,0,0,0,1038185,"2024-01-20T00:00:00.000Z",4,FALSE,23,328,"F",23,23,"Philadelphia 76ers","Marcus Morris",0,0,0,0,0,0
0,0,7,0,0,2,1,0,0,"11",1,0,2,8,0,1,1038185,"2024-01-20T00:00:00.000Z",4,FALSE,23,3547270,"F",23,23,"Philadelphia 76ers","Paul Reed",0,10,10,2,8,10.6
0,0,0,0,0,0,0,0,0,"01",0,0,0,0,0,0,1038185,"2024-01-20T00:00:00.000Z",4,FALSE,23,56677788,"G",23,23,"Philadelphia 76ers","Terquavion Smith",0,0,0,0,0,0
0,0,0,0,0,0,0,0,0,"00",0,0,0,0,0,0,1038185,"2024-01-20T00:00:00.000Z",4,FALSE,23,28,"C",23,23,"Philadelphia 76ers","Mo Bamba",0,0,0,0,0,0
0,0,0,0,0,0,0,0,0,"00",0,0,0,0,0,0,1038185,"2024-01-20T00:00:00.000Z",4,FALSE,23,45,"G",23,23,"Philadelphia 76ers","Patrick Beverley",0,0,0,0,0,0
0,0,0,0,0,0,0,0,0,"00",0,0,0,0,0,0,1038185,"2024-01-20T00:00:00.000Z",4,FALSE,23,108,"F",23,23,"Philadelphia 76ers","Robert Covington",0,0,0,0,0,0
0,0,0,0,0,0,0,0,0,"00",0,0,0,0,0,0,1038185,"2024-01-20T00:00:00.000Z",4,FALSE,23,38017732,"F",15,23,"Philadelphia 76ers","Kenneth Lofton Jr.",0,0,0,0,0,0
0,0,0,0,0,0,0,0,0,"00",0,0,0,0,0,0,1038185,"2024-01-20T00:00:00.000Z",4,FALSE,23,313,"G",23,23,"Philadelphia 76ers","De'Anthony Melton",0,0,0,0,0,0
0,0,0,0,0,0,0,0,0,"00",0,0,0,0,0,0,1038185,"2024-01-20T00:00:00.000Z",4,FALSE,23,17896025,"G",23,23,"Philadelphia 76ers","Jaden Springer",0,0,0,0,0,0
8,1,3,4,1,20,7,4,3,"37",1,0,18,4,1,1,1038189,"2024-01-20T00:00:00.000Z",5,FALSE,15,125,"G",5,5,"Chicago Bulls","DeMar DeRozan",2,22,30,26,12,39.8
0,1,3,7,3,11,4,4,4,"27",2,4,15,5,2,2,1038189,"2024-01-20T00:00:00.000Z",5,FALSE,15,3547248,"F",5,5,"Chicago Bulls","Patrick Williams",3,20,20,15,5,28
3,0,9,3,1,8,5,0,0,"25",2,3,11,11,0,2,1038189,"2024-01-20T00:00:00.000Z",5,FALSE,15,460,"C",5,5,"Chicago Bulls","Nikola Vucevic",0,22,25,14,14,26.7
1,1,3,5,2,6,3,0,0,"25",0,3,8,3,2,0,1038189,"2024-01-20T00:00:00.000Z",5,FALSE,15,89,"G",5,5,"Chicago Bulls","Alex Caruso",3,11,12,9,4,22.1
5,0,4,3,1,14,7,2,2,"36",1,1,17,5,0,1,1038189,"2024-01-20T00:00:00.000Z",5,FALSE,15,666956,"G",5,5,"Chicago Bulls","Coby White",0,22,27,22,10,29.5
5,0,1,3,2,7,5,0,0,"17",0,0,12,1,0,0,1038189,"2024-01-20T00:00:00.000Z",5,FALSE,15,87,"G",5,5,"Chicago Bulls","Jevon Carter",0,13,18,17,6,20.7
0,0,0,0,0,0,0,0,0,"00",0,0,0,0,0,0,1038189,"2024-01-20T00:00:00.000Z",5,FALSE,15,110,"F",5,5,"Chicago Bulls","Torrey Craig",0,0,0,0,0,0
0,0,0,0,0,0,0,0,0,"00",0,0,0,0,0,0,1038189,"2024-01-20T00:00:00.000Z",5,FALSE,15,401,"G",15,15,"Memphis Grizzlies","Derrick Rose",0,0,0,0,0,0
0,0,0,0,0,0,0,0,0,"00",0,0,0,0,0,0,1038189,"2024-01-20T00:00:00.000Z",5,FALSE,15,420,"G",15,15,"Memphis Grizzlies","Marcus Smart",0,0,0,0,0,0
4,1,6,5,3,10,7,3,3,"28",0,1,20,6,1,3,1038189,"2024-01-20T00:00:00.000Z",5,FALSE,15,17895983,"G",5,5,"Chicago Bulls","Ayo Dosunmu",2,26,30,24,10,36.2
1,0,5,0,0,11,7,2,1,"19",5,2,15,10,4,0,1038189,"2024-01-20T00:00:00.000Z",5,FALSE,15,137,"C",5,5,"Chicago Bulls","Andre Drummond",4,25,26,16,11,40.5
1,0,0,0,0,0,0,0,0,"04",0,0,0,0,0,0,1038189,"2024-01-20T00:00:00.000Z",5,FALSE,15,56677857,"F",5,5,"Chicago Bulls","Julian Phillips",0,0,1,1,1,1.5
1,0,1,0,0,1,1,0,0,"04",1,2,2,2,0,1,1038189,"2024-01-20T00:00:00.000Z",5,FALSE,15,17896116,"G",5,5,"Chicago Bulls","Terry Taylor",0,4,5,3,3,4.9
3,1,4,3,1,3,1,6,4,"18",1,2,7,5,1,1,1038189,"2024-01-20T00:00:00.000Z",5,FALSE,15,38017719,"F",5,5,"Chicago Bulls","Dalen Terry",2,12,15,10,8,22.5
0,0,0,0,0,0,0,0,0,"00",0,0,0,0,0,0,1038189,"2024-01-20T00:00:00.000Z",5,FALSE,15,27,"G",5,5,"Chicago Bulls","Lonzo Ball",0,0,0,0,0,0
0,0,0,0,0,0,0,0,0,"00",0,0,0,0,0,0,1038189,"2024-01-20T00:00:00.000Z",5,FALSE,15,56677874,"F",5,5,"Chicago Bulls","Onuralp Bitim",0,0,0,0,0,0
0,0,0,0,0,0,0,0,0,"00",0,0,0,0,0,0,1038189,"2024-01-20T00:00:00.000Z",5,FALSE,15,NA,NA,NA,5,"Chicago Bulls","NA NA",0,0,0,0,0,0
0,0,0,0,0,0,0,0,0,"00",0,0,0,0,0,0,1038189,"2024-01-20T00:00:00.000Z",5,FALSE,15,268,"G",5,5,"Chicago Bulls","Zach LaVine",0,0,0,0,0,0
0,0,0,0,0,0,0,0,0,"00",0,0,0,0,0,0,1038189,"2024-01-20T00:00:00.000Z",5,FALSE,15,56677860,"F",5,5,"Chicago Bulls","Adama Sanogo",0,0,0,0,0,0
2,0,5,6,3,9,5,2,1,"30",0,2,14,5,1,2,1038189,"2024-01-20T00:00:00.000Z",5,FALSE,15,38017731,"G",15,15,"Memphis Grizzlies","Vince Williams Jr.",1,19,21,16,7,24
3,2,8,5,1,7,2,0,0,"28",0,0,5,8,1,2,1038189,"2024-01-20T00:00:00.000Z",5,FALSE,15,17896067,"F",15,15,"Memphis Grizzlies","Santi Aldama",3,13,16,8,11,26.1
5,0,5,7,1,18,8,9,9,"33",1,3,26,6,1,2,1038189,"2024-01-20T00:00:00.000Z",5,FALSE,15,231,"F-C",15,15,"Memphis Grizzlies","Jaren Jackson Jr.",1,32,37,31,11,41.7
6,0,2,7,4,9,5,1,0,"30",0,0,14,2,0,3,1038189,"2024-01-20T00:00:00.000Z",5,FALSE,15,254,"G",15,15,"Memphis Grizzlies","Luke Kennard",0,16,22,20,8,22.4
6,2,5,2,0,4,1,0,0,"26",0,0,2,5,0,2,1038189,"2024-01-20T00:00:00.000Z",5,FALSE,15,666703,"G-F",15,15,"Memphis Grizzlies","John Konchar",2,7,13,8,11,21
1,0,1,3,1,3,1,0,0,"16",0,0,3,1,1,1,1038189,"2024-01-20T00:00:00.000Z",5,FALSE,15,48248287,"G",15,15,"Memphis Grizzlies","Jacob Gilyard",1,4,5,4,2,7.7
0,0,1,2,2,3,2,6,4,"18",0,2,10,1,0,0,1038189,"2024-01-20T00:00:00.000Z",5,FALSE,15,56677830,"F",15,15,"Memphis Grizzlies","GG Jackson",0,11,11,10,1,11.2
0,0,0,0,0,0,0,0,0,"00",0,0,0,0,0,0,1038189,"2024-01-20T00:00:00.000Z",5,FALSE,15,38017728,"F",15,15,"Memphis Grizzlies","Jake LaRavia",0,0,0,0,0,0
3,0,2,5,1,11,5,0,0,"32",0,3,11,2,0,1,1038189,"2024-01-20T00:00:00.000Z",5,FALSE,15,38017729,"F",15,15,"Memphis Grizzlies","David Roddy",0,13,16,14,5,16.9
1,0,0,5,0,9,2,4,4,"22",1,3,8,1,2,1,1038189,"2024-01-20T00:00:00.000Z",5,FALSE,15,17896027,"G-F",15,15,"Memphis Grizzlies","Ziaire Williams",2,9,10,9,2,15.7
1,0,0,0,0,2,1,1,1,"05",1,0,3,1,0,1,1038189,"2024-01-20T00:00:00.000Z",5,FALSE,15,38017656,"G",14,15,"Memphis Grizzlies","Scotty Pippen Jr.",0,4,5,4,2,4.7
0,0,0,0,0,0,0,0,0,"00",0,0,0,0,0,0,1038189,"2024-01-20T00:00:00.000Z",5,FALSE,15,3547285,"F",15,15,"Memphis Grizzlies","Xavier Tillman",0,0,0,0,0,0
0,0,0,0,0,0,0,0,0,"00",0,0,0,0,0,0,1038189,"2024-01-20T00:00:00.000Z",5,FALSE,15,3,"C",15,15,"Memphis Grizzlies","Steven Adams",0,0,0,0,0,0
0,0,0,0,0,0,0,0,0,"00",0,0,0,0,0,0,1038189,"2024-01-20T00:00:00.000Z",5,FALSE,15,3547287,"G",15,15,"Memphis Grizzlies","Desmond Bane",0,0,0,0,0,0
0,0,0,0,0,0,0,0,0,"00",0,0,0,0,0,0,1038189,"2024-01-20T00:00:00.000Z",5,FALSE,15,666505,"F",15,15,"Memphis Grizzlies","Brandon Clarke",0,0,0,0,0,0
0,0,0,0,0,0,0,0,0,"00",0,0,0,0,0,0,1038189,"2024-01-20T00:00:00.000Z",5,FALSE,15,666786,"G",15,15,"Memphis Grizzlies","Ja Morant",0,0,0,0,0,0
1,0,5,3,1,10,3,0,0,"35",0,2,7,5,0,0,1038190,"2024-01-20T00:00:00.000Z",11,FALSE,29,66,"G-F",11,11,"Houston Rockets","Dillon Brooks",0,12,13,8,6,14.5
1,1,6,8,4,19,9,4,2,"41",4,2,24,10,2,0,1038190,"2024-01-20T00:00:00.000Z",11,FALSE,29,38017684,"F",11,11,"Houston Rockets","Jabari Smith Jr.",3,34,35,25,11,46.5
6,1,6,1,1,26,15,10,6,"42",8,4,37,14,1,1,1038190,"2024-01-20T00:00:00.000Z",11,FALSE,29,17896062,"F-C",11,11,"Houston Rockets","Alperen Sengun",2,51,57,43,20,67.8
4,0,3,6,0,12,3,1,1,"28",0,0,7,3,1,1,1038190,"2024-01-20T00:00:00.000Z",11,FALSE,29,17895966,"G",11,11,"Houston Rockets","Jalen Green",1,10,14,11,7,18.6
7,3,3,10,2,19,8,0,0,"34",2,6,18,5,1,2,1038190,"2024-01-20T00:00:00.000Z",11,FALSE,29,458,"G",11,11,"Houston Rockets","Fred VanVleet",4,23,30,25,12,44.5
2,0,2,3,1,6,1,0,0,"16",1,0,3,3,0,1,1038190,"2024-01-20T00:00:00.000Z",11,FALSE,29,188,"F",11,11,"Houston Rockets","Jeff Green",0,6,8,5,5,8.6
2,2,4,1,0,6,2,2,2,"19",4,3,6,8,2,0,1038190,"2024-01-20T00:00:00.000Z",11,FALSE,29,56677825,"G-F",11,11,"Houston Rockets","Amen Thompson",4,14,16,8,10,30.6
1,2,4,6,4,13,6,3,1,"27",1,1,17,5,0,2,1038190,"2024-01-20T00:00:00.000Z",11,FALSE,29,56677831,"F",11,11,"Houston Rockets","Cam Whitmore",2,22,23,18,6,28.5
0,0,0,0,0,0,0,0,0,"00",0,0,0,0,0,0,1038190,"2024-01-20T00:00:00.000Z",11,FALSE,29,47738533,"G",11,11,"Houston Rockets","Jeenathan Williams",0,0,0,0,0,0
0,0,0,0,0,0,0,0,0,"00",0,0,0,0,0,0,1038190,"2024-01-20T00:00:00.000Z",11,FALSE,29,75,"G-F",11,11,"Houston Rockets","Reggie Bullock",0,0,0,0,0,0
0,0,0,0,0,0,0,0,0,"00",0,0,0,0,0,0,1038190,"2024-01-20T00:00:00.000Z",11,FALSE,29,38017695,"F",11,11,"Houston Rockets","Tari Eason",0,0,0,0,0,0
0,0,0,0,0,0,0,0,0,"00",0,0,0,0,0,0,1038190,"2024-01-20T00:00:00.000Z",11,FALSE,29,3547281,"G-F",11,11,"Houston Rockets","Nate Hinton",0,0,0,0,0,0
0,0,0,0,0,0,0,0,0,"00",0,0,0,0,0,0,1038190,"2024-01-20T00:00:00.000Z",11,FALSE,29,357,"G",11,11,"Houston Rockets","Victor Oladipo",0,0,0,0,0,0
0,0,0,0,0,0,0,0,0,"00",0,0,0,0,0,0,1038190,"2024-01-20T00:00:00.000Z",11,FALSE,29,56677809,"F",11,11,"Houston Rockets","Jermaine Samuels Jr.",0,0,0,0,0,0
3,0,5,5,2,7,4,0,0,"29",2,2,10,7,0,1,1038190,"2024-01-20T00:00:00.000Z",11,FALSE,29,38017739,"F",29,29,"Utah Jazz","Simone Fontecchio",0,17,20,13,10,21.9
1,0,6,11,3,18,8,4,3,"39",3,2,22,9,0,3,1038190,"2024-01-20T00:00:00.000Z",11,FALSE,29,297,"F",29,29,"Utah Jazz","Lauri Markkanen",0,31,32,23,10,31.3
2,0,5,4,0,9,3,1,1,"20",1,2,7,6,0,0,1038190,"2024-01-20T00:00:00.000Z",11,FALSE,29,101,"F-C",29,29,"Utah Jazz","John Collins",0,13,15,9,8,17.2
5,0,0,7,2,27,11,4,4,"40",3,4,28,3,2,2,1038190,"2024-01-20T00:00:00.000Z",11,FALSE,29,413,"G",29,29,"Utah Jazz","Collin Sexton",2,31,36,33,8,43.1
7,0,6,2,1,6,4,2,1,"27",2,2,10,8,1,0,1038190,"2024-01-20T00:00:00.000Z",11,FALSE,29,139,"G",29,29,"Utah Jazz","Kris Dunn",1,18,25,17,15,33.1
0,3,0,1,0,1,0,0,0,"13",0,0,0,0,0,1,1038190,"2024-01-20T00:00:00.000Z",11,FALSE,29,38017620,"G",29,29,"Utah Jazz","Ochai Agbaji",3,0,0,0,0,8
4,0,10,10,4,25,12,5,5,"39",2,1,33,12,0,3,1038190,"2024-01-20T00:00:00.000Z",11,FALSE,29,100,"G",29,29,"Utah Jazz","Jordan Clarkson",0,45,49,37,16,50.4
2,0,1,2,1,3,1,0,0,"10",0,1,3,1,0,3,1038190,"2024-01-20T00:00:00.000Z",11,FALSE,29,56677834,"G",29,29,"Utah Jazz","Keyonte George",0,4,6,5,3,4.2
0,0,0,0,0,0,0,0,0,"00",0,0,0,0,0,0,1038190,"2024-01-20T00:00:00.000Z",11,FALSE,29,666650,"G",29,29,"Utah Jazz","Talen Horton-Tucker",0,0,0,0,0,0
3,5,7,0,0,4,2,6,3,"32",3,6,7,10,0,3,1038190,"2024-01-20T00:00:00.000Z",11,FALSE,29,38017705,"C",29,29,"Utah Jazz","Walker Kessler",5,17,20,10,13,35.5
1,0,3,1,0,5,3,0,0,"16",0,4,6,3,1,1,1038190,"2024-01-20T00:00:00.000Z",11,FALSE,29,358,"F",29,29,"Utah Jazz","Kelly Olynyk",1,9,10,7,4,13.1
0,0,0,0,0,0,0,0,0,"00",0,0,0,0,0,0,1038190,"2024-01-20T00:00:00.000Z",11,FALSE,29,666881,"F",29,29,"Utah Jazz","Luka Samanic",0,0,0,0,0,0
0,0,0,0,0,0,0,0,0,"00",0,0,0,0,0,0,1038190,"2024-01-20T00:00:00.000Z",11,FALSE,29,11891374,"C",29,29,"Utah Jazz","Omer Yurtseven",0,0,0,0,0,0
0,0,0,0,0,2,2,2,2,"09",0,2,6,0,3,0,1038190,"2024-01-20T00:00:00.000Z",11,FALSE,29,213,"G",11,11,"Houston Rockets","Aaron Holiday",3,6,6,6,0,15
0,0,0,0,0,0,0,0,0,"00",0,0,0,0,0,0,1038190,"2024-01-20T00:00:00.000Z",11,FALSE,29,19465326,"C",11,11,"Houston Rockets","Jock Landale",0,0,0,0,0,0
0,0,0,0,0,0,0,0,0,"00",0,0,0,0,0,0,1038190,"2024-01-20T00:00:00.000Z",11,FALSE,29,296,"C",11,11,"Houston Rockets","Boban Marjanovic",0,0,0,0,0,0
3,1,0,1,0,4,1,0,0,"14",3,2,2,3,1,0,1038190,"2024-01-20T00:00:00.000Z",11,FALSE,29,3547301,"F",11,11,"Houston Rockets","Jae'Sean Tate",2,5,8,5,6,16.1
0,0,0,0,0,0,0,0,0,"00",0,0,0,0,0,0,1038190,"2024-01-20T00:00:00.000Z",11,FALSE,29,56677824,"F",29,29,"Utah Jazz","Taylor Hendricks",0,0,0,0,0,0
0,0,0,0,0,0,0,0,0,"00",0,0,0,0,0,0,1038190,"2024-01-20T00:00:00.000Z",11,FALSE,29,38017630,"G",29,29,"Utah Jazz","Johnny Juzang",0,0,0,0,0,0
0,0,0,0,0,0,0,0,0,"00",0,0,0,0,0,0,1038190,"2024-01-20T00:00:00.000Z",11,FALSE,29,19465584,"F",29,29,"Utah Jazz","Micah Potter",0,0,0,0,0,0
0,0,0,0,0,0,0,0,0,"00",0,0,0,0,0,0,1038190,"2024-01-20T00:00:00.000Z",11,FALSE,29,17896042,"G",13,29,"Utah Jazz","Jason Preston",0,0,0,0,0,0
0,0,0,0,0,0,0,0,0,"00",0,0,0,0,0,0,1038190,"2024-01-20T00:00:00.000Z",11,FALSE,29,56677842,"F",29,29,"Utah Jazz","Brice Sensabaugh",0,0,0,0,0,0
0,2,1,2,1,3,2,0,0,"12",0,1,5,1,0,1,1038191,"2024-01-20T00:00:00.000Z",18,FALSE,21,38017706,"F",21,21,"Oklahoma City Thunder","Jaylin Williams",2,6,6,5,1,11.2
0,0,3,2,0,2,0,0,0,"10",0,1,0,3,1,1,1038191,"2024-01-20T00:00:00.000Z",18,FALSE,21,480,"G-F",21,21,"Oklahoma City Thunder","Kenrich Williams",1,3,3,0,3,5.6
0,0,0,0,0,0,0,0,0,"00",0,0,0,0,0,0,1038191,"2024-01-20T00:00:00.000Z",18,FALSE,21,38017716,"F",21,21,"Oklahoma City Thunder","Ousmane Dieng",0,0,0,0,0,0
0,0,0,0,0,0,0,0,0,"00",0,0,0,0,0,0,1038191,"2024-01-20T00:00:00.000Z",18,FALSE,21,56677853,"F",21,21,"Oklahoma City Thunder","Keyontae Johnson",0,0,0,0,0,0
0,0,0,0,0,0,0,0,0,"00",0,0,0,0,0,0,1038191,"2024-01-20T00:00:00.000Z",18,FALSE,21,3547271,"C",21,21,"Oklahoma City Thunder","Aleksej Pokusevski",0,0,0,0,0,0
0,0,1,5,3,11,6,1,0,"27",1,4,15,2,0,2,1038191,"2024-01-20T00:00:00.000Z",18,FALSE,21,3547259,"F",18,18,"Minnesota Timberwolves","Jaden McDaniels",0,17,17,15,2,15.4
2,1,10,4,1,10,4,10,10,"36",1,6,19,11,0,3,1038191,"2024-01-20T00:00:00.000Z",18,FALSE,21,447,"C",18,18,"Minnesota Timberwolves","Karl-Anthony Towns",1,30,32,21,13,35.2
2,0,14,0,0,6,1,8,5,"33",4,4,7,18,0,2,1038191,"2024-01-20T00:00:00.000Z",18,FALSE,21,176,"C",18,18,"Minnesota Timberwolves","Rudy Gobert",0,25,27,9,20,29.6
5,0,5,3,1,10,6,10,6,"38",0,2,19,5,0,5,1038191,"2024-01-20T00:00:00.000Z",18,FALSE,21,3547238,"G",18,18,"Minnesota Timberwolves","Anthony Edwards",0,24,29,24,10,27.5
4,1,3,9,1,11,1,0,0,"29",0,3,3,3,0,3,1038191,"2024-01-20T00:00:00.000Z",18,FALSE,21,104,"G",18,18,"Minnesota Timberwolves","Mike Conley",1,6,10,7,7,12.6
2,1,5,2,1,3,1,0,0,"19",0,1,3,5,1,2,1038191,"2024-01-20T00:00:00.000Z",18,FALSE,21,666400,"G",18,18,"Minnesota Timberwolves","Nickeil Alexander-Walker",2,8,10,5,7,16
4,0,0,3,1,4,2,0,0,"19",1,2,5,1,1,0,1038191,"2024-01-20T00:00:00.000Z",18,FALSE,21,12,"F",18,18,"Minnesota Timberwolves","Kyle Anderson",1,6,10,9,5,15.2
0,0,0,0,0,0,0,0,0,"00",0,0,0,0,0,0,1038191,"2024-01-20T00:00:00.000Z",18,FALSE,21,68,"F",18,18,"Minnesota Timberwolves","Troy Brown Jr.",0,0,0,0,0,0
3,0,0,3,2,7,3,0,0,"13",2,1,8,2,2,0,1038191,"2024-01-20T00:00:00.000Z",18,FALSE,21,666767,"G",18,18,"Minnesota Timberwolves","Jordan McLaughlin",2,10,13,11,5,20.9
0,0,0,0,0,0,0,0,0,"00",0,0,0,0,0,0,1038191,"2024-01-20T00:00:00.000Z",18,FALSE,21,320,"G",18,18,"Minnesota Timberwolves","Shake Milton",0,0,0,0,0,0
0,0,0,0,0,0,0,0,0,"00",0,0,0,0,0,0,1038191,"2024-01-20T00:00:00.000Z",18,FALSE,21,38017700,"G",18,18,"Minnesota Timberwolves","Wendell Moore Jr.",0,0,0,0,0,0
0,0,0,0,0,0,0,0,0,"00",0,0,0,0,0,0,1038191,"2024-01-20T00:00:00.000Z",18,FALSE,21,17895968,"F",18,18,"Minnesota Timberwolves","Daishen Nix",0,0,0,0,0,0
0,4,3,8,4,13,7,0,0,"26",0,3,18,3,0,4,1038191,"2024-01-20T00:00:00.000Z",18,FALSE,21,667378,"F-C",18,18,"Minnesota Timberwolves","Naz Reid",4,21,21,18,3,29.6
0,0,0,0,0,0,0,0,0,"00",0,0,0,0,0,0,1038191,"2024-01-20T00:00:00.000Z",18,FALSE,21,56677851,"G",18,18,"Minnesota Timberwolves","Jaylen Clark",0,0,0,0,0,0
0,0,0,0,0,0,0,0,0,"00",0,0,0,0,0,0,1038191,"2024-01-20T00:00:00.000Z",18,FALSE,21,17896056,"C",18,18,"Minnesota Timberwolves","Luka Garza",0,0,0,0,0,0
0,0,0,0,0,0,0,0,0,"00",0,0,0,0,0,0,1038191,"2024-01-20T00:00:00.000Z",18,FALSE,21,56677782,"F",18,18,"Minnesota Timberwolves","Leonard Miller",0,0,0,0,0,0
4,0,7,4,0,8,2,2,1,"25",1,0,5,8,1,1,1038191,"2024-01-20T00:00:00.000Z",18,FALSE,21,17896065,"G",21,21,"Oklahoma City Thunder","Josh Giddey",1,13,17,9,12,22.6
6,0,1,2,1,22,10,13,12,"37",1,0,33,2,2,2,1038191,"2024-01-20T00:00:00.000Z",18,FALSE,21,175,"G",21,21,"Oklahoma City Thunder","Shai Gilgeous-Alexander",2,35,41,39,8,48.4
0,0,0,0,0,0,0,0,0,"00",0,0,0,0,0,0,1038191,"2024-01-20T00:00:00.000Z",18,FALSE,21,44,"F",21,21,"Oklahoma City Thunder","Davis Bertans",0,0,0,0,0,0
5,0,5,2,1,3,1,2,2,"22",0,4,5,5,1,0,1038191,"2024-01-20T00:00:00.000Z",18,FALSE,21,3547272,"G",21,21,"Oklahoma City Thunder","Isaiah Joe",1,10,15,10,10,21.5
0,0,0,0,0,0,0,0,0,"00",0,0,0,0,0,0,1038191,"2024-01-20T00:00:00.000Z",18,FALSE,21,17896036,"G",21,21,"Oklahoma City Thunder","Tre Mann",0,0,0,0,0,0
0,0,0,0,0,2,0,0,0,"08",0,0,0,0,0,0,1038191,"2024-01-20T00:00:00.000Z",18,FALSE,21,4197029,"G",21,21,"Oklahoma City Thunder","Vasilije Micic",0,0,0,0,0,0
0,0,0,0,0,0,0,0,0,"00",0,0,0,0,0,0,1038191,"2024-01-20T00:00:00.000Z",18,FALSE,21,24572055,"C",21,21,"Oklahoma City Thunder","Olivier Sarr",0,0,0,0,0,0
0,0,2,0,0,1,0,0,0,"12",1,2,0,3,1,1,1038191,"2024-01-20T00:00:00.000Z",18,FALSE,21,56677833,"G",21,21,"Oklahoma City Thunder","Cason Wallace",1,3,3,0,3,5.6
0,0,0,0,0,0,0,0,0,"00",0,0,0,0,0,0,1038191,"2024-01-20T00:00:00.000Z",18,FALSE,21,27924547,"F",21,21,"Oklahoma City Thunder","Lindy Waters III",0,0,0,0,0,0
0,0,0,1,1,2,2,0,0,"12",0,0,5,0,0,1,1038191,"2024-01-20T00:00:00.000Z",18,FALSE,21,17896078,"G",21,21,"Oklahoma City Thunder","Aaron Wiggins",0,5,5,5,0,4
0,0,0,0,0,0,0,0,0,"00",0,0,0,0,0,0,1038191,"2024-01-20T00:00:00.000Z",18,FALSE,21,38017715,"F",18,18,"Minnesota Timberwolves","Josh Minott",0,0,0,0,0,0
1,0,3,7,3,12,5,2,1,"33",2,4,14,5,2,1,1038191,"2024-01-20T00:00:00.000Z",18,FALSE,21,666541,"G",21,21,"Oklahoma City Thunder","Luguentz Dort",2,19,20,15,6,26.5
3,0,2,2,0,18,6,10,8,"36",3,4,20,5,3,0,1038191,"2024-01-20T00:00:00.000Z",18,FALSE,21,38017703,"G-F",21,21,"Oklahoma City Thunder","Jalen Williams",3,25,28,23,8,39.5
2,2,4,2,1,8,4,6,6,"33",1,4,15,5,1,0,1038191,"2024-01-20T00:00:00.000Z",18,FALSE,21,38017685,"C-F",21,21,"Oklahoma City Thunder","Chet Holmgren",3,20,22,17,7,33
1,3,7,3,0,11,5,4,4,"37",0,2,14,7,1,1,1038188,"2024-01-20T00:00:00.000Z",20,FALSE,28,18,"F",28,20,"New York Knicks","OG Anunoby",4,21,22,15,8,34.9
10,0,9,7,3,13,7,2,1,"32",7,3,18,16,0,7,1038188,"2024-01-20T00:00:00.000Z",20,FALSE,28,387,"F",20,20,"New York Knicks","Julius Randle",0,34,44,28,26,45.2
1,0,4,0,0,1,0,2,1,"23",0,2,1,4,0,0,1038188,"2024-01-20T00:00:00.000Z",20,FALSE,28,201,"F-C",20,20,"New York Knicks","Isaiah Hartenstein",0,5,6,2,5,7.3
9,0,4,11,5,23,13,7,7,"35",1,3,38,5,1,3,1038188,"2024-01-20T00:00:00.000Z",20,FALSE,28,73,"G",20,20,"New York Knicks","Jalen Brunson",1,43,52,47,14,57.5
1,0,2,7,2,12,7,3,1,"20",1,1,17,3,1,0,1038188,"2024-01-20T00:00:00.000Z",20,FALSE,28,131,"G",20,20,"New York Knicks","Donte DiVincenzo",1,20,21,18,4,25.1
0,1,7,0,0,10,9,0,0,"25",4,4,18,11,0,3,1038188,"2024-01-20T00:00:00.000Z",20,FALSE,28,3547249,"F",28,20,"New York Knicks","Precious Achiuwa",1,29,29,18,11,31.2
1,0,1,0,0,0,0,0,0,"03",0,0,0,1,0,0,1038188,"2024-01-20T00:00:00.000Z",20,FALSE,28,19,"G",20,20,"New York Knicks","Ryan Arcidiacono",0,1,2,1,2,2.7
1,0,1,1,1,1,1,0,0,"03",0,0,3,1,0,1,1038188,"2024-01-20T00:00:00.000Z",20,FALSE,28,3547275,"G",28,20,"New York Knicks","Malachi Flynn",0,4,5,4,2,4.7
0,0,0,0,0,0,0,0,0,"00",0,0,0,0,0,0,1038188,"2024-01-20T00:00:00.000Z",20,FALSE,28,160,"G-F",20,20,"New York Knicks","Evan Fournier",0,0,0,0,0,0
1,1,3,4,0,8,2,0,0,"20",1,3,4,4,1,1,1038188,"2024-01-20T00:00:00.000Z",20,FALSE,28,17895858,"G",20,20,"New York Knicks","Quentin Grimes",2,8,9,5,5,15.3
1,1,8,3,2,5,3,2,2,"26",1,1,10,9,0,3,1038188,"2024-01-20T00:00:00.000Z",20,FALSE,28,202,"G",20,20,"New York Knicks","Josh Hart",1,19,20,11,10,22.3
1,0,0,3,1,4,1,0,0,"13",0,1,3,0,0,2,1038188,"2024-01-20T00:00:00.000Z",20,FALSE,28,17896033,"G",20,20,"New York Knicks","Miles McBride",0,3,4,4,1,2.5
0,1,0,0,0,0,0,0,0,"03",0,0,0,0,0,0,1038188,"2024-01-20T00:00:00.000Z",20,FALSE,28,17896063,"F",20,20,"New York Knicks","Jericho Sims",1,0,0,0,0,3
0,0,0,0,0,0,0,0,0,"00",0,0,0,0,0,0,1038188,"2024-01-20T00:00:00.000Z",20,FALSE,28,666474,"G",20,20,"New York Knicks","Charles Brown",0,0,0,0,0,0
0,0,0,0,0,0,0,0,0,"00",0,0,0,0,0,0,1038188,"2024-01-20T00:00:00.000Z",20,FALSE,28,399,"C",20,20,"New York Knicks","Mitchell Robinson",0,0,0,0,0,0
0,0,0,0,0,0,0,0,0,"00",0,0,0,0,0,0,1038188,"2024-01-20T00:00:00.000Z",20,FALSE,28,56677795,"F",20,20,"New York Knicks","Jacob Toppin",0,0,0,0,0,0
0,0,0,0,0,0,0,0,0,"00",0,0,0,0,0,0,1038188,"2024-01-20T00:00:00.000Z",20,FALSE,28,17896089,"G",20,20,"New York Knicks","Duane Washington Jr.",0,0,0,0,0,0
7,2,4,3,0,14,4,3,1,"33",2,2,9,6,0,3,1038188,"2024-01-20T00:00:00.000Z",20,FALSE,28,17896055,"G-F",28,28,"Toronto Raptors","Scottie Barnes",2,15,22,16,13,29.7
4,0,6,3,1,15,8,9,3,"29",2,2,20,8,1,0,1038188,"2024-01-20T00:00:00.000Z",20,FALSE,28,666423,"F-G",20,28,"Toronto Raptors","RJ Barrett",1,28,32,24,12,38.6
1,1,1,2,0,8,2,2,2,"21",1,1,6,2,3,2,1038188,"2024-01-20T00:00:00.000Z",20,FALSE,28,2309958,"C-F",15,28,"Toronto Raptors","Jontay Porter",4,8,9,7,3,19.9
11,0,2,4,2,8,4,3,2,"31",0,1,12,2,1,2,1038188,"2024-01-20T00:00:00.000Z",20,FALSE,28,3547269,"G",20,28,"Toronto Raptors","Immanuel Quickley",1,14,25,23,13,31.9
0,1,1,8,4,10,6,0,0,"26",0,4,16,1,1,1,1038188,"2024-01-20T00:00:00.000Z",20,FALSE,28,3089,"",28,28,"Toronto Raptors","Gary Trent Jr.",2,17,17,16,1,22.2
1,0,0,1,0,5,2,2,1,"12",2,2,5,2,0,0,1038188,"2024-01-20T00:00:00.000Z",20,FALSE,28,58,"F",28,28,"Toronto Raptors","Chris Boucher",0,7,8,6,3,8.9
0,1,2,2,0,8,3,2,2,"22",1,2,8,3,1,2,1038188,"2024-01-20T00:00:00.000Z",20,FALSE,28,69,"G",12,28,"Toronto Raptors","Bruce Brown",2,11,11,8,3,15.6
1,0,2,6,3,7,4,0,0,"16",0,1,11,2,1,0,1038188,"2024-01-20T00:00:00.000Z",20,FALSE,28,56677828,"G",28,28,"Toronto Raptors","Gradey Dick",1,13,14,12,3,17.9
0,0,0,2,0,4,1,0,0,"04",0,0,2,0,0,0,1038188,"2024-01-20T00:00:00.000Z",20,FALSE,28,666762,"F",28,28,"Toronto Raptors","Jalen McDaniels",0,2,2,2,0,2
0,0,0,1,1,1,1,0,0,"04",0,0,3,0,0,0,1038188,"2024-01-20T00:00:00.000Z",20,FALSE,28,3547207,"F",12,28,"Toronto Raptors","Jordan Nwora",0,3,3,3,0,3
0,0,0,0,0,0,0,0,0,"00",0,0,0,0,0,0,1038188,"2024-01-20T00:00:00.000Z",20,FALSE,28,376,"F",28,28,"Toronto Raptors","Otto Porter Jr.",0,0,0,0,0,0
3,0,1,1,0,5,1,0,0,"23",0,1,2,1,0,0,1038188,"2024-01-20T00:00:00.000Z",20,FALSE,28,409,"G",28,28,"Toronto Raptors","Dennis Schroder",0,3,6,5,4,7.7
0,0,0,1,0,3,0,2,2,"04",2,0,2,2,0,0,1038188,"2024-01-20T00:00:00.000Z",20,FALSE,28,436,"G-F",28,28,"Toronto Raptors","Garrett Temple",0,4,4,2,2,4.4
1,0,1,0,0,4,2,0,0,"15",1,2,4,2,2,0,1038188,"2024-01-20T00:00:00.000Z",20,FALSE,28,489,"F",28,28,"Toronto Raptors","Thaddeus Young",2,6,7,5,3,13.9
0,0,0,0,0,0,0,0,0,"00",0,0,0,0,0,0,1038188,"2024-01-20T00:00:00.000Z",20,FALSE,28,56677805,"G",28,28,"Toronto Raptors","Javon Freeman-Liberty",0,0,0,0,0,0
0,0,0,0,0,0,0,0,0,"00",0,0,0,0,0,0,1038188,"2024-01-20T00:00:00.000Z",20,FALSE,28,3547260,"G",19,28,"Toronto Raptors","Kira Lewis Jr.",0,0,0,0,0,0
0,0,0,0,0,0,0,0,0,"00",0,0,0,0,0,0,1038188,"2024-01-20T00:00:00.000Z",20,FALSE,28,56677869,"G",28,28,"Toronto Raptors","Markquis Nowell",0,0,0,0,0,0
0,0,0,0,0,0,0,0,0,"00",0,0,0,0,0,0,1038188,"2024-01-20T00:00:00.000Z",20,FALSE,28,373,"C",28,28,"Toronto Raptors","Jakob Poeltl",0,0,0,0,0,0
5,0,1,5,2,13,6,5,5,"28",1,2,19,2,0,0,1038193,"2024-01-21T00:00:00.000Z",22,FALSE,16,17896026,"F",22,22,"Orlando Magic","Franz Wagner",0,21,26,24,7,28.9
2,0,10,5,3,14,7,5,3,"31",0,2,20,10,0,2,1038193,"2024-01-21T00:00:00.000Z",22,FALSE,16,38017683,"F",22,22,"Orlando Magic","Paolo Banchero",0,30,32,22,12,33
2,0,7,3,1,11,7,2,2,"34",2,1,17,9,1,1,1038193,"2024-01-21T00:00:00.000Z",22,FALSE,16,85,"F",22,22,"Orlando Magic","Wendell Carter Jr.",1,26,28,19,11,32.8
1,0,0,6,1,11,4,2,2,"29",4,4,11,4,1,2,1038193,"2024-01-21T00:00:00.000Z",22,FALSE,16,17896073,"G",22,22,"Orlando Magic","Jalen Suggs",1,15,16,12,5,18.3
4,2,0,0,0,8,6,0,0,"29",1,3,12,1,2,2,1038193,"2024-01-21T00:00:00.000Z",22,FALSE,16,165,"G",22,22,"Orlando Magic","Markelle Fultz",4,13,17,16,5,29.2
2,1,6,2,1,6,2,0,0,"16",0,0,5,6,1,3,1038193,"2024-01-21T00:00:00.000Z",22,FALSE,16,3547251,"G",22,22,"Orlando Magic","Cole Anthony",2,11,13,7,8,18.2
0,0,0,0,0,0,0,0,0,"00",0,0,0,0,0,0,1038193,"2024-01-21T00:00:00.000Z",22,FALSE,16,666442,"C",22,22,"Orlando Magic","Goga Bitadze",0,0,0,0,0,0
1,0,0,2,1,5,2,2,1,"14",0,3,6,0,0,1,1038193,"2024-01-21T00:00:00.000Z",22,FALSE,16,56677827,"G",22,22,"Orlando Magic","Anthony Black",0,6,7,7,1,6.5
1,0,0,0,0,0,0,0,0,"08",0,0,0,0,0,0,1038193,"2024-01-21T00:00:00.000Z",22,FALSE,16,38017724,"G",22,22,"Orlando Magic","Caleb Houstan",0,0,1,1,1,1.5
0,0,1,0,0,0,0,2,1,"03",0,0,1,1,0,0,1038193,"2024-01-21T00:00:00.000Z",22,FALSE,16,56677839,"G",22,22,"Orlando Magic","Jett Howard",0,2,2,1,1,2.2
3,0,2,2,0,2,0,0,0,"17",1,0,0,3,0,3,1038193,"2024-01-21T00:00:00.000Z",22,FALSE,16,226,"F",22,22,"Orlando Magic","Joe Ingles",0,3,6,3,6,5.1
0,1,1,1,0,3,2,2,2,"14",0,0,6,1,0,0,1038193,"2024-01-21T00:00:00.000Z",22,FALSE,16,229,"F",22,22,"Orlando Magic","Jonathan Isaac",1,7,7,6,1,10.2
0,0,2,2,0,2,0,0,0,"03",0,0,0,2,0,0,1038193,"2024-01-21T00:00:00.000Z",22,FALSE,16,666818,"F",22,22,"Orlando Magic","Chuma Okeke",0,2,2,0,2,2.4
0,0,1,0,0,0,0,0,0,"03",0,0,0,1,0,0,1038193,"2024-01-21T00:00:00.000Z",22,FALSE,16,17553983,"G",22,22,"Orlando Magic","Trevelin Queen",0,1,1,0,1,1.2
0,0,1,0,0,3,1,8,6,"11",3,1,8,4,0,0,1038193,"2024-01-21T00:00:00.000Z",22,FALSE,16,462,"C",22,22,"Orlando Magic","Moritz Wagner",0,12,12,8,4,12.8
0,0,0,0,0,0,0,0,0,"00",0,0,0,0,0,0,1038193,"2024-01-21T00:00:00.000Z",22,FALSE,16,196,"G",22,22,"Orlando Magic","Gary Harris",0,0,0,0,0,0
0,0,0,0,0,0,0,0,0,"00",0,0,0,0,0,0,1038193,"2024-01-21T00:00:00.000Z",22,FALSE,16,38017607,"G",22,22,"Orlando Magic","Kevon Harris",0,0,0,0,0,0
7,0,5,1,0,17,8,6,6,"35",6,3,22,11,2,5,1038193,"2024-01-21T00:00:00.000Z",22,FALSE,16,4,"C-F",16,16,"Miami Heat","Bam Adebayo",2,33,40,29,18,46.7
4,0,3,1,1,7,5,0,0,"31",1,2,11,4,0,2,1038193,"2024-01-21T00:00:00.000Z",22,FALSE,16,666747,"F",16,16,"Miami Heat","Caleb Martin",0,15,19,15,8,19.8
2,0,0,11,4,14,4,0,0,"33",1,1,12,1,1,2,1038193,"2024-01-21T00:00:00.000Z",22,FALSE,16,666633,"G",16,16,"Miami Heat","Tyler Herro",1,13,15,14,3,17.2
0,0,0,0,0,0,0,0,0,"00",0,0,0,0,0,0,1038193,"2024-01-21T00:00:00.000Z",22,FALSE,16,74,"C",16,16,"Miami Heat","Thomas Bryant",0,0,0,0,0,0
1,0,2,1,1,3,1,3,2,"25",0,4,5,2,2,0,1038193,"2024-01-21T00:00:00.000Z",22,FALSE,16,3092,"",16,16,"Miami Heat","Haywood Highsmith",2,7,8,6,3,14.9
0,0,3,5,2,6,3,2,1,"14",3,4,9,6,0,1,1038193,"2024-01-21T00:00:00.000Z",22,FALSE,16,285,"F-C",16,16,"Miami Heat","Kevin Love",0,15,15,9,6,15.2
3,1,1,6,0,9,1,0,0,"25",1,2,2,2,2,0,1038193,"2024-01-21T00:00:00.000Z",22,FALSE,16,286,"G",16,16,"Miami Heat","Kyle Lowry",3,4,7,5,5,17.9
0,0,2,3,1,4,1,0,0,"09",0,1,3,2,0,1,1038193,"2024-01-21T00:00:00.000Z",22,FALSE,16,391,"G-F",16,16,"Miami Heat","Josh Richardson",0,5,5,3,2,4.4
1,0,1,3,0,6,1,4,4,"21",0,2,6,1,2,2,1038193,"2024-01-21T00:00:00.000Z",22,FALSE,16,397,"F",16,16,"Miami Heat","Duncan Robinson",2,7,8,7,2,12.7
2,0,0,0,0,0,0,0,0,"03",0,0,0,0,0,0,1038193,"2024-01-21T00:00:00.000Z",22,FALSE,16,39398582,"C",16,16,"Miami Heat","Orlando Robinson",0,0,2,2,2,3
0,0,0,0,0,0,0,0,0,"00",0,0,0,0,0,0,1038193,"2024-01-21T00:00:00.000Z",22,FALSE,16,38017734,"F",16,16,"Miami Heat","Jamal Cain",0,0,0,0,0,0
0,0,0,0,0,0,0,0,0,"00",0,0,0,0,0,0,1038193,"2024-01-21T00:00:00.000Z",22,FALSE,16,3547257,"G",16,16,"Miami Heat","R.J. Hampton",0,0,0,0,0,0
0,0,0,0,0,0,0,0,0,"00",0,0,0,0,0,0,1038193,"2024-01-21T00:00:00.000Z",22,FALSE,16,56677785,"G",16,16,"Miami Heat","Jaime Jaquez Jr.",0,0,0,0,0,0
0,0,0,0,0,0,0,0,0,"00",0,0,0,0,0,0,1038193,"2024-01-21T00:00:00.000Z",22,FALSE,16,19465585,"G",16,16,"Miami Heat","Dru Smith",0,0,0,0,0,0
0,0,0,0,0,0,0,0,0,"00",0,0,0,0,0,0,1038193,"2024-01-21T00:00:00.000Z",22,FALSE,16,38017736,"F",16,16,"Miami Heat","Cole Swider",0,0,0,0,0,0
0,0,0,0,0,0,0,0,0,"00",0,0,0,0,0,0,1038193,"2024-01-21T00:00:00.000Z",22,FALSE,16,666885,"F",22,22,"Orlando Magic","Admiral Schofield",0,0,0,0,0,0
2,0,4,5,3,10,5,2,2,"29",0,1,15,4,0,0,1038193,"2024-01-21T00:00:00.000Z",22,FALSE,16,79,"G-F",16,16,"Miami Heat","Jimmy Butler",0,19,21,17,6,22.8
0,0,3,1,0,4,1,1,0,"15",0,2,2,3,0,1,1038193,"2024-01-21T00:00:00.000Z",22,FALSE,16,38017696,"F",16,16,"Miami Heat","Nikola Jovic",0,5,5,2,3,4.6
3,1,8,1,0,5,1,4,2,"18",0,1,4,8,0,2,1038194,"2024-01-21T00:00:00.000Z",30,FALSE,8,3547242,"F",30,30,"Washington Wizards","Deni Avdija",1,12,15,7,11,19.1
7,2,6,4,2,14,7,2,1,"33",0,5,17,6,0,2,1038194,"2024-01-21T00:00:00.000Z",30,FALSE,8,265,"F",30,30,"Washington Wizards","Kyle Kuzma",2,23,30,24,13,38.7
2,1,4,0,0,10,7,2,1,"30",3,5,15,7,2,2,1038194,"2024-01-21T00:00:00.000Z",30,FALSE,8,666577,"F",30,30,"Washington Wizards","Daniel Gafford",3,22,24,17,9,33.4
0,0,1,4,1,7,1,1,1,"28",0,4,4,1,0,2,1038194,"2024-01-21T00:00:00.000Z",30,FALSE,8,666848,"G",30,30,"Washington Wizards","Jordan Poole",0,5,5,4,1,3.2
13,0,1,4,3,14,6,0,0,"31",1,0,15,2,1,1,1038194,"2024-01-21T00:00:00.000Z",30,FALSE,8,249,"G",30,30,"Washington Wizards","Tyus Jones",1,17,30,28,15,38.9
1,0,2,0,0,9,5,4,4,"18",5,3,14,7,0,0,1038194,"2024-01-21T00:00:00.000Z",30,FALSE,8,24,"F",9,30,"Washington Wizards","Marvin Bagley III",0,21,22,15,8,23.9
0,0,0,0,0,0,0,0,0,"00",0,0,0,0,0,0,1038194,"2024-01-21T00:00:00.000Z",30,FALSE,8,38017704,"F",30,30,"Washington Wizards","Patrick Baldwin Jr.",0,0,0,0,0,0
1,4,2,3,1,9,4,0,0,"31",1,2,9,3,1,2,1038194,"2024-01-21T00:00:00.000Z",30,FALSE,8,56677844,"G",30,30,"Washington Wizards","Bilal Coulibaly",5,12,13,10,4,27.1
0,0,0,0,0,0,0,0,0,"00",0,0,0,0,0,0,1038194,"2024-01-21T00:00:00.000Z",30,FALSE,8,3547302,"F",30,30,"Washington Wizards","Anthony Gill",0,0,0,0,0,0
0,0,0,0,0,0,0,0,0,"00",0,0,0,0,0,0,1038194,"2024-01-21T00:00:00.000Z",30,FALSE,8,NA,NA,NA,30,"Washington Wizards","NA NA",0,0,0,0,0,0
1,0,3,6,0,9,1,4,4,"18",0,0,6,3,0,1,1038194,"2024-01-21T00:00:00.000Z",30,FALSE,8,17896045,"F",30,30,"Washington Wizards","Corey Kispert",0,9,10,7,4,10.1
0,0,2,0,0,1,1,2,1,"07",2,1,3,4,0,1,1038194,"2024-01-21T00:00:00.000Z",30,FALSE,8,250,"C",8,8,"Denver Nuggets","DeAndre Jordan",0,7,7,3,4,6.8
2,0,0,0,0,2,1,0,0,"05",1,3,2,1,1,2,1038194,"2024-01-21T00:00:00.000Z",30,FALSE,8,3547268,"F-C",8,8,"Denver Nuggets","Zeke Nnaji",1,3,5,4,3,7.2
0,0,0,0,0,0,0,0,0,"00",0,0,0,0,0,0,1038194,"2024-01-21T00:00:00.000Z",30,FALSE,8,56677582,"G",8,8,"Denver Nuggets","Jalen Pickett",0,0,0,0,0,0
0,0,0,0,0,0,0,0,0,"00",0,0,0,0,0,0,1038194,"2024-01-21T00:00:00.000Z",30,FALSE,8,56677871,"F",8,8,"Denver Nuggets","Hunter Tyson",0,0,0,0,0,0
2,3,3,0,0,2,1,1,0,"13",0,0,2,3,0,2,1038194,"2024-01-21T00:00:00.000Z",30,FALSE,8,38017721,"G",8,8,"Denver Nuggets","Peyton Watson",3,5,7,4,5,15.6
0,0,0,0,0,0,0,0,0,"00",0,0,0,0,0,0,1038194,"2024-01-21T00:00:00.000Z",30,FALSE,8,666489,"F",8,8,"Denver Nuggets","Vlatko Cancar",0,0,0,0,0,0
0,0,0,0,0,0,0,0,0,"00",0,0,0,0,0,0,1038194,"2024-01-21T00:00:00.000Z",30,FALSE,8,38017727,"G",8,8,"Denver Nuggets","Collin Gillespie",0,0,0,0,0,0
0,0,0,0,0,0,0,0,0,"00",0,0,0,0,0,0,1038194,"2024-01-21T00:00:00.000Z",30,FALSE,8,17896007,"G",8,8,"Denver Nuggets","Braxton Key",0,0,0,0,0,0
0,0,0,0,0,0,0,0,0,"00",0,0,0,0,0,0,1038194,"2024-01-21T00:00:00.000Z",30,FALSE,8,56677776,"G",8,8,"Denver Nuggets","Julian Strawther",0,0,0,0,0,0
0,0,0,0,0,0,0,0,0,"00",0,0,0,0,0,0,1038194,"2024-01-21T00:00:00.000Z",30,FALSE,8,17896071,"F",9,30,"Washington Wizards","Isaiah Livers",0,0,0,0,0,0
0,0,0,0,0,0,0,0,0,"00",0,0,0,0,0,0,1038194,"2024-01-21T00:00:00.000Z",30,FALSE,8,17896106,"F",30,30,"Washington Wizards","Eugene Omoruyi",0,0,0,0,0,0
3,0,0,5,1,10,4,5,5,"16",1,2,14,1,1,0,1038194,"2024-01-21T00:00:00.000Z",30,FALSE,8,414,"G",30,30,"Washington Wizards","Landry Shamet",1,15,18,17,4,22.7
0,1,1,0,0,5,3,0,0,"17",1,1,6,2,1,0,1038194,"2024-01-21T00:00:00.000Z",30,FALSE,8,487,"G",30,30,"Washington Wizards","Delon Wright",2,8,8,6,2,14.4
0,0,0,0,0,0,0,0,0,"00",0,0,0,0,0,0,1038194,"2024-01-21T00:00:00.000Z",30,FALSE,8,NA,NA,NA,30,"Washington Wizards","NA NA",0,0,0,0,0,0
0,0,0,0,0,0,0,0,0,"00",0,0,0,0,0,0,1038194,"2024-01-21T00:00:00.000Z",30,FALSE,8,18677954,"G",30,30,"Washington Wizards","Jared Butler",0,0,0,0,0,0
0,0,0,0,0,0,0,0,0,"00",0,0,0,0,0,0,1038194,"2024-01-21T00:00:00.000Z",30,FALSE,8,38017687,"G",30,30,"Washington Wizards","Johnny Davis",0,0,0,0,0,0
0,2,6,7,3,14,8,0,0,"32",0,2,19,6,2,3,1038194,"2024-01-21T00:00:00.000Z",30,FALSE,8,375,"F",8,8,"Denver Nuggets","Michael Porter Jr.",4,25,25,19,6,35.2
2,3,7,0,0,10,4,7,3,"31",3,0,11,10,1,1,1038194,"2024-01-21T00:00:00.000Z",30,FALSE,8,177,"F",8,8,"Denver Nuggets","Aaron Gordon",4,21,23,13,12,37
8,3,8,0,0,20,15,14,12,"36",4,2,42,12,1,0,1038194,"2024-01-21T00:00:00.000Z",30,FALSE,8,246,"C",8,8,"Denver Nuggets","Nikola Jokic",4,54,62,50,20,80.4
3,0,3,5,1,9,4,2,1,"35",0,2,10,3,3,2,1038194,"2024-01-21T00:00:00.000Z",30,FALSE,8,81,"G",8,8,"Denver Nuggets","Kentavious Caldwell-Pope",3,13,16,13,6,25.1
7,0,4,8,3,23,7,2,2,"39",1,2,19,5,0,1,1038194,"2024-01-21T00:00:00.000Z",30,FALSE,8,335,"G",8,8,"Denver Nuggets","Jamal Murray",0,24,31,26,12,34.5
2,1,4,0,0,3,1,0,0,"21",2,3,2,6,0,1,1038194,"2024-01-21T00:00:00.000Z",30,FALSE,8,38017709,"G",8,8,"Denver Nuggets","Christian Braun",1,8,10,4,8,14.2
0,0,0,0,0,0,0,0,0,"00",0,0,0,0,0,0,1038194,"2024-01-21T00:00:00.000Z",30,FALSE,8,215,"F-G",8,8,"Denver Nuggets","Justin Holiday",0,0,0,0,0,0
0,0,0,0,0,0,0,0,0,"00",0,0,0,0,0,0,1038194,"2024-01-21T00:00:00.000Z",30,FALSE,8,17896103,"F-C",8,8,"Denver Nuggets","Jay Huff",0,0,0,0,0,0
3,0,1,2,1,4,1,0,0,"21",0,1,3,1,0,0,1038194,"2024-01-21T00:00:00.000Z",30,FALSE,8,236,"G",8,8,"Denver Nuggets","Reggie Jackson",0,4,7,6,4,8.7
0,1,4,4,1,7,2,2,0,"27",0,1,5,4,1,1,1038195,"2024-01-21T00:00:00.000Z",11,FALSE,2,56677831,"F",11,11,"Houston Rockets","Cam Whitmore",2,9,9,5,4,14.8
1,0,4,15,5,23,8,5,4,"40",1,5,25,5,4,0,1038195,"2024-01-21T00:00:00.000Z",11,FALSE,2,66,"G-F",11,11,"Houston Rockets","Dillon Brooks",4,30,31,26,6,44.5
10,0,10,2,0,18,10,4,4,"37",2,2,24,12,1,6,1038195,"2024-01-21T00:00:00.000Z",11,FALSE,2,17896062,"F-C",11,11,"Houston Rockets","Alperen Sengun",1,36,46,34,22,50.4
5,0,11,2,0,10,5,6,5,"32",3,3,15,14,1,2,1038195,"2024-01-21T00:00:00.000Z",11,FALSE,2,56677825,"G-F",11,11,"Houston Rockets","Amen Thompson",1,29,34,20,19,40.3
5,0,3,6,1,18,7,3,1,"32",1,0,16,4,1,3,1038195,"2024-01-21T00:00:00.000Z",11,FALSE,2,17895966,"G",11,11,"Houston Rockets","Jalen Green",1,20,25,21,9,28.3
0,0,0,0,0,0,0,0,0,"00",0,0,0,0,0,0,1038195,"2024-01-21T00:00:00.000Z",11,FALSE,2,3547281,"G-F",11,11,"Houston Rockets","Nate Hinton",0,0,0,0,0,0
5,0,4,5,2,8,5,0,0,"27",0,4,12,4,1,2,1038195,"2024-01-21T00:00:00.000Z",11,FALSE,2,213,"G",11,11,"Houston Rockets","Aaron Holiday",1,16,21,17,9,25.3
0,0,1,0,0,2,1,2,1,"11",2,0,3,3,0,1,1038195,"2024-01-21T00:00:00.000Z",11,FALSE,2,19465326,"C",11,11,"Houston Rockets","Jock Landale",0,6,6,3,3,5.6
0,0,0,0,0,0,0,0,0,"00",0,0,0,0,0,0,1038195,"2024-01-21T00:00:00.000Z",11,FALSE,2,296,"C",11,11,"Houston Rockets","Boban Marjanovic",0,0,0,0,0,0
0,0,0,0,0,0,0,0,0,"00",0,0,0,0,0,0,1038195,"2024-01-21T00:00:00.000Z",11,FALSE,2,56677809,"F",11,11,"Houston Rockets","Jermaine Samuels Jr.",0,0,0,0,0,0
0,2,0,0,0,2,1,0,0,"15",0,1,2,0,0,0,1038195,"2024-01-21T00:00:00.000Z",11,FALSE,2,3547301,"F",11,11,"Houston Rockets","Jae'Sean Tate",2,2,2,2,0,8
0,0,1,1,1,6,2,0,0,"19",2,1,5,3,0,0,1038195,"2024-01-21T00:00:00.000Z",11,FALSE,2,47738533,"G",11,11,"Houston Rockets","Jeenathan Williams",0,8,8,5,3,8.6
0,0,0,0,0,0,0,0,0,"00",0,0,0,0,0,0,1038195,"2024-01-21T00:00:00.000Z",11,FALSE,2,75,"G-F",11,11,"Houston Rockets","Reggie Bullock",0,0,0,0,0,0
0,0,0,0,0,0,0,0,0,"00",0,0,0,0,0,0,1038195,"2024-01-21T00:00:00.000Z",11,FALSE,2,38017695,"F",11,11,"Houston Rockets","Tari Eason",0,0,0,0,0,0
0,0,0,0,0,0,0,0,0,"00",0,0,0,0,0,0,1038195,"2024-01-21T00:00:00.000Z",11,FALSE,2,188,"F",11,11,"Houston Rockets","Jeff Green",0,0,0,0,0,0
0,0,0,0,0,0,0,0,0,"00",0,0,0,0,0,0,1038195,"2024-01-21T00:00:00.000Z",11,FALSE,2,357,"G",11,11,"Houston Rockets","Victor Oladipo",0,0,0,0,0,0
0,0,0,0,0,0,0,0,0,"00",0,0,0,0,0,0,1038195,"2024-01-21T00:00:00.000Z",11,FALSE,2,38017684,"F",11,11,"Houston Rockets","Jabari Smith Jr.",0,0,0,0,0,0
0,0,0,0,0,0,0,0,0,"00",0,0,0,0,0,0,1038195,"2024-01-21T00:00:00.000Z",11,FALSE,2,458,"G",11,11,"Houston Rockets","Fred VanVleet",0,0,0,0,0,0
6,1,5,12,3,12,3,0,0,"31",2,0,9,7,1,1,1038195,"2024-01-21T00:00:00.000Z",11,FALSE,2,17896060,"F",2,2,"Boston Celtics","Sam Hauser",2,16,22,15,13,31.4
3,0,6,6,1,17,4,12,9,"35",1,0,18,7,1,2,1038195,"2024-01-21T00:00:00.000Z",11,FALSE,2,434,"F",2,2,"Boston Celtics","Jayson Tatum",1,25,28,21,10,31.9
1,5,2,11,6,21,11,4,4,"33",3,5,32,5,1,3,1038195,"2024-01-21T00:00:00.000Z",11,FALSE,2,378,"F-C",2,2,"Boston Celtics","Kristaps Porzingis",6,37,38,33,6,54.5
10,0,11,3,1,14,6,2,0,"31",0,0,13,11,3,3,1038195,"2024-01-21T00:00:00.000Z",11,FALSE,2,70,"G",2,2,"Boston Celtics","Jaylen Brown",3,24,34,23,21,47.2
3,2,9,8,3,19,9,0,0,"36",2,2,21,11,0,3,1038195,"2024-01-21T00:00:00.000Z",11,FALSE,2,473,"G",2,2,"Boston Celtics","Derrick White",2,32,35,24,14,41.7
0,0,0,0,0,0,0,0,0,"00",0,0,0,0,0,0,1038195,"2024-01-21T00:00:00.000Z",11,FALSE,2,17896094,"G",2,2,"Boston Celtics","Dalano Banton",0,0,0,0,0,0
3,1,1,2,0,5,3,0,0,"18",1,4,6,2,0,3,1038195,"2024-01-21T00:00:00.000Z",11,FALSE,2,666468,"F",2,2,"Boston Celtics","Oshae Brissett",1,8,11,9,5,12.9
1,3,4,0,0,4,4,0,0,"23",6,3,8,10,1,1,1038195,"2024-01-21T00:00:00.000Z",11,FALSE,2,261,"F-C",2,2,"Boston Celtics","Luke Kornet",4,18,19,9,11,32.5
0,0,0,0,0,0,0,0,0,"00",0,0,0,0,0,0,1038195,"2024-01-21T00:00:00.000Z",11,FALSE,2,338,"G",2,2,"Boston Celtics","Svi Mykhailiuk",0,0,0,0,0,0
4,0,1,5,3,6,3,0,0,"30",1,1,9,2,2,0,1038195,"2024-01-21T00:00:00.000Z",11,FALSE,2,3547276,"G",2,2,"Boston Celtics","Payton Pritchard",2,11,15,13,6,23.4
0,0,0,0,0,0,0,0,0,"03",0,2,0,0,1,0,1038195,"2024-01-21T00:00:00.000Z",11,FALSE,2,17553967,"C",2,2,"Boston Celtics","Neemias Queta",1,0,0,0,0,3
0,0,0,0,0,0,0,0,0,"00",0,0,0,0,0,0,1038195,"2024-01-21T00:00:00.000Z",11,FALSE,2,3547279,"F",2,2,"Boston Celtics","Lamar Stevens",0,0,0,0,0,0
0,0,0,0,0,0,0,0,0,"00",0,0,0,0,0,0,1038195,"2024-01-21T00:00:00.000Z",11,FALSE,2,56677864,"G",2,2,"Boston Celtics","Jordan Walsh",0,0,0,0,0,0
0,0,0,0,0,0,0,0,0,"00",0,0,0,0,0,0,1038195,"2024-01-21T00:00:00.000Z",11,FALSE,2,38017707,"G",2,2,"Boston Celtics","JD Davison",0,0,0,0,0,0
0,0,0,0,0,0,0,0,0,"00",0,0,0,0,0,0,1038195,"2024-01-21T00:00:00.000Z",11,FALSE,2,214,"G",2,2,"Boston Celtics","Jrue Holiday",0,0,0,0,0,0
0,0,0,0,0,0,0,0,0,"00",0,0,0,0,0,0,1038195,"2024-01-21T00:00:00.000Z",11,FALSE,2,219,"C-F",2,2,"Boston Celtics","Al Horford",0,0,0,0,0,0
0,0,0,0,0,0,0,0,0,"00",0,0,0,0,0,0,1038195,"2024-01-21T00:00:00.000Z",11,FALSE,2,NA,NA,NA,2,"Boston Celtics","NA NA",0,0,0,0,0,0
2,0,1,4,3,7,5,0,0,"32",1,1,13,2,1,0,1038196,"2024-01-21T00:00:00.000Z",24,FALSE,12,8,"G",24,24,"Phoenix Suns","Grayson Allen",1,15,17,15,4,21.4
2,3,8,7,4,25,18,0,0,"40",1,4,40,9,0,2,1038196,"2024-01-21T00:00:00.000Z",24,FALSE,12,140,"F",24,24,"Phoenix Suns","Kevin Durant",3,49,51,42,11,60.8
4,1,13,0,0,2,2,0,0,"19",0,6,4,13,0,6,1038196,"2024-01-21T00:00:00.000Z",24,FALSE,12,349,"C",24,24,"Phoenix Suns","Jusuf Nurkic",1,17,21,8,17,22.6
3,0,3,1,0,16,11,3,3,"38",1,4,25,4,1,2,1038196,"2024-01-21T00:00:00.000Z",24,FALSE,12,37,"G",24,24,"Phoenix Suns","Bradley Beal",1,29,32,28,7,35.3
8,0,5,7,1,24,9,9,7,"36",1,2,26,6,2,2,1038196,"2024-01-21T00:00:00.000Z",24,FALSE,12,57,"G",24,24,"Phoenix Suns","Devin Booker",2,32,40,34,14,49.2
1,0,1,0,0,0,0,0,0,"12",1,1,0,2,1,1,1038196,"2024-01-21T00:00:00.000Z",24,FALSE,12,32,"F",24,24,"Phoenix Suns","Keita Bates-Diop",1,2,3,1,3,5.9
0,0,2,0,0,1,1,2,1,"11",0,2,3,2,0,1,1038196,"2024-01-21T00:00:00.000Z",24,FALSE,12,147,"F",24,24,"Phoenix Suns","Drew Eubanks",0,5,5,3,2,4.4
0,0,0,0,0,0,0,0,0,"00",0,0,0,0,0,0,1038196,"2024-01-21T00:00:00.000Z",24,FALSE,12,18678058,"",24,24,"Phoenix Suns","Jordan Goodwin",0,0,0,0,0,0
2,1,3,5,0,6,1,2,2,"30",0,2,4,3,0,2,1038196,"2024-01-21T00:00:00.000Z",24,FALSE,12,178,"G",24,24,"Phoenix Suns","Eric Gordon",1,7,9,6,5,11.6
0,0,0,0,0,0,0,0,0,"00",0,0,0,0,0,0,1038196,"2024-01-21T00:00:00.000Z",24,FALSE,12,666729,"F",24,24,"Phoenix Suns","Nassir Little",0,0,0,0,0,0
1,0,1,0,0,0,0,2,2,"07",0,2,2,1,1,0,1038196,"2024-01-21T00:00:00.000Z",24,FALSE,12,314,"F",24,24,"Phoenix Suns","Chimezie Metu",1,3,4,3,2,7.7
0,0,0,0,0,0,0,0,0,"00",0,0,0,0,0,0,1038196,"2024-01-21T00:00:00.000Z",24,FALSE,12,666451,"C",24,24,"Phoenix Suns","Bol Bol",0,0,0,0,0,0
0,0,0,0,0,0,0,0,0,"00",0,0,0,0,0,0,1038196,"2024-01-21T00:00:00.000Z",24,FALSE,12,272,"G",24,24,"Phoenix Suns","Damion Lee",0,0,0,0,0,0
0,0,0,0,0,0,0,0,0,"00",0,0,0,0,0,0,1038196,"2024-01-21T00:00:00.000Z",24,FALSE,12,3547298,"G",24,24,"Phoenix Suns","Saben Lee",0,0,0,0,0,0
0,0,0,0,0,0,0,0,0,"00",0,0,0,0,0,0,1038196,"2024-01-21T00:00:00.000Z",24,FALSE,12,3547253,"G",4,24,"Phoenix Suns","Theo Maledon",0,0,0,0,0,0
1,0,2,5,1,7,2,3,1,"26",1,4,6,3,1,0,1038196,"2024-01-21T00:00:00.000Z",24,FALSE,12,3547250,"G-F",12,12,"Indiana Pacers","Aaron Nesmith",1,9,10,7,4,14.1
7,0,2,3,1,14,6,2,2,"30",2,6,15,4,0,3,1038196,"2024-01-21T00:00:00.000Z",24,FALSE,12,416,"F",28,12,"Indiana Pacers","Pascal Siakam",0,19,26,22,11,27.3
6,0,0,0,0,9,3,4,3,"25",0,3,9,0,1,4,1038196,"2024-01-21T00:00:00.000Z",24,FALSE,12,38017507,"G-F",12,12,"Indiana Pacers","Andrew Nembhard",1,9,15,15,6,17
2,0,1,1,0,1,0,0,0,"15",1,0,0,2,1,0,1038196,"2024-01-21T00:00:00.000Z",24,FALSE,12,356,"G",24,24,"Phoenix Suns","Josh Okogie",1,2,4,2,4,8.4
0,0,0,0,0,0,0,0,0,"00",0,0,0,0,0,0,1038196,"2024-01-21T00:00:00.000Z",24,FALSE,12,470,"G",24,24,"Phoenix Suns","Yuta Watanabe",0,0,0,0,0,0
0,0,0,0,0,0,0,0,0,"00",0,0,0,0,0,0,1038196,"2024-01-21T00:00:00.000Z",24,FALSE,12,3547095,"C-F",24,24,"Phoenix Suns","Udoka Azubuike",0,0,0,0,0,0
0,0,0,0,0,0,0,0,0,"00",0,0,0,0,0,0,1038196,"2024-01-21T00:00:00.000Z",24,FALSE,12,38017701,"G",12,12,"Indiana Pacers","Kendall Brown",0,0,0,0,0,0
0,0,0,0,0,0,0,0,0,"00",0,0,0,0,0,0,1038196,"2024-01-21T00:00:00.000Z",24,FALSE,12,242,"F",12,12,"Indiana Pacers","James Johnson",0,0,0,0,0,0
0,0,3,4,1,8,1,2,1,"14",0,0,4,3,0,0,1038196,"2024-01-21T00:00:00.000Z",24,FALSE,12,38017686,"G-F",12,12,"Indiana Pacers","Bennedict Mathurin",0,7,7,4,3,7.6
3,0,1,0,0,8,2,0,0,"12",0,0,4,1,2,1,1038196,"2024-01-21T00:00:00.000Z",24,FALSE,12,304,"G",12,12,"Indiana Pacers","T.J. McConnell",2,5,8,7,4,14.7
4,0,2,1,0,4,1,2,2,"20",2,3,4,4,2,0,1038196,"2024-01-21T00:00:00.000Z",24,FALSE,12,56677861,"G",12,12,"Indiana Pacers","Ben Sheppard",2,8,12,8,8,20.8
1,2,2,3,3,5,5,4,2,"19",2,0,15,4,1,1,1038196,"2024-01-21T00:00:00.000Z",24,FALSE,12,3547264,"F-C",12,12,"Indiana Pacers","Jalen Smith",3,19,20,16,5,29.3
1,0,4,2,0,12,6,2,1,"26",2,1,13,6,0,0,1038196,"2024-01-21T00:00:00.000Z",24,FALSE,12,3547243,"F",12,12,"Indiana Pacers","Obi Toppin",0,19,20,14,7,21.7
0,0,0,0,0,0,0,0,0,"00",0,0,0,0,0,0,1038196,"2024-01-21T00:00:00.000Z",24,FALSE,12,56677778,"F-C",12,12,"Indiana Pacers","Oscar Tshiebwe",0,0,0,0,0,0
1,0,6,3,2,6,4,0,0,"18",3,0,10,9,1,1,1038196,"2024-01-21T00:00:00.000Z",24,FALSE,12,56677832,"F",12,12,"Indiana Pacers","Jarace Walker",1,19,20,11,10,24.3
0,0,0,0,0,0,0,0,0,"00",0,0,0,0,0,0,1038196,"2024-01-21T00:00:00.000Z",24,FALSE,12,56677794,"G",12,12,"Indiana Pacers","Isaiah Wong",0,0,0,0,0,0
0,0,0,0,0,0,0,0,0,"00",0,0,0,0,0,0,1038196,"2024-01-21T00:00:00.000Z",24,FALSE,12,3547245,"G",12,12,"Indiana Pacers","Tyrese Haliburton",0,0,0,0,0,0
0,0,0,0,0,0,0,0,0,"00",0,0,0,0,0,0,1038196,"2024-01-21T00:00:00.000Z",24,FALSE,12,17896035,"F",12,12,"Indiana Pacers","Isaiah Jackson",0,0,0,0,0,0
1,2,1,2,1,11,5,2,1,"19",1,1,12,2,0,1,1038196,"2024-01-21T00:00:00.000Z",24,FALSE,12,452,"C-F",12,12,"Indiana Pacers","Myles Turner",2,14,15,13,3,20.9
3,0,3,8,5,10,6,2,1,"31",1,2,18,4,1,0,1038196,"2024-01-21T00:00:00.000Z",24,FALSE,12,210,"G",12,12,"Indiana Pacers","Buddy Hield",1,22,25,21,7,30.3
2,0,1,3,1,7,2,5,4,"23",1,2,9,2,1,1,1038197,"2024-01-21T00:00:00.000Z",14,FALSE,25,666609,"F",14,14,"Los Angeles Lakers","Rui Hachimura",1,11,13,11,4,16.4
5,0,5,8,3,16,8,10,9,"31",0,2,28,5,0,3,1038197,"2024-01-21T00:00:00.000Z",14,FALSE,25,237,"F",14,14,"Los Angeles Lakers","LeBron James",0,33,38,33,10,38.5
3,0,11,1,0,7,4,6,6,"26",3,0,14,14,0,0,1038197,"2024-01-21T00:00:00.000Z",14,FALSE,25,117,"F-C",14,14,"Los Angeles Lakers","Anthony Davis",0,28,31,17,17,35.3
2,0,3,4,3,10,5,2,2,"26",1,1,15,4,1,1,1038197,"2024-01-21T00:00:00.000Z",14,FALSE,25,17553995,"G",14,14,"Los Angeles Lakers","Austin Reaves",1,19,21,17,6,24.8
8,2,0,11,6,21,14,0,0,"34",1,2,34,1,0,0,1038197,"2024-01-21T00:00:00.000Z",14,FALSE,25,405,"G",14,14,"Los Angeles Lakers","D'Angelo Russell",2,35,43,42,9,53.2
0,0,1,0,0,1,1,2,2,"04",1,1,4,2,0,1,1038197,"2024-01-21T00:00:00.000Z",14,FALSE,25,56677738,"C",14,14,"Los Angeles Lakers","Colin Castleton",0,6,6,4,2,5.4
2,1,1,3,0,7,1,2,2,"22",0,3,4,1,0,2,1038197,"2024-01-21T00:00:00.000Z",14,FALSE,25,38017697,"G",14,14,"Los Angeles Lakers","Max Christie",1,5,7,6,3,9.2
0,0,1,0,0,2,2,0,0,"04",0,2,4,1,0,0,1038197,"2024-01-21T00:00:00.000Z",14,FALSE,25,666626,"C",14,14,"Los Angeles Lakers","Jaxson Hayes",0,5,5,4,1,5.2
1,0,1,0,0,1,1,2,2,"06",0,0,4,1,1,1,1038197,"2024-01-21T00:00:00.000Z",14,FALSE,25,56677835,"G",14,14,"Los Angeles Lakers","Jalen Hood-Schifino",1,5,6,5,2,8.7
0,0,0,0,0,0,0,0,0,"04",0,0,0,0,0,0,1038197,"2024-01-21T00:00:00.000Z",14,FALSE,25,56677836,"F",14,14,"Los Angeles Lakers","Maxwell Lewis",0,0,0,0,0,0
1,0,4,2,0,8,5,0,0,"21",0,2,10,4,2,0,1038197,"2024-01-21T00:00:00.000Z",14,FALSE,25,666860,"F-G",14,14,"Los Angeles Lakers","Cameron Reddish",2,14,15,11,5,22.3
2,0,2,0,0,3,2,0,0,"21",2,1,4,4,2,3,1038197,"2024-01-21T00:00:00.000Z",14,FALSE,25,457,"F",14,14,"Los Angeles Lakers","Jarred Vanderbilt",2,8,10,6,6,14.8
2,3,5,1,0,3,2,0,0,"18",1,2,4,6,2,0,1038197,"2024-01-21T00:00:00.000Z",14,FALSE,25,486,"F",14,14,"Los Angeles Lakers","Christian Wood",5,10,12,6,8,29.2
0,0,0,0,0,0,0,0,0,"00",0,0,0,0,0,0,1038197,"2024-01-21T00:00:00.000Z",14,FALSE,25,3547289,"G",25,14,"Los Angeles Lakers","Skylar Mays",0,0,0,0,0,0
0,0,0,0,0,0,0,0,0,"00",0,0,0,0,0,0,1038197,"2024-01-21T00:00:00.000Z",14,FALSE,25,383,"F",14,14,"Los Angeles Lakers","Taurean Prince",0,0,0,0,0,0
0,0,0,0,0,0,0,0,0,"00",0,0,0,0,0,0,1038197,"2024-01-21T00:00:00.000Z",14,FALSE,25,1603383,"G",14,14,"Los Angeles Lakers","Gabe Vincent",0,0,0,0,0,0
0,0,0,0,0,0,0,0,0,"00",0,0,0,0,0,0,1038197,"2024-01-21T00:00:00.000Z",14,FALSE,25,666971,"G-F",20,14,"Los Angeles Lakers","Dylan Windler",0,0,0,0,0,0
3,1,2,3,0,15,6,5,5,"33",1,3,17,3,1,1,1038197,"2024-01-21T00:00:00.000Z",14,FALSE,25,182,"F",25,25,"Portland Trail Blazers","Jerami Grant",2,20,23,20,6,30.1
0,0,4,2,1,8,5,2,1,"22",3,0,12,7,0,0,1038197,"2024-01-21T00:00:00.000Z",14,FALSE,25,38017711,"F",25,25,"Portland Trail Blazers","Jabari Walker",0,19,19,12,7,20.4
0,0,3,0,0,7,3,0,0,"22",1,3,6,4,0,1,1038197,"2024-01-21T00:00:00.000Z",14,FALSE,25,22,"C",25,25,"Portland Trail Blazers","Deandre Ayton",0,10,10,6,4,9.8
3,0,2,7,3,15,8,0,0,"30",0,4,19,2,0,4,1038197,"2024-01-21T00:00:00.000Z",14,FALSE,25,419,"G",25,25,"Portland Trail Blazers","Anfernee Simons",0,21,24,22,5,21.9
9,1,6,4,3,17,8,5,4,"33",1,3,23,7,0,1,1038197,"2024-01-21T00:00:00.000Z",14,FALSE,25,65,"G",25,25,"Portland Trail Blazers","Malcolm Brogdon",1,30,39,32,16,46.9
0,0,0,2,0,5,2,2,2,"06",1,0,6,1,0,0,1038197,"2024-01-21T00:00:00.000Z",14,FALSE,25,56677829,"G-F",25,25,"Portland Trail Blazers","Rayan Rupert",0,7,7,6,1,7.2
2,0,0,1,0,1,0,0,0,"12",0,0,0,0,3,0,1038197,"2024-01-21T00:00:00.000Z",14,FALSE,25,666923,"G-F",25,25,"Portland Trail Blazers","Matisse Thybulle",3,0,2,2,2,12
0,0,0,0,0,0,0,0,0,"00",0,0,0,0,0,0,1038197,"2024-01-21T00:00:00.000Z",14,FALSE,25,666476,"C",25,25,"Portland Trail Blazers","Moses Brown",0,0,0,0,0,0
0,0,0,0,0,0,0,0,0,"00",0,0,0,0,0,0,1038197,"2024-01-21T00:00:00.000Z",14,FALSE,25,47957121,"F",25,25,"Portland Trail Blazers","Justin Minaya",0,0,0,0,0,0
1,0,4,2,0,5,2,2,1,"23",1,3,5,5,2,1,1038197,"2024-01-21T00:00:00.000Z",14,FALSE,25,56677850,"F",25,25,"Portland Trail Blazers","Toumani Camara",2,10,11,6,6,17.5
2,0,1,3,0,6,1,2,2,"23",0,1,4,1,0,3,1038197,"2024-01-21T00:00:00.000Z",14,FALSE,25,56677747,"G",25,25,"Portland Trail Blazers","Scoot Henderson",0,5,7,6,3,5.2
0,1,1,0,0,0,0,0,0,"03",0,0,0,1,0,0,1038197,"2024-01-21T00:00:00.000Z",14,FALSE,25,39613724,"C",25,25,"Portland Trail Blazers","Ibou Badji",1,1,1,0,1,4.2
0,0,0,1,0,2,1,0,0,"04",0,1,2,0,1,0,1038197,"2024-01-21T00:00:00.000Z",14,FALSE,25,NA,NA,NA,25,"Portland Trail Blazers","NA NA",1,2,2,2,0,5
0,1,1,0,0,0,0,0,0,"06",0,0,0,1,0,0,1038197,"2024-01-21T00:00:00.000Z",14,FALSE,25,56677791,"F",25,25,"Portland Trail Blazers","Kris Murray",1,1,1,0,1,4.2
4,1,1,4,2,9,6,2,2,"23",2,3,16,3,0,1,1038197,"2024-01-21T00:00:00.000Z",14,FALSE,25,56783340,"C",25,25,"Portland Trail Blazers","Duop Reath",1,19,23,20,7,27.6
0,0,0,0,0,0,0,0,0,"00",0,0,0,0,0,0,1038197,"2024-01-21T00:00:00.000Z",14,FALSE,25,38017690,"G",25,25,"Portland Trail Blazers","Shaedon Sharpe",0,0,0,0,0,0
0,0,0,0,0,0,0,0,0,"00",0,0,0,0,0,0,1038197,"2024-01-21T00:00:00.000Z",14,FALSE,25,476,"C-F",25,25,"Portland Trail Blazers","Robert Williams III",0,0,0,0,0,0
4,1,3,3,2,15,6,8,7,"37",1,2,21,4,0,2,1038192,"2024-01-21T00:00:00.000Z",13,FALSE,3,274,"F",13,13,"LA Clippers","Kawhi Leonard",1,25,29,25,8,32.8
1,0,6,7,2,17,5,0,0,"36",1,3,12,7,1,1,1038192,"2024-01-21T00:00:00.000Z",13,FALSE,3,172,"F",13,13,"LA Clippers","Paul George",1,19,20,13,8,23.9
1,0,7,0,0,3,1,6,5,"15",1,2,7,8,0,0,1038192,"2024-01-21T00:00:00.000Z",13,FALSE,3,371,"F-C",13,13,"LA Clippers","Mason Plumlee",0,15,16,8,9,18.1
2,0,3,3,2,6,4,3,3,"26",0,1,13,3,1,0,1038192,"2024-01-21T00:00:00.000Z",13,FALSE,3,666743,"G",13,13,"LA Clippers","Terance Mann",1,16,18,15,5,22.6
10,1,5,6,3,11,6,9,9,"39",0,2,24,5,2,4,1038192,"2024-01-21T00:00:00.000Z",13,FALSE,3,192,"G",13,13,"LA Clippers","James Harden",3,29,39,34,15,50
0,0,0,0,0,0,0,0,0,"00",0,0,0,0,0,0,1038192,"2024-01-21T00:00:00.000Z",13,FALSE,3,17896022,"G",13,13,"LA Clippers","Brandon Boston Jr.",0,0,0,0,0,0
0,0,0,0,0,0,0,0,0,"00",0,0,0,0,0,0,1038192,"2024-01-21T00:00:00.000Z",13,FALSE,3,56677849,"F",13,13,"LA Clippers","Kobe Brown",0,0,0,0,0,0
1,0,1,1,1,2,2,0,0,"15",0,2,5,1,1,0,1038192,"2024-01-21T00:00:00.000Z",13,FALSE,3,666511,"G",13,13,"LA Clippers","Amir Coffey",1,6,7,6,2,10.7
0,0,0,0,0,0,0,0,0,"00",0,0,0,0,0,0,1038192,"2024-01-21T00:00:00.000Z",13,FALSE,3,17896031,"G",13,13,"LA Clippers","Nah'Shon Hyland",0,0,0,0,0,0
0,0,5,3,2,7,4,3,2,"24",0,2,12,5,0,0,1038192,"2024-01-21T00:00:00.000Z",13,FALSE,3,380,"F-G",13,13,"LA Clippers","Norman Powell",0,17,17,12,5,18
1,2,1,1,0,6,4,0,0,"17",2,1,8,3,0,1,1038192,"2024-01-21T00:00:00.000Z",13,FALSE,3,439,"F",13,13,"LA Clippers","Daniel Theis",2,11,12,9,4,18.1
0,0,0,0,0,0,0,0,0,"00",0,0,0,0,0,0,1038192,"2024-01-21T00:00:00.000Z",13,FALSE,3,450,"F",13,13,"LA Clippers","PJ Tucker",0,0,0,0,0,0
6,1,6,2,1,16,10,4,2,"31",3,3,23,9,1,2,1038192,"2024-01-21T00:00:00.000Z",13,FALSE,3,472,"G",13,13,"LA Clippers","Russell Westbrook",2,32,38,29,15,46.8
0,0,0,0,0,0,0,0,0,"00",0,0,0,0,0,0,1038192,"2024-01-21T00:00:00.000Z",13,FALSE,3,38017725,"F",13,13,"LA Clippers","Moussa Diabate",0,0,0,0,0,0
6,0,4,7,2,11,3,2,1,"29",0,1,9,4,1,0,1038192,"2024-01-21T00:00:00.000Z",13,FALSE,3,666679,"F",3,3,"Brooklyn Nets","Cameron Johnson",1,13,19,15,10,25.8
0,1,9,3,0,5,0,0,0,"27",0,2,0,9,0,1,1038192,"2024-01-21T00:00:00.000Z",13,FALSE,3,158,"F",3,3,"Brooklyn Nets","Dorian Finney-Smith",1,9,9,0,9,12.8
3,2,4,1,0,10,7,4,2,"31",2,5,16,6,1,0,1038192,"2024-01-21T00:00:00.000Z",13,FALSE,3,666508,"F-C",3,3,"Brooklyn Nets","Nicolas Claxton",3,22,25,19,9,36.7
5,1,5,7,4,17,9,4,4,"38",1,1,26,6,1,3,1038192,"2024-01-21T00:00:00.000Z",13,FALSE,3,61,"F",3,3,"Brooklyn Nets","Mikal Bridges",2,32,37,31,11,43.7
7,1,1,6,4,9,6,0,0,"33",1,2,16,2,0,1,1038192,"2024-01-21T00:00:00.000Z",13,FALSE,3,130,"G",3,3,"Brooklyn Nets","Spencer Dinwiddie",1,18,25,23,9,30.9
0,0,0,0,0,0,0,0,0,"00",0,0,0,0,0,0,1038192,"2024-01-21T00:00:00.000Z",13,FALSE,3,174,"F-C",3,3,"Brooklyn Nets","Harry Giles III",0,0,0,0,0,0
0,0,1,5,0,6,1,2,2,"15",0,2,4,1,0,0,1038192,"2024-01-21T00:00:00.000Z",13,FALSE,3,351,"F",3,3,"Brooklyn Nets","Royce O'Neale",0,5,5,4,1,5.2
0,0,0,0,0,0,0,0,0,"00",0,0,0,0,0,0,1038192,"2024-01-21T00:00:00.000Z",13,FALSE,3,56677856,"G",13,13,"LA Clippers","Jordan Miller",0,0,0,0,0,0
0,0,0,0,0,0,0,0,0,"00",0,0,0,0,0,0,1038192,"2024-01-21T00:00:00.000Z",13,FALSE,3,24417679,"G",13,13,"LA Clippers","Xavier Moon",0,0,0,0,0,0
0,0,0,0,0,0,0,0,0,"00",0,0,0,0,0,0,1038192,"2024-01-21T00:00:00.000Z",13,FALSE,3,17896051,"G",13,13,"LA Clippers","Joshua Primo",0,0,0,0,0,0
0,0,0,0,0,0,0,0,0,"00",0,0,0,0,0,0,1038192,"2024-01-21T00:00:00.000Z",13,FALSE,3,493,"C",13,13,"LA Clippers","Ivica Zubac",0,0,0,0,0,0
0,0,0,0,0,0,0,0,0,"00",0,0,0,0,0,0,1038192,"2024-01-21T00:00:00.000Z",13,FALSE,3,17896038,"C",3,3,"Brooklyn Nets","Day'Ron Sharpe",0,0,0,0,0,0
1,0,2,2,1,8,6,0,0,"18",1,2,13,3,0,2,1038192,"2024-01-21T00:00:00.000Z",13,FALSE,3,421,"G",3,3,"Brooklyn Nets","Dennis Smith Jr.",0,16,17,14,4,16.1
6,0,2,5,1,17,8,4,3,"27",0,2,20,2,0,4,1038192,"2024-01-21T00:00:00.000Z",13,FALSE,3,17896048,"G",3,3,"Brooklyn Nets","Cam Thomas",0,22,28,26,8,27.4
0,0,2,2,2,4,3,0,0,"10",0,3,8,2,2,0,1038192,"2024-01-21T00:00:00.000Z",13,FALSE,3,464,"G",3,3,"Brooklyn Nets","Lonnie Walker IV",2,10,10,8,2,16.4
1,0,0,1,0,3,1,0,0,"12",1,1,2,1,1,1,1038192,"2024-01-21T00:00:00.000Z",13,FALSE,3,17896058,"F",3,3,"Brooklyn Nets","Trendon Watford",1,3,4,3,2,6.7
0,0,0,0,0,0,0,0,0,"00",0,0,0,0,0,0,1038192,"2024-01-21T00:00:00.000Z",13,FALSE,3,56677843,"F",3,3,"Brooklyn Nets","Noah Clowney",0,0,0,0,0,0
0,0,0,0,0,0,0,0,0,"00",0,0,0,0,0,0,1038192,"2024-01-21T00:00:00.000Z",13,FALSE,3,17896041,"G",3,3,"Brooklyn Nets","Keon Johnson",0,0,0,0,0,0
0,0,0,0,0,0,0,0,0,"00",0,0,0,0,0,0,1038192,"2024-01-21T00:00:00.000Z",13,FALSE,3,417,"G-F",3,3,"Brooklyn Nets","Ben Simmons",0,0,0,0,0,0
0,0,0,0,0,0,0,0,0,"00",0,0,0,0,0,0,1038192,"2024-01-21T00:00:00.000Z",13,FALSE,3,56677841,"F",3,3,"Brooklyn Nets","Dariq Whitehead",0,0,0,0,0,0
0,0,0,0,0,0,0,0,0,"00",0,0,0,0,0,0,1038192,"2024-01-21T00:00:00.000Z",13,FALSE,3,56677722,"F",3,3,"Brooklyn Nets","Jalen Wilson",0,0,0,0,0,0
1,1,1,4,2,12,6,2,1,"23",0,3,15,1,0,0,1038198,"2024-01-22T00:00:00.000Z",9,FALSE,17,54,"F",9,9,"Detroit Pistons","Bojan Bogdanovic",1,16,17,16,2,20.7
0,0,2,1,0,3,2,0,0,"09",0,3,4,2,0,0,1038198,"2024-01-22T00:00:00.000Z",9,FALSE,17,259,"F",9,9,"Detroit Pistons","Kevin Knox",0,6,6,4,2,6.4
1,1,11,0,0,14,5,2,2,"33",1,4,12,12,0,2,1038198,"2024-01-22T00:00:00.000Z",9,FALSE,17,38017694,"C",9,9,"Detroit Pistons","Jalen Duren",1,24,25,13,13,28.9
6,0,2,4,1,14,5,7,6,"32",1,0,17,3,0,3,1038198,"2024-01-22T00:00:00.000Z",9,FALSE,17,38017682,"G",9,9,"Detroit Pistons","Jaden Ivey",0,20,26,23,9,26.6
5,1,1,0,0,2,1,0,0,"16",0,2,2,1,1,1,1038198,"2024-01-22T00:00:00.000Z",9,FALSE,17,3547241,"G",9,9,"Detroit Pistons","Killian Hayes",2,3,8,7,6,15.7
3,0,2,9,3,12,3,0,0,"28",0,4,9,2,0,1,1038198,"2024-01-22T00:00:00.000Z",9,FALSE,17,77,"G",9,9,"Detroit Pistons","Alec Burks",0,11,14,12,5,14.9
2,0,3,1,1,4,3,3,2,"10",0,2,9,3,0,0,1038198,"2024-01-22T00:00:00.000Z",9,FALSE,17,167,"F",30,9,"Detroit Pistons","Danilo Gallinari",0,12,14,11,5,15.6
0,0,0,0,0,0,0,0,0,"00",0,0,0,0,0,0,1038198,"2024-01-22T00:00:00.000Z",9,FALSE,17,197,"F-G",9,9,"Detroit Pistons","Joe Harris",0,0,0,0,0,0
1,1,2,1,1,1,1,0,0,"16",2,2,3,4,0,0,1038198,"2024-01-22T00:00:00.000Z",9,FALSE,17,337,"F-C",30,9,"Detroit Pistons","Mike Muscala",1,7,8,4,5,12.3
0,0,1,1,0,2,1,0,0,"09",0,2,2,1,0,0,1038198,"2024-01-22T00:00:00.000Z",9,FALSE,17,105,"G",17,17,"Milwaukee Bucks","Pat Connaughton",0,3,3,2,1,3.2
1,0,2,4,1,6,1,0,0,"12",0,1,3,2,0,1,1038198,"2024-01-22T00:00:00.000Z",9,FALSE,17,112,"F",17,17,"Milwaukee Bucks","Jae Crowder",0,5,6,4,3,5.9
0,0,0,0,0,0,0,0,0,"00",0,0,0,0,0,0,1038198,"2024-01-22T00:00:00.000Z",9,FALSE,17,38017733,"G",17,17,"Milwaukee Bucks","A.J. Green",0,0,0,0,0,0
0,1,1,1,0,4,3,2,2,"20",0,5,8,1,1,0,1038198,"2024-01-22T00:00:00.000Z",9,FALSE,17,56677852,"G",17,17,"Milwaukee Bucks","Andre Jackson Jr.",2,9,9,8,1,15.2
0,0,0,0,0,0,0,0,0,"00",0,0,0,0,0,0,1038198,"2024-01-22T00:00:00.000Z",9,FALSE,17,284,"C",17,17,"Milwaukee Bucks","Robin Lopez",0,0,0,0,0,0
0,0,0,0,0,0,0,0,0,"00",0,0,0,0,0,0,1038198,"2024-01-22T00:00:00.000Z",9,FALSE,17,368,"G",17,17,"Milwaukee Bucks","Cameron Payne",0,0,0,0,0,0
0,1,3,3,0,5,2,4,3,"25",1,3,7,4,0,0,1038198,"2024-01-22T00:00:00.000Z",9,FALSE,17,377,"F",17,17,"Milwaukee Bucks","Bobby Portis",1,11,11,7,4,14.8
3,0,1,4,0,17,9,5,5,"26",0,1,23,1,1,2,1038198,"2024-01-22T00:00:00.000Z",9,FALSE,17,56677792,"G",9,9,"Detroit Pistons","Marcus Sasser",1,24,27,26,4,29.7
2,5,7,6,2,9,5,8,7,"28",1,2,19,8,2,1,1038198,"2024-01-22T00:00:00.000Z",9,FALSE,17,3547267,"F-C",9,9,"Detroit Pistons","Isaiah Stewart",7,27,29,21,10,51.6
1,0,4,0,0,1,0,2,0,"19",1,2,0,5,0,0,1038198,"2024-01-22T00:00:00.000Z",9,FALSE,17,56677826,"G-F",9,9,"Detroit Pistons","Ausar Thompson",0,5,6,1,6,7.5
0,0,0,0,0,0,0,0,0,"00",0,0,0,0,0,0,1038198,"2024-01-22T00:00:00.000Z",9,FALSE,17,3547240,"C",9,9,"Detroit Pistons","James Wiseman",0,0,0,0,0,0
0,0,0,0,0,0,0,0,0,"00",0,0,0,0,0,0,1038198,"2024-01-22T00:00:00.000Z",9,FALSE,17,56677729,"G",9,9,"Detroit Pistons","Malcolm Cazalon",0,0,0,0,0,0
0,0,0,0,0,0,0,0,0,"00",0,0,0,0,0,0,1038198,"2024-01-22T00:00:00.000Z",9,FALSE,17,17896075,"G-F",9,9,"Detroit Pistons","Cade Cunningham",0,0,0,0,0,0
0,0,0,0,0,0,0,0,0,"00",0,0,0,0,0,0,1038198,"2024-01-22T00:00:00.000Z",9,FALSE,17,330,"G",9,9,"Detroit Pistons","Monte Morris",0,0,0,0,0,0
0,0,0,0,0,0,0,0,0,"00",0,0,0,0,0,0,1038198,"2024-01-22T00:00:00.000Z",9,FALSE,17,42097199,"G",9,9,"Detroit Pistons","Jared Rhoden",0,0,0,0,0,0
0,0,0,0,0,0,0,0,0,"00",0,0,0,0,0,0,1038198,"2024-01-22T00:00:00.000Z",9,FALSE,17,44477024,"G",9,9,"Detroit Pistons","Stanley Umude",0,0,0,0,0,0
2,0,2,5,2,14,9,6,6,"31",0,2,26,2,2,1,1038198,"2024-01-22T00:00:00.000Z",9,FALSE,17,315,"F",17,17,"Milwaukee Bucks","Khris Middleton",2,28,30,28,4,36.4
10,2,14,5,1,25,11,12,8,"36",3,3,31,17,3,2,1038198,"2024-01-22T00:00:00.000Z",9,FALSE,17,15,"F",17,17,"Milwaukee Bucks","Giannis Antetokounmpo",5,48,58,41,27,79.4
3,4,6,2,1,9,6,2,2,"35",5,4,15,11,0,3,1038198,"2024-01-22T00:00:00.000Z",9,FALSE,17,283,"C",17,17,"Milwaukee Bucks","Brook Lopez",4,26,29,18,14,41.7
2,0,5,8,3,14,5,0,0,"35",1,2,13,6,0,0,1038198,"2024-01-22T00:00:00.000Z",9,FALSE,17,38,"G",17,17,"Milwaukee Bucks","Malik Beasley",0,19,21,15,8,23.2
0,0,0,0,0,0,0,0,0,"00",0,0,0,0,0,0,1038198,"2024-01-22T00:00:00.000Z",9,FALSE,17,2148,"",17,17,"Milwaukee Bucks","Thanasis Antetokounmpo",0,0,0,0,0,0
0,0,0,0,0,0,0,0,0,"00",0,0,0,0,0,0,1038198,"2024-01-22T00:00:00.000Z",9,FALSE,17,38017676,"F",17,17,"Milwaukee Bucks","MarJon Beauchamp",0,0,0,0,0,0
0,0,0,0,0,0,0,0,0,"00",0,0,0,0,0,0,1038198,"2024-01-22T00:00:00.000Z",9,FALSE,17,56677854,"F",17,17,"Milwaukee Bucks","Chris Livingston",0,0,0,0,0,0
0,0,0,0,0,0,0,0,0,"00",0,0,0,0,0,0,1038198,"2024-01-22T00:00:00.000Z",9,FALSE,17,38017691,"G",17,17,"Milwaukee Bucks","TyTy Washington Jr.",0,0,0,0,0,0
8,0,5,10,2,15,4,8,7,"37",0,0,17,5,1,2,1038198,"2024-01-22T00:00:00.000Z",9,FALSE,17,278,"G",17,17,"Milwaukee Bucks","Damian Lillard",1,22,30,25,13,36
2,0,2,5,2,11,6,3,3,"24",1,2,17,3,0,3,1038199,"2024-01-22T00:00:00.000Z",22,FALSE,6,17896026,"F",22,22,"Orlando Magic","Franz Wagner",0,20,22,19,5,20.6
6,0,3,4,1,14,6,9,5,"29",0,2,18,3,0,2,1038199,"2024-01-22T00:00:00.000Z",22,FALSE,6,38017683,"F",22,22,"Orlando Magic","Paolo Banchero",0,21,27,24,9,28.6
1,0,7,2,1,9,4,2,1,"27",2,2,10,9,2,1,1038199,"2024-01-22T00:00:00.000Z",22,FALSE,6,85,"F",22,22,"Orlando Magic","Wendell Carter Jr.",2,19,20,11,10,27.3
3,0,2,4,2,5,2,0,0,"25",0,2,6,2,2,3,1038199,"2024-01-22T00:00:00.000Z",22,FALSE,6,17896073,"G",22,22,"Orlando Magic","Jalen Suggs",2,8,11,9,5,15.9
2,0,0,1,0,6,3,2,1,"18",1,0,7,1,1,0,1038199,"2024-01-22T00:00:00.000Z",22,FALSE,6,56677827,"G",22,22,"Orlando Magic","Anthony Black",1,8,10,9,3,14.2
2,0,2,1,1,4,2,0,0,"13",0,1,5,2,0,2,1038199,"2024-01-22T00:00:00.000Z",22,FALSE,6,3547251,"G",22,22,"Orlando Magic","Cole Anthony",0,7,9,7,4,8.4
1,0,0,0,0,1,1,0,0,"09",1,1,2,1,0,0,1038199,"2024-01-22T00:00:00.000Z",22,FALSE,6,666442,"C",22,22,"Orlando Magic","Goga Bitadze",0,3,4,3,2,4.7
0,0,2,3,2,3,2,0,0,"24",0,2,6,2,0,1,1038199,"2024-01-22T00:00:00.000Z",22,FALSE,6,38017724,"G",22,22,"Orlando Magic","Caleb Houstan",0,8,8,6,2,7.4
1,0,3,1,1,8,4,8,6,"18",1,2,15,4,0,0,1038199,"2024-01-22T00:00:00.000Z",22,FALSE,6,462,"C",22,22,"Orlando Magic","Moritz Wagner",0,19,20,16,5,21.3
0,0,0,0,0,0,0,0,0,"00",0,0,0,0,0,0,1038199,"2024-01-22T00:00:00.000Z",22,FALSE,6,165,"G",22,22,"Orlando Magic","Markelle Fultz",0,0,0,0,0,0
0,0,0,0,0,0,0,0,0,"00",0,0,0,0,0,0,1038199,"2024-01-22T00:00:00.000Z",22,FALSE,6,196,"G",22,22,"Orlando Magic","Gary Harris",0,0,0,0,0,0
0,0,0,0,0,0,0,0,0,"00",0,0,0,0,0,0,1038199,"2024-01-22T00:00:00.000Z",22,FALSE,6,38017607,"G",22,22,"Orlando Magic","Kevon Harris",0,0,0,0,0,0
0,0,0,0,0,0,0,0,0,"00",0,0,0,0,0,0,1038199,"2024-01-22T00:00:00.000Z",22,FALSE,6,56677839,"G",22,22,"Orlando Magic","Jett Howard",0,0,0,0,0,0
0,0,0,0,0,0,0,0,0,"00",0,0,0,0,0,0,1038199,"2024-01-22T00:00:00.000Z",22,FALSE,6,229,"F",22,22,"Orlando Magic","Jonathan Isaac",0,0,0,0,0,0
0,0,1,1,1,4,3,2,1,"20",0,4,8,1,0,0,1038199,"2024-01-22T00:00:00.000Z",22,FALSE,6,3547247,"F-G",6,6,"Cleveland Cavaliers","Isaac Okoro",0,9,9,8,1,9.2
1,0,3,3,3,4,3,0,0,"24",0,2,9,3,2,0,1038199,"2024-01-22T00:00:00.000Z",22,FALSE,6,666940,"F",6,6,"Cleveland Cavaliers","Dean Wade",2,12,13,10,4,20.1
4,2,6,0,0,8,6,4,2,"27",5,2,14,11,0,2,1038199,"2024-01-22T00:00:00.000Z",22,FALSE,6,9,"C",6,6,"Cleveland Cavaliers","Jarrett Allen",2,25,29,18,15,37.2
4,0,3,4,2,7,4,0,0,"27",1,0,10,4,1,1,1038199,"2024-01-22T00:00:00.000Z",22,FALSE,6,666908,"G",6,6,"Cleveland Cavaliers","Max Strus",1,14,18,14,8,22.8
13,0,3,8,3,19,9,4,4,"30",0,3,25,3,4,3,1038199,"2024-01-22T00:00:00.000Z",22,FALSE,6,322,"G",6,6,"Cleveland Cavaliers","Donovan Mitchell",4,28,41,38,16,57.1
0,0,0,0,0,0,0,0,0,"00",0,0,0,0,0,0,1038199,"2024-01-22T00:00:00.000Z",22,FALSE,6,666676,"G",6,6,"Cleveland Cavaliers","Ty Jerome",0,0,0,0,0,0
0,0,1,2,1,3,2,2,2,"09",0,1,7,1,1,0,1038199,"2024-01-22T00:00:00.000Z",22,FALSE,6,248,"C",6,6,"Cleveland Cavaliers","Damian Jones",1,8,8,7,1,11.2
0,0,0,0,0,0,0,0,0,"00",0,0,0,0,0,0,1038199,"2024-01-22T00:00:00.000Z",22,FALSE,6,277,"G",6,6,"Cleveland Cavaliers","Caris LeVert",0,0,0,0,0,0
1,0,1,13,8,13,8,2,2,"31",2,2,26,3,1,1,1038199,"2024-01-22T00:00:00.000Z",22,FALSE,6,3547299,"G",6,6,"Cleveland Cavaliers","Sam Merrill",1,29,30,27,4,33.1
0,1,5,7,2,9,3,4,3,"29",0,3,11,5,0,0,1038199,"2024-01-22T00:00:00.000Z",22,FALSE,6,344,"F",6,6,"Cleveland Cavaliers","Georges Niang",1,16,16,11,5,20
5,0,3,0,0,7,5,2,2,"22",0,2,12,3,0,1,1038199,"2024-01-22T00:00:00.000Z",22,FALSE,6,56677872,"G",6,6,"Cleveland Cavaliers","Craig Porter",0,15,20,17,8,22.1
1,1,4,0,0,6,2,2,0,"21",1,1,4,5,1,1,1038199,"2024-01-22T00:00:00.000Z",22,FALSE,6,444,"C-F",6,6,"Cleveland Cavaliers","Tristan Thompson",2,9,10,5,6,16.5
2,0,2,0,0,1,1,0,0,"15",2,2,2,4,1,2,1038199,"2024-01-22T00:00:00.000Z",22,FALSE,6,226,"F",22,22,"Orlando Magic","Joe Ingles",1,6,8,4,6,10.8
0,0,1,6,1,6,1,0,0,"21",0,1,3,1,0,0,1038199,"2024-01-22T00:00:00.000Z",22,FALSE,6,666818,"F",22,22,"Orlando Magic","Chuma Okeke",0,4,4,3,1,4.2
5,0,1,1,0,4,2,6,4,"14",0,0,8,1,1,1,1038199,"2024-01-22T00:00:00.000Z",22,FALSE,6,17553983,"G",22,22,"Orlando Magic","Trevelin Queen",1,9,14,13,6,18.7
0,0,1,1,0,2,0,0,0,"03",0,0,0,1,0,0,1038199,"2024-01-22T00:00:00.000Z",22,FALSE,6,666885,"F",22,22,"Orlando Magic","Admiral Schofield",0,1,1,0,1,1.2
0,0,0,0,0,0,0,0,0,"00",0,0,0,0,0,0,1038199,"2024-01-22T00:00:00.000Z",22,FALSE,6,56677847,"F",6,6,"Cleveland Cavaliers","Emoni Bates",0,0,0,0,0,0
0,0,0,0,0,0,0,0,0,"00",0,0,0,0,0,0,1038199,"2024-01-22T00:00:00.000Z",22,FALSE,6,666581,"G",6,6,"Cleveland Cavaliers","Darius Garland",0,0,0,0,0,0
0,0,0,0,0,0,0,0,0,"00",0,0,0,0,0,0,1038199,"2024-01-22T00:00:00.000Z",22,FALSE,6,17896076,"F-C",6,6,"Cleveland Cavaliers","Evan Mobley",0,0,0,0,0,0
0,0,0,0,0,0,0,0,0,"00",0,0,0,0,0,0,1038199,"2024-01-22T00:00:00.000Z",22,FALSE,6,38017662,"F",6,6,"Cleveland Cavaliers","Isaiah Mobley",0,0,0,0,0,0
0,0,0,0,0,0,0,0,0,"00",0,0,0,0,0,0,1038199,"2024-01-22T00:00:00.000Z",22,FALSE,6,NA,NA,NA,6,"Cleveland Cavaliers","NA NA",0,0,0,0,0,0
6,0,4,3,1,4,2,0,0,"33",4,3,5,8,3,1,1038200,"2024-01-22T00:00:00.000Z",23,FALSE,27,33,"F-G",23,23,"Philadelphia 76ers","Nicolas Batum",3,13,19,11,14,31.6
6,0,2,5,0,11,5,4,4,"35",0,3,14,2,0,0,1038200,"2024-01-22T00:00:00.000Z",23,FALSE,27,200,"F",23,23,"Philadelphia 76ers","Tobias Harris",0,16,22,20,8,25.4
5,1,9,2,1,41,24,23,21,"37",9,2,70,18,1,1,1038200,"2024-01-22T00:00:00.000Z",23,FALSE,27,145,"F-C",23,23,"Philadelphia 76ers","Joel Embiid",2,88,93,75,23,104.1
0,0,3,1,0,6,3,5,2,"24",0,4,8,3,0,0,1038200,"2024-01-22T00:00:00.000Z",23,FALSE,27,360,"F",23,23,"Philadelphia 76ers","Kelly Oubre Jr.",0,11,11,8,3,11.6
8,0,3,5,2,15,7,2,2,"42",1,1,18,4,0,2,1038200,"2024-01-22T00:00:00.000Z",23,FALSE,27,3547254,"G",23,23,"Philadelphia 76ers","Tyrese Maxey",0,22,30,26,12,32.8
1,0,2,3,1,4,2,6,3,"23",0,0,8,2,0,0,1038200,"2024-01-22T00:00:00.000Z",23,FALSE,27,2175,"",23,23,"Philadelphia 76ers","Danuel House Jr.",0,10,11,9,3,11.9
1,1,1,1,0,3,0,0,0,"13",0,1,0,1,0,0,1038200,"2024-01-22T00:00:00.000Z",23,FALSE,27,260,"G-F",23,23,"Philadelphia 76ers","Furkan Korkmaz",1,1,2,1,2,5.7
1,0,2,0,0,5,2,0,0,"17",0,2,4,2,0,0,1038200,"2024-01-22T00:00:00.000Z",23,FALSE,27,3547294,"F",23,23,"Philadelphia 76ers","Kenyon Martin Jr.",0,6,7,5,3,7.9
0,0,2,4,0,12,4,0,0,"21",0,3,8,2,0,1,1038200,"2024-01-22T00:00:00.000Z",23,FALSE,27,666682,"F",27,27,"San Antonio Spurs","Keldon Johnson",0,10,10,8,2,9.4
0,0,0,0,0,0,0,0,0,"00",0,0,0,0,0,0,1038200,"2024-01-22T00:00:00.000Z",23,FALSE,27,17896059,"F",27,27,"San Antonio Spurs","Sandro Mamukelashvili",0,0,0,0,0,0
0,0,2,9,3,12,5,0,0,"22",3,1,13,5,0,2,1038200,"2024-01-22T00:00:00.000Z",23,FALSE,27,305,"F",27,27,"San Antonio Spurs","Doug McDermott",0,18,18,13,5,17
1,0,3,0,0,1,1,0,0,"11",0,2,2,3,0,0,1038200,"2024-01-22T00:00:00.000Z",23,FALSE,27,359,"F",27,27,"San Antonio Spurs","Cedi Osman",0,5,6,3,4,7.1
2,0,1,2,0,6,3,0,0,"19",1,1,6,2,1,0,1038200,"2024-01-22T00:00:00.000Z",23,FALSE,27,38017693,"G",27,27,"San Antonio Spurs","Blake Wesley",1,8,10,8,4,14.4
0,0,0,0,0,0,0,0,0,"00",0,0,0,0,0,0,1038200,"2024-01-22T00:00:00.000Z",23,FALSE,27,38017730,"F",27,27,"San Antonio Spurs","Dominick Barlow",0,0,0,0,0,0
0,0,0,0,0,0,0,0,0,"00",0,0,0,0,0,0,1038200,"2024-01-22T00:00:00.000Z",23,FALSE,27,17895854,"G",27,27,"San Antonio Spurs","Charles Bassey",0,0,0,0,0,0
0,0,0,0,0,0,0,0,0,"00",0,0,0,0,0,0,1038200,"2024-01-22T00:00:00.000Z",23,FALSE,27,313,"G",23,23,"Philadelphia 76ers","De'Anthony Melton",0,0,0,0,0,0
0,0,0,0,0,0,0,0,0,"00",0,0,0,0,0,0,1038200,"2024-01-22T00:00:00.000Z",23,FALSE,27,328,"F",23,23,"Philadelphia 76ers","Marcus Morris",0,0,0,0,0,0
0,0,0,0,0,0,0,0,0,"00",0,0,0,0,0,0,1038200,"2024-01-22T00:00:00.000Z",23,FALSE,27,17896025,"G",23,23,"Philadelphia 76ers","Jaden Springer",0,0,0,0,0,0
4,1,5,6,3,12,5,2,1,"33",3,2,14,8,0,2,1038200,"2024-01-22T00:00:00.000Z",23,FALSE,27,38017699,"F",27,27,"San Antonio Spurs","Jeremy Sochan",1,22,26,18,12,30.6
1,0,2,3,3,4,3,3,3,"15",0,2,12,2,0,0,1038200,"2024-01-22T00:00:00.000Z",23,FALSE,27,38017649,"F",27,27,"San Antonio Spurs","Julian Champagnie",0,14,15,13,3,15.9
2,2,4,5,2,19,10,12,11,"28",3,5,33,7,0,1,1038200,"2024-01-22T00:00:00.000Z",23,FALSE,27,56677822,"F-C",27,27,"San Antonio Spurs","Victor Wembanyama",2,40,42,35,9,49.4
9,0,4,6,2,13,7,6,6,"38",0,3,22,4,0,1,1038200,"2024-01-22T00:00:00.000Z",23,FALSE,27,3547246,"G-F",27,27,"San Antonio Spurs","Devin Vassell",0,26,35,31,13,39.3
6,0,3,1,0,7,5,2,2,"33",1,1,12,4,2,0,1038200,"2024-01-22T00:00:00.000Z",23,FALSE,27,3547274,"G",27,27,"San Antonio Spurs","Tre Jones",2,16,22,18,10,31.8
0,0,0,0,0,0,0,0,0,"00",0,0,0,0,0,0,1038200,"2024-01-22T00:00:00.000Z",23,FALSE,27,38017692,"F",27,27,"San Antonio Spurs","Malaki Branham",0,0,0,0,0,0
4,0,4,5,0,7,0,2,1,"20",2,2,1,6,0,1,1038200,"2024-01-22T00:00:00.000Z",23,FALSE,27,102,"F-C",27,27,"San Antonio Spurs","Zach Collins",0,7,11,5,10,13.2
0,0,0,0,0,0,0,0,0,"00",0,0,0,0,0,0,1038200,"2024-01-22T00:00:00.000Z",23,FALSE,27,3547163,"F",6,27,"San Antonio Spurs","Mamadi Diakite",0,0,0,0,0,0
0,0,0,0,0,0,0,0,0,"00",0,0,0,0,0,0,1038200,"2024-01-22T00:00:00.000Z",23,FALSE,27,180,"G",27,27,"San Antonio Spurs","Devonte' Graham",0,0,0,0,0,0
0,0,0,0,0,0,0,0,0,"00",0,0,0,0,0,0,1038200,"2024-01-22T00:00:00.000Z",23,FALSE,27,28,"C",23,23,"Philadelphia 76ers","Mo Bamba",0,0,0,0,0,0
0,0,0,0,0,0,0,0,0,"00",0,0,0,0,0,0,1038200,"2024-01-22T00:00:00.000Z",23,FALSE,27,45,"G",23,23,"Philadelphia 76ers","Patrick Beverley",0,0,0,0,0,0
0,0,0,0,0,0,0,0,0,"00",0,0,0,0,0,0,1038200,"2024-01-22T00:00:00.000Z",23,FALSE,27,108,"F",23,23,"Philadelphia 76ers","Robert Covington",0,0,0,0,0,0
0,0,0,0,0,0,0,0,0,"00",0,0,0,0,0,0,1038200,"2024-01-22T00:00:00.000Z",23,FALSE,27,38017732,"F",15,23,"Philadelphia 76ers","Kenneth Lofton Jr.",0,0,0,0,0,0
0,0,0,0,0,0,0,0,0,"00",0,0,0,0,0,0,1038200,"2024-01-22T00:00:00.000Z",23,FALSE,27,56677817,"G",27,27,"San Antonio Spurs","Sidy Cissoko",0,0,0,0,0,0
0,0,0,0,0,0,0,0,0,"00",0,0,0,0,0,0,1038200,"2024-01-22T00:00:00.000Z",23,FALSE,27,17896049,"G",3,27,"San Antonio Spurs","David Duke Jr.",0,0,0,0,0,0
0,1,3,0,0,6,3,0,0,"14",5,4,6,8,1,0,1038200,"2024-01-22T00:00:00.000Z",23,FALSE,27,3547270,"F",23,23,"Philadelphia 76ers","Paul Reed",2,14,14,6,8,21.6
0,0,0,0,0,1,0,0,0,"01",0,0,0,0,0,0,1038200,"2024-01-22T00:00:00.000Z",23,FALSE,27,56913527,"G",23,23,"Philadelphia 76ers","Ricky Council IV",0,0,0,0,0,0
0,0,0,0,0,1,0,0,0,"01",0,0,0,0,0,0,1038200,"2024-01-22T00:00:00.000Z",23,FALSE,27,56677788,"G",23,23,"Philadelphia 76ers","Terquavion Smith",0,0,0,0,0,0
1,1,8,2,0,18,12,6,5,"37",1,3,29,9,0,2,1038201,"2024-01-22T00:00:00.000Z",28,FALSE,15,666423,"F-G",20,28,"Toronto Raptors","RJ Barrett",1,38,39,30,10,42.3
8,6,7,3,1,14,6,9,9,"41",5,2,22,12,0,5,1038201,"2024-01-22T00:00:00.000Z",28,FALSE,15,17896055,"G-F",28,28,"Toronto Raptors","Scottie Barnes",6,34,42,30,20,61.4
0,1,2,0,0,2,0,0,0,"06",0,1,0,2,0,0,1038201,"2024-01-22T00:00:00.000Z",28,FALSE,15,2309958,"C-F",15,28,"Toronto Raptors","Jontay Porter",1,2,2,0,2,5.4
2,0,0,4,2,6,2,0,0,"24",0,1,6,0,1,1,1038201,"2024-01-22T00:00:00.000Z",28,FALSE,15,3089,"",28,28,"Toronto Raptors","Gary Trent Jr.",1,6,8,8,2,11
10,0,5,6,2,13,3,0,0,"37",0,1,8,5,2,4,1038201,"2024-01-22T00:00:00.000Z",28,FALSE,15,3547269,"G",20,28,"Toronto Raptors","Immanuel Quickley",2,13,23,18,15,31
1,0,3,2,1,3,1,2,2,"12",2,1,5,5,0,0,1038201,"2024-01-22T00:00:00.000Z",28,FALSE,15,58,"F",28,28,"Toronto Raptors","Chris Boucher",0,10,11,6,6,12.5
2,0,3,2,1,5,3,0,0,"21",0,3,7,3,0,2,1038201,"2024-01-22T00:00:00.000Z",28,FALSE,15,69,"G",12,28,"Toronto Raptors","Bruce Brown",0,10,12,9,5,11.6
0,0,2,1,0,1,0,0,0,"14",1,0,0,3,1,1,1038201,"2024-01-22T00:00:00.000Z",28,FALSE,15,56677828,"G",28,28,"Toronto Raptors","Gradey Dick",1,3,3,0,3,5.6
0,0,0,0,0,0,0,0,0,"00",0,0,0,0,0,0,1038201,"2024-01-22T00:00:00.000Z",28,FALSE,15,3547260,"G",19,28,"Toronto Raptors","Kira Lewis Jr.",0,0,0,0,0,0
0,0,0,0,0,0,0,0,0,"00",0,0,0,0,0,0,1038201,"2024-01-22T00:00:00.000Z",28,FALSE,15,666762,"F",28,28,"Toronto Raptors","Jalen McDaniels",0,0,0,0,0,0
0,0,0,0,0,0,0,0,0,"00",0,0,0,0,0,0,1038201,"2024-01-22T00:00:00.000Z",28,FALSE,15,3547207,"F",12,28,"Toronto Raptors","Jordan Nwora",0,0,0,0,0,0
0,0,0,0,0,0,0,0,0,"00",0,0,0,0,0,0,1038201,"2024-01-22T00:00:00.000Z",28,FALSE,15,376,"F",28,28,"Toronto Raptors","Otto Porter Jr.",0,0,0,0,0,0
3,0,1,3,1,9,3,4,4,"22",1,1,11,2,1,2,1038201,"2024-01-22T00:00:00.000Z",28,FALSE,15,409,"G",28,28,"Toronto Raptors","Dennis Schroder",1,13,16,14,5,18.9
0,0,0,0,0,0,0,0,0,"00",0,0,0,0,0,0,1038201,"2024-01-22T00:00:00.000Z",28,FALSE,15,436,"G-F",28,28,"Toronto Raptors","Garrett Temple",0,0,0,0,0,0
4,0,4,0,0,9,5,2,2,"26",3,1,12,7,2,0,1038201,"2024-01-22T00:00:00.000Z",28,FALSE,15,489,"F",28,28,"Toronto Raptors","Thaddeus Young",2,19,23,16,11,32.4
0,0,0,0,0,0,0,0,0,"00",0,0,0,0,0,0,1038201,"2024-01-22T00:00:00.000Z",28,FALSE,15,56677805,"G",28,28,"Toronto Raptors","Javon Freeman-Liberty",0,0,0,0,0,0
0,0,0,0,0,0,0,0,0,"00",0,0,0,0,0,0,1038201,"2024-01-22T00:00:00.000Z",28,FALSE,15,56677869,"G",28,28,"Toronto Raptors","Markquis Nowell",0,0,0,0,0,0
0,0,0,0,0,0,0,0,0,"00",0,0,0,0,0,0,1038201,"2024-01-22T00:00:00.000Z",28,FALSE,15,373,"C",28,28,"Toronto Raptors","Jakob Poeltl",0,0,0,0,0,0
1,1,7,4,2,11,7,3,2,"35",3,2,18,10,2,2,1038201,"2024-01-22T00:00:00.000Z",28,FALSE,15,38017731,"G",15,15,"Memphis Grizzlies","Vince Williams Jr.",3,28,29,19,11,38.5
4,0,3,4,1,9,4,1,1,"23",1,0,10,4,1,1,1038201,"2024-01-22T00:00:00.000Z",28,FALSE,15,17896067,"F",15,15,"Memphis Grizzlies","Santi Aldama",1,14,18,14,8,22.8
4,5,1,1,0,6,3,1,0,"28",3,2,6,4,0,1,1038201,"2024-01-22T00:00:00.000Z",28,FALSE,15,666703,"G-F",15,15,"Memphis Grizzlies","John Konchar",5,10,14,10,8,30.8
2,0,1,2,1,3,2,0,0,"13",0,0,5,1,0,0,1038201,"2024-01-22T00:00:00.000Z",28,FALSE,15,48248287,"G",15,15,"Memphis Grizzlies","Jacob Gilyard",0,6,8,7,3,9.2
1,1,5,3,1,5,3,0,0,"21",0,0,7,5,1,0,1038201,"2024-01-22T00:00:00.000Z",28,FALSE,15,56677830,"F",15,15,"Memphis Grizzlies","GG Jackson",2,12,13,8,6,20.5
0,0,0,0,0,0,0,0,0,"00",0,0,0,0,0,0,1038201,"2024-01-22T00:00:00.000Z",28,FALSE,15,38017728,"F",15,15,"Memphis Grizzlies","Jake LaRavia",0,0,0,0,0,0
2,0,3,0,0,12,4,0,0,"23",7,1,8,10,0,1,1038201,"2024-01-22T00:00:00.000Z",28,FALSE,15,38017729,"F",15,15,"Memphis Grizzlies","David Roddy",0,18,20,10,12,22
0,0,0,0,0,0,0,0,0,"00",0,0,0,0,0,0,1038201,"2024-01-22T00:00:00.000Z",28,FALSE,15,401,"G",15,15,"Memphis Grizzlies","Derrick Rose",0,0,0,0,0,0
2,0,3,1,0,7,1,0,0,"16",3,2,2,6,1,1,1038201,"2024-01-22T00:00:00.000Z",28,FALSE,15,3547285,"F",15,15,"Memphis Grizzlies","Xavier Tillman",1,8,10,4,8,14.2
2,0,1,1,1,3,1,3,3,"14",0,3,6,1,0,2,1038201,"2024-01-22T00:00:00.000Z",28,FALSE,15,17896027,"G-F",15,15,"Memphis Grizzlies","Ziaire Williams",0,7,9,8,3,8.2
0,0,0,0,0,0,0,0,0,"00",0,0,0,0,0,0,1038201,"2024-01-22T00:00:00.000Z",28,FALSE,15,3,"C",15,15,"Memphis Grizzlies","Steven Adams",0,0,0,0,0,0
0,0,0,0,0,0,0,0,0,"00",0,0,0,0,0,0,1038201,"2024-01-22T00:00:00.000Z",28,FALSE,15,3547287,"G",15,15,"Memphis Grizzlies","Desmond Bane",0,0,0,0,0,0
0,0,0,0,0,0,0,0,0,"00",0,0,0,0,0,0,1038201,"2024-01-22T00:00:00.000Z",28,FALSE,15,666505,"F",15,15,"Memphis Grizzlies","Brandon Clarke",0,0,0,0,0,0
0,0,0,0,0,0,0,0,0,"00",0,0,0,0,0,0,1038201,"2024-01-22T00:00:00.000Z",28,FALSE,15,666786,"G",15,15,"Memphis Grizzlies","Ja Morant",0,0,0,0,0,0
0,0,0,0,0,0,0,0,0,"00",0,0,0,0,0,0,1038201,"2024-01-22T00:00:00.000Z",28,FALSE,15,38017656,"G",14,15,"Memphis Grizzlies","Scotty Pippen Jr.",0,0,0,0,0,0
0,0,0,0,0,0,0,0,0,"00",0,0,0,0,0,0,1038201,"2024-01-22T00:00:00.000Z",28,FALSE,15,420,"G",15,15,"Memphis Grizzlies","Marcus Smart",0,0,0,0,0,0
5,1,1,5,2,22,12,3,1,"32",3,4,27,4,6,4,1038201,"2024-01-22T00:00:00.000Z",28,FALSE,15,231,"F-C",15,15,"Memphis Grizzlies","Jaren Jackson Jr.",7,31,36,32,9,56.3
7,0,3,13,5,18,7,1,0,"35",0,1,19,3,0,3,1038201,"2024-01-22T00:00:00.000Z",28,FALSE,15,254,"G",15,15,"Memphis Grizzlies","Luke Kennard",0,22,29,26,10,30.1
1,0,0,0,0,1,1,0,0,"06",0,0,2,0,0,0,1038202,"2024-01-22T00:00:00.000Z",18,FALSE,4,38017708,"G",4,4,"Charlotte Hornets","Bryce McGowens",0,2,3,3,1,3.5
0,0,0,0,0,0,0,0,0,"00",0,0,0,0,0,0,1038202,"2024-01-22T00:00:00.000Z",18,FALSE,4,347,"G",4,4,"Charlotte Hornets","Frank Ntilikina",0,0,0,0,0,0
2,0,2,3,2,4,3,0,0,"15",0,1,8,2,0,2,1038202,"2024-01-22T00:00:00.000Z",18,FALSE,4,56677846,"G",4,4,"Charlotte Hornets","Nick Smith Jr.",0,10,12,10,4,11.4
0,0,0,0,0,0,0,0,0,"00",0,0,0,0,0,0,1038202,"2024-01-22T00:00:00.000Z",18,FALSE,4,56677848,"G",4,4,"Charlotte Hornets","Amari Bailey",0,0,0,0,0,0
0,0,0,0,0,0,0,0,0,"00",0,0,0,0,0,0,1038202,"2024-01-22T00:00:00.000Z",18,FALSE,4,204,"F",4,4,"Charlotte Hornets","Gordon Hayward",0,0,0,0,0,0
0,0,0,0,0,0,0,0,0,"00",0,0,0,0,0,0,1038202,"2024-01-22T00:00:00.000Z",18,FALSE,4,666748,"F",4,4,"Charlotte Hornets","Cody Martin",0,0,0,0,0,0
0,0,0,0,0,0,0,0,0,"00",0,0,0,0,0,0,1038202,"2024-01-22T00:00:00.000Z",18,FALSE,4,3547282,"C",4,4,"Charlotte Hornets","Nick Richards",0,0,0,0,0,0
0,0,0,0,0,0,0,0,0,"00",0,0,0,0,0,0,1038202,"2024-01-22T00:00:00.000Z",18,FALSE,4,38017698,"C",4,4,"Charlotte Hornets","Mark Williams",0,0,0,0,0,0
0,0,0,0,0,0,0,0,0,"00",0,0,0,0,0,0,1038202,"2024-01-22T00:00:00.000Z",18,FALSE,4,56677851,"G",18,18,"Minnesota Timberwolves","Jaylen Clark",0,0,0,0,0,0
0,0,0,0,0,0,0,0,0,"00",0,0,0,0,0,0,1038202,"2024-01-22T00:00:00.000Z",18,FALSE,4,104,"G",18,18,"Minnesota Timberwolves","Mike Conley",0,0,0,0,0,0
0,0,0,0,0,0,0,0,0,"00",0,0,0,0,0,0,1038202,"2024-01-22T00:00:00.000Z",18,FALSE,4,56677782,"F",18,18,"Minnesota Timberwolves","Leonard Miller",0,0,0,0,0,0
4,0,4,7,2,9,3,2,1,"35",0,2,9,4,2,1,1038202,"2024-01-22T00:00:00.000Z",18,FALSE,4,3547259,"F",18,18,"Minnesota Timberwolves","Jaden McDaniels",2,13,17,13,8,24.8
2,0,5,15,10,35,21,14,10,"38",3,2,62,8,0,7,1038202,"2024-01-22T00:00:00.000Z",18,FALSE,4,447,"C",18,18,"Minnesota Timberwolves","Karl-Anthony Towns",0,70,72,64,10,67.6
1,0,9,0,0,6,6,2,1,"39",2,3,13,11,0,0,1038202,"2024-01-22T00:00:00.000Z",18,FALSE,4,176,"C",18,18,"Minnesota Timberwolves","Rudy Gobert",0,24,25,14,12,27.7
11,0,5,4,1,11,3,2,2,"37",0,1,9,5,0,1,1038202,"2024-01-22T00:00:00.000Z",18,FALSE,4,3547238,"G",18,18,"Minnesota Timberwolves","Anthony Edwards",0,14,25,20,16,30.5
2,0,0,6,4,9,6,2,2,"30",0,2,18,0,1,1,1038202,"2024-01-22T00:00:00.000Z",18,FALSE,4,666400,"G",18,18,"Minnesota Timberwolves","Nickeil Alexander-Walker",1,18,20,20,2,23
8,0,3,0,0,2,1,3,3,"21",1,1,5,4,0,1,1038202,"2024-01-22T00:00:00.000Z",18,FALSE,4,12,"F",18,18,"Minnesota Timberwolves","Kyle Anderson",0,9,17,13,12,20.8
3,0,2,2,0,2,0,0,0,"10",0,0,0,2,0,1,1038202,"2024-01-22T00:00:00.000Z",18,FALSE,4,666767,"G",18,18,"Minnesota Timberwolves","Jordan McLaughlin",0,2,5,3,5,5.9
0,0,0,4,1,5,2,0,0,"15",0,3,5,0,1,1,1038202,"2024-01-22T00:00:00.000Z",18,FALSE,4,667378,"F-C",18,18,"Minnesota Timberwolves","Naz Reid",1,5,5,5,0,7
0,0,0,0,0,0,0,0,0,"00",0,0,0,0,0,0,1038202,"2024-01-22T00:00:00.000Z",18,FALSE,4,38017715,"F",18,18,"Minnesota Timberwolves","Josh Minott",0,0,0,0,0,0
2,0,3,4,3,13,11,2,2,"29",0,4,27,3,1,0,1038202,"2024-01-22T00:00:00.000Z",18,FALSE,4,56677823,"F",4,4,"Charlotte Hornets","Brandon Miller",1,30,32,29,5,36.6
2,0,4,10,3,23,10,5,5,"40",1,2,28,5,1,1,1038202,"2024-01-22T00:00:00.000Z",18,FALSE,4,62,"F",4,4,"Charlotte Hornets","Miles Bridges",1,33,35,30,7,39
3,1,7,4,2,7,5,1,0,"33",0,4,12,7,1,0,1038202,"2024-01-22T00:00:00.000Z",18,FALSE,4,666950,"F",4,4,"Charlotte Hornets","P.J. Washington",2,19,22,15,10,30.9
4,0,2,6,0,12,5,2,1,"35",0,1,11,2,0,4,1038202,"2024-01-22T00:00:00.000Z",18,FALSE,4,403,"G",4,4,"Charlotte Hornets","Terry Rozier",0,13,17,15,6,15.4
13,0,4,6,1,17,7,4,3,"35",2,1,18,6,3,2,1038202,"2024-01-22T00:00:00.000Z",18,FALSE,4,3547239,"G",4,4,"Charlotte Hornets","LaMelo Ball",3,24,37,31,19,51.7
1,1,2,1,1,3,2,2,2,"05",1,0,7,3,0,0,1038202,"2024-01-22T00:00:00.000Z",18,FALSE,4,56677866,"F",4,4,"Charlotte Hornets","Leaky Black",1,10,11,8,4,15.1
0,0,0,0,0,0,0,0,0,"00",0,0,0,0,0,0,1038202,"2024-01-22T00:00:00.000Z",18,FALSE,4,17896037,"G",4,4,"Charlotte Hornets","James Bouknight",0,0,0,0,0,0
1,0,0,0,0,1,1,0,0,"15",3,3,2,3,0,0,1038202,"2024-01-22T00:00:00.000Z",18,FALSE,4,NA,NA,NA,4,"Charlotte Hornets","NA NA",0,5,6,3,4,7.1
1,0,1,0,0,3,3,0,0,"11",0,2,6,1,2,0,1038202,"2024-01-22T00:00:00.000Z",18,FALSE,4,422,"G",4,4,"Charlotte Hornets","Ish Smith",2,7,8,7,2,14.7
0,2,3,3,2,3,2,2,1,"16",0,2,7,3,0,2,1038202,"2024-01-22T00:00:00.000Z",18,FALSE,4,18678001,"F",4,4,"Charlotte Hornets","JT Thor",2,10,10,7,3,14.6
3,0,1,2,0,5,2,0,0,"15",0,1,4,1,1,0,1038202,"2024-01-22T00:00:00.000Z",18,FALSE,4,320,"G",18,18,"Minnesota Timberwolves","Shake Milton",1,5,8,7,4,12.7
0,0,0,0,0,0,0,0,0,"00",0,0,0,0,0,0,1038202,"2024-01-22T00:00:00.000Z",18,FALSE,4,68,"F",18,18,"Minnesota Timberwolves","Troy Brown Jr.",0,0,0,0,0,0
0,0,0,0,0,0,0,0,0,"00",0,0,0,0,0,0,1038202,"2024-01-22T00:00:00.000Z",18,FALSE,4,17896056,"C",18,18,"Minnesota Timberwolves","Luka Garza",0,0,0,0,0,0
0,0,0,0,0,0,0,0,0,"00",0,0,0,0,0,0,1038202,"2024-01-22T00:00:00.000Z",18,FALSE,4,38017700,"G",18,18,"Minnesota Timberwolves","Wendell Moore Jr.",0,0,0,0,0,0
0,0,0,0,0,0,0,0,0,"00",0,0,0,0,0,0,1038202,"2024-01-22T00:00:00.000Z",18,FALSE,4,17895968,"F",18,18,"Minnesota Timberwolves","Daishen Nix",0,0,0,0,0,0
3,0,4,4,3,6,3,0,0,"36",0,1,9,4,1,1,1038204,"2024-01-22T00:00:00.000Z",24,FALSE,5,8,"G",24,24,"Phoenix Suns","Grayson Allen",1,13,16,12,7,20.3
8,2,5,15,6,32,16,6,5,"41",1,2,43,6,1,1,1038204,"2024-01-22T00:00:00.000Z",24,FALSE,5,140,"F",24,24,"Phoenix Suns","Kevin Durant",3,49,57,51,14,70.2
4,2,6,0,0,7,4,0,0,"25",1,3,8,7,0,1,1038204,"2024-01-22T00:00:00.000Z",24,FALSE,5,349,"C",24,24,"Phoenix Suns","Jusuf Nurkic",2,15,19,12,11,27.4
5,0,4,6,2,11,6,3,2,"41",0,2,16,4,1,2,1038204,"2024-01-22T00:00:00.000Z",24,FALSE,5,57,"G",24,24,"Phoenix Suns","Devin Booker",1,20,25,21,9,29.3
5,0,4,4,2,17,7,2,2,"37",0,0,18,4,0,1,1038204,"2024-01-22T00:00:00.000Z",24,FALSE,5,37,"G",24,24,"Phoenix Suns","Bradley Beal",0,22,27,23,9,29.3
2,1,1,2,1,3,2,0,0,"18",0,1,5,1,1,0,1038204,"2024-01-22T00:00:00.000Z",24,FALSE,5,32,"F",24,24,"Phoenix Suns","Keita Bates-Diop",2,6,8,7,3,15.2
4,0,6,0,0,4,4,2,2,"22",2,3,10,8,0,0,1038204,"2024-01-22T00:00:00.000Z",24,FALSE,5,147,"F",24,24,"Phoenix Suns","Drew Eubanks",0,18,22,14,12,25.6
1,0,2,1,0,2,1,0,0,"06",0,0,2,2,0,1,1038204,"2024-01-22T00:00:00.000Z",24,FALSE,5,3547298,"G",24,24,"Phoenix Suns","Saben Lee",0,4,5,3,3,4.9
0,0,2,2,0,3,1,4,2,"14",1,1,4,3,1,0,1038204,"2024-01-22T00:00:00.000Z",24,FALSE,5,356,"G",24,24,"Phoenix Suns","Josh Okogie",1,7,7,4,3,10.6
0,0,1,2,0,4,0,0,0,"08",0,0,0,1,0,0,1038204,"2024-01-22T00:00:00.000Z",24,FALSE,5,87,"G",5,5,"Chicago Bulls","Jevon Carter",0,1,1,0,1,1.2
0,0,0,0,0,0,0,0,0,"00",0,0,0,0,0,0,1038204,"2024-01-22T00:00:00.000Z",24,FALSE,5,110,"F",5,5,"Chicago Bulls","Torrey Craig",0,0,0,0,0,0
0,0,0,0,0,0,0,0,0,"00",0,0,0,0,0,0,1038204,"2024-01-22T00:00:00.000Z",24,FALSE,5,56677857,"F",5,5,"Chicago Bulls","Julian Phillips",0,0,0,0,0,0
0,0,0,0,0,0,0,0,0,"00",0,0,0,0,0,0,1038204,"2024-01-22T00:00:00.000Z",24,FALSE,5,17896116,"G",5,5,"Chicago Bulls","Terry Taylor",0,0,0,0,0,0
1,0,0,1,0,2,0,0,0,"09",0,0,0,0,0,0,1038204,"2024-01-22T00:00:00.000Z",24,FALSE,5,38017719,"F",5,5,"Chicago Bulls","Dalen Terry",0,0,1,1,1,1.5
0,0,0,0,0,0,0,0,0,"00",0,0,0,0,0,0,1038204,"2024-01-22T00:00:00.000Z",24,FALSE,5,27,"G",5,5,"Chicago Bulls","Lonzo Ball",0,0,0,0,0,0
0,0,0,0,0,0,0,0,0,"00",0,0,0,0,0,0,1038204,"2024-01-22T00:00:00.000Z",24,FALSE,5,56677874,"F",5,5,"Chicago Bulls","Onuralp Bitim",0,0,0,0,0,0
0,0,0,0,0,0,0,0,0,"00",0,0,0,0,0,0,1038204,"2024-01-22T00:00:00.000Z",24,FALSE,5,NA,NA,NA,5,"Chicago Bulls","NA NA",0,0,0,0,0,0
0,0,0,0,0,0,0,0,0,"00",0,0,0,0,0,0,1038204,"2024-01-22T00:00:00.000Z",24,FALSE,5,268,"G",5,5,"Chicago Bulls","Zach LaVine",0,0,0,0,0,0
0,0,0,0,0,0,0,0,0,"00",0,0,0,0,0,0,1038204,"2024-01-22T00:00:00.000Z",24,FALSE,5,56677860,"F",5,5,"Chicago Bulls","Adama Sanogo",0,0,0,0,0,0
0,0,2,0,0,4,2,4,2,"11",3,0,6,5,0,1,1038204,"2024-01-22T00:00:00.000Z",24,FALSE,5,137,"C",5,5,"Chicago Bulls","Andre Drummond",0,11,11,6,5,11
0,1,0,2,0,11,6,2,1,"30",1,2,13,1,2,1,1038204,"2024-01-22T00:00:00.000Z",24,FALSE,5,17895983,"G",5,5,"Chicago Bulls","Ayo Dosunmu",3,14,14,13,1,22.2
0,0,0,0,0,0,0,0,0,"00",0,0,0,0,0,0,1038204,"2024-01-22T00:00:00.000Z",24,FALSE,5,3547095,"C-F",24,24,"Phoenix Suns","Udoka Azubuike",0,0,0,0,0,0
0,0,0,0,0,0,0,0,0,"00",0,0,0,0,0,0,1038204,"2024-01-22T00:00:00.000Z",24,FALSE,5,18678058,"",24,24,"Phoenix Suns","Jordan Goodwin",0,0,0,0,0,0
0,0,0,0,0,0,0,0,0,"00",0,0,0,0,0,0,1038204,"2024-01-22T00:00:00.000Z",24,FALSE,5,666729,"F",24,24,"Phoenix Suns","Nassir Little",0,0,0,0,0,0
0,0,0,0,0,0,0,0,0,"00",0,0,0,0,0,0,1038204,"2024-01-22T00:00:00.000Z",24,FALSE,5,314,"F",24,24,"Phoenix Suns","Chimezie Metu",0,0,0,0,0,0
0,0,0,0,0,0,0,0,0,"00",0,0,0,0,0,0,1038204,"2024-01-22T00:00:00.000Z",24,FALSE,5,470,"G",24,24,"Phoenix Suns","Yuta Watanabe",0,0,0,0,0,0
0,0,0,0,0,0,0,0,0,"00",0,0,0,0,0,0,1038204,"2024-01-22T00:00:00.000Z",24,FALSE,5,666451,"C",24,24,"Phoenix Suns","Bol Bol",0,0,0,0,0,0
0,0,0,0,0,0,0,0,0,"00",0,0,0,0,0,0,1038204,"2024-01-22T00:00:00.000Z",24,FALSE,5,178,"G",24,24,"Phoenix Suns","Eric Gordon",0,0,0,0,0,0
0,0,0,0,0,0,0,0,0,"00",0,0,0,0,0,0,1038204,"2024-01-22T00:00:00.000Z",24,FALSE,5,272,"G",24,24,"Phoenix Suns","Damion Lee",0,0,0,0,0,0
0,0,0,0,0,0,0,0,0,"00",0,0,0,0,0,0,1038204,"2024-01-22T00:00:00.000Z",24,FALSE,5,3547253,"G",4,24,"Phoenix Suns","Theo Maledon",0,0,0,0,0,0
3,0,4,3,1,17,8,6,4,"40",1,3,21,5,1,2,1038204,"2024-01-22T00:00:00.000Z",24,FALSE,5,125,"G",5,5,"Chicago Bulls","DeMar DeRozan",1,26,29,24,8,32.5
2,0,3,8,3,12,5,0,0,"31",1,2,13,4,1,2,1038204,"2024-01-22T00:00:00.000Z",24,FALSE,5,3547248,"F",5,5,"Chicago Bulls","Patrick Williams",1,17,19,15,6,21.8
7,0,12,5,1,17,9,0,0,"37",5,2,19,17,0,1,1038204,"2024-01-22T00:00:00.000Z",24,FALSE,5,460,"C",5,5,"Chicago Bulls","Nikola Vucevic",0,36,43,26,24,48.9
3,3,3,11,5,12,5,0,0,"33",1,5,15,4,0,2,1038204,"2024-01-22T00:00:00.000Z",24,FALSE,5,89,"G",5,5,"Chicago Bulls","Alex Caruso",3,19,22,18,7,31.3
9,0,8,5,4,14,10,2,2,"41",2,4,26,10,2,1,1038204,"2024-01-22T00:00:00.000Z",24,FALSE,5,666956,"G",5,5,"Chicago Bulls","Coby White",2,36,45,35,19,56.5
0,0,2,8,4,20,10,8,8,"30",2,2,32,4,1,0,1038205,"2024-01-22T00:00:00.000Z",26,FALSE,1,30,"F",26,26,"Sacramento Kings","Harrison Barnes",1,36,36,32,4,39.8
2,0,4,7,2,12,5,2,1,"32",2,3,13,6,2,0,1038205,"2024-01-22T00:00:00.000Z",26,FALSE,1,38017688,"F",26,26,"Sacramento Kings","Keegan Murray",2,19,21,15,8,29.2
6,0,19,1,0,10,4,6,6,"38",2,4,14,21,2,4,1038205,"2024-01-22T00:00:00.000Z",26,FALSE,1,406,"F",26,26,"Sacramento Kings","Domantas Sabonis",2,35,41,20,27,50.2
3,1,2,5,2,6,3,0,0,"26",0,4,8,2,0,1,1038205,"2024-01-22T00:00:00.000Z",26,FALSE,1,221,"G",26,26,"Sacramento Kings","Kevin Huerter",1,10,13,11,5,16.9
1,0,3,5,0,16,5,3,2,"35",0,1,12,3,1,1,1038205,"2024-01-22T00:00:00.000Z",26,FALSE,1,161,"G",26,26,"Sacramento Kings","De'Aaron Fox",1,15,16,13,4,19.1
0,0,0,0,0,0,0,0,0,"00",0,0,0,0,0,0,1038205,"2024-01-22T00:00:00.000Z",26,FALSE,1,17896030,"G",26,26,"Sacramento Kings","Chris Duarte",0,0,0,0,0,0
0,0,0,0,0,0,0,0,0,"00",0,0,0,0,0,0,1038205,"2024-01-22T00:00:00.000Z",26,FALSE,1,38017714,"G",26,26,"Sacramento Kings","Keon Ellis",0,0,0,0,0,0
0,0,0,0,0,0,0,0,0,"00",0,0,0,0,0,0,1038205,"2024-01-22T00:00:00.000Z",26,FALSE,1,56677845,"G",26,26,"Sacramento Kings","Colby Jones",0,0,0,0,0,0
0,0,0,0,0,0,0,0,0,"00",0,0,0,0,0,0,1038205,"2024-01-22T00:00:00.000Z",26,FALSE,1,273,"C",26,26,"Sacramento Kings","Alex Len",0,0,0,0,0,0
0,0,0,0,0,0,0,0,0,"00",0,0,0,0,0,0,1038205,"2024-01-22T00:00:00.000Z",26,FALSE,1,56677862,"F",26,26,"Sacramento Kings","Jalen Slawson",0,0,0,0,0,0
2,0,5,7,2,11,4,4,3,"30",2,1,13,7,0,0,1038205,"2024-01-22T00:00:00.000Z",26,FALSE,1,3547256,"F",1,1,"Atlanta Hawks","Saddiq Bey",0,20,22,15,9,24.4
0,2,5,7,1,18,4,4,2,"38",2,1,11,7,1,0,1038205,"2024-01-22T00:00:00.000Z",26,FALSE,1,17896040,"F",1,1,"Atlanta Hawks","Jalen Johnson",3,18,18,11,7,28.4
1,2,6,0,0,10,4,4,3,"22",6,0,11,12,0,1,1038205,"2024-01-22T00:00:00.000Z",26,FALSE,1,83,"C",1,1,"Atlanta Hawks","Clint Capela",2,23,24,12,13,31.9
4,0,2,8,2,12,5,6,6,"34",0,4,18,2,0,2,1038205,"2024-01-22T00:00:00.000Z",26,FALSE,1,53,"G",1,1,"Atlanta Hawks","Bogdan Bogdanovic",0,20,24,22,6,24.4
6,1,10,10,6,23,11,8,7,"40",0,1,35,10,0,4,1038205,"2024-01-22T00:00:00.000Z",26,FALSE,1,334,"G",1,1,"Atlanta Hawks","Dejounte Murray",1,45,51,41,16,55
0,0,0,0,0,0,0,0,0,"00",0,0,0,0,0,0,1038205,"2024-01-22T00:00:00.000Z",26,FALSE,1,666564,"F",1,1,"Atlanta Hawks","Bruno Fernando",0,0,0,0,0,0
1,0,2,0,0,3,0,0,0,"08",0,1,0,2,0,0,1038205,"2024-01-22T00:00:00.000Z",26,FALSE,1,3547297,"G",1,1,"Atlanta Hawks","Trent Forrest",0,2,3,1,3,3.9
0,0,0,0,0,0,0,0,0,"00",0,0,0,0,0,0,1038205,"2024-01-22T00:00:00.000Z",26,FALSE,1,38017689,"F",1,1,"Atlanta Hawks","AJ Griffin",0,0,0,0,0,0
0,0,0,0,0,0,0,0,0,"00",0,0,0,0,0,0,1038205,"2024-01-22T00:00:00.000Z",26,FALSE,1,56677855,"G",1,1,"Atlanta Hawks","Seth Lundy",0,0,0,0,0,0
0,0,1,5,3,5,3,0,0,"23",0,5,9,1,0,2,1038205,"2024-01-22T00:00:00.000Z",26,FALSE,1,666754,"G",1,1,"Atlanta Hawks","Garrison Mathews",0,10,10,9,1,8.2
2,0,0,2,0,5,1,0,0,"16",0,0,2,0,1,1,1038205,"2024-01-22T00:00:00.000Z",26,FALSE,1,319,"G",1,1,"Atlanta Hawks","Patty Mills",1,2,4,4,2,7
0,0,5,5,2,8,4,0,0,"16",2,0,10,7,0,1,1038205,"2024-01-22T00:00:00.000Z",26,FALSE,1,290,"F",26,26,"Sacramento Kings","Trey Lyles",0,17,17,10,7,17.4
0,1,3,1,0,4,3,2,1,"10",0,2,7,3,1,0,1038205,"2024-01-22T00:00:00.000Z",26,FALSE,1,306,"C",26,26,"Sacramento Kings","JaVale McGee",2,10,10,7,3,16.6
2,0,1,2,0,7,2,1,1,"22",1,1,5,2,0,0,1038205,"2024-01-22T00:00:00.000Z",26,FALSE,1,17553994,"G",26,26,"Sacramento Kings","Davion Mitchell",0,7,9,7,4,10.4
8,0,1,1,0,6,4,5,5,"25",0,3,13,1,1,1,1038205,"2024-01-22T00:00:00.000Z",26,FALSE,1,324,"G",26,26,"Sacramento Kings","Malik Monk",1,14,22,21,9,28.2
0,0,1,3,2,4,3,0,0,"06",1,1,8,2,0,0,1038205,"2024-01-22T00:00:00.000Z",26,FALSE,1,4197162,"F",26,26,"Sacramento Kings","Aleksandar Vezenkov",0,10,10,8,2,10.4
0,0,0,0,0,0,0,0,0,"00",0,0,0,0,0,0,1038205,"2024-01-22T00:00:00.000Z",26,FALSE,1,17896044,"F",26,26,"Sacramento Kings","Kessler Edwards",0,0,0,0,0,0
0,0,0,0,0,0,0,0,0,"00",0,0,0,0,0,0,1038205,"2024-01-22T00:00:00.000Z",26,FALSE,1,17895990,"G",26,26,"Sacramento Kings","Jordan Ford",0,0,0,0,0,0
0,0,0,0,0,0,0,0,0,"00",0,0,0,0,0,0,1038205,"2024-01-22T00:00:00.000Z",26,FALSE,1,490,"G",1,1,"Atlanta Hawks","Trae Young",0,0,0,0,0,0
3,2,6,1,0,6,4,1,0,"29",3,6,8,9,0,2,1038205,"2024-01-22T00:00:00.000Z",26,FALSE,1,3547244,"F-C",1,1,"Atlanta Hawks","Onyeka Okongwu",2,17,20,11,12,27.3
0,0,0,0,0,0,0,0,0,"00",0,0,0,0,0,0,1038205,"2024-01-22T00:00:00.000Z",26,FALSE,1,56677838,"G",1,1,"Atlanta Hawks","Kobe Bufkin",0,0,0,0,0,0
0,0,0,0,0,0,0,0,0,"00",0,0,0,0,0,0,1038205,"2024-01-22T00:00:00.000Z",26,FALSE,1,56677806,"F",1,1,"Atlanta Hawks","Mouhamed Gueye",0,0,0,0,0,0
0,0,0,0,0,0,0,0,0,"00",0,0,0,0,0,0,1038205,"2024-01-22T00:00:00.000Z",26,FALSE,1,666656,"F",1,1,"Atlanta Hawks","De'Andre Hunter",0,0,0,0,0,0
0,0,0,0,0,0,0,0,0,"00",0,0,0,0,0,0,1038205,"2024-01-22T00:00:00.000Z",26,FALSE,1,4197387,"G",1,1,"Atlanta Hawks","Vit Krejci",0,0,0,0,0,0
0,0,0,0,0,0,0,0,0,"00",0,0,0,0,0,0,1038205,"2024-01-22T00:00:00.000Z",26,FALSE,1,301,"G-F",1,1,"Atlanta Hawks","Wesley Matthews",0,0,0,0,0,0
1,0,6,7,4,11,5,0,0,"38",1,4,14,7,0,3,1038203,"2024-01-22T00:00:00.000Z",7,FALSE,2,3547258,"G",7,7,"Dallas Mavericks","Josh Green",0,21,22,15,8,20.9
3,0,2,3,1,7,2,0,0,"25",0,1,5,2,0,1,1038203,"2024-01-22T00:00:00.000Z",7,FALSE,2,247,"F-G",7,7,"Dallas Mavericks","Derrick Jones Jr.",0,7,10,8,5,10.9
1,2,4,0,0,3,3,0,0,"24",4,2,6,8,0,1,1038203,"2024-01-22T00:00:00.000Z",7,FALSE,2,56677840,"C",7,7,"Dallas Mavericks","Dereck Lively II",2,14,15,7,9,22.1
3,0,6,7,3,20,9,2,2,"36",0,3,23,6,2,1,1038203,"2024-01-22T00:00:00.000Z",7,FALSE,2,228,"G",7,7,"Dallas Mavericks","Kyrie Irving",2,29,32,26,9,39.7
13,0,13,8,2,30,12,11,7,"40",5,5,33,18,2,3,1038203,"2024-01-22T00:00:00.000Z",7,FALSE,2,132,"F-G",7,7,"Dallas Mavericks","Luka Doncic",2,51,64,46,31,77.1
1,0,2,7,4,13,8,0,0,"32",0,2,20,2,0,0,1038203,"2024-01-22T00:00:00.000Z",7,FALSE,2,191,"G",7,7,"Dallas Mavericks","Tim Hardaway Jr.",0,22,23,21,3,23.9
0,0,0,1,0,1,0,0,0,"02",0,0,0,0,0,0,1038203,"2024-01-22T00:00:00.000Z",7,FALSE,2,38017679,"G",7,7,"Dallas Mavericks","Jaden Hardy",0,0,0,0,0,0
0,0,0,0,0,0,0,0,0,"00",0,0,0,0,0,0,1038203,"2024-01-22T00:00:00.000Z",7,FALSE,2,217,"F-C",7,7,"Dallas Mavericks","Richaun Holmes",0,0,0,0,0,0
0,2,2,3,0,7,3,1,1,"25",0,2,7,2,0,1,1038203,"2024-01-22T00:00:00.000Z",7,FALSE,2,257,"F",7,7,"Dallas Mavericks","Maxi Kleber",2,9,9,7,2,14.4
0,0,0,0,0,0,0,0,0,"00",0,0,0,0,0,0,1038203,"2024-01-22T00:00:00.000Z",7,FALSE,2,17554004,"G",7,7,"Dallas Mavericks","AJ Lawson",0,0,0,0,0,0
0,0,0,0,0,0,0,0,0,"00",0,0,0,0,0,0,1038203,"2024-01-22T00:00:00.000Z",7,FALSE,2,329,"F",7,7,"Dallas Mavericks","Markieff Morris",0,0,0,0,0,0
0,0,0,0,0,0,0,0,0,"00",0,0,0,0,0,0,1038203,"2024-01-22T00:00:00.000Z",7,FALSE,2,114,"G",7,7,"Dallas Mavericks","Seth Curry",0,0,0,0,0,0
0,0,0,0,0,0,0,0,0,"00",0,0,0,0,0,0,1038203,"2024-01-22T00:00:00.000Z",7,FALSE,2,151,"G",7,7,"Dallas Mavericks","Dante Exum",0,0,0,0,0,0
4,2,2,7,2,22,13,11,7,"37",1,5,35,3,0,0,1038203,"2024-01-22T00:00:00.000Z",7,FALSE,2,70,"G",2,2,"Boston Celtics","Jaylen Brown",2,38,42,39,7,50.6
5,2,11,8,2,21,11,17,14,"41",0,4,38,11,3,0,1038203,"2024-01-22T00:00:00.000Z",7,FALSE,2,434,"F",2,2,"Boston Celtics","Jayson Tatum",5,49,54,43,16,73.7
3,0,5,6,3,7,4,0,0,"31",1,2,11,6,1,1,1038203,"2024-01-22T00:00:00.000Z",7,FALSE,2,219,"C-F",2,2,"Boston Celtics","Al Horford",1,17,20,14,9,24.7
6,1,7,12,5,13,6,0,0,"38",0,2,17,7,0,1,1038203,"2024-01-22T00:00:00.000Z",7,FALSE,2,214,"G",2,2,"Boston Celtics","Jrue Holiday",1,24,30,23,13,36.4
1,1,4,7,1,12,2,2,1,"34",0,3,6,4,2,1,1038203,"2024-01-22T00:00:00.000Z",7,FALSE,2,473,"G",2,2,"Boston Celtics","Derrick White",3,10,11,7,5,20.3
0,0,0,0,0,0,0,0,0,"00",0,0,0,0,0,0,1038203,"2024-01-22T00:00:00.000Z",7,FALSE,2,17896094,"G",2,2,"Boston Celtics","Dalano Banton",0,0,0,0,0,0
0,0,0,2,1,3,2,0,0,"15",1,1,5,1,0,0,1038203,"2024-01-22T00:00:00.000Z",7,FALSE,2,17896060,"F",2,2,"Boston Celtics","Sam Hauser",0,6,6,5,1,6.2
1,1,4,0,0,3,1,0,0,"19",1,2,2,5,0,2,1038203,"2024-01-22T00:00:00.000Z",7,FALSE,2,261,"F-C",2,2,"Boston Celtics","Luke Kornet",1,7,8,3,6,10.5
0,0,0,0,0,0,0,0,0,"00",0,0,0,0,0,0,1038203,"2024-01-22T00:00:00.000Z",7,FALSE,2,338,"G",2,2,"Boston Celtics","Svi Mykhailiuk",0,0,0,0,0,0
6,1,6,4,1,7,2,0,0,"25",1,1,5,7,1,1,1038203,"2024-01-22T00:00:00.000Z",7,FALSE,2,3547276,"G",2,2,"Boston Celtics","Payton Pritchard",2,12,18,11,13,27.4
0,0,0,0,0,0,0,0,0,"00",0,0,0,0,0,0,1038203,"2024-01-22T00:00:00.000Z",7,FALSE,2,17553967,"C",2,2,"Boston Celtics","Neemias Queta",0,0,0,0,0,0
0,0,0,0,0,0,0,0,0,"00",0,0,0,0,0,0,1038203,"2024-01-22T00:00:00.000Z",7,FALSE,2,3547279,"F",2,2,"Boston Celtics","Lamar Stevens",0,0,0,0,0,0
0,0,0,0,0,0,0,0,0,"00",0,0,0,0,0,0,1038203,"2024-01-22T00:00:00.000Z",7,FALSE,2,56677864,"G",2,2,"Boston Celtics","Jordan Walsh",0,0,0,0,0,0
0,0,0,0,0,0,0,0,0,"00",0,0,0,0,0,0,1038203,"2024-01-22T00:00:00.000Z",7,FALSE,2,666468,"F",2,2,"Boston Celtics","Oshae Brissett",0,0,0,0,0,0
0,0,0,0,0,0,0,0,0,"00",0,0,0,0,0,0,1038203,"2024-01-22T00:00:00.000Z",7,FALSE,2,38017707,"G",2,2,"Boston Celtics","JD Davison",0,0,0,0,0,0
0,0,0,0,0,0,0,0,0,"00",0,0,0,0,0,0,1038203,"2024-01-22T00:00:00.000Z",7,FALSE,2,NA,NA,NA,2,"Boston Celtics","NA NA",0,0,0,0,0,0
0,0,0,0,0,0,0,0,0,"00",0,0,0,0,0,0,1038203,"2024-01-22T00:00:00.000Z",7,FALSE,2,378,"F-C",2,2,"Boston Celtics","Kristaps Porzingis",0,0,0,0,0,0
0,0,0,0,0,0,0,0,0,"00",0,0,0,0,0,0,1038203,"2024-01-22T00:00:00.000Z",7,FALSE,2,379,"F-C",7,7,"Dallas Mavericks","Dwight Powell",0,0,0,0,0,0
0,0,0,0,0,0,0,0,0,"00",0,0,0,0,0,0,1038203,"2024-01-22T00:00:00.000Z",7,FALSE,2,56677859,"F",7,7,"Dallas Mavericks","Olivier-Maxence Prosper",0,0,0,0,0,0
0,0,0,0,0,0,0,0,0,"00",0,0,0,0,0,0,1038203,"2024-01-22T00:00:00.000Z",7,FALSE,2,24489167,"G",25,7,"Dallas Mavericks","Brandon Williams",0,0,0,0,0,0
2,0,3,4,0,5,1,0,0,"18",0,1,2,3,0,0,1038203,"2024-01-22T00:00:00.000Z",7,FALSE,2,666965,"F",7,7,"Dallas Mavericks","Grant Williams",0,5,7,4,5,8.6
0,0,0,0,0,0,0,0,0,"00",0,0,0,0,0,0,1038203,"2024-01-22T00:00:00.000Z",7,FALSE,2,17896028,"F",7,7,"Dallas Mavericks","Greg Brown III",0,0,0,0,0,0
6,0,4,2,0,18,8,2,2,"31",1,1,18,5,0,1,1038208,"2024-01-23T00:00:00.000Z",19,FALSE,29,227,"F",19,19,"New Orleans Pelicans","Brandon Ingram",0,23,29,24,11,32
11,0,2,0,0,12,8,2,1,"27",1,2,17,3,0,2,1038208,"2024-01-23T00:00:00.000Z",19,FALSE,29,666969,"F",19,19,"New Orleans Pelicans","Zion Williamson",0,20,31,28,14,35.1
3,0,9,5,1,13,7,4,2,"23",3,2,17,12,0,1,1038208,"2024-01-23T00:00:00.000Z",19,FALSE,29,455,"C",19,19,"New Orleans Pelicans","Jonas Valanciunas",0,29,32,20,15,34.9
5,1,3,4,4,9,8,2,2,"26",2,4,22,5,2,0,1038208,"2024-01-23T00:00:00.000Z",19,FALSE,29,17896024,"F",19,19,"New Orleans Pelicans","Herbert Jones",3,27,32,27,10,44.5
2,1,4,13,9,17,11,3,2,"29",1,3,33,5,1,2,1038208,"2024-01-23T00:00:00.000Z",19,FALSE,29,303,"G",19,19,"New Orleans Pelicans","CJ McCollum",2,38,40,35,7,46
0,0,2,4,3,5,3,0,0,"05",0,0,9,2,0,1,1038208,"2024-01-23T00:00:00.000Z",19,FALSE,29,17896097,"G",19,19,"New Orleans Pelicans","Jose Alvarado",0,11,11,9,2,10.4
3,0,5,1,0,2,0,0,0,"17",0,2,0,5,1,0,1038208,"2024-01-23T00:00:00.000Z",19,FALSE,29,38017677,"G",19,19,"New Orleans Pelicans","Dyson Daniels",1,5,8,3,8,13.5
0,1,2,4,2,4,2,0,0,"16",0,1,6,2,0,0,1038208,"2024-01-23T00:00:00.000Z",19,FALSE,29,56677837,"G",19,19,"New Orleans Pelicans","Jordan Hawkins",1,8,8,6,2,11.4
4,0,1,1,1,3,1,0,0,"16",1,3,3,2,1,1,1038208,"2024-01-23T00:00:00.000Z",19,FALSE,29,3547293,"F",19,19,"New Orleans Pelicans","Naji Marshall",1,5,9,7,6,13.4
2,0,3,10,2,14,6,1,0,"25",1,2,14,4,0,0,1038208,"2024-01-23T00:00:00.000Z",19,FALSE,29,18677986,"F",19,19,"New Orleans Pelicans","Trey Murphy III",0,18,20,16,6,21.8
3,1,8,2,1,6,5,1,1,"20",0,2,12,8,1,1,1038208,"2024-01-23T00:00:00.000Z",19,FALSE,29,340,"F",19,19,"New Orleans Pelicans","Larry Nance Jr.",2,20,23,15,11,31.1
2,0,2,0,0,1,1,0,0,"05",2,2,2,4,0,0,1038208,"2024-01-23T00:00:00.000Z",19,FALSE,29,491,"C",19,19,"New Orleans Pelicans","Cody Zeller",0,6,8,4,6,9.8
0,0,0,0,0,0,0,0,0,"00",0,0,0,0,0,0,1038208,"2024-01-23T00:00:00.000Z",19,FALSE,29,38017663,"F",19,19,"New Orleans Pelicans","E.J. Liddell",0,0,0,0,0,0
0,0,0,0,0,0,0,0,0,"00",0,0,0,0,0,0,1038208,"2024-01-23T00:00:00.000Z",19,FALSE,29,17896021,"F",19,19,"New Orleans Pelicans","Jeremiah Robinson-Earl",0,0,0,0,0,0
0,0,0,0,0,0,0,0,0,"00",0,0,0,0,0,0,1038208,"2024-01-23T00:00:00.000Z",19,FALSE,29,17896017,"F",19,19,"New Orleans Pelicans","Matt Ryan",0,0,0,0,0,0
0,0,0,0,0,0,0,0,0,"00",0,0,0,0,0,0,1038208,"2024-01-23T00:00:00.000Z",19,FALSE,29,38017726,"G",19,19,"New Orleans Pelicans","Dereon Seabron",0,0,0,0,0,0
2,0,4,8,5,9,6,1,1,"25",0,1,18,4,2,1,1038208,"2024-01-23T00:00:00.000Z",19,FALSE,29,38017739,"F",29,29,"Utah Jazz","Simone Fontecchio",2,22,24,20,6,30.8
1,0,2,5,1,15,4,2,2,"27",2,0,11,4,0,1,1038208,"2024-01-23T00:00:00.000Z",19,FALSE,29,297,"F",29,29,"Utah Jazz","Lauri Markkanen",0,15,16,12,5,16.3
2,3,8,3,0,12,5,4,4,"25",1,5,14,9,0,1,1038208,"2024-01-23T00:00:00.000Z",19,FALSE,29,101,"F-C",29,29,"Utah Jazz","John Collins",3,23,25,16,11,35.8
4,0,1,4,2,7,4,0,0,"17",2,3,10,3,0,1,1038208,"2024-01-23T00:00:00.000Z",19,FALSE,29,139,"G",29,29,"Utah Jazz","Kris Dunn",0,13,17,14,7,18.6
7,1,3,4,2,12,9,3,2,"24",0,0,22,3,0,1,1038208,"2024-01-23T00:00:00.000Z",19,FALSE,29,413,"G",29,29,"Utah Jazz","Collin Sexton",1,25,32,29,10,38.1
0,0,1,1,1,4,2,0,0,"23",1,0,5,2,0,0,1038208,"2024-01-23T00:00:00.000Z",19,FALSE,29,38017620,"G",29,29,"Utah Jazz","Ochai Agbaji",0,7,7,5,2,7.4
1,0,1,3,0,9,4,1,1,"22",0,0,9,1,0,2,1038208,"2024-01-23T00:00:00.000Z",19,FALSE,29,100,"G",29,29,"Utah Jazz","Jordan Clarkson",0,10,11,10,2,9.7
5,0,1,4,1,8,1,10,9,"25",0,2,12,1,1,0,1038208,"2024-01-23T00:00:00.000Z",19,FALSE,29,56677834,"G",29,29,"Utah Jazz","Keyonte George",1,13,18,17,6,23.7
2,0,3,2,0,7,2,4,4,"08",0,0,8,3,1,0,1038208,"2024-01-23T00:00:00.000Z",19,FALSE,29,666650,"G",29,29,"Utah Jazz","Talen Horton-Tucker",1,11,13,10,5,17.6
1,4,5,0,0,3,2,5,2,"25",0,1,6,5,0,0,1038208,"2024-01-23T00:00:00.000Z",19,FALSE,29,38017705,"C",29,29,"Utah Jazz","Walker Kessler",4,11,12,7,6,25.5
2,0,3,1,0,5,4,2,1,"14",0,3,9,3,0,1,1038208,"2024-01-23T00:00:00.000Z",19,FALSE,29,358,"F",29,29,"Utah Jazz","Kelly Olynyk",0,12,14,11,5,14.6
0,0,0,1,0,1,0,0,0,"05",0,0,0,0,0,0,1038208,"2024-01-23T00:00:00.000Z",19,FALSE,29,666881,"F",29,29,"Utah Jazz","Luka Samanic",0,0,0,0,0,0
0,0,0,0,0,0,0,0,0,"00",0,0,0,0,0,0,1038208,"2024-01-23T00:00:00.000Z",19,FALSE,29,11891374,"C",29,29,"Utah Jazz","Omer Yurtseven",0,0,0,0,0,0
0,0,0,0,0,0,0,0,0,"00",0,0,0,0,0,0,1038208,"2024-01-23T00:00:00.000Z",19,FALSE,29,56677824,"F",29,29,"Utah Jazz","Taylor Hendricks",0,0,0,0,0,0
0,0,0,0,0,0,0,0,0,"00",0,0,0,0,0,0,1038208,"2024-01-23T00:00:00.000Z",19,FALSE,29,38017630,"G",29,29,"Utah Jazz","Johnny Juzang",0,0,0,0,0,0
0,0,0,0,0,0,0,0,0,"00",0,0,0,0,0,0,1038208,"2024-01-23T00:00:00.000Z",19,FALSE,29,19465584,"F",29,29,"Utah Jazz","Micah Potter",0,0,0,0,0,0
0,0,0,0,0,0,0,0,0,"00",0,0,0,0,0,0,1038208,"2024-01-23T00:00:00.000Z",19,FALSE,29,17896042,"G",13,29,"Utah Jazz","Jason Preston",0,0,0,0,0,0
0,0,0,0,0,0,0,0,0,"00",0,0,0,0,0,0,1038208,"2024-01-23T00:00:00.000Z",19,FALSE,29,56677842,"F",29,29,"Utah Jazz","Brice Sensabaugh",0,0,0,0,0,0
7,1,2,4,2,12,5,6,6,"35",0,2,18,2,0,7,1038209,"2024-01-23T00:00:00.000Z",21,FALSE,25,65,"G",25,25,"Portland Trail Blazers","Malcolm Brogdon",1,20,27,25,9,26.9
0,0,0,0,0,0,0,0,0,"00",0,0,0,0,0,0,1038209,"2024-01-23T00:00:00.000Z",21,FALSE,25,39613724,"C",25,25,"Portland Trail Blazers","Ibou Badji",0,0,0,0,0,0
1,0,3,0,0,2,0,0,0,"14",2,2,0,5,2,0,1038209,"2024-01-23T00:00:00.000Z",21,FALSE,25,56677850,"F",25,25,"Portland Trail Blazers","Toumani Camara",2,5,6,1,6,13.5
7,0,4,6,2,18,7,3,3,"26",0,5,19,4,1,1,1038209,"2024-01-23T00:00:00.000Z",21,FALSE,25,56677747,"G",25,25,"Portland Trail Blazers","Scoot Henderson",1,23,30,26,11,36.3
0,0,0,0,0,0,0,0,0,"00",0,0,0,0,0,0,1038209,"2024-01-23T00:00:00.000Z",21,FALSE,25,NA,NA,NA,25,"Portland Trail Blazers","NA NA",0,0,0,0,0,0
0,0,0,0,0,0,0,0,0,"00",0,0,0,0,0,0,1038209,"2024-01-23T00:00:00.000Z",21,FALSE,25,56677791,"F",25,25,"Portland Trail Blazers","Kris Murray",0,0,0,0,0,0
3,1,3,3,2,5,3,2,2,"21",1,3,10,4,1,2,1038209,"2024-01-23T00:00:00.000Z",21,FALSE,25,56783340,"C",25,25,"Portland Trail Blazers","Duop Reath",2,14,17,13,7,23.3
1,0,2,5,1,6,2,2,1,"24",1,4,6,3,0,3,1038209,"2024-01-23T00:00:00.000Z",21,FALSE,25,666541,"G",21,21,"Oklahoma City Thunder","Luguentz Dort",0,9,10,7,4,8.1
2,2,4,3,1,20,9,0,0,"32",0,1,19,4,2,0,1038209,"2024-01-23T00:00:00.000Z",21,FALSE,25,38017703,"G-F",21,21,"Oklahoma City Thunder","Jalen Williams",4,23,25,21,6,38.8
3,6,9,2,0,6,3,4,2,"32",1,1,8,10,0,1,1038209,"2024-01-23T00:00:00.000Z",21,FALSE,25,38017685,"C-F",21,21,"Oklahoma City Thunder","Chet Holmgren",6,18,21,11,13,41.5
3,0,3,0,0,6,3,2,1,"25",2,2,7,5,0,0,1038209,"2024-01-23T00:00:00.000Z",21,FALSE,25,17896065,"G",21,21,"Oklahoma City Thunder","Josh Giddey",0,12,15,10,8,17.5
10,0,4,3,0,24,10,17,13,"35",2,3,33,6,5,3,1038209,"2024-01-23T00:00:00.000Z",21,FALSE,25,175,"G",21,21,"Oklahoma City Thunder","Shai Gilgeous-Alexander",5,39,49,43,16,67.2
0,1,0,1,0,1,0,0,0,"03",0,0,0,0,0,0,1038209,"2024-01-23T00:00:00.000Z",21,FALSE,25,44,"F",21,21,"Oklahoma City Thunder","Davis Bertans",1,0,0,0,0,3
2,0,1,2,1,5,4,0,0,"20",0,2,9,1,0,0,1038209,"2024-01-23T00:00:00.000Z",21,FALSE,25,3547272,"G",21,21,"Oklahoma City Thunder","Isaiah Joe",0,10,12,11,3,13.2
1,0,0,0,0,0,0,0,0,"05",1,1,0,1,0,0,1038209,"2024-01-23T00:00:00.000Z",21,FALSE,25,56677853,"F",21,21,"Oklahoma City Thunder","Keyontae Johnson",0,1,2,1,2,2.7
0,0,0,0,0,0,0,0,0,"00",0,0,0,0,0,0,1038209,"2024-01-23T00:00:00.000Z",21,FALSE,25,17896036,"G",21,21,"Oklahoma City Thunder","Tre Mann",0,0,0,0,0,0
0,0,0,0,0,1,0,2,1,"07",0,0,1,0,0,1,1038209,"2024-01-23T00:00:00.000Z",21,FALSE,25,4197029,"G",21,21,"Oklahoma City Thunder","Vasilije Micic",0,1,1,1,0,0
0,0,0,0,0,0,0,0,0,"00",0,0,0,0,0,0,1038209,"2024-01-23T00:00:00.000Z",21,FALSE,25,3547271,"C",21,21,"Oklahoma City Thunder","Aleksej Pokusevski",0,0,0,0,0,0
0,0,4,2,1,2,1,0,0,"12",0,0,3,4,0,2,1038209,"2024-01-23T00:00:00.000Z",21,FALSE,25,56677833,"G",21,21,"Oklahoma City Thunder","Cason Wallace",0,7,7,3,4,5.8
0,0,1,1,1,8,6,0,0,"17",2,3,13,3,0,1,1038209,"2024-01-23T00:00:00.000Z",21,FALSE,25,17896078,"G",21,21,"Oklahoma City Thunder","Aaron Wiggins",0,16,16,13,3,15.6
1,1,2,2,1,5,3,1,0,"15",0,1,7,2,1,0,1038209,"2024-01-23T00:00:00.000Z",21,FALSE,25,38017706,"F",21,21,"Oklahoma City Thunder","Jaylin Williams",2,9,10,8,3,16.9
0,0,3,2,1,5,2,0,0,"13",1,0,5,4,1,1,1038209,"2024-01-23T00:00:00.000Z",21,FALSE,25,480,"G-F",21,21,"Oklahoma City Thunder","Kenrich Williams",1,9,9,5,4,11.8
0,0,0,0,0,0,0,0,0,"00",0,0,0,0,0,0,1038209,"2024-01-23T00:00:00.000Z",21,FALSE,25,38017716,"F",21,21,"Oklahoma City Thunder","Ousmane Dieng",0,0,0,0,0,0
0,0,0,0,0,0,0,0,0,"00",0,0,0,0,0,0,1038209,"2024-01-23T00:00:00.000Z",21,FALSE,25,24572055,"C",21,21,"Oklahoma City Thunder","Olivier Sarr",0,0,0,0,0,0
0,0,0,0,0,0,0,0,0,"00",0,0,0,0,0,0,1038209,"2024-01-23T00:00:00.000Z",21,FALSE,25,27924547,"F",21,21,"Oklahoma City Thunder","Lindy Waters III",0,0,0,0,0,0
0,1,7,7,2,14,6,0,0,"34",6,0,14,13,0,1,1038209,"2024-01-23T00:00:00.000Z",21,FALSE,25,38017711,"F",25,25,"Portland Trail Blazers","Jabari Walker",1,27,27,14,13,31.6
1,1,5,5,4,10,6,4,2,"30",0,0,18,5,1,1,1038209,"2024-01-23T00:00:00.000Z",21,FALSE,25,182,"F",25,25,"Portland Trail Blazers","Jerami Grant",2,23,24,19,6,30.5
2,0,5,0,0,7,2,2,1,"27",2,2,5,7,0,3,1038209,"2024-01-23T00:00:00.000Z",21,FALSE,25,22,"C",25,25,"Portland Trail Blazers","Deandre Ayton",0,12,14,7,9,13.4
5,1,3,9,4,12,5,4,3,"33",0,3,17,3,0,4,1038209,"2024-01-23T00:00:00.000Z",21,FALSE,25,419,"G",25,25,"Portland Trail Blazers","Anfernee Simons",1,20,25,22,8,27.1
0,0,0,0,0,0,0,0,0,"00",0,0,0,0,0,0,1038209,"2024-01-23T00:00:00.000Z",21,FALSE,25,476,"C-F",25,25,"Portland Trail Blazers","Robert Williams III",0,0,0,0,0,0
0,0,0,0,0,0,0,0,0,"00",0,0,0,0,0,0,1038209,"2024-01-23T00:00:00.000Z",21,FALSE,25,56677829,"G-F",25,25,"Portland Trail Blazers","Rayan Rupert",0,0,0,0,0,0
1,1,2,5,2,6,3,0,0,"20",1,2,8,3,1,0,1038209,"2024-01-23T00:00:00.000Z",21,FALSE,25,666923,"G-F",25,25,"Portland Trail Blazers","Matisse Thybulle",2,11,12,9,4,19.1
0,0,0,0,0,0,0,0,0,"00",0,0,0,0,0,0,1038209,"2024-01-23T00:00:00.000Z",21,FALSE,25,666476,"C",25,25,"Portland Trail Blazers","Moses Brown",0,0,0,0,0,0
0,0,0,0,0,0,0,0,0,"00",0,0,0,0,0,0,1038209,"2024-01-23T00:00:00.000Z",21,FALSE,25,47957121,"F",25,25,"Portland Trail Blazers","Justin Minaya",0,0,0,0,0,0
0,0,0,0,0,0,0,0,0,"00",0,0,0,0,0,0,1038209,"2024-01-23T00:00:00.000Z",21,FALSE,25,38017690,"G",25,25,"Portland Trail Blazers","Shaedon Sharpe",0,0,0,0,0,0
10,1,9,1,0,16,11,3,3,"38",2,0,25,11,2,2,1038210,"2024-01-23T00:00:00.000Z",13,FALSE,14,274,"F",13,13,"LA Clippers","Kawhi Leonard",3,36,46,35,21,60.2
3,1,4,2,1,12,8,0,0,"30",1,2,17,5,0,4,1038210,"2024-01-23T00:00:00.000Z",13,FALSE,14,172,"F",13,13,"LA Clippers","Paul George",1,22,25,20,8,26.5
2,0,2,0,0,1,0,0,0,"19",0,0,0,2,0,1,1038210,"2024-01-23T00:00:00.000Z",13,FALSE,14,371,"F-C",13,13,"LA Clippers","Mason Plumlee",0,2,4,2,4,4.4
1,0,0,4,2,10,7,2,1,"23",1,4,17,1,1,2,1038210,"2024-01-23T00:00:00.000Z",13,FALSE,14,666743,"G",13,13,"LA Clippers","Terance Mann",1,18,19,18,2,20.7
10,1,1,8,4,17,8,5,3,"39",1,3,23,2,1,1,1038210,"2024-01-23T00:00:00.000Z",13,FALSE,14,192,"G",13,13,"LA Clippers","James Harden",2,25,35,33,12,45.4
0,0,0,0,0,0,0,0,0,"00",0,0,0,0,0,0,1038210,"2024-01-23T00:00:00.000Z",13,FALSE,14,17896022,"G",13,13,"LA Clippers","Brandon Boston Jr.",0,0,0,0,0,0
0,0,0,0,0,0,0,0,0,"01",0,0,0,0,0,0,1038210,"2024-01-23T00:00:00.000Z",13,FALSE,14,56677849,"F",13,13,"LA Clippers","Kobe Brown",0,0,0,0,0,0
0,0,2,3,3,4,3,0,0,"24",0,2,9,2,1,0,1038210,"2024-01-23T00:00:00.000Z",13,FALSE,14,666511,"G",13,13,"LA Clippers","Amir Coffey",1,11,11,9,2,14.4
0,0,0,0,0,0,0,0,0,"00",0,0,0,0,0,0,1038210,"2024-01-23T00:00:00.000Z",13,FALSE,14,17896031,"G",13,13,"LA Clippers","Nah'Shon Hyland",0,0,0,0,0,0
2,2,5,4,1,14,8,0,0,"27",0,0,17,5,0,1,1038210,"2024-01-23T00:00:00.000Z",13,FALSE,14,380,"F-G",13,13,"LA Clippers","Norman Powell",2,22,24,19,7,31
2,0,1,2,0,3,1,1,1,"21",1,5,3,2,1,0,1038210,"2024-01-23T00:00:00.000Z",13,FALSE,14,439,"F",13,13,"LA Clippers","Daniel Theis",1,5,7,5,4,11.4
0,0,0,0,0,0,0,0,0,"00",0,0,0,0,0,0,1038210,"2024-01-23T00:00:00.000Z",13,FALSE,14,450,"F",13,13,"LA Clippers","PJ Tucker",0,0,0,0,0,0
3,0,6,3,3,11,6,1,1,"18",0,1,16,6,2,3,1038210,"2024-01-23T00:00:00.000Z",13,FALSE,14,472,"G",13,13,"LA Clippers","Russell Westbrook",2,22,25,19,9,30.7
0,0,0,0,0,0,0,0,0,"00",0,0,0,0,0,0,1038210,"2024-01-23T00:00:00.000Z",13,FALSE,14,38017725,"F",13,13,"LA Clippers","Moussa Diabate",0,0,0,0,0,0
0,0,0,0,0,0,0,0,0,"00",0,0,0,0,0,0,1038210,"2024-01-23T00:00:00.000Z",13,FALSE,14,56677856,"G",13,13,"LA Clippers","Jordan Miller",0,0,0,0,0,0
0,0,0,0,0,0,0,0,0,"00",0,0,0,0,0,0,1038210,"2024-01-23T00:00:00.000Z",13,FALSE,14,24417679,"G",13,13,"LA Clippers","Xavier Moon",0,0,0,0,0,0
0,0,0,0,0,0,0,0,0,"00",0,0,0,0,0,0,1038210,"2024-01-23T00:00:00.000Z",13,FALSE,14,17896051,"G",13,13,"LA Clippers","Joshua Primo",0,0,0,0,0,0
0,0,0,0,0,0,0,0,0,"00",0,0,0,0,0,0,1038210,"2024-01-23T00:00:00.000Z",13,FALSE,14,493,"C",13,13,"LA Clippers","Ivica Zubac",0,0,0,0,0,0
2,2,3,6,2,10,4,1,1,"33",0,2,11,3,2,1,1038210,"2024-01-23T00:00:00.000Z",13,FALSE,14,383,"F",14,14,"Los Angeles Lakers","Taurean Prince",4,14,16,13,5,28.6
2,1,2,1,1,8,5,0,0,"30",1,1,11,3,1,0,1038210,"2024-01-23T00:00:00.000Z",13,FALSE,14,666609,"F",14,14,"Los Angeles Lakers","Rui Hachimura",2,14,16,13,5,23.6
2,0,8,1,0,20,12,2,2,"36",4,2,26,12,0,1,1038210,"2024-01-23T00:00:00.000Z",13,FALSE,14,117,"F-C",14,14,"Los Angeles Lakers","Anthony Davis",0,38,40,28,14,42.4
5,1,2,8,2,14,5,0,0,"34",0,3,12,2,2,3,1038210,"2024-01-23T00:00:00.000Z",13,FALSE,14,17553995,"G",14,14,"Los Angeles Lakers","Austin Reaves",3,14,19,17,7,27.9
10,1,3,10,4,21,9,6,5,"40",2,3,27,5,0,5,1038210,"2024-01-23T00:00:00.000Z",13,FALSE,14,405,"G",14,14,"Los Angeles Lakers","D'Angelo Russell",1,32,42,37,15,46
2,1,3,1,0,10,4,4,4,"25",6,3,12,9,3,2,1038210,"2024-01-23T00:00:00.000Z",13,FALSE,14,457,"F",14,14,"Los Angeles Lakers","Jarred Vanderbilt",4,21,23,14,11,35.8
0,0,0,1,0,1,0,0,0,"10",0,0,0,0,0,0,1038210,"2024-01-23T00:00:00.000Z",13,FALSE,14,38017697,"G",14,14,"Los Angeles Lakers","Max Christie",0,0,0,0,0,0
0,0,0,0,0,0,0,0,0,"01",0,0,0,0,0,0,1038210,"2024-01-23T00:00:00.000Z",13,FALSE,14,666626,"C",14,14,"Los Angeles Lakers","Jaxson Hayes",0,0,0,0,0,0
1,3,0,4,2,5,3,4,1,"16",0,1,9,0,1,1,1038210,"2024-01-23T00:00:00.000Z",13,FALSE,14,666860,"F-G",14,14,"Los Angeles Lakers","Cameron Reddish",4,9,10,10,1,21.5
3,0,7,0,0,2,2,5,2,"13",0,0,6,7,0,1,1038210,"2024-01-23T00:00:00.000Z",13,FALSE,14,486,"F",14,14,"Los Angeles Lakers","Christian Wood",0,13,16,9,10,17.9
0,0,0,0,0,0,0,0,0,"01",0,0,0,0,0,1,1038210,"2024-01-23T00:00:00.000Z",13,FALSE,14,56677835,"G",14,14,"Los Angeles Lakers","Jalen Hood-Schifino",0,0,0,0,0,-1
0,0,0,0,0,1,1,0,0,"01",0,0,2,0,0,0,1038210,"2024-01-23T00:00:00.000Z",13,FALSE,14,56677836,"F",14,14,"Los Angeles Lakers","Maxwell Lewis",0,2,2,2,0,2
0,0,0,0,0,0,0,0,0,"00",0,0,0,0,0,0,1038210,"2024-01-23T00:00:00.000Z",13,FALSE,14,56677738,"C",14,14,"Los Angeles Lakers","Colin Castleton",0,0,0,0,0,0
0,0,0,0,0,0,0,0,0,"00",0,0,0,0,0,0,1038210,"2024-01-23T00:00:00.000Z",13,FALSE,14,237,"F",14,14,"Los Angeles Lakers","LeBron James",0,0,0,0,0,0
0,0,0,0,0,0,0,0,0,"00",0,0,0,0,0,0,1038210,"2024-01-23T00:00:00.000Z",13,FALSE,14,3547289,"G",25,14,"Los Angeles Lakers","Skylar Mays",0,0,0,0,0,0
0,0,0,0,0,0,0,0,0,"00",0,0,0,0,0,0,1038210,"2024-01-23T00:00:00.000Z",13,FALSE,14,1603383,"G",14,14,"Los Angeles Lakers","Gabe Vincent",0,0,0,0,0,0
0,0,0,0,0,0,0,0,0,"00",0,0,0,0,0,0,1038210,"2024-01-23T00:00:00.000Z",13,FALSE,14,666971,"G-F",20,14,"Los Angeles Lakers","Dylan Windler",0,0,0,0,0,0
0,0,5,7,1,13,5,2,2,"34",4,3,13,9,0,1,1038206,"2024-01-23T00:00:00.000Z",12,FALSE,8,3547250,"G-F",12,12,"Indiana Pacers","Aaron Nesmith",0,22,22,13,9,22.8
4,0,8,0,0,16,7,2,2,"33",2,1,16,10,0,1,1038206,"2024-01-23T00:00:00.000Z",12,FALSE,8,416,"F",28,12,"Indiana Pacers","Pascal Siakam",0,26,30,20,14,33
1,0,6,5,0,18,8,7,6,"37",0,3,22,6,1,2,1038206,"2024-01-23T00:00:00.000Z",12,FALSE,8,452,"C-F",12,12,"Indiana Pacers","Myles Turner",1,28,29,23,7,31.7
1,1,1,2,0,3,1,1,1,"22",0,1,3,1,2,0,1038206,"2024-01-23T00:00:00.000Z",12,FALSE,8,210,"G",12,12,"Indiana Pacers","Buddy Hield",3,4,5,4,2,14.7
7,0,1,3,1,9,7,0,0,"27",0,1,15,1,0,2,1038206,"2024-01-23T00:00:00.000Z",12,FALSE,8,38017507,"G-F",12,12,"Indiana Pacers","Andrew Nembhard",0,16,23,22,8,24.7
0,0,0,0,0,0,0,0,0,"00",0,0,0,0,0,0,1038206,"2024-01-23T00:00:00.000Z",12,FALSE,8,38017701,"G",12,12,"Indiana Pacers","Kendall Brown",0,0,0,0,0,0
0,0,2,0,0,3,1,2,1,"09",0,1,3,2,0,0,1038206,"2024-01-23T00:00:00.000Z",12,FALSE,8,17896035,"F",12,12,"Indiana Pacers","Isaiah Jackson",0,5,5,3,2,5.4
0,0,0,0,0,0,0,0,0,"00",0,0,0,0,0,0,1038206,"2024-01-23T00:00:00.000Z",12,FALSE,8,242,"F",12,12,"Indiana Pacers","James Johnson",0,0,0,0,0,0
3,0,5,2,1,8,3,5,4,"28",0,2,11,5,0,1,1038206,"2024-01-23T00:00:00.000Z",12,FALSE,8,38017686,"G-F",12,12,"Indiana Pacers","Bennedict Mathurin",0,16,19,14,8,20.5
7,0,1,1,1,11,7,2,2,"21",0,3,17,1,0,3,1038206,"2024-01-23T00:00:00.000Z",12,FALSE,8,304,"G",12,12,"Indiana Pacers","T.J. McConnell",0,18,25,24,8,25.7
1,0,0,1,1,2,2,0,0,"12",1,1,5,1,1,0,1038206,"2024-01-23T00:00:00.000Z",12,FALSE,8,56677861,"G",12,12,"Indiana Pacers","Ben Sheppard",1,6,7,6,2,10.7
0,0,0,0,0,0,0,0,0,"00",0,0,0,0,0,0,1038206,"2024-01-23T00:00:00.000Z",12,FALSE,8,3547264,"F-C",12,12,"Indiana Pacers","Jalen Smith",0,0,0,0,0,0
0,0,2,0,0,4,2,0,0,"17",0,0,4,2,0,0,1038206,"2024-01-23T00:00:00.000Z",12,FALSE,8,3547243,"F",12,12,"Indiana Pacers","Obi Toppin",0,6,6,4,2,6.4
0,0,0,0,0,0,0,0,0,"00",0,0,0,0,0,0,1038206,"2024-01-23T00:00:00.000Z",12,FALSE,8,56677778,"F-C",12,12,"Indiana Pacers","Oscar Tshiebwe",0,0,0,0,0,0
0,0,0,0,0,0,0,0,0,"00",0,0,0,0,0,0,1038206,"2024-01-23T00:00:00.000Z",12,FALSE,8,56677832,"F",12,12,"Indiana Pacers","Jarace Walker",0,0,0,0,0,0
0,0,0,0,0,0,0,0,0,"00",0,0,0,0,0,0,1038206,"2024-01-23T00:00:00.000Z",12,FALSE,8,3547245,"G",12,12,"Indiana Pacers","Tyrese Haliburton",0,0,0,0,0,0
0,0,0,0,0,0,0,0,0,"00",0,0,0,0,0,0,1038206,"2024-01-23T00:00:00.000Z",12,FALSE,8,56677794,"G",12,12,"Indiana Pacers","Isaiah Wong",0,0,0,0,0,0
1,1,4,5,1,9,2,0,0,"31",0,1,5,4,0,0,1038206,"2024-01-23T00:00:00.000Z",12,FALSE,8,375,"F",8,8,"Denver Nuggets","Michael Porter Jr.",1,9,10,6,5,14.3
10,1,11,4,3,19,13,2,2,"37",2,3,31,13,0,1,1038206,"2024-01-23T00:00:00.000Z",12,FALSE,8,246,"C",8,8,"Denver Nuggets","Nikola Jokic",1,44,54,41,23,63.6
0,0,3,6,2,12,5,2,2,"35",2,3,14,5,1,1,1038206,"2024-01-23T00:00:00.000Z",12,FALSE,8,81,"G",8,8,"Denver Nuggets","Kentavious Caldwell-Pope",1,19,19,14,5,22
7,0,6,9,3,24,11,6,6,"37",2,1,31,8,0,3,1038206,"2024-01-23T00:00:00.000Z",12,FALSE,8,335,"G",8,8,"Denver Nuggets","Jamal Murray",0,39,46,38,15,48.1
0,1,1,2,0,3,1,0,0,"15",3,0,2,4,1,0,1038206,"2024-01-23T00:00:00.000Z",12,FALSE,8,38017709,"G",8,8,"Denver Nuggets","Christian Braun",2,6,6,2,4,12.8
0,0,0,0,0,0,0,0,0,"00",0,0,0,0,0,0,1038206,"2024-01-23T00:00:00.000Z",12,FALSE,8,215,"F-G",8,8,"Denver Nuggets","Justin Holiday",0,0,0,0,0,0
2,1,2,4,1,11,6,0,0,"24",0,3,13,2,2,2,1038206,"2024-01-23T00:00:00.000Z",12,FALSE,8,236,"G",8,8,"Denver Nuggets","Reggie Jackson",3,15,17,15,4,25.4
1,1,1,0,0,1,1,2,0,"11",2,2,2,3,0,1,1038206,"2024-01-23T00:00:00.000Z",12,FALSE,8,250,"C",8,8,"Denver Nuggets","DeAndre Jordan",1,5,6,3,4,9.1
0,2,2,2,1,4,2,2,2,"18",0,1,7,2,1,2,1038206,"2024-01-23T00:00:00.000Z",12,FALSE,8,38017721,"G",8,8,"Denver Nuggets","Peyton Watson",3,9,9,7,2,16.4
0,0,0,0,0,0,0,0,0,"00",0,0,0,0,0,0,1038206,"2024-01-23T00:00:00.000Z",12,FALSE,8,666489,"F",8,8,"Denver Nuggets","Vlatko Cancar",0,0,0,0,0,0
0,0,0,0,0,0,0,0,0,"00",0,0,0,0,0,0,1038206,"2024-01-23T00:00:00.000Z",12,FALSE,8,38017727,"G",8,8,"Denver Nuggets","Collin Gillespie",0,0,0,0,0,0
0,0,0,0,0,0,0,0,0,"00",0,0,0,0,0,0,1038206,"2024-01-23T00:00:00.000Z",12,FALSE,8,17896007,"G",8,8,"Denver Nuggets","Braxton Key",0,0,0,0,0,0
1,2,1,1,0,5,3,3,3,"32",0,3,9,1,0,0,1038206,"2024-01-23T00:00:00.000Z",12,FALSE,8,177,"F",8,8,"Denver Nuggets","Aaron Gordon",2,10,11,10,2,17.7
0,0,0,0,0,0,0,0,0,"00",0,0,0,0,0,0,1038206,"2024-01-23T00:00:00.000Z",12,FALSE,8,17896103,"F-C",8,8,"Denver Nuggets","Jay Huff",0,0,0,0,0,0
0,0,0,0,0,0,0,0,0,"00",0,0,0,0,0,0,1038206,"2024-01-23T00:00:00.000Z",12,FALSE,8,3547268,"F-C",8,8,"Denver Nuggets","Zeke Nnaji",0,0,0,0,0,0
0,0,0,0,0,0,0,0,0,"00",0,0,0,0,0,0,1038206,"2024-01-23T00:00:00.000Z",12,FALSE,8,56677582,"G",8,8,"Denver Nuggets","Jalen Pickett",0,0,0,0,0,0
0,0,0,0,0,0,0,0,0,"00",0,0,0,0,0,0,1038206,"2024-01-23T00:00:00.000Z",12,FALSE,8,56677871,"F",8,8,"Denver Nuggets","Hunter Tyson",0,0,0,0,0,0
0,0,0,0,0,0,0,0,0,"00",0,0,0,0,0,0,1038206,"2024-01-23T00:00:00.000Z",12,FALSE,8,56677776,"G",8,8,"Denver Nuggets","Julian Strawther",0,0,0,0,0,0
2,0,3,6,4,14,7,1,1,"25",2,1,19,5,0,0,1038207,"2024-01-23T00:00:00.000Z",3,FALSE,20,666679,"F",3,3,"Brooklyn Nets","Cameron Johnson",0,24,26,21,7,28
7,1,0,7,1,10,2,0,0,"37",2,3,5,2,1,2,1038207,"2024-01-23T00:00:00.000Z",3,FALSE,20,158,"F",3,3,"Brooklyn Nets","Dorian Finney-Smith",2,7,14,12,9,21.9
1,1,11,0,0,9,4,0,0,"39",6,1,8,17,2,3,1038207,"2024-01-23T00:00:00.000Z",3,FALSE,20,666508,"F-C",3,3,"Brooklyn Nets","Nicolas Claxton",3,25,26,9,18,35.9
5,0,5,13,7,26,14,2,1,"37",0,2,36,5,1,0,1038207,"2024-01-23T00:00:00.000Z",3,FALSE,20,61,"F",3,3,"Brooklyn Nets","Mikal Bridges",1,41,46,41,10,52.5
4,0,0,4,0,4,0,0,0,"19",0,1,0,0,0,1,1038207,"2024-01-23T00:00:00.000Z",3,FALSE,20,130,"G",3,3,"Brooklyn Nets","Spencer Dinwiddie",0,0,4,4,4,5
0,0,0,0,0,0,0,0,0,"00",0,0,0,0,0,0,1038207,"2024-01-23T00:00:00.000Z",3,FALSE,20,174,"F-C",3,3,"Brooklyn Nets","Harry Giles III",0,0,0,0,0,0
3,1,2,3,2,4,3,0,0,"20",2,3,8,4,1,1,1038207,"2024-01-23T00:00:00.000Z",3,FALSE,20,351,"F",3,3,"Brooklyn Nets","Royce O'Neale",2,12,15,11,7,22.3
0,0,0,0,0,0,0,0,0,"00",0,0,0,0,0,0,1038207,"2024-01-23T00:00:00.000Z",3,FALSE,20,17896038,"C",3,3,"Brooklyn Nets","Day'Ron Sharpe",0,0,0,0,0,0
5,1,5,1,0,9,4,0,0,"29",0,5,8,5,2,5,1038207,"2024-01-23T00:00:00.000Z",3,FALSE,20,421,"G",3,3,"Brooklyn Nets","Dennis Smith Jr.",3,13,18,13,10,25.5
2,1,1,3,0,11,6,2,2,"22",0,3,14,1,0,1,1038207,"2024-01-23T00:00:00.000Z",3,FALSE,20,17896048,"G",3,3,"Brooklyn Nets","Cam Thomas",1,15,17,16,3,20.2
0,0,0,5,1,8,2,0,0,"12",1,0,5,1,0,0,1038207,"2024-01-23T00:00:00.000Z",3,FALSE,20,464,"G",3,3,"Brooklyn Nets","Lonnie Walker IV",0,6,6,5,1,6.2
0,0,0,0,0,0,0,0,0,"00",0,0,0,0,0,0,1038207,"2024-01-23T00:00:00.000Z",3,FALSE,20,17896058,"F",3,3,"Brooklyn Nets","Trendon Watford",0,0,0,0,0,0
0,0,0,0,0,0,0,0,0,"00",0,0,0,0,0,0,1038207,"2024-01-23T00:00:00.000Z",3,FALSE,20,56677843,"F",3,3,"Brooklyn Nets","Noah Clowney",0,0,0,0,0,0
0,0,0,0,0,0,0,0,0,"00",0,0,0,0,0,0,1038207,"2024-01-23T00:00:00.000Z",3,FALSE,20,17896041,"G",3,3,"Brooklyn Nets","Keon Johnson",0,0,0,0,0,0
0,0,0,0,0,0,0,0,0,"00",0,0,0,0,0,0,1038207,"2024-01-23T00:00:00.000Z",3,FALSE,20,417,"G-F",3,3,"Brooklyn Nets","Ben Simmons",0,0,0,0,0,0
0,0,0,0,0,0,0,0,0,"00",0,0,0,0,0,0,1038207,"2024-01-23T00:00:00.000Z",3,FALSE,20,56677841,"F",3,3,"Brooklyn Nets","Dariq Whitehead",0,0,0,0,0,0
4,0,3,7,2,22,11,7,6,"36",0,2,30,3,0,2,1038207,"2024-01-23T00:00:00.000Z",3,FALSE,20,73,"G",20,20,"New York Knicks","Jalen Brunson",0,33,37,34,7,37.6
2,0,5,1,0,6,3,0,0,"22",4,1,6,9,0,0,1038207,"2024-01-23T00:00:00.000Z",3,FALSE,20,3547249,"F",28,20,"New York Knicks","Precious Achiuwa",0,15,17,8,11,19.8
0,0,0,0,0,0,0,0,0,"00",0,0,0,0,0,0,1038207,"2024-01-23T00:00:00.000Z",3,FALSE,20,19,"G",20,20,"New York Knicks","Ryan Arcidiacono",0,0,0,0,0,0
0,0,0,0,0,0,0,0,0,"00",0,0,0,0,0,0,1038207,"2024-01-23T00:00:00.000Z",3,FALSE,20,3547275,"G",28,20,"New York Knicks","Malachi Flynn",0,0,0,0,0,0
0,0,0,0,0,0,0,0,0,"00",0,0,0,0,0,0,1038207,"2024-01-23T00:00:00.000Z",3,FALSE,20,160,"G-F",20,20,"New York Knicks","Evan Fournier",0,0,0,0,0,0
2,0,1,4,1,5,2,0,0,"20",0,2,5,1,1,0,1038207,"2024-01-23T00:00:00.000Z",3,FALSE,20,17895858,"G",20,20,"New York Knicks","Quentin Grimes",1,6,8,7,3,12.2
1,1,4,3,0,7,1,0,0,"28",1,1,2,5,2,1,1038207,"2024-01-23T00:00:00.000Z",3,FALSE,20,202,"G",20,20,"New York Knicks","Josh Hart",3,7,8,3,6,17.5
0,0,0,0,0,0,0,0,0,"00",0,0,0,0,0,0,1038207,"2024-01-23T00:00:00.000Z",3,FALSE,20,56677722,"F",3,3,"Brooklyn Nets","Jalen Wilson",0,0,0,0,0,0
1,2,4,1,0,8,3,4,4,"33",1,2,10,5,4,3,1038207,"2024-01-23T00:00:00.000Z",3,FALSE,20,18,"F",28,20,"New York Knicks","OG Anunoby",6,15,16,11,6,32.5
7,0,7,2,2,19,10,8,8,"37",2,3,30,9,0,4,1038207,"2024-01-23T00:00:00.000Z",3,FALSE,20,387,"F",20,20,"New York Knicks","Julius Randle",0,39,46,37,16,47.3
2,4,2,0,0,4,3,0,0,"27",2,1,6,4,0,0,1038207,"2024-01-23T00:00:00.000Z",3,FALSE,20,17896063,"F",20,20,"New York Knicks","Jericho Sims",4,10,12,8,6,25.8
0,0,4,8,3,10,4,0,0,"25",1,0,11,5,1,3,1038207,"2024-01-23T00:00:00.000Z",3,FALSE,20,131,"G",20,20,"New York Knicks","Donte DiVincenzo",1,16,16,11,5,17
2,1,1,3,2,5,3,0,0,"12",0,1,8,1,0,0,1038207,"2024-01-23T00:00:00.000Z",3,FALSE,20,17896033,"G",20,20,"New York Knicks","Miles McBride",1,9,11,10,3,15.2
0,0,0,0,0,0,0,0,0,"00",0,0,0,0,0,0,1038207,"2024-01-23T00:00:00.000Z",3,FALSE,20,666474,"G",20,20,"New York Knicks","Charles Brown",0,0,0,0,0,0
0,0,0,0,0,0,0,0,0,"00",0,0,0,0,0,0,1038207,"2024-01-23T00:00:00.000Z",3,FALSE,20,201,"F-C",20,20,"New York Knicks","Isaiah Hartenstein",0,0,0,0,0,0
0,0,0,0,0,0,0,0,0,"00",0,0,0,0,0,0,1038207,"2024-01-23T00:00:00.000Z",3,FALSE,20,399,"C",20,20,"New York Knicks","Mitchell Robinson",0,0,0,0,0,0
0,0,0,0,0,0,0,0,0,"00",0,0,0,0,0,0,1038207,"2024-01-23T00:00:00.000Z",3,FALSE,20,56677795,"F",20,20,"New York Knicks","Jacob Toppin",0,0,0,0,0,0
0,0,0,0,0,0,0,0,0,"00",0,0,0,0,0,0,1038207,"2024-01-23T00:00:00.000Z",3,FALSE,20,17896089,"G",20,20,"New York Knicks","Duane Washington Jr.",0,0,0,0,0,0
4,0,4,10,5,23,12,6,5,"33",0,1,34,4,0,2,1038211,"2024-01-24T00:00:00.000Z",9,FALSE,4,54,"F",9,9,"Detroit Pistons","Bojan Bogdanovic",0,38,42,38,8,42.8
2,0,7,2,1,8,4,4,2,"34",1,3,11,8,1,2,1038211,"2024-01-24T00:00:00.000Z",9,FALSE,4,3547267,"F-C",9,9,"Detroit Pistons","Isaiah Stewart",1,19,21,13,10,24.6
2,0,6,0,0,9,7,1,0,"22",2,3,14,8,0,1,1038211,"2024-01-24T00:00:00.000Z",9,FALSE,4,38017694,"C",9,9,"Detroit Pistons","Jalen Duren",0,22,24,16,10,25.6
2,0,1,3,1,10,4,0,0,"22",0,2,9,1,1,2,1038211,"2024-01-24T00:00:00.000Z",9,FALSE,4,38017682,"G",9,9,"Detroit Pistons","Jaden Ivey",1,10,12,11,3,14.2
8,0,7,2,1,3,2,3,1,"27",0,1,6,7,0,1,1038211,"2024-01-24T00:00:00.000Z",9,FALSE,4,3547241,"G",9,9,"Detroit Pistons","Killian Hayes",0,13,21,14,15,25.4
1,0,0,9,4,11,4,4,3,"26",0,1,15,0,0,0,1038211,"2024-01-24T00:00:00.000Z",9,FALSE,4,77,"G",9,9,"Detroit Pistons","Alec Burks",0,15,16,16,1,16.5
0,0,0,0,0,0,0,0,0,"00",0,0,0,0,0,0,1038211,"2024-01-24T00:00:00.000Z",9,FALSE,4,167,"F",30,9,"Detroit Pistons","Danilo Gallinari",0,0,0,0,0,0
0,0,0,0,0,0,0,0,0,"00",0,0,0,0,0,0,1038211,"2024-01-24T00:00:00.000Z",9,FALSE,4,197,"F-G",9,9,"Detroit Pistons","Joe Harris",0,0,0,0,0,0
0,0,4,2,0,4,0,0,0,"13",0,0,0,4,0,0,1038211,"2024-01-24T00:00:00.000Z",9,FALSE,4,259,"F",9,9,"Detroit Pistons","Kevin Knox",0,4,4,0,4,4.8
3,0,3,1,1,4,3,0,0,"11",0,0,7,3,0,0,1038211,"2024-01-24T00:00:00.000Z",9,FALSE,4,330,"G",9,9,"Detroit Pistons","Monte Morris",0,10,13,10,6,15.1
1,0,3,4,1,5,2,0,0,"13",2,1,5,5,0,0,1038211,"2024-01-24T00:00:00.000Z",9,FALSE,4,337,"F-C",30,9,"Detroit Pistons","Mike Muscala",0,10,11,6,6,12.5
2,0,2,4,1,5,2,0,0,"12",0,1,5,2,0,1,1038211,"2024-01-24T00:00:00.000Z",9,FALSE,4,56677792,"G",9,9,"Detroit Pistons","Marcus Sasser",0,7,9,7,4,9.4
1,0,2,1,0,4,3,2,1,"27",0,4,7,2,2,2,1038211,"2024-01-24T00:00:00.000Z",9,FALSE,4,56677826,"G-F",9,9,"Detroit Pistons","Ausar Thompson",2,9,10,8,3,14.9
0,0,0,0,0,0,0,0,0,"00",0,0,0,0,0,0,1038211,"2024-01-24T00:00:00.000Z",9,FALSE,4,3547240,"C",9,9,"Detroit Pistons","James Wiseman",0,0,0,0,0,0
0,0,0,0,0,0,0,0,0,"00",0,0,0,0,0,0,1038211,"2024-01-24T00:00:00.000Z",9,FALSE,4,56677729,"G",9,9,"Detroit Pistons","Malcolm Cazalon",0,0,0,0,0,0
0,0,0,0,0,0,0,0,0,"00",0,0,0,0,0,0,1038211,"2024-01-24T00:00:00.000Z",9,FALSE,4,17896075,"G-F",9,9,"Detroit Pistons","Cade Cunningham",0,0,0,0,0,0
0,0,0,0,0,0,0,0,0,"00",0,0,0,0,0,0,1038211,"2024-01-24T00:00:00.000Z",9,FALSE,4,42097199,"G",9,9,"Detroit Pistons","Jared Rhoden",0,0,0,0,0,0
0,0,0,0,0,0,0,0,0,"00",0,0,0,0,0,0,1038211,"2024-01-24T00:00:00.000Z",9,FALSE,4,44477024,"G",9,9,"Detroit Pistons","Stanley Umude",0,0,0,0,0,0
0,0,0,1,0,1,0,0,0,"09",0,1,0,0,0,0,1038211,"2024-01-24T00:00:00.000Z",9,FALSE,4,347,"G",4,4,"Charlotte Hornets","Frank Ntilikina",0,0,0,0,0,0
5,0,3,0,0,1,1,0,0,"13",1,0,2,4,0,0,1038211,"2024-01-24T00:00:00.000Z",9,FALSE,4,422,"G",4,4,"Charlotte Hornets","Ish Smith",0,6,11,7,9,14.3
1,0,0,1,1,2,1,0,0,"17",0,0,3,0,0,0,1038211,"2024-01-24T00:00:00.000Z",9,FALSE,4,56677846,"G",4,4,"Charlotte Hornets","Nick Smith Jr.",0,3,4,4,1,4.5
0,0,0,0,0,0,0,0,0,"00",0,0,0,0,0,0,1038211,"2024-01-24T00:00:00.000Z",9,FALSE,4,18678001,"F",4,4,"Charlotte Hornets","JT Thor",0,0,0,0,0,0
5,1,6,6,4,6,4,0,0,"28",0,4,12,6,1,2,1038211,"2024-01-24T00:00:00.000Z",9,FALSE,4,666950,"F",4,4,"Charlotte Hornets","P.J. Washington",2,18,23,17,11,30.7
0,0,0,0,0,0,0,0,0,"00",0,0,0,0,0,0,1038211,"2024-01-24T00:00:00.000Z",9,FALSE,4,56677848,"G",4,4,"Charlotte Hornets","Amari Bailey",0,0,0,0,0,0
0,0,0,0,0,0,0,0,0,"00",0,0,0,0,0,0,1038211,"2024-01-24T00:00:00.000Z",9,FALSE,4,204,"F",4,4,"Charlotte Hornets","Gordon Hayward",0,0,0,0,0,0
3,0,2,2,0,4,1,4,3,"25",1,2,5,3,1,0,1038211,"2024-01-24T00:00:00.000Z",9,FALSE,4,666748,"F",4,4,"Charlotte Hornets","Cody Martin",1,8,11,8,6,16.1
2,0,10,9,3,21,7,4,3,"41",0,1,20,10,2,3,1038211,"2024-01-24T00:00:00.000Z",9,FALSE,4,62,"F",4,4,"Charlotte Hornets","Miles Bridges",2,30,32,22,12,38
0,1,5,0,0,13,9,4,3,"27",5,1,21,10,0,0,1038211,"2024-01-24T00:00:00.000Z",9,FALSE,4,3547282,"C",4,4,"Charlotte Hornets","Nick Richards",1,31,31,21,10,36
4,1,6,10,5,17,8,3,2,"39",1,4,23,7,0,2,1038211,"2024-01-24T00:00:00.000Z",9,FALSE,4,56677823,"F",4,4,"Charlotte Hornets","Brandon Miller",1,30,34,27,11,38.4
7,0,3,8,1,21,6,4,4,"31",1,6,17,4,1,4,1038211,"2024-01-24T00:00:00.000Z",9,FALSE,4,3547239,"G",4,4,"Charlotte Hornets","LaMelo Ball",1,21,28,24,11,31.3
0,0,2,1,1,1,1,0,0,"03",0,0,3,2,0,0,1038211,"2024-01-24T00:00:00.000Z",9,FALSE,4,56677866,"F",4,4,"Charlotte Hornets","Leaky Black",0,5,5,3,2,5.4
0,0,0,0,0,0,0,0,0,"00",0,0,0,0,0,0,1038211,"2024-01-24T00:00:00.000Z",9,FALSE,4,17896037,"G",4,4,"Charlotte Hornets","James Bouknight",0,0,0,0,0,0
0,0,0,0,0,0,0,0,0,"00",0,0,0,0,0,0,1038211,"2024-01-24T00:00:00.000Z",9,FALSE,4,38017708,"G",4,4,"Charlotte Hornets","Bryce McGowens",0,0,0,0,0,0
0,1,2,0,0,0,0,0,0,"07",0,3,0,2,0,0,1038211,"2024-01-24T00:00:00.000Z",9,FALSE,4,NA,NA,NA,4,"Charlotte Hornets","NA NA",1,2,2,0,2,5.4
0,0,0,0,0,0,0,0,0,"00",0,0,0,0,0,0,1038211,"2024-01-24T00:00:00.000Z",9,FALSE,4,286,"G",16,4,"Charlotte Hornets","Kyle Lowry",0,0,0,0,0,0
0,0,0,0,0,0,0,0,0,"00",0,0,0,0,0,0,1038211,"2024-01-24T00:00:00.000Z",9,FALSE,4,38017698,"C",4,4,"Charlotte Hornets","Mark Williams",0,0,0,0,0,0
6,0,6,5,4,12,7,6,6,"38",0,3,24,6,0,2,1038212,"2024-01-24T00:00:00.000Z",30,FALSE,18,3547242,"F",30,30,"Washington Wizards","Deni Avdija",0,30,36,30,12,38.2
8,1,14,8,3,11,5,4,4,"35",0,4,17,14,0,5,1038212,"2024-01-24T00:00:00.000Z",30,FALSE,18,265,"F",30,30,"Washington Wizards","Kyle Kuzma",1,31,39,25,22,43.8
1,2,3,0,0,5,5,0,0,"21",1,6,10,4,1,2,1038212,"2024-01-24T00:00:00.000Z",30,FALSE,18,666577,"F",30,30,"Washington Wizards","Daniel Gafford",3,14,15,11,5,23.3
3,0,2,4,1,11,2,2,2,"28",0,3,7,2,0,4,1038212,"2024-01-24T00:00:00.000Z",30,FALSE,18,666848,"G",30,30,"Washington Wizards","Jordan Poole",0,9,12,10,5,9.9
6,0,2,2,0,7,2,2,1,"32",0,1,5,2,0,0,1038212,"2024-01-24T00:00:00.000Z",30,FALSE,18,249,"G",30,30,"Washington Wizards","Tyus Jones",0,7,13,11,8,16.4
0,0,9,0,0,8,7,8,3,"26",6,3,17,15,1,1,1038212,"2024-01-24T00:00:00.000Z",30,FALSE,18,24,"F",9,30,"Washington Wizards","Marvin Bagley III",1,32,32,17,15,37
0,0,1,1,1,1,1,0,0,"01",0,0,3,1,0,0,1038212,"2024-01-24T00:00:00.000Z",30,FALSE,18,38017704,"F",30,30,"Washington Wizards","Patrick Baldwin Jr.",0,4,4,3,1,4.2
1,0,0,3,0,7,2,0,0,"20",0,1,4,0,0,3,1038212,"2024-01-24T00:00:00.000Z",30,FALSE,18,56677844,"G",30,30,"Washington Wizards","Bilal Coulibaly",0,4,5,5,1,2.5
1,0,0,0,0,0,0,0,0,"01",0,0,0,0,0,0,1038212,"2024-01-24T00:00:00.000Z",30,FALSE,18,3547302,"F",30,30,"Washington Wizards","Anthony Gill",0,0,1,1,1,1.5
0,0,0,0,0,0,0,0,0,"01",0,0,0,0,0,1,1038212,"2024-01-24T00:00:00.000Z",30,FALSE,18,NA,NA,NA,30,"Washington Wizards","NA NA",0,0,0,0,0,-1
0,0,4,0,0,6,3,1,1,"16",0,0,7,4,0,3,1038212,"2024-01-24T00:00:00.000Z",30,FALSE,18,17896045,"F",30,30,"Washington Wizards","Corey Kispert",0,11,11,7,4,8.8
2,0,1,1,1,3,1,6,6,"12",0,0,9,1,0,0,1038212,"2024-01-24T00:00:00.000Z",30,FALSE,18,414,"G",30,30,"Washington Wizards","Landry Shamet",0,10,12,11,3,13.2
3,0,0,0,0,6,2,0,0,"09",0,1,4,0,0,0,1038212,"2024-01-24T00:00:00.000Z",30,FALSE,18,487,"G",30,30,"Washington Wizards","Delon Wright",0,4,7,7,3,8.5
0,0,0,0,0,0,0,0,0,"00",0,0,0,0,0,0,1038212,"2024-01-24T00:00:00.000Z",30,FALSE,18,NA,NA,NA,30,"Washington Wizards","NA NA",0,0,0,0,0,0
0,0,0,0,0,0,0,0,0,"00",0,0,0,0,0,0,1038212,"2024-01-24T00:00:00.000Z",30,FALSE,18,17896106,"F",30,30,"Washington Wizards","Eugene Omoruyi",0,0,0,0,0,0
0,0,3,4,1,11,5,2,2,"30",2,4,13,5,2,1,1038212,"2024-01-24T00:00:00.000Z",30,FALSE,18,3547259,"F",18,18,"Minnesota Timberwolves","Jaden McDaniels",2,18,18,13,5,24
3,1,6,10,2,24,11,3,3,"34",0,4,27,6,0,1,1038212,"2024-01-24T00:00:00.000Z",30,FALSE,18,447,"C",18,18,"Minnesota Timberwolves","Karl-Anthony Towns",1,33,36,30,9,40.7
1,4,9,0,0,11,7,6,5,"35",7,4,19,16,0,0,1038212,"2024-01-24T00:00:00.000Z",30,FALSE,18,176,"C",18,18,"Minnesota Timberwolves","Rudy Gobert",4,35,36,20,17,51.7
5,0,2,10,3,28,11,14,13,"34",1,4,38,3,1,4,1038212,"2024-01-24T00:00:00.000Z",30,FALSE,18,3547238,"G",18,18,"Minnesota Timberwolves","Anthony Edwards",1,41,46,43,8,48.1
5,0,4,3,1,4,2,2,1,"31",1,2,6,5,1,0,1038212,"2024-01-24T00:00:00.000Z",30,FALSE,18,666400,"G",18,18,"Minnesota Timberwolves","Nickeil Alexander-Walker",1,11,16,11,10,22.5
2,0,1,1,1,4,2,0,0,"13",1,1,5,2,1,0,1038212,"2024-01-24T00:00:00.000Z",30,FALSE,18,666767,"G",18,18,"Minnesota Timberwolves","Jordan McLaughlin",1,7,9,7,4,13.4
3,1,1,1,0,5,1,0,0,"18",2,1,2,3,1,1,1038212,"2024-01-24T00:00:00.000Z",30,FALSE,18,320,"G",18,18,"Minnesota Timberwolves","Shake Milton",2,5,8,5,6,15.1
0,0,0,0,0,0,0,0,0,"01",0,0,0,0,1,0,1038212,"2024-01-24T00:00:00.000Z",30,FALSE,18,38017700,"G",18,18,"Minnesota Timberwolves","Wendell Moore Jr.",1,0,0,0,0,3
2,1,3,3,1,9,2,0,0,"21",0,1,5,3,1,0,1038212,"2024-01-24T00:00:00.000Z",30,FALSE,18,667378,"F-C",18,18,"Minnesota Timberwolves","Naz Reid",2,8,10,7,5,17.6
0,0,0,0,0,0,0,0,0,"00",0,0,0,0,0,0,1038212,"2024-01-24T00:00:00.000Z",30,FALSE,18,56677851,"G",18,18,"Minnesota Timberwolves","Jaylen Clark",0,0,0,0,0,0
0,0,0,0,0,0,0,0,0,"00",0,0,0,0,0,0,1038212,"2024-01-24T00:00:00.000Z",30,FALSE,18,104,"G",18,18,"Minnesota Timberwolves","Mike Conley",0,0,0,0,0,0
0,0,0,0,0,0,0,0,0,"00",0,0,0,0,0,0,1038212,"2024-01-24T00:00:00.000Z",30,FALSE,18,56677782,"F",18,18,"Minnesota Timberwolves","Leonard Miller",0,0,0,0,0,0
0,0,0,0,0,0,0,0,0,"00",0,0,0,0,0,0,1038212,"2024-01-24T00:00:00.000Z",30,FALSE,18,38017715,"F",18,18,"Minnesota Timberwolves","Josh Minott",0,0,0,0,0,0
0,0,0,0,0,0,0,0,0,"00",0,0,0,0,0,0,1038212,"2024-01-24T00:00:00.000Z",30,FALSE,18,17895968,"F",18,18,"Minnesota Timberwolves","Daishen Nix",0,0,0,0,0,0
0,0,0,0,0,0,0,0,0,"00",0,0,0,0,0,0,1038212,"2024-01-24T00:00:00.000Z",30,FALSE,18,18677954,"G",30,30,"Washington Wizards","Jared Butler",0,0,0,0,0,0
0,0,0,0,0,0,0,0,0,"00",0,0,0,0,0,0,1038212,"2024-01-24T00:00:00.000Z",30,FALSE,18,38017687,"G",30,30,"Washington Wizards","Johnny Davis",0,0,0,0,0,0
0,0,0,0,0,0,0,0,0,"00",0,0,0,0,0,0,1038212,"2024-01-24T00:00:00.000Z",30,FALSE,18,17896071,"F",9,30,"Washington Wizards","Isaiah Livers",0,0,0,0,0,0
5,0,4,0,0,4,1,2,1,"22",1,1,3,5,0,0,1038212,"2024-01-24T00:00:00.000Z",30,FALSE,18,12,"F",18,18,"Minnesota Timberwolves","Kyle Anderson",0,8,13,8,10,16.5
0,0,0,0,0,0,0,0,0,"00",0,0,0,0,0,0,1038212,"2024-01-24T00:00:00.000Z",30,FALSE,18,68,"F",18,18,"Minnesota Timberwolves","Troy Brown Jr.",0,0,0,0,0,0
0,0,0,0,0,0,0,0,0,"01",0,0,0,0,0,0,1038212,"2024-01-24T00:00:00.000Z",30,FALSE,18,17896056,"C",18,18,"Minnesota Timberwolves","Luka Garza",0,0,0,0,0,0
3,0,1,2,1,10,4,8,6,"35",3,1,15,4,2,4,1038213,"2024-01-24T00:00:00.000Z",16,FALSE,15,79,"G-F",16,16,"Miami Heat","Jimmy Butler",2,19,22,18,7,26.3
1,1,3,4,2,6,3,0,0,"24",1,1,8,4,2,1,1038213,"2024-01-24T00:00:00.000Z",16,FALSE,15,3092,"",16,16,"Miami Heat","Haywood Highsmith",3,12,13,9,5,22.3
6,6,12,1,0,13,4,11,7,"39",3,3,15,15,1,0,1038213,"2024-01-24T00:00:00.000Z",16,FALSE,15,4,"C-F",16,16,"Miami Heat","Bam Adebayo",7,30,36,21,21,63
2,1,3,4,1,7,4,0,0,"18",0,2,9,3,0,1,1038213,"2024-01-24T00:00:00.000Z",16,FALSE,15,391,"G-F",16,16,"Miami Heat","Josh Richardson",1,12,14,11,5,17.6
3,0,6,6,2,15,8,0,0,"38",0,1,18,6,0,4,1038213,"2024-01-24T00:00:00.000Z",16,FALSE,15,666633,"G",16,16,"Miami Heat","Tyler Herro",0,24,27,21,9,25.7
0,0,0,0,0,0,0,0,0,"07",0,1,0,0,0,0,1038213,"2024-01-24T00:00:00.000Z",16,FALSE,15,74,"C",16,16,"Miami Heat","Thomas Bryant",0,0,0,0,0,0
0,0,0,0,0,0,0,0,0,"00",0,0,0,0,0,0,1038213,"2024-01-24T00:00:00.000Z",16,FALSE,15,3547257,"G",16,16,"Miami Heat","R.J. Hampton",0,0,0,0,0,0
0,0,0,0,0,0,0,0,0,"00",0,0,0,0,0,0,1038213,"2024-01-24T00:00:00.000Z",16,FALSE,15,38017696,"F",16,16,"Miami Heat","Nikola Jovic",0,0,0,0,0,0
0,0,1,2,0,3,0,0,0,"05",0,0,0,1,0,0,1038213,"2024-01-24T00:00:00.000Z",16,FALSE,15,285,"F-C",16,16,"Miami Heat","Kevin Love",0,1,1,0,1,1.2
1,1,2,4,3,8,4,4,4,"29",2,2,15,4,2,2,1038213,"2024-01-24T00:00:00.000Z",16,FALSE,15,666747,"F",16,16,"Miami Heat","Caleb Martin",3,19,20,16,5,28.3
0,0,3,5,1,9,3,0,0,"16",0,4,7,3,0,2,1038213,"2024-01-24T00:00:00.000Z",16,FALSE,15,397,"F",16,16,"Miami Heat","Duncan Robinson",0,10,10,7,3,8.6
0,0,0,0,0,0,0,0,0,"00",0,0,0,0,0,0,1038213,"2024-01-24T00:00:00.000Z",16,FALSE,15,39398582,"C",16,16,"Miami Heat","Orlando Robinson",0,0,0,0,0,0
5,0,2,5,1,11,3,2,2,"29",2,2,9,4,2,3,1038213,"2024-01-24T00:00:00.000Z",16,FALSE,15,403,"G",4,16,"Miami Heat","Terry Rozier",2,13,18,14,9,24.3
0,0,0,0,0,0,0,0,0,"00",0,0,0,0,0,0,1038213,"2024-01-24T00:00:00.000Z",16,FALSE,15,38017734,"F",16,16,"Miami Heat","Jamal Cain",0,0,0,0,0,0
0,0,0,0,0,0,0,0,0,"00",0,0,0,0,0,0,1038213,"2024-01-24T00:00:00.000Z",16,FALSE,15,56677785,"G",16,16,"Miami Heat","Jaime Jaquez Jr.",0,0,0,0,0,0
0,0,0,0,0,0,0,0,0,"00",0,0,0,0,0,0,1038213,"2024-01-24T00:00:00.000Z",16,FALSE,15,19465585,"G",16,16,"Miami Heat","Dru Smith",0,0,0,0,0,0
0,0,0,0,0,0,0,0,0,"00",0,0,0,0,0,0,1038213,"2024-01-24T00:00:00.000Z",16,FALSE,15,38017736,"F",16,16,"Miami Heat","Cole Swider",0,0,0,0,0,0
4,0,5,6,5,10,8,4,4,"33",0,3,25,5,1,1,1038213,"2024-01-24T00:00:00.000Z",16,FALSE,15,38017731,"G",15,15,"Memphis Grizzlies","Vince Williams Jr.",1,30,34,29,9,39
4,1,1,4,2,11,4,0,0,"32",2,2,10,3,2,3,1038213,"2024-01-24T00:00:00.000Z",16,FALSE,15,38017729,"F",15,15,"Memphis Grizzlies","David Roddy",3,13,17,14,7,25.6
3,1,6,7,1,21,5,5,4,"35",0,1,15,6,1,5,1038213,"2024-01-24T00:00:00.000Z",16,FALSE,15,231,"F-C",15,15,"Memphis Grizzlies","Jaren Jackson Jr.",2,21,24,18,9,27.7
7,0,0,4,2,5,2,0,0,"24",0,1,6,0,1,2,1038213,"2024-01-24T00:00:00.000Z",16,FALSE,15,48248287,"G",15,15,"Memphis Grizzlies","Jacob Gilyard",1,6,13,13,7,17.5
2,1,7,3,1,7,5,0,0,"31",3,4,11,10,1,2,1038213,"2024-01-24T00:00:00.000Z",16,FALSE,15,666703,"G-F",15,15,"Memphis Grizzlies","John Konchar",2,21,23,13,12,30
0,0,0,0,0,0,0,0,0,"00",0,0,0,0,0,0,1038213,"2024-01-24T00:00:00.000Z",16,FALSE,15,17896067,"F",15,15,"Memphis Grizzlies","Santi Aldama",0,0,0,0,0,0
2,0,4,6,4,9,5,4,3,"26",0,3,17,4,0,1,1038213,"2024-01-24T00:00:00.000Z",16,FALSE,15,56677830,"F",15,15,"Memphis Grizzlies","GG Jackson",0,21,23,19,6,23.8
0,0,0,0,0,0,0,0,0,"00",0,0,0,0,0,0,1038213,"2024-01-24T00:00:00.000Z",16,FALSE,15,38017728,"F",15,15,"Memphis Grizzlies","Jake LaRavia",0,0,0,0,0,0
6,0,6,1,1,7,5,4,4,"24",0,1,15,6,0,2,1038213,"2024-01-24T00:00:00.000Z",16,FALSE,15,38017656,"G",14,15,"Memphis Grizzlies","Scotty Pippen Jr.",0,21,27,21,12,29.2
0,0,0,0,0,0,0,0,0,"00",0,0,0,0,0,0,1038213,"2024-01-24T00:00:00.000Z",16,FALSE,15,401,"G",15,15,"Memphis Grizzlies","Derrick Rose",0,0,0,0,0,0
1,3,3,1,1,2,2,2,1,"18",1,3,6,4,1,1,1038213,"2024-01-24T00:00:00.000Z",16,FALSE,15,3547285,"F",15,15,"Memphis Grizzlies","Xavier Tillman",4,10,11,7,5,23.3
1,0,5,4,0,8,0,0,0,"17",1,1,0,6,1,1,1038213,"2024-01-24T00:00:00.000Z",16,FALSE,15,17896027,"G-F",15,15,"Memphis Grizzlies","Ziaire Williams",1,6,7,1,7,10.7
0,0,0,0,0,0,0,0,0,"00",0,0,0,0,0,0,1038213,"2024-01-24T00:00:00.000Z",16,FALSE,15,3,"C",15,15,"Memphis Grizzlies","Steven Adams",0,0,0,0,0,0
0,0,0,0,0,0,0,0,0,"00",0,0,0,0,0,0,1038213,"2024-01-24T00:00:00.000Z",16,FALSE,15,3547287,"G",15,15,"Memphis Grizzlies","Desmond Bane",0,0,0,0,0,0
0,0,0,0,0,0,0,0,0,"00",0,0,0,0,0,0,1038213,"2024-01-24T00:00:00.000Z",16,FALSE,15,666505,"F",15,15,"Memphis Grizzlies","Brandon Clarke",0,0,0,0,0,0
0,0,0,0,0,0,0,0,0,"00",0,0,0,0,0,0,1038213,"2024-01-24T00:00:00.000Z",16,FALSE,15,254,"G",15,15,"Memphis Grizzlies","Luke Kennard",0,0,0,0,0,0
0,0,0,0,0,0,0,0,0,"00",0,0,0,0,0,0,1038213,"2024-01-24T00:00:00.000Z",16,FALSE,15,666786,"G",15,15,"Memphis Grizzlies","Ja Morant",0,0,0,0,0,0
0,0,0,0,0,0,0,0,0,"00",0,0,0,0,0,0,1038213,"2024-01-24T00:00:00.000Z",16,FALSE,15,420,"G",15,15,"Memphis Grizzlies","Marcus Smart",0,0,0,0,0,0
1,0,2,5,1,5,1,0,0,"21",0,1,3,2,2,2,1038214,"2024-01-24T00:00:00.000Z",27,FALSE,21,38017649,"F",27,27,"San Antonio Spurs","Julian Champagnie",2,5,6,4,3,10.9
4,0,3,3,0,7,1,0,0,"24",2,3,2,5,0,2,1038214,"2024-01-24T00:00:00.000Z",27,FALSE,21,38017699,"F",27,27,"San Antonio Spurs","Jeremy Sochan",0,7,11,6,9,12
4,4,6,3,0,18,9,8,6,"28",6,2,24,12,1,3,1038214,"2024-01-24T00:00:00.000Z",27,FALSE,21,56677822,"F-C",27,27,"San Antonio Spurs","Victor Wembanyama",5,36,40,28,16,56.4
7,1,4,4,1,14,9,2,2,"34",1,1,21,5,0,0,1038214,"2024-01-24T00:00:00.000Z",27,FALSE,21,3547246,"G-F",27,27,"San Antonio Spurs","Devin Vassell",1,26,33,28,12,40.5
6,1,3,1,1,5,5,3,1,"28",1,4,12,4,0,4,1038214,"2024-01-24T00:00:00.000Z",27,FALSE,21,38017693,"G",27,27,"San Antonio Spurs","Blake Wesley",1,16,22,18,10,24.8
2,1,3,2,1,5,3,4,4,"28",0,1,11,3,2,0,1038214,"2024-01-24T00:00:00.000Z",27,FALSE,21,38017692,"F",27,27,"San Antonio Spurs","Malaki Branham",3,14,16,13,5,26.6
2,2,1,2,1,8,3,4,3,"17",2,1,10,3,1,2,1038214,"2024-01-24T00:00:00.000Z",27,FALSE,21,102,"F-C",27,27,"San Antonio Spurs","Zach Collins",3,13,15,12,5,23.6
0,0,2,2,1,2,1,0,0,"05",0,0,3,2,0,0,1038214,"2024-01-24T00:00:00.000Z",27,FALSE,21,180,"G",27,27,"San Antonio Spurs","Devonte' Graham",0,5,5,3,2,5.4
1,1,0,2,0,8,3,1,1,"19",0,0,7,0,1,2,1038214,"2024-01-24T00:00:00.000Z",27,FALSE,21,666682,"F",27,27,"San Antonio Spurs","Keldon Johnson",2,7,8,8,1,12.5
0,0,1,1,0,3,2,0,0,"05",0,0,4,1,0,0,1038214,"2024-01-24T00:00:00.000Z",27,FALSE,21,17896059,"F",27,27,"San Antonio Spurs","Sandro Mamukelashvili",0,5,5,4,1,5.2
3,0,1,4,2,6,3,0,0,"17",0,1,8,1,0,3,1038214,"2024-01-24T00:00:00.000Z",27,FALSE,21,305,"F",27,27,"San Antonio Spurs","Doug McDermott",0,9,12,11,4,10.7
0,1,0,3,1,5,3,3,2,"14",0,0,9,0,0,0,1038214,"2024-01-24T00:00:00.000Z",27,FALSE,21,359,"F",27,27,"San Antonio Spurs","Cedi Osman",1,9,9,9,0,12
0,0,0,0,0,0,0,0,0,"00",0,0,0,0,0,0,1038214,"2024-01-24T00:00:00.000Z",27,FALSE,21,38017730,"F",27,27,"San Antonio Spurs","Dominick Barlow",0,0,0,0,0,0
0,0,0,0,0,0,0,0,0,"00",0,0,0,0,0,0,1038214,"2024-01-24T00:00:00.000Z",27,FALSE,21,17895854,"G",27,27,"San Antonio Spurs","Charles Bassey",0,0,0,0,0,0
0,0,0,0,0,0,0,0,0,"00",0,0,0,0,0,0,1038214,"2024-01-24T00:00:00.000Z",27,FALSE,21,56677817,"G",27,27,"San Antonio Spurs","Sidy Cissoko",0,0,0,0,0,0
0,0,0,0,0,0,0,0,0,"00",0,0,0,0,0,0,1038214,"2024-01-24T00:00:00.000Z",27,FALSE,21,3547163,"F",6,27,"San Antonio Spurs","Mamadi Diakite",0,0,0,0,0,0
0,0,0,0,0,0,0,0,0,"00",0,0,0,0,0,0,1038214,"2024-01-24T00:00:00.000Z",27,FALSE,21,17896049,"G",3,27,"San Antonio Spurs","David Duke Jr.",0,0,0,0,0,0
0,0,0,0,0,0,0,0,0,"00",0,0,0,0,0,0,1038214,"2024-01-24T00:00:00.000Z",27,FALSE,21,3547274,"G",27,27,"San Antonio Spurs","Tre Jones",0,0,0,0,0,0
1,1,2,5,0,6,1,0,0,"25",1,2,2,3,2,1,1038214,"2024-01-24T00:00:00.000Z",27,FALSE,21,666541,"G",21,21,"Oklahoma City Thunder","Luguentz Dort",3,5,6,3,4,15.1
7,0,5,5,1,12,6,0,0,"29",0,3,13,5,2,0,1038214,"2024-01-24T00:00:00.000Z",27,FALSE,21,38017703,"G-F",21,21,"Oklahoma City Thunder","Jalen Williams",2,18,25,20,12,35.5
3,3,5,4,2,13,7,3,1,"30",4,3,17,9,1,3,1038214,"2024-01-24T00:00:00.000Z",27,FALSE,21,38017685,"C-F",21,21,"Oklahoma City Thunder","Chet Holmgren",4,26,29,20,12,41.3
4,0,3,3,0,13,6,0,0,"22",5,1,12,8,0,2,1038214,"2024-01-24T00:00:00.000Z",27,FALSE,21,17896065,"G",21,21,"Oklahoma City Thunder","Josh Giddey",0,20,24,16,12,25.6
1,0,0,0,0,2,0,0,0,"05",0,0,0,0,0,1,1038214,"2024-01-24T00:00:00.000Z",27,FALSE,21,56677853,"F",21,21,"Oklahoma City Thunder","Keyontae Johnson",0,0,1,1,1,0.5
3,0,1,1,0,2,1,0,0,"14",0,0,2,1,1,3,1038214,"2024-01-24T00:00:00.000Z",27,FALSE,21,4197029,"G",21,21,"Oklahoma City Thunder","Vasilije Micic",1,3,6,5,4,7.7
0,0,1,1,0,2,1,0,0,"05",0,0,2,1,0,0,1038214,"2024-01-24T00:00:00.000Z",27,FALSE,21,3547271,"C",21,21,"Oklahoma City Thunder","Aleksej Pokusevski",0,3,3,2,1,3.2
4,0,2,3,2,7,5,1,1,"23",1,4,13,3,1,0,1038214,"2024-01-24T00:00:00.000Z",27,FALSE,21,56677833,"G",21,21,"Oklahoma City Thunder","Cason Wallace",1,16,20,17,7,25.6
10,1,4,2,2,15,9,12,12,"29",2,3,32,6,2,4,1038214,"2024-01-24T00:00:00.000Z",27,FALSE,21,175,"G",21,21,"Oklahoma City Thunder","Shai Gilgeous-Alexander",3,38,48,42,16,59.2
1,0,0,1,1,1,1,0,0,"05",0,0,3,0,1,0,1038214,"2024-01-24T00:00:00.000Z",27,FALSE,21,44,"F",21,21,"Oklahoma City Thunder","Davis Bertans",1,3,4,4,1,7.5
0,1,0,5,3,5,3,0,0,"13",1,0,9,1,0,0,1038214,"2024-01-24T00:00:00.000Z",27,FALSE,21,3547272,"G",21,21,"Oklahoma City Thunder","Isaiah Joe",1,10,10,9,1,13.2
1,1,3,6,4,11,9,0,0,"19",0,1,22,3,0,0,1038214,"2024-01-24T00:00:00.000Z",27,FALSE,21,17896078,"G",21,21,"Oklahoma City Thunder","Aaron Wiggins",1,25,26,23,4,30.1
0,0,3,2,2,3,2,0,0,"11",1,2,6,4,0,1,1038214,"2024-01-24T00:00:00.000Z",27,FALSE,21,38017706,"F",21,21,"Oklahoma City Thunder","Jaylin Williams",0,10,10,6,4,9.8
0,1,2,2,1,4,3,0,0,"10",1,1,7,3,1,0,1038214,"2024-01-24T00:00:00.000Z",27,FALSE,21,480,"G-F",21,21,"Oklahoma City Thunder","Kenrich Williams",2,10,10,7,3,16.6
0,0,0,0,0,0,0,0,0,"00",0,0,0,0,0,0,1038214,"2024-01-24T00:00:00.000Z",27,FALSE,21,38017716,"F",21,21,"Oklahoma City Thunder","Ousmane Dieng",0,0,0,0,0,0
0,0,0,0,0,0,0,0,0,"00",0,0,0,0,0,0,1038214,"2024-01-24T00:00:00.000Z",27,FALSE,21,17896036,"G",21,21,"Oklahoma City Thunder","Tre Mann",0,0,0,0,0,0
0,0,0,0,0,0,0,0,0,"00",0,0,0,0,0,0,1038214,"2024-01-24T00:00:00.000Z",27,FALSE,21,24572055,"C",21,21,"Oklahoma City Thunder","Olivier Sarr",0,0,0,0,0,0
0,0,0,0,0,0,0,0,0,"00",0,0,0,0,0,0,1038214,"2024-01-24T00:00:00.000Z",27,FALSE,21,27924547,"F",21,21,"Oklahoma City Thunder","Lindy Waters III",0,0,0,0,0,0
4,0,4,6,3,11,5,1,1,"32",0,3,14,4,0,3,1038215,"2024-01-24T00:00:00.000Z",11,FALSE,25,66,"G-F",11,11,"Houston Rockets","Dillon Brooks",0,18,22,18,8,21.8
1,1,4,2,0,4,2,0,0,"38",0,2,4,4,2,0,1038215,"2024-01-24T00:00:00.000Z",11,FALSE,25,188,"F",11,11,"Houston Rockets","Jeff Green",3,8,9,5,5,19.3
8,0,6,2,1,17,11,8,7,"39",4,5,30,10,1,2,1038215,"2024-01-24T00:00:00.000Z",11,FALSE,25,17896062,"F-C",11,11,"Houston Rockets","Alperen Sengun",1,40,48,38,18,55
3,1,0,7,2,24,12,4,3,"39",0,1,29,0,1,1,1038215,"2024-01-24T00:00:00.000Z",11,FALSE,25,17895966,"G",11,11,"Houston Rockets","Jalen Green",2,29,32,32,3,38.5
7,3,6,10,2,17,8,0,0,"46",0,1,18,6,3,2,1038215,"2024-01-24T00:00:00.000Z",11,FALSE,25,458,"G",11,11,"Houston Rockets","Fred VanVleet",6,24,31,25,13,51.7
0,0,0,0,0,0,0,0,0,"00",0,0,0,0,0,0,1038215,"2024-01-24T00:00:00.000Z",11,FALSE,25,3547281,"G-F",11,11,"Houston Rockets","Nate Hinton",0,0,0,0,0,0
2,0,3,3,2,4,2,6,6,"29",0,0,12,3,1,0,1038215,"2024-01-24T00:00:00.000Z",11,FALSE,25,213,"G",11,11,"Houston Rockets","Aaron Holiday",1,15,17,14,5,21.6
2,0,0,0,0,2,2,3,2,"13",3,2,6,3,0,0,1038215,"2024-01-24T00:00:00.000Z",11,FALSE,25,19465326,"C",11,11,"Houston Rockets","Jock Landale",0,9,11,8,5,12.6
0,0,0,0,0,0,0,0,0,"01",0,0,0,0,0,0,1038215,"2024-01-24T00:00:00.000Z",11,FALSE,25,296,"C",11,11,"Houston Rockets","Boban Marjanovic",0,0,0,0,0,0
0,0,0,0,0,0,0,0,0,"00",0,0,0,0,0,0,1038215,"2024-01-24T00:00:00.000Z",11,FALSE,25,56677809,"F",11,11,"Houston Rockets","Jermaine Samuels Jr.",0,0,0,0,0,0
0,0,0,0,0,0,0,0,0,"00",0,0,0,0,0,0,1038215,"2024-01-24T00:00:00.000Z",11,FALSE,25,38017684,"F",11,11,"Houston Rockets","Jabari Smith Jr.",0,0,0,0,0,0
2,1,2,0,0,5,3,0,0,"14",1,3,6,3,0,0,1038215,"2024-01-24T00:00:00.000Z",11,FALSE,25,56677825,"G-F",11,11,"Houston Rockets","Amen Thompson",1,9,11,8,5,15.6
0,0,4,6,2,10,5,0,0,"14",0,2,12,4,0,0,1038215,"2024-01-24T00:00:00.000Z",11,FALSE,25,56677831,"F",11,11,"Houston Rockets","Cam Whitmore",0,16,16,12,4,16.8
0,0,0,0,0,0,0,0,0,"00",0,0,0,0,0,0,1038215,"2024-01-24T00:00:00.000Z",11,FALSE,25,47738533,"G",11,11,"Houston Rockets","Jeenathan Williams",0,0,0,0,0,0
0,0,0,0,0,0,0,0,0,"00",0,0,0,0,0,0,1038215,"2024-01-24T00:00:00.000Z",11,FALSE,25,75,"G-F",11,11,"Houston Rockets","Reggie Bullock",0,0,0,0,0,0
0,0,0,0,0,0,0,0,0,"00",0,0,0,0,0,0,1038215,"2024-01-24T00:00:00.000Z",11,FALSE,25,38017695,"F",11,11,"Houston Rockets","Tari Eason",0,0,0,0,0,0
0,0,0,0,0,0,0,0,0,"00",0,0,0,0,0,0,1038215,"2024-01-24T00:00:00.000Z",11,FALSE,25,357,"G",11,11,"Houston Rockets","Victor Oladipo",0,0,0,0,0,0
0,0,0,0,0,0,0,0,0,"00",0,0,0,0,0,0,1038215,"2024-01-24T00:00:00.000Z",11,FALSE,25,3547301,"F",11,11,"Houston Rockets","Jae'Sean Tate",0,0,0,0,0,0
1,0,6,2,1,4,2,4,4,"24",1,4,9,7,0,2,1038215,"2024-01-24T00:00:00.000Z",11,FALSE,25,38017711,"F",25,25,"Portland Trail Blazers","Jabari Walker",0,16,17,10,8,16.9
9,2,5,5,2,12,5,11,9,"43",0,0,21,5,0,1,1038215,"2024-01-24T00:00:00.000Z",11,FALSE,25,182,"F",25,25,"Portland Trail Blazers","Jerami Grant",2,26,35,30,14,45.5
3,2,11,0,0,13,8,2,2,"41",6,3,18,17,1,1,1038215,"2024-01-24T00:00:00.000Z",11,FALSE,25,22,"C",25,25,"Portland Trail Blazers","Deandre Ayton",3,35,38,21,20,50.9
5,0,4,9,4,20,13,3,3,"41",2,3,33,6,0,3,1038215,"2024-01-24T00:00:00.000Z",11,FALSE,25,419,"G",25,25,"Portland Trail Blazers","Anfernee Simons",0,39,44,38,11,44.7
6,0,1,7,3,19,8,0,0,"41",1,2,19,2,0,2,1038215,"2024-01-24T00:00:00.000Z",11,FALSE,25,65,"G",25,25,"Portland Trail Blazers","Malcolm Brogdon",0,21,27,25,8,28.4
0,0,0,0,0,0,0,0,0,"00",0,0,0,0,0,0,1038215,"2024-01-24T00:00:00.000Z",11,FALSE,25,39613724,"C",25,25,"Portland Trail Blazers","Ibou Badji",0,0,0,0,0,0
1,0,3,0,0,4,1,2,2,"17",1,3,4,4,2,0,1038215,"2024-01-24T00:00:00.000Z",11,FALSE,25,56677850,"F",25,25,"Portland Trail Blazers","Toumani Camara",2,8,9,5,5,16.3
3,0,1,5,1,12,4,2,2,"24",0,0,11,1,0,2,1038215,"2024-01-24T00:00:00.000Z",11,FALSE,25,56677747,"G",25,25,"Portland Trail Blazers","Scoot Henderson",0,12,15,14,4,14.7
0,0,0,0,0,0,0,0,0,"00",0,0,0,0,0,0,1038215,"2024-01-24T00:00:00.000Z",11,FALSE,25,NA,NA,NA,25,"Portland Trail Blazers","NA NA",0,0,0,0,0,0
0,0,0,0,0,0,0,0,0,"00",0,0,0,0,0,0,1038215,"2024-01-24T00:00:00.000Z",11,FALSE,25,56677791,"F",25,25,"Portland Trail Blazers","Kris Murray",0,0,0,0,0,0
2,0,1,3,1,7,4,0,0,"12",1,0,9,2,0,0,1038215,"2024-01-24T00:00:00.000Z",11,FALSE,25,56783340,"C",25,25,"Portland Trail Blazers","Duop Reath",0,11,13,11,4,14.4
0,0,0,0,0,0,0,0,0,"00",0,0,0,0,0,0,1038215,"2024-01-24T00:00:00.000Z",11,FALSE,25,56677829,"G-F",25,25,"Portland Trail Blazers","Rayan Rupert",0,0,0,0,0,0
1,0,3,4,3,7,5,0,0,"22",1,3,13,4,3,1,1038215,"2024-01-24T00:00:00.000Z",11,FALSE,25,666923,"G-F",25,25,"Portland Trail Blazers","Matisse Thybulle",3,17,18,14,5,27.3
0,0,0,0,0,0,0,0,0,"00",0,0,0,0,0,0,1038215,"2024-01-24T00:00:00.000Z",11,FALSE,25,666476,"C",25,25,"Portland Trail Blazers","Moses Brown",0,0,0,0,0,0
0,0,0,0,0,0,0,0,0,"00",0,0,0,0,0,0,1038215,"2024-01-24T00:00:00.000Z",11,FALSE,25,47957121,"F",25,25,"Portland Trail Blazers","Justin Minaya",0,0,0,0,0,0
0,0,0,0,0,0,0,0,0,"00",0,0,0,0,0,0,1038215,"2024-01-24T00:00:00.000Z",11,FALSE,25,38017690,"G",25,25,"Portland Trail Blazers","Shaedon Sharpe",0,0,0,0,0,0
0,0,0,0,0,0,0,0,0,"00",0,0,0,0,0,0,1038215,"2024-01-24T00:00:00.000Z",11,FALSE,25,476,"C-F",25,25,"Portland Trail Blazers","Robert Williams III",0,0,0,0,0,0
1,2,3,4,0,11,4,4,4,"29",2,4,12,5,0,0,1038218,"2024-01-24T00:00:00.000Z",10,FALSE,1,475,"F-G",10,10,"Golden State Warriors","Andrew Wiggins",2,17,18,13,6,25.5
3,0,2,3,2,6,4,0,0,"16",1,0,10,3,1,0,1038218,"2024-01-24T00:00:00.000Z",10,FALSE,1,407,"F",10,10,"Golden State Warriors","Dario Saric",1,13,16,13,6,21.1
1,1,5,0,0,2,1,0,0,"10",2,1,2,7,1,1,1038218,"2024-01-24T00:00:00.000Z",10,FALSE,1,282,"F",10,10,"Golden State Warriors","Kevon Looney",2,9,10,3,8,16.9
3,1,1,10,5,18,8,3,3,"30",1,2,24,2,0,2,1038218,"2024-01-24T00:00:00.000Z",10,FALSE,1,443,"G",10,10,"Golden State Warriors","Klay Thompson",1,26,29,27,5,31.9
8,0,3,8,5,16,7,6,6,"31",0,3,25,3,0,1,1038218,"2024-01-24T00:00:00.000Z",10,FALSE,1,115,"G",10,10,"Golden State Warriors","Stephen Curry",0,28,36,33,11,39.6
3,1,4,3,2,6,5,0,0,"23",1,3,12,5,2,2,1038218,"2024-01-24T00:00:00.000Z",10,FALSE,1,185,"F",10,10,"Golden State Warriors","Draymond Green",3,17,20,15,8,29.5
1,2,4,0,0,4,2,4,0,"15",2,2,4,6,0,0,1038218,"2024-01-24T00:00:00.000Z",10,FALSE,1,56677799,"F",10,10,"Golden State Warriors","Trayce Jackson-Davis",2,10,11,5,7,18.7
1,0,2,2,2,3,3,0,0,"21",0,1,8,2,0,0,1038218,"2024-01-24T00:00:00.000Z",10,FALSE,1,251,"G",10,10,"Golden State Warriors","Cory Joseph",0,10,11,9,3,11.9
0,0,0,0,0,0,0,0,0,"00",0,0,0,0,0,0,1038218,"2024-01-24T00:00:00.000Z",10,FALSE,1,56677806,"F",1,1,"Atlanta Hawks","Mouhamed Gueye",0,0,0,0,0,0
0,0,0,0,0,0,0,0,0,"00",0,0,0,0,0,0,1038218,"2024-01-24T00:00:00.000Z",10,FALSE,1,666656,"F",1,1,"Atlanta Hawks","De'Andre Hunter",0,0,0,0,0,0
0,0,0,0,0,0,0,0,0,"00",0,0,0,0,0,0,1038218,"2024-01-24T00:00:00.000Z",10,FALSE,1,4197387,"G",1,1,"Atlanta Hawks","Vit Krejci",0,0,0,0,0,0
0,0,0,0,0,0,0,0,0,"00",0,0,0,0,0,0,1038218,"2024-01-24T00:00:00.000Z",10,FALSE,1,301,"G-F",1,1,"Atlanta Hawks","Wesley Matthews",0,0,0,0,0,0
0,0,0,0,0,0,0,0,0,"00",0,0,0,0,0,0,1038218,"2024-01-24T00:00:00.000Z",10,FALSE,1,490,"G",1,1,"Atlanta Hawks","Trae Young",0,0,0,0,0,0
1,1,8,0,0,9,3,7,5,"25",3,2,11,11,0,0,1038218,"2024-01-24T00:00:00.000Z",10,FALSE,1,83,"C",1,1,"Atlanta Hawks","Clint Capela",1,22,23,12,12,28.7
3,0,0,9,4,11,6,1,1,"32",0,1,17,0,1,1,1038218,"2024-01-24T00:00:00.000Z",10,FALSE,1,53,"G",1,1,"Atlanta Hawks","Bogdan Bogdanovic",1,17,20,20,3,23.5
2,2,9,0,0,11,11,5,3,"29",0,1,25,9,2,1,1038218,"2024-01-24T00:00:00.000Z",10,FALSE,1,17553979,"F",10,10,"Golden State Warriors","Jonathan Kuminga",4,34,36,27,11,49.8
2,0,3,1,0,9,5,0,0,"27",0,1,10,3,0,2,1038218,"2024-01-24T00:00:00.000Z",10,FALSE,1,56677858,"G",10,10,"Golden State Warriors","Brandin Podziemski",0,13,15,12,5,14.6
0,0,2,1,0,2,1,0,0,"03",1,0,2,3,0,1,1038218,"2024-01-24T00:00:00.000Z",10,FALSE,1,45658838,"G",10,10,"Golden State Warriors","Lester Quinones",0,5,5,2,3,4.6
1,0,0,1,0,2,0,0,0,"03",0,0,0,0,0,0,1038218,"2024-01-24T00:00:00.000Z",10,FALSE,1,398,"G",10,10,"Golden State Warriors","Jerome Robinson",0,0,1,1,1,1.5
0,0,0,0,0,1,0,0,0,"03",1,0,0,1,0,0,1038218,"2024-01-24T00:00:00.000Z",10,FALSE,1,57875092,"F",10,10,"Golden State Warriors","Gui Santos",0,1,1,0,1,1.2
0,0,0,0,0,0,0,0,0,"00",0,0,0,0,0,0,1038218,"2024-01-24T00:00:00.000Z",10,FALSE,1,17896070,"F",10,10,"Golden State Warriors","Usman Garuba",0,0,0,0,0,0
0,0,0,0,0,0,0,0,0,"00",0,0,0,0,0,0,1038218,"2024-01-24T00:00:00.000Z",10,FALSE,1,17553992,"G",10,10,"Golden State Warriors","Moses Moody",0,0,0,0,0,0
0,0,0,0,0,0,0,0,0,"00",0,0,0,0,0,0,1038218,"2024-01-24T00:00:00.000Z",10,FALSE,1,367,"G",10,10,"Golden State Warriors","Chris Paul",0,0,0,0,0,0
0,0,0,0,0,0,0,0,0,"00",0,0,0,0,0,0,1038218,"2024-01-24T00:00:00.000Z",10,FALSE,1,2189,"",10,10,"Golden State Warriors","Gary Payton II",0,0,0,0,0,0
3,0,4,6,3,12,6,3,3,"27",3,0,18,7,1,0,1038218,"2024-01-24T00:00:00.000Z",10,FALSE,1,3547256,"F",1,1,"Atlanta Hawks","Saddiq Bey",1,25,28,21,10,33.9
6,0,8,6,2,16,8,5,3,"36",1,4,21,9,1,0,1038218,"2024-01-24T00:00:00.000Z",10,FALSE,1,17896040,"F",1,1,"Atlanta Hawks","Jalen Johnson",1,30,36,27,15,43.8
1,0,0,6,0,7,1,2,1,"20",0,3,3,0,0,1,1038218,"2024-01-24T00:00:00.000Z",10,FALSE,1,666754,"G",1,1,"Atlanta Hawks","Garrison Mathews",0,3,4,4,1,3.5
3,0,1,6,3,11,5,0,0,"22",1,0,13,2,1,2,1038218,"2024-01-24T00:00:00.000Z",10,FALSE,1,319,"G",1,1,"Atlanta Hawks","Patty Mills",1,15,18,16,5,20.9
1,1,5,1,0,5,3,0,0,"25",2,3,6,7,0,3,1038218,"2024-01-24T00:00:00.000Z",10,FALSE,1,3547244,"F-C",1,1,"Atlanta Hawks","Onyeka Okongwu",1,13,14,7,8,15.9
0,0,0,0,0,0,0,0,0,"00",0,0,0,0,0,0,1038218,"2024-01-24T00:00:00.000Z",10,FALSE,1,56677838,"G",1,1,"Atlanta Hawks","Kobe Bufkin",0,0,0,0,0,0
0,0,0,0,0,0,0,0,0,"00",0,0,0,0,0,0,1038218,"2024-01-24T00:00:00.000Z",10,FALSE,1,666564,"F",1,1,"Atlanta Hawks","Bruno Fernando",0,0,0,0,0,0
7,0,4,7,2,19,7,8,7,"33",3,2,23,7,1,2,1038218,"2024-01-24T00:00:00.000Z",10,FALSE,1,334,"G",1,1,"Atlanta Hawks","Dejounte Murray",1,30,37,30,14,42.9
5,0,0,0,0,1,0,0,0,"15",0,1,0,0,2,1,1038218,"2024-01-24T00:00:00.000Z",10,FALSE,1,3547297,"G",1,1,"Atlanta Hawks","Trent Forrest",2,0,5,5,5,12.5
0,0,0,2,0,2,0,0,0,"02",0,0,0,0,0,0,1038218,"2024-01-24T00:00:00.000Z",10,FALSE,1,38017689,"F",1,1,"Atlanta Hawks","AJ Griffin",0,0,0,0,0,0
0,0,2,0,0,1,0,0,0,"03",0,0,0,2,0,0,1038218,"2024-01-24T00:00:00.000Z",10,FALSE,1,56677855,"G",1,1,"Atlanta Hawks","Seth Lundy",0,2,2,0,2,2.4
5,0,3,4,1,15,8,8,7,"32",2,3,24,5,2,0,1038216,"2024-01-24T00:00:00.000Z",17,FALSE,6,315,"F",17,17,"Milwaukee Bucks","Khris Middleton",2,29,34,29,10,43.5
10,2,16,1,1,24,16,3,2,"34",2,3,35,18,0,2,1038216,"2024-01-24T00:00:00.000Z",17,FALSE,6,15,"F",17,17,"Milwaukee Bucks","Giannis Antetokounmpo",2,53,63,45,28,75.6
3,1,4,1,0,7,3,2,2,"35",5,1,8,9,1,1,1038216,"2024-01-24T00:00:00.000Z",17,FALSE,6,283,"C",17,17,"Milwaukee Bucks","Brook Lopez",2,17,20,11,12,28.3
1,0,1,5,3,5,3,0,0,"27",0,3,9,1,1,1,1038216,"2024-01-24T00:00:00.000Z",17,FALSE,6,38,"G",17,17,"Milwaukee Bucks","Malik Beasley",1,10,11,10,2,13.7
4,0,1,9,2,21,8,11,10,"35",0,1,28,1,2,2,1038216,"2024-01-24T00:00:00.000Z",17,FALSE,6,278,"G",17,17,"Milwaukee Bucks","Damian Lillard",2,29,33,32,5,39.2
0,0,0,0,0,0,0,0,0,"01",0,0,0,0,0,0,1038216,"2024-01-24T00:00:00.000Z",17,FALSE,6,2148,"",17,17,"Milwaukee Bucks","Thanasis Antetokounmpo",0,0,0,0,0,0
0,0,1,3,2,4,2,0,0,"17",0,1,6,1,2,0,1038216,"2024-01-24T00:00:00.000Z",17,FALSE,6,105,"G",17,17,"Milwaukee Bucks","Pat Connaughton",2,7,7,6,1,13.2
5,0,8,0,0,19,10,2,1,"32",4,0,21,12,0,1,1038216,"2024-01-24T00:00:00.000Z",17,FALSE,6,9,"C",6,6,"Cleveland Cavaliers","Jarrett Allen",0,33,38,26,17,41.9
2,0,4,6,2,11,6,0,0,"34",0,5,14,4,2,1,1038216,"2024-01-24T00:00:00.000Z",17,FALSE,6,666908,"G",6,6,"Cleveland Cavaliers","Max Strus",2,18,20,16,6,26.8
8,0,7,11,2,24,10,4,1,"39",0,5,23,7,1,6,1038216,"2024-01-24T00:00:00.000Z",17,FALSE,6,322,"G",6,6,"Cleveland Cavaliers","Donovan Mitchell",1,30,38,31,15,40.4
2,0,0,0,0,2,2,1,1,"10",0,0,5,0,0,0,1038216,"2024-01-24T00:00:00.000Z",17,FALSE,6,248,"C",6,6,"Cleveland Cavaliers","Damian Jones",0,5,7,7,2,8
4,1,4,4,1,10,4,0,0,"28",0,2,9,4,2,2,1038216,"2024-01-24T00:00:00.000Z",17,FALSE,6,277,"G",6,6,"Cleveland Cavaliers","Caris LeVert",3,13,17,13,8,26.8
3,0,2,9,4,9,4,0,0,"27",0,1,12,2,0,1,1038216,"2024-01-24T00:00:00.000Z",17,FALSE,6,3547299,"G",6,6,"Cleveland Cavaliers","Sam Merrill",0,14,17,15,5,17.9
0,0,0,0,0,0,0,0,0,"01",0,0,0,0,0,0,1038216,"2024-01-24T00:00:00.000Z",17,FALSE,6,NA,NA,NA,6,"Cleveland Cavaliers","NA NA",0,0,0,0,0,0
2,0,3,3,2,7,5,2,2,"21",1,2,14,4,0,0,1038216,"2024-01-24T00:00:00.000Z",17,FALSE,6,344,"F",6,6,"Cleveland Cavaliers","Georges Niang",0,18,20,16,6,21.8
0,0,0,0,0,0,0,2,2,"01",0,0,2,0,0,0,1038216,"2024-01-24T00:00:00.000Z",17,FALSE,6,56677872,"G",6,6,"Cleveland Cavaliers","Craig Porter",0,2,2,2,0,2
0,0,0,0,0,0,0,0,0,"00",0,0,0,0,0,0,1038216,"2024-01-24T00:00:00.000Z",17,FALSE,6,444,"C-F",6,6,"Cleveland Cavaliers","Tristan Thompson",0,0,0,0,0,0
0,0,0,0,0,0,0,0,0,"00",0,0,0,0,0,0,1038216,"2024-01-24T00:00:00.000Z",17,FALSE,6,56677847,"F",6,6,"Cleveland Cavaliers","Emoni Bates",0,0,0,0,0,0
0,0,0,0,0,0,0,0,0,"00",0,0,0,0,0,0,1038216,"2024-01-24T00:00:00.000Z",17,FALSE,6,666581,"G",6,6,"Cleveland Cavaliers","Darius Garland",0,0,0,0,0,0
0,0,0,0,0,0,0,0,0,"00",0,0,0,0,0,0,1038216,"2024-01-24T00:00:00.000Z",17,FALSE,6,666676,"G",6,6,"Cleveland Cavaliers","Ty Jerome",0,0,0,0,0,0
0,0,0,0,0,0,0,0,0,"01",0,0,0,0,0,0,1038216,"2024-01-24T00:00:00.000Z",17,FALSE,6,284,"C",17,17,"Milwaukee Bucks","Robin Lopez",0,0,0,0,0,0
0,0,2,3,1,6,2,0,0,"13",0,1,5,2,1,1,1038216,"2024-01-24T00:00:00.000Z",17,FALSE,6,368,"G",17,17,"Milwaukee Bucks","Cameron Payne",1,7,7,5,2,9.4
0,0,6,1,0,6,2,4,4,"25",0,1,8,6,0,1,1038216,"2024-01-24T00:00:00.000Z",17,FALSE,6,377,"F",17,17,"Milwaukee Bucks","Bobby Portis",0,14,14,8,6,14.2
0,0,0,0,0,0,0,0,0,"00",0,0,0,0,0,0,1038216,"2024-01-24T00:00:00.000Z",17,FALSE,6,38017676,"F",17,17,"Milwaukee Bucks","MarJon Beauchamp",0,0,0,0,0,0
0,0,0,0,0,0,0,0,0,"00",0,0,0,0,0,0,1038216,"2024-01-24T00:00:00.000Z",17,FALSE,6,56677854,"F",17,17,"Milwaukee Bucks","Chris Livingston",0,0,0,0,0,0
0,0,0,0,0,0,0,0,0,"00",0,0,0,0,0,0,1038216,"2024-01-24T00:00:00.000Z",17,FALSE,6,38017691,"G",17,17,"Milwaukee Bucks","TyTy Washington Jr.",0,0,0,0,0,0
0,0,0,1,0,5,3,4,4,"24",1,2,10,1,0,0,1038216,"2024-01-24T00:00:00.000Z",17,FALSE,6,3547247,"F-G",6,6,"Cleveland Cavaliers","Isaac Okoro",0,11,11,10,1,11.2
0,1,5,4,2,4,2,0,0,"23",0,1,6,5,0,1,1038216,"2024-01-24T00:00:00.000Z",17,FALSE,6,666940,"F",6,6,"Cleveland Cavaliers","Dean Wade",1,11,11,6,5,14
0,0,0,0,0,0,0,0,0,"01",0,0,0,0,0,0,1038216,"2024-01-24T00:00:00.000Z",17,FALSE,6,56677852,"G",17,17,"Milwaukee Bucks","Andre Jackson Jr.",0,0,0,0,0,0
1,0,2,2,1,2,1,0,0,"18",1,2,3,3,0,3,1038216,"2024-01-24T00:00:00.000Z",17,FALSE,6,112,"F",17,17,"Milwaukee Bucks","Jae Crowder",0,6,7,4,4,5.1
0,0,0,0,0,0,0,0,0,"01",0,0,0,0,0,0,1038216,"2024-01-24T00:00:00.000Z",17,FALSE,6,38017733,"G",17,17,"Milwaukee Bucks","A.J. Green",0,0,0,0,0,0
0,0,0,0,0,0,0,0,0,"00",0,0,0,0,0,0,1038216,"2024-01-24T00:00:00.000Z",17,FALSE,6,17896076,"F-C",6,6,"Cleveland Cavaliers","Evan Mobley",0,0,0,0,0,0
0,0,0,0,0,0,0,0,0,"00",0,0,0,0,0,0,1038216,"2024-01-24T00:00:00.000Z",17,FALSE,6,38017662,"F",6,6,"Cleveland Cavaliers","Isaiah Mobley",0,0,0,0,0,0
0,0,0,1,0,2,1,0,0,"04",0,0,2,0,0,0,1038217,"2024-01-24T00:00:00.000Z",7,FALSE,24,666729,"F",24,24,"Phoenix Suns","Nassir Little",0,2,2,2,0,2
1,0,6,0,0,1,1,0,0,"14",1,1,2,7,0,0,1038217,"2024-01-24T00:00:00.000Z",7,FALSE,24,314,"F",24,24,"Phoenix Suns","Chimezie Metu",0,9,10,3,8,11.9
1,0,1,3,0,8,3,1,0,"24",1,3,6,2,0,3,1038217,"2024-01-24T00:00:00.000Z",7,FALSE,24,247,"F-G",7,7,"Dallas Mavericks","Derrick Jones Jr.",0,8,9,7,3,6.9
1,0,1,4,2,6,3,0,0,"11",0,3,8,1,0,3,1038217,"2024-01-24T00:00:00.000Z",7,FALSE,24,666965,"F",7,7,"Dallas Mavericks","Grant Williams",0,9,10,9,2,7.7
1,1,1,0,0,5,4,0,0,"25",1,2,8,2,1,0,1038217,"2024-01-24T00:00:00.000Z",7,FALSE,24,56677840,"C",7,7,"Dallas Mavericks","Dereck Lively II",2,10,11,9,3,17.9
3,0,1,6,2,8,3,0,0,"31",3,1,8,4,0,1,1038217,"2024-01-24T00:00:00.000Z",7,FALSE,24,3547258,"G",7,7,"Dallas Mavericks","Josh Green",0,12,15,11,7,16.3
9,2,7,11,4,24,11,12,8,"39",1,1,34,8,1,5,1038217,"2024-01-24T00:00:00.000Z",7,FALSE,24,132,"F-G",7,7,"Dallas Mavericks","Luka Doncic",3,42,51,43,17,61.1
2,0,2,1,1,4,2,2,1,"19",0,1,6,2,0,0,1038217,"2024-01-24T00:00:00.000Z",7,FALSE,24,151,"G",7,7,"Dallas Mavericks","Dante Exum",0,8,10,8,4,11.4
2,0,5,10,4,16,6,2,1,"34",0,1,17,5,2,1,1038217,"2024-01-24T00:00:00.000Z",7,FALSE,24,191,"G",7,7,"Dallas Mavericks","Tim Hardaway Jr.",2,22,24,19,7,31
2,0,3,4,3,9,4,0,0,"15",0,1,11,3,0,0,1038217,"2024-01-24T00:00:00.000Z",7,FALSE,24,38017679,"G",7,7,"Dallas Mavericks","Jaden Hardy",0,14,16,13,5,17.6
3,0,1,1,0,2,1,0,0,"22",2,3,2,3,0,1,1038217,"2024-01-24T00:00:00.000Z",7,FALSE,24,257,"F",7,7,"Dallas Mavericks","Maxi Kleber",0,5,8,5,6,9.1
0,0,0,1,0,2,1,1,0,"05",0,0,2,0,0,0,1038217,"2024-01-24T00:00:00.000Z",7,FALSE,24,24489167,"G",25,7,"Dallas Mavericks","Brandon Williams",0,2,2,2,0,2
0,0,0,0,0,0,0,0,0,"00",0,0,0,0,0,0,1038217,"2024-01-24T00:00:00.000Z",7,FALSE,24,17896028,"F",7,7,"Dallas Mavericks","Greg Brown III",0,0,0,0,0,0
0,0,0,0,0,0,0,0,0,"00",0,0,0,0,0,0,1038217,"2024-01-24T00:00:00.000Z",7,FALSE,24,228,"G",7,7,"Dallas Mavericks","Kyrie Irving",0,0,0,0,0,0
0,0,0,0,0,0,0,0,0,"00",0,0,0,0,0,0,1038217,"2024-01-24T00:00:00.000Z",7,FALSE,24,379,"F-C",7,7,"Dallas Mavericks","Dwight Powell",0,0,0,0,0,0
4,0,4,5,3,8,5,2,2,"33",1,3,15,5,1,2,1038217,"2024-01-24T00:00:00.000Z",7,FALSE,24,8,"G",24,24,"Phoenix Suns","Grayson Allen",1,20,24,19,9,28
7,2,10,4,0,10,4,7,4,"38",0,4,12,10,1,1,1038217,"2024-01-24T00:00:00.000Z",7,FALSE,24,140,"F",24,24,"Phoenix Suns","Kevin Durant",3,22,29,19,17,42.5
3,0,2,1,0,5,3,2,2,"21",3,4,8,5,2,4,1038217,"2024-01-24T00:00:00.000Z",7,FALSE,24,349,"C",24,24,"Phoenix Suns","Jusuf Nurkic",2,13,16,11,8,20.5
7,1,5,7,3,15,8,2,1,"36",2,4,20,7,1,2,1038217,"2024-01-24T00:00:00.000Z",7,FALSE,24,37,"G",24,24,"Phoenix Suns","Bradley Beal",2,27,34,27,14,42.9
3,0,6,10,6,23,17,8,6,"35",1,0,46,7,2,2,1038217,"2024-01-24T00:00:00.000Z",7,FALSE,24,57,"G",24,24,"Phoenix Suns","Devin Booker",2,53,56,49,10,62.9
3,1,3,3,1,7,2,1,1,"24",1,2,6,4,2,2,1038217,"2024-01-24T00:00:00.000Z",7,FALSE,24,356,"G",24,24,"Phoenix Suns","Josh Okogie",3,10,13,9,7,22.3
0,0,0,0,0,2,1,0,0,"09",0,1,2,0,0,1,1038217,"2024-01-24T00:00:00.000Z",7,FALSE,24,147,"F",24,24,"Phoenix Suns","Drew Eubanks",0,2,2,2,0,1
1,0,0,2,1,7,5,0,0,"15",2,0,11,2,1,1,1038217,"2024-01-24T00:00:00.000Z",7,FALSE,24,32,"F",24,24,"Phoenix Suns","Keita Bates-Diop",1,13,14,12,3,16.9
0,0,2,0,0,1,1,0,0,"07",0,1,2,2,0,0,1038217,"2024-01-24T00:00:00.000Z",7,FALSE,24,470,"G",24,24,"Phoenix Suns","Yuta Watanabe",0,4,4,2,2,4.4
1,0,0,1,0,4,3,0,0,"04",0,0,6,0,0,0,1038217,"2024-01-24T00:00:00.000Z",7,FALSE,24,18678058,"",24,24,"Phoenix Suns","Jordan Goodwin",0,6,7,7,1,7.5
0,0,0,0,0,0,0,0,0,"00",0,0,0,0,0,0,1038217,"2024-01-24T00:00:00.000Z",7,FALSE,24,114,"G",7,7,"Dallas Mavericks","Seth Curry",0,0,0,0,0,0
0,0,0,0,0,2,2,0,0,"05",2,0,4,2,0,0,1038217,"2024-01-24T00:00:00.000Z",7,FALSE,24,217,"F-C",7,7,"Dallas Mavericks","Richaun Holmes",0,6,6,4,2,6.4
1,0,1,2,1,3,1,0,0,"05",0,0,3,1,0,0,1038217,"2024-01-24T00:00:00.000Z",7,FALSE,24,17554004,"G",7,7,"Dallas Mavericks","AJ Lawson",0,4,5,4,2,5.7
0,0,0,0,0,0,0,0,0,"00",0,0,0,0,0,0,1038217,"2024-01-24T00:00:00.000Z",7,FALSE,24,329,"F",7,7,"Dallas Mavericks","Markieff Morris",0,0,0,0,0,0
0,0,0,0,0,0,0,0,0,"05",0,0,0,0,0,0,1038217,"2024-01-24T00:00:00.000Z",7,FALSE,24,56677859,"F",7,7,"Dallas Mavericks","Olivier-Maxence Prosper",0,0,0,0,0,0
0,0,0,0,0,0,0,0,0,"00",0,0,0,0,0,0,1038217,"2024-01-24T00:00:00.000Z",7,FALSE,24,3547095,"C-F",24,24,"Phoenix Suns","Udoka Azubuike",0,0,0,0,0,0
0,0,0,0,0,0,0,0,0,"00",0,0,0,0,0,0,1038217,"2024-01-24T00:00:00.000Z",7,FALSE,24,666451,"C",24,24,"Phoenix Suns","Bol Bol",0,0,0,0,0,0
0,0,0,0,0,0,0,0,0,"00",0,0,0,0,0,0,1038217,"2024-01-24T00:00:00.000Z",7,FALSE,24,178,"G",24,24,"Phoenix Suns","Eric Gordon",0,0,0,0,0,0
0,0,0,0,0,0,0,0,0,"00",0,0,0,0,0,0,1038217,"2024-01-24T00:00:00.000Z",7,FALSE,24,272,"G",24,24,"Phoenix Suns","Damion Lee",0,0,0,0,0,0
0,0,0,0,0,0,0,0,0,"00",0,0,0,0,0,0,1038217,"2024-01-24T00:00:00.000Z",7,FALSE,24,3547298,"G",24,24,"Phoenix Suns","Saben Lee",0,0,0,0,0,0
0,0,0,0,0,0,0,0,0,"00",0,0,0,0,0,0,1038217,"2024-01-24T00:00:00.000Z",7,FALSE,24,3547253,"G",4,24,"Phoenix Suns","Theo Maledon",0,0,0,0,0,0
5,1,6,1,1,9,5,2,2,"27",0,1,13,6,1,3,1038220,"2024-01-25T00:00:00.000Z",30,FALSE,29,3547242,"F",30,30,"Washington Wizards","Deni Avdija",2,19,24,18,11,30.7
5,0,4,8,1,24,12,1,1,"34",2,0,26,6,0,5,1038220,"2024-01-25T00:00:00.000Z",30,FALSE,29,265,"F",30,30,"Washington Wizards","Kyle Kuzma",0,32,37,31,11,35.7
1,4,7,0,0,7,6,2,1,"31",2,2,13,9,1,0,1038220,"2024-01-25T00:00:00.000Z",30,FALSE,29,666577,"F",30,30,"Washington Wizards","Daniel Gafford",5,22,23,14,10,40.3
2,2,2,7,3,12,6,4,3,"28",0,5,18,2,2,0,1038220,"2024-01-25T00:00:00.000Z",30,FALSE,29,666848,"G",30,30,"Washington Wizards","Jordan Poole",4,20,22,20,4,35.4
14,0,6,4,2,12,5,0,0,"34",0,1,12,6,1,0,1038220,"2024-01-25T00:00:00.000Z",30,FALSE,29,249,"G",30,30,"Washington Wizards","Tyus Jones",1,18,32,26,20,43.2
1,0,2,0,0,5,4,9,6,"16",1,2,14,3,0,1,1038220,"2024-01-25T00:00:00.000Z",30,FALSE,29,24,"F",9,30,"Washington Wizards","Marvin Bagley III",0,17,18,15,4,18.1
0,0,0,0,0,0,0,0,0,"01",0,0,0,0,0,0,1038220,"2024-01-25T00:00:00.000Z",30,FALSE,29,38017704,"F",30,30,"Washington Wizards","Patrick Baldwin Jr.",0,0,0,0,0,0
0,0,0,1,0,1,0,0,0,"01",0,0,0,0,0,0,1038220,"2024-01-25T00:00:00.000Z",30,FALSE,29,NA,NA,NA,30,"Washington Wizards","NA NA",0,0,0,0,0,0
0,0,0,0,0,0,0,0,0,"00",0,0,0,0,0,0,1038220,"2024-01-25T00:00:00.000Z",30,FALSE,29,18677954,"G",30,30,"Washington Wizards","Jared Butler",0,0,0,0,0,0
2,0,1,2,0,5,0,2,2,"29",0,1,2,1,3,2,1038220,"2024-01-25T00:00:00.000Z",30,FALSE,29,56677844,"G",30,30,"Washington Wizards","Bilal Coulibaly",3,3,5,4,3,13.2
0,0,0,0,0,0,0,0,0,"01",0,0,0,0,0,0,1038220,"2024-01-25T00:00:00.000Z",30,FALSE,29,38017687,"G",30,30,"Washington Wizards","Johnny Davis",0,0,0,0,0,0
0,0,0,0,0,0,0,0,0,"01",0,0,0,0,0,0,1038220,"2024-01-25T00:00:00.000Z",30,FALSE,29,3547302,"F",30,30,"Washington Wizards","Anthony Gill",0,0,0,0,0,0
0,0,1,0,0,0,0,0,0,"01",0,0,0,1,0,0,1038220,"2024-01-25T00:00:00.000Z",30,FALSE,29,NA,NA,NA,30,"Washington Wizards","NA NA",0,1,1,0,1,1.2
1,0,0,4,0,9,4,0,0,"20",0,0,8,0,3,0,1038220,"2024-01-25T00:00:00.000Z",30,FALSE,29,17896045,"F",30,30,"Washington Wizards","Corey Kispert",3,8,9,9,1,18.5
0,0,0,0,0,0,0,0,0,"00",0,0,0,0,0,0,1038220,"2024-01-25T00:00:00.000Z",30,FALSE,29,17896106,"F",30,30,"Washington Wizards","Eugene Omoruyi",0,0,0,0,0,0
1,0,0,3,0,4,1,0,0,"11",0,2,2,0,0,0,1038220,"2024-01-25T00:00:00.000Z",30,FALSE,29,414,"G",30,30,"Washington Wizards","Landry Shamet",0,2,3,3,1,3.5
1,0,1,0,0,0,0,0,0,"05",0,0,0,1,0,0,1038220,"2024-01-25T00:00:00.000Z",30,FALSE,29,487,"G",30,30,"Washington Wizards","Delon Wright",0,1,2,1,2,2.7
0,0,0,0,0,0,0,0,0,"00",0,0,0,0,0,0,1038220,"2024-01-25T00:00:00.000Z",30,FALSE,29,17896071,"F",9,30,"Washington Wizards","Isaiah Livers",0,0,0,0,0,0
2,0,5,3,2,7,4,0,0,"21",2,1,10,7,0,0,1038220,"2024-01-25T00:00:00.000Z",30,FALSE,29,38017739,"F",29,29,"Utah Jazz","Simone Fontecchio",0,17,19,12,9,21.4
5,0,6,12,6,20,11,2,1,"33",1,3,29,7,3,3,1038220,"2024-01-25T00:00:00.000Z",30,FALSE,29,297,"F",29,29,"Utah Jazz","Lauri Markkanen",3,36,41,34,12,50.9
1,0,9,2,0,15,11,0,0,"33",7,2,22,16,1,1,1038220,"2024-01-25T00:00:00.000Z",30,FALSE,29,101,"F-C",29,29,"Utah Jazz","John Collins",1,38,39,23,17,44.7
6,0,2,2,1,11,4,2,2,"17",1,2,11,3,1,2,1038220,"2024-01-25T00:00:00.000Z",30,FALSE,29,413,"G",29,29,"Utah Jazz","Collin Sexton",1,14,20,17,9,24.6
3,0,1,1,0,4,2,0,0,"17",0,1,4,1,1,0,1038220,"2024-01-25T00:00:00.000Z",30,FALSE,29,139,"G",29,29,"Utah Jazz","Kris Dunn",1,5,8,7,4,12.7
0,1,4,1,0,3,0,0,0,"20",0,1,0,4,0,1,1038220,"2024-01-25T00:00:00.000Z",30,FALSE,29,38017620,"G",29,29,"Utah Jazz","Ochai Agbaji",1,4,4,0,4,6.8
8,0,3,4,1,17,7,4,4,"30",0,1,19,3,0,4,1038220,"2024-01-25T00:00:00.000Z",30,FALSE,29,100,"G",29,29,"Utah Jazz","Jordan Clarkson",0,22,30,27,11,30.6
7,0,4,2,0,6,1,4,3,"31",0,0,5,4,0,3,1038220,"2024-01-25T00:00:00.000Z",30,FALSE,29,56677834,"G",29,29,"Utah Jazz","Keyonte George",0,9,16,12,11,17.3
0,0,0,0,0,0,0,0,0,"00",0,0,0,0,0,0,1038220,"2024-01-25T00:00:00.000Z",30,FALSE,29,666650,"G",29,29,"Utah Jazz","Talen Horton-Tucker",0,0,0,0,0,0
0,1,3,0,0,3,2,0,0,"15",0,5,4,3,0,0,1038220,"2024-01-25T00:00:00.000Z",30,FALSE,29,38017705,"C",29,29,"Utah Jazz","Walker Kessler",1,7,7,4,3,10.6
2,0,2,4,3,11,8,0,0,"21",2,3,19,4,0,1,1038220,"2024-01-25T00:00:00.000Z",30,FALSE,29,358,"F",29,29,"Utah Jazz","Kelly Olynyk",0,23,25,21,6,25.8
0,0,0,0,0,0,0,0,0,"01",0,0,0,0,0,0,1038220,"2024-01-25T00:00:00.000Z",30,FALSE,29,666881,"F",29,29,"Utah Jazz","Luka Samanic",0,0,0,0,0,0
0,0,0,0,0,0,0,0,0,"01",0,0,0,0,0,0,1038220,"2024-01-25T00:00:00.000Z",30,FALSE,29,11891374,"C",29,29,"Utah Jazz","Omer Yurtseven",0,0,0,0,0,0
0,0,0,0,0,0,0,0,0,"00",0,0,0,0,0,0,1038220,"2024-01-25T00:00:00.000Z",30,FALSE,29,56677824,"F",29,29,"Utah Jazz","Taylor Hendricks",0,0,0,0,0,0
0,0,0,0,0,0,0,0,0,"00",0,0,0,0,0,0,1038220,"2024-01-25T00:00:00.000Z",30,FALSE,29,38017630,"G",29,29,"Utah Jazz","Johnny Juzang",0,0,0,0,0,0
0,0,0,0,0,0,0,0,0,"00",0,0,0,0,0,0,1038220,"2024-01-25T00:00:00.000Z",30,FALSE,29,19465584,"F",29,29,"Utah Jazz","Micah Potter",0,0,0,0,0,0
0,0,0,0,0,0,0,0,0,"00",0,0,0,0,0,0,1038220,"2024-01-25T00:00:00.000Z",30,FALSE,29,17896042,"G",13,29,"Utah Jazz","Jason Preston",0,0,0,0,0,0
0,0,0,0,0,0,0,0,0,"00",0,0,0,0,0,0,1038220,"2024-01-25T00:00:00.000Z",30,FALSE,29,56677842,"F",29,29,"Utah Jazz","Brice Sensabaugh",0,0,0,0,0,0
3,0,4,3,1,5,2,0,0,"22",0,2,5,4,0,1,1038221,"2024-01-25T00:00:00.000Z",3,FALSE,18,666679,"F",3,3,"Brooklyn Nets","Cameron Johnson",0,9,12,8,7,13.3
2,0,2,5,2,6,3,0,0,"36",0,2,8,2,0,0,1038221,"2024-01-25T00:00:00.000Z",3,FALSE,18,158,"F",3,3,"Brooklyn Nets","Dorian Finney-Smith",0,10,12,10,4,13.4
4,2,9,0,0,10,8,0,0,"39",2,2,16,11,2,0,1038221,"2024-01-25T00:00:00.000Z",3,FALSE,18,666508,"F-C",3,3,"Brooklyn Nets","Nicolas Claxton",4,27,31,20,15,47.2
3,0,1,8,2,18,8,5,3,"35",0,1,21,1,2,3,1038221,"2024-01-25T00:00:00.000Z",3,FALSE,18,61,"F",3,3,"Brooklyn Nets","Mikal Bridges",2,22,25,24,4,29.7
2,0,2,6,3,10,5,1,1,"32",0,3,14,2,0,0,1038221,"2024-01-25T00:00:00.000Z",3,FALSE,18,130,"G",3,3,"Brooklyn Nets","Spencer Dinwiddie",0,16,18,16,4,19.4
0,0,0,0,0,0,0,0,0,"00",0,0,0,0,0,0,1038221,"2024-01-25T00:00:00.000Z",3,FALSE,18,56677843,"F",3,3,"Brooklyn Nets","Noah Clowney",0,0,0,0,0,0
0,0,0,0,0,0,0,0,0,"00",0,0,0,0,0,0,1038221,"2024-01-25T00:00:00.000Z",3,FALSE,18,174,"F-C",3,3,"Brooklyn Nets","Harry Giles III",0,0,0,0,0,0
0,0,0,0,0,0,0,0,0,"00",0,0,0,0,0,0,1038221,"2024-01-25T00:00:00.000Z",3,FALSE,18,17896041,"G",3,3,"Brooklyn Nets","Keon Johnson",0,0,0,0,0,0
2,1,3,4,1,4,1,0,0,"18",1,2,3,4,0,1,1038221,"2024-01-25T00:00:00.000Z",3,FALSE,18,351,"F",3,3,"Brooklyn Nets","Royce O'Neale",1,7,9,5,6,12.8
2,0,0,0,0,4,0,0,0,"16",2,1,0,2,0,1,1038221,"2024-01-25T00:00:00.000Z",3,FALSE,18,421,"G",3,3,"Brooklyn Nets","Dennis Smith Jr.",0,2,4,2,4,4.4
3,0,6,4,1,15,7,10,10,"28",0,0,25,6,2,5,1038221,"2024-01-25T00:00:00.000Z",3,FALSE,18,17896048,"G",3,3,"Brooklyn Nets","Cam Thomas",2,31,34,28,9,37.7
1,0,0,3,0,5,1,0,0,"14",0,2,2,0,1,2,1038221,"2024-01-25T00:00:00.000Z",3,FALSE,18,464,"G",3,3,"Brooklyn Nets","Lonnie Walker IV",1,2,3,3,1,4.5
0,0,0,0,0,0,0,0,0,"00",0,0,0,0,0,0,1038221,"2024-01-25T00:00:00.000Z",3,FALSE,18,17896058,"F",3,3,"Brooklyn Nets","Trendon Watford",0,0,0,0,0,0
0,0,0,0,0,0,0,0,0,"00",0,0,0,0,0,0,1038221,"2024-01-25T00:00:00.000Z",3,FALSE,18,56677722,"F",3,3,"Brooklyn Nets","Jalen Wilson",0,0,0,0,0,0
0,0,0,0,0,0,0,0,0,"00",0,0,0,0,0,0,1038221,"2024-01-25T00:00:00.000Z",3,FALSE,18,17896038,"C",3,3,"Brooklyn Nets","Day'Ron Sharpe",0,0,0,0,0,0
0,0,0,0,0,0,0,0,0,"00",0,0,0,0,0,0,1038221,"2024-01-25T00:00:00.000Z",3,FALSE,18,417,"G-F",3,3,"Brooklyn Nets","Ben Simmons",0,0,0,0,0,0
0,0,0,0,0,0,0,0,0,"00",0,0,0,0,0,0,1038221,"2024-01-25T00:00:00.000Z",3,FALSE,18,56677841,"F",3,3,"Brooklyn Nets","Dariq Whitehead",0,0,0,0,0,0
1,0,3,1,1,6,4,0,0,"33",1,2,9,4,0,0,1038221,"2024-01-25T00:00:00.000Z",3,FALSE,18,3547259,"F",18,18,"Minnesota Timberwolves","Jaden McDaniels",0,13,14,10,5,15.3
3,0,9,3,2,15,12,2,1,"37",1,3,27,10,0,6,1038221,"2024-01-25T00:00:00.000Z",3,FALSE,18,447,"C",18,18,"Minnesota Timberwolves","Karl-Anthony Towns",0,37,40,30,13,37.5
1,2,12,0,0,9,4,2,2,"33",1,3,10,13,1,1,1038221,"2024-01-25T00:00:00.000Z",3,FALSE,18,176,"C",18,18,"Minnesota Timberwolves","Rudy Gobert",3,23,24,11,14,35.1
3,0,1,7,3,23,8,6,5,"36",0,3,24,1,1,3,1038221,"2024-01-25T00:00:00.000Z",3,FALSE,18,3547238,"G",18,18,"Minnesota Timberwolves","Anthony Edwards",1,25,28,27,4,29.7
4,1,2,4,2,6,3,2,2,"33",0,1,10,2,2,1,1038221,"2024-01-25T00:00:00.000Z",3,FALSE,18,104,"G",18,18,"Minnesota Timberwolves","Mike Conley",3,12,16,14,6,26.4
4,0,1,3,1,4,2,2,1,"17",0,2,6,1,0,0,1038221,"2024-01-25T00:00:00.000Z",3,FALSE,18,666400,"G",18,18,"Minnesota Timberwolves","Nickeil Alexander-Walker",0,7,11,10,5,13.2
5,0,2,0,0,3,1,2,1,"18",1,0,3,3,2,1,1038221,"2024-01-25T00:00:00.000Z",3,FALSE,18,12,"F",18,18,"Minnesota Timberwolves","Kyle Anderson",2,6,11,8,8,19.1
0,0,0,0,0,0,0,0,0,"00",0,0,0,0,0,0,1038221,"2024-01-25T00:00:00.000Z",3,FALSE,18,68,"F",18,18,"Minnesota Timberwolves","Troy Brown Jr.",0,0,0,0,0,0
0,0,0,0,0,0,0,0,0,"00",0,0,0,0,0,0,1038221,"2024-01-25T00:00:00.000Z",3,FALSE,18,17896056,"C",18,18,"Minnesota Timberwolves","Luka Garza",0,0,0,0,0,0
1,0,0,0,0,2,1,0,0,"10",0,0,2,0,0,1,1038221,"2024-01-25T00:00:00.000Z",3,FALSE,18,666767,"G",18,18,"Minnesota Timberwolves","Jordan McLaughlin",0,2,3,3,1,2.5
0,0,0,0,0,0,0,0,0,"00",0,0,0,0,0,0,1038221,"2024-01-25T00:00:00.000Z",3,FALSE,18,320,"G",18,18,"Minnesota Timberwolves","Shake Milton",0,0,0,0,0,0
0,0,0,0,0,0,0,0,0,"00",0,0,0,0,0,0,1038221,"2024-01-25T00:00:00.000Z",3,FALSE,18,38017700,"G",18,18,"Minnesota Timberwolves","Wendell Moore Jr.",0,0,0,0,0,0
2,1,3,3,1,7,2,0,0,"23",1,3,5,4,0,1,1038221,"2024-01-25T00:00:00.000Z",3,FALSE,18,667378,"F-C",18,18,"Minnesota Timberwolves","Naz Reid",1,9,11,7,6,14.8
0,0,0,0,0,0,0,0,0,"00",0,0,0,0,0,0,1038221,"2024-01-25T00:00:00.000Z",3,FALSE,18,56677851,"G",18,18,"Minnesota Timberwolves","Jaylen Clark",0,0,0,0,0,0
0,0,0,0,0,0,0,0,0,"00",0,0,0,0,0,0,1038221,"2024-01-25T00:00:00.000Z",3,FALSE,18,56677782,"F",18,18,"Minnesota Timberwolves","Leonard Miller",0,0,0,0,0,0
0,0,0,0,0,0,0,0,0,"00",0,0,0,0,0,0,1038221,"2024-01-25T00:00:00.000Z",3,FALSE,18,38017715,"F",18,18,"Minnesota Timberwolves","Josh Minott",0,0,0,0,0,0
0,0,0,0,0,0,0,0,0,"00",0,0,0,0,0,0,1038221,"2024-01-25T00:00:00.000Z",3,FALSE,18,17895968,"F",18,18,"Minnesota Timberwolves","Daishen Nix",0,0,0,0,0,0
4,0,2,3,2,11,7,1,1,"29",1,1,17,3,2,1,1038222,"2024-01-25T00:00:00.000Z",16,FALSE,2,79,"G-F",16,16,"Miami Heat","Jimmy Butler",2,20,24,21,7,31.6
1,0,2,4,4,7,5,0,0,"26",1,3,14,3,1,1,1038222,"2024-01-25T00:00:00.000Z",16,FALSE,2,3092,"",16,16,"Miami Heat","Haywood Highsmith",1,17,18,15,4,21.1
2,1,4,0,0,14,8,4,3,"29",1,0,19,5,1,0,1038222,"2024-01-25T00:00:00.000Z",16,FALSE,2,4,"C-F",16,16,"Miami Heat","Bam Adebayo",2,24,26,21,7,34
6,0,3,10,5,14,7,0,0,"29",0,0,19,3,1,1,1038222,"2024-01-25T00:00:00.000Z",16,FALSE,2,666633,"G",16,16,"Miami Heat","Tyler Herro",1,22,28,25,9,33.6
3,0,2,4,1,10,3,0,0,"29",0,2,7,2,1,0,1038222,"2024-01-25T00:00:00.000Z",16,FALSE,2,403,"G",4,16,"Miami Heat","Terry Rozier",1,9,12,10,5,16.9
2,0,2,1,0,4,3,2,1,"12",3,1,7,5,0,0,1038222,"2024-01-25T00:00:00.000Z",16,FALSE,2,74,"C",16,16,"Miami Heat","Thomas Bryant",0,12,14,9,7,16
0,0,1,2,1,4,1,0,0,"07",2,0,3,3,0,0,1038222,"2024-01-25T00:00:00.000Z",16,FALSE,2,38017696,"F",16,16,"Miami Heat","Nikola Jovic",0,6,6,3,3,6.6
2,0,2,8,2,12,2,2,2,"22",1,0,8,3,1,0,1038222,"2024-01-25T00:00:00.000Z",16,FALSE,2,666747,"F",16,16,"Miami Heat","Caleb Martin",1,11,13,10,5,17.6
3,0,1,4,0,9,4,0,0,"24",1,1,8,2,0,0,1038222,"2024-01-25T00:00:00.000Z",16,FALSE,2,391,"G-F",16,16,"Miami Heat","Josh Richardson",0,10,13,11,5,14.9
2,0,0,5,1,6,2,0,0,"20",0,3,5,0,0,0,1038222,"2024-01-25T00:00:00.000Z",16,FALSE,2,397,"F",16,16,"Miami Heat","Duncan Robinson",0,5,7,7,2,8
0,0,1,0,0,1,0,4,3,"06",1,0,3,2,0,1,1038222,"2024-01-25T00:00:00.000Z",16,FALSE,2,39398582,"C",16,16,"Miami Heat","Orlando Robinson",0,5,5,3,2,4.4
0,0,0,1,0,2,0,0,0,"07",0,1,0,0,0,0,1038222,"2024-01-25T00:00:00.000Z",16,FALSE,2,38017736,"F",16,16,"Miami Heat","Cole Swider",0,0,0,0,0,0
0,0,0,0,0,0,0,0,0,"00",0,0,0,0,0,0,1038222,"2024-01-25T00:00:00.000Z",16,FALSE,2,38017734,"F",16,16,"Miami Heat","Jamal Cain",0,0,0,0,0,0
0,0,0,0,0,0,0,0,0,"00",0,0,0,0,0,0,1038222,"2024-01-25T00:00:00.000Z",16,FALSE,2,3547257,"G",16,16,"Miami Heat","R.J. Hampton",0,0,0,0,0,0
0,0,0,0,0,0,0,0,0,"00",0,0,0,0,0,0,1038222,"2024-01-25T00:00:00.000Z",16,FALSE,2,56677785,"G",16,16,"Miami Heat","Jaime Jaquez Jr.",0,0,0,0,0,0
0,0,0,0,0,0,0,0,0,"00",0,0,0,0,0,0,1038222,"2024-01-25T00:00:00.000Z",16,FALSE,2,285,"F-C",16,16,"Miami Heat","Kevin Love",0,0,0,0,0,0
0,0,0,0,0,0,0,0,0,"00",0,0,0,0,0,0,1038222,"2024-01-25T00:00:00.000Z",16,FALSE,2,19465585,"G",16,16,"Miami Heat","Dru Smith",0,0,0,0,0,0
5,0,3,8,4,11,7,0,0,"27",1,1,18,4,3,3,1038222,"2024-01-25T00:00:00.000Z",16,FALSE,2,70,"G",2,2,"Boston Celtics","Jaylen Brown",3,22,27,23,9,36.3
4,0,7,7,3,15,7,10,9,"32",1,1,26,8,0,1,1038222,"2024-01-25T00:00:00.000Z",16,FALSE,2,434,"F",2,2,"Boston Celtics","Jayson Tatum",0,34,38,30,12,40.6
1,0,4,4,3,9,6,4,4,"21",0,1,19,4,0,0,1038222,"2024-01-25T00:00:00.000Z",16,FALSE,2,378,"F-C",2,2,"Boston Celtics","Kristaps Porzingis",0,23,24,20,5,25.3
5,1,5,4,3,8,7,0,0,"29",0,1,17,5,0,3,1038222,"2024-01-25T00:00:00.000Z",16,FALSE,2,214,"G",2,2,"Boston Celtics","Jrue Holiday",1,22,27,22,10,30.5
6,2,4,9,3,12,6,0,0,"29",2,0,15,6,0,1,1038222,"2024-01-25T00:00:00.000Z",16,FALSE,2,473,"G",2,2,"Boston Celtics","Derrick White",2,21,27,21,12,36.2
1,0,0,1,1,2,2,0,0,"12",0,0,5,0,0,1,1038222,"2024-01-25T00:00:00.000Z",16,FALSE,2,17896060,"F",2,2,"Boston Celtics","Sam Hauser",0,5,6,6,1,5.5
6,1,7,3,2,4,3,0,0,"23",0,2,8,7,0,1,1038222,"2024-01-25T00:00:00.000Z",16,FALSE,2,219,"C-F",2,2,"Boston Celtics","Al Horford",1,15,21,14,13,27.4
2,0,3,2,1,7,4,2,2,"23",0,0,11,3,0,0,1038222,"2024-01-25T00:00:00.000Z",16,FALSE,2,3547276,"G",2,2,"Boston Celtics","Payton Pritchard",0,14,16,13,5,17.6
1,0,4,0,0,4,4,4,4,"19",1,1,12,5,0,0,1038222,"2024-01-25T00:00:00.000Z",16,FALSE,2,261,"F-C",2,2,"Boston Celtics","Luke Kornet",0,17,18,13,6,19.5
0,0,1,0,0,2,2,0,0,"03",1,0,4,2,0,0,1038222,"2024-01-25T00:00:00.000Z",16,FALSE,2,666468,"F",2,2,"Boston Celtics","Oshae Brissett",0,6,6,4,2,6.4
2,0,0,0,0,1,0,0,0,"07",0,1,0,0,1,0,1038222,"2024-01-25T00:00:00.000Z",16,FALSE,2,17896094,"G",2,2,"Boston Celtics","Dalano Banton",1,0,2,2,2,6
0,0,0,2,2,2,2,0,0,"03",0,0,6,0,0,0,1038222,"2024-01-25T00:00:00.000Z",16,FALSE,2,338,"G",2,2,"Boston Celtics","Svi Mykhailiuk",0,6,6,6,0,6
0,1,1,0,0,0,0,0,0,"04",0,2,0,1,0,0,1038222,"2024-01-25T00:00:00.000Z",16,FALSE,2,17553967,"C",2,2,"Boston Celtics","Neemias Queta",1,1,1,0,1,4.2
1,0,1,0,0,3,1,0,0,"05",0,0,2,1,0,1,1038222,"2024-01-25T00:00:00.000Z",16,FALSE,2,3547279,"F",2,2,"Boston Celtics","Lamar Stevens",0,3,4,3,2,3.7
1,0,1,0,0,0,0,0,0,"03",0,0,0,1,0,0,1038222,"2024-01-25T00:00:00.000Z",16,FALSE,2,56677864,"G",2,2,"Boston Celtics","Jordan Walsh",0,1,2,1,2,2.7
0,0,0,0,0,0,0,0,0,"00",0,0,0,0,0,0,1038222,"2024-01-25T00:00:00.000Z",16,FALSE,2,38017707,"G",2,2,"Boston Celtics","JD Davison",0,0,0,0,0,0
0,0,0,0,0,0,0,0,0,"00",0,0,0,0,0,0,1038222,"2024-01-25T00:00:00.000Z",16,FALSE,2,NA,NA,NA,2,"Boston Celtics","NA NA",0,0,0,0,0,0
0,0,0,0,0,0,0,0,0,"00",0,0,0,0,0,0,1038223,"2024-01-25T00:00:00.000Z",20,FALSE,8,666474,"G",20,20,"New York Knicks","Charles Brown",0,0,0,0,0,0
0,0,0,0,0,0,0,0,0,"00",0,0,0,0,0,0,1038223,"2024-01-25T00:00:00.000Z",20,FALSE,8,201,"F-C",20,20,"New York Knicks","Isaiah Hartenstein",0,0,0,0,0,0
0,0,0,0,0,0,0,0,0,"00",0,0,0,0,0,0,1038223,"2024-01-25T00:00:00.000Z",20,FALSE,8,399,"C",20,20,"New York Knicks","Mitchell Robinson",0,0,0,0,0,0
0,0,0,0,0,0,0,0,0,"00",0,0,0,0,0,0,1038223,"2024-01-25T00:00:00.000Z",20,FALSE,8,56677795,"F",20,20,"New York Knicks","Jacob Toppin",0,0,0,0,0,0
0,0,0,0,0,0,0,0,0,"00",0,0,0,0,0,0,1038223,"2024-01-25T00:00:00.000Z",20,FALSE,8,17896089,"G",20,20,"New York Knicks","Duane Washington Jr.",0,0,0,0,0,0
2,0,4,1,0,10,5,2,2,"30",1,2,12,5,1,1,1038223,"2024-01-25T00:00:00.000Z",20,FALSE,8,177,"F",8,8,"Denver Nuggets","Aaron Gordon",1,17,19,14,7,23
0,0,3,0,0,4,2,1,1,"22",3,2,5,6,0,2,1038223,"2024-01-25T00:00:00.000Z",20,FALSE,8,375,"F",8,8,"Denver Nuggets","Michael Porter Jr.",0,11,11,5,6,10.2
3,0,7,3,2,18,13,3,3,"27",4,1,31,11,0,7,1038223,"2024-01-25T00:00:00.000Z",20,FALSE,8,246,"C",8,8,"Denver Nuggets","Nikola Jokic",0,42,45,34,14,41.7
0,0,0,3,1,6,2,0,0,"22",0,4,5,0,0,1,1038223,"2024-01-25T00:00:00.000Z",20,FALSE,8,81,"G",8,8,"Denver Nuggets","Kentavious Caldwell-Pope",0,5,5,5,0,4
7,0,2,3,1,11,3,3,2,"30",0,1,9,2,0,3,1038223,"2024-01-25T00:00:00.000Z",20,FALSE,8,335,"G",8,8,"Denver Nuggets","Jamal Murray",0,11,18,16,9,18.9
1,0,2,9,3,18,10,5,3,"29",0,2,26,2,6,1,1038223,"2024-01-25T00:00:00.000Z",20,FALSE,8,18,"F",28,20,"New York Knicks","OG Anunoby",6,28,29,27,3,46.9
8,0,4,5,1,15,7,2,2,"30",3,2,17,7,1,2,1038223,"2024-01-25T00:00:00.000Z",20,FALSE,8,387,"F",20,20,"New York Knicks","Julius Randle",1,24,32,25,15,38.4
0,1,7,0,0,1,1,0,0,"26",1,4,2,8,0,1,1038223,"2024-01-25T00:00:00.000Z",20,FALSE,8,17896063,"F",20,20,"New York Knicks","Jericho Sims",1,10,10,2,8,13.6
4,0,1,2,1,10,7,6,6,"27",0,0,21,1,0,2,1038223,"2024-01-25T00:00:00.000Z",20,FALSE,8,73,"G",20,20,"New York Knicks","Jalen Brunson",0,22,26,25,5,26.2
6,0,1,9,4,10,5,2,2,"26",2,2,16,3,1,0,1038223,"2024-01-25T00:00:00.000Z",20,FALSE,8,131,"G",20,20,"New York Knicks","Donte DiVincenzo",1,19,25,22,9,31.6
3,1,4,0,0,4,1,0,0,"23",6,1,2,10,0,0,1038223,"2024-01-25T00:00:00.000Z",20,FALSE,8,3547249,"F",28,20,"New York Knicks","Precious Achiuwa",1,12,15,5,13,21.5
0,0,0,1,0,1,0,0,0,"05",0,1,0,0,1,0,1038223,"2024-01-25T00:00:00.000Z",20,FALSE,8,19,"G",20,20,"New York Knicks","Ryan Arcidiacono",1,0,0,0,0,3
0,0,0,0,0,1,1,0,0,"04",0,0,2,0,0,0,1038223,"2024-01-25T00:00:00.000Z",20,FALSE,8,3547275,"G",28,20,"New York Knicks","Malachi Flynn",0,2,2,2,0,2
0,0,0,0,0,0,0,0,0,"00",0,0,0,0,0,0,1038223,"2024-01-25T00:00:00.000Z",20,FALSE,8,160,"G-F",20,20,"New York Knicks","Evan Fournier",0,0,0,0,0,0
0,0,5,5,2,11,7,3,3,"23",0,0,19,5,0,2,1038223,"2024-01-25T00:00:00.000Z",20,FALSE,8,17895858,"G",20,20,"New York Knicks","Quentin Grimes",0,24,24,19,5,23
3,1,7,2,0,5,2,0,0,"26",0,0,4,7,1,0,1038223,"2024-01-25T00:00:00.000Z",20,FALSE,8,202,"G",20,20,"New York Knicks","Josh Hart",2,11,14,7,10,22.9
1,0,1,5,4,9,4,2,1,"21",0,2,13,1,2,0,1038223,"2024-01-25T00:00:00.000Z",20,FALSE,8,17896033,"G",20,20,"New York Knicks","Miles McBride",2,14,15,14,2,21.7
2,0,0,2,0,3,1,0,0,"07",0,0,2,0,0,0,1038223,"2024-01-25T00:00:00.000Z",20,FALSE,8,56677582,"G",8,8,"Denver Nuggets","Jalen Pickett",0,2,4,4,2,5
0,0,1,3,0,3,0,0,0,"07",0,1,0,1,0,2,1038223,"2024-01-25T00:00:00.000Z",20,FALSE,8,56677871,"F",8,8,"Denver Nuggets","Hunter Tyson",0,1,1,0,1,-0.8
3,2,3,4,0,8,3,2,1,"23",1,2,7,4,0,2,1038223,"2024-01-25T00:00:00.000Z",20,FALSE,8,38017721,"G",8,8,"Denver Nuggets","Peyton Watson",2,11,14,10,7,20.3
0,0,0,0,0,0,0,0,0,"00",0,0,0,0,0,0,1038223,"2024-01-25T00:00:00.000Z",20,FALSE,8,666489,"F",8,8,"Denver Nuggets","Vlatko Cancar",0,0,0,0,0,0
0,0,0,0,0,0,0,0,0,"00",0,0,0,0,0,0,1038223,"2024-01-25T00:00:00.000Z",20,FALSE,8,38017727,"G",8,8,"Denver Nuggets","Collin Gillespie",0,0,0,0,0,0
0,0,0,0,0,0,0,0,0,"00",0,0,0,0,0,0,1038223,"2024-01-25T00:00:00.000Z",20,FALSE,8,17896007,"G",8,8,"Denver Nuggets","Braxton Key",0,0,0,0,0,0
0,0,0,0,0,0,0,0,0,"00",0,0,0,0,0,0,1038223,"2024-01-25T00:00:00.000Z",20,FALSE,8,56677776,"G",8,8,"Denver Nuggets","Julian Strawther",0,0,0,0,0,0
0,0,2,1,0,4,1,2,2,"15",1,1,4,3,0,1,1038223,"2024-01-25T00:00:00.000Z",20,FALSE,8,38017709,"G",8,8,"Denver Nuggets","Christian Braun",0,7,7,4,3,6.6
0,0,1,2,0,4,2,0,0,"12",0,2,4,1,1,0,1038223,"2024-01-25T00:00:00.000Z",20,FALSE,8,215,"F-G",8,8,"Denver Nuggets","Justin Holiday",1,5,5,4,1,8.2
0,0,0,2,1,2,1,0,0,"05",0,2,3,0,0,0,1038223,"2024-01-25T00:00:00.000Z",20,FALSE,8,17896103,"F-C",8,8,"Denver Nuggets","Jay Huff",0,3,3,3,0,3
3,0,0,1,0,7,1,0,0,"24",1,2,2,1,0,0,1038223,"2024-01-25T00:00:00.000Z",20,FALSE,8,236,"G",8,8,"Denver Nuggets","Reggie Jackson",0,3,6,5,4,7.7
0,0,3,0,0,2,0,0,0,"11",2,0,0,5,0,0,1038223,"2024-01-25T00:00:00.000Z",20,FALSE,8,250,"C",8,8,"Denver Nuggets","DeAndre Jordan",0,5,5,0,5,6
0,0,1,1,0,2,0,0,0,"05",0,0,0,1,0,0,1038223,"2024-01-25T00:00:00.000Z",20,FALSE,8,3547268,"F-C",8,8,"Denver Nuggets","Zeke Nnaji",0,1,1,0,1,1.2
4,0,4,3,2,8,6,4,3,"31",0,2,17,4,0,2,1038224,"2024-01-25T00:00:00.000Z",10,FALSE,26,475,"F-G",10,10,"Golden State Warriors","Andrew Wiggins",0,21,25,21,8,25.8
5,0,2,4,4,6,5,0,0,"20",2,2,14,4,0,2,1038224,"2024-01-25T00:00:00.000Z",10,FALSE,26,407,"F",10,10,"Golden State Warriors","Dario Saric",0,18,23,19,9,24.3
2,1,3,0,0,2,2,0,0,"16",0,2,4,3,0,1,1038224,"2024-01-25T00:00:00.000Z",10,FALSE,26,282,"F",10,10,"Golden State Warriors","Kevon Looney",1,7,9,6,5,12.6
1,1,1,7,2,14,5,4,4,"31",0,5,16,1,1,1,1038224,"2024-01-25T00:00:00.000Z",10,FALSE,26,443,"G",10,10,"Golden State Warriors","Klay Thompson",2,17,18,17,2,23.7
2,0,5,14,6,26,13,1,1,"36",1,0,33,6,1,2,1038224,"2024-01-25T00:00:00.000Z",10,FALSE,26,115,"G",10,10,"Golden State Warriors","Stephen Curry",1,39,41,35,8,44.2
11,1,4,1,0,3,0,8,5,"32",0,3,5,4,3,2,1038224,"2024-01-25T00:00:00.000Z",10,FALSE,26,185,"F",10,10,"Golden State Warriors","Draymond Green",4,9,20,16,15,36.3
0,0,0,0,0,0,0,0,0,"00",0,0,0,0,0,0,1038224,"2024-01-25T00:00:00.000Z",10,FALSE,26,56677799,"F",10,10,"Golden State Warriors","Trayce Jackson-Davis",0,0,0,0,0,0
0,0,4,2,2,3,2,0,0,"17",1,1,6,5,0,0,1038224,"2024-01-25T00:00:00.000Z",10,FALSE,26,251,"G",10,10,"Golden State Warriors","Cory Joseph",0,11,11,6,5,12
3,0,2,4,2,19,12,6,5,"30",1,2,31,3,2,2,1038224,"2024-01-25T00:00:00.000Z",10,FALSE,26,17553979,"F",10,10,"Golden State Warriors","Jonathan Kuminga",2,34,37,34,6,43.1
2,0,2,2,1,5,3,0,0,"27",1,2,7,3,0,1,1038224,"2024-01-25T00:00:00.000Z",10,FALSE,26,56677858,"G",10,10,"Golden State Warriors","Brandin Podziemski",0,10,12,9,5,12.6
0,0,0,0,0,0,0,0,0,"00",0,0,0,0,0,0,1038224,"2024-01-25T00:00:00.000Z",10,FALSE,26,45658838,"G",10,10,"Golden State Warriors","Lester Quinones",0,0,0,0,0,0
0,0,0,0,0,0,0,0,0,"00",0,0,0,0,0,0,1038224,"2024-01-25T00:00:00.000Z",10,FALSE,26,57875092,"F",10,10,"Golden State Warriors","Gui Santos",0,0,0,0,0,0
0,0,0,0,0,0,0,0,0,"00",0,0,0,0,0,0,1038224,"2024-01-25T00:00:00.000Z",10,FALSE,26,17896070,"F",10,10,"Golden State Warriors","Usman Garuba",0,0,0,0,0,0
0,0,0,0,0,0,0,0,0,"00",0,0,0,0,0,0,1038224,"2024-01-25T00:00:00.000Z",10,FALSE,26,17553992,"G",10,10,"Golden State Warriors","Moses Moody",0,0,0,0,0,0
0,1,3,12,7,24,14,4,4,"40",1,0,39,4,2,1,1038224,"2024-01-25T00:00:00.000Z",10,FALSE,26,30,"F",26,26,"Sacramento Kings","Harrison Barnes",3,43,43,39,4,51.8
1,2,5,7,2,12,5,2,2,"38",1,2,14,6,1,0,1038224,"2024-01-25T00:00:00.000Z",10,FALSE,26,38017688,"F",26,26,"Sacramento Kings","Keegan Murray",3,20,21,15,7,31.7
13,1,7,2,2,11,8,0,0,"35",1,5,18,8,0,3,1038224,"2024-01-25T00:00:00.000Z",10,FALSE,26,406,"F",26,26,"Sacramento Kings","Domantas Sabonis",1,26,39,31,21,47.1
4,0,7,8,3,10,4,3,1,"33",3,4,12,10,3,2,1038224,"2024-01-25T00:00:00.000Z",10,FALSE,26,221,"G",26,26,"Sacramento Kings","Kevin Huerter",3,22,26,16,14,37
5,1,1,7,3,16,9,8,8,"36",0,3,29,1,1,1,1038224,"2024-01-25T00:00:00.000Z",10,FALSE,26,161,"G",26,26,"Sacramento Kings","De'Aaron Fox",2,30,35,34,6,42.7
0,0,0,0,0,0,0,0,0,"03",0,0,0,0,0,0,1038224,"2024-01-25T00:00:00.000Z",10,FALSE,26,17896030,"G",26,26,"Sacramento Kings","Chris Duarte",0,0,0,0,0,0
1,0,1,1,0,1,0,0,0,"06",0,1,0,1,0,0,1038224,"2024-01-25T00:00:00.000Z",10,FALSE,26,17896044,"F",26,26,"Sacramento Kings","Kessler Edwards",0,1,2,1,2,2.7
0,0,0,0,0,0,0,0,0,"00",0,0,0,0,0,0,1038224,"2024-01-25T00:00:00.000Z",10,FALSE,26,38017714,"G",26,26,"Sacramento Kings","Keon Ellis",0,0,0,0,0,0
0,0,0,0,0,0,0,0,0,"00",0,0,0,0,0,0,1038224,"2024-01-25T00:00:00.000Z",10,FALSE,26,56677845,"G",26,26,"Sacramento Kings","Colby Jones",0,0,0,0,0,0
0,0,0,0,0,0,0,0,0,"00",0,0,0,0,0,0,1038224,"2024-01-25T00:00:00.000Z",10,FALSE,26,273,"C",26,26,"Sacramento Kings","Alex Len",0,0,0,0,0,0
2,0,0,4,2,7,3,0,0,"15",0,1,8,0,1,0,1038224,"2024-01-25T00:00:00.000Z",10,FALSE,26,290,"F",26,26,"Sacramento Kings","Trey Lyles",1,8,10,10,2,14
0,0,0,0,0,0,0,0,0,"00",0,0,0,0,0,0,1038224,"2024-01-25T00:00:00.000Z",10,FALSE,26,306,"C",26,26,"Sacramento Kings","JaVale McGee",0,0,0,0,0,0
4,0,1,5,3,5,3,2,1,"15",1,2,10,2,0,0,1038224,"2024-01-25T00:00:00.000Z",10,FALSE,26,17553994,"G",26,26,"Sacramento Kings","Davion Mitchell",0,12,16,14,6,18.4
3,0,1,2,0,5,2,0,0,"19",1,3,4,2,0,3,1038224,"2024-01-25T00:00:00.000Z",10,FALSE,26,324,"G",26,26,"Sacramento Kings","Malik Monk",0,6,9,7,5,7.9
0,0,0,0,0,0,0,0,0,"00",0,0,0,0,0,0,1038224,"2024-01-25T00:00:00.000Z",10,FALSE,26,56677862,"F",26,26,"Sacramento Kings","Jalen Slawson",0,0,0,0,0,0
0,0,0,0,0,0,0,0,0,"00",0,0,0,0,0,0,1038224,"2024-01-25T00:00:00.000Z",10,FALSE,26,367,"G",10,10,"Golden State Warriors","Chris Paul",0,0,0,0,0,0
0,0,0,0,0,0,0,0,0,"00",0,0,0,0,0,0,1038224,"2024-01-25T00:00:00.000Z",10,FALSE,26,2189,"",10,10,"Golden State Warriors","Gary Payton II",0,0,0,0,0,0
0,0,0,0,0,0,0,0,0,"00",0,0,0,0,0,0,1038224,"2024-01-25T00:00:00.000Z",10,FALSE,26,398,"G",10,10,"Golden State Warriors","Jerome Robinson",0,0,0,0,0,0
0,0,0,0,0,0,0,0,0,"00",0,0,0,0,0,0,1038224,"2024-01-25T00:00:00.000Z",10,FALSE,26,17895990,"G",26,26,"Sacramento Kings","Jordan Ford",0,0,0,0,0,0
0,0,0,0,0,0,0,0,0,"00",0,0,0,0,0,0,1038224,"2024-01-25T00:00:00.000Z",10,FALSE,26,4197162,"F",26,26,"Sacramento Kings","Aleksandar Vezenkov",0,0,0,0,0,0
2,0,4,7,4,8,5,0,0,"30",0,3,14,4,2,0,1038225,"2024-01-25T00:00:00.000Z",14,FALSE,5,383,"F",14,14,"Los Angeles Lakers","Taurean Prince",2,18,20,16,6,27.8
12,0,4,4,3,19,10,2,2,"36",0,2,25,4,2,5,1038225,"2024-01-25T00:00:00.000Z",14,FALSE,5,237,"F",14,14,"Los Angeles Lakers","LeBron James",2,29,41,37,16,48.8
6,1,6,1,0,18,10,5,2,"36",5,1,22,11,0,0,1038225,"2024-01-25T00:00:00.000Z",14,FALSE,5,117,"F-C",14,14,"Los Angeles Lakers","Anthony Davis",1,33,39,28,17,47.2
8,0,3,3,2,9,7,4,4,"33",0,4,20,3,0,1,1038225,"2024-01-25T00:00:00.000Z",14,FALSE,5,17553995,"G",14,14,"Los Angeles Lakers","Austin Reaves",0,23,31,28,11,34.6
4,1,0,13,8,18,10,2,1,"38",0,3,29,0,1,2,1038225,"2024-01-25T00:00:00.000Z",14,FALSE,5,405,"G",14,14,"Los Angeles Lakers","D'Angelo Russell",2,29,33,33,4,39
1,0,0,0,0,0,0,2,2,"09",0,0,2,0,1,1,1038225,"2024-01-25T00:00:00.000Z",14,FALSE,5,38017697,"G",14,14,"Los Angeles Lakers","Max Christie",1,2,3,3,1,5.5
2,0,3,2,2,3,3,2,2,"19",0,3,10,3,1,1,1038225,"2024-01-25T00:00:00.000Z",14,FALSE,5,666609,"F",14,14,"Los Angeles Lakers","Rui Hachimura",1,13,15,12,5,18.6
0,0,0,0,0,0,0,0,0,"00",0,0,0,0,0,0,1038225,"2024-01-25T00:00:00.000Z",14,FALSE,5,666626,"C",14,14,"Los Angeles Lakers","Jaxson Hayes",0,0,0,0,0,0
0,0,0,0,0,0,0,0,0,"00",0,0,0,0,0,0,1038225,"2024-01-25T00:00:00.000Z",14,FALSE,5,56677835,"G",14,14,"Los Angeles Lakers","Jalen Hood-Schifino",0,0,0,0,0,0
0,0,0,0,0,0,0,0,0,"00",0,0,0,0,0,0,1038225,"2024-01-25T00:00:00.000Z",14,FALSE,5,666860,"F-G",14,14,"Los Angeles Lakers","Cameron Reddish",0,0,0,0,0,0
0,1,5,1,1,11,8,1,0,"27",0,2,17,5,3,2,1038225,"2024-01-25T00:00:00.000Z",14,FALSE,5,457,"F",14,14,"Los Angeles Lakers","Jarred Vanderbilt",4,22,22,17,5,33
0,1,0,0,0,1,0,2,2,"12",0,3,2,0,0,0,1038225,"2024-01-25T00:00:00.000Z",14,FALSE,5,486,"F",14,14,"Los Angeles Lakers","Christian Wood",1,2,2,2,0,5
0,0,0,0,0,0,0,0,0,"00",0,0,0,0,0,0,1038225,"2024-01-25T00:00:00.000Z",14,FALSE,5,666971,"G-F",20,14,"Los Angeles Lakers","Dylan Windler",0,0,0,0,0,0
10,1,2,1,1,14,10,12,11,"41",0,2,32,2,2,3,1038225,"2024-01-25T00:00:00.000Z",14,FALSE,5,125,"G",5,5,"Chicago Bulls","DeMar DeRozan",3,34,44,42,12,55.4
2,2,6,5,0,9,2,2,2,"24",0,5,6,6,0,2,1038225,"2024-01-25T00:00:00.000Z",14,FALSE,5,3547248,"F",5,5,"Chicago Bulls","Patrick Williams",2,12,14,8,8,20.2
1,1,5,3,2,12,9,0,0,"39",3,2,20,8,0,2,1038225,"2024-01-25T00:00:00.000Z",14,FALSE,5,460,"C",5,5,"Chicago Bulls","Nikola Vucevic",1,28,29,21,9,32.1
6,2,3,9,3,12,6,2,2,"35",1,4,17,4,2,2,1038225,"2024-01-25T00:00:00.000Z",14,FALSE,5,89,"G",5,5,"Chicago Bulls","Alex Caruso",4,21,27,23,10,40.8
3,0,5,10,3,18,8,7,6,"43",2,1,25,7,0,4,1038225,"2024-01-25T00:00:00.000Z",14,FALSE,5,666956,"G",5,5,"Chicago Bulls","Coby White",0,32,35,28,10,33.9
2,0,1,3,0,3,0,0,0,"08",0,1,0,1,0,0,1038225,"2024-01-25T00:00:00.000Z",14,FALSE,5,87,"G",5,5,"Chicago Bulls","Jevon Carter",0,1,3,2,3,4.2
0,0,0,0,0,0,0,0,0,"00",0,0,0,0,0,0,1038225,"2024-01-25T00:00:00.000Z",14,FALSE,5,110,"F",5,5,"Chicago Bulls","Torrey Craig",0,0,0,0,0,0
1,1,1,5,2,11,6,4,4,"30",1,2,18,2,2,2,1038225,"2024-01-25T00:00:00.000Z",14,FALSE,5,17895983,"G",5,5,"Chicago Bulls","Ayo Dosunmu",3,20,21,19,3,28.9
1,0,4,0,0,7,5,2,1,"17",5,0,11,9,1,1,1038225,"2024-01-25T00:00:00.000Z",14,FALSE,5,137,"C",5,5,"Chicago Bulls","Andre Drummond",1,20,21,12,10,25.3
0,0,0,0,0,0,0,0,0,"00",0,0,0,0,0,0,1038225,"2024-01-25T00:00:00.000Z",14,FALSE,5,56677857,"F",5,5,"Chicago Bulls","Julian Phillips",0,0,0,0,0,0
0,0,0,0,0,0,0,0,0,"00",0,0,0,0,0,0,1038225,"2024-01-25T00:00:00.000Z",14,FALSE,5,17896116,"G",5,5,"Chicago Bulls","Terry Taylor",0,0,0,0,0,0
1,0,0,1,1,2,1,0,0,"03",0,1,3,0,0,0,1038225,"2024-01-25T00:00:00.000Z",14,FALSE,5,38017719,"F",5,5,"Chicago Bulls","Dalen Terry",0,3,4,4,1,4.5
0,0,0,0,0,0,0,0,0,"00",0,0,0,0,0,0,1038225,"2024-01-25T00:00:00.000Z",14,FALSE,5,27,"G",5,5,"Chicago Bulls","Lonzo Ball",0,0,0,0,0,0
0,0,0,0,0,0,0,0,0,"00",0,0,0,0,0,0,1038225,"2024-01-25T00:00:00.000Z",14,FALSE,5,56677874,"F",5,5,"Chicago Bulls","Onuralp Bitim",0,0,0,0,0,0
0,0,0,0,0,0,0,0,0,"00",0,0,0,0,0,0,1038225,"2024-01-25T00:00:00.000Z",14,FALSE,5,NA,NA,NA,5,"Chicago Bulls","NA NA",0,0,0,0,0,0
0,0,0,0,0,0,0,0,0,"00",0,0,0,0,0,0,1038225,"2024-01-25T00:00:00.000Z",14,FALSE,5,268,"G",5,5,"Chicago Bulls","Zach LaVine",0,0,0,0,0,0
0,0,0,0,0,0,0,0,0,"00",0,0,0,0,0,0,1038225,"2024-01-25T00:00:00.000Z",14,FALSE,5,56677860,"F",5,5,"Chicago Bulls","Adama Sanogo",0,0,0,0,0,0
0,0,0,0,0,0,0,0,0,"00",0,0,0,0,0,0,1038225,"2024-01-25T00:00:00.000Z",14,FALSE,5,56677738,"C",14,14,"Los Angeles Lakers","Colin Castleton",0,0,0,0,0,0
0,0,0,0,0,0,0,0,0,"00",0,0,0,0,0,0,1038225,"2024-01-25T00:00:00.000Z",14,FALSE,5,56677836,"F",14,14,"Los Angeles Lakers","Maxwell Lewis",0,0,0,0,0,0
0,0,0,0,0,0,0,0,0,"00",0,0,0,0,0,0,1038225,"2024-01-25T00:00:00.000Z",14,FALSE,5,3547289,"G",25,14,"Los Angeles Lakers","Skylar Mays",0,0,0,0,0,0
0,0,0,0,0,0,0,0,0,"00",0,0,0,0,0,0,1038225,"2024-01-25T00:00:00.000Z",14,FALSE,5,1603383,"G",14,14,"Los Angeles Lakers","Gabe Vincent",0,0,0,0,0,0
3,0,7,3,3,8,6,1,1,"29",1,2,16,8,0,1,1038219,"2024-01-25T00:00:00.000Z",12,FALSE,23,3547250,"G-F",12,12,"Indiana Pacers","Aaron Nesmith",0,24,27,19,11,29.1
10,0,10,2,1,13,9,10,7,"30",3,3,26,13,0,2,1038219,"2024-01-25T00:00:00.000Z",12,FALSE,23,416,"F",28,12,"Indiana Pacers","Pascal Siakam",0,39,49,36,23,54.6
1,2,6,6,3,12,7,4,3,"27",3,4,20,9,1,1,1038219,"2024-01-25T00:00:00.000Z",12,FALSE,23,452,"C-F",12,12,"Indiana Pacers","Myles Turner",3,29,30,21,10,40.3
2,0,3,5,3,6,4,0,0,"26",0,1,11,3,2,1,1038219,"2024-01-25T00:00:00.000Z",12,FALSE,23,210,"G",12,12,"Indiana Pacers","Buddy Hield",2,14,16,13,5,22.6
8,1,2,3,1,15,8,2,2,"29",0,3,19,2,1,6,1038219,"2024-01-25T00:00:00.000Z",12,FALSE,23,38017507,"G-F",12,12,"Indiana Pacers","Andrew Nembhard",2,21,29,27,10,33.4
0,0,0,0,0,0,0,0,0,"02",0,0,0,0,0,0,1038219,"2024-01-25T00:00:00.000Z",12,FALSE,23,38017701,"G",12,12,"Indiana Pacers","Kendall Brown",0,0,0,0,0,0
0,2,0,0,0,1,0,0,0,"05",0,1,0,0,0,1,1038219,"2024-01-25T00:00:00.000Z",12,FALSE,23,17896035,"F",12,12,"Indiana Pacers","Isaiah Jackson",2,0,0,0,0,5
0,0,0,0,0,0,0,0,0,"00",0,0,0,0,0,0,1038219,"2024-01-25T00:00:00.000Z",12,FALSE,23,242,"F",12,12,"Indiana Pacers","James Johnson",0,0,0,0,0,0
4,0,4,2,0,13,5,3,3,"25",1,2,13,5,0,3,1038219,"2024-01-25T00:00:00.000Z",12,FALSE,23,38017686,"G-F",12,12,"Indiana Pacers","Bennedict Mathurin",0,18,22,17,9,22
5,0,3,0,0,6,4,0,0,"24",1,4,8,4,2,3,1038219,"2024-01-25T00:00:00.000Z",12,FALSE,23,304,"G",12,12,"Indiana Pacers","T.J. McConnell",2,12,17,13,9,23.3
2,0,5,2,0,4,1,0,0,"15",0,5,2,5,0,0,1038219,"2024-01-25T00:00:00.000Z",12,FALSE,23,56677861,"G",12,12,"Indiana Pacers","Ben Sheppard",0,7,9,4,7,11
0,2,0,1,0,4,3,1,0,"09",1,6,6,1,0,0,1038219,"2024-01-25T00:00:00.000Z",12,FALSE,23,3547264,"F-C",12,12,"Indiana Pacers","Jalen Smith",2,7,7,6,1,13.2
0,1,3,4,1,11,6,0,0,"19",2,2,13,5,0,3,1038219,"2024-01-25T00:00:00.000Z",12,FALSE,23,3547243,"F",12,12,"Indiana Pacers","Obi Toppin",1,18,18,13,5,19
0,0,0,0,0,0,0,0,0,"00",0,0,0,0,0,0,1038219,"2024-01-25T00:00:00.000Z",12,FALSE,23,56677778,"F-C",12,12,"Indiana Pacers","Oscar Tshiebwe",0,0,0,0,0,0
0,0,0,0,0,0,0,0,0,"00",0,0,0,0,0,0,1038219,"2024-01-25T00:00:00.000Z",12,FALSE,23,56677832,"F",12,12,"Indiana Pacers","Jarace Walker",0,0,0,0,0,0
0,0,0,0,0,0,0,0,0,"00",0,0,0,0,0,0,1038219,"2024-01-25T00:00:00.000Z",12,FALSE,23,3547245,"G",12,12,"Indiana Pacers","Tyrese Haliburton",0,0,0,0,0,0
0,0,0,0,0,0,0,0,0,"00",0,0,0,0,0,0,1038219,"2024-01-25T00:00:00.000Z",12,FALSE,23,56677794,"G",12,12,"Indiana Pacers","Isaiah Wong",0,0,0,0,0,0
2,3,1,2,0,5,2,1,0,"21",1,4,4,2,1,0,1038219,"2024-01-25T00:00:00.000Z",12,FALSE,23,360,"F",23,23,"Philadelphia 76ers","Kelly Oubre Jr.",4,6,8,6,4,21.4
1,0,3,3,2,5,4,0,0,"21",0,2,10,3,0,1,1038219,"2024-01-25T00:00:00.000Z",12,FALSE,23,33,"F-G",23,23,"Philadelphia 76ers","Nicolas Batum",0,13,14,11,4,14.1
3,0,6,4,2,20,11,10,7,"31",1,1,31,7,0,2,1038219,"2024-01-25T00:00:00.000Z",12,FALSE,23,145,"F-C",23,23,"Philadelphia 76ers","Joel Embiid",0,38,41,34,10,41.9
5,1,3,3,0,6,1,3,2,"19",0,3,4,3,0,2,1038219,"2024-01-25T00:00:00.000Z",12,FALSE,23,45,"G",23,23,"Philadelphia 76ers","Patrick Beverley",1,7,12,9,8,16.1
2,1,1,8,1,17,7,7,7,"29",0,2,22,1,0,1,1038219,"2024-01-25T00:00:00.000Z",12,FALSE,23,3547254,"G",23,23,"Philadelphia 76ers","Tyrese Maxey",1,23,25,24,3,28.2
0,0,0,1,1,6,3,6,4,"12",1,0,11,1,1,0,1038219,"2024-01-25T00:00:00.000Z",12,FALSE,23,56913527,"G",23,23,"Philadelphia 76ers","Ricky Council IV",1,12,12,11,1,15.2
0,0,0,0,0,0,0,0,0,"00",0,0,0,0,0,0,1038219,"2024-01-25T00:00:00.000Z",12,FALSE,23,200,"F",23,23,"Philadelphia 76ers","Tobias Harris",0,0,0,0,0,0
1,1,1,0,0,6,4,3,2,"19",1,2,10,2,2,2,1038219,"2024-01-25T00:00:00.000Z",12,FALSE,23,2175,"",23,23,"Philadelphia 76ers","Danuel House Jr.",3,12,13,11,3,20.9
2,0,1,1,0,2,1,1,0,"13",0,0,2,1,1,0,1038219,"2024-01-25T00:00:00.000Z",12,FALSE,23,260,"G-F",23,23,"Philadelphia 76ers","Furkan Korkmaz",1,3,5,4,3,9.2
2,0,2,1,0,6,4,6,3,"31",1,4,11,3,3,2,1038219,"2024-01-25T00:00:00.000Z",12,FALSE,23,3547294,"F",23,23,"Philadelphia 76ers","Kenyon Martin Jr.",3,14,16,13,5,24.6
0,0,0,0,0,0,0,0,0,"00",0,0,0,0,0,0,1038219,"2024-01-25T00:00:00.000Z",12,FALSE,23,328,"F",23,23,"Philadelphia 76ers","Marcus Morris",0,0,0,0,0,0
1,0,5,2,1,5,3,0,0,"17",1,2,7,6,2,1,1038219,"2024-01-25T00:00:00.000Z",12,FALSE,23,3547270,"F",23,23,"Philadelphia 76ers","Paul Reed",2,13,14,8,7,20.7
5,0,0,4,0,6,0,2,2,"12",0,0,2,0,3,1,1038219,"2024-01-25T00:00:00.000Z",12,FALSE,23,56677788,"G",23,23,"Philadelphia 76ers","Terquavion Smith",3,2,7,7,5,17.5
0,0,2,0,0,3,2,4,4,"15",0,0,8,2,0,0,1038219,"2024-01-25T00:00:00.000Z",12,FALSE,23,17896025,"G",23,23,"Philadelphia 76ers","Jaden Springer",0,10,10,8,2,10.4
0,0,0,0,0,0,0,0,0,"00",0,0,0,0,0,0,1038219,"2024-01-25T00:00:00.000Z",12,FALSE,23,28,"C",23,23,"Philadelphia 76ers","Mo Bamba",0,0,0,0,0,0
0,0,0,0,0,0,0,0,0,"00",0,0,0,0,0,0,1038219,"2024-01-25T00:00:00.000Z",12,FALSE,23,108,"F",23,23,"Philadelphia 76ers","Robert Covington",0,0,0,0,0,0
0,0,0,0,0,0,0,0,0,"00",0,0,0,0,0,0,1038219,"2024-01-25T00:00:00.000Z",12,FALSE,23,38017732,"F",15,23,"Philadelphia 76ers","Kenneth Lofton Jr.",0,0,0,0,0,0
0,0,0,0,0,0,0,0,0,"00",0,0,0,0,0,0,1038219,"2024-01-25T00:00:00.000Z",12,FALSE,23,313,"G",23,23,"Philadelphia 76ers","De'Anthony Melton",0,0,0,0,0,0
